あいしゅう	a̠iɕɨᵝː
あいせき	a̠ise̞kʲi
あおうなばら	a̠o̞ɯ̟ᵝna̠ba̠ɾa̠
あおもの	a̠o̞mo̞no̞
あからめる	a̠ka̠ɾa̠me̞ɾɯ̟ᵝ
あきさめ	a̠kʲisa̠me̞
あきはばら	a̠kʲiha̠ba̠ɾa̠
あさひ	a̠sa̠çi̥
あしたれぼし	a̠ɕita̠ɾe̞bo̞ɕi
あじみ	a̠ʑimʲi
あっせい	a̠sːe̞ː
あつくるしい	a̠t͡sɨᵝkɯ̟ᵝɾɯ̟ᵝɕiː
あなうさぎ	a̠na̠ɯ̟ᵝsa̠ɡʲi
あまねく	a̠ma̠ne̞kɯ̟ᵝ
あらし	a̠ɾa̠ɕi
あらぬ	a̠ɾa̠nɯ̟ᵝ
ありがと	a̠ɾʲiɡa̠to̞
あわれむ	a̠ɰᵝa̠ɾe̞mɯ̟ᵝ
あんていざい	ã̠nte̞ːza̠i
いえじ	ie̞ʑi
いきごむ	ikʲiɡo̞mɯ̟ᵝ
いしむかで	iɕimɯ̟ᵝka̠de̞
いせいじん	ise̞ːʑĩɴ
いちい	it͡ɕii
いちじくか	it͡ɕiʑikɯ̟ᵝka̠
いちやく	it͡ɕija̠kɯ̟ᵝ
いっぴょう	ip̚ʲpʲo̞ː
いぬがみ	inɯ̟ᵝɡa̠mʲi
いぬつげ	inɯ̟ᵝt͡sɨᵝɡe̞
いばしょ	iba̠ɕo̞
いばら	iba̠ɾa̠
いみん	imʲĩɴ
いろあせる	iɾo̞a̠se̞ɾɯ̟ᵝ
いろむじ	iɾo̞mɯ̟ᵝʑi
いわう	iɰᵝa̠ɯ̟ᵝ
いんきゃ	ĩŋʲkʲa̠
いんきょくせんかん	ĩŋʲkʲo̞kɯ̟̊ᵝsẽ̞ŋkã̠ɴ
うえる	ɯ̟ᵝe̞ɾɯ̟ᵝ
うきゅう	ɯ̟ᵝkʲɨᵝː
うけもつ	ɯ̟ᵝke̞mo̞t͡sɨᵝ
うせる	ɯ̟ᵝse̞ɾɯ̟ᵝ
うちぜい	ɯ̟ᵝt͡ɕize̞ː
うちわ	ɯ̟ᵝt͡ɕiɰᵝa̠
うで	ɯ̟ᵝde̞
うどのき	ɯ̟ᵝdo̞no̞kʲi
うなばら	ɯ̟ᵝna̠ba̠ɾa̠
うなる	ɯ̟ᵝna̠ɾɯ̟ᵝ
うまれかわる	ɯ̟ᵝma̠ɾe̞ka̠ɰᵝa̠ɾɯ̟ᵝ
うわる	ɯ̟ᵝɰᵝa̠ɾɯ̟ᵝ
えいしゃ	e̞ːɕa̠
えつ	e̞t͡sɨᵝ
おいこむ	o̞iko̞mɯ̟ᵝ
おいつく	o̞it͡sɨᵝkɯ̟ᵝ
おうけ	o̞ːke̞
おおおおじおじ	oːoːod͡ʑiod͡ʑi
おおかみざ	o̞ːka̠mʲiza̠
おおざっぱ	o̞ːza̠p̚pa̠
おおめ	o̞ːme̞
おちつく	o̞t͡ɕit͡sɨᵝkɯ̟ᵝ
おっさん	o̞sːã̠ɴ
おつかれ	o̞t͡sɨᵝka̠ɾe̞
おとす	o̞to̞sɨᵝ
おとひめ	o̞to̞çime̞
おとる	o̞to̞ɾɯ̟ᵝ
おね	o̞ne̞
おねえさん	o̞ne̞ːsã̠ɴ
おも	a̠ɾɯ̟ᵝʑi
おもいまどう	o̞mo̞ima̠do̞ː
おもう	o̞mo̞ɯ̟ᵝ
おやじ	o̞ja̠ʑi
おんいん	õ̞ɰ̃ĩɴ
かいおん	ka̠iõ̞ɴ
かいかく	ka̠ika̠kɯ̟ᵝ
かいがんせん	ka̠iɡã̠ɰ̃sẽ̞ɴ
かいし	ka̠iɕi
かいじ	ka̠iʑi
かいせい	ka̠ise̞ː
かいてんずし	ka̠itẽ̞nd͡zɨᵝɕi
かいへん	ka̠ihẽ̞ɴ
かがくてき	ka̠ɡa̠kɯ̟̊ᵝte̞kʲi
かきゅうてき	ka̠kʲɨᵝːte̞kʲi
かぎっこ	ka̠ɡʲik̚ko̞
かくしょうたい	ka̠kɯ̟ᵝɕo̞ːta̠i
かくひつ	kakuçitsu
かざんがん	ka̠zã̠ŋɡã̠ɴ
かたくむじょう	ka̠ta̠kɯ̟ᵝmɯ̟ᵝʑo̞ː
かつひろ	ka̠t͡sɨᵝçiɾo̞
かつま	ka̠t͡sɨᵝma̠
かと	ka̠to̞
かなしばり	ka̠na̠ɕiba̠ɾʲi
かぶせる	ka̠bɯ̟ᵝse̞ɾɯ̟ᵝ
かようび	ka̠jo̞ːbʲi
かれる	ka̠ɾe̞ɾɯ̟ᵝ
かろうし	ka̠ɾo̞ːɕi
かわき	ka̠ɰᵝa̠kʲi
かわせみ	ka̠ɰᵝa̠se̞mʲi
かんけつ	kã̠ŋke̞t͡sɨᵝ
かんばしい	kã̠mba̠ɕii
かんり	kã̠nɾʲi
かんろ	kã̠nɾo̞
がくしゃ	ɡa̠kɯ̟ᵝɕa̠
がらんどう	ɡa̠ɾã̠ndo̞ː
きぐう	kʲiɡɯ̟ᵝː
きざし	kʲiza̠ɕi
きざむ	kʲiza̠mɯ̟ᵝ
きずいせん	kʲizɨᵝisẽ̞ɴ
きてい	kʲite̞ː
きてん	kʲitẽ̞ɴ
きぼう	kʲibo̞ː
きゅうけつき	kʲɨᵝːke̞t͡sɨ̥ᵝkʲi
きょうけんびょう	kʲo̞ːkẽ̞mbʲo̞ː
きょうだい	kʲo̞ːda̠i
きょうはくじょう	kʲo̞ːha̠kɯ̟ᵝʑo̞ː
きょうりょく	kʲo̞ːɾʲo̞kɯ̟ᵝ
きよ	kʲijo̞
きんせん	kʲĩɰ̃sẽ̞ɴ
きんてい	kʲĩnte̞ː
きんぱつ	kʲĩmpa̠t͡sɨᵝ
きんぴん	kʲĩmpʲĩɴ
ぎそく	ɡʲiso̞kɯ̟ᵝ
ぎったんばっこん	ɡʲit̚tã̠mba̠k̚kõ̞ɴ
ぎもんふ	ɡʲimõ̞ɰ̃ɸɯ̟ᵝ
ぎんかん	ɡʲĩŋkã̠ɴ
ぎんざめ	ɡʲĩnd͡za̠me̞
くうき	kɯ̟ᵝːkʲi
くうどう	kɯ̟ᵝːdo̞ː
くぎゅ	kɯ̟ᵝɡʲɨᵝ
くずしじ	kɯ̟ᵝzɨᵝɕiʑi
くちぶえ	kɯ̟ᵝt͡ɕibɯ̟ᵝe̞
くちぶり	kɯ̟ᵝt͡ɕibɯ̟ᵝɾʲi
くちよせ	kɯ̟ᵝt͡ɕijo̞se̞
くび	kɯ̟ᵝbʲi
くむ	kɯ̟ᵝmɯ̟ᵝ
くもん	kɯ̟ᵝmõ̞ɴ
くりかえし	kɯ̟ᵝɾʲika̠e̞ɕi
くるみわり	kɯ̟ᵝɾɯ̟ᵝmʲiɰᵝa̠ɾʲi
くろい	kɯ̟ᵝɾo̞i
くんどく	kɯ̟̃ᵝndo̞kɯ̟ᵝ
ぐうぞうすうはい	ɡɯ̟ᵝːzo̞ːsɨᵝːha̠i
ぐうているい	ɡɯ̟ᵝːte̞ːɾɯ̟ᵝi
ぐれん	ɡɯ̟ᵝɾẽ̞ɴ
けびいし	ke̞bʲiːɕi
けんさつ	kẽ̞ɰ̃sa̠t͡sɨᵝ
けんどう	kẽ̞ndo̞ː
げんし	ɡẽ̞ɰ̃ɕi
げんしょう	ɡẽ̞ɰ̃ɕo̞ː
げんそう	ɡẽ̞ɰ̃so̞ː
げんちご	ɡẽ̞ɲ̟t͡ɕiɡo̞
こうせつ	ko̞ːse̞t͡sɨᵝ
こうつうきかん	ko̞ːt͡sɨᵝːkʲikã̠ɴ
こうつごう	ko̞ːt͡sɨᵝɡo̞ː
こうていてき	ko̞ːte̞ːte̞kʲi
こくがん	ko̞kɯ̟ᵝɡã̠ɴ
こげる	ko̞ɡe̞ɾɯ̟ᵝ
こたま	ko̞da̠ma̠
こだいさんき	ko̞da̠isã̠ŋʲkʲi
こっきん	ko̞k̚ʲkʲĩɴ
こと	ko̞to̞
ことがら	ko̞to̞ɡa̠ɾa̠
ことわざ	ko̞to̞ɰᵝa̠za̠
こぼく	ko̞bo̞kɯ̟ᵝ
こぼね	ko̞bo̞ne̞
こんざい	kõ̞nd͡za̠i
ごうご	ɡo̞ːɡo̞
ごげん	ɡo̞ɡẽ̞ɴ
ごげんがく	ɡo̞ɡẽ̞ŋɡa̠kɯ̟ᵝ
ごしきひわ	ɡo̞ɕikʲiçiɰᵝa̠
ごぜん	ɡo̞zẽ̞ɴ
さいしゅうびん	sa̠iɕɨᵝːbʲĩɴ
さいでん	sa̠idẽ̞ɴ
さかえる	sa̠ka̠e̞ɾɯ̟ᵝ
さかさ	sa̠ka̠sa̠
さぎちょう	sa̠ɡʲit͡ɕo̞ː
さげもの	sa̠ɡe̞mo̞no̞
させん	sa̠sẽ̞ɴ
さつえい	sa̠t͡sɨᵝe̞ː
さようなら	sa̠jo̞ːna̠ɾa̠
さらいげつ	sa̠ɾa̠iɡe̞t͡sɨᵝ
さんえつ	sã̠ɰ̃e̞t͡sɨᵝ
さんがつ	sã̠ŋɡa̠t͡sɨᵝ
さんだつ	sã̠nda̠t͡sɨᵝ
ざつがく	d͡za̠t͡sɨᵝɡa̠kɯ̟ᵝ
ざら	d͡za̠ɾa̠
ざんねんかい	d͡zã̠nːẽ̞ŋka̠i
しきそう	ɕikʲiso̞ː
ししょ	ɕiɕo̞
しつおん	ɕit͡sɨᵝõ̞ɴ
しつごしょう	ɕit͡sɨᵝɡo̞ɕo̞ː
しつないゆうぎ	ɕit͡sɨᵝna̠ijɯ̟ᵝːɡʲi
しどう	ɕido̞ː
しにん	ɕiɲ̟ĩɴ
しぬ	ɕinɯ̟ᵝ
しゃかいじん	ɕa̠ka̠iʑĩɴ
しゅうしょう	ɕɨᵝːɕo̞ː
しゅっぺい	ɕɨᵝp̚pe̞ː
しょうこ	ɕo̞ːko̞
しょうみ	ɕo̞ːmʲi
しょくもつせんい	ɕo̞kɯ̟ᵝmo̞t͡sɨᵝsẽ̞ɰ̃i
しょけん	ɕo̞kẽ̞ɴ
しょちょう	ɕo̞t͡ɕo̞ː
しらさぎ	ɕiɾa̠sa̠ɡʲi
しらぬい	ɕiɾa̠nɯ̟ᵝi
しろたえ	ɕiɾo̞ta̠e̞
しんしん	ɕĩɰ̃ɕĩɴ
しんじたい	ɕĩɲ̟d͡ʑita̠i
しんじる	ɕĩɲ̟d͡ʑiɾɯ̟ᵝ
しんじんるい	ɕĩɲ̟d͡ʑĩnɾɯ̟ᵝi
しんちょう	ɕĩɲ̟t͡ɕo̞ː
しんぴつ	ɕĩmpʲit͡sɨᵝ
しんゆう	ɕĩɰ̃jɯ̟ᵝː
じがい	d͡ʑiɡa̠i
じきゅう	d͡ʑikʲɨᵝː
じさつ	d͡ʑisa̠t͡sɨᵝ
じひ	d͡ʑiçi
じゃり	d͡ʑa̠ɾʲi
じゅ	d͡ʑɨᵝ
じゅんしょく	d͡ʑɨ̃ᵝɰ̃ɕo̞kɯ̟ᵝ
じょうかく	d͡ʑo̞ːka̠kɯ̟ᵝ
じょうもん	d͡ʑo̞ːmõ̞ɴ
じょしりょう	d͡ʑo̞ɕiɾʲo̞ː
すいあげる	sɨᵝia̠ɡe̞ɾɯ̟ᵝ
すいさい	sɨᵝisa̠i
すいどう	sɨᵝido̞ː
すいもん	sɨᵝimõ̞ɴ
すえおそろしい	sɨᵝe̞o̞so̞ɾo̞ɕiː
すさのお	sɨ̥ᵝsa̠no̞o̞
すずらん	sɨᵝzɨᵝɾã̠ɴ
せいいっぱい	se̞ːip̚pa̠i
せいさく	se̞ːsa̠kɯ̟ᵝ
せいすう	se̞ːsɨᵝː
せいそうけん	se̞ːso̞ːkẽ̞ɴ
せいたいがく	se̞ːta̠iɡa̠kɯ̟ᵝ
せいぶつがく	se̞ːbɯ̟ᵝt͡sɨᵝɡa̠kɯ̟ᵝ
せきじゅん	se̞kʲiʑɨ̃ᵝɴ
せんめつ	sẽ̞mːe̞t͡sɨᵝ
ぜいじゃくせい	d͡ze̞ːʑa̠kɯ̟̊ᵝse̞ː
ぜひ	d͡ze̞çi
そうがんきょう	so̞ːɡã̠ŋʲkʲo̞ː
そけい	so̞ke̞ː
それる	so̞ɾe̞ɾɯ̟ᵝ
そんちょう	sõ̞ɲ̟t͡ɕo̞ː
ぞくせつ	d͡zo̞kɯ̟ᵝse̞t͡sɨᵝ
ぞくぞく	d͡zo̞kɯ̟ᵝzo̞kɯ̟ᵝ
ぞくへん	d͡zo̞kɯ̟̊ᵝhẽ̞ɴ
たいか	ta̠ika̠
たいぎゃくざい	ta̠iɡʲa̠kɯ̟ᵝza̠i
たいさく	ta̠isa̠kɯ̟ᵝ
たいりゅうけん	ta̠iɾʲɨᵝːkẽ̞ɴ
たおやめぶり	ta̠o̞ja̠me̞bɯ̟ᵝɾʲi
たおれる	ta̠o̞ɾe̞ɾɯ̟ᵝ
たかいびき	ta̠ka̠ibʲikʲi
たくわえる	ta̠kɯ̟ᵝɰᵝa̠e̞ɾɯ̟ᵝ
たけひろ	ta̠ke̞çiɾo̞
たけよし	ta̠ke̞jo̞ɕi
たちき	ta̠t͡ɕikʲi
たりる	ta̠ɾʲiɾɯ̟ᵝ
たんこん	tã̠ŋkõ̞ɴ
だいなし	da̠ina̠ɕi
だっきゃく	da̠k̚ʲkʲa̠kɯ̟ᵝ
だるい	da̠ɾɯ̟ᵝi
だんとうだい	dã̠nto̞ːda̠i
ちくふじん	t͡ɕikɯ̟ᵝɸɯ̟ᵝʑĩɴ
ちちおや	t͡ɕi̥t͡ɕio̞ja̠
ちちゅうかい	t͡ɕi̥t͡ɕɨᵝːka̠i
ちはやぶる	t͡ɕiha̠ja̠bɯ̟ᵝɾɯ̟ᵝ
ちゃき	t͡ɕa̠kʲi
ちゅうとん	t͡ɕɨᵝːtõ̞ɴ
ちょうこうせい	t͡ɕo̞ːko̞ːse̞ː
ちりゃく	t͡ɕiɾʲa̠kɯ̟ᵝ
ついきゅう	t͡sɨᵝikʲɨᵝː
ついらく	t͡sɨᵝiɾa̠kɯ̟ᵝ
つうこう	t͡sɨᵝːko̞ː
つるざ	t͡sɨᵝɾɯ̟ᵝza̠
ていしゃ	te̞ːɕa̠
ておけ	te̞o̞ke̞
てぎわ	te̞ɡʲiɰᵝa̠
てっこう	te̞k̚ko̞ː
てつこ	te̞t͡sɨᵝko̞
てつり	te̞t͡sɨᵝɾʲi
てぬぐい	te̞nɯ̟ᵝɡɯ̟ᵝi
てまめ	te̞ma̠me̞
てんきあめ	tẽ̞ŋʲkʲia̠me̞
てんさい	tẽ̞ɰ̃sa̠i
てんちょう	tẽ̞ɲ̟t͡ɕo̞ː
てんない	tẽ̞nːa̠i
でいりぐち	de̞ːɾʲiɡɯ̟ᵝt͡ɕi
できあがる	de̞kʲia̠ɡa̠ɾɯ̟ᵝ
でぶせん	de̞bɯ̟ᵝsẽ̞ɴ
でむかえる	de̞mɯ̟ᵝka̠e̞ɾɯ̟ᵝ
でん	dẽ̞ɴ
でんしょ	dẽ̞ɰ̃ɕo̞
とうや	to̞ːja̠
とおとうみ	to̞ːto̞ːmʲi
とくい	to̞kɯ̟ᵝi
とっとり	to̞t̚to̞ɾʲi
とっとりけん	to̞t̚to̞ɾʲikẽ̞ɴ
とても	to̞te̞mo̞
ととのう	to̞to̞no̞ɯ̟ᵝ
とにかく	to̞ɲ̟ika̠kɯ̟ᵝ
ともたか	to̞mo̞ta̠ka̠
とやまけん	to̞ja̠ma̠kẽ̞ɴ
どうせい	do̞ːse̞ː
どうとう	do̞ːto̞ː
どうぶつ	do̞ːbɯ̟ᵝt͡sɨᵝ
どくりょく	do̞kɯ̟ᵝɾʲo̞kɯ̟ᵝ
どさんこ	do̞sã̠ŋko̞
どてら	do̞te̞ɾa̠
どんたく	dõ̞nta̠kɯ̟ᵝ
ないくう	na̠ikɯ̟ᵝː
ないはんそく	na̠ihã̠ɰ̃so̞kɯ̟ᵝ
ないよう	na̠ijo̞ː
ながわずらい	na̠ɡa̠ɰᵝa̠zɨᵝɾa̠i
なさる	na̠sa̠ɾɯ̟ᵝ
なじむ	na̠ʑimɯ̟ᵝ
ななつ	na̠na̠t͡sɨᵝ
ななふし	na̠na̠ɸɯ̟̊ᵝɕi
なみだごえ	na̠mʲida̠ɡo̞e̞
なん	nã̠ɴ
なんきょう	nã̠ŋʲkʲo̞ː
なんにち	nã̠ɲ̟ɲ̟it͡ɕi
にえる	ɲ̟ie̞ɾɯ̟ᵝ
におどり	ɲ̟io̞do̞ɾʲi
にごり	ɲ̟iɡo̞ɾʲi
にまいがい	ɲ̟ima̠iɡa̠i
にょうどうきゅうせんえき	ɲ̟o̞ːdo̞ːkʲɨᵝːsẽ̞ɰ̃e̞kʲi
にわとこ	ɲ̟iɰᵝa̠to̞ko̞
ぬか	nɯ̟ᵝka̠
ねむろ	ne̞mɯ̟ᵝɾo̞
ねんぎょ	nẽ̞ŋʲɡʲo̞
ねんし	nẽ̞ɰ̃ɕi
ねんしゅつ	nẽ̞ɰ̃ɕɨᵝt͡sɨᵝ
ねんすう	nẽ̞ɰ̃sɨᵝː
のうど	no̞ːdo̞
のぞみうす	no̞zo̞mʲiɯ̟ᵝsɨᵝ
のっかる	no̞k̚ka̠ɾɯ̟ᵝ
はいだす	ha̠ida̠sɨᵝ
はき	ha̠kʲi
はさつおん	ha̠sa̠t͡sɨᵝõ̞ɴ
はじ	ha̠ʑi
はじまる	ha̠ʑima̠ɾɯ̟ᵝ
はじらう	ha̠ʑiɾa̠ɯ̟ᵝ
はちぶんぎざ	ha̠t͡ɕibɯ̟̃ᵝŋʲɡʲiza̠
はっけっきゅう	ha̠k̚ke̞k̚ʲkʲɨᵝː
はってん	ha̠t̚tẽ̞ɴ
はつ	ha̠t͡sɨᵝ
はやい	ha̠ja̠i
はんこ	hã̠ŋko̞
はんせん	hã̠ɰ̃sẽ̞ɴ
ばくえき	ba̠kɯ̟ᵝe̞kʲi
ばらはた	ba̠ɾa̠ha̠ta̠
ばらまく	ba̠ɾa̠ma̠kɯ̟ᵝ
ばんじ	bã̠ɲ̟d͡ʑi
ひげくじら	çiɡe̞kɯ̟ᵝʑiɾa̠
ひぞう	çizoː
ひといき	çito̞ikʲi
ひとめ	çito̞me̞
ひなが	çina̠ɡa̠
ひのき	çino̞kʲi̥
ひひ	çi̥çi
ひんちゃ	çĩɲ̟t͡ɕa̠
びゃくだんこう	bʲa̠kɯ̟ᵝdã̠ŋko̞ː
びゃくだんゆ	bʲa̠kɯ̟ᵝdã̠ɰ̃jɯ̟ᵝ
びよう	bʲijo̞ː
びんなん	bʲĩnːã̠ɴ
ふかちろん	ɸɯ̟̊ᵝka̠t͡ɕiɾõ̞ɴ
ふくそすう	ɸɯ̟̊ᵝkɯ̟ᵝso̞sɨᵝː
ふくめん	ɸɯ̟ᵝkɯ̟ᵝmẽ̞ɴ
ふだらく	ɸɯ̟ᵝda̠ɾa̠kɯ̟ᵝ
ふだん	ɸɯ̟ᵝdã̠ɴ
ふなよい	ɸɯ̟ᵝna̠jo̞i
ふのう	ɸɯ̟ᵝno̞ː
ふみかためる	ɸɯ̟ᵝmʲika̠ta̠me̞ɾɯ̟ᵝ
ぶたねつ	bɯ̟ᵝta̠ne̞t͡sɨᵝ
ぶっけん	bɯ̟ᵝk̚kẽ̞ɴ
ぶんかい	bɯ̟̃ᵝŋka̠i
ぶんべんだい	bɯ̟̃ᵝmbẽ̞nda̠i
へいか	he̞ːka̠
へいこう	he̞ːko̞ː
へちま	he̞t͡ɕima̠
へんしゅう	hẽ̞ɰ̃ɕɨᵝː
べいふん	be̞ːɸɯ̟̃ᵝɴ
ほうちょう	ho̞ːt͡ɕo̞ː
ほごしゃ	ho̞ɡo̞ɕa̠
ほろう	ho̞ɾo̞ː
ほんぐ	honɡu
ほんじつ	hõ̞ɲ̟d͡ʑit͡sɨᵝ
ぼうふら	bo̞ːɸɯ̟ᵝɾa̠
ぼうよみ	bo̞ːjo̞mʲi
ぼんさい	bõ̞ɰ̃sa̠i
ぽつり	po̞t͡sɨᵝɾʲi
まいすう	ma̠isɨᵝː
まさのり	ma̠sa̠no̞ɾʲi
まざる	ma̠za̠ɾɯ̟ᵝ
まずしい	ma̠zɨᵝɕiː
まっしょうめん	ma̠ɕːo̞ːmẽ̞ɴ
まっとう	ma̠t̚to̞ː
まるた	ma̠ɾɯ̟ᵝta̠
まんこ	mã̠ŋko̞
みかける	mʲika̠ke̞ɾɯ̟ᵝ
みずたまり	mʲizɨᵝta̠ma̠ɾʲi
みちお	mʲit͡ɕio̞
みのがす	mʲino̞ɡa̠sɨᵝ
みやぶ	mʲija̠bɯ̟ᵝ
みわこ	mʲiɰᵝa̠ko̞
むごい	mɯ̟ᵝɡo̞i
むすい	mɯ̟ᵝsɨᵝi
むはい	mɯ̟ᵝha̠i
もうきんるい	mo̞ːkʲĩnɾɯ̟ᵝi
もうしあげる	mo̞ːɕia̠ɡe̞ɾɯ̟ᵝ
もうしわけ	mo̞ːɕiɰᵝa̠ke̞
もうそう	mo̞ːso̞ː
もぎとる	mo̞ɡʲito̞ɾɯ̟ᵝ
もくろみ	mo̞kɯ̟ᵝɾo̞mʲi
もくろむ	mo̞kɯ̟ᵝɾo̞mɯ̟ᵝ
もじどおり	mo̞ʑido̞ːɾʲi
もったいない	mo̞t̚ta̠ina̠i
ものごし	mo̞no̞ɡo̞ɕi
やかん	ja̠kã̠ɴ
やくご	ja̠kɯ̟ᵝɡo̞
やくざ	ja̠kɯ̟ᵝza̠
やぶさめ	jabusame
やわらぐ	ja̠ɰᵝa̠ɾa̠ɡɯ̟ᵝ
ゆうれつ	jɯ̟ᵝːɾe̞t͡sɨᵝ
ゆれる	jɯ̟ᵝɾe̞ɾɯ̟ᵝ
ようおん	jo̞ːõ̞ɴ
ようかい	jo̞ːka̠i
よこはば	jo̞ko̞ha̠ba̠
よしたか	jo̞ɕita̠ka̠
よは	jo̞ha̠
よふかし	jo̞ɸɯ̟ᵝka̠ɕi
よみきり	jo̞mʲikʲiɾʲi
よりみち	jo̞ɾʲimʲit͡ɕi
らんちゅう	ɾã̠ɲ̟t͡ɕɨᵝː
らんぼう	ɾã̠mbo̞ː
りっきょう	ɾʲik̚ʲkʲo̞ː
りにゅう	ɾʲiɲ̟ɯ̟ᵝː
りゅうこつ	ɾʲɨᵝːko̞t͡sɨᵝ
りょうけんざ	ɾʲo̞ːkẽ̞nd͡za̠
りょくぶ	ɾʲo̞kɯ̟ᵝbɯ̟ᵝ
れいがい	ɾe̞ːɡa̠i
れんおん	ɾẽ̞ɰ̃õ̞ɴ
れんしゅく	ɾẽ̞ɰ̃ɕɨᵝkɯ̟ᵝ
れんたいし	ɾẽ̞nta̠iɕi
ろうどうしゃ	ɾo̞ːdo̞ːɕa̠
ろくろくび	rokurokubi
ろせい	ɾo̞se̞ː
ろわ	ɾo̞ɰᵝa̠
わくせん	ɰᵝa̠kɯ̟ᵝsẽ̞ɴ
わけあたえる	ɰᵝa̠ke̞a̠ta̠e̞ɾɯ̟ᵝ
わりびく	ɰᵝa̠ɾʲibʲikɯ̟ᵝ
