te	tˈe
i	ˈi
o	ˈɔ
ki	kˈi
ngā	ŋˈaː
e	ˈe
ka	kˈa
a	ˈa
me	mˈe
ana	ˈana
he	hˈe
nga	ŋˈa
Te	tˈe
ko	kˈɔ
mai	mˈa͡ɪ
Ko	kˈɔ
atu	ˈatu"
Ka	kˈa
He	hˈe
ai	ˈa͡ɪ
hei	hˈei
mō	mˈɔː
Māori	maːˈɔri
kia	kˈia
ia	ˈia
I	ˈi
mahi	mˈahi
hoki	hˈɔki
nei	nˈei
tau	tˈau"
tēnei	teːnˈei
tētahi	teːtˈahi
E	ˈe
roto	rˈɔtɔ
mea	mˈea
ake	ˈake
kei	kˈei
kua	kˈu"a
kōrero	kˈɔːrerˌɔ
ā	ˈaː
anō	ˈanɔː
nui	nˈu"i
reo	rˈeɔ
haere	hˈa͡ɪre
tangata	taŋˈata
ētahi	eːtˈahi
tonu	tˈɔnu"
mo	mˈɔ
katoa	katˈɔa
mā	mˈaː
rātou	raːtˈou"
whai	fˈa͡ɪ
iwi	ˈiwi
noho	nˈɔhɔ
koe	kwˈe
runga	rˈu"ŋa
Kei	kˈei
tō	tˈɔː
rānei	raːnˈei
whenua	fenˈu"a
to	tˈɔ
noa	nˈɔa
ākonga	aːkˈɔŋa
wā	wˈaː
kaupapa	kˌau"pˈapa
whare	fˈare
tana	tˈana
tino	tˈinɔ
pai	pˈa͡ɪ
Aotearoa	ˌa͡ʊtearˈɔa
rā	rˈaː
take	tˈake
Ngā	ŋˈaː
tenei	tenˈei
aha	ˈaha
ra	rˈa
taua	taˈu"a
toa	tˈɔa
taea	tˈa͡ɪa
tōna	tˈɔːna
kura	kˈu"ra
kai	kˈa͡ɪ
tae	tˈa͡ɪ
rawa	rˈawa
rua	rˈu"a
Kua	kˈu"a
kore	kˈɔre
whakaaro	fˌakaˈarɔ
mate	mˈate
puta	pˈu"ta
tamariki	tˌamarˈiki
tikanga	tikˈaŋa
ēnei	eːnˈei
reira	reˈira
wāhi	wˈaːhi
taku	tˈaku"
wai	wˈa͡ɪ
iho	ˈihɔ
pukapuka	pˌu"kapˈu"ka
ano	ˈanɔ
au	ˈau"
ao	ˈa͡ʊ
T	t
waka	wˈaka
tā	tˈaː
kitea	kitˈea
tetahi	tetˈahi
kupu	kˈu"pu"
momo	mˈɔmɔ
muri	mˈu"ri
Me	mˈe
ako	ˈakɔ
mua	mˈu"a
taha	tˈaha
whakaatu	fˌakaˈatu"
whānau	faːnˈau"
tika	tˈika
korero	kɔrˈerɔ
tahi	tˈahi
nā	nˈaː
tauira	tˌau"ˈira
nō	nˈɔː
kaha	kˈaha
tohu	tˈɔhu"
pā	pˈaː
M	m
matua	matˈu"a
of	ˈɔ (͡e͡n)ˈɛf(͡m͡i)
āhua	aːhˈu"a
Kia	kˈia
ratou	ratˈou"
kāore	kaːˈɔre
pea	pˈea
engari	eŋˈari
ōna	ˈɔːna
tuatahi	tˌu"atˈahi
kē	kˈeː
wāhanga	waːhˈaŋa
the	thˈe
Hei	hˈei
hua	hˈu"a
ingoa	iŋˈɔa
maha	mˈaha
nama	nˈama
hou	hˈou"
raro	rˈarɔ
hunga	hˈu"ŋa
ō	ˈɔː
mana	mˈana
roa	rˈɔa
tēnā	tˈeːnaː
Mātauranga	mˌaːtau"rˈaŋa
āhuatanga	ˌaːhu"atˈaŋa
Nā	nˈaː
Ki	kˈi
kaiwhakahaere	kˌa͡ɪfakahˈa͡ɪre
mōhio	mɔːhˈiɔ
tū	tˈu"ː
hanga	hˈaŋa
rōpū	rˈɔːpu"ː
ahau	ahˈau"
koutou	kˌou"tˈou"
wa	wˈa
waiata	wa͡ɪˈata
tuku	tˈu"ku"
tērā	tˈeːraː
tona	tˈɔna
kotahi	kɔtˈahi
taki	tˈaki
mau	mˈau"
mātou	maːtˈou"
Ngati	ŋˈati
na	nˈa
utu	ˈu"tu"
hiahia	hˌiahˈia
rārangi	raːrˈaŋi
tautoko	tˌau"tˈɔkɔ
arā	ˈaraː
rauemi	rˌau"ˈemi
Mā	mˈaː
hāngai	hˈaːŋa͡ɪ
tāngata	taːŋˈata
wahine	wahˈine
Kete	kˈete
ara	ˈara
Nō	nˈɔː
Rauemi	rˌau"ˈemi
kōwhiringa	kˌɔːfirˈiŋa
kaore	kˈa͡ʊre
huarahi	hˌu"arˈahi
Ipurangi	ˌipu"rˈaŋi
whakamahi	fˌakamˈahi
toru	tˈɔru"
Reo	rˈeɔ
Kāore	kaːˈɔre
kite	kˈite
tekau	tekˈau"
ma	mˈa
Ngāti	ŋˈaːti
Kohinga	kɔhˈiŋa
aua	aˈu"a
Maori	mˈa͡ʊri
whakaahua	fˌakaahˈu"a
iti	ˈiti
hoa	hˈɔa
rāua	raːˈu"a
ta	tˈa
rangatira	rˌaŋatˈira
taonga	tˈa͡ʊŋa
tātou	taːtˈou"
rohe	rˈɔhe
Iwi	ˈiwi
New	nˈew
whakahaere	fˌakahˈa͡ɪre
rere	rˈere
marama	marˈama
āta	ˈaːta
Kura	kˈu"ra
etahi	etˈahi
Na	nˈa
moana	mɔˈana
ture	tˈu"re
ora	ˈɔra
nuinga	nu"ˈiŋa
konei	kɔnˈei
rite	rˈite
matou	matˈou"
tata	tˈata
no	nˈɔ
Makino	makˈinɔ
rau	rˈau"
and	ˈa n (͡e͡n)dˈiː(͡m͡i)
Tiriti	tirˈiti
rātau	raːtˈau"
pānui	paːnˈu"i
tini	tˈini
Zealand	(͡e͡n)zˈɛd(͡m͡i) ˈe ˈa (͡e͡n)ˈɛl(͡m͡i) ˈa n (͡e͡n)dˈiː(͡m͡i)
whakamārama	fˌakamaːrˈama
taumata	tˌau"mˈata
mutu	mˈu"tu"
papa	pˈapa
pērā	pˈeːraː
whānui	faːnˈu"i
tuhi	tˈu"hi
kāinga	kaːˈiŋa
Pākehā	paːkˈehaː
tamaiti	tamˈa͡ɪti
or	ˈɔr
anake	anˈake
tuhinga	tu"hˈiŋa
tipu	tˈipu"
manu	mˈanu"
raua	raˈu"a
hapori	hapˈɔri
titiro	titˈirɔ
ika	ˈika
pa	pˈa
Ehara	ehˈara
Kōrero	kˈɔːrerˌɔ
huri	hˈu"ri
hui	hˈu"i
āwhina	aːfˈina
Kātahi	kaːtˈahi
Nau	nˈau"
marae	mˈara͡ɪ
mātauranga	mˌaːtau"rˈaŋa
kino	kˈinɔ
rapu	rˈapu"
whakarite	fˌakarˈite
rongo	rˈɔŋɔ
view	(͡e͡n)vˈiː(͡m͡i) ˈi ˈe w
kī	kˈiː
āna	ˈaːna
Hoki	hˈɔki
motu	mˈɔtu"
pouako	pˌou"ˈakɔ
rangi	rˈaŋi
tono	tˈɔnɔ
TKI	tkˈi
pātai	pˈaːta͡ɪ
rerekē	rerˈekeː
kainga	kˈa͡ɪŋa
kaiako	ka͡ɪˈakɔ
whakamahia	fˌakamahˈia
Engari	eŋˈari
waho	wˈahɔ
heke	hˈeke
uru	ˈu"ru"
wahi	wˈahi
rahi	rˈahi
tatou	tatˈou"
pēhea	peːhˈea
tinana	tinˈana
Tai	tˈa͡ɪ
oti	ˈɔti
whakatau	fˌakatˈau"
ngaro	ŋˈarɔ
pōti	pˈɔːti
ahakoa	ˌahakˈɔa
hau	hˈau"
rangahau	rˌaŋahˈau"
tukuna	tu"kˈu"na
piki	pˈiki
kaimahi	ka͡ɪmˈahi
pae	pˈa͡ɪ
tohunga	tɔhˈu"ŋa
Whare	fˈare
rākau	raːkˈau"
tuarua	tˌu"arˈu"a
tīmata	tiːmˈata
ranei	ranˈei
putanga	pu"tˈaŋa
whiwhi	fˈifi
moni	mˈɔni
ahi	ˈahi
tera	tˈera
tāna	tˈaːna
ata	ˈata
wātea	waːtˈea
akoranga	ˌakɔrˈaŋa
tere	tˈere
Ahakoa	ˌahakˈɔa
wiki	wˈiki
pēnei	peːnˈei
awa	ˈawa
kāwanatanga	kˌaːwanatˈaŋa
waenganui	wˌa͡ɪŋanˈu"i
Waitangi	wa͡ɪtˈaŋi
enable	ˈe n ˈa (͡e͡n)bˈiː ˈɛl(͡m͡i) ˈe
enei	enˈei
mohio	mɔhˈiɔ
ērā	ˈeːraː
mihi	mˈihi
tu	tˈu"
whārangi	faːrˈaŋi
Heoi	hˈeo͡ɪ
hoko	hˈɔkɔ
pakeke	pakˈeke
ona	ˈɔna
toi	tˈo͡ɪ
rima	rˈima
hononga	hɔnˈɔŋa
riro	rˈirɔ
pānga	pˈaːŋa
pakanga	pakˈaŋa
ōrau	ɔːrˈau"
motuhake	mˌɔtu"hˈake
whā	fˈaː
eke	ˈeke
kau	kˈau"
kātahi	kaːtˈahi
ōrite	ɔːrˈite
tiaki	tiˈaki
hia	hˈia
taiao	tˈa͡ɪa͡ʊ
whāinga	faːˈiŋa
mārama	maːrˈama
ringa	rˈiŋa
aroha	arˈɔha
neke	nˈeke
whakaae	fakˈaa͡ɪ
Mēnā	mˈeːnaː
waahi	waˈahi
your	(͡e͡n)wˈa͡ɪ(͡m͡i) ˈɔ ˈu" r
Koia	kˈo͡ɪa
raruraru	ɹˈaɹuɹˌaɹu
haka	hˈaka
oranga	ɔrˈaŋa
hauora	hˌau"ˈɔra
mahere	mahˈere
karakia	kˌarakˈia
pūrākau	pˌu"ːraːkˈau"
tirohia	tˌirɔhˈia
uri	ˈu"ri
tena	tˈena
ngä	ŋˈa
rautaki	rˌau"tˈaki
whanau	fanˈau"
kawe	kˈawe
Kaore	kˈa͡ʊre
tuhia	tu"hˈia
koia	kˈo͡ɪa
Tuhia	tu"hˈia
Katahi	katˈahi
māmā	mˈaːmaː
patu	pˈatu"
whakautu	fˌakaˈu"tu"
whakarongo	fˌakarˈɔŋɔ
mutunga	mu"tˈu"ŋa
aku	ˈaku"
aro	ˈarɔ
kapa	kˈapa
huanga	hu"ˈaŋa
mēnā	mˈeːnaː
Tokerau	tˌɔkerˈau"
Plan	p (͡e͡n)ˈɛl(͡m͡i) ˈa n
Summary	(͡e͡n)ˈɛs(͡m͡i) ˈu" m m ˈa r (͡e͡n)wˈa͡ɪ(͡m͡i)
Waikato	wa͡ɪkˈatɔ
Week	wˈeek
Authority	ˈa ˈu" t h ˈɔ r ˈi t (͡e͡n)wˈa͡ɪ(͡m͡i)
Search	(͡e͡n)ˈɛs(͡m͡i) ˈe ˈa r (͡e͡n)sˈiː(͡m͡i) h
pirihimana	pˌirihimˈana
tirotiro	tˌirɔtˈirɔ
Mākino	maːkˈinɔ
profile	p r ˈɔ (͡e͡n)ˈɛf(͡m͡i) ˈi (͡e͡n)ˈɛl(͡m͡i) ˈe
A	ˈa
AuthorityStrategic	ˈa ˈu" t h ˈɔ r ˈi t (͡e͡n)wˈa͡ɪ ˈɛs(͡m͡i) t r ˈa t ˈe (͡e͡n)d͡ʒˈiː(͡m͡i) ˈi (͡e͡n)sˈiː(͡m͡i)
akomanga	ˌakɔmˈaŋa
edit	ˈe (͡e͡n)dˈiː(͡m͡i) ˈi t
tangi	tˈaŋi
ina	ˈina
rerenga	rerˈeŋa
ahua	ahˈu"a
EVENTSLogin	ˈe (͡e͡n)vˈiː(͡m͡i) ˈe n t (͡e͡n)ˈɛs ˈɛl(͡m͡i) ˈɔ (͡e͡n)d͡ʒˈiː(͡m͡i) ˈi n
tohutohu	tˌɔhu"tˈɔhu"
waahanga	wˌaahˈaŋa
whakataetae	fˌakatˈa͡ɪta͡ɪ
hōtaka	hɔːtˈaka
No	nˈɔ
pūrongo	pu"ːrˈɔŋɔ
whakauru	fˌakaˈu"ru"
ratonga	ratˈɔŋa
by	(͡e͡n)bˈiː wˈa͡ɪ(͡m͡i)
mātua	maːtˈu"a
wairua	wa͡ɪrˈu"a
kīia	kiːˈia
tētehi	teːtˈehi
Kaupapa	kˌau"pˈapa
uaua	ˌu"aˈu"a
hea	hˈea
tama	tˈama
Tau	tˈau"
whakaputa	fˌakapˈu"ta
waihanga	wa͡ɪhˈaŋa
kaua	kaˈu"a
pū	pˈu"ː
whakaako	fˌakaˈakɔ
kimi	kˈimi
karanga	karˈaŋa
rakau	rakˈau"
Mai	mˈa͡ɪ
tango	tˈaŋɔ
Niu	nˈiu"
riri	rˈiri
waenga	wˈa͡ɪŋa
mahinga	mahˈiŋa
Ao	ˈa͡ʊ
raupapa	rˌau"pˈapa
ke	kˈe
hangaia	haŋˈa͡ɪa
maunga	maˈu"ŋa
āhei	aːhˈei
Ture	tˈu"re
whakawhiti	fˌakafˈiti
Matua	matˈu"a
whakaritea	fˌakaritˈea
Whenua	fenˈu"a
ope	ˈɔpe
pepa	pˈepa
painga	pˈa͡ɪŋa
atua	atˈu"a
tirohanga	tˌirɔhˈaŋa
whawhai	fˈafa͡ɪ
whakanui	fˌakanˈu"i
whakaaturanga	fˌakaˌatu"rˈaŋa
To	tˈɔ
takoto	takˈɔtɔ
tukutuku	tˌu"ku"tˈu"ku"
takiwā	takˈiwaː
poto	pˈɔtɔ
whakaaturia	fˌakaˌatu"rˈia
haerenga	ha͡ɪrˈeŋa
wānanga	waːnˈaŋa
moe	mwˈe
whiriwhiri	fˌirifˈiri
Mō	mˈɔː
po	pˈɔ
mata	mˈata
mema	mˈema
Tari	tˈari
whakapono	fˌakapˈɔnɔ
kanohi	kanˈɔhi
huinga	hu"ˈiŋa
waiho	wˈa͡ɪhɔ
whakamutunga	fˌakamu"tˈu"ŋa
Marautanga	mˌarau"tˈaŋa
raraunga	rˌaraˈu"ŋa
Nga	ŋˈa
awhina	afˈina
whakaari	fˌakaˈari
pou	pˈou"
pupuri	pu"pˈu"ri
mahia	mahˈia
mehemea	mˌehemˈea
ono	ˈɔnɔ
The	thˈe
pikitia	pˌikitˈia
pūkenga	pu"ːkˈeŋa
tupu	tˈu"pu"
whakaoti	fakˈa͡ʊti
Arā	ˈaraː
tua	tˈu"a
tatau	tatˈau"
tawhiti	tafˈiti
whakaritenga	fˌakaritˈeŋa
here	hˈere
kii	kˈii
tukua	tu"kˈu"a
Haere	hˈa͡ɪre
in	ˈin
tūtohu	tu"ːtˈɔhu"
Karauna	kˌaraˈu"na
hono	hˈɔnɔ
Kāwanatanga	kˌaːwanatˈaŋa
taitara	ta͡ɪtˈara
Ingarangi	ˌiŋarˈaŋi
mātau	maːtˈau"
hoatu	hɔˈatu"
tai	tˈa͡ɪ
ahu	ˈahu"
hangarau	hˌaŋarˈau"
ipurangi	ˌipu"rˈaŋi
Society	(͡e͡n)ˈɛs(͡m͡i) ˈɔ (͡e͡n)sˈiː(͡m͡i) ˈi ˈe t (͡e͡n)wˈa͡ɪ(͡m͡i)
kā	kˈaː
tukanga	tu"kˈaŋa
Education	ˈe (͡e͡n)dˈiː(͡m͡i) ˈu" (͡e͡n)sˈiː(͡m͡i) ˈa t ˈi ˈɔ n
whakatakoto	fˌakatakˈɔtɔ
Tautoko	tˌau"tˈɔkɔ
mano	mˈanɔ
hapū	hˈapu"ː
W	w
marautanga	mˌarau"tˈaŋa
Tirohia	tˌirɔhˈia
ataata	ˌataˈata
aromatawai	ˌarɔmatˈawa͡ɪ
ārahi	aːrˈahi
audio	ˈa ˈu" (͡e͡n)dˈiː(͡m͡i) ˈi ˈɔ
kōwae	kˈɔːwa͡ɪ
haumaru	hˌau"mˈaru"
ahiahi	ˌahiˈahi
Kaunihera	kˌau"nihˈera
pakihi	pakˈihi
tuhituhi	tˌu"hitˈu"hi
Tireni	tirˈeni
ehara	ehˈara
whakaata	fˌakaˈata
click	(͡e͡n)sˈiː ˈɛl(͡m͡i) ˈi (͡e͡n)sˈiː(͡m͡i) k
file	(͡e͡n)ˈɛf(͡m͡i) ˈi (͡e͡n)ˈɛl(͡m͡i) ˈe
javascript	(͡e͡n)d͡ʒˈe͡ɪ(͡m͡i) ˈa (͡e͡n)vˈiː(͡m͡i) ˈa (͡e͡n)ˈɛs sˈiː(͡m͡i) r ˈi p t
listen	(͡e͡n)ˈɛl(͡m͡i) ˈi (͡e͡n)ˈɛs(͡m͡i) t ˈe n
Ara	ˈara
Koinei	ko͡ɪnˈei
Tuatahi	tˌu"atˈahi
pūtea	pu"ːtˈea
waewae	wˈa͡ɪwa͡ɪ
tapu	tˈapu"
toku	tˈɔku"
āu	ˈaːu"
pō	pˈɔː
Papa	pˈapa
kauwhata	kˌau"fˈata
Language	(͡e͡n)ˈɛl(͡m͡i) ˈa n (͡e͡n)d͡ʒˈiː(͡m͡i) ˈu" ˈa (͡e͡n)d͡ʒˈiː(͡m͡i) ˈe
Tauranga	tˌau"rˈaŋa
taputapu	tˌapu"tˈapu"
Sandspit	(͡e͡n)ˈɛs(͡m͡i) ˈa n (͡e͡n)dˈiː ˈɛs(͡m͡i) p ˈi t
mōhiotia	mˌɔːhiɔtˈia
tangohia	tˌaŋɔhˈia
tīmatanga	tˌiːmatˈaŋa
ahurea	ˌahu"rˈea
hinga	hˈiŋa
whakapapa	fˌakapˈapa
matau	matˈau"
ii	ˈii
taone	tˈa͡ʊne
Protection	p r ˈɔ t ˈe (͡e͡n)sˈiː(͡m͡i) t ˈi ˈɔ n
Wānanga	waːnˈaŋa
uta	ˈu"ta
Taumata	tˌau"mˈata
rīpene	riːpˈene
waea	wˈa͡ɪa
Taki	tˈaki
whakairo	fakˈa͡ɪrɔ
waru	wˈaru"
taka	tˈaka
tapaina	tapˈa͡ɪna
tāpiri	taːpˈiri
tōku	tˈɔːku"
ārai	ˈaːra͡ɪ
Archives	ˈa r (͡e͡n)sˈiː(͡m͡i) h ˈi (͡e͡n)vˈiː(͡m͡i) ˈe (͡e͡n)ˈɛs(͡m͡i)
Rangi	rˈaŋi
koa	kˈɔa
timata	timˈata
tūranga	tu"ːrˈaŋa
katahi	katˈahi
Ina	ˈina
Māui	maːˈu"i
Rōpū	rˈɔːpu"ː
Anei	anˈei
for	(͡e͡n)ˈɛf(͡m͡i) ˈɔ r
tutuki	tu"tˈu"ki
ratau	ratˈau"
tawhito	tafˈitɔ
Mehemea	mˌehemˈea
tākaro	taːkˈarɔ
Tērā	tˈeːraː
arotake	ˌarɔtˈake
mōhiohio	mˌɔːhiɔhˈiɔ
whakaaetia	fˌakaa͡ɪtˈia
S	(͡e͡n)ˈɛs(͡m͡i)
Ngāi	ŋˈaːi
horopaki	hˌɔrɔpˈaki
pūnaha	pu"ːnˈaha
whakamahinga	fˌakamahˈiŋa
Pāremata	pˌaːremˈata
kararehe	kˌararˈehe
kāri	kˈaːri
Kotahi	kɔtˈahi
Matariki	mˌatarˈiki
niho	nˈihɔ
uara	u"ˈara
hiahiatia	hˌiahˌiatˈia
kiri	kˈiri
pouaka	pˌou"ˈaka
wehe	wˈehe
Ma	mˈa
ngahere	ŋahˈere
pito	pˈitɔ
tokomaha	tˌɔkɔmˈaha
tūturu	tu"ːtˈu"ru"
JavaScript	(͡e͡n)d͡ʒˈe͡ɪ(͡m͡i) ˈa (͡e͡n)vˈiː(͡m͡i) ˈa (͡e͡n)ˈɛs sˈiː(͡m͡i) r ˈi p t
Rau	rˈau"
Taranaki	tˌaranˈaki
Toi	tˈo͡ɪ
taenga	tˈa͡ɪŋa
whakatūria	fˌakatu"ːrˈia
Tohu	tˈɔhu"
kawea	kawˈea
mahara	mahˈara
Please	p (͡e͡n)ˈɛl(͡m͡i) ˈe ˈa (͡e͡n)ˈɛs(͡m͡i) ˈe
kohinga	kɔhˈiŋa
tūhura	tu"ːhˈu"ra
Manu	mˈanu"
Tahu	tˈahu"
miriona	mˌiriˈɔna
tapawhā	tapˈafaː
Rauparaha	rˌau"parˈaha
taketake	tˌaketˈake
tohua	tɔhˈu"a
paetukutuku	pˌa͡ɪtu"ku"tˈu"ku"
Disqus	(͡e͡n)dˈiː(͡m͡i) ˈi (͡e͡n)ˈɛs kjˈuː(͡m͡i) ˈu" (͡e͡n)ˈɛs(͡m͡i)
Pūtaiao	pu"ːtˈa͡ɪa͡ʊ
comments	(͡e͡n)sˈiː(͡m͡i) ˈɔ m m ˈe n t (͡e͡n)ˈɛs(͡m͡i)
powered	p ˈɔ w ˈe r ˈe (͡e͡n)dˈiː(͡m͡i)
tūmatanui	tˌu"ːmatanˈu"i
ua	ˈu"a
Pirihimana	pˌirihimˈana
hokohoko	hˌɔkɔhˈɔkɔ
rorohiko	rˌɔrɔhˈikɔ
hāpai	hˈaːpa͡ɪ
ngākau	ŋaːkˈau"
whakatutuki	fˌakatu"tˈu"ki
pūtake	pu"ːtˈake
tātai	tˈaːta͡ɪ
puna	pˈu"na
whakawhanake	fˌakafanˈake
nana	nˈana
tāne	tˈaːne
Pakeha	pakˈeha
kiia	kiˈia
whakapakari	fˌakapakˈari
whakatū	fakˈatu"ː
tari	tˈari
whiti	fˈiti
tokorua	tˌɔkɔrˈu"a
Kōhanga	kɔːhˈaŋa
tonga	tˈɔŋa
navigation	n ˈa (͡e͡n)vˈiː(͡m͡i) ˈi (͡e͡n)d͡ʒˈiː(͡m͡i) ˈa t ˈi ˈɔ n
aronga	arˈɔŋa
Mr	mr
hinengaro	hˌineŋˈarɔ
nāna	nˈaːna
Tuarua	tˌu"arˈu"a
anga	ˈaŋa
pārongo	paːrˈɔŋɔ
Ahitereiria	ˌahitˌereirˈia
aho	ˈahɔ
whitu	fˈitu"
kōhanga	kɔːhˈaŋa
poari	pɔˈari
tipuna	tipˈu"na
kaitiaki	kˌa͡ɪtiˈaki
waha	wˈaha
whakarato	fˌakarˈatɔ
Rua	rˈu"a
wera	wˈera
hōia	hɔːˈia
parekura	pˌarekˈu"ra
teitei	tˌeitˈei
hoahoa	hˌɔahˈɔa
Toa	tˈɔa
pau	pˈau"
tiki	tˈiki
kamupene	kˌamu"pˈene
mokopuna	mˌɔkɔpˈu"na
pokapū	pɔkˈapu"ː
Mahi	mˈahi
putea	pu"tˈea
hapu	hˈapu"
ngohe	ŋˈɔhe
tuatoru	tˌu"atˈɔru"
Ingarihi	ˌiŋarˈihi
ngakau	ŋakˈau"
Atua	atˈu"a
whakamua	fˌakamˈu"a
whāia	faːˈia
Minita	minˈita
puoro	pu"ˈɔrɔ
Waiata	wa͡ɪˈata
kaitohutohu	kˌa͡ɪtɔhu"tˈɔhu"
māori	maːˈɔri
pakari	pakˈari
pāngarau	pˌaːŋarˈau"
rapanga	rapˈaŋa
takitahi	tˌakitˈahi
tuakana	tˌu"akˈana
ui	ˈu"i
katoatia	kˌatɔatˈia
manaaki	mˌanaˈaki
puka	pˈu"ka
takirua	tˌakirˈu"a
otinga	ɔtˈiŋa
hara	hˈara
pūtaiao	pu"ːtˈa͡ɪa͡ʊ
tahuri	tahˈu"ri
tāone	taːˈɔne
ngaru	ŋˈaru"
rongonui	rˌɔŋɔnˈu"i
Kāinga	kaːˈiŋa
Catalogue	(͡e͡n)sˈiː(͡m͡i) ˈa t ˈa (͡e͡n)ˈɛl(͡m͡i) ˈɔ (͡e͡n)d͡ʒˈiː(͡m͡i) ˈu" ˈe
Kupu	kˈu"pu"
ināianei	ˌinaːˌianˈei
mita	mˈita
whakatairanga	fˌakata͡ɪrˈaŋa
Items	ˈi t ˈe m (͡e͡n)ˈɛs(͡m͡i)
hokona	hɔkˈɔna
kuia	ku"ˈia
tūmomo	tu"ːmˈɔmɔ
whakangungu	fˌakaŋˈu"ŋu"
Karaiti	karˈa͡ɪti
whakatika	fˌakatˈika
Kawanatanga	kˌawanatˈaŋa
Wharekura	fˌarekˈu"ra
tapa	tˈapa
kaunihera	kˌau"nihˈera
whaea	fˈa͡ɪa
Bay	(͡e͡n)bˈiː(͡m͡i) ˈa (͡e͡n)wˈa͡ɪ(͡m͡i)
Poari	pɔˈari
arotahi	ˌarɔtˈahi
hē	hˈeː
manuhiri	mˌanu"hˈiri
patua	patˈu"a
pupuhi	pu"pˈu"hi
waa	wˈaa
māna	mˈaːna
oro	ˈɔrɔ
Takiuru	tˌakiˈu"ru"
harakeke	hˌarakˈeke
rēhita	reːhˈita
whakahoki	fˌakahˈɔki
Rotorua	rˌɔtɔrˈu"a
ngaa	ŋˈaa
whakataunga	fˌakataˈu"ŋa
whenu	fˈenu"
Arawa	arˈawa
pakeha	pakˈeha
upoko	u"pˈɔkɔ
mahue	mahˈu"e
ngātahi	ŋaːtˈahi
tane	tˈane
J	(͡e͡n)d͡ʒˈe͡ɪ(͡m͡i)
Kaua	kaˈu"a
hopu	hˈɔpu"
hītori	hiːtˈɔri
whetū	fˈetu"ː
Pukapuka	pˌu"kapˈu"ka
huhua	hu"hˈu"a
matatau	mˌatatˈau"
pakaru	pakˈaru"
toro	tˈɔrɔ
ariā	arˈiaː
mōhiotanga	mˌɔːhiɔtˈaŋa
toka	tˈɔka
Rā	rˈaː
heoi	hˈeo͡ɪ
whakawhitinga	fˌakafitˈiŋa
kawenga	kawˈeŋa
whakapae	fakˈapa͡ɪ
whakawhitiwhiti	fˌakafˌitifˈiti
Ministry	m ˈi n ˈi (͡e͡n)ˈɛs(͡m͡i) t r (͡e͡n)wˈa͡ɪ(͡m͡i)
māramatanga	mˌaːramatˈaŋa
kākahu	kaːkˈahu"
tūponotanga	tˌu"ːpɔnɔtˈaŋa
whakaora	fakˈa͡ʊra
whakaputaina	fˌakapu"tˈa͡ɪna
kaipupuri	kˌa͡ɪpu"pˈu"ri
hai	hˈa͡ɪ
hiko	hˈikɔ
nāianei	nˌaːianˈei
paki	pˈaki
tapatoru	tˌapatˈɔru"
Whakamahia	fˌakamahˈia
kete	kˈete
moutere	mˌou"tˈere
tāu	tˈaːu"
wāhine	waːhˈine
Moana	mɔˈana
Pāwhiria	pˌaːfirˈia
paku	pˈaku"
otirā	ɔtˈiraː
ētehi	eːtˈehi
penei	penˈei
reta	rˈeta
haurua	hˌau"rˈu"a
ira	ˈira
mahana	mahˈana
roanga	rɔˈaŋa
rerekētanga	rˌerekeːtˈaŋa
kahore	kahˈɔre
rangona	raŋˈɔna
whakamātau	fˌakamaːtˈau"
Kai	kˈa͡ɪ
at	ˈat
haora	hˈa͡ʊra
piri	pˈiri
wero	wˈerɔ
P	p
hoe	hwˈe
kitenga	kitˈeŋa
whakaaetanga	fˌakaa͡ɪtˈaŋa
hanganga	haŋˈaŋa
tetehi	tetˈehi
School	(͡e͡n)ˈɛs sˈiː(͡m͡i) h ˈɔ ˈɔ (͡e͡n)ˈɛl(͡m͡i)
aratohu	ˌaratˈɔhu"
kaihoko	ka͡ɪhˈɔkɔ
takiwa	takˈiwa
whakatipu	fˌakatˈipu"
ine	ˈine
koki	kˈɔki
whakatikatika	fˌakatˌikatˈika
Makaurau	mˌakau"rˈau"
Tāhuhu	taːhˈu"hu"
nunui	nu"nˈu"i
raru	ɹˈaɹu
toto	tˈɔtɔ
tīpuna	tiːpˈu"na
tūmanako	tˌu"ːmanˈakɔ
wehenga	wehˈeŋa
whakahau	fˌakahˈau"
whakawhiwhia	fˌakafifˈia
rangatahi	rˌaŋatˈahi
whara	fˈara
Waipounamu	wˌa͡ɪpou"nˈamu"
pono	pˈɔnɔ
whakapā	fakˈapaː
Kuini	ku"ˈini
Kōti	kˈɔːti
Tā	tˈaː
pahure	pahˈu"re
whakahokia	fˌakahɔkˈia
Tangata	taŋˈata
taipitopito	tˌa͡ɪpitɔpˈitɔ
whakapai	fakˈapa͡ɪ
kaitono	ka͡ɪtˈɔnɔ
taiohi	ta͡ɪˈɔhi
taumaha	tˌau"mˈaha
Kooti	kɔˈɔti
Ngunguru	ŋu"ŋˈu"ru"
ipu	ˈipu"
Tawhaki	tafˈaki
kuhu	kˈu"hu"
wha	fˈa
Take	tˈake
kaituhi	ka͡ɪtˈu"hi
pūmau	pu"ːmˈau"
taupori	tˌau"pˈɔri
Whanaketanga	fˌanaketˈaŋa
ihu	ˈihu"
tupuna	tu"pˈu"na
John	(͡e͡n)d͡ʒˈe͡ɪ(͡m͡i) ˈɔ h n
miraka	mirˈaka
raatau	rˌaatˈau"
Ā	ˈaː
era	ˈera
huihuinga	hˌu"ihu"ˈiŋa
rumaki	ru"mˈaki
tātau	taːtˈau"
Kaiwhakahaere	kˌa͡ɪfakahˈa͡ɪre
Porou	pɔrˈou"
paetae	pˈa͡ɪta͡ɪ
taringa	tarˈiŋa
taura	taˈu"ra
Kapa	kˈapa
Whai	fˈa͡ɪ
Ngata	ŋˈata
ngāwari	ŋaːwˈari
uhi	ˈu"hi
hāora	haːˈɔra
kohi	kˈɔhi
taunga	taˈu"ŋa
kaipuke	ka͡ɪpˈu"ke
kōpae	kˈɔːpa͡ɪ
kati	kˈati
kaumātua	kˌau"maːtˈu"a
tēhea	teːhˈea
wheako	feˈakɔ
O	ˈɔ
hinu	hˈinu"
tonoa	tɔnˈɔa
whakaarohia	fˌakaˌarɔhˈia
whakaputanga	fˌakapu"tˈaŋa
angitu	aŋˈitu"
manawa	manˈawa
meneti	menˈeti
taurangi	tˌau"rˈaŋi
tou	tˈou"
whakaheke	fˌakahˈeke
Pakanga	pakˈaŋa
Taonga	tˈa͡ʊŋa
akiaki	ˌakiˈaki
de	(͡e͡n)dˈiː(͡m͡i) ˈe
kihai	kˈiha͡ɪ
nekehanga	nˌekehˈaŋa
oneone	ˌɔneˈɔne
roopu	rɔˈɔpu"
tatari	tatˈari
urupare	ˌu"ru"pˈare
Library	(͡e͡n)ˈɛl(͡m͡i) ˈi (͡e͡n)bˈiː(͡m͡i) r ˈa r (͡e͡n)wˈa͡ɪ(͡m͡i)
Marae	mˈara͡ɪ
Reanga	reˈaŋa
Tēnā	tˈeːnaː
tūtohi	tu"ːtˈɔhi
Ika	ˈika
Kōkiri	kɔːkˈiri
TMOAHe	tmɔˈahe
Taura	taˈu"ra
Tāmaki	taːmˈaki
Waka	wˈaka
tito	tˈitɔ
whārite	faːrˈite
huringa	hu"rˈiŋa
kāhui	kaːhˈu"i
mamae	mˈama͡ɪ
kēmu	kˈeːmu"
pounamu	pˌou"nˈamu"
taraiwa	tarˈa͡ɪwa
whakapuaki	fˌakapu"ˈaki
ōku	ˈɔːku"
Whakaaturia	fˌakaˌatu"rˈia
Maui	maˈu"i
karaka	karˈaka
matenga	matˈeŋa
pēke	pˈeːke
pepeke	pepˈeke
kiriata	kˌiriˈata
kōhungahunga	kˌɔːhu"ŋahˈu"ŋa
tonutia	tˌɔnu"tˈia
whakamarama	fˌakamarˈama
Mana	mˈana
Protestant	p r ˈɔ t ˈe (͡e͡n)ˈɛs(͡m͡i) t ˈa n t
Putumōhio	pˌu"tu"mɔːhˈiɔ
Théologie	t h (͡e͡n)ˌiːɐkjˈuːt(͡m͡i) ˈɔ (͡e͡n)ˈɛl(͡m͡i) ˈɔ (͡e͡n)d͡ʒˈiː(͡m͡i) ˈi ˈe
Whanganui	fˌaŋanˈu"i
ahuatanga	ˌahu"atˈaŋa
iwa	ˈiwa
katoaInstitut	katˈɔa ˈi n (͡e͡n)ˈɛs(͡m͡i) t ˈi t ˈu" t
pukapukaNgā	pˌu"kapˈu"ka ŋˈaː
tumuaki	tˌu"mu"ˈaki
wawata	wawˈata
whaiaro	fa͡ɪˈarɔ
whea	fˈea
aroaro	ˌarɔˈarɔ
whakahirahira	fˌakahˌirahˈira
whero	fˈerɔ
īmēra	iːmˈeːra
Tainui	ta͡ɪnˈu"i
kounga	koˈu"ŋa
National	n ˈa t ˈi ˈɔ n ˈa (͡e͡n)ˈɛl(͡m͡i)
Tangaroa	tˌaŋarˈɔa
karu	kˈaru"
maatau	mˌaatˈau"
whakaeke	fakˈa͡ɪke
whakaminea	fˌakaminˈea
Akarana	ˌakarˈana
Rautaki	rˌau"tˈaki
hokinga	hɔkˈiŋa
kakahu	kakˈahu"
karaipi	karˈa͡ɪpi
huka	hˈu"ka
pānuitanga	pˌaːnu"itˈaŋa
Rumaki	ru"mˈaki
hākinakina	hˌaːkinakˈina
kuri	kˈu"ri
pu	pˈu"
Whiri	fˈiri
kanikani	kˌanikˈani
pūmanawa	pˌu"ːmanˈawa
December	(͡e͡n)dˈiː(͡m͡i) ˈe (͡e͡n)sˈiː(͡m͡i) ˈe m (͡e͡n)bˈiː(͡m͡i) ˈe r
Hauora	hˌau"ˈɔra
Tr	tr
akonga	akˈɔŋa
inu	ˈinu"
is	ˈi (͡e͡n)ˈɛs(͡m͡i)
puku	pˈu"ku"
pūngao	pˈu"ːŋa͡ʊ
whakamahere	fˌakamahˈere
Arotake	ˌarɔtˈake
Puni	pˈu"ni
Rangatira	rˌaŋatˈira
paerewa	pa͡ɪrˈewa
tūpuna	tu"ːpˈu"na
wehi	wˈehi
Tikanga	tikˈaŋa
mōna	mˈɔːna
whakahē	fakˈaheː
whanaunga	fˌanaˈu"ŋa
Tekau	tekˈau"
maroke	marˈɔke
Whānau	faːnˈau"
kākano	kaːkˈanɔ
ringaringa	rˌiŋarˈiŋa
teina	teˈina
tōrangapū	tˌɔːraŋˈapu"ː
Awa	ˈawa
Pou	pˈou"
Tena	tˈena
pakiwaitara	pˌakiwa͡ɪtˈara
pēpi	pˈeːpi
Tenei	tenˈei
United	ˈu" n ˈi t ˈe (͡e͡n)dˈiː(͡m͡i)
inā	ˈinaː
kerēme	kerˈeːme
Kahungunu	kˌahu"ŋˈu"nu"
Kupe	kˈu"pe
irirangi	ˌirirˈaŋi
kaitautoko	kˌa͡ɪtau"tˈɔkɔ
utua	u"tˈu"a
inaianei	ˌina͡ɪanˈei
pouri	poˈu"ri
raki	rˈaki
whakatere	fˌakatˈere
whanga	fˈaŋa
takutai	takˈu"ta͡ɪ
Auckland	ˈa ˈu" (͡e͡n)sˈiː(͡m͡i) k (͡e͡n)ˈɛl(͡m͡i) ˈa n (͡e͡n)dˈiː(͡m͡i)
Kāti	kˈaːti
Papatūānuku	pˌapatˌu"ːaːnˈu"ku"
Tonoa	tɔnˈɔa
ahumahi	ˌahu"mˈahi
hīkoi	hˈiːko͡ɪ
porotiti	pˌɔrɔtˈiti
rongoā	rɔŋˈɔaː
whāiti	faːˈiti
māu	mˈaːu"
whakarahinga	fˌakarahˈiŋa
whatu	fˈatu"
whāngai	fˈaːŋa͡ɪ
ahunga	ahˈu"ŋa
mātakitaki	mˌaːtakitˈaki
tōtika	tɔːtˈika
whanaketanga	fˌanaketˈaŋa
Pi	pˈi
Tonga	tˈɔŋa
Wiremu	wirˈemu"
kohikohi	kˌɔhikˈɔhi
pātata	paːtˈata
raumati	rˌau"mˈati
Hoatu	hɔˈatu"
mauri	maˈu"ri
on	ˈɔn
toharite	tˌɔharˈite
uiui	ˌu"iˈu"i
whakataukī	fˌakataˈu"kiː
Hou	hˈou"
mātāpono	mˌaːtaːpˈɔnɔ
out	ˈou"t
pūrere	pu"ːrˈere
huruhuru	hˌu"ru"hˈu"ru"
matū	mˈatu"ː
whakapau	fˌakapˈau"
Nui	nˈu"i
koroua	kˌɔroˈu"a
kūmara	ku"ːmˈara
reka	rˈeka
whānuitanga	fˌaːnu"itˈaŋa
Tūhoe	tˈu"ːhwe
hari	hˈari
matihiko	mˌatihˈikɔ
tāpiritanga	tˌaːpiritˈaŋa
whakakore	fˌakakˈɔre
Amerika	ˌamerˈika
Haka	hˈaka
hī	hˈiː
karere	karˈere
rō	rˈɔː
tapeke	tapˈeke
tāwāhi	taːwˈaːhi
whanaungatanga	fˌanaˌu"ŋatˈaŋa
Puna	pˈu"na
rawe	rˈawe
whanake	fanˈake
whiua	fiˈu"a
Whakamāramatia	fˌakamˌaːramatˈia
kōtiro	kɔːtˈirɔ
tumanako	tˌu"manˈakɔ
tuwhera	tu"fˈera
whakaiti	fakˈa͡ɪti
Kohikohinga	kˌɔhikɔhˈiŋa
Tera	tˈera
koinei	ko͡ɪnˈei
koiora	ko͡ɪˈɔra
print	prˈint
rautau	rˌau"tˈau"
rereke	rerˈeke
taniwha	tanˈifa
tautuhi	tˌau"tˈu"hi
whakahaerehia	fˌakahˌa͡ɪrehˈia
whakamōhio	fˌakamɔːhˈiɔ
with	wˈith
Hawaiki	hawˈa͡ɪki
Ora	ˈɔra
tuakiri	tˌu"akˈiri
tāke	tˈaːke
Pēhea	peːhˈea
haina	hˈa͡ɪna
nuku	nˈu"ku"
peke	pˈeke
whakatinana	fˌakatinˈana
Mo	mˈɔ
huna	hˈu"na
pāpā	pˈaːpaː
tiro	tˈirɔ
tuna	tˈu"na
NZ	n(͡e͡n)zˈɛd(͡m͡i)
Newsie	n ˈe w (͡e͡n)ˈɛs(͡m͡i) ˈi ˈe
classification	(͡e͡n)sˈiː ˈɛl(͡m͡i) ˈa (͡e͡n)ˈɛs ˈɛs(͡m͡i) ˈi (͡e͡n)ˈɛf(͡m͡i) ˈi (͡e͡n)sˈiː(͡m͡i) ˈa t ˈi ˈɔ n
hourua	hˌou"rˈu"a
kōhatu	kɔːhˈatu"
tōu	tˈɔːu"
ōu	ˈɔːu"
Kāwana	kaːwˈana
Titiro	titˈirɔ
marau	marˈau"
ngana	ŋˈana
pango	pˈaŋɔ
tūāpapa	tˌu"ːaːpˈapa
whakamana	fˌakamˈana
Ō	ˈɔː
Independent	ˈi n (͡e͡n)dˈiː(͡m͡i) ˈe p ˈe n (͡e͡n)dˈiː(͡m͡i) ˈe n t
Raukawa	rˌau"kˈawa
from	(͡e͡n)ˈɛf(͡m͡i) r ˈɔ m
pāpori	paːpˈɔri
urunga	u"rˈu"ŋa
Kīngitanga	kˌiːŋitˈaŋa
Whakawhitiwhiti	fˌakafˌitifˈiti
poraka	pɔrˈaka
tunu	tˈu"nu"
maori	mˈa͡ʊri
whakaurua	fˌakau"rˈu"a
Paraire	parˈa͡ɪre
moenga	mwˈeŋa
wawe	wˈawe
Henare	henˈare
NewsLanguage	n ˈe w (͡e͡n)ˈɛs ˈɛl(͡m͡i) ˈa n (͡e͡n)d͡ʒˈiː(͡m͡i) ˈu" ˈa (͡e͡n)d͡ʒˈiː(͡m͡i) ˈe
Preference	p r ˈe (͡e͡n)ˈɛf(͡m͡i) ˈe r ˈe n (͡e͡n)sˈiː(͡m͡i) ˈe
Waihoki	wa͡ɪhˈɔki
hiki	hˈiki
horo	hˈɔrɔ
kape	kˈape
nuitia	nˌu"itˈia
puritia	pˌu"ritˈia
pāmu	pˈaːmu"
pōtitanga	pˌɔːtitˈaŋa
waitohu	wa͡ɪtˈɔhu"
whakatauira	fˌakatˌau"ˈira
January	(͡e͡n)d͡ʒˈe͡ɪ(͡m͡i) ˈa n ˈu" ˈa r (͡e͡n)wˈa͡ɪ(͡m͡i)
Kahore	kahˈɔre
Whanake	fanˈake
horoi	hˈɔro͡ɪ
kaikōrero	kˌa͡ɪkɔːrˈerɔ
kawanatanga	kˌawanatˈaŋa
māra	mˈaːra
rori	rˈɔri
whakamatautau	fˌakamˌatau"tˈau"
whiwhinga	fifˈiŋa
Kīngi	kˈiːŋi
Pōti	pˈɔːti
kahu	kˈahu"
kaiwhakaako	kˌa͡ɪfakaˈakɔ
matapaki	mˌatapˈaki
oma	ˈɔma
poti	pˈɔti
äkonga	akˈɔŋa
Pāngarau	pˌaːŋarˈau"
one	ˈɔne
rererangi	rˌererˈaŋi
hoariri	hˌɔarˈiri
kawa	kˈawa
kōrerohia	kˌɔːrerɔhˈia
maua	maˈu"a
mātanga	maːtˈaŋa
tiakina	tˌiakˈina
whakapiki	fˌakapˈiki
ū	ˈu"ː
herehere	hˌerehˈere
huihui	hˌu"ihˈu"i
komiti	kɔmˈiti
kōura	kɔːˈu"ra
porowhita	pˌɔrɔfˈita
whakahua	fˌakahˈu"a
ātaahua	ˌaːtaahˈu"a
kaiārahi	kˌa͡ɪaːrˈahi
takahi	takˈahi
tiriti	tirˈiti
whakangahau	fˌakaŋahˈau"
Āta	ˈaːta
Mäori	mˈa͡ʊri
Taea	tˈa͡ɪa
Tuku	tˈu"ku"
Tumuaki	tˌu"mu"ˈaki
Tāne	tˈaːne
Whakarongo	fˌakarˈɔŋɔ
aromātai	ˌarɔmˈaːta͡ɪ
matauranga	mˌatau"rˈaŋa
ngutu	ŋˈu"tu"
poi	pˈo͡ɪ
pūtau	pu"ːtˈau"
toki	tˈɔki
Kihai	kˈiha͡ɪ
March	m ˈa r (͡e͡n)sˈiː(͡m͡i) h
October	ˈɔ (͡e͡n)sˈiː(͡m͡i) t ˈɔ (͡e͡n)bˈiː(͡m͡i) ˈe r
Ranginui	rˌaŋinˈu"i
Tae	tˈa͡ɪ
ahuwhenua	ˌahu"fenˈu"a
koirā	kˈo͡ɪraː
pitopito	pˌitɔpˈitɔ
rauropi	rˌau"rˈɔpi
tatauranga	tˌatau"rˈaŋa
tāutu	taːˈu"tu"
waipuke	wa͡ɪpˈu"ke
whakareatanga	fˌakarˌeatˈaŋa
Kaitiaki	kˌa͡ɪtiˈaki
Rūnanga	ru"ːnˈaŋa
kano	kˈanɔ
kare	kˈare
kōrua	kɔːrˈu"a
pera	pˈera
pukupuku	pˌu"ku"pˈu"ku"
tōmua	tɔːmˈu"a
PouakoHe	pˌou"ˈakɔ hˈe
Rāwhiti	raːfˈiti
ea	ˈea
haki	hˈaki
kiore	kiˈɔre
tīma	tˈiːma
wahanga	wahˈaŋa
hurihia	hˌu"rihˈia
otaota	ɔtˈa͡ʊta
tautohu	tˌau"tˈɔhu"
pehea	pehˈea
Hine	hˈine
Pipiri	pipˈiri
Taku	tˈaku"
kaipānui	kˌa͡ɪpaːnˈu"i
moko	mˈɔkɔ
tahuna	tahˈu"na
whati	fˈati
Tama	tˈama
Wiki	wˈiki
māngai	mˈaːŋa͡ɪ
patai	pˈata͡ɪ
Catalyst	(͡e͡n)sˈiː(͡m͡i) ˈa t ˈa (͡e͡n)ˈɛl wˈa͡ɪ ˈɛs(͡m͡i) t
hautau	hˌau"tˈau"
horahanga	hˌɔrahˈaŋa
kāhore	kaːhˈɔre
whakatakotoria	fˌakatˌakɔtɔrˈia
ēngari	eːŋˈari
Pirimia	pˌirimˈia
Wai	wˈa͡ɪ
homai	hˈɔma͡ɪ
kupenga	ku"pˈeŋa
timatanga	tˌimatˈaŋa
ahurei	ˌahu"rˈei
kōkiri	kɔːkˈiri
kōrerotia	kˌɔːrerɔtˈia
minita	minˈita
papakupu	pˌapakˈu"pu"
rama	rˈama
whakahou	fˌakahˈou"
August	ˈa ˈu" (͡e͡n)d͡ʒˈiː(͡m͡i) ˈu" (͡e͡n)ˈɛs(͡m͡i) t
Road	r ˈɔ ˈa (͡e͡n)dˈiː(͡m͡i)
mauī	maˈu"iː
rangatiratanga	rˌaŋatˌiratˈaŋa
November	n ˈɔ (͡e͡n)vˈiː(͡m͡i) ˈe m (͡e͡n)bˈiː(͡m͡i) ˈe r
kiko	kˈikɔ
mauria	mˌau"rˈia
tira	tˈira
tūhono	tu"ːhˈɔnɔ
Iho	ˈihɔ
Nāna	nˈaːna
Ope	ˈɔpe
September	(͡e͡n)ˈɛs(͡m͡i) ˈe p t ˈe m (͡e͡n)bˈiː(͡m͡i) ˈe r
kumara	ku"mˈara
ritenga	ritˈeŋa
tātari	taːtˈari
tūnga	tˈu"ːŋa
waipiro	wa͡ɪpˈirɔ
wāhitanga	wˌaːhitˈaŋa
Otira	ɔtˈira
auaha	ˌau"ˈaha
haria	harˈia
kaukau	kˌau"kˈau"
oku	ˈɔku"
rūma	rˈu"ːma
taunakitanga	tˌau"nˌakitˈaŋa
tūru	tˈu"ːru"
whakatō	fakˈatɔː
Pōneke	pɔːnˈeke
atawhai	atˈafa͡ɪ
aukati	ˌau"kˈati
kirimana	kˌirimˈana
paenga	pˈa͡ɪŋa
waeine	wa͡ɪˈine
whanonga	fanˈɔŋa
Aho	ˈahɔ
April	ˈa p r ˈi (͡e͡n)ˈɛl(͡m͡i)
February	(͡e͡n)ˈɛf(͡m͡i) ˈe (͡e͡n)bˈiː(͡m͡i) r ˈu" ˈa r (͡e͡n)wˈa͡ɪ(͡m͡i)
mohiotia	mˌɔhiɔtˈia
mona	mˈɔna
rata	rˈata
takoha	takˈɔha
Tamaki	tamˈaki
Whakamana	fˌakamˈana
awatea	ˌawatˈea
kānga	kˈaːŋa
ohorere	ˌɔhɔrˈere
pīrangi	piːrˈaŋi
takea	takˈea
tuahine	tˌu"ahˈine
wareware	wˌarewˈare
Huanga	hu"ˈaŋa
Maniapoto	mˌaniapˈɔtɔ
kohia	kɔhˈia
kōwhiri	kɔːfˈiri
peka	pˈeka
taitamariki	tˌa͡ɪtamarˈiki
Kaupae	kaˈu"pa͡ɪ
Kawana	kawˈana
Media	m ˈe (͡e͡n)dˈiː(͡m͡i) ˈi ˈa
Rohe	rˈɔhe
hōu	hˈɔːu"
parirau	pˌarirˈau"
poaka	pɔˈaka
puke	pˈu"ke
tauiwi	tˌau"ˈiwi
tānga	tˈaːŋa
tūtaki	tu"ːtˈaki
Kirihimete	kˌirihimˈete
hekenga	hekˈeŋa
hipa	hˈipa
panoni	panˈɔni
tahua	tahˈu"a
tapahi	tapˈahi
tāpirihia	tˌaːpirihˈia
Hāhi	hˈaːhi
Rāhoroi	raːhˈɔro͡ɪ
atahanga	ˌatahˈaŋa
koha	kˈɔha
kīanga	kiːˈaŋa
kōrerorero	kˌɔːrerɔrˈerɔ
tohatoha	tˌɔhatˈɔha
Mahuru	mahˈu"ru"
Posted	p ˈɔ (͡e͡n)ˈɛs(͡m͡i) t ˈe (͡e͡n)dˈiː(͡m͡i)
Pouako	pˌou"ˈakɔ
Trust	t r ˈu" (͡e͡n)ˈɛs(͡m͡i) t
kapua	kapˈu"a
korerotia	kˌɔrerɔtˈia
mataku	matˈaku"
ngahuru	ŋahˈu"ru"
para	pˈara
pāngia	paːŋˈia
tihi	tˈihi
toenga	twˈeŋa
toko	tˈɔkɔ
tōpana	tɔːpˈana
whakawhānui	fˌakafaːnˈu"i
Mei	mˈei
Takawaenga	tˌakawˈa͡ɪŋa
iii	iˈii
koi	kˈo͡ɪ
mara	mˈara
nekeneke	nˌekenˈeke
pahi	pˈahi
pene	pˈene
pire	pˈire
tangohanga	tˌaŋɔhˈaŋa
tara	tˈara
tupapaku	tˌu"papˈaku"
whakamuri	fˌakamˈu"ri
Ako	ˈakɔ
Britain	(͡e͡n)bˈiː(͡m͡i) r ˈi t ˈa ˈi n
Hui	hˈu"i
Kamupene	kˌamu"pˈene
Online	ˈɔ n (͡e͡n)ˈɛl(͡m͡i) ˈi n ˈe
arataki	ˌaratˈaki
haramai	harˈama͡ɪ
puhuruhurutanga	pˌu"hu"rˌu"hu"ru"tˈaŋa
puia	pu"ˈia
rewa	rˈewa
whakamātautau	fˌakamˌaːtau"tˈau"
āwangawanga	ˌaːwaŋawˈaŋa
Kara	kˈara
herea	herˈea
hurihanga	hˌu"rihˈaŋa
kaumatua	kˌau"matˈu"a
main	mˈa͡ɪn
maru	mˈaru"
pari	pˈari
umanga	u"mˈaŋa
wehewehe	wˌehewˈehe
whakaū	fakˈau"ː
Inā	ˈinaː
Kotahitanga	kˌɔtahitˈaŋa
Manatū	manˈatu"ː
Whakahaere	fˌakahˈa͡ɪre
hōhonu	hɔːhˈɔnu"
pōuri	pɔːˈu"ri
raina	rˈa͡ɪna
tākuta	taːkˈu"ta
whaihua	fa͡ɪhˈu"a
whakanuia	fˌakanu"ˈia
Aroha	arˈɔha
Ia	ˈia
Tapu	tˈapu"
Waitaha	wa͡ɪtˈaha
Whakatane	fˌakatˈane
hāhi	hˈaːhi
karangatia	kˌaraŋatˈia
nohoanga	nˌɔhɔˈaŋa
oho	ˈɔhɔ
rāngai	rˈaːŋa͡ɪ
tautohetohe	tˌau"tˌɔhetˈɔhe
tomo	tˈɔmɔ
Dr	(͡e͡n)dˈiː(͡m͡i)r
Wairarapa	wˌa͡ɪrarˈapa
Whakamārama	fˌakamaːrˈama
aa	ˈaa
amuamu	ˌamu"ˈamu"
hū	hˈu"ː
poro	pˈɔrɔ
tapahia	tˌapahˈia
wehea	wehˈea
whakaakoranga	fˌakaˌakɔrˈaŋa
Paoa	pˈa͡ʊa
hoiho	hˈo͡ɪhɔ
paepae	pˈa͡ɪpa͡ɪ
pua	pˈu"a
reanga	reˈaŋa
tamāhine	tˌamaːhˈine
whakahaeretia	fˌakahˌa͡ɪretˈia
whakapiri	fˌakapˈiri
Ahorangi	ˌahɔrˈaŋi
Encyclopedia	ˈe n (͡e͡n)sˈiː wˈa͡ɪ sˈiː ˈɛl(͡m͡i) ˈɔ p ˈe (͡e͡n)dˈiː(͡m͡i) ˈi ˈa
Kiwi	kˈiwi
Maxwell	m ˈa (͡e͡n)ˈɛks(͡m͡i) w ˈe (͡e͡n)ˈɛl ˈɛl(͡m͡i)
South	(͡e͡n)ˈɛs(͡m͡i) ˈɔ ˈu" t h
Wāhanga	waːhˈaŋa
ama	ˈama
awhi	ˈafi
hapa	hˈapa
kahurangi	kˌahu"rˈaŋi
muka	mˈu"ka
māua	maːˈu"a
ngaio	ŋˈa͡ɪɔ
ripoata	rˌipɔˈata
whakarea	fˌakarˈea
ōwehenga	ˌɔːwehˈeŋa
North	nˈɔrth
Pai	pˈa͡ɪ
Pānui	paːnˈu"i
Tukuna	tu"kˈu"na
inenga	inˈeŋa
kāre	kˈaːre
pārekareka	pˌaːrekarˈeka
tukunga	tu"kˈu"ŋa
tāku	tˈaːku"
tūāhua	tˌu"ːaːhˈu"a
whakatupato	fˌakatu"pˈatɔ
whiu	fˈiu"
Ana	ˈana
Ariki	arˈiki
Tū	tˈu"ː
Whānui	faːnˈu"i
hokonga	hɔkˈɔŋa
kaiwhakawā	kˌa͡ɪfakˈawaː
konā	kˈɔnaː
puninga	pu"nˈiŋa
takaro	takˈarɔ
tautokona	tˌau"tɔkˈɔna
tikina	tikˈina
tohe	tˈɔhe
āpiha	aːpˈiha
Kingi	kˈiŋi
auraki	ˌau"rˈaki
hainatia	hˌa͡ɪnatˈia
hoia	hˈo͡ɪa
kapu	kˈapu"
kurī	kˈu"riː
toe	twˈe
tohungatanga	tˌɔhu"ŋatˈaŋa
torotoro	tˌɔrɔtˈɔrɔ
waimarie	wˌa͡ɪmarˈie
whakakotahi	fˌakakɔtˈahi
whakawhanaketanga	fˌakafˌanaketˈaŋa
whānuitia	fˌaːnu"itˈia
Kaiako	ka͡ɪˈakɔ
Tūroa	tu"ːrˈɔa
kara	kˈara
ngāi	ŋˈaːi
tuākana	tˌu"aːkˈana
Henrietta	hˌenriˈetta
Kimihia	kˌimihˈia
Oketopa	ˌɔketˈɔpa
Tauira	tˌau"ˈira
Turi	tˈu"ri
hiranga	hirˈaŋa
hopukina	hˌɔpu"kˈina
kōnae	kˈɔːna͡ɪ
mataono	matˈa͡ʊnɔ
mati	mˈati
ngahau	ŋahˈau"
pepeha	pepˈeha
riu	rˈiu"
takahia	tˌakahˈia
x	(͡e͡n)ˈɛks(͡m͡i)
Living	(͡e͡n)ˈɛl(͡m͡i) ˈi (͡e͡n)vˈiː(͡m͡i) ˈi n (͡e͡n)d͡ʒˈiː(͡m͡i)
hohoro	hɔhˈɔrɔ
pere	pˈere
āheinga	ˌaːheˈiŋa
Reipa	reˈipa
noatia	nˌɔatˈia
rongoa	rɔŋˈɔa
tarai	tˈara͡ɪ
u	ˈu"
Hoani	hɔˈani
James	(͡e͡n)d͡ʒˈe͡ɪ(͡m͡i) ˈa m ˈe (͡e͡n)ˈɛs(͡m͡i)
Tahi	tˈahi
Thomas	t h ˈɔ m ˈa (͡e͡n)ˈɛs(͡m͡i)
Tūwharetoa	tˌu"ːfaretˈɔa
Whakatau	fˌakatˈau"
hauwhā	haˈu"faː
karangahia	kˌaraŋahˈia
kata	kˈata
kiwi	kˈiwi
kōti	kˈɔːti
maimai	mˈa͡ɪma͡ɪ
maumahara	mˌau"mahˈara
peita	peˈita
ruarua	rˌu"arˈu"a
tūpono	tu"ːpˈɔnɔ
whakahuatia	fˌakahˌu"atˈia
whiringa	firˈiŋa
ōkawa	ɔːkˈawa
Taua	taˈu"a
Waiho	wˈa͡ɪhɔ
hora	hˈɔra
kotiro	kɔtˈirɔ
māia	maːˈia
taia	tˈa͡ɪa
waihangatia	wˌa͡ɪhaŋatˈia
whakataki	fˌakatˈaki
whetu	fˈetu"
Awards	ˈa w ˈa r (͡e͡n)dˈiː ˈɛs(͡m͡i)
Hauraki	hˌau"rˈaki
Maehe	mˈa͡ɪhe
Marama	marˈama
Motu	mˈɔtu"
Neke	nˈeke
Tu	tˈu"
Uenuku	ˌu"enˈu"ku"
eZ	ˈe (͡e͡n)zˈɛd(͡m͡i)
hainatanga	hˌa͡ɪnatˈaŋa
papai	pˈapa͡ɪ
putu	pˈu"tu"
raupatu	rˌau"pˈatu"
ruri	rˈu"ri
tahu	tˈahu"
tohungia	tˌɔhu"ŋˈia
tē	tˈeː
whakarunga	fˌakarˈu"ŋa
Hauhau	hˌau"hˈau"
Kahu	kˈahu"
Mātāpunenga	mˌaːtaːpu"nˈeŋa
PublishHe	p ˈu" (͡e͡n)bˈiː ˈɛl(͡m͡i) ˈi (͡e͡n)ˈɛs(͡m͡i) h hˈe
Regionals	r ˈe (͡e͡n)d͡ʒˈiː(͡m͡i) ˈi ˈɔ n ˈa (͡e͡n)ˈɛl ˈɛs(͡m͡i)
Rongo	rˈɔŋɔ
Rātana	raːtˈana
Tino	tˈinɔ
Whakaraparapatia	fˌakarˌaparˌapatˈia
ZealandSkip	(͡e͡n)zˈɛd(͡m͡i) ˈe ˈa (͡e͡n)ˈɛl(͡m͡i) ˈa n (͡e͡n)dˈiː ˈɛs(͡m͡i) k ˈi p
contentTiro	(͡e͡n)sˈiː(͡m͡i) ˈɔ n t ˈe n t tˈirɔ
kaipōti	ka͡ɪpˈɔːti
karo	kˈarɔ
kauhoe	kaˈu"hwe
tuihono	tˌu"ihˈɔnɔ
whakaturia	fˌakatu"rˈia
Great	(͡e͡n)d͡ʒˈiː(͡m͡i) r ˈe ˈa t
Kāhore	kaːhˈɔre
Noho	nˈɔhɔ
Whakaahua	fˌakaahˈu"a
akoako	ˌakɔˈakɔ
harikoa	hˌarikˈɔa
kapi	kˈapi
kāta	kˈaːta
matapae	matˈapa͡ɪ
ngota	ŋˈɔta
poipoi	pˈo͡ɪpo͡ɪ
roro	rˈɔrɔ
tokotoru	tˌɔkɔtˈɔru"
tīpako	tiːpˈakɔ
whanui	fanˈu"i
Papakupu	pˌapakˈu"pu"
mīharo	miːhˈarɔ
mōrearea	mˌɔːrearˈea
putiputi	pˌu"tipˈu"ti
pūngāwerewere	pˌu"ːŋaːwˌerewˈere
whakakī	fakˈakiː
whakawakia	fˌakawakˈia
ōhanga	ɔːhˈaŋa
Development	(͡e͡n)dˈiː(͡m͡i) ˈe (͡e͡n)vˈiː(͡m͡i) ˈe (͡e͡n)ˈɛl(͡m͡i) ˈɔ p m ˈe n t
Pire	pˈire
ataahua	ˌataahˈu"a
mārō	mˈaːrɔː
nōna	nˈɔːna
pāpāho	paːpˈaːhɔ
raranga	rarˈaŋa
tiketike	tˌiketˈike
turanga	tu"rˈaŋa
Hokianga	hˌɔkiˈaŋa
Homai	hˈɔma͡ɪ
Karere	karˈere
Kerei	kerˈei
ariki	arˈiki
kaiwhakatere	kˌa͡ɪfakatˈere
maro	mˈarɔ
pōwhiri	pɔːfˈiri
tauhokohoko	tˌau"hˌɔkɔhˈɔkɔ
whiriwhiria	fˌirifirˈia
Whiti	fˈiti
hautoru	hˌau"tˈɔru"
kaikorero	kˌa͡ɪkɔrˈerɔ
makariri	mˌakarˈiri
taurite	tˌau"rˈite
v	(͡e͡n)vˈiː(͡m͡i)
whakapaunga	fˌakapaˈu"ŋa
Koirā	kˈo͡ɪraː
Takiwa	takˈiwa
TrustNgā	t r ˈu" (͡e͡n)ˈɛs(͡m͡i) t ŋˈaː
Tāpiritia	tˌaːpiritˈia
Tīreni	tiːrˈeni
aruhe	arˈu"he
hao	hˈa͡ʊ
kōiwi	kɔːˈiwi
matea	matˈea
tuawhenua	tˌu"afenˈu"a
whakakapi	fˌakakˈapi
whakatipuranga	fˌakatˌipu"rˈaŋa
whakatupu	fˌakatˈu"pu"
wāwāhi	waːwˈaːhi
Apirana	ˌapirˈana
Kore	kˈɔre
Maunga	maˈu"ŋa
Otirā	ɔtˈiraː
Pae	pˈa͡ɪ
Poneke	pɔnˈeke
matapihi	mˌatapˈihi
ngoikore	ŋo͡ɪkˈɔre
pirau	pirˈau"
puehu	pu"ˈehu"
tamahine	tˌamahˈine
tāia	taːˈia
whakamāori	fˌakamaːˈɔri
Heretaunga	hˌeretaˈu"ŋa
Mahere	mahˈere
Noema	nwˈema
Pānuitia	pˌaːnu"itˈia
Whāriki	faːrˈiki
iahiko	ˌiahˈikɔ
kairangahau	kˌa͡ɪraŋahˈau"
kētia	keːtˈia
pata	pˈata
pukenga	pu"kˈeŋa
tīkina	tiːkˈina
whakaharahara	fˌakahˌarahˈara
whakamau	fˌakamˈau"
whakawhirinaki	fˌakafˌirinˈaki
īngoa	iːŋˈɔa
Hepetema	hˌepetˈema
Nei	nˈei
Puhi	pˈu"hi
Tamariki	tˌamarˈiki
kimihia	kˌimihˈia
korua	kɔrˈu"a
kōpaki	kɔːpˈaki
maramara	mˌaramˈara
motokā	mɔtˈɔkaː
takenga	takˈeŋa
tuturu	tu"tˈu"ru"
whaikōrero	fˌa͡ɪkɔːrˈerɔ
whakahaeretanga	fˌakahˌa͡ɪretˈaŋa
xx	(͡e͡n)ˌɛksˈɛks(͡m͡i)
Ētahi	eːtˈahi
rū	rˈu"ː
tahae	tˈaha͡ɪ
teihana	tˌeihˈana
tima	tˈima
tokoiti	tɔkˈo͡ɪti
whaitake	fa͡ɪtˈake
whakahāngai	fˌakahˈaːŋa͡ɪ
whakarōpū	fˌakarˈɔːpu"ː
Act	ˈa (͡e͡n)sˈiː(͡m͡i) t
Anō	ˈanɔː
Komiti	kɔmˈiti
Mau	mˈau"
TKKM	tkkm
Tara	tˈara
aroturuki	ˌarɔtu"rˈu"ki
hurihuri	hˌu"rihˈu"ri
kaituku	ka͡ɪtˈu"ku"
kirihou	kˌirihˈou"
kona	kˈɔna
kukume	ku"kˈu"me
maimoatanga	mˌa͡ɪmɔatˈaŋa
mitarau	mˌitarˈau"
paanga	paˈaŋa
parāoa	pˌaraːˈɔa
ripanga	ripˈaŋa
tuawhā	tu"ˈafaː
tutu	tˈu"tu"
uira	u"ˈira
whakapaipai	fˌakapˈa͡ɪpa͡ɪ
whakatinanatanga	fˌakatˌinanatˈaŋa
Advice	ˈa (͡e͡n)dˈiː vˈiː(͡m͡i) ˈi (͡e͡n)sˈiː(͡m͡i) ˈe
Aratohu	ˌaratˈɔhu"
Hangaia	haŋˈa͡ɪa
Hiku	hˈiku"
Kupenga	ku"pˈeŋa
Mema	mˈema
Plenty	p (͡e͡n)ˈɛl(͡m͡i) ˈe n t (͡e͡n)wˈa͡ɪ(͡m͡i)
Teina	teˈina
kaihautū	kˌa͡ɪhaˈu"tu"ː
kaute	kaˈu"te
more	mˈɔre
reti	rˈeti
tēpu	tˈeːpu"
whakatakotoranga	fˌakatˌakɔtɔrˈaŋa
whatitiri	fˌatitˈiri
āwhata	aːfˈata
Atu	ˈatu"
Hakihea	hˌakihˈea
Koiora	ko͡ɪˈɔra
Mahara	mahˈara
McLean	m(͡e͡n)sˈiː ˈɛl(͡m͡i) ˈe ˈa n
Upoko	u"pˈɔkɔ
Whāia	faːˈia
Williams	w ˈi (͡e͡n)ˈɛl ˈɛl(͡m͡i) ˈi ˈa m (͡e͡n)ˈɛs(͡m͡i)
awe	ˈawe
hautanga	hˌau"tˈaŋa
kaupae	kaˈu"pa͡ɪ
koro	kˈɔrɔ
kō	kˈɔː
māpere	maːpˈere
ou	ˈou"
raihana	ra͡ɪhˈana
torutoru	tˌɔru"tˈɔru"
uwha	ˈu"fa
Āe	ˈaːe
ēhea	eːhˈea
College	(͡e͡n)sˈiː(͡m͡i) ˈɔ (͡e͡n)ˈɛl ˈɛl(͡m͡i) ˈe (͡e͡n)d͡ʒˈiː(͡m͡i) ˈe
Festival	(͡e͡n)ˈɛf(͡m͡i) ˈe (͡e͡n)ˈɛs(͡m͡i) t ˈi (͡e͡n)vˈiː(͡m͡i) ˈa (͡e͡n)ˈɛl(͡m͡i)
Heke	hˈeke
Island	ˈi (͡e͡n)ˈɛs ˈɛl(͡m͡i) ˈa n (͡e͡n)dˈiː(͡m͡i)
Kaikohe	ka͡ɪkˈɔhe
Rata	rˈata
University	ˈu" n ˈi (͡e͡n)vˈiː(͡m͡i) ˈe r (͡e͡n)ˈɛs(͡m͡i) ˈi t (͡e͡n)wˈa͡ɪ(͡m͡i)
herenga	herˈeŋa
hiwi	hˈiwi
kāwai	kˈaːwa͡ɪ
makawe	makˈawe
ngawari	ŋawˈari
pana	pˈana
puni	pˈu"ni
raatou	rˌaatˈou"
ruru	rˈu"ru"
taiapa	ta͡ɪˈapa
Kāi	kˈaːi
Manaia	manˈa͡ɪa
TPK	tpk
Tāhei	taːhˈei
Tākuta	taːkˈu"ta
auau	ˌau"ˈau"
kaihanga	ka͡ɪhˈaŋa
kauae	kaˈu"a͡ɪ
kokonga	kɔkˈɔŋa
pakitara	pˌakitˈara
raweke	rawˈeke
taiaha	ta͡ɪˈaha
tangihanga	tˌaŋihˈaŋa
tuhituhinga	tˌu"hitu"hˈiŋa
Ngake	ŋˈake
St	(͡e͡n)ˈɛs(͡m͡i)t
Waiariki	wˌa͡ɪarˈiki
Welcome	w ˈe (͡e͡n)ˈɛl sˈiː(͡m͡i) ˈɔ m ˈe
eetahi	ˌeetˈahi
karapu	karˈapu"
maia	mˈa͡ɪa
mihinare	mˌihinˈare
motika	mɔtˈika
mōu	mˈɔːu"
otira	ɔtˈira
ropu	rˈɔpu"
uiuinga	ˌu"iu"ˈiŋa
whakararo	fˌakarˈarɔ
whakarerekē	fˌakarerˈekeː
Jones	(͡e͡n)d͡ʒˈe͡ɪ(͡m͡i) ˈɔ n ˈe (͡e͡n)ˈɛs(͡m͡i)
Mena	mˈena
Nana	nˈana
Ngai	ŋˈa͡ɪ
Ranga	rˈaŋa
Tane	tˈane
Whakarea	fˌakarˈea
aitua	a͡ɪtˈu"a
cm	(͡e͡n)sˈiː(͡m͡i)m
hōhipera	hˌɔːhipˈera
iv	ˈi (͡e͡n)vˈiː(͡m͡i)
meka	mˈeka
neherā	nehˈeraː
pena	pˈena
pikinga	pikˈiŋa
rahinga	rahˈiŋa
rōrahi	rɔːrˈahi
speech	(͡e͡n)ˈɛs(͡m͡i) p ˈe ˈe (͡e͡n)sˈiː(͡m͡i) h
tauhou	tˌau"hˈou"
whakakaha	fˌakakˈaha
whakatupuranga	fˌakatˌu"pu"rˈaŋa
Ākonga	aːkˈɔŋa
Kōeke	kɔːˈeke
Porirua	pˌɔrirˈu"a
Rarotonga	rˌarɔtˈɔŋa
Ratonga	ratˈɔŋa
Rēhia	reːhˈia
Smith	(͡e͡n)ˈɛs(͡m͡i) m ˈi t h
Tata	tˈata
Tatauranga	tˌatau"rˈaŋa
Wellington	w ˈe (͡e͡n)ˈɛl ˈɛl(͡m͡i) ˈi n (͡e͡n)d͡ʒˈiː(͡m͡i) t ˈɔ n
William	w ˈi (͡e͡n)ˈɛl ˈɛl(͡m͡i) ˈi ˈa m
hira	hˈira
hāunga	haːˈu"ŋa
kaumoana	kˌau"mɔˈana
kohatu	kɔhˈatu"
maku	mˈaku"
motukā	mɔtˈu"kaː
mura	mˈu"ra
mātai	mˈaːta͡ɪ
paraoa	parˈa͡ʊa
paru	pˈaru"
tahataha	tˌahatˈaha
tohorā	tɔhˈɔraː
utaina	u"tˈa͡ɪna
werohia	wˌerɔhˈia
whakatairite	fˌakata͡ɪrˈite
whakatenatena	fˌakatˌenatˈena
Ōtautahi	ˌɔːtau"tˈahi
Mutu	mˈu"tu"
Rangitāne	rˌaŋitˈaːne
Tika	tˈika
Tukua	tu"kˈu"a
Turanga	tu"rˈaŋa
Tutanekai	tˌu"tanˈeka͡ɪ
Waiapu	wa͡ɪˈapu"
harore	harˈɔre
kaihokohoko	kˌa͡ɪhɔkɔhˈɔkɔ
kaitākaro	kˌa͡ɪtaːkˈarɔ
kakara	kakˈara
kītanga	kiːtˈaŋa
manawanui	mˌanawanˈu"i
miharo	mihˈarɔ
moea	mwˈea
motuka	mɔtˈu"ka
nehe	nˈehe
panui	panˈu"i
taina	tˈa͡ɪna
taraka	tarˈaka
tautohe	tˌau"tˈɔhe
tumu	tˈu"mu"
whakarauora	fˌakarˌau"ˈɔra
whakariterite	fˌakarˌiterˈite
Haina	hˈa͡ɪna
Images	ˈi m ˈa (͡e͡n)d͡ʒˈiː(͡m͡i) ˈe (͡e͡n)ˈɛs(͡m͡i)
Kiwa	kˈiwa
Matatini	mˌatatˈini
Pā	pˈaː
akona	akˈɔna
haurehu	hˌau"rˈehu"
hue	hˈu"e
kaka	kˈaka
koroni	kɔrˈɔni
mīhini	miːhˈini
ngau	ŋˈau"
papanga	papˈaŋa
tāpiria	tˌaːpirˈia
whakanoho	fˌakanˈɔhɔ
whakarewa	fˌakarˈewa
whakataurite	fˌakatˌau"rˈite
City	(͡e͡n)sˈiː(͡m͡i) ˈi t (͡e͡n)wˈa͡ɪ(͡m͡i)
Dictionary	(͡e͡n)dˈiː(͡m͡i) ˈi (͡e͡n)sˈiː(͡m͡i) t ˈi ˈɔ n ˈa r (͡e͡n)wˈa͡ɪ(͡m͡i)
Hangarau	hˌaŋarˈau"
Hāunga	haːˈu"ŋa
Mihi	mˈihi
Parihaka	pˌarihˈaka
Pita	pˈita
Puea	pu"ˈea
Pēwhairangi	pˌeːfa͡ɪrˈaŋi
Waititi	wa͡ɪtˈiti
atamira	ˌatamˈira
auahi	ˌau"ˈahi
kake	kˈake
maa	mˈaa
mahunga	mahˈu"ŋa
mātāmua	mˌaːtaːmˈu"a
ngako	ŋˈakɔ
oriori	ˌɔriˈɔri
pahikara	pˌahikˈara
pepe	pˈepe
tao	tˈa͡ʊ
taro	tˈarɔ
taru	tˈaru"
taunaki	tˌau"nˈaki
tina	tˈina
wh	wh
whakatā	fakˈataː
Kaha	kˈaha
Otago	ˈɔ t ˈa (͡e͡n)d͡ʒˈiː(͡m͡i) ˈɔ
PDF	p(͡e͡n)dˌiːˈɛf(͡m͡i)
Tohua	tɔhˈu"a
Tēnei	teːnˈei
Whakaritea	fˌakaritˈea
Whina	fˈina
hararei	hˌararˈei
manaakitanga	mˌanaˌakitˈaŋa
maoa	mˈa͡ʊa
mōteatea	mˌɔːteatˈea
nau	nˈau"
ngākaunui	ŋˌaːkau"nˈu"i
paunga	paˈu"ŋa
pēnā	pˈeːnaː
taangata	tˌaaŋˈata
taatau	tˌaatˈau"
teenei	tˌeenˈei
tü	tˈu"
wao	wˈa͡ʊ
whakaingoatia	fˌaka͡ɪŋˌɔatˈia
whakamihi	fˌakamˈihi
whakamāramatanga	fˌakamˌaːramatˈaŋa
whakapūmau	fˌakapu"ːmˈau"
wharenui	fˌarenˈu"i
ātete	aːtˈete
George	(͡e͡n)d͡ʒˈiː(͡m͡i) ˈe ˈɔ r (͡e͡n)d͡ʒˈiː(͡m͡i) ˈe
Kāhui	kaːhˈu"i
Learning	(͡e͡n)ˈɛl(͡m͡i) ˈe ˈa r n ˈi n (͡e͡n)d͡ʒˈiː(͡m͡i)
Ltd	(͡e͡n)ˌɛl(͡m͡i)t(͡e͡n)dˈiː(͡m͡i)
Ngapuhi	ŋapˈu"hi
Primary	p r ˈi m ˈa r (͡e͡n)wˈa͡ɪ(͡m͡i)
Runanga	ru"nˈaŋa
Timi	tˈimi
Whakataunga	fˌakataˈu"ŋa
apopo	apˈɔpɔ
hika	hˈika
hiku	hˈiku"
honoa	hɔnˈɔa
kumea	ku"mˈea
kīhai	kˈiːha͡ɪ
marea	marˈea
ngārara	ŋaːrˈara
puhi	pˈu"hi
rawatia	rˌawatˈia
rūnanga	ru"ːnˈaŋa
su	(͡e͡n)ˈɛs(͡m͡i) ˈu"
support	(͡e͡n)ˈɛs(͡m͡i) ˈu" p p ˈɔ r t
tohaina	tɔhˈa͡ɪna
whaia	fˈa͡ɪa
whakarere	fˌakarˈere
wheke	fˈeke
Hirini	hirˈini
Kōmihana	kˌɔːmihˈana
Mate	mˈate
Ngohe	ŋˈɔhe
Richard	r ˈi (͡e͡n)sˈiː(͡m͡i) h ˈa r (͡e͡n)dˈiː(͡m͡i)
Rātapu	raːtˈapu"
eka	ˈeka
haumi	haˈu"mi
huaina	hu"ˈa͡ɪna
hākari	haːkˈari
kapo	kˈapɔ
punga	pˈu"ŋa
punua	pu"nˈu"a
ruku	rˈu"ku"
rōia	rɔːˈia
tuara	tu"ˈara
whakaekea	fˌaka͡ɪkˈea
whakahoutanga	fˌakahˌou"tˈaŋa
whiriwhiringa	fˌirifirˈiŋa
āe	ˈaːe
Ahupūngao	ˌahu"pˈu"ːŋa͡ʊ
Koro	kˈɔrɔ
Nāwai	nˈaːwa͡ɪ
Peter	pˈeter
Puketeraki	pˌu"keterˈaki
Pēpuere	pˌeːpu"ˈere
Rūnaka	ru"ːnˈaka
Taiao	tˈa͡ɪa͡ʊ
Taylor	t ˈa (͡e͡n)wˈa͡ɪ ˈɛl(͡m͡i) ˈɔ r
Treaty	t r ˈe ˈa t (͡e͡n)wˈa͡ɪ(͡m͡i)
Whakaata	fˌakaˈata
Whātaitai	faːtˈa͡ɪta͡ɪ
aka	ˈaka
anoo	anˈɔɔ
hipi	hˈipi
iri	ˈiri
pononga	pɔnˈɔŋa
pāwhiri	paːfˈiri
pūtohu	pu"ːtˈɔhu"
raakau	rˌaakˈau"
roimata	ro͡ɪmˈata
tāpaetanga	tˌaːpa͡ɪtˈaŋa
tāua	taːˈu"a
tōkeke	tɔːkˈeke
uku	ˈu"ku"
waiaro	wa͡ɪˈarɔ
whakaahuatia	fˌakaˌahu"atˈia
whakaatuhia	fˌakaˌatu"hˈia
whakamaharatanga	fˌakamˌaharatˈaŋa
whakaratohia	fˌakarˌatɔhˈia
whakarārangi	fˌakaraːrˈaŋi
whakatutukitanga	fˌakatˌu"tu"kitˈaŋa
Harakeke	hˌarakˈeke
Heuheu	hˌeu"hˈeu"
Huirapa	hˌu"irˈapa
Hōngongoi	hɔːŋˈɔŋo͡ɪ
Lotto	(͡e͡n)ˈɛl(͡m͡i) ˈɔ t t ˈɔ
Mere	mˈere
Mihinare	mˌihinˈare
Ngaheu	ŋahˈeu"
Taupo	taˈu"pɔ
Tiaki	tiˈaki
ahei	ahˈei
hangarite	hˌaŋarˈite
hine	hˈine
huānga	hu"ˈaːŋa
karangatanga	kˌaraŋatˈaŋa
mātao	mˈaːta͡ʊ
pakupaku	pˌaku"pˈaku"
pia	pˈia
pōturi	pɔːtˈu"ri
repo	rˈepɔ
rāwhiti	raːfˈiti
titoa	titˈɔa
toroa	tɔrˈɔa
Āti	ˈaːti
Dec	(͡e͡n)dˈiː(͡m͡i) ˈe (͡e͡n)sˈiː(͡m͡i)
Kairangi	ka͡ɪrˈaŋi
MPI	mpˈi
Mahia	mahˈia
Mahuta	mahˈu"ta
Pouaka	pˌou"ˈaka
Puanga	pu"ˈaŋa
Raki	rˈaki
Rangahau	rˌaŋahˈau"
Rere	rˈere
Tangi	tˈaŋi
Tihema	tihˈema
Waitara	wa͡ɪtˈara
ate	ˈate
huarere	hˌu"arˈere
hā	hˈaː
kaitirotiro	kˌa͡ɪtirɔtˈirɔ
kaiwhiwhi	ka͡ɪfˈifi
karahipi	kˌarahˈipi
kauhau	kˌau"hˈau"
kiritaki	kˌiritˈaki
korowai	kɔrˈɔwa͡ɪ
kowhatu	kɔfˈatu"
kōaro	kɔːˈarɔ
kōwhai	kˈɔːfa͡ɪ
kōwhiria	kˌɔːfirˈia
moemoeā	mwemwˈeaː
piriona	pˌiriˈɔna
rae	rˈa͡ɪ
tāhuhu	taːhˈu"hu"
tārua	taːrˈu"a
whakatangi	fˌakatˈaŋi
whakatata	fˌakatˈata
whakatauranga	fˌakatˌau"rˈaŋa
āwhinatia	ˌaːfinatˈia
Apanui	ˌapanˈu"i
Mane	mˈane
Taupō	taˈu"pɔː
Tongarewa	tˌɔŋarˈewa
Tūranga	tu"ːrˈaŋa
an	ˈan
ekenga	ekˈeŋa
horahia	hˌɔrahˈia
huia	hu"ˈia
kaainga	kaˈa͡ɪŋa
kaitito	ka͡ɪtˈitɔ
korokoro	kˌɔrɔkˈɔrɔ
manene	manˈene
matawaka	mˌatawˈaka
mö	mˈɔ
paemahana	pˌa͡ɪmahˈana
perform	p ˈe r (͡e͡n)ˈɛf(͡m͡i) ˈɔ r m
pūwāhi	pu"ːwˈaːhi
raanei	rˌaanˈei
turi	tˈu"ri
uhia	u"hˈia
whakaakona	fˌakaakˈɔna
whakaara	fˌakaˈara
whakakitenga	fˌakakitˈeŋa
whiri	fˈiri
ëtahi	etˈahi
ākona	aːkˈɔna
īnanga	iːnˈaŋa
Aurere	ˌau"rˈere
English	ˈe n (͡e͡n)d͡ʒˈiː ˈɛl(͡m͡i) ˈi (͡e͡n)ˈɛs(͡m͡i) h
Kawekawe	kˌawekˈawe
Kirikiriroa	kˌirikˌirirˈɔa
Kāre	kˈaːre
Maketu	makˈetu"
Ngāpuhi	ŋaːpˈu"hi
Tūmatauenga	tˌu"ːmatˌau"ˈeŋa
hihi	hˈihi
kohuru	kɔhˈu"ru"
kori	kˈɔri
miro	mˈirɔ
māharahara	mˌaːharahˈara
mōkai	mˈɔːka͡ɪ
paheko	pahˈekɔ
paparanga	pˌaparˈaŋa
puru	pˈu"ru"
pānuitia	pˌaːnu"itˈia
pātaka	paːtˈaka
rahui	rahˈu"i
rāhui	raːhˈu"i
taatai	taˈata͡ɪ
tūmataiti	tˌu"ːmatˈa͡ɪti
whakarahi	fˌakarˈahi
whakaraupapa	fˌakarˌau"pˈapa
whutupōro	fˌu"tu"pˈɔːrɔ
History	h ˈi (͡e͡n)ˈɛs(͡m͡i) t ˈɔ r (͡e͡n)wˈa͡ɪ(͡m͡i)
Hopihona	hˌɔpihˈɔna
Kuki	kˈu"ki
Kāwhia	kaːfˈia
Mohi	mˈɔhi
Oranga	ɔrˈaŋa
Simon	(͡e͡n)ˈɛs(͡m͡i) ˈi m ˈɔ n
Tuhoe	tˈu"hwe
Wairoa	wa͡ɪrˈɔa
Whaea	fˈa͡ɪa
korenga	kɔrˈeŋa
meatia	mˌeatˈia
mihingare	mˌihiŋˈare
mē	mˈeː
pūkete	pu"ːkˈete
rapa	rˈapa
rapua	rapˈu"a
tahumaero	tˌahu"mˈa͡ɪrɔ
taupatupatu	tˌau"pˌatu"pˈatu"
toitū	tˈo͡ɪtu"ː
umu	ˈu"mu"
whakawa	fakˈawa
wharekura	fˌarekˈu"ra
whutupaoro	fˌu"tu"pˈa͡ʊrɔ
wāriu	waːrˈiu"
Ano	ˈanɔ
Atawhai	atˈafa͡ɪ
Hune	hˈu"ne
Katoa	katˈɔa
Taitokerau	tˌa͡ɪtɔkerˈau"
Taurangi	tˌau"rˈaŋi
arahi	arˈahi
ena	ˈena
hemo	hˈemɔ
kaihauturu	kˌa͡ɪhau"tˈu"ru"
kainoho	ka͡ɪnˈɔhɔ
kaki	kˈaki
karekau	kˌarekˈau"
kui	kˈu"i
kuku	kˈu"ku"
pitihana	pˌitihˈana
purapura	pˌu"rapˈu"ra
pātara	paːtˈara
pōhēhē	pɔːhˈeːheː
rarangi	rarˈaŋi
tukinga	tu"kˈiŋa
tūmahi	tu"ːmˈahi
tūrangawaewae	tˌu"ːraŋawˈa͡ɪwa͡ɪ
waikano	wa͡ɪkˈanɔ
waikawa	wa͡ɪkˈawa
whakamāramatia	fˌakamˌaːramatˈia
ĀwhinaServices	aːfˈina (͡e͡n)ˈɛs(͡m͡i) ˈe r (͡e͡n)vˈiː(͡m͡i) ˈi (͡e͡n)sˈiː(͡m͡i) ˈe (͡e͡n)ˈɛs(͡m͡i)
ūpoko	u"ːpˈɔkɔ
Chris	(͡e͡n)sˈiː(͡m͡i) h r ˈi (͡e͡n)ˈɛs(͡m͡i)
Ihaka	ihˈaka
Kākano	kaːkˈanɔ
Manawatū	mˌanawˈatu"ː
Mark	mˈark
Motuhake	mˌɔtu"hˈake
Rārangi	raːrˈaŋi
Unit	ˈu"nit
Whakamāramahia	fˌakamˌaːramahˈia
kairangi	ka͡ɪrˈaŋi
karaehe	karˈa͡ɪhe
kauri	kaˈu"ri
kiihia	kˌiihˈia
manako	manˈakɔ
pirangi	pirˈaŋi
poho	pˈɔhɔ
puare	pu"ˈare
pūoro	pu"ːˈɔrɔ
ruma	rˈu"ma
takanga	takˈaŋa
tatū	tˈatu"ː
tuaka	tu"ˈaka
tūhonohono	tˌu"ːhɔnɔhˈɔnɔ
waihoki	wa͡ɪhˈɔki
wananga	wanˈaŋa
whakakorea	fˌakakɔrˈea
whakakorehia	fˌakakˌɔrehˈia
ārainga	aːrˈa͡ɪŋa
Black	(͡e͡n)bˈiː ˈɛl(͡m͡i) ˈa (͡e͡n)sˈiː(͡m͡i) k
Commission	(͡e͡n)sˈiː(͡m͡i) ˈɔ m m ˈi (͡e͡n)ˈɛs ˈɛs(͡m͡i) ˈi ˈɔ n
Komihana	kˌɔmihˈana
Korero	kɔrˈerɔ
Museum	m ˈu" (͡e͡n)ˈɛs(͡m͡i) ˈe ˈu" m
Ta	tˈa
Toko	tˈɔkɔ
Whakaaro	fˌakaˈarɔ
ahuareka	ˌahu"arˈeka
are	ˈare
honohono	hˌɔnɔhˈɔnɔ
kaiwhakamahi	kˌa͡ɪfakamˈahi
koko	kˈɔkɔ
marangai	marˈaŋa͡ɪ
mataara	mˌataˈara
matakitaki	mˌatakitˈaki
memeha	memˈeha
mihini	mihˈini
omaoma	ɔmˈa͡ʊma
oo	ˈɔɔ
paearu	pa͡ɪˈaru"
panga	pˈaŋa
parauri	pˌaraˈu"ri
pirepire	pˌirepˈire
pēwhea	peːfˈea
pūkoro	pu"ːkˈɔrɔ
rawhiti	rafˈiti
rotarota	rˌɔtarˈɔta
tuitui	tˌu"itˈu"i
turoro	tu"rˈɔrɔ
tāpui	taːpˈu"i
waia	wˈa͡ɪa
wetewete	wˌetewˈete
Ae	ˈa͡ɪ
Andrew	ˈa n (͡e͡n)dˈiː(͡m͡i) r ˈe w
Awarua	ˌawarˈu"a
Kōwhiri	kɔːfˈiri
Matiu	matˈiu"
Opotiki	ˌɔpɔtˈiki
Pounamu	pˌou"nˈamu"
Tinirau	tˌinirˈau"
Tongariro	tˌɔŋarˈirɔ
Wairua	wa͡ɪrˈu"a
arai	ˈara͡ɪ
arero	arˈerɔ
ihirangi	ˌihirˈaŋi
kamo	kˈamɔ
makere	makˈere
mautohe	mˌau"tˈɔhe
pakirehua	pˌakirehˈu"a
poka	pˈɔka
poroporoaki	pˌɔrɔpˌɔrɔˈaki
pungarehu	pˌu"ŋarˈehu"
pupū	pˈu"pu"ː
puāwai	pu"ˈaːwa͡ɪ
reorua	rˌeɔrˈu"a
rokohanga	rˌɔkɔhˈaŋa
tauanga	tˌau"ˈaŋa
tirotirohia	tˌirɔtˌirɔhˈia
titi	tˈiti
tāhei	taːhˈei
tāroaroa	tˌaːrɔarˈɔa
tūpato	tu"ːpˈatɔ
whaiwhai	fˈa͡ɪfa͡ɪ
whakaarotia	fˌakaˌarɔtˈia
whakahaerenga	fˌakaha͡ɪrˈeŋa
whakatu	fakˈatu"
whakatūpato	fˌakatu"ːpˈatɔ
whana	fˈana
Brown	(͡e͡n)bˈiː(͡m͡i) r ˈɔ w n
Health	h ˈe ˈa (͡e͡n)ˈɛl(͡m͡i) t h
Ināianei	ˌinaːˌianˈei
Kati	kˈati
Taka	tˈaka
World	w ˈɔ r (͡e͡n)ˈɛl dˈiː(͡m͡i)
hāpori	haːpˈɔri
hōnore	hɔːnˈɔre
ihi	ˈihi
inoi	ˈino͡ɪ
kanae	kˈana͡ɪ
kiripuaki	kˌiripu"ˈaki
koura	koˈu"ra
kīnaki	kiːnˈaki
kīwaha	kiːwˈaha
matatini	mˌatatˈini
mokai	mˈɔka͡ɪ
nawe	nˈawe
nūpepa	nu"ːpˈepa
pani	pˈani
pāremata	pˌaːremˈata
pōtae	pˈɔːta͡ɪ
rironga	rirˈɔŋa
tauranga	tˌau"rˈaŋa
tokowhā	tɔkˈɔfaː
tāpae	tˈaːpa͡ɪ
tūroro	tu"ːrˈɔrɔ
whakaingoa	fˌaka͡ɪŋˈɔa
whakairi	fakˈa͡ɪri
whakama	fakˈama
whakamahana	fˌakamahˈana
whakamanahia	fˌakamˌanahˈia
whakatauhia	fˌakatˌau"hˈia
whiore	fiˈɔre
wātaka	waːtˈaka
Ākarana	ˌaːkarˈana
ākau	aːkˈau"
Bill	(͡e͡n)bˈiː(͡m͡i) ˈi (͡e͡n)ˈɛl ˈɛl(͡m͡i)
Hongoeka	hɔŋwˈeka
Kōwhiringa	kˌɔːfirˈiŋa
Ms	m(͡e͡n)ˈɛs(͡m͡i)
Otiia	ˌɔtiˈia
Poutini	pˌou"tˈini
Rehua	rehˈu"a
Tairāwhiti	tˌa͡ɪraːfˈiti
Tētahi	teːtˈahi
aahua	ˌaahˈu"a
huaki	hu"ˈaki
hūnuku	hu"ːnˈu"ku"
kaikawe	ka͡ɪkˈawe
kirikiri	kˌirikˈiri
kooti	kɔˈɔti
kuraina	ku"rˈa͡ɪna
kāwana	kaːwˈana
mokemoke	mˌɔkemˈɔke
nohoia	nɔhˈo͡ɪa
pātuhi	paːtˈu"hi
pīni	pˈiːni
pūtoru	pu"ːtˈɔru"
tahitia	tˌahitˈia
taiepa	ta͡ɪˈepa
takere	takˈere
tiwhikete	tˌifikˈete
tutaki	tu"tˈaki
wahie	wahˈie
waiatatia	wˌa͡ɪatatˈia
whaimana	fa͡ɪmˈana
whakawakanga	fˌakawakˈaŋa
Āniwaniwa	ˌaːniwanˈiwa
ātea	aːtˈea
Hanuere	hˌanu"ˈere
Hauauru	hˌau"aˈu"ru"
High	h ˈi (͡e͡n)d͡ʒˈiː(͡m͡i) h
Hiko	hˈikɔ
Hone	hˈɔne
Kapiti	kapˈiti
MP	mp
Maru	mˈaru"
Mua	mˈu"a
Paerewa	pa͡ɪrˈewa
Wales	w ˈa (͡e͡n)ˈɛl(͡m͡i) ˈe (͡e͡n)ˈɛs(͡m͡i)
Wenerei	wˌenerˈei
Whāinga	faːˈiŋa
aituā	a͡ɪtˈu"aː
heketea	hˌeketˈea
kaihoe	kˈa͡ɪhwe
karihi	karˈihi
keke	kˈeke
kereru	kerˈeru"
korikori	kˌɔrikˈɔri
manaakitia	mˌanaˌakitˈia
mimiti	mimˈiti
mōkihi	mɔːkˈihi
ngaki	ŋˈaki
ngarara	ŋarˈara
paura	paˈu"ra
putake	pu"tˈake
rereketanga	rˌereketˈaŋa
rita	rˈita
rokiroki	rˌɔkirˈɔki
rīpoata	rˌiːpɔˈata
tahaki	tahˈaki
teka	tˈeka
that	thˈat
tukino	tu"kˈinɔ
tupato	tu"pˈatɔ
tëtahi	tetˈahi
tūhuratanga	tˌu"ːhu"ratˈaŋa
whainga	fˈa͡ɪŋa
whakahoahoa	fˌakahˌɔahˈɔa
whakamutu	fˌakamˈu"tu"
whakaongaonga	fˌaka͡ʊŋˈa͡ʊŋa
whakawehe	fˌakawˈehe
whangai	fˈaŋa͡ɪ
Āpiha	aːpˈiha
Āwhina	aːfˈina
Charles	(͡e͡n)sˈiː(͡m͡i) h ˈa r (͡e͡n)ˈɛl(͡m͡i) ˈe (͡e͡n)ˈɛs(͡m͡i)
Kahurangi	kˌahu"rˈaŋi
Matū	mˈatu"ː
Nelson	n ˈe (͡e͡n)ˈɛl ˈɛs(͡m͡i) ˈɔ n
Park	pˈark
Poutama	pˌou"tˈama
Pērā	pˈeːraː
Pū	pˈu"ː
Tauiwi	tˌau"ˈiwi
Tokomaru	tˌɔkɔmˈaru"
Whanau	fanˈau"
ahatia	ˌahatˈia
anuhe	anˈu"he
as	ˈa (͡e͡n)ˈɛs(͡m͡i)
etehi	etˈehi
hi	hˈi
hokowhitu	hˌɔkɔfˈitu"
manga	mˈaŋa
papaki	papˈaki
poua	poˈu"a
rare	rˈare
rourou	rˌou"rˈou"
rāwaho	raːwˈahɔ
tatauria	tˌatau"rˈia
tautokohia	tˌau"tˌɔkɔhˈia
tawahi	tawˈahi
tereina	tˌereˈina
tia	tˈia
tonutanga	tˌɔnu"tˈaŋa
tuatahitia	tˌu"atˌahitˈia
waituhi	wa͡ɪtˈu"hi
waro	wˈarɔ
whaitua	fa͡ɪtˈu"a
whakatauki	fˌakataˈu"ki
whakautua	fˌakau"tˈu"a
whakawātea	fˌakawaːtˈea
whānautanga	fˌaːnau"tˈaŋa
whētui	feːtˈu"i
Ōtaki	ɔːtˈaki
C	(͡e͡n)sˈiː(͡m͡i)
Heoti	heˈɔti
Huia	hu"ˈia
Iti	ˈiti
Journal	(͡e͡n)d͡ʒˈe͡ɪ(͡m͡i) ˈɔ ˈu" r n ˈa (͡e͡n)ˈɛl(͡m͡i)
Karaitiana	kˌara͡ɪtiˈana
Kitea	kitˈea
Kāpiti	kaːpˈiti
Mea	mˈea
Nationals	n ˈa t ˈi ˈɔ n ˈa (͡e͡n)ˈɛl ˈɛs(͡m͡i)
Navigation	n ˈa (͡e͡n)vˈiː(͡m͡i) ˈi (͡e͡n)d͡ʒˈiː(͡m͡i) ˈa t ˈi ˈɔ n
Nov	n ˈɔ (͡e͡n)vˈiː(͡m͡i)
Pasifika	p ˈa (͡e͡n)ˈɛs(͡m͡i) ˈi (͡e͡n)ˈɛf(͡m͡i) ˈi k ˈa
Rangahautia	rˌaŋahˌau"tˈia
Ross	r ˈɔ (͡e͡n)ˈɛs ˈɛs(͡m͡i)
Urewera	ˌu"rewˈera
about	ˈa (͡e͡n)bˈiː(͡m͡i) ˈɔ ˈu" t
aronui	ˌarɔnˈu"i
be	(͡e͡n)bˈiː(͡m͡i) ˈe
ix	ˈi (͡e͡n)ˈɛks(͡m͡i)
keehi	keˈehi
motopaika	mˌɔtɔpˈa͡ɪka
ngâ	ŋˈa
nona	nˈɔna
nēhi	nˈeːhi
ohotata	ˌɔhɔtˈata
okioki	ˌɔkiˈɔki
pona	pˈɔna
pooti	pɔˈɔti
rino	rˈinɔ
ruia	ru"ˈia
story	(͡e͡n)ˈɛs(͡m͡i) t ˈɔ r (͡e͡n)wˈa͡ɪ(͡m͡i)
takahanga	tˌakahˈaŋa
torotika	tˌɔrɔtˈika
tāngia	taːŋˈia
tārai	tˈaːra͡ɪ
uauatanga	ˌu"aˌu"atˈaŋa
whakamarumaru	fˌakamˌaru"mˈaru"
whakamaua	fˌakamaˈu"a
whakaminenga	fˌakaminˈeŋa
whakamoemiti	fˌakamwemˈiti
whakarawe	fˌakarˈawe
whakarerea	fˌakarerˈea
whakarērea	fˌakareːrˈea
whakawā	fakˈawaː
Ōtākou	ˌɔːtaːkˈou"
David	(͡e͡n)dˈiː(͡m͡i) ˈa (͡e͡n)vˈiː(͡m͡i) ˈi (͡e͡n)dˈiː(͡m͡i)
Henry	h ˈe n r (͡e͡n)wˈa͡ɪ(͡m͡i)
Hāmoa	haːmˈɔa
Hōne	hˈɔːne
Hūrae	hˈu"ːra͡ɪ
Irirangi	ˌirirˈaŋi
Katorika	kˌatɔrˈika
Kawerau	kˌawerˈau"
Korimako	kˌɔrimˈakɔ
Kāreti	kaːrˈeti
Rāwhitiroa	rˌaːfitirˈɔa
Rāwiri	raːwˈiri
Tangohia	tˌaŋɔhˈia
Tumu	tˈu"mu"
Whiro	fˈirɔ
Whātua	faːtˈu"a
Wilson	w ˈi (͡e͡n)ˈɛl ˈɛs(͡m͡i) ˈɔ n
aitanga	a͡ɪtˈaŋa
haepapa	ha͡ɪpˈapa
hakari	hakˈari
hihiri	hihˈiri
huakita	hˌu"akˈita
kaimoana	kˌa͡ɪmɔˈana
kari	kˈari
mangai	mˈaŋa͡ɪ
manuka	manˈu"ka
matawhānui	mˌatafaːnˈu"i
maui	maˈu"i
mena	mˈena
moku	mˈɔku"
māku	mˈaːku"
nanakia	nˌanakˈia
ngata	ŋˈata
pane	pˈane
penapena	pˌenapˈena
pōro	pˈɔːrɔ
rätou	ratˈou"
their	thˈeir
tote	tˈɔte
tuanui	tˌu"anˈu"i
tāra	tˈaːra
tī	tˈiː
tītī	tˈiːtiː
waiwai	wˈa͡ɪwa͡ɪ
whakaaroaro	fˌakaˌarɔˈarɔ
whakamataku	fˌakamatˈaku"
whakaoranga	fˌaka͡ʊrˈaŋa
whakawhanakehia	fˌakafˌanakehˈia
Āpirana	ˌaːpirˈana
Ahuriri	ˌahu"rˈiri
For	(͡e͡n)ˈɛf(͡m͡i) ˈɔ r
Hamilton	h ˈa m ˈi (͡e͡n)ˈɛl(͡m͡i) t ˈɔ n
Paremata	pˌaremˈata
Puta	pˈu"ta
Raumati	rˌau"mˈati
Tāwhirimātea	tˌaːfirˌimaːtˈea
arahina	ˌarahˈina
arohaehae	ˌarɔhˈa͡ɪha͡ɪ
heihei	hˌeihˈei
henemita	hˌenemˈita
it	ˈit
kanga	kˈaŋa
kingi	kˈiŋi
kohikohinga	kˌɔhikɔhˈiŋa
maranga	marˈaŋa
mirumiru	mˌiru"mˈiru"
morehu	mɔrˈehu"
mātaitai	maːtˈa͡ɪta͡ɪ
mātaki	maːtˈaki
ngaarara	ŋˌaarˈara
pakiaka	pˌakiˈaka
papatipu	pˌapatˈipu"
paremata	pˌaremˈata
poropiti	pˌɔrɔpˈiti
pītara	piːtˈara
pūrua	pu"ːrˈu"a
tauākī	tˌau"ˈaːkiː
tio	tˈiɔ
totoka	tɔtˈɔka
unahi	u"nˈahi
whakaarahia	fˌakaˌarahˈia
whakahe	fakˈahe
whakamahara	fˌakamahˈara
whitinga	fitˈiŋa
ACET	ˈa (͡e͡n)sˈiː(͡m͡i) ˈe t
Alexander	ˈa (͡e͡n)ˈɛl(͡m͡i) ˈe (͡e͡n)ˈɛks(͡m͡i) ˈa n (͡e͡n)dˈiː(͡m͡i) ˈe r
HPV	hp(͡e͡n)vˈiː(͡m͡i)
Islands	ˈi (͡e͡n)ˈɛs ˈɛl(͡m͡i) ˈa n (͡e͡n)dˈiː ˈɛs(͡m͡i)
Kawiti	kawˈiti
Pakihi	pakˈihi
Piki	pˈiki
Roopu	rɔˈɔpu"
Royal	r ˈɔ (͡e͡n)wˈa͡ɪ(͡m͡i) ˈa (͡e͡n)ˈɛl(͡m͡i)
Tamanuiterā	tˌamanˌu"itˈeraː
Tiamana	tˌiamˈana
Tūhuratia	tˌu"ːhu"ratˈia
Uru	ˈu"ru"
Whakapā	fakˈapaː
aranga	arˈaŋa
hitori	hitˈɔri
huakina	hˌu"akˈina
hāereere	hˌaːereˈere
kererū	kerˈeru"ː
kākāriki	kˌaːkaːrˈiki
motoka	mɔtˈɔka
mätauranga	mˌatau"rˈaŋa
pangia	paŋˈia
pauna	paˈu"na
pānuihia	pˌaːnu"ihˈia
stories	(͡e͡n)ˈɛs(͡m͡i) t ˈɔ r ˈi ˈe (͡e͡n)ˈɛs(͡m͡i)
taimaha	ta͡ɪmˈaha
toronga	tɔrˈɔŋa
tupeka	tu"pˈeka
tāpiritia	tˌaːpiritˈia
tātaki	taːtˈaki
tāutuhia	tˌaːu"tu"hˈia
tēra	tˈeːra
viii	(͡e͡n)vˈiː(͡m͡i) ˈi ˈi ˈi
whakamanaia	fˌakamanˈa͡ɪa
whakamatau	fˌakamatˈau"
whakamāoritanga	fˌakamˌaːɔritˈaŋa
whakararu	fˌakarˈaru"
whakareatia	fˌakarˌeatˈia
whakatauria	fˌakatˌau"rˈia
whakatūnga	fˌakatˈu"ːŋa
whakaurunga	fˌakau"rˈu"ŋa
whakawhitia	fˌakafitˈia
āporo	aːpˈɔrɔ
Battalion	(͡e͡n)bˈiː(͡m͡i) ˈa t t ˈa (͡e͡n)ˈɛl(͡m͡i) ˈi ˈɔ n
Centre	(͡e͡n)sˈiː(͡m͡i) ˈe n t r ˈe
Christchurch	(͡e͡n)sˈiː(͡m͡i) h r ˈi (͡e͡n)ˈɛs(͡m͡i) t (͡e͡n)sˈiː(͡m͡i) h ˈu" r (͡e͡n)sˈiː(͡m͡i) h
Hana	hˈana
Hononga	hɔnˈɔŋa
House	h ˈɔ ˈu" (͡e͡n)ˈɛs(͡m͡i) ˈe
Hānuere	hˌaːnu"ˈere
Moriori	mˌɔriˈɔri
Māngai	mˈaːŋa͡ɪ
Ngoi	ŋˈo͡ɪ
Pakiwaitara	pˌakiwa͡ɪtˈara
Rangatiratanga	rˌaŋatˌiratˈaŋa
Ropu	rˈɔpu"
Tahiti	tahˈiti
Tautake	tˌau"tˈake
Toku	tˈɔku"
Version	(͡e͡n)vˈiː(͡m͡i) ˈe r (͡e͡n)ˈɛs(͡m͡i) ˈi ˈɔ n
Waru	wˈaru"
Whakaputanga	fˌakapu"tˈaŋa
Wikitōria	wˌikitɔːrˈia
haruru	harˈu"ru"
hawhe	hˈafe
kawenata	kˌawenˈata
keri	kˈeri
maakete	mˌaakˈete
maatou	mˌaatˈou"
mārika	maːrˈika
patunga	patˈu"ŋa
pihikete	pˌihikˈete
piko	pˈikɔ
poupou	pˌou"pˈou"
rapunga	rapˈu"ŋa
region	r ˈe (͡e͡n)d͡ʒˈiː(͡m͡i) ˈi ˈɔ n
rōpu	rˈɔːpu"
takotoranga	tˌakɔtɔrˈaŋa
tokorima	tˌɔkɔrˈima
tunua	tu"nˈu"a
tōraro	tɔːrˈarɔ
video	(͡e͡n)vˈiː(͡m͡i) ˈi (͡e͡n)dˈiː(͡m͡i) ˈe ˈɔ
whakamanatia	fˌakamˌanatˈia
whakaoho	fakˈa͡ʊhɔ
whakapuakina	fˌakapˌu"akˈina
whakawehi	fˌakawˈehi
whata	fˈata
whāriki	faːrˈiki
Ūpoko	u"ːpˈɔkɔ
ūngeri	u"ːŋˈeri
Canterbury	(͡e͡n)sˈiː(͡m͡i) ˈa n t ˈe r (͡e͡n)bˈiː(͡m͡i) ˈu" r (͡e͡n)wˈa͡ɪ(͡m͡i)
Hēmi	hˈeːmi
Ihipa	ihˈipa
Manawa	manˈawa
Mrs	mr(͡e͡n)ˈɛs(͡m͡i)
Naku	nˈaku"
Nama	nˈama
One	ˈɔne
Pari	pˈari
Pewhairangi	pˌefa͡ɪrˈaŋi
Pātai	pˈaːta͡ɪ
Resource	r ˈe (͡e͡n)ˈɛs(͡m͡i) ˈɔ ˈu" r (͡e͡n)sˈiː(͡m͡i) ˈe
Street	(͡e͡n)ˈɛs(͡m͡i) t r ˈe ˈe t
What	fˈat
angitū	aŋˈitu"ː
hiakai	hiˈaka͡ɪ
kaingākau	kˌa͡ɪŋaːkˈau"
kaipatu	ka͡ɪpˈatu"
karaihe	karˈa͡ɪhe
kīrehe	kiːrˈehe
matakite	mˌatakˈite
meinga	meˈiŋa
muru	mˈu"ru"
mä	mˈa
naianei	nˌa͡ɪanˈei
naku	nˈaku"
niupepa	nˌiu"pˈepa
paipa	pˈa͡ɪpa
piriti	pirˈiti
piro	pˈirɔ
published	p ˈu" (͡e͡n)bˈiː ˈɛl(͡m͡i) ˈi (͡e͡n)ˈɛs(͡m͡i) h ˈe (͡e͡n)dˈiː(͡m͡i)
pātītī	paːtˈiːtiː
taihoa	ta͡ɪhˈɔa
taokete	ta͡ʊkˈete
waatea	wˌaatˈea
whakamāoritia	fˌakamˌaːɔritˈia
whakaruruhau	fˌakarˌu"ru"hˈau"
whakawhetai	fˌakafˈeta͡ɪ
wheua	feˈu"a
wē	wˈeː
you	(͡e͡n)wˈa͡ɪ(͡m͡i) ˈɔ ˈu"
Ahu	ˈahu"
Aotea	a͡ʊtˈea
June	(͡e͡n)d͡ʒˈe͡ɪ(͡m͡i) ˈu" n ˈe
Kae	kˈa͡ɪ
Kawenata	kˌawenˈata
Koroni	kɔrˈɔni
Mahuika	mˌahu"ˈika
Mārama	maːrˈama
NCEA	n (͡e͡n)sˈiː(͡m͡i) ˈe ˈa
Peretānia	pˌeretaːnˈia
Pūtea	pu"ːtˈea
Tāpiripiri	tˌaːpiripˈiri
Tāpiritanga	tˌaːpiritˈaŋa
Wherowhero	fˌerɔfˈerɔ
anei	anˈei
anōtia	ˌanɔːtˈia
hae	hˈa͡ɪ
hangai	hˈaŋa͡ɪ
hapai	hˈapa͡ɪ
hauota	hˌau"ˈɔta
kiromita	kˌirɔmˈita
kuhuna	ku"hˈu"na
kīngi	kˈiːŋi
kōhao	kˈɔːha͡ʊ
mahanga	mahˈaŋa
moheni	mɔhˈeni
motumotu	mˌɔtu"mˈɔtu"
mārire	maːrˈire
ohaoha	ɔhˈa͡ʊha
pipi	pˈipi
ranga	rˈaŋa
raupapatanga	rˌau"pˌapatˈaŋa
rongohia	rˌɔŋɔhˈia
rōpinepine	rˌɔːpinepˈine
this	t h ˈi (͡e͡n)ˈɛs(͡m͡i)
tuarā	tu"ˈaraː
tui	tˈu"i
tukituki	tˌu"kitˈu"ki
tuumomo	tˌu"u"mˈɔmɔ
tōpito	tɔːpˈitɔ
whaka	fˈaka
whakahiato	fˌakahiˈatɔ
whakapaetia	fˌakapa͡ɪtˈia
Akoranga	ˌakɔrˈaŋa
Biography	(͡e͡n)bˈiː(͡m͡i) ˈi ˈɔ (͡e͡n)d͡ʒˈiː(͡m͡i) r ˈa p h (͡e͡n)wˈa͡ɪ(͡m͡i)
Central	(͡e͡n)sˈiː(͡m͡i) ˈe n t r ˈa (͡e͡n)ˈɛl(͡m͡i)
Hoko	hˈɔkɔ
Iharaira	ˌiharˈa͡ɪra
International	ˈi n t ˈe r n ˈa t ˈi ˈɔ n ˈa (͡e͡n)ˈɛl(͡m͡i)
July	(͡e͡n)d͡ʒˈe͡ɪ(͡m͡i) ˈu" (͡e͡n)ˈɛl wˈa͡ɪ(͡m͡i)
Makaawhio	mˌakaafˈiɔ
Martin	mˈartin
Matau	matˈau"
Paetae	pˈa͡ɪta͡ɪ
Paul	p ˈa ˈu" (͡e͡n)ˈɛl(͡m͡i)
Pei	pˈei
Pepuere	pˌepu"ˈere
Purapura	pˌu"rapˈu"ra
Pāho	pˈaːhɔ
Rangitukutuku	rˌaŋitˌu"ku"tˈu"ku"
Roa	rˈɔa
Ruru	rˈu"ru"
Tame	tˈame
Wera	wˈera
Whakatāne	fˌakatˈaːne
arohia	ˌarɔhˈia
awangawanga	ˌawaŋawˈaŋa
haunga	haˈu"ŋa
hura	hˈu"ra
hōiho	hɔːˈihɔ
kaitakaro	kˌa͡ɪtakˈarɔ
koroheke	kˌɔrɔhˈeke
kōawa	kɔːˈawa
kōharinga	kˌɔːharˈiŋa
language	(͡e͡n)ˈɛl(͡m͡i) ˈa n (͡e͡n)d͡ʒˈiː(͡m͡i) ˈu" ˈa (͡e͡n)d͡ʒˈiː(͡m͡i) ˈe
maka	mˈaka
mama	mˈama
matimati	mˌatimˈati
moemoea	mwemwˈea
paihikara	pˌa͡ɪhikˈara
purei	pu"rˈei
raukura	rˌau"kˈu"ra
ririki	rirˈiki
ruihi	ru"ˈihi
rōnaki	rɔːnˈaki
speaks	(͡e͡n)ˈɛs(͡m͡i) p ˈe ˈa k (͡e͡n)ˈɛs(͡m͡i)
taitama	ta͡ɪtˈama
tapuwae	tapˈu"wa͡ɪ
tauaromahi	tˌau"ˌarɔmˈahi
tinihanga	tˌinihˈaŋa
turakina	tˌu"rakˈina
tātaitanga	tˌaːta͡ɪtˈaŋa
whakaea	fakˈa͡ɪa
whakarereke	fˌakarerˈeke
whitianga	fˌitiˈaŋa
āpōpō	aːpˈɔːpɔː
Hami	hˈami
Kahukura	kˌahu"kˈu"ra
Kaihauturu	kˌa͡ɪhau"tˈu"ru"
Kaipara	ka͡ɪpˈara
Kawakawa	kˌawakˈawa
Mauri	maˈu"ri
Murray	m ˈu" r r ˈa (͡e͡n)wˈa͡ɪ(͡m͡i)
Nash	n ˈa (͡e͡n)ˈɛs(͡m͡i) h
Onehunga	ˌɔnehˈu"ŋa
Pānuihia	pˌaːnu"ihˈia
Pūrongo	pu"ːrˈɔŋɔ
Ra	rˈa
Robert	r ˈɔ (͡e͡n)bˈiː(͡m͡i) ˈe r t
Schools	(͡e͡n)ˈɛs sˈiː(͡m͡i) h ˈɔ ˈɔ (͡e͡n)ˈɛl ˈɛs(͡m͡i)
Service	(͡e͡n)ˈɛs(͡m͡i) ˈe r (͡e͡n)vˈiː(͡m͡i) ˈi (͡e͡n)sˈiː(͡m͡i) ˈe
Tāwhiao	taːfˈia͡ʊ
Whakatū	fakˈatu"ː
first	(͡e͡n)ˈɛf(͡m͡i) ˈi r (͡e͡n)ˈɛs(͡m͡i) t
hauauru	hˌau"aˈu"ru"
hauhā	haˈu"haː
hikoi	hˈiko͡ɪ
inea	inˈea
kaiwhaiwhai	ka͡ɪfˈa͡ɪfa͡ɪ
korekore	kˌɔrekˈɔre
mahitahi	mˌahitˈahi
maramataka	mˌaramatˈaka
miramira	mˌiramˈira
mou	mˈou"
nohonga	nɔhˈɔŋa
noke	nˈɔke
pahū	pˈahu"ː
popo	pˈɔpɔ
pāhekoheko	pˌaːhekɔhˈekɔ
pēhi	pˈeːhi
pēne	pˈeːne
rangimārie	rˌaŋimaːrˈie
rango	rˈaŋɔ
ruahine	rˌu"ahˈine
rīwai	rˈiːwa͡ɪ
taparau	tˌaparˈau"
tarutaru	tˌaru"tˈaru"
taurekareka	tˌau"rˌekarˈeka
tautuhia	tˌau"tu"hˈia
whakahoutia	fˌakahˌou"tˈia
whakarara	fˌakarˈara
whakarāpopoto	fˌakarˌaːpɔpˈɔtɔ
whakawhānau	fˌakafaːnˈau"
wharekai	farˈeka͡ɪ
whiria	firˈia
ä	(͡e͡n)ˌe͡ɪˈʊmla͡ʊt(͡m͡i)
Ake	ˈake
Back	(͡e͡n)bˈiː(͡m͡i) ˈa (͡e͡n)sˈiː(͡m͡i) k
Dunedin	(͡e͡n)dˈiː(͡m͡i) ˈu" n ˈe (͡e͡n)dˈiː(͡m͡i) ˈi n
Hori	hˈɔri
Irawaru	ˌirawˈaru"
Michael	m ˈi (͡e͡n)sˈiː(͡m͡i) h ˈa ˈe (͡e͡n)ˈɛl(͡m͡i)
Moe	mwˈe
Moutere	mˌou"tˈere
Ngatoro	ŋatˈɔrɔ
Rangihaeata	rˌaŋiha͡ɪˈata
Research	r ˈe (͡e͡n)ˈɛs(͡m͡i) ˈe ˈa r (͡e͡n)sˈiː(͡m͡i) h
Rewi	rˈewi
Rukuwai	ru"kˈu"wa͡ɪ
Sergeant	(͡e͡n)ˈɛs(͡m͡i) ˈe r (͡e͡n)d͡ʒˈiː(͡m͡i) ˈe ˈa n t
Takurua	tˌaku"rˈu"a
Taniwha	tanˈifa
Whakaarohia	fˌakaˌarɔhˈia
Wharekauri	fˌarekaˈu"ri
White	fˈite
Wāhi	wˈaːhi
anahe	anˈahe
haupū	haˈu"pu"ː
hohou	hɔhˈou"
hāngī	hˈaːŋiː
kaiwaiata	kˌa͡ɪwa͡ɪˈata
kauwhau	kˌau"fˈau"
kohu	kˈɔhu"
mare	mˈare
marie	marˈie
matemate	mˌatemˈate
ngētehi	ŋeːtˈehi
paheke	pahˈeke
pao	pˈa͡ʊ
paua	paˈu"a
pātapa	paːtˈapa
pī	pˈiː
rangahautanga	rˌaŋahˌau"tˈaŋa
raupatutia	rˌau"pˌatu"tˈia
talks	t ˈa (͡e͡n)ˈɛl(͡m͡i) k (͡e͡n)ˈɛs(͡m͡i)
taona	tˈa͡ʊna
tohora	tɔhˈɔra
toia	tˈo͡ɪa
tātaitai	taːtˈa͡ɪta͡ɪ
tōnā	tˈɔːnaː
tūtū	tˈu"ːtu"ː
uniana	ˌu"niˈana
waiora	wa͡ɪˈɔra
was	w ˈa (͡e͡n)ˈɛs(͡m͡i)
whakaawe	fˌakaˈawe
whakangaro	fˌakaŋˈarɔ
whakatangitangi	fˌakatˌaŋitˈaŋi
whakauruhia	fˌakaˌu"ru"hˈia
whakawhiwhi	fˌakafˈifi
wikitoria	wˌikitɔrˈia
ākina	aːkˈina
Ahi	ˈahi
Association	ˈa (͡e͡n)ˈɛs ˈɛs(͡m͡i) ˈɔ (͡e͡n)sˈiː(͡m͡i) ˈi ˈa t ˈi ˈɔ n
Aute	aˈu"te
Fiordland	(͡e͡n)ˈɛf(͡m͡i) ˈi ˈɔ r (͡e͡n)dˈiː ˈɛl(͡m͡i) ˈa n (͡e͡n)dˈiː(͡m͡i)
Hai	hˈa͡ɪ
Hau	hˈau"
Hurinui	hˌu"rinˈu"i
King	kˈiŋ
Mātaiako	mˌaːta͡ɪˈakɔ
Nuku	nˈu"ku"
Press	p r ˈe (͡e͡n)ˈɛs ˈɛs(͡m͡i)
Pōmare	pɔːmˈare
Ringatū	riŋˈatu"ː
Rānana	raːnˈana
Tairawhiti	tˌa͡ɪrafˈiti
Taraipiunara	tˌara͡ɪpˌiu"nˈara
Tukutuku	tˌu"ku"tˈu"ku"
Tuwharetoa	tˌu"faretˈɔa
Whakahoki	fˌakahˈɔki
awaawa	ˌawaˈawa
haeretia	hˌa͡ɪretˈia
hu	hˈu"
hātepe	haːtˈepe
kaiarahi	kˌa͡ɪarˈahi
kao	kˈa͡ʊ
kaupeka	kˌau"pˈeka
koinā	kˈo͡ɪnaː
koiwi	kˈo͡ɪwi
korerohia	kˌɔrerɔhˈia
korerorero	kˌɔrerɔrˈerɔ
koreutu	kˌɔreˈu"tu"
marire	marˈire
murua	mu"rˈu"a
mākete	maːkˈete
pokohiwi	pˌɔkɔhˈiwi
pōtitia	pˌɔːtitˈia
rawakore	rˌawakˈɔre
tahatika	tˌahatˈika
tapanga	tapˈaŋa
tipua	tipˈu"a
tuarima	tˌu"arˈima
tuhituhia	tˌu"hitu"hˈia
tēna	tˈeːna
tūpāpaku	tˌu"ːpaːpˈaku"
waiu	wˈa͡ɪu"
watea	watˈea
whakairia	fˌaka͡ɪrˈia
whakamīharo	fˌakamiːhˈarɔ
whakatuwheratanga	fˌakatˌu"feratˈaŋa
whāea	faːˈea
Ahurei	ˌahu"rˈei
Akuhata	ˌaku"hˈata
Home	hˈɔme
Hōri	hˈɔːri
Inia	inˈia
Melbourne	m ˈe (͡e͡n)ˈɛl bˈiː(͡m͡i) ˈɔ ˈu" r n ˈe
Māmā	mˈaːmaː
Nu	nˈu"
Our	ˈou"r
Paikea	pa͡ɪkˈea
Paora	pˈa͡ʊra
Pāpāho	paːpˈaːhɔ
Rawa	rˈawa
Rawiri	rawˈiri
Rēkohu	reːkˈɔhu"
Shane	(͡e͡n)ˈɛs(͡m͡i) h ˈa n ˈe
Tatau	tatˈau"
Tomo	tˈɔmɔ
Tāpiri	taːpˈiri
Whiriwhiria	fˌirifirˈia
Whā	fˈaː
available	ˈa (͡e͡n)vˈiː(͡m͡i) ˈa ˈi (͡e͡n)ˈɛl(͡m͡i) ˈa (͡e͡n)bˈiː ˈɛl(͡m͡i) ˈe
awheawhe	ˌafeˈafe
hauā	haˈu"aː
heru	hˈeru"
hukarere	hˌu"karˈere
io	ˈiɔ
itiiti	ˌitiˈiti
kaiwhakaatu	kˌa͡ɪfakaˈatu"
kātua	kaːtˈu"a
loan	(͡e͡n)ˈɛl(͡m͡i) ˈɔ ˈa n
mihimihi	mˌihimˈihi
ngaua	ŋaˈu"a
nāwai	nˈaːwa͡ɪ
ohanga	ɔhˈaŋa
ohu	ˈɔhu"
peia	peˈia
pihi	pˈihi
puhia	pu"hˈia
pēpē	pˈeːpeː
rano	rˈanɔ
rīhi	rˈiːhi
taetae	tˈa͡ɪta͡ɪ
tanumia	tˌanu"mˈia
tauparapara	tˌau"pˌarapˈara
taupānga	tˌau"pˈaːŋa
tuemi	tu"ˈemi
tōpū	tˈɔːpu"ː
whakaemi	fakˈa͡ɪmi
whakamiharo	fˌakamihˈarɔ
whakaraerae	fˌakarˈa͡ɪra͡ɪ
whakawai	fakˈawa͡ɪ
wāwāhitanga	wˌaːwaːhitˈaŋa
Āhua	aːhˈu"a
Advanced	ˈa (͡e͡n)dˈiː vˈiː(͡m͡i) ˈa n (͡e͡n)sˈiː(͡m͡i) ˈe (͡e͡n)dˈiː(͡m͡i)
Anga	ˈaŋa
Cliff	(͡e͡n)sˈiː ˈɛl(͡m͡i) ˈi (͡e͡n)ˈɛf ˈɛf(͡m͡i)
Haratua	hˌaratˈu"a
Herewini	hˌerewˈini
Ihu	ˈihu"
Ira	ˈira
Karahipi	kˌarahˈipi
Karaka	karˈaka
Māku	mˈaːku"
Nanny	n ˈa n n (͡e͡n)wˈa͡ɪ(͡m͡i)
Papahurihia	pˌapahˌu"rihˈia
Patāriana	pˌataːriˈana
Poihākena	pˌo͡ɪhaːkˈena
Pāpā	pˈaːpaː
Radio	r ˈa (͡e͡n)dˈiː(͡m͡i) ˈi ˈɔ
Taketake	tˌaketˈake
Takoto	takˈɔtɔ
Tamaiti	tamˈa͡ɪti
Teacher	t ˈe ˈa (͡e͡n)sˈiː(͡m͡i) h ˈe r
This	t h ˈi (͡e͡n)ˈɛs(͡m͡i)
Tiki	tˈiki
Toru	tˈɔru"
Tātou	taːtˈou"
War	wˈar
Wā	wˈaː
Wīwī	wˈiːwiː
aorangi	a͡ʊrˈaŋi
has	h ˈa (͡e͡n)ˈɛs(͡m͡i)
haumanu	hˌau"mˈanu"
hautekau	hˌau"tekˈau"
hākona	haːkˈɔna
hāngi	hˈaːŋi
kaupapahere	kˌau"pˌapahˈere
kuare	ku"ˈare
manomano	mˌanɔmˈanɔ
mapi	mˈapi
marara	marˈara
ngaku	ŋˈaku"
panaia	panˈa͡ɪa
parakuihi	pˌaraku"ˈihi
pare	pˈare
pikitanga	pˌikitˈaŋa
potiki	pɔtˈiki
purua	pu"rˈu"a
pāhotanga	pˌaːhɔtˈaŋa
pātene	paːtˈene
ro	rˈɔ
rātaka	raːtˈaka
tapere	tapˈere
tatai	tˈata͡ɪ
tauhohe	tˌau"hˈɔhe
taunekeneke	tˌau"nˌekenˈeke
taurewa	tˌau"rˈewa
titonga	titˈɔŋa
tohi	tˈɔhi
torongū	tɔrˈɔŋu"ː
tënei	tenˈei
tāruarua	tˌaːru"arˈu"a
tēina	teːˈina
tūkino	tu"ːkˈinɔ
whakaarotanga	fˌakaˌarɔtˈaŋa
whakaekenga	fˌaka͡ɪkˈeŋa
whakarāpopototanga	fˌakarˌaːpɔpˌɔtɔtˈaŋa
whakatuwheratia	fˌakatˌu"feratˈia
ārahina	ˌaːrahˈina
Airani	a͡ɪrˈani
Aratakina	ˌaratakˈina
Ati	ˈati
Group	(͡e͡n)d͡ʒˈiː(͡m͡i) r ˈɔ ˈu" p
Hanga	hˈaŋa
Hemi	hˈemi
Hikurangi	hˌiku"rˈaŋi
Ingarani	ˌiŋarˈani
Jason	(͡e͡n)d͡ʒˈe͡ɪ(͡m͡i) ˈa (͡e͡n)ˈɛs(͡m͡i) ˈɔ n
Kaa	kˈaa
Kī	kˈiː
Manukau	mˌanu"kˈau"
Maoritanga	mˌa͡ʊritˈaŋa
Maungapōhatu	mˌau"ŋˌapɔːhˈatu"
More	mˈɔre
Māu	mˈaːu"
Pōtae	pˈɔːta͡ɪ
Pūhipi	pu"ːhˈipi
Pūtahi	pu"ːtˈahi
Taiwhanga	ta͡ɪfˈaŋa
Tarawera	tˌarawˈera
Toitū	tˈo͡ɪtu"ː
Tokorua	tˌɔkɔrˈu"a
Walker	w ˈa (͡e͡n)ˈɛl(͡m͡i) k ˈe r
Whakaritenga	fˌakaritˈeŋa
Whakawhiti	fˌakafˈiti
Whangarei	fˌaŋarˈei
Whatu	fˈatu"
autō	aˈu"tɔː
haurangi	hˌau"rˈaŋi
heria	herˈia
hohipera	hˌɔhipˈera
hohonu	hɔhˈɔnu"
hokia	hɔkˈia
hopi	hˈɔpi
huahua	hˌu"ahˈu"a
hēkeretari	hˌeːkeretˈari
irahiko	ˌirahˈikɔ
itinga	itˈiŋa
katia	katˈia
kohanga	kɔhˈaŋa
kohikohia	kˌɔhikɔhˈia
kotahitanga	kˌɔtahitˈaŋa
körero	kɔrˈerɔ
kōhauhau	kˌɔːhau"hˈau"
kōmihana	kˌɔːmihˈana
maunu	maˈu"nu"
moa	mˈɔa
mätou	matˈou"
mārena	maːrˈena
nōhanga	nɔːhˈaŋa
orokohanga	ˌɔrɔkɔhˈaŋa
porohita	pˌɔrɔhˈita
potae	pˈɔta͡ɪ
pupu	pˈu"pu"
pūmotu	pu"ːmˈɔtu"
taiora	ta͡ɪˈɔra
takurua	tˌaku"rˈu"a
taupoki	tˌau"pˈɔki
tauwhāinga	tˌau"faːˈiŋa
toetoe	twˈetwe
tuari	tu"ˈari
waiū	wˈa͡ɪu"ː
wana	wˈana
whakamahuki	fˌakamahˈu"ki
whakapaua	fˌakapaˈu"a
whakapuakanga	fˌakapˌu"akˈaŋa
whakarerekētanga	fˌakarˌerekeːtˈaŋa
whakawhanaunga	fˌakafˌanaˈu"ŋa
whawhati	fafˈati
whāwhā	fˈaːfaː
āku	ˈaːku"
Aperira	ˌaperˈira
Arts	ˈa r t (͡e͡n)ˈɛs(͡m͡i)
Ata	ˈata
Aunty	ˈa ˈu" n t (͡e͡n)wˈa͡ɪ(͡m͡i)
Cooper	(͡e͡n)sˈiː(͡m͡i) ˈɔ ˈɔ p ˈe r
Hapori	hapˈɔri
Hongi	hˈɔŋi
Horowhenua	hˌɔrɔfenˈu"a
Hēnare	heːnˈare
Kurī	kˈu"riː
Matauranga	mˌatau"rˈaŋa
MāoriHe	maːˈɔri hˈe
Māoritanga	mˌaːɔritˈaŋa
Pātaka	paːtˈaka
Rangahaua	rˌaŋahaˈu"a
Rāpare	raːpˈare
Tiireni	tˌiirˈeni
Tua	tˈu"a
Tōku	tˈɔːku"
Tūhono	tu"ːhˈɔnɔ
Wahine	wahˈine
Wairau	wa͡ɪrˈau"
Whakaari	fˌakaˈari
Whakaue	fˌakaˈu"e
Whenu	fˈenu"
amio	amˈiɔ
heamana	hˌeamˈana
honore	hɔnˈɔre
hōhonutanga	hˌɔːhɔnu"tˈaŋa
kaitohu	ka͡ɪtˈɔhu"
kaiwhakaari	kˌa͡ɪfakaˈari
katau	katˈau"
kawau	kawˈau"
kikokiko	kˌikɔkˈikɔ
kuhunga	ku"hˈu"ŋa
learning	(͡e͡n)ˈɛl(͡m͡i) ˈe ˈa r n ˈi n (͡e͡n)d͡ʒˈiː(͡m͡i)
manakohia	mˌanakɔhˈia
mākū	mˈaːku"ː
mātotoru	mˌaːtɔtˈɔru"
paahitia	pˌaahitˈia
pakimaero	pˌakimˈa͡ɪrɔ
pohewa	pɔhˈewa
rewharewha	rˌefarˈefa
takatū	takˈatu"ː
tutakina	tˌu"takˈina
tīmatatanga	tˌiːmatatˈaŋa
tōkena	tɔːkˈena
tūroa	tu"ːrˈɔa
werawera	wˌerawˈera
whakamātauria	fˌakamˌaːtau"rˈia
whakamōhiotia	fˌakamˌɔːhiɔtˈia
whakaranu	fˌakarˈanu"
whakatakotohia	fˌakatˌakɔtɔhˈia
whiriwhirihia	fˌirifˌirihˈia
ōpaki	ɔːpˈaki
Ūropi	u"ːrˈɔpi
Added	ˈa (͡e͡n)dˈiː dˈiː(͡m͡i) ˈe (͡e͡n)dˈiː(͡m͡i)
Aromatawai	ˌarɔmatˈawa͡ɪ
Beach	(͡e͡n)bˈiː(͡m͡i) ˈe ˈa (͡e͡n)sˈiː(͡m͡i) h
Board	(͡e͡n)bˈiː(͡m͡i) ˈɔ ˈa r (͡e͡n)dˈiː(͡m͡i)
Council	(͡e͡n)sˈiː(͡m͡i) ˈɔ ˈu" n (͡e͡n)sˈiː(͡m͡i) ˈi (͡e͡n)ˈɛl(͡m͡i)
Eramiha	ˌeramˈiha
Ha	hˈa
Hua	hˈu"a
Kaikōura	kˌa͡ɪkɔːˈu"ra
Kuia	ku"ˈia
Land	(͡e͡n)ˈɛl(͡m͡i) ˈa n (͡e͡n)dˈiː(͡m͡i)
Lisa	(͡e͡n)ˈɛl(͡m͡i) ˈi (͡e͡n)ˈɛs(͡m͡i) ˈa
Marau	marˈau"
Mātenga	maːtˈeŋa
Pahi	pˈahi
Paipera	pa͡ɪpˈera
Palmerston	p ˈa (͡e͡n)ˈɛl(͡m͡i) m ˈe r (͡e͡n)ˈɛs(͡m͡i) t ˈɔ n
Paraone	parˈa͡ʊne
Parata	parˈata
Point	pˈo͡ɪnt
Pāora	paːˈɔra
Rongowhakaata	rˌɔŋɔfˌakaˈata
Ruanui	rˌu"anˈu"i
Tamihana	tˌamihˈana
Tipene	tipˈene
Tirohanga	tˌirɔhˈaŋa
Waea	wˈa͡ɪa
Whakaatu	fˌakaˈatu"
Whakamoemiti	fˌakamwemˈiti
Whakarite	fˌakarˈite
Whakatohea	fˌakatɔhˈea
etc	ˈe t (͡e͡n)sˈiː(͡m͡i)
hori	hˈɔri
korakora	kˌɔrakˈɔra
koropupū	kˌɔrɔpˈu"pu"ː
kōeke	kɔːˈeke
maero	mˈa͡ɪrɔ
mauheretia	mˌau"hˌeretˈia
mihia	mihˈia
momoho	mɔmˈɔhɔ
mēra	mˈeːra
nakunaku	nˌaku"nˈaku"
nekehia	nˌekehˈia
neketai	nekˈeta͡ɪ
ngohi	ŋˈɔhi
ngongo	ŋˈɔŋɔ
nē	nˈeː
panuku	panˈu"ku"
porihanga	pˌɔrihˈaŋa
puawai	pu"ˈawa͡ɪ
pueru	pu"ˈeru"
pukuriri	pˌu"ku"rˈiri
putunga	pu"tˈu"ŋa
pāwhiria	pˌaːfirˈia
rangahaua	rˌaŋahaˈu"a
rohenga	rɔhˈeŋa
rāhuitia	rˌaːhu"itˈia
taiwhanga	ta͡ɪfˈaŋa
takawaenga	tˌakawˈa͡ɪŋa
tamatāne	tˌamatˈaːne
tauoti	tˌau"ˈɔti
toona	tɔˈɔna
totohu	tɔtˈɔhu"
tuaahu	tˌu"aˈahu"
tukinotia	tˌu"kinɔtˈia
tupua	tu"pˈu"a
tōtara	tɔːtˈara
uia	u"ˈia
ware	wˈare
whakareri	fˌakarˈeri
wīra	wˈiːra
wīwhara	wiːfˈara
āpiti	aːpˈiti
Ēngari	eːŋˈari
ūnga	ˈu"ːŋa
Aka	ˈaka
Aua	aˈu"a
General	(͡e͡n)d͡ʒˈiː(͡m͡i) ˈe n ˈe r ˈa (͡e͡n)ˈɛl(͡m͡i)
Hinemoana	hˌinemɔˈana
Huri	hˈu"ri
Impromptu	imprˈɔmptu"
Karakia	kˌarakˈia
Limited	(͡e͡n)ˈɛl(͡m͡i) ˈi m ˈi t ˈe (͡e͡n)dˈiː(͡m͡i)
Maunganui	mˌau"ŋanˈu"i
Moananui	mˌɔananˈu"i
Muri	mˈu"ri
Mātaatua	mˌaːtaatˈu"a
Phrases	p h r ˈa (͡e͡n)ˈɛs(͡m͡i) ˈe (͡e͡n)ˈɛs(͡m͡i)
Piripi	pirˈipi
Rarawa	rarˈawa
Roimata	ro͡ɪmˈata
Ruma	rˈu"ma
Runtime	ru"ntˈime
Rākau	raːkˈau"
Scott	(͡e͡n)ˈɛs sˈiː(͡m͡i) ˈɔ t t
Services	(͡e͡n)ˈɛs(͡m͡i) ˈe r (͡e͡n)vˈiː(͡m͡i) ˈi (͡e͡n)sˈiː(͡m͡i) ˈe (͡e͡n)ˈɛs(͡m͡i)
Stewart	(͡e͡n)ˈɛs(͡m͡i) t ˈe w ˈa r t
Stories	(͡e͡n)ˈɛs(͡m͡i) t ˈɔ r ˈi ˈe (͡e͡n)ˈɛs(͡m͡i)
Taihoa	ta͡ɪhˈɔa
Tiati	tiˈati
Tohutohu	tˌɔhu"tˈɔhu"
Transport	t r ˈa n (͡e͡n)ˈɛs(͡m͡i) p ˈɔ r t
Waikano	wa͡ɪkˈanɔ
Whakaakoranga	fˌakaˌakɔrˈaŋa
Whakatairanga	fˌakata͡ɪrˈaŋa
Wicks	w ˈi (͡e͡n)sˈiː(͡m͡i) k (͡e͡n)ˈɛs(͡m͡i)
Winners	w ˈi n n ˈe r (͡e͡n)ˈɛs(͡m͡i)
ae	ˈa͡ɪ
hakinakina	hˌakinakˈina
hauhake	hˌau"hˈake
horapa	hɔrˈapa
kaiwhakanoho	kˌa͡ɪfakanˈɔhɔ
kakā	kˈakaː
kokiri	kɔkˈiri
kōnei	kɔːnˈei
maitai	mˈa͡ɪta͡ɪ
maringi	marˈiŋi
marino	marˈinɔ
matomato	mˌatɔmˈatɔ
papamahi	pˌapamˈahi
patapatai	pˌatapˈata͡ɪ
piripono	pˌiripˈɔnɔ
pūhiko	pu"ːhˈikɔ
pūrerehua	pˌu"ːrerehˈu"a
rekoata	rˌekɔˈata
runanga	ru"nˈaŋa
rūri	rˈu"ːri
takapau	tˌakapˈau"
taumahi	tˌau"mˈahi
teetahi	tˌeetˈahi
timu	tˈimu"
tomokanga	tˌɔmɔkˈaŋa
uma	ˈu"ma
ure	ˈu"re
urupā	uɹˈupaː
vii	(͡e͡n)vˈiː(͡m͡i) ˈi ˈi
weropepahia	wˌerɔpˌepahˈia
whakahokinga	fˌakahɔkˈiŋa
whakaniko	fˌakanˈikɔ
whakaorangia	fˌaka͡ʊraŋˈia
whakaroa	fˌakarˈɔa
whakatuwhera	fˌakatu"fˈera
whakaute	fˌakaˈu"te
whatunga	fatˈu"ŋa
āki	ˈaːki
ārani	aːrˈani
āwhā	ˈaːfaː
ēnā	ˈeːnaː
Ōtepoti	ˌɔːtepˈɔti
Au	ˈau"
B	(͡e͡n)bˈiː(͡m͡i)
Collection	(͡e͡n)sˈiː(͡m͡i) ˈɔ (͡e͡n)ˈɛl ˈɛl(͡m͡i) ˈe (͡e͡n)sˈiː(͡m͡i) t ˈi ˈɔ n
Eke	ˈeke
Harawira	hˌarawˈira
Hurae	hˈu"ra͡ɪ
Hīkoi	hˈiːko͡ɪ
Karanga	karˈaŋa
Kawea	kawˈea
Kawhia	kafˈia
Koinā	kˈo͡ɪnaː
Kāpene	kaːpˈene
Kōrerohia	kˌɔːrerɔhˈia
Little	(͡e͡n)ˈɛl(͡m͡i) ˈi t t (͡e͡n)ˈɛl(͡m͡i) ˈe
Matapakia	mˌatapakˈia
MauHe	mˈau" hˈe
May	m ˈa (͡e͡n)wˈa͡ɪ(͡m͡i)
Native	n ˈa t ˈi (͡e͡n)vˈiː(͡m͡i) ˈe
Papamoa	pˌapamˈɔa
Peti	pˈeti
Rapua	rapˈu"a
Tapahia	tˌapahˈia
Thursday	t h ˈu" r (͡e͡n)ˈɛs dˈiː(͡m͡i) ˈa (͡e͡n)wˈa͡ɪ(͡m͡i)
Tikina	tikˈina
Tohunga	tɔhˈu"ŋa
Tokohia	tˌɔkɔhˈia
Tuesday	t ˈu" ˈe (͡e͡n)ˈɛs dˈiː(͡m͡i) ˈa (͡e͡n)wˈa͡ɪ(͡m͡i)
Tuhituhi	tˌu"hitˈu"hi
Turnbull	t ˈu" r n (͡e͡n)bˈiː(͡m͡i) ˈu" (͡e͡n)ˈɛl ˈɛl(͡m͡i)
Tūrei	tu"ːrˈei
Waihi	wˈa͡ɪhi
Waikanae	wa͡ɪkˈana͡ɪ
Whakatakotoria	fˌakatˌakɔtɔrˈia
Whetu	fˈetu"
Wikitoria	wˌikitɔrˈia
anö	ˈanɔ
arotakenga	ˌarɔtakˈeŋa
auahatanga	ˌau"ˌahatˈaŋa
aue	aˈu"e
content	(͡e͡n)sˈiː(͡m͡i) ˈɔ n t ˈe n t
hongi	hˈɔŋi
hōrapa	hɔːrˈapa
kaho	kˈahɔ
kaitiakitanga	kˌa͡ɪtiˌakitˈaŋa
karauna	kˌaraˈu"na
koraha	kɔrˈaha
kōanga	kɔːˈaŋa
maioha	ma͡ɪˈɔha
maioro	ma͡ɪˈɔrɔ
manatārua	mˌanataːrˈu"a
marena	marˈena
muna	mˈu"na
māwhitiwhiti	mˌaːfitifˈiti
ngenge	ŋˈeŋe
nohinohi	nˌɔhinˈɔhi
oreore	ˌɔreˈɔre
paingia	pa͡ɪŋˈia
pakihiwi	pˌakihˈiwi
poihau	po͡ɪhˈau"
puea	pu"ˈea
pumau	pu"mˈau"
pure	pˈu"re
pākete	paːkˈete
pūoho	pu"ːˈɔhɔ
pūtakenga	pˌu"ːtakˈeŋa
raka	rˈaka
riterite	rˌiterˈite
rēhia	reːhˈia
taima	tˈa͡ɪma
taipakeke	tˌa͡ɪpakˈeke
tapuhi	tapˈu"hi
tarukino	tˌaru"kˈinɔ
tatu	tˈatu"
taukumekume	tˌau"kˌu"mekˈu"me
ti	tˈi
totara	tɔtˈara
tāhū	tˈaːhu"ː
tāwere	taːwˈere
tūtohinga	tˌu"ːtɔhˈiŋa
uha	ˈu"ha
wae	wˈa͡ɪ
week	wˈeek
whakaaehia	fˌakaa͡ɪhˈia
whakahaua	fˌakahaˈu"a
whakamāherehere	fˌakamˌaːherehˈere
whakarerekētia	fˌakarˌerekeːtˈia
whakatauākī	fˌakatˌau"ˈaːkiː
Ākuhata	ˌaːku"hˈata
ānō	ˈaːnɔː
ārikarika	ˌaːrikarˈika
Air	ˈa͡ɪr
An	ˈan
Andy	ˈa n (͡e͡n)dˈiː wˈa͡ɪ(͡m͡i)
Bennett	(͡e͡n)bˈiː(͡m͡i) ˈe n n ˈe t t
Club	(͡e͡n)sˈiː ˈɛl(͡m͡i) ˈu" (͡e͡n)bˈiː(͡m͡i)
Graham	(͡e͡n)d͡ʒˈiː(͡m͡i) r ˈa h ˈa m
Hautau	hˌau"tˈau"
Ingoa	iŋˈɔa
Kawariki	kˌawarˈiki
Mataatua	mˌataatˈu"a
Meiha	meˈiha
Mātāwai	maːtˈaːwa͡ɪ
Paerua	pa͡ɪrˈu"a
Pihinga	pihˈiŋa
Rangiātea	rˌaŋiaːtˈea
Rauru	raˈu"ru"
Rupe	rˈu"pe
Southland	(͡e͡n)ˈɛs(͡m͡i) ˈɔ ˈu" t h (͡e͡n)ˈɛl(͡m͡i) ˈa n (͡e͡n)dˈiː(͡m͡i)
Teachers	t ˈe ˈa (͡e͡n)sˈiː(͡m͡i) h ˈe r (͡e͡n)ˈɛs(͡m͡i)
Tuatoru	tˌu"atˈɔru"
Tuia	tu"ˈia
Tāngia	taːŋˈia
Waharoa	wˌaharˈɔa
Wananga	wanˈaŋa
Whakaaetanga	fˌakaa͡ɪtˈaŋa
Wāhine	waːhˈine
York	(͡e͡n)wˈa͡ɪ(͡m͡i) ˈɔ r k
akiakihia	ˌakiˌakihˈia
arotakengia	ˌarɔtˌakeŋˈia
hangi	hˈaŋi
hangā	hˈaŋaː
hautaka	hˌau"tˈaka
hinonga	hinˈɔŋa
hore	hˈɔre
huarākau	hˌu"araːkˈau"
kaa	kˈaa
kahui	kahˈu"i
kaieke	ka͡ɪˈeke
kaitoi	kˈa͡ɪto͡ɪ
kaiwhakawa	kˌa͡ɪfakˈawa
kawana	kawˈana
kemu	kˈemu"
kiriuhi	kˌiriˈu"hi
kēkē	kˈeːkeː
kōpū	kˈɔːpu"ː
mamao	mˈama͡ʊ
matataunga	mˌatataˈu"ŋa
matches	m ˈa t (͡e͡n)sˈiː(͡m͡i) h ˈe (͡e͡n)ˈɛs(͡m͡i)
mohoa	mɔhˈɔa
māhunga	maːhˈu"ŋa
māuiui	mˌaːu"iˈu"i
nehu	nˈehu"
ohia	ɔhˈia
paetuku	pa͡ɪtˈu"ku"
parenga	parˈeŋa
paruparu	pˌaru"pˈaru"
pātiki	paːtˈiki
raa	rˈaa
returned	r ˈe t ˈu" r n ˈe (͡e͡n)dˈiː(͡m͡i)
rāwekeweke	rˌaːwekewˈeke
taiopenga	tˌa͡ɪɔpˈeŋa
tokoono	tˌɔkɔˈɔnɔ
tokotoko	tˌɔkɔtˈɔkɔ
too	tˈɔɔ
tuaina	tu"ˈa͡ɪna
tungane	tu"ŋˈane
tuunga	tu"ˈu"ŋa
tōmuri	tɔːmˈu"ri
uiuitanga	ˌu"iˌu"itˈaŋa
uka	ˈu"ka
waku	wˈaku"
whakahaerea	fˌakaha͡ɪrˈea
whakahīhī	fˌakahˈiːhiː
whakapumautia	fˌakapˌu"mau"tˈia
whakapākehātanga	fˌakapˌaːkehaːtˈaŋa
whakatairitea	fˌakatˌa͡ɪritˈea
whakatinanahia	fˌakatˌinanahˈia
whao	fˈa͡ʊ
wini	wˈini
Āperira	ˌaːperˈira
Ōrākei	ˌɔːraːkˈei
Agency	ˈa (͡e͡n)d͡ʒˈiː(͡m͡i) ˈe n (͡e͡n)sˈiː wˈa͡ɪ(͡m͡i)
Akuanei	ˌaku"anˈei
Allen	ˈa (͡e͡n)ˈɛl ˈɛl(͡m͡i) ˈe n
Best	(͡e͡n)bˈiː(͡m͡i) ˈe (͡e͡n)ˈɛs(͡m͡i) t
Coast	(͡e͡n)sˈiː(͡m͡i) ˈɔ ˈa (͡e͡n)ˈɛs(͡m͡i) t
Colin	(͡e͡n)sˈiː(͡m͡i) ˈɔ (͡e͡n)ˈɛl(͡m͡i) ˈi n
Dentist	(͡e͡n)dˈiː(͡m͡i) ˈe n t ˈi (͡e͡n)ˈɛs(͡m͡i) t
Facebook	(͡e͡n)ˈɛf(͡m͡i) ˈa (͡e͡n)sˈiː(͡m͡i) ˈe (͡e͡n)bˈiː(͡m͡i) ˈɔ ˈɔ k
Fonterra	(͡e͡n)ˈɛf(͡m͡i) ˈɔ n t ˈe r r ˈa
Harbour	h ˈa r (͡e͡n)bˈiː(͡m͡i) ˈɔ ˈu" r
Here	hˈere
Hereturikōkā	hˌeretˌu"rikˈɔːkaː
Hutt	hˈu"tt
Institute	ˈi n (͡e͡n)ˈɛs(͡m͡i) t ˈi t ˈu" t ˈe
Kaihautū	kˌa͡ɪhaˈu"tu"ː
Kaiwhakawā	kˌa͡ɪfakˈawaː
Kare	kˈare
Koianei	kˌo͡ɪanˈei
Kororāreka	kˌɔrɔraːrˈeka
Korowaitanga	kˌɔrɔwa͡ɪtˈaŋa
Kā	kˈaː
MInistry	m ˈi n ˈi (͡e͡n)ˈɛs(͡m͡i) t r (͡e͡n)wˈa͡ɪ(͡m͡i)
Marsden	m ˈa r (͡e͡n)ˈɛs dˈiː(͡m͡i) ˈe n
Matakite	mˌatakˈite
Mokopuna	mˌɔkɔpˈu"na
Mōhio	mɔːhˈiɔ
Next	n ˈe (͡e͡n)ˈɛks(͡m͡i) t
Nohotima	nˌɔhɔtˈima
Pikiao	pikˈia͡ʊ
Puke	pˈu"ke
Sir	(͡e͡n)ˈɛs(͡m͡i) ˈi r
Story	(͡e͡n)ˈɛs(͡m͡i) t ˈɔ r (͡e͡n)wˈa͡ɪ(͡m͡i)
Tuwhakairiora	tˌu"fakˌa͡ɪriˈɔra
Valley	(͡e͡n)vˈiː(͡m͡i) ˈa (͡e͡n)ˈɛl ˈɛl(͡m͡i) ˈe (͡e͡n)wˈa͡ɪ(͡m͡i)
Waaka	waˈaka
Wehea	wehˈea
Whakaako	fˌakaˈakɔ
Wī	wˈiː
aki	ˈaki
autaia	ˌau"tˈa͡ɪa
ha	hˈa
harakoa	hˌarakˈɔa
haumarutanga	hˌau"mˌaru"tˈaŋa
hikareti	hˌikarˈeti
hoea	hwˈea
hōpara	hɔːpˈara
kaitoro	ka͡ɪtˈɔrɔ
kakama	kakˈama
kakano	kakˈanɔ
kapahaka	kˌapahˈaka
karamu	karˈamu"
karapoti	kˌarapˈɔti
makau	makˈau"
mei	mˈei
moata	mɔˈata
mīhana	miːhˈana
mīti	mˈiːti
nehera	nehˈera
new	nˈew
nōhia	nɔːhˈia
onamata	ˌɔnamˈata
otiia	ˌɔtiˈia
performance	p ˈe r (͡e͡n)ˈɛf(͡m͡i) ˈɔ r m ˈa n (͡e͡n)sˈiː(͡m͡i) ˈe
pupuritia	pˌu"pu"ritˈia
pāho	pˈaːhɔ
pēhia	peːhˈia
pūmua	pu"ːmˈu"a
pūrama	pu"ːrˈama
raima	rˈa͡ɪma
roia	rˈo͡ɪa
taiwhenua	tˌa͡ɪfenˈu"a
takaia	takˈa͡ɪa
takina	takˈina
takitini	tˌakitˈini
tuatara	tˌu"atˈara
tārewa	taːrˈewa
tātahi	taːtˈahi
urutomo	ˌu"ru"tˈɔmɔ
utanga	u"tˈaŋa
whakamā	fakˈamaː
whakamāmā	fˌakamˈaːmaː
whakamāramahia	fˌakamˌaːramahˈia
whakanohoia	fˌakanɔhˈo͡ɪa
whakapuakitanga	fˌakapˌu"akitˈaŋa
whakapūmautia	fˌakapˌu"ːmau"tˈia
whakarei	fˌakarˈei
whakataka	fˌakatˈaka
whakatutukihia	fˌakatˌu"tu"kihˈia
whakatūngia	fˌakatu"ːŋˈia
whakawhanaungatanga	fˌakafˌanaˌu"ŋatˈaŋa
whakawhāiti	fˌakafaːˈiti
wharepaku	fˌarepˈaku"
whatumanawa	fˌatu"manˈawa
wä	wˈa
Āhia	aːhˈia
ārahitanga	ˌaːrahitˈaŋa
Aoraki	a͡ʊrˈaki
Aronui	ˌarɔnˈu"i
Community	(͡e͡n)sˈiː(͡m͡i) ˈɔ m m ˈu" n ˈi t (͡e͡n)wˈa͡ɪ(͡m͡i)
Craig	(͡e͡n)sˈiː(͡m͡i) r ˈa ˈi (͡e͡n)d͡ʒˈiː(͡m͡i)
Curriculum	(͡e͡n)sˈiː(͡m͡i) ˈu" r r ˈi (͡e͡n)sˈiː(͡m͡i) ˈu" (͡e͡n)ˈɛl(͡m͡i) ˈu" m
Google	(͡e͡n)d͡ʒˈiː(͡m͡i) ˈɔ ˈɔ (͡e͡n)d͡ʒˈiː ˈɛl(͡m͡i) ˈe
Hato	hˈatɔ
Haumaru	hˌau"mˈaru"
Huinga	hu"ˈiŋa
Hītori	hiːtˈɔri
In	ˈin
Jack	(͡e͡n)d͡ʒˈe͡ɪ(͡m͡i) ˈa (͡e͡n)sˈiː(͡m͡i) k
Kaimahi	ka͡ɪmˈahi
Keepa	keˈepa
Koi	kˈo͡ɪ
Kokiri	kɔkˈiri
Manus	m ˈa n ˈu" (͡e͡n)ˈɛs(͡m͡i)
Mike	mˈike
Monday	m ˈɔ n (͡e͡n)dˈiː(͡m͡i) ˈa (͡e͡n)wˈa͡ɪ(͡m͡i)
Māna	mˈaːna
N	n
NZQA	n (͡e͡n)zˈɛd kjˈuː(͡m͡i) ˈa
Panguru	paŋˈu"ru"
Parore	parˈɔre
Prepared	p r ˈe p ˈa r ˈe (͡e͡n)dˈiː(͡m͡i)
Pīpī	pˈiːpiː
Rongopai	rɔŋˈɔpa͡ɪ
Ruatapu	rˌu"atˈapu"
Rāmere	raːmˈere
Social	(͡e͡n)ˈɛs(͡m͡i) ˈɔ (͡e͡n)sˈiː(͡m͡i) ˈi ˈa (͡e͡n)ˈɛl(͡m͡i)
Stephen	(͡e͡n)ˈɛs(͡m͡i) t ˈe p h ˈe n
Support	(͡e͡n)ˈɛs(͡m͡i) ˈu" p p ˈɔ r t
Tamati	tamˈati
Tiwhikete	tˌifikˈete
Tupu	tˈu"pu"
Tāmati	taːmˈati
Tāpirihia	tˌaːpirihˈia
Tīhema	tiːhˈema
Tūturu	tu"ːtˈu"ru"
Whakauru	fˌakaˈu"ru"
Whangaroa	fˌaŋarˈɔa
Whetū	fˈetu"ː
akuanei	ˌaku"anˈei
haehae	hˈa͡ɪha͡ɪ
his	h ˈi (͡e͡n)ˈɛs(͡m͡i)
hopukanga	hˌɔpu"kˈaŋa
horoia	hɔrˈo͡ɪa
huawhenua	hˌu"afenˈu"a
image	ˈi m ˈa (͡e͡n)d͡ʒˈiː(͡m͡i) ˈe
kaaore	kaˈa͡ʊre
kaiwhakarato	kˌa͡ɪfakarˈatɔ
kanorau	kˌanɔrˈau"
kirikiti	kˌirikˈiti
kuini	ku"ˈini
kīa	kˈiːa
kōtui	kɔːtˈu"i
mango	mˈaŋɔ
mangu	mˈaŋu"
mania	manˈia
matikara	mˌatikˈara
mauhere	mˌau"hˈere
mm	mm
mōrehu	mɔːrˈehu"
oi	ˈo͡ɪ
oko	ˈɔkɔ
onāianei	ˌɔnaːˌianˈei
ota	ˈɔta
paetahi	pa͡ɪtˈahi
paparau	pˌaparˈau"
pereti	perˈeti
pohehe	pɔhˈehe
pouaru	pˌou"ˈaru"
pōkākā	pɔːkˈaːkaː
rangirua	rˌaŋirˈu"a
rangitahi	rˌaŋitˈahi
ranunga	ranˈu"ŋa
reinga	reˈiŋa
reri	rˈeri
rïroa	rirˈɔa
sources	(͡e͡n)ˈɛs(͡m͡i) ˈɔ ˈu" r (͡e͡n)sˈiː(͡m͡i) ˈe (͡e͡n)ˈɛs(͡m͡i)
tauaro	tˌau"ˈarɔ
tauhono	tˌau"hˈɔnɔ
taumahatanga	tˌau"mˌahatˈaŋa
taurua	tˌau"rˈu"a
tuaono	tu"ˈa͡ʊnɔ
tunga	tˈu"ŋa
tuu	tˈu"u"
tīmataria	tˌiːmatarˈia
tīpakohia	tˌiːpakɔhˈia
tūao	tˈu"ːa͡ʊ
tūwhera	tu"ːfˈera
tūāhuatanga	tˌu"ːaːhˌu"atˈaŋa
warea	warˈea
weheruatanga	wˌeherˌu"atˈaŋa
whaa	fˈaa
whakamohio	fˌakamɔhˈiɔ
whano	fˈanɔ
wāwāhia	wˌaːwaːhˈia
āhuahanga	ˌaːhu"ahˈaŋa
Aha	ˈaha
Anau	anˈau"
Ani	ˈani
Apa	ˈapa
Ataata	ˌataˈata
Ben	(͡e͡n)bˈiː(͡m͡i) ˈe n
Eruera	ˌeru"ˈera
Excellence	ˈe (͡e͡n)ˈɛks sˈiː(͡m͡i) ˈe (͡e͡n)ˈɛl ˈɛl(͡m͡i) ˈe n (͡e͡n)sˈiː(͡m͡i) ˈe
Files	(͡e͡n)ˈɛf(͡m͡i) ˈi (͡e͡n)ˈɛl(͡m͡i) ˈe (͡e͡n)ˈɛs(͡m͡i)
Haane	haˈane
Joseph	(͡e͡n)d͡ʒˈe͡ɪ(͡m͡i) ˈɔ (͡e͡n)ˈɛs(͡m͡i) ˈe p h
Kaitaia	ka͡ɪtˈa͡ɪa
Kaitirotiro	kˌa͡ɪtirɔtˈirɔ
Manahi	manˈahi
Mataira	matˈa͡ɪra
Mātai	mˈaːta͡ɪ
Pacific	p ˈa (͡e͡n)sˈiː(͡m͡i) ˈi (͡e͡n)ˈɛf(͡m͡i) ˈi (͡e͡n)sˈiː(͡m͡i)
Page	p ˈa (͡e͡n)d͡ʒˈiː(͡m͡i) ˈe
Pango	pˈaŋɔ
Patupaiarehe	pˌatu"pˌa͡ɪarˈehe
Peehi	peˈehi
Pīngao	pˈiːŋa͡ʊ
Pūkenga	pu"ːkˈeŋa
Rakiura	rˌakiˈu"ra
Regional	r ˈe (͡e͡n)d͡ʒˈiː(͡m͡i) ˈi ˈɔ n ˈa (͡e͡n)ˈɛl(͡m͡i)
Rāhina	raːhˈina
Seniors	(͡e͡n)ˈɛs(͡m͡i) ˈe n ˈi ˈɔ r (͡e͡n)ˈɛs(͡m͡i)
Sh	(͡e͡n)ˈɛs(͡m͡i)h
TE	tˈe
TTR	ttr
Takitimu	tˌakitˈimu"
Tapuika	tˌapu"ˈika
Thompson	t h ˈɔ m p (͡e͡n)ˈɛs(͡m͡i) ˈɔ n
Tui	tˈu"i
Tīkina	tiːkˈina
Tīmoti	tiːmˈɔti
US	ˈu" (͡e͡n)ˈɛs(͡m͡i)
Uropi	u"rˈɔpi
Wahi	wˈahi
Wanganui	wˌaŋanˈu"i
Whakangungu	fˌakaŋˈu"ŋu"
Whakapono	fˌakapˈɔnɔ
Whakareatia	fˌakarˌeatˈia
Whiriwhiri	fˌirifˈiri
ahupūngao	ˌahu"pˈu"ːŋa͡ʊ
amotai	amˈɔta͡ɪ
arawhata	ˌarafˈata
autōhiko	ˌau"tɔːhˈikɔ
ekore	ekˈɔre
hauāuru	hˌau"aːˈu"ru"
heipū	heˈipu"ː
hihiko	hihˈikɔ
hinaki	hinˈaki
huhu	hˈu"hu"
hukihuki	hˌu"kihˈu"ki
ianei	ˌianˈei
ihiihi	ˌihiˈihi
inanga	inˈaŋa
kaitā	kˈa͡ɪtaː
kaiwhakamāori	kˌa͡ɪfakˌamaːˈɔri
kaiwhakatairanga	kˌa͡ɪfakˌata͡ɪrˈaŋa
kapohia	kˌapɔhˈia
kaupare	kˌau"pˈare
koorero	kˌɔɔrˈerɔ
kopu	kˈɔpu"
kākā	kˈaːkaː
kāpehu	kaːpˈehu"
kāti	kˈaːti
links	(͡e͡n)ˈɛl(͡m͡i) ˈi n k (͡e͡n)ˈɛs(͡m͡i)
matatapu	mˌatatˈapu"
mauritau	mˌau"ritˈau"
mohiotanga	mˌɔhiɔtˈaŋa
mokomoko	mˌɔkɔmˈɔkɔ
nge	ŋˈe
nukunuku	nˌu"ku"nˈu"ku"
nāku	nˈaːku"
pukumahi	pˌu"ku"mˈahi
pāhekeheke	pˌaːhekehˈeke
pāpāhua	pˌaːpaːhˈu"a
pāua	paːˈu"a
pōtiki	pɔːtˈiki
pūkahukahu	pˌu"ːkahu"kˈahu"
pūkeko	pu"ːkˈekɔ
rara	rˈara
rei	rˈei
reiti	reˈiti
rūmaki	ru"ːmˈaki
takahuri	tˌakahˈu"ri
takitaki	tˌakitˈaki
tauria	tˌau"rˈia
tauwhitiwhiti	tˌau"fˌitifˈiti
tonuhia	tˌɔnu"hˈia
tuohu	tu"ˈɔhu"
turu	tˈu"ru"
tāpaea	taːpˈa͡ɪa
tūhurangia	tˌu"ːhu"raŋˈia
uiuia	ˌu"iu"ˈia
ururua	ˌu"ru"rˈu"a
whakapehapeha	fˌakapˌehapˈeha
whakapiria	fˌakapirˈia
whakarauoratanga	fˌakarˌau"ˌɔratˈaŋa
whakarōpūtanga	fˌakarˌɔːpu"ːtˈaŋa
whakawhitihia	fˌakafˌitihˈia
whatitoka	fˌatitˈɔka
whiunga	fiˈu"ŋa
whātoro	faːtˈɔrɔ
Āhuatanga	ˌaːhu"atˈaŋa
āhukahuka	ˌaːhu"kahˈu"ka
Aitanga	a͡ɪtˈaŋa
Aue	aˈu"e
Bruce	(͡e͡n)bˈiː(͡m͡i) r ˈu" (͡e͡n)sˈiː(͡m͡i) ˈe
East	ˈe ˈa (͡e͡n)ˈɛs(͡m͡i) t
Edward	ˈe (͡e͡n)dˈiː(͡m͡i) w ˈa r (͡e͡n)dˈiː(͡m͡i)
Frances	(͡e͡n)ˈɛf(͡m͡i) r ˈa n (͡e͡n)sˈiː(͡m͡i) ˈe (͡e͡n)ˈɛs(͡m͡i)
Grace	(͡e͡n)d͡ʒˈiː(͡m͡i) r ˈa (͡e͡n)sˈiː(͡m͡i) ˈe
Hainamana	hˌa͡ɪnamˈana
Hoa	hˈɔa
Ian	ˈian
Ipukarea	ˌipu"karˈea
Kanawa	kanˈawa
Kauaka	kˌau"ˈaka
Kohai	kˈɔha͡ɪ
Kīhai	kˈiːha͡ɪ
Lake	(͡e͡n)ˈɛl(͡m͡i) ˈa k ˈe
Leaders	(͡e͡n)ˈɛl(͡m͡i) ˈe ˈa (͡e͡n)dˈiː(͡m͡i) ˈe r (͡e͡n)ˈɛs(͡m͡i)
Materoa	mˌaterˈɔa
Matihiko	mˌatihˈikɔ
MetService	mˈet (͡e͡n)ˈɛs(͡m͡i) ˈe r (͡e͡n)vˈiː(͡m͡i) ˈi (͡e͡n)sˈiː(͡m͡i) ˈe
Moemiti	mwemˈiti
Māhaki	maːhˈaki
Mākarini	mˌaːkarˈini
Northland	n ˈɔ r t h (͡e͡n)ˈɛl(͡m͡i) ˈa n (͡e͡n)dˈiː(͡m͡i)
Nāu	nˈaːu"
Otautahi	ˌɔtau"tˈahi
Programme	p r ˈɔ (͡e͡n)d͡ʒˈiː(͡m͡i) r ˈa m m ˈe
Pīhopa	piːhˈɔpa
Rahui	rahˈu"i
Raukura	rˌau"kˈu"ra
Rescue	r ˈe (͡e͡n)ˈɛs sˈiː(͡m͡i) ˈu" ˈe
Riro	rˈirɔ
Roto	rˈɔtɔ
Roxburgh	r ˈɔ (͡e͡n)ˈɛks bˈiː(͡m͡i) ˈu" r (͡e͡n)d͡ʒˈiː(͡m͡i) h
Ruatara	rˌu"atˈara
Skip	(͡e͡n)ˈɛs(͡m͡i) k ˈi p
Tamatea	tˌamatˈea
Tasman	t ˈa (͡e͡n)ˈɛs(͡m͡i) m ˈa n
Tātaihia	tˌaːta͡ɪhˈia
Tō	tˈɔː
Uri	ˈu"ri
Wairaka	wa͡ɪrˈaka
West	w ˈe (͡e͡n)ˈɛs(͡m͡i) t
Whaitere	fa͡ɪtˈere
Whaitiri	fa͡ɪtˈiri
Whakairo	fakˈa͡ɪrɔ
Whakapapa	fˌakapˈapa
Wharehuia	fˌarehu"ˈia
Whata	fˈata
Wi	wˈi
Wāwāhi	waːwˈaːhi
aata	aˈata
after	ˈa (͡e͡n)ˈɛf(͡m͡i) t ˈe r
angawaho	ˌaŋawˈahɔ
anā	ˈanaː
aratakina	ˌaratakˈina
hapainga	hapˈa͡ɪŋa
hotoke	hɔtˈɔke
huamoni	hˌu"amˈɔni
hāpaitia	hˌaːpa͡ɪtˈia
iraoho	irˈa͡ʊhɔ
karetao	karˈeta͡ʊ
karoro	karˈɔrɔ
kinaki	kinˈaki
kēhi	kˈeːhi
kīhini	kiːhˈini
kōtuitui	kˌɔːtu"itˈu"i
māhere	maːhˈere
mātātuhi	mˌaːtaːtˈu"hi
ngari	ŋˈari
ngāwhā	ŋˈaːfaː
notes	n ˈɔ t ˈe (͡e͡n)ˈɛs(͡m͡i)
nuka	nˈu"ka
nzmaths	n (͡e͡n)zˈɛd(͡m͡i) m ˈa t h (͡e͡n)ˈɛs(͡m͡i)
p	p
pakipaki	pˌakipˈaki
papatuhituhi	pˌapatˌu"hitˈu"hi
parea	parˈea
petihana	pˌetihˈana
pirihi	pirˈihi
piringa	pirˈiŋa
piu	pˈiu"
puaki	pu"ˈaki
pukepuke	pˌu"kepˈu"ke
pupuru	pu"pˈu"ru"
pātaihia	pˌaːta͡ɪhˈia
pēhanga	peːhˈaŋa
raorao	rˈa͡ʊra͡ʊ
roroa	rɔrˈɔa
rēhitatia	rˌeːhitatˈia
taero	tˈa͡ɪrɔ
tahuhu	tahˈu"hu"
tahā	tˈahaː
tapiri	tapˈiri
tutū	tˈu"tu"ː
tāima	taːˈima
tēwhea	teːfˈea
tīkiti	tiːkˈiti
tōiriiri	tˌɔːiriˈiri
tūmau	tu"ːmˈau"
unu	ˈu"nu"
use	ˈu" (͡e͡n)ˈɛs(͡m͡i) ˈe
wairehu	wa͡ɪrˈehu"
website	w ˈe (͡e͡n)bˈiː ˈɛs(͡m͡i) ˈi t ˈe
wehewehenga	wˌehewehˈeŋa
weu	wˈeu"
whakaaraara	fˌakaˌaraˈara
whakairoiro	fˌaka͡ɪrˈo͡ɪrɔ
whakakai	fakˈaka͡ɪ
whakakāhore	fˌakakaːhˈɔre
whakamaherehere	fˌakamˌaherehˈere
whakarewatanga	fˌakarˌewatˈaŋa
whakaroto	fˌakarˈɔtɔ
whakato	fakˈatɔ
wharangi	farˈaŋi
wharau	farˈau"
whāki	fˈaːki
āhea	aːhˈea
āputa	aːpˈu"ta
Apple	ˈa p p (͡e͡n)ˈɛl(͡m͡i) ˈe
Awakairangi	ˌawaka͡ɪrˈaŋi
Church	(͡e͡n)sˈiː(͡m͡i) h ˈu" r (͡e͡n)sˈiː(͡m͡i) h
ERO	ˈerɔ
External	ˈe (͡e͡n)ˈɛks(͡m͡i) t ˈe r n ˈa (͡e͡n)ˈɛl(͡m͡i)
Flavell	(͡e͡n)ˈɛf ˈɛl(͡m͡i) ˈa (͡e͡n)vˈiː(͡m͡i) ˈe (͡e͡n)ˈɛl ˈɛl(͡m͡i)
Grant	(͡e͡n)d͡ʒˈiː(͡m͡i) r ˈa n t
H	h
HeritageSkip	h ˈe r ˈi t ˈa (͡e͡n)d͡ʒˈiː(͡m͡i) ˈe (͡e͡n)ˈɛs(͡m͡i) k ˈi p
Hinemoa	hˌinemˈɔa
Hoahoatia	hˌɔahˌɔatˈia
Horo	hˈɔrɔ
Japan	(͡e͡n)d͡ʒˈe͡ɪ(͡m͡i) ˈa p ˈa n
Katikati	kˌatikˈati
Kumeroa	kˌu"merˈɔa
Life	(͡e͡n)ˈɛl(͡m͡i) ˈi (͡e͡n)ˈɛf(͡m͡i) ˈe
Maku	mˈaku"
Matene	matˈene
Matt	mˈatt
Mutunga	mu"tˈu"ŋa
MāoriTe	maːˈɔri tˈe
Ngoingoi	ŋˈo͡ɪŋo͡ɪ
Nolan	n ˈɔ (͡e͡n)ˈɛl(͡m͡i) ˈa n
Papatuanuku	pˌapatˌu"anˈu"ku"
Parahaki	pˌarahˈaki
Paratene	pˌaratˈene
Pare	pˈare
Pipi	pˈipi
Po	pˈɔ
Pokapū	pɔkˈapu"ː
Puhiwahine	pˌu"hiwahˈine
Puketapu	pˌu"ketˈapu"
Pēhi	pˈeːhi
Rapu	rˈapu"
Tahua	tahˈu"a
Taiwhenua	tˌa͡ɪfenˈu"a
Tana	tˈana
Taonui	ta͡ʊnˈu"i
Taranga	tarˈaŋa
Tere	tˈere
Tini	tˈini
Tony	t ˈɔ n (͡e͡n)wˈa͡ɪ(͡m͡i)
Tuhinga	tu"hˈiŋa
Tāpiria	tˌaːpirˈia
Tōna	tˈɔːna
Tūtira	tu"ːtˈira
Whakamahi	fˌakamˈahi
Whakangahau	fˌakaŋahˈau"
akau	akˈau"
anamata	ˌanamˈata
apataki	ˌapatˈaki
apu	ˈapu"
eenei	ˌeenˈei
haerea	ha͡ɪrˈea
hahi	hˈahi
hangarua	hˌaŋarˈu"a
hauwaru	hˌau"wˈaru"
hiringa	hirˈiŋa
huapae	hu"ˈapa͡ɪ
huatau	hˌu"atˈau"
hāngaitanga	hˌaːŋa͡ɪtˈaŋa
hōro	hˈɔːrɔ
inarā	inˈaraː
kaiahuwhenua	kˌa͡ɪahˌu"fenˈu"a
kaimātai	ka͡ɪmˈaːta͡ɪ
kaipūtaiao	kˌa͡ɪpu"ːtˈa͡ɪa͡ʊ
kakau	kakˈau"
karawhiu	kˌarafˈiu"
kopa	kˈɔpa
kotuku	kɔtˈu"ku"
kāmera	kaːmˈera
kāpia	kaːpˈia
kōhinu	kɔːhˈinu"
kōwhaiwhai	kɔːfˈa͡ɪfa͡ɪ
lyricsHe	(͡e͡n)ˈɛl wˈa͡ɪ(͡m͡i) r ˈi (͡e͡n)sˈiː ˈɛs(͡m͡i) hˈe
maera	mˈa͡ɪra
manomita	mˌanɔmˈita
matatika	mˌatatˈika
matawai	matˈawa͡ɪ
matika	matˈika
matā	mˈataː
moka	mˈɔka
muramura	mˌu"ramˈu"ra
namata	namˈata
ngeri	ŋˈeri
ngeru	ŋˈeru"
ngū	ŋˈu"ː
peenei	pˌeenˈei
punaha	pu"nˈaha
pōkai	pˈɔːka͡ɪ
pūoru	pu"ːˈɔru"
rawaka	rawˈaka
riihi	riˈihi
rimu	rˈimu"
ringatoi	riŋˈato͡ɪ
riwai	rˈiwa͡ɪ
ränei	ranˈei
rārangitanga	rˌaːraŋitˈaŋa
rēmana	reːmˈana
shcool	(͡e͡n)ˈɛs(͡m͡i) h (͡e͡n)sˈiː(͡m͡i) ˈɔ ˈɔ (͡e͡n)ˈɛl(͡m͡i)
system	(͡e͡n)ˈɛs wˈa͡ɪ ˈɛs(͡m͡i) t ˈe m
taa	tˈaa
taau	taˈau"
tahitanga	tˌahitˈaŋa
taiaki	ta͡ɪˈaki
takahurihuri	tˌakahˌu"rihˈu"ri
tanga	tˈaŋa
tangihia	tˌaŋihˈia
taumāhekeheke	tˌau"mˌaːhekehˈeke
tautōhito	tˌau"tɔːhˈitɔ
tea	tˈea
tohuhia	tˌɔhu"hˈia
totika	tɔtˈika
tuki	tˈu"ki
turaki	tu"rˈaki
tāmi	tˈaːmi
tāneke	taːnˈeke
tāpoi	tˈaːpo͡ɪ
tātaihia	tˌaːta͡ɪhˈia
tītaha	tiːtˈaha
tōrunga	tɔːrˈu"ŋa
waero	wˈa͡ɪrɔ
waihotia	wˌa͡ɪhɔtˈia
wairangi	wa͡ɪrˈaŋi
warewaretia	wˌarewˌaretˈia
wawa	wˈawa
whakahōnore	fˌakahɔːnˈɔre
whangaia	faŋˈa͡ɪa
wheketere	fˌeketˈere
Āperahama	ˌaːperahˈama
Āwherika	ˌaːferˈika
āio	aːˈiɔ
ōnā	ˈɔːnaː
Araroa	ˌararˈɔa
Art	ˈart
Books	(͡e͡n)bˈiː(͡m͡i) ˈɔ ˈɔ k (͡e͡n)ˈɛs(͡m͡i)
Committee	(͡e͡n)sˈiː(͡m͡i) ˈɔ m m ˈi t t ˈe ˈe
Donald	(͡e͡n)dˈiː(͡m͡i) ˈɔ n ˈa (͡e͡n)ˈɛl dˈiː(͡m͡i)
Friday	(͡e͡n)ˈɛf(͡m͡i) r ˈi (͡e͡n)dˈiː(͡m͡i) ˈa (͡e͡n)wˈa͡ɪ(͡m͡i)
GPS	(͡e͡n)d͡ʒˌiː(͡m͡i)p(͡e͡n)ˈɛs(͡m͡i)
Green	(͡e͡n)d͡ʒˈiː(͡m͡i) r ˈe ˈe n
Hahi	hˈahi
Haki	hˈaki
Hape	hˈape
Heritage	h ˈe r ˈi t ˈa (͡e͡n)d͡ʒˈiː(͡m͡i) ˈe
Horomona	hˌɔrɔmˈɔna
Image	ˈi m ˈa (͡e͡n)d͡ʒˈiː(͡m͡i) ˈe
Intermediate	ˈi n t ˈe r m ˈe (͡e͡n)dˈiː(͡m͡i) ˈi ˈa t ˈe
Itari	itˈari
Karekau	kˌarekˈau"
Kawau	kawˈau"
Lord	(͡e͡n)ˈɛl(͡m͡i) ˈɔ r (͡e͡n)dˈiː(͡m͡i)
Mārire	maːrˈire
Napier	napˈier
Noa	nˈɔa
Office	ˈɔ (͡e͡n)ˈɛf ˈɛf(͡m͡i) ˈi (͡e͡n)sˈiː(͡m͡i) ˈe
Oho	ˈɔhɔ
Pani	pˈani
Patapātai	pˌatapˈaːta͡ɪ
Pomare	pɔmˈare
Poronihana	pˌɔrɔnihˈana
Pānga	pˈaːŋa
Pōtitanga	pˌɔːtitˈaŋa
RTM	rtm
Raihania	rˌa͡ɪhanˈia
Ratana	ratˈana
Rauropi	rˌau"rˈɔpi
Rerenga	rerˈeŋa
River	r ˈi (͡e͡n)vˈiː(͡m͡i) ˈe r
Rotoiti	rɔtˈo͡ɪti
Taake	taˈake
Taite	tˈa͡ɪte
Tangohanga	tˌaŋɔhˈaŋa
Tawhiao	tafˈia͡ʊ
Tina	tˈina
Tirani	tirˈani
Tāke	tˈaːke
Waikaremoana	wˌa͡ɪkarˌemɔˈana
Whiringa	firˈiŋa
Whiwhi	fˈifi
aroā	arˈɔaː
aru	ˈaru"
download	(͡e͡n)dˈiː(͡m͡i) ˈɔ w n (͡e͡n)ˈɛl(͡m͡i) ˈɔ ˈa (͡e͡n)dˈiː(͡m͡i)
hamama	hamˈama
hoihoi	hˈo͡ɪho͡ɪ
hokihoki	hˌɔkihˈɔki
kaikai	kˈa͡ɪka͡ɪ
kaipakihi	kˌa͡ɪpakˈihi
kaiwhakangungu	kˌa͡ɪfakaŋˈu"ŋu"
kakī	kˈakiː
kiato	kiˈatɔ
konihi	kɔnˈihi
kotia	kɔtˈia
kuputuhi	kˌu"pu"tˈu"hi
kutikuti	kˌu"tikˈu"ti
kutu	kˈu"tu"
kāo	kˈaːɔ
kōhua	kɔːhˈu"a
kōkuhu	kɔːkˈu"hu"
mako	mˈakɔ
makutu	makˈu"tu"
manuwhiri	mˌanu"fˈiri
muia	mu"ˈia
mātātoa	mˌaːtaːtˈɔa
paihamu	pa͡ɪhˈamu"
pakarutanga	pˌakaru"tˈaŋa
pakiwaituhi	pˌakiwa͡ɪtˈu"hi
papatahi	pˌapatˈahi
paraihe	parˈa͡ɪhe
peha	pˈeha
pewhea	pefˈea
pipiri	pipˈiri
piunga	piˈu"ŋa
pokanoa	pˌɔkanˈɔa
poupoutanga	pˌou"pˌou"tˈaŋa
pune	pˈu"ne
purakau	pˌu"rakˈau"
pūtirotiro	pˌu"ːtirɔtˈirɔ
rekereke	rˌekerˈeke
riringi	rirˈiŋi
ritamano	rˌitamˈanɔ
rito	rˈitɔ
rongopai	rɔŋˈɔpa͡ɪ
rīki	rˈiːki
taikaha	ta͡ɪkˈaha
takiuru	tˌakiˈu"ru"
tautau	tˌau"tˈau"
tautono	tˌau"tˈɔnɔ
tohutoro	tˌɔhu"tˈɔrɔ
tupono	tu"pˈɔnɔ
tōnga	tˈɔːŋa
tūhuratia	tˌu"ːhu"ratˈia
unuhia	ˌu"nu"hˈia
utunga	u"tˈu"ŋa
wehewehea	wˌehewehˈea
whakaawhiwhi	fˌakaafˈifi
whakaharatau	fˌakahˌaratˈau"
whakamamae	fˌakamˈama͡ɪ
whakamatea	fˌakamatˈea
whakamaumahara	fˌakamˌau"mahˈara
whakamaumaharatanga	fˌakamˌau"mˌaharatˈaŋa
whakatoko	fˌakatˈɔkɔ
whakatōpū	fˌakatˈɔːpu"ː
whakatūhia	fˌakatu"ːhˈia
whariki	farˈiki
whitiki	fitˈiki
whitiwhiti	fˌitifˈiti
whānako	faːnˈakɔ
wira	wˈira
wähi	wˈahi
wūru	wˈu"ːru"
xii	(͡e͡n)ˈɛks(͡m͡i) ˈi ˈi
Ārai	ˈaːra͡ɪ
Amorangi	ˌamɔrˈaŋi
Aperahama	ˌaperahˈama
Aranga	arˈaŋa
Britten	(͡e͡n)bˈiː(͡m͡i) r ˈi t t ˈe n
Business	(͡e͡n)bˈiː(͡m͡i) ˈu" (͡e͡n)ˈɛs(͡m͡i) ˈi n ˈe (͡e͡n)ˈɛs ˈɛs(͡m͡i)
Campbell	(͡e͡n)sˈiː(͡m͡i) ˈa m p (͡e͡n)bˈiː(͡m͡i) ˈe (͡e͡n)ˈɛl ˈɛl(͡m͡i)
Department	(͡e͡n)dˈiː(͡m͡i) ˈe p ˈa r t m ˈe n t
Elizabeth	ˈe (͡e͡n)ˈɛl(͡m͡i) ˈi (͡e͡n)zˈɛd(͡m͡i) ˈa (͡e͡n)bˈiː(͡m͡i) ˈe t h
England	ˈe n (͡e͡n)d͡ʒˈiː ˈɛl(͡m͡i) ˈa n (͡e͡n)dˈiː(͡m͡i)
Family	(͡e͡n)ˈɛf(͡m͡i) ˈa m ˈi (͡e͡n)ˈɛl wˈa͡ɪ(͡m͡i)
Hall	h ˈa (͡e͡n)ˈɛl ˈɛl(͡m͡i)
Hapū	hˈapu"ː
Hera	hˈera
HeritageHe	h ˈe r ˈi t ˈa (͡e͡n)d͡ʒˈiː(͡m͡i) ˈe hˈe
Hika	hˈika
Hinewhaitiri	hˌinefa͡ɪtˈiri
Hobson	h ˈɔ (͡e͡n)bˈiː ˈɛs(͡m͡i) ˈɔ n
Hokowhitu	hˌɔkɔfˈitu"
Hotunui	hˌɔtu"nˈu"i
II	ˈii
Ine	ˈine
Kaitohutohu	kˌa͡ɪtɔhu"tˈɔhu"
Kao	kˈa͡ʊ
Kimi	kˈimi
Kopu	kˈɔpu"
Korea	kɔrˈea
Kāterina	kˌaːterˈina
Kōwhiria	kˌɔːfirˈia
Manaaki	mˌanaˈaki
Milroy	m ˈi (͡e͡n)ˈɛl(͡m͡i) r ˈɔ (͡e͡n)wˈa͡ɪ(͡m͡i)
Moehau	mwehˈau"
Moeraki	mwerˈaki
Moni	mˈɔni
Morrison	m ˈɔ r r ˈi (͡e͡n)ˈɛs(͡m͡i) ˈɔ n
Muriwai	mu"rˈiwa͡ɪ
Paari	paˈari
Paeroa	pa͡ɪrˈɔa
Patariana	pˌatariˈana
Piri	pˈiri
Port	pˈɔrt
Potatau	pˌɔtatˈau"
Published	p ˈu" (͡e͡n)bˈiː ˈɛl(͡m͡i) ˈi (͡e͡n)ˈɛs(͡m͡i) h ˈe (͡e͡n)dˈiː(͡m͡i)
Puoro	pu"ˈɔrɔ
Pō	pˈɔː
Pūreta	pu"ːrˈeta
Raglan	r ˈa (͡e͡n)d͡ʒˈiː ˈɛl(͡m͡i) ˈa n
Rahi	rˈahi
Rangihiroa	rˌaŋihirˈɔa
Rāniera	rˌaːniˈera
Rūaumoko	rˌu"ːau"mˈɔkɔ
Sam	(͡e͡n)ˈɛs(͡m͡i) ˈa m
Samuel	(͡e͡n)ˈɛs(͡m͡i) ˈa m ˈu" ˈe (͡e͡n)ˈɛl(͡m͡i)
Tahuri	tahˈu"ri
Takitahi	tˌakitˈahi
Tamatoa	tˌamatˈɔa
Tauanga	tˌau"ˈaŋa
Tauaromahi	tˌau"ˌarɔmˈahi
Tom	tˈɔm
Toroa	tɔrˈɔa
Tuakana	tˌu"akˈana
Tuhi	tˈu"hi
Tuna	tˈu"na
Ua	ˈu"a
Union	u"nˈiɔn
Waihangatia	wˌa͡ɪhaŋatˈia
Wednesday	w ˈe (͡e͡n)dˈiː(͡m͡i) n ˈe (͡e͡n)ˈɛs dˈiː(͡m͡i) ˈa (͡e͡n)wˈa͡ɪ(͡m͡i)
Whakamahinga	fˌakamahˈiŋa
Whakamātauria	fˌakamˌaːtau"rˈia
ahumoana	ˌahu"mɔˈana
arahau	ˌarahˈau"
can	(͡e͡n)sˈiː(͡m͡i) ˈa n
haerehia	hˌa͡ɪrehˈia
honi	hˈɔni
huritau	hˌu"ritˈau"
hēoi	hˈeːo͡ɪ
ihotanga	ˌihɔtˈaŋa
iramutu	ˌiramˈu"tu"
kaitarai	ka͡ɪtˈara͡ɪ
kame	kˈame
katakata	kˌatakˈata
kereme	kerˈeme
keria	kerˈia
kōpaka	kɔːpˈaka
kōpiro	kɔːpˈirɔ
kōrari	kɔːrˈari
matao	mˈata͡ʊ
mawhiti	mafˈiti
momona	mɔmˈɔna
moohio	mˌɔɔhˈiɔ
moroiti	mɔrˈo͡ɪti
motupaika	mˌɔtu"pˈa͡ɪka
moumou	mˌou"mˈou"
mōkito	mɔːkˈitɔ
mōku	mˈɔːku"
ngatahi	ŋatˈahi
ngira	ŋˈira
noaiho	nɔˈa͡ɪhɔ
nohanga	nɔhˈaŋa
ohonga	ɔhˈɔŋa
ohooho	ˌɔhɔˈɔhɔ
onepū	ɔnˈepu"ː
orite	ɔrˈite
paea	pˈa͡ɪa
patupaiarehe	pˌatu"pˌa͡ɪarˈehe
poke	pˈɔke
poutū	poˈu"tu"ː
pākeke	paːkˈeke
pīrangitia	pˌiːraŋitˈia
pōhara	pɔːhˈara
pōhiri	pɔːhˈiri
pūkei	pu"ːkˈei
rarau	rarˈau"
rea	rˈea
repe	rˈepe
riki	rˈiki
ripa	rˈipa
taapiri	tˌaapˈiri
takai	tˈaka͡ɪ
tanu	tˈanu"
tapatahi	tˌapatˈahi
taratara	tˌaratˈara
taria	tarˈia
tatahi	tatˈahi
tekoteko	tˌekɔtˈekɔ
tiamana	tˌiamˈana
toha	tˈɔha
tohia	tɔhˈia
tope	tˈɔpe
tuatahitanga	tˌu"atˌahitˈaŋa
tuawhitu	tˌu"afˈitu"
tuia	tu"ˈia
tukatuka	tˌu"katˈu"ka
tungāne	tu"ŋˈaːne
turuki	tu"rˈu"ki
turuturu	tˌu"ru"tˈu"ru"
tākina	taːkˈina
tākupu	taːkˈu"pu"
tāruke	taːrˈu"ke
urutau	ˌu"ru"tˈau"
vi	(͡e͡n)vˈiː(͡m͡i) ˈi
waina	wˈa͡ɪna
werohanga	wˌerɔhˈaŋa
whakaaotanga	fˌakaa͡ʊtˈaŋa
whakahekea	fˌakahekˈea
whakakao	fakˈaka͡ʊ
whakakāhoretia	fˌakakˌaːhɔretˈia
whakamutua	fˌakamu"tˈu"a
whakanikoniko	fˌakanˌikɔnˈikɔ
whakapainga	fˌakapˈa͡ɪŋa
whakarau	fˌakarˈau"
whakarewahia	fˌakarˌewahˈia
whakarārangitia	fˌakarˌaːraŋitˈia
whakatakariri	fˌakatˌakarˈiri
whakatītina	fˌakatiːtˈina
wiri	wˈiri
wānaka	waːnˈaka
wētahi	weːtˈahi
Ötautahi	ˌɔtau"tˈahi
ënei	enˈei
Affairs	ˈa (͡e͡n)ˈɛf ˈɛf(͡m͡i) ˈa ˈi r (͡e͡n)ˈɛs(͡m͡i)
Army	ˈa r m (͡e͡n)wˈa͡ɪ(͡m͡i)
Atiawa	ˌatiˈawa
Awherika	ˌaferˈika
Broughton	(͡e͡n)bˈiː(͡m͡i) r ˈɔ ˈu" (͡e͡n)d͡ʒˈiː(͡m͡i) h t ˈɔ n
Clark	(͡e͡n)sˈiː ˈɛl(͡m͡i) ˈa r k
Click	(͡e͡n)sˈiː ˈɛl(͡m͡i) ˈi (͡e͡n)sˈiː(͡m͡i) k
Educational	ˈe (͡e͡n)dˈiː(͡m͡i) ˈu" (͡e͡n)sˈiː(͡m͡i) ˈa t ˈi ˈɔ n ˈa (͡e͡n)ˈɛl(͡m͡i)
Erima	erˈima
Fox	(͡e͡n)ˈɛf(͡m͡i) ˈɔ (͡e͡n)ˈɛks(͡m͡i)
Gisborne	(͡e͡n)d͡ʒˈiː(͡m͡i) ˈi (͡e͡n)ˈɛs bˈiː(͡m͡i) ˈɔ r n ˈe
HIV	h ˈi (͡e͡n)vˈiː(͡m͡i)
Herenga	herˈeŋa
Hiranga	hirˈaŋa
Hunga	hˈu"ŋa
Hākinakina	hˌaːkinakˈina
IV	ˈi (͡e͡n)vˈiː(͡m͡i)
Jackson	(͡e͡n)d͡ʒˈe͡ɪ(͡m͡i) ˈa (͡e͡n)sˈiː(͡m͡i) k (͡e͡n)ˈɛs(͡m͡i) ˈɔ n
Karihi	karˈihi
Kīia	kiːˈia
Mata	mˈata
Miro	mˈirɔ
Muturangi	mˌu"tu"rˈaŋi
Nawai	nˈawa͡ɪ
Papaioea	pˌapa͡ɪwˈea
Party	p ˈa r t (͡e͡n)wˈa͡ɪ(͡m͡i)
Pau	pˈau"
Pono	pˈɔnɔ
Prime	prˈime
Pōkiha	pɔːkˈiha
Raka	rˈaka
Raupapahia	rˌau"pˌapahˈia
Rawinia	rˌawinˈia
Rongoā	rɔŋˈɔaː
Ruawharo	rˌu"afˈarɔ
Southern	(͡e͡n)ˈɛs(͡m͡i) ˈɔ ˈu" t h ˈe r n
Submitted	(͡e͡n)ˈɛs(͡m͡i) ˈu" (͡e͡n)bˈiː(͡m͡i) m ˈi t t ˈe (͡e͡n)dˈiː(͡m͡i)
Taha	tˈaha
Taro	tˈarɔ
Tatauria	tˌatau"rˈia
Tauihu	tˌau"ˈihu"
Tianara	tˌianˈara
Tokomaha	tˌɔkɔmˈaha
Toro	tˈɔrɔ
Tākaro	taːkˈarɔ
Tāngata	taːŋˈata
Tīmata	tiːmˈata
Tūhura	tu"ːhˈu"ra
Victoria	(͡e͡n)vˈiː(͡m͡i) ˈi (͡e͡n)sˈiː(͡m͡i) t ˈɔ r ˈi ˈa
Wahanga	wahˈaŋa
Waimate	wa͡ɪmˈate
Waiora	wa͡ɪˈɔra
Whakautua	fˌakau"tˈu"a
Whatatutu	fˌatatˈu"tu"
Whatuiapiti	fˌatu"ˌiapˈiti
Whitinga	fitˈiŋa
Young	(͡e͡n)wˈa͡ɪ(͡m͡i) ˈɔ ˈu" n (͡e͡n)d͡ʒˈiː(͡m͡i)
admin	ˈa (͡e͡n)dˈiː(͡m͡i) m ˈi n
akohia	ˌakɔhˈia
amorangi	ˌamɔrˈaŋi
arotau	ˌarɔtˈau"
haau	haˈau"
hamumu	hamˈu"mu"
haukoti	hˌau"kˈɔti
haukāinga	hˌau"kaːˈiŋa
hautū	haˈu"tu"ː
houhia	hˌou"hˈia
hīkoikoi	hiːkˈo͡ɪko͡ɪ
hūnga	hˈu"ːŋa
images	ˈi m ˈa (͡e͡n)d͡ʒˈiː(͡m͡i) ˈe (͡e͡n)ˈɛs(͡m͡i)
ioio	iˈo͡ɪɔ
kahawai	kahˈawa͡ɪ
kaipāmu	ka͡ɪpˈaːmu"
kaipūrongo	kˌa͡ɪpu"ːrˈɔŋɔ
katinga	katˈiŋa
km	km
kokoti	kɔkˈɔti
kuru	kˈu"ru"
käore	kˈa͡ʊre
manahau	mˌanahˈau"
matamua	mˌatamˈu"a
mataora	matˈa͡ʊra
mauhia	mˌau"hˈia
mitamano	mˌitamˈanɔ
moo	mˈɔɔ
mānuka	maːnˈu"ka
mārakerake	mˌaːrakerˈake
māti	mˈaːti
mātāwaka	mˌaːtaːwˈaka
nanao	nˈana͡ʊ
ngutuawa	ŋˌu"tu"ˈawa
noku	nˈɔku"
pahemo	pahˈemɔ
paiheretia	pˌa͡ɪheretˈia
pakipūmeka	pˌakipu"ːmˈeka
patohanga	pˌatɔhˈaŋa
pekanga	pekˈaŋa
pekapeka	pˌekapˈeka
pereki	perˈeki
pokea	pɔkˈea
purākau	pˌu"raːkˈau"
pänui	panˈu"i
pītau	piːtˈau"
pūranga	pu"ːrˈaŋa
pūtaketanga	pˌu"ːtaketˈaŋa
pūāhua	pˌu"ːaːhˈu"a
rerehua	rˌerehˈu"a
rongomau	rˌɔŋɔmˈau"
ru	rˈu"
rumakina	rˌu"makˈina
rērere	reːrˈere
taatou	tˌaatˈou"
taihemahema	tˌa͡ɪhemahˈema
takiri	takˈiri
taotū	tˈa͡ʊtu"ː
tautohua	tˌau"tɔhˈu"a
tauā	taˈu"aː
teretere	tˌeretˈere
toanga	tɔˈaŋa
tohea	tɔhˈea
tohetohe	tˌɔhetˈɔhe
tākiri	taːkˈiri
tāonga	taːˈɔŋa
tātaritanga	tˌaːtaritˈaŋa
umere	u"mˈere
wahapū	wahˈapu"ː
wahia	wahˈia
waiariki	wˌa͡ɪarˈiki
weherua	wˌeherˈu"a
weka	wˈeka
whakahaumako	fˌakahˌau"mˈakɔ
whakahoungia	fˌakahˌou"ŋˈia
whakahāwea	fˌakahaːwˈea
whakahōu	fˌakahˈɔːu"
whakakotahitanga	fˌakakˌɔtahitˈaŋa
whakamaheretia	fˌakamˌaheretˈia
whakamate	fˌakamˈate
whakaohooho	fˌaka͡ʊhɔˈɔhɔ
whakapaitanga	fˌakapa͡ɪtˈaŋa
whakapaparanga	fˌakapˌaparˈaŋa
whakaratoa	fˌakaratˈɔa
whakatikaina	fˌakatikˈa͡ɪna
whakatupuria	fˌakatˌu"pu"rˈia
whakatūturu	fˌakatu"ːtˈu"ru"
whawhaitia	fˌafa͡ɪtˈia
wherawhera	fˌerafˈera
which	w h ˈi (͡e͡n)sˈiː(͡m͡i) h
will	w ˈi (͡e͡n)ˈɛl ˈɛl(͡m͡i)
āniwhaniwha	ˌaːnifanˈifa
īnoi	ˈiːno͡ɪ
APEC	ˈa p ˈe (͡e͡n)sˈiː(͡m͡i)
Alex	ˈa (͡e͡n)ˈɛl(͡m͡i) ˈe (͡e͡n)ˈɛks(͡m͡i)
Arapeta	ˌarapˈeta
Area	arˈea
Bell	(͡e͡n)bˈiː(͡m͡i) ˈe (͡e͡n)ˈɛl ˈɛl(͡m͡i)
Cambridge	(͡e͡n)sˈiː(͡m͡i) ˈa m (͡e͡n)bˈiː(͡m͡i) r ˈi (͡e͡n)dˈiː d͡ʒˈiː(͡m͡i) ˈe
Company	(͡e͡n)sˈiː(͡m͡i) ˈɔ m p ˈa n (͡e͡n)wˈa͡ɪ(͡m͡i)
Cross	(͡e͡n)sˈiː(͡m͡i) r ˈɔ (͡e͡n)ˈɛs ˈɛs(͡m͡i)
Cultural	(͡e͡n)sˈiː(͡m͡i) ˈu" (͡e͡n)ˈɛl(͡m͡i) t ˈu" r ˈa (͡e͡n)ˈɛl(͡m͡i)
Davis	(͡e͡n)dˈiː(͡m͡i) ˈa (͡e͡n)vˈiː(͡m͡i) ˈi (͡e͡n)ˈɛs(͡m͡i)
Day	(͡e͡n)dˈiː(͡m͡i) ˈa (͡e͡n)wˈa͡ɪ(͡m͡i)
Duncan	(͡e͡n)dˈiː(͡m͡i) ˈu" n (͡e͡n)sˈiː(͡m͡i) ˈa n
Edwards	ˈe (͡e͡n)dˈiː(͡m͡i) w ˈa r (͡e͡n)dˈiː ˈɛs(͡m͡i)
Foundation	(͡e͡n)ˈɛf(͡m͡i) ˈɔ ˈu" n (͡e͡n)dˈiː(͡m͡i) ˈa t ˈi ˈɔ n
GST	(͡e͡n)d͡ʒˌiːˈɛs(͡m͡i)t
Greenpeace	(͡e͡n)d͡ʒˈiː(͡m͡i) r ˈe ˈe n p ˈe ˈa (͡e͡n)sˈiː(͡m͡i) ˈe
Hakinakina	hˌakinakˈina
Hao	hˈa͡ʊ
Hawaii	hawˈa͡ɪi
Heamana	hˌeamˈana
Highway	h ˈi (͡e͡n)d͡ʒˈiː(͡m͡i) h w ˈa (͡e͡n)wˈa͡ɪ(͡m͡i)
Hoi	hˈo͡ɪ
Hon	hˈɔn
Hoturoa	hˌɔtu"rˈɔa
Howard	h ˈɔ w ˈa r (͡e͡n)dˈiː(͡m͡i)
Ihenga	ihˈeŋa
Kaiapoi	ka͡ɪˈapo͡ɪ
Kamo	kˈamɔ
Kelly	k ˈe (͡e͡n)ˈɛl ˈɛl wˈa͡ɪ(͡m͡i)
Kiekie	kˌiekˈie
Kōhure	kɔːhˈu"re
Maaui	mˌaaˈu"i
Manuka	manˈu"ka
Margaret	m ˈa r (͡e͡n)d͡ʒˈiː(͡m͡i) ˈa r ˈe t
Matenga	matˈeŋa
Matewhawhati	mˌatefafˈati
Mauao	maˈu"a͡ʊ
Michelle	m ˈi (͡e͡n)sˈiː(͡m͡i) h ˈe (͡e͡n)ˈɛl ˈɛl(͡m͡i) ˈe
Mitchell	m ˈi t (͡e͡n)sˈiː(͡m͡i) h ˈe (͡e͡n)ˈɛl ˈɛl(͡m͡i)
Murihiku	mˌu"rihˈiku"
Network	nˈetwɔrk
Ngāruawāhia	ŋˌaːru"ˌawaːhˈia
Pere	pˈere
Pitopito	pˌitɔpˈitɔ
Polynesian	p ˈɔ (͡e͡n)ˈɛl wˈa͡ɪ(͡m͡i) n ˈe (͡e͡n)ˈɛs(͡m͡i) ˈi ˈa n
PōtiNgāwari	pˈɔːti ŋaːwˈari
Rangatahi	rˌaŋatˈahi
Rarohenga	rˌarɔhˈeŋa
Rd	r(͡e͡n)dˈiː(͡m͡i)
References	r ˈe (͡e͡n)ˈɛf(͡m͡i) ˈe r ˈe n (͡e͡n)sˈiː(͡m͡i) ˈe (͡e͡n)ˈɛs(͡m͡i)
Rito	rˈitɔ
Ruatepupuke	rˌu"atˌepu"pˈu"ke
Rārangihia	rˌaːraŋihˈia
Sarah	(͡e͡n)ˈɛs(͡m͡i) ˈa r ˈa h
States	(͡e͡n)ˈɛs(͡m͡i) t ˈa t ˈe (͡e͡n)ˈɛs(͡m͡i)
Teitei	tˌeitˈei
Tibble	t ˈi (͡e͡n)bˈiː bˈiː ˈɛl(͡m͡i) ˈe
Tokotoru	tˌɔkɔtˈɔru"
Tāhūhū	taːhˈu"ːhu"ː
Tāmakimakaurau	tˌaːmakˌimakˌau"rˈau"
Tē	tˈeː
Tīpene	tiːpˈene
Wayne	w ˈa (͡e͡n)wˈa͡ɪ(͡m͡i) n ˈe
Wehi	wˈehi
Whakaae	fakˈaa͡ɪ
Whakatōhea	fˌakatɔːhˈea
Wēteriana	wˌeːteriˈana
aianei	ˌa͡ɪanˈei
arotahinga	ˌarɔtahˈiŋa
events	ˈe (͡e͡n)vˈiː(͡m͡i) ˈe n t (͡e͡n)ˈɛs(͡m͡i)
hahana	hahˈana
hapūtanga	hˌapu"ːtˈaŋa
haurima	hˌau"rˈima
hautipua	hˌau"tipˈu"a
hewa	hˈewa
hinganga	hiŋˈaŋa
hukahuka	hˌu"kahˈu"ka
hīkaka	hiːkˈaka
hīkina	hiːkˈina
ikeike	ˌikeˈike
kaihaka	ka͡ɪhˈaka
kaingakau	kˌa͡ɪŋakˈau"
kaingārahu	kˌa͡ɪŋaːrˈahu"
kaiwhakamārama	kˌa͡ɪfakˌamaːrˈama
kaiwhakaora	kˌa͡ɪfakˈa͡ʊra
kaiwhakarite	kˌa͡ɪfakarˈite
kariri	karˈiri
karukaru	kˌaru"kˈaru"
kawekawe	kˌawekˈawe
kohine	kɔhˈine
kopae	kˈɔpa͡ɪ
kuaore	ku"ˈa͡ʊre
kï	kˈi
kāpene	kaːpˈene
kētanga	keːtˈaŋa
kūaha	ku"ːˈaha
mahaki	mahˈaki
manawataki	mˌanawatˈaki
matarau	mˌatarˈau"
miihini	mˌiihˈini
mirimiri	mˌirimˈiri
mokete	mɔkˈete
mānu	mˈaːnu"
mātārere	mˌaːtaːrˈere
nekenekehanga	nˌekenˌekehˈaŋa
ng	n(͡e͡n)d͡ʒˈiː(͡m͡i)
ngahoro	ŋahˈɔrɔ
ngoi	ŋˈo͡ɪ
ngunguru	ŋu"ŋˈu"ru"
not	nˈɔt
oona	ɔˈɔna
paerua	pa͡ɪrˈu"a
pania	panˈia
paoho	pˈa͡ʊhɔ
parai	pˈara͡ɪ
parepare	pˌarepˈare
patipati	pˌatipˈati
patuki	patˈu"ki
piupiu	pˌiu"pˈiu"
pokai	pˈɔka͡ɪ
pürongo	pu"rˈɔŋɔ
pāwera	paːwˈera
pōtaka	pɔːtˈaka
pōuriuri	pˌɔːu"riˈu"ri
pūhia	pu"ːhˈia
pūira	pu"ːˈira
pūkana	pu"ːkˈana
pūkohu	pu"ːkˈɔhu"
rangimarie	rˌaŋimarˈie
rarauhe	rˌaraˈu"he
rerewhenua	rˌerefenˈu"a
taara	taˈara
takohanga	tˌakɔhˈaŋa
tapahanga	tˌapahˈaŋa
tiaho	tiˈahɔ
tikaka	tikˈaka
tokowhitu	tˌɔkɔfˈitu"
tuaiwi	tu"ˈa͡ɪwi
tuarongo	tˌu"arˈɔŋɔ
tuke	tˈu"ke
tukia	tu"kˈia
type	t (͡e͡n)wˈa͡ɪ(͡m͡i) p ˈe
tāruatia	tˌaːru"atˈia
tūhonotanga	tˌu"ːhɔnɔtˈaŋa
up	ˈu"p
whakahauhau	fˌakahˌau"hˈau"
whakahī	fakˈahiː
whakairihia	fˌaka͡ɪrihˈia
whakakake	fˌakakˈake
whakamanatanga	fˌakamˌanatˈaŋa
whakamoe	fakˈamwe
whakamomori	fˌakamɔmˈɔri
whakanuitanga	fˌakanˌu"itˈaŋa
whakaputu	fˌakapˈu"tu"
whakaranua	fˌakaranˈu"a
whakaratonga	fˌakaratˈɔŋa
whakarewaina	fˌakarewˈa͡ɪna
whakarākei	fˌakaraːkˈei
whakatahi	fˌakatˈahi
whakatipuria	fˌakatˌipu"rˈia
whakatōkia	fˌakatɔːkˈia
whakawehea	fˌakawehˈea
whakawhitiwhitinga	fˌakafˌitifitˈiŋa
whutuporo	fˌu"tu"pˈɔrɔ
Ākene	aːkˈene
Ōpango	ɔːpˈaŋɔ
AJHR	ˈa (͡e͡n)d͡ʒˈe͡ɪ(͡m͡i) h r
AUT	ˈau"t
Aku	ˈaku"
Alan	ˈa (͡e͡n)ˈɛl(͡m͡i) ˈa n
Anā	ˈanaː
Aorangi	a͡ʊrˈaŋi
Aromātai	ˌarɔmˈaːta͡ɪ
Ataarangi	ˌataarˈaŋi
BiographyDDC	(͡e͡n)bˈiː(͡m͡i) ˈi ˈɔ (͡e͡n)d͡ʒˈiː(͡m͡i) r ˈa p h (͡e͡n)wˈa͡ɪ dˌiːdˌiːsˈiː(͡m͡i)
Blake	(͡e͡n)bˈiː ˈɛl(͡m͡i) ˈa k ˈe
Book	(͡e͡n)bˈiː(͡m͡i) ˈɔ ˈɔ k
Cape	(͡e͡n)sˈiː(͡m͡i) ˈa p ˈe
Catholic	(͡e͡n)sˈiː(͡m͡i) ˈa t h ˈɔ (͡e͡n)ˈɛl(͡m͡i) ˈi (͡e͡n)sˈiː(͡m͡i)
DNA	(͡e͡n)dˈiː(͡m͡i) n ˈa
Dave	(͡e͡n)dˈiː(͡m͡i) ˈa (͡e͡n)vˈiː(͡m͡i) ˈe
Emma	ˈemma
First	(͡e͡n)ˈɛf(͡m͡i) ˈi r (͡e͡n)ˈɛs(͡m͡i) t
Fitzgerald	(͡e͡n)ˈɛf(͡m͡i) ˈi t (͡e͡n)zˈɛd d͡ʒˈiː(͡m͡i) ˈe r ˈa (͡e͡n)ˈɛl dˈiː(͡m͡i)
Galleries	(͡e͡n)d͡ʒˈiː(͡m͡i) ˈa (͡e͡n)ˈɛl ˈɛl(͡m͡i) ˈe r ˈi ˈe (͡e͡n)ˈɛs(͡m͡i)
Haria	harˈia
Hastings	h ˈa (͡e͡n)ˈɛs(͡m͡i) t ˈi n (͡e͡n)d͡ʒˈiː ˈɛs(͡m͡i)
Hatupatu	hˌatu"pˈatu"
Horouta	hˌɔroˈu"ta
Inea	inˈea
Inspector	ˈi n (͡e͡n)ˈɛs(͡m͡i) p ˈe (͡e͡n)sˈiː(͡m͡i) t ˈɔ r
Interview	ˈi n t ˈe r (͡e͡n)vˈiː(͡m͡i) ˈi ˈe w
Ipu	ˈipu"
Jim	(͡e͡n)d͡ʒˈe͡ɪ(͡m͡i) ˈi m
Julie	(͡e͡n)d͡ʒˈe͡ɪ(͡m͡i) ˈu" (͡e͡n)ˈɛl(͡m͡i) ˈi ˈe
Kaipōti	ka͡ɪpˈɔːti
Kaiwhakaako	kˌa͡ɪfakaˈakɔ
Kapene	kapˈene
Kauwhata	kˌau"fˈata
Koe	kwˈe
Kohanga	kɔhˈaŋa
Kuaka	ku"ˈaka
Labour	(͡e͡n)ˈɛl(͡m͡i) ˈa (͡e͡n)bˈiː(͡m͡i) ˈɔ ˈu" r
Leni	(͡e͡n)ˈɛl(͡m͡i) ˈe n ˈi
Lodge	(͡e͡n)ˈɛl(͡m͡i) ˈɔ (͡e͡n)dˈiː d͡ʒˈiː(͡m͡i) ˈe
Makau	makˈau"
Mano	mˈanɔ
Maraenui	mˌara͡ɪnˈu"i
Mokoia	mɔkˈo͡ɪa
Morgan	m ˈɔ r (͡e͡n)d͡ʒˈiː(͡m͡i) ˈa n
Mātua	maːtˈu"a
Nōna	nˈɔːna
Oxford	ˈɔ (͡e͡n)ˈɛks ˈɛf(͡m͡i) ˈɔ r (͡e͡n)dˈiː(͡m͡i)
Paengawhāwhā	pˌa͡ɪŋafˈaːfaː
Paraihe	parˈa͡ɪhe
Pera	pˈera
Ponga	pˈɔŋa
Pūnaha	pu"ːnˈaha
Rangitaiki	rˌaŋitˈa͡ɪki
Rereroa	rˌererˈɔa
Reserve	r ˈe (͡e͡n)ˈɛs(͡m͡i) ˈe r (͡e͡n)vˈiː(͡m͡i) ˈe
Roera	rwˈera
Ryan	r (͡e͡n)wˈa͡ɪ(͡m͡i) ˈa n
Rēhita	reːhˈita
Science	(͡e͡n)ˈɛs sˈiː(͡m͡i) ˈi ˈe n (͡e͡n)sˈiː(͡m͡i) ˈe
Sound	(͡e͡n)ˈɛs(͡m͡i) ˈɔ ˈu" n (͡e͡n)dˈiː(͡m͡i)
Sunday	(͡e͡n)ˈɛs(͡m͡i) ˈu" n (͡e͡n)dˈiː(͡m͡i) ˈa (͡e͡n)wˈa͡ɪ(͡m͡i)
Taiopenga	tˌa͡ɪɔpˈeŋa
Tangaere	taŋˈa͡ɪre
Tirikātene	tˌirikaːtˈene
Toby	t ˈɔ (͡e͡n)bˈiː wˈa͡ɪ(͡m͡i)
Tokowhā	tɔkˈɔfaː
Turei	tu"rˈei
Tīmatanga	tˌiːmatˈaŋa
Tūhurahia	tˌu"ːhu"rahˈia
Wero	wˈerɔ
Whakaminenga	fˌakaminˈeŋa
Whakanui	fˌakanˈu"i
Whakataetae	fˌakatˈa͡ɪta͡ɪ
Years	(͡e͡n)wˈa͡ɪ(͡m͡i) ˈe ˈa r (͡e͡n)ˈɛs(͡m͡i)
acknowledgements	ˈa (͡e͡n)sˈiː(͡m͡i) k n ˈɔ w (͡e͡n)ˈɛl(͡m͡i) ˈe (͡e͡n)dˈiː d͡ʒˈiː(͡m͡i) ˈe m ˈe n t (͡e͡n)ˈɛs(͡m͡i)
angaanga	ˌaŋaˈaŋa
anuanu	ˌanu"ˈanu"
aria	arˈia
aute	aˈu"te
been	(͡e͡n)bˈiː(͡m͡i) ˈe ˈe n
haehaea	ha͡ɪhˈa͡ɪa
haupapa	hˌau"pˈapa
heri	hˈeri
hina	hˈina
hiriwa	hirˈiwa
history	h ˈi (͡e͡n)ˈɛs(͡m͡i) t ˈɔ r (͡e͡n)wˈa͡ɪ(͡m͡i)
ho	hˈɔ
huata	hu"ˈata
hōpua	hɔːpˈu"a
kahakina	kˌahakˈina
kaihautu	kˌa͡ɪhaˈu"tu"
kaihoahoa	kˌa͡ɪhɔahˈɔa
kaitātaki	kˌa͡ɪtaːtˈaki
kaiwhakautu	kˌa͡ɪfakaˈu"tu"
kohua	kɔhˈu"a
konganuku	kˌɔŋanˈu"ku"
konohete	kˌɔnɔhˈete
koti	kˈɔti
kuao	kˈu"a͡ʊ
kānapanapa	kˌaːnapanˈapa
maharatanga	mˌaharatˈaŋa
mahau	mahˈau"
maheni	mahˈeni
manapori	mˌanapˈɔri
marere	marˈere
marika	marˈika
marumaru	mˌaru"mˈaru"
mere	mˈere
māhita	maːhˈita
māka	mˈaːka
mātāpuna	mˌaːtaːpˈu"na
ngēnei	ŋeːnˈei
nohonoho	nˌɔhɔnˈɔhɔ
nou	nˈou"
oati	ɔˈati
our	ˈou"r
pahua	pahˈu"a
papā	pˈapaː
parae	pˈara͡ɪ
parera	parˈera
pati	pˈati
piua	piˈu"a
poipoia	po͡ɪpˈo͡ɪa
potaka	pɔtˈaka
poutokomanawa	pˌou"tˌɔkɔmanˈawa
pukana	pu"kˈana
punahiko	pˌu"nahˈikɔ
pūata	pu"ːˈata
pūrēhua	pˌu"ːreːhˈu"a
pūtoro	pu"ːtˈɔrɔ
raiti	rˈa͡ɪti
raweketia	rˌaweketˈia
rehita	rehˈita
retireti	rˌetirˈeti
takuta	takˈu"ta
taraipiunara	tˌara͡ɪpˌiu"nˈara
taumau	tˌau"mˈau"
taunaha	tˌau"nˈaha
taurea	tˌau"rˈea
tawai	tˈawa͡ɪ
teachers	t ˈe ˈa (͡e͡n)sˈiː(͡m͡i) h ˈe r (͡e͡n)ˈɛs(͡m͡i)
tohutō	tɔhˈu"tɔː
tokowha	tɔkˈɔfa
tumanakohia	tˌu"manˌakɔhˈia
tö	tˈɔ
tāniko	taːnˈikɔ
tāruatanga	tˌaːru"atˈaŋa
tīwhiri	tiːfˈiri
tōtā	tˈɔːtaː
tūkinotia	tˌu"ːkinɔtˈia
tūtata	tu"ːtˈata
tūī	tˈu"ːiː
uaratanga	ˌu"aratˈaŋa
urutā	u"rˈu"taː
weera	weˈera
wetekina	wˌetekˈina
whakahekenga	fˌakahekˈeŋa
whakamaheretanga	fˌakamˌaheretˈaŋa
whakamaramatia	fˌakamˌaramatˈia
whakamaroke	fˌakamarˈɔke
whakamātao	fˌakamˈaːta͡ʊ
whakataungia	fˌakatˌau"ŋˈia
whakatinanatia	fˌakatˌinanatˈia
whakatūtū	fˌakatˈu"ːtu"ː
whakawera	fˌakawˈera
whakawāteatia	fˌakawˌaːteatˈia
wharepuni	fˌarepˈu"ni
whitia	fitˈia
whārua	faːrˈu"a
whēnā	fˈeːnaː
wāpu	wˈaːpu"
Āhuahanga	ˌaːhu"ahˈaŋa
Ākona	aːkˈɔna
Ōpōtiki	ˌɔːpɔːtˈiki
ACC	ˈa (͡e͡n)sˈiː sˈiː(͡m͡i)
Aotaki	a͡ʊtˈaki
Brian	(͡e͡n)bˈiː(͡m͡i) r ˈi ˈa n
Busby	(͡e͡n)bˈiː(͡m͡i) ˈu" (͡e͡n)ˈɛs bˈiː wˈa͡ɪ(͡m͡i)
Clare	(͡e͡n)sˈiː ˈɛl(͡m͡i) ˈa r ˈe
D	(͡e͡n)dˈiː(͡m͡i)
DHB	(͡e͡n)dˌiː(͡m͡i)h(͡e͡n)bˈiː(͡m͡i)
DOC	(͡e͡n)dˈiː(͡m͡i) ˈɔ (͡e͡n)sˈiː(͡m͡i)
Douglas	(͡e͡n)dˈiː(͡m͡i) ˈɔ ˈu" (͡e͡n)d͡ʒˈiː ˈɛl(͡m͡i) ˈa (͡e͡n)ˈɛs(͡m͡i)
Goulton	(͡e͡n)d͡ʒˈiː(͡m͡i) ˈɔ ˈu" (͡e͡n)ˈɛl(͡m͡i) t ˈɔ n
Grey	(͡e͡n)d͡ʒˈiː(͡m͡i) r ˈe (͡e͡n)wˈa͡ɪ(͡m͡i)
Grove	(͡e͡n)d͡ʒˈiː(͡m͡i) r ˈɔ (͡e͡n)vˈiː(͡m͡i) ˈe
Hakawau	hˌakawˈau"
Hapanihi	hˌapanˈihi
Hauiti	hˌau"ˈiti
Hineteiwaiwa	hˌinetˌeiwˈa͡ɪwa
Hopa	hˈɔpa
Hurihia	hˌu"rihˈia
Hīroa	hiːrˈɔa
It	ˈit
Iāri	iˈaːri
KKM	kkm
Kaiwhakarite	kˌa͡ɪfakarˈite
Katerina	kˌaterˈina
Kohitātea	kˌɔhitaːtˈea
Kōmiti	kɔːmˈiti
LINZ	(͡e͡n)ˈɛl(͡m͡i) ˈi n (͡e͡n)zˈɛd(͡m͡i)
Maihi	mˈa͡ɪhi
Manawatu	mˌanawˈatu"
Maria	marˈia
Matahiko	mˌatahˈikɔ
Matapihi	mˌatapˈihi
Mōteatea	mˌɔːteatˈea
Nene	nˈene
Ngārimu	ŋaːrˈimu"
Nōku	nˈɔːku"
People	p ˈe ˈɔ p (͡e͡n)ˈɛl(͡m͡i) ˈe
Perohuka	pˌerɔhˈu"ka
Phil	p h ˈi (͡e͡n)ˈɛl(͡m͡i)
Police	p ˈɔ (͡e͡n)ˈɛl(͡m͡i) ˈi (͡e͡n)sˈiː(͡m͡i) ˈe
Punarua	pˌu"narˈu"a
Putanga	pu"tˈaŋa
Pōtiki	pɔːtˈiki
Rangitihi	rˌaŋitˈihi
Rees	r ˈe ˈe (͡e͡n)ˈɛs(͡m͡i)
Rehunga	rehˈu"ŋa
Resources	r ˈe (͡e͡n)ˈɛs(͡m͡i) ˈɔ ˈu" r (͡e͡n)sˈiː(͡m͡i) ˈe (͡e͡n)ˈɛs(͡m͡i)
Rite	rˈite
Rokohanga	rˌɔkɔhˈaŋa
Rongomaraeroa	rˌɔŋɔmˌara͡ɪrˈɔa
Roopū	rɔˈɔpu"ː
Ruapehu	rˌu"apˈehu"
Rāhiri	raːhˈiri
Rōpata	rɔːpˈata
Susan	(͡e͡n)ˈɛs(͡m͡i) ˈu" (͡e͡n)ˈɛs(͡m͡i) ˈa n
TEETH	tˈeeth
TMoA	t mˈɔ ˈa
TTT	ttt
Takirua	tˌakirˈu"a
Taria	tarˈia
Taumārere	tˌau"maːrˈere
Tawhiti	tafˈiti
Team	tˈeam
Tetahi	tetˈahi
Tiro	tˈirɔ
Tuwhakararo	tˌu"fakarˈarɔ
Tāmihana	tˌaːmihˈana
Tātaki	taːtˈaki
Tūmanako	tˌu"ːmanˈakɔ
Tūrangawaewae	tˌu"ːraŋawˈa͡ɪwa͡ɪ
Tūrongo	tu"ːrˈɔŋɔ
Tūtarawānanga	tˌu"ːtarˌawaːnˈaŋa
Uia	u"ˈia
Uniana	ˌu"niˈana
Ururoa	ˌu"ru"rˈɔa
Whakaora	fakˈa͡ʊra
Whakapakari	fˌakapakˈari
Whakatūria	fˌakatu"ːrˈia
Whakawhanake	fˌakafanˈake
Whiting	fˈitiŋ
Year	(͡e͡n)wˈa͡ɪ(͡m͡i) ˈe ˈa r
aio	ˈa͡ɪɔ
araa	arˈaa
areare	ˌareˈare
aromatawaitia	ˌarɔmˌatawa͡ɪtˈia
century	(͡e͡n)sˈiː(͡m͡i) ˈe n t ˈu" r (͡e͡n)wˈa͡ɪ(͡m͡i)
education	ˈe (͡e͡n)dˈiː(͡m͡i) ˈu" (͡e͡n)sˈiː(͡m͡i) ˈa t ˈi ˈɔ n
enabling	ˈe n ˈa (͡e͡n)bˈiː ˈɛl(͡m͡i) ˈi n (͡e͡n)d͡ʒˈiː(͡m͡i)
hauwai	haˈu"wa͡ɪ
have	h ˈa (͡e͡n)vˈiː(͡m͡i) ˈe
heeki	heˈeki
hikina	hikˈina
hoenga	hwˈeŋa
hohonutanga	hˌɔhɔnu"tˈaŋa
houra	hoˈu"ra
huaketo	hˌu"akˈetɔ
hupa	hˈu"pa
hāngū	hˈaːŋu"ː
hōmai	hˈɔːma͡ɪ
imu	ˈimu"
irāmutu	ˌiraːmˈu"tu"
ite	ˈite
kaitōrangapū	kˌa͡ɪtɔːraŋˈapu"ː
kakari	kakˈari
karaitiana	kˌara͡ɪtiˈana
kikī	kˈikiː
kitehia	kˌitehˈia
koira	kˈo͡ɪra
koiri	kˈo͡ɪri
kokoraho	kˌɔkɔrˈahɔ
kora	kˈɔra
koronga	kɔrˈɔŋa
kororia	kˌɔrɔrˈia
kuaha	ku"ˈaha
kāpō	kˈaːpɔː
kōtiti	kɔːtˈiti
land	(͡e͡n)ˈɛl(͡m͡i) ˈa n (͡e͡n)dˈiː(͡m͡i)
mahita	mahˈita
mangere	maŋˈere
matara	matˈara
matarua	mˌatarˈu"a
mauru	maˈu"ru"
mene	mˈene
miti	mˈiti
mōmona	mɔːmˈɔna
mōrahi	mɔːrˈahi
nehua	nehˈu"a
news	n ˈe w (͡e͡n)ˈɛs(͡m͡i)
ngaiotanga	ŋˌa͡ɪɔtˈaŋa
ngarahu	ŋarˈahu"
ngaronga	ŋarˈɔŋa
ngarongaro	ŋˌarɔŋˈarɔ
nunumi	nu"nˈu"mi
onepu	ɔnˈepu"
paetara	pa͡ɪtˈara
pahore	pahˈɔre
paihana	pa͡ɪhˈana
paoa	pˈa͡ʊa
paparinga	pˌaparˈiŋa
pm	pm
powhiri	pɔfˈiri
püoru	pu"ˈɔru"
pākawa	paːkˈawa
pākiki	paːkˈiki
pāpaka	paːpˈaka
pāpaku	paːpˈaku"
pāpono	paːpˈɔnɔ
pātengi	paːtˈeŋi
pātere	paːtˈere
pōwhiritia	pˌɔːfiritˈia
pūhihi	pu"ːhˈihi
pūkaha	pu"ːkˈaha
pūmatua	pˌu"ːmatˈu"a
pūtahitanga	pˌu"ːtahitˈaŋa
raihi	rˈa͡ɪhi
rakuraku	rˌaku"rˈaku"
rarahi	rarˈahi
raupo	raˈu"pɔ
rehe	rˈehe
rehu	rˈehu"
saints	(͡e͡n)ˈɛs(͡m͡i) ˈa ˈi n t (͡e͡n)ˈɛs(͡m͡i)
t	t
tahitahi	tˌahitˈahi
takuhe	takˈu"he
taratahi	tˌaratˈahi
tarau	tarˈau"
tarea	tarˈea
tareka	tarˈeka
tatanga	tatˈaŋa
temepara	tˌemepˈara
tepe	tˈepe
tuaiwa	tu"ˈa͡ɪwa
tuatangata	tˌu"ataŋˈata
tukitukia	tˌu"kitu"kˈia
tukurua	tˌu"ku"rˈu"a
tutua	tu"tˈu"a
tānekaha	tˌaːnekˈaha
tātea	taːtˈea
tēneti	teːnˈeti
tūpuhi	tu"ːpˈu"hi
tūtakitanga	tˌu"ːtakitˈaŋa
tūātipu	tˌu"ːaːtˈipu"
unga	ˈu"ŋa
ura	ˈu"ra
wairewa	wa͡ɪrˈewa
wairuatanga	wˌa͡ɪru"atˈaŋa
wewete	wewˈete
whaikorero	fˌa͡ɪkɔrˈerɔ
whakaahuru	fˌakaahˈu"ru"
whakaawhiwhia	fˌakaˌafifˈia
whakakite	fˌakakˈite
whakakorikori	fˌakakˌɔrikˈɔri
whakamoea	fˌakamwˈea
whakangungua	fˌakaŋu"ŋˈu"a
whakangā	fakˈaŋaː
whakapaingia	fˌakapa͡ɪŋˈia
whakapānga	fˌakapˈaːŋa
whakarauika	fˌakarˌau"ˈika
whakaruru	fˌakarˈu"ru"
whakataua	fˌakataˈu"a
whakatauritea	fˌakatˌau"ritˈea
whakatikanga	fˌakatikˈaŋa
whakatina	fˌakatˈina
whakau	fakˈau"
whakaupoko	fˌakau"pˈɔkɔ
whakawahia	fˌakawahˈia
whakawaho	fˌakawˈahɔ
whakawākanga	fˌakawaːkˈaŋa
whanatu	fanˈatu"
wiwi	wˈiwi
xiii	(͡e͡n)ˈɛks(͡m͡i) ˈi ˈi ˈi
years	(͡e͡n)wˈa͡ɪ(͡m͡i) ˈe ˈa r (͡e͡n)ˈɛs(͡m͡i)
Āpiti	aːpˈiti
ēra	ˈeːra
ōritenga	ˌɔːritˈeŋa
American	ˈa m ˈe r ˈi (͡e͡n)sˈiː(͡m͡i) ˈa n
Arikinui	ˌarikinˈu"i
Aupouri	ˌau"poˈu"ri
Bridge	(͡e͡n)bˈiː(͡m͡i) r ˈi (͡e͡n)dˈiː d͡ʒˈiː(͡m͡i) ˈe
Chapman	(͡e͡n)sˈiː(͡m͡i) h ˈa p m ˈa n
China	(͡e͡n)sˈiː(͡m͡i) h ˈi n ˈa
Crash	(͡e͡n)sˈiː(͡m͡i) r ˈa (͡e͡n)ˈɛs(͡m͡i) h
Digital	(͡e͡n)dˈiː(͡m͡i) ˈi (͡e͡n)d͡ʒˈiː(͡m͡i) ˈi t ˈa (͡e͡n)ˈɛl(͡m͡i)
District	(͡e͡n)dˈiː(͡m͡i) ˈi (͡e͡n)ˈɛs(͡m͡i) t r ˈi (͡e͡n)sˈiː(͡m͡i) t
Early	ˈe ˈa r (͡e͡n)ˈɛl wˈa͡ɪ(͡m͡i)
Erihana	ˌerihˈana
Erueti	ˌeru"ˈeti
Federation	(͡e͡n)ˈɛf(͡m͡i) ˈe (͡e͡n)dˈiː(͡m͡i) ˈe r ˈa t ˈi ˈɔ n
Georgina	(͡e͡n)d͡ʒˈiː(͡m͡i) ˈe ˈɔ r (͡e͡n)d͡ʒˈiː(͡m͡i) ˈi n ˈa
Greg	(͡e͡n)d͡ʒˈiː(͡m͡i) r ˈe (͡e͡n)d͡ʒˈiː(͡m͡i)
Hari	hˈari
Heikōkō	hˌeikˈɔːkɔː
Hinetūāhōanga	hˌinetˌu"ːaːhɔːˈaŋa
Hira	hˈira
Hunia	hu"nˈia
Hāre	hˈaːre
Hēni	hˈeːni
Hōhepa	hɔːhˈepa
ICT	ˈi (͡e͡n)sˈiː(͡m͡i) t
Ihoa	ihˈɔa
Inaianei	ˌina͡ɪanˈei
Joe	(͡e͡n)d͡ʒˈe͡ɪ(͡m͡i) ˈɔ ˈe
Kererū	kerˈeru"ː
Kirihi	kirˈihi
Kite	kˈite
Kohia	kɔhˈia
Korowai	kɔrˈɔwa͡ɪ
Koutu	koˈu"tu"
Kui	kˈu"i
Kō	kˈɔː
Mac	m ˈa (͡e͡n)sˈiː(͡m͡i)
Malcolm	m ˈa (͡e͡n)ˈɛl sˈiː(͡m͡i) ˈɔ (͡e͡n)ˈɛl(͡m͡i) m
Mareikura	mˌareikˈu"ra
Mauria	mˌau"rˈia
Mete	mˈete
Moerewa	mwerˈewa
Māhuri	maːhˈu"ri
Māramatanga	mˌaːramatˈaŋa
Nations	n ˈa t ˈi ˈɔ n (͡e͡n)ˈɛs(͡m͡i)
News	n ˈe w (͡e͡n)ˈɛs(͡m͡i)
Ngahiwi	ŋahˈiwi
Ngohi	ŋˈɔhi
Notes	n ˈɔ t ˈe (͡e͡n)ˈɛs(͡m͡i)
Paetahi	pa͡ɪtˈahi
Panui	panˈu"i
Papakura	pˌapakˈu"ra
Papers	p ˈa p ˈe r (͡e͡n)ˈɛs(͡m͡i)
Parker	pˈarker
Patu	pˈatu"
Pompallier	p ˈɔ m p ˈa (͡e͡n)ˈɛl ˈɛl(͡m͡i) ˈi ˈe r
Poroporoaki	pˌɔrɔpˌɔrɔˈaki
Power	pˈɔwer
Publishers	p ˈu" (͡e͡n)bˈiː ˈɛl(͡m͡i) ˈi (͡e͡n)ˈɛs(͡m͡i) h ˈe r (͡e͡n)ˈɛs(͡m͡i)
Putea	pu"tˈea
Pākeha	paːkˈeha
Pātiti	paːtˈiti
Pīra	pˈiːra
Pōkai	pˈɔːka͡ɪ
Pōkeka	pɔːkˈeka
Queenstown	(͡e͡n)kjˈuː(͡m͡i) ˈu" ˈe ˈe n (͡e͡n)ˈɛs(͡m͡i) t ˈɔ w n
RNZ	rn(͡e͡n)zˈɛd(͡m͡i)
Rangitāke	rˌaŋitˈaːke
Rangiwewehi	rˌaŋiwewˈehi
Reed	r ˈe ˈe (͡e͡n)dˈiː(͡m͡i)
Rikiriki	rˌikirˈiki
Russell	r ˈu" (͡e͡n)ˈɛs ˈɛs(͡m͡i) ˈe (͡e͡n)ˈɛl ˈɛl(͡m͡i)
Rīpeka	riːpˈeka
Sandy	(͡e͡n)ˈɛs(͡m͡i) ˈa n (͡e͡n)dˈiː wˈa͡ɪ(͡m͡i)
Sean	(͡e͡n)ˈɛs(͡m͡i) ˈe ˈa n
Selwyn	(͡e͡n)ˈɛs(͡m͡i) ˈe (͡e͡n)ˈɛl(͡m͡i) w (͡e͡n)wˈa͡ɪ(͡m͡i) n
Special	(͡e͡n)ˈɛs(͡m͡i) p ˈe (͡e͡n)sˈiː(͡m͡i) ˈi ˈa (͡e͡n)ˈɛl(͡m͡i)
Tahupōtiki	tˌahu"pɔːtˈiki
Takiwā	takˈiwaː
Tawhiuau	tˌafiu"ˈau"
Tikitiki	tˌikitˈiki
Topeora	tˌɔpeˈɔra
Totara	tɔtˈara
Tree	trˈee
Tuini	tu"ˈini
Tāwhaki	taːfˈaki
Tūhourangi	tˌu"ːhou"rˈaŋi
Waihanga	wa͡ɪhˈaŋa
Waihou	wa͡ɪhˈou"
Whakarewarewa	fˌakarˌewarˈewa
Whanui	fanˈu"i
Whawhai	fˈafa͡ɪ
Whāiti	faːˈiti
Willie	w ˈi (͡e͡n)ˈɛl ˈɛl(͡m͡i) ˈi ˈe
ahurewa	ˌahu"rˈewa
aia	ˈa͡ɪa
all	ˈa (͡e͡n)ˈɛl ˈɛl(͡m͡i)
arongia	ˌarɔŋˈia
arumoni	ˌaru"mˈɔni
atamai	atˈama͡ɪ
aukatia	ˌau"katˈia
below	(͡e͡n)bˈiː(͡m͡i) ˈe (͡e͡n)ˈɛl(͡m͡i) ˈɔ w
browser	(͡e͡n)bˈiː(͡m͡i) r ˈɔ w (͡e͡n)ˈɛs(͡m͡i) ˈe r
hapuu	hapˈu"u"
hikaka	hikˈaka
hikohiko	hˌikɔhˈikɔ
hirahira	hˌirahˈira
hiraka	hirˈaka
hoahoatia	hˌɔahˌɔatˈia
hope	hˈɔpe
hukapapa	hˌu"kapˈapa
humarie	hˌu"marˈie
huripoki	hˌu"ripˈɔki
hāwhe	hˈaːfe
hēki	hˈeːki
hīanga	hiːˈaŋa
hōhā	hˈɔːhaː
hōtoke	hɔːtˈɔke
kaati	kaˈati
kahikatea	kˌahikatˈea
kaikanikani	kˌa͡ɪkanikˈani
kairūri	ka͡ɪrˈu"ːri
kaitakawaenga	kˌa͡ɪtakawˈa͡ɪŋa
kaiārahitanga	kˌa͡ɪaːrˌahitˈaŋa
kaiāwhina	kˌa͡ɪaːfˈina
kapiheihana	kˌapihˌeihˈana
kawakawa	kˌawakˈawa
kee	kˈee
koka	kˈɔka
kokowai	kɔkˈɔwa͡ɪ
konutai	kɔnˈu"ta͡ɪ
kāreti	kaːrˈeti
kōhari	kɔːhˈari
kōhine	kɔːhˈine
kōkiritia	kˌɔːkiritˈia
kōkopu	kɔːkˈɔpu"
kōrerotanga	kˌɔːrerɔtˈaŋa
life	(͡e͡n)ˈɛl(͡m͡i) ˈi (͡e͡n)ˈɛf(͡m͡i) ˈe
maminga	mamˈiŋa
matawhenua	mˌatafenˈu"a
methamphetamine	mˌethamphˌetamˈine
mira	mˈira
motukore	mˌɔtu"kˈɔre
mōwhiti	mɔːfˈiti
ngare	ŋˈare
ngohengohe	ŋˌɔheŋˈɔhe
ngātahitia	ŋˌaːtahitˈia
nohopuku	nˌɔhɔpˈu"ku"
nuitanga	nˌu"itˈaŋa
over	ˈɔ (͡e͡n)vˈiː(͡m͡i) ˈe r
paihere	pa͡ɪhˈere
panonitanga	pˌanɔnitˈaŋa
papapaki	pˌapapˈaki
pararopi	pˌararˈɔpi
pataka	patˈaka
pato	pˈatɔ
pehi	pˈehi
porowini	pˌɔrɔwˈini
puiaki	pˌu"iˈaki
putaputa	pˌu"tapˈu"ta
pütaiao	pu"tˈa͡ɪa͡ʊ
pāhotia	pˌaːhɔtˈia
pēneitia	pˌeːneitˈia
pūataata	pˌu"ːataˈata
pūtahi	pu"ːtˈahi
rakatira	rˌakatˈira
ramarama	rˌamarˈama
rangahautia	rˌaŋahˌau"tˈia
rapuhia	rˌapu"hˈia
rauna	raˈu"na
raupua	rˌau"pˈu"a
rerewē	rerˈeweː
ripi	rˈipi
ruaki	ru"ˈaki
ruinga	ru"ˈiŋa
rupeke	ru"pˈeke
rāpoi	rˈaːpo͡ɪ
taewa	tˈa͡ɪwa
tare	tˈare
tataunga	tˌataˈu"ŋa
tatua	tatˈu"a
tauārai	tˌau"ˈaːra͡ɪ
teenaa	tˌeenˈaa
teetehi	tˌeetˈehi
tete	tˈete
tiakareti	tˌiakarˈeti
tikiake	tˌikiˈake
tikitiki	tˌikitˈiki
tipi	tˈipi
tiwai	tˈiwa͡ɪ
tuatini	tˌu"atˈini
tuituia	tˌu"itu"ˈia
turituri	tˌu"ritˈu"ri
tāhae	tˈaːha͡ɪ
tāporowhita	tˌaːpɔrɔfˈita
tāraia	taːrˈa͡ɪa
tāroa	taːrˈɔa
tātā	tˈaːtaː
tūmatarau	tˌu"ːmatarˈau"
tūruhi	tu"ːrˈu"hi
urutaunga	ˌu"ru"taˈu"ŋa
waaawa	wˌaaˈawa
wahapu	wahˈapu"
waihoe	wˈa͡ɪhwe
watch	w ˈa t (͡e͡n)sˈiː(͡m͡i) h
whakaahuatanga	fˌakaˌahu"atˈaŋa
whakaihiihi	fˌaka͡ɪhiˈihi
whakakotahitia	fˌakakˌɔtahitˈia
whakakīia	fˌakakiːˈia
whakanao	fakˈana͡ʊ
whakanohonoho	fˌakanˌɔhɔnˈɔhɔ
whakaotinga	fˌaka͡ʊtˈiŋa
whakapakoko	fˌakapakˈɔkɔ
whakapaoho	fˌakapˈa͡ʊhɔ
whakatairangahia	fˌakatˌa͡ɪraŋahˈia
whakatōngia	fˌakatɔːŋˈia
whakawhanaketia	fˌakafˌanaketˈia
whanako	fanˈakɔ
whatiwhati	fˌatifˈati
where	fˈere
whirinaki	fˌirinˈaki
whēnei	feːnˈei
wānangahia	wˌaːnaŋahˈia
Āpitihanga	ˌaːpitihˈaŋa
āraia	aːrˈa͡ɪa
ūhia	u"ːhˈia
Ahurea	ˌahu"rˈea
Alice	ˈa (͡e͡n)ˈɛl(͡m͡i) ˈi (͡e͡n)sˈiː(͡m͡i) ˈe
BCG	(͡e͡n)bˌiːsˌiːd͡ʒˈiː(͡m͡i)
Barry	(͡e͡n)bˈiː(͡m͡i) ˈa r r (͡e͡n)wˈa͡ɪ(͡m͡i)
Beattie	(͡e͡n)bˈiː(͡m͡i) ˈe ˈa t t ˈi ˈe
Bishop	(͡e͡n)bˈiː(͡m͡i) ˈi (͡e͡n)ˈɛs(͡m͡i) h ˈɔ p
Blue	(͡e͡n)bˈiː ˈɛl(͡m͡i) ˈu" ˈe
Boots	(͡e͡n)bˈiː(͡m͡i) ˈɔ ˈɔ t (͡e͡n)ˈɛs(͡m͡i)
Brigade	(͡e͡n)bˈiː(͡m͡i) r ˈi (͡e͡n)d͡ʒˈiː(͡m͡i) ˈa (͡e͡n)dˈiː(͡m͡i) ˈe
Carroll	(͡e͡n)sˈiː(͡m͡i) ˈa r r ˈɔ (͡e͡n)ˈɛl ˈɛl(͡m͡i)
Challenge	(͡e͡n)sˈiː(͡m͡i) h ˈa (͡e͡n)ˈɛl ˈɛl(͡m͡i) ˈe n (͡e͡n)d͡ʒˈiː(͡m͡i) ˈe
Charlie	(͡e͡n)sˈiː(͡m͡i) h ˈa r (͡e͡n)ˈɛl(͡m͡i) ˈi ˈe
Core	(͡e͡n)sˈiː(͡m͡i) ˈɔ r ˈe
Election	ˈe (͡e͡n)ˈɛl(͡m͡i) ˈe (͡e͡n)sˈiː(͡m͡i) t ˈi ˈɔ n
Emepaea	ˌemepˈa͡ɪa
Excel	ˈe (͡e͡n)ˈɛks sˈiː(͡m͡i) ˈe (͡e͡n)ˈɛl(͡m͡i)
Framework	(͡e͡n)ˈɛf(͡m͡i) r ˈa m ˈe w ˈɔ r k
Gibbs	(͡e͡n)d͡ʒˈiː(͡m͡i) ˈi (͡e͡n)bˈiː bˈiː ˈɛs(͡m͡i)
Gordon	(͡e͡n)d͡ʒˈiː(͡m͡i) ˈɔ r (͡e͡n)dˈiː(͡m͡i) ˈɔ n
Gray	(͡e͡n)d͡ʒˈiː(͡m͡i) r ˈa (͡e͡n)wˈa͡ɪ(͡m͡i)
Haramai	harˈama͡ɪ
Hare	hˈare
Harry	h ˈa r r (͡e͡n)wˈa͡ɪ(͡m͡i)
Haumiatiketike	hˌau"mˌiatˌiketˈike
Hauāuru	hˌau"aːˈu"ru"
Helen	h ˈe (͡e͡n)ˈɛl(͡m͡i) ˈe n
Herald	h ˈe r ˈa (͡e͡n)ˈɛl dˈiː(͡m͡i)
Higgins	h ˈi (͡e͡n)d͡ʒˈiː d͡ʒˈiː(͡m͡i) ˈi n (͡e͡n)ˈɛs(͡m͡i)
Hikareia	hˌikareˈia
Hikitia	hˌikitˈia
Hiruharama	hˌiru"harˈama
Huakina	hˌu"akˈina
Huka	hˈu"ka
Hōnore	hɔːnˈɔre
Intent	ˈintent
Introduction	ˈi n t r ˈɔ (͡e͡n)dˈiː(͡m͡i) ˈu" (͡e͡n)sˈiː(͡m͡i) t ˈi ˈɔ n
Kaati	kaˈati
Kainga	kˈa͡ɪŋa
Karen	kˈaren
Karuwhā	karˈu"faː
Kate	kˈate
Kim	kˈim
Kiwibank	k ˈi w ˈi (͡e͡n)bˈiː(͡m͡i) ˈa n k
Koina	kˈo͡ɪna
Koira	kˈo͡ɪra
Kuri	kˈu"ri
Kōhungahunga	kˌɔːhu"ŋahˈu"ŋa
Luke	(͡e͡n)ˈɛl(͡m͡i) ˈu" k ˈe
Marlborough	m ˈa r (͡e͡n)ˈɛl bˈiː(͡m͡i) ˈɔ r ˈɔ ˈu" (͡e͡n)d͡ʒˈiː(͡m͡i) h
Matahi	matˈahi
Matangi	matˈaŋi
Mataora	matˈa͡ʊra
Maungapohatu	mˌau"ŋˌapɔhˈatu"
Mead	m ˈe ˈa (͡e͡n)dˈiː(͡m͡i)
Merivale	m ˈe r ˈi (͡e͡n)vˈiː(͡m͡i) ˈa (͡e͡n)ˈɛl(͡m͡i) ˈe
Mission	m ˈi (͡e͡n)ˈɛs ˈɛs(͡m͡i) ˈi ˈɔ n
Morehu	mɔrˈehu"
Muriwhenua	mˌu"rifenˈu"a
Mātakitaki	mˌaːtakitˈaki
Mātanga	maːtˈaŋa
Mātāpono	mˌaːtaːpˈɔnɔ
Mōhiotanga	mˌɔːhiɔtˈaŋa
NEMP	nˈemp
Ngawai	ŋˈawa͡ɪ
Ohu	ˈɔhu"
Opening	ɔpˈeniŋ
Pa	pˈa
Paenga	pˈa͡ɪŋa
Paepae	pˈa͡ɪpa͡ɪ
Paki	pˈaki
Patrick	p ˈa t r ˈi (͡e͡n)sˈiː(͡m͡i) k
Pitiroi	pitˈiro͡ɪ
Planning	p (͡e͡n)ˈɛl(͡m͡i) ˈa n n ˈi n (͡e͡n)d͡ʒˈiː(͡m͡i)
Politics	p ˈɔ (͡e͡n)ˈɛl(͡m͡i) ˈi t ˈi (͡e͡n)sˈiː ˈɛs(͡m͡i)
Poraka	pɔrˈaka
Post	p ˈɔ (͡e͡n)ˈɛs(͡m͡i) t
Poutūterangi	pˌou"tˌu"ːterˈaŋi
Pūmotu	pu"ːmˈɔtu"
Rakera	rakˈera
Raraunga	rˌaraˈu"ŋa
Rawhiti	rafˈiti
Representative	r ˈe p r ˈe (͡e͡n)ˈɛs(͡m͡i) ˈe n t ˈa t ˈi (͡e͡n)vˈiː(͡m͡i) ˈe
Rewa	rˈewa
Riki	rˈiki
Riri	rˈiri
Rodney	r ˈɔ (͡e͡n)dˈiː(͡m͡i) n ˈe (͡e͡n)wˈa͡ɪ(͡m͡i)
Rāngai	rˈaːŋa͡ɪ
Rāpata	raːpˈata
Settlement	(͡e͡n)ˈɛs(͡m͡i) ˈe t t (͡e͡n)ˈɛl(͡m͡i) ˈe m ˈe n t
Sharp	(͡e͡n)ˈɛs(͡m͡i) h ˈa r p
Sky	(͡e͡n)ˈɛs(͡m͡i) k (͡e͡n)wˈa͡ɪ(͡m͡i)
State	(͡e͡n)ˈɛs(͡m͡i) t ˈa t ˈe
Statement	(͡e͡n)ˈɛs(͡m͡i) t ˈa t ˈe m ˈe n t
Steve	(͡e͡n)ˈɛs(͡m͡i) t ˈe (͡e͡n)vˈiː(͡m͡i) ˈe
Stratford	(͡e͡n)ˈɛs(͡m͡i) t r ˈa t (͡e͡n)ˈɛf(͡m͡i) ˈɔ r (͡e͡n)dˈiː(͡m͡i)
Surf	(͡e͡n)ˈɛs(͡m͡i) ˈu" r (͡e͡n)ˈɛf(͡m͡i)
TV	t(͡e͡n)vˈiː(͡m͡i)
Tamure	tamˈu"re
Tapere	tapˈere
Tapuwae	tapˈu"wa͡ɪ
Taute	taˈu"te
Tawhirimatea	tˌafirˌimatˈea
These	t h ˈe (͡e͡n)ˈɛs(͡m͡i) ˈe
Tono	tˈɔnɔ
Torere	tɔrˈere
Tura	tˈu"ra
Tānerore	tˌaːnerˈɔre
Tītokowaru	tˌiːtɔkɔwˈaru"
Uiui	ˌu"iˈu"i
Waimarie	wˌa͡ɪmarˈie
Walter	w ˈa (͡e͡n)ˈɛl(͡m͡i) t ˈe r
WeatherWatch	weˈather w ˈa t (͡e͡n)sˈiː(͡m͡i) h
Whakaaturanga	fˌakaˌatu"rˈaŋa
Whakahirahira	fˌakahˌirahˈira
Whakahētanga	fˌakaheːtˈaŋa
Whakarawea	fˌakarawˈea
Whakarewa	fˌakarˈewa
Whanga	fˈaŋa
Windows	w ˈi n (͡e͡n)dˈiː(͡m͡i) ˈɔ w (͡e͡n)ˈɛs(͡m͡i)
Wiwi	wˈiwi
Wātaka	waːtˈaka
Wātene	waːtˈene
above	ˈa (͡e͡n)bˈiː(͡m͡i) ˈɔ (͡e͡n)vˈiː(͡m͡i) ˈe
anu	ˈanu"
arohaina	ˌarɔhˈa͡ɪna
arotakehia	ˌarɔtˌakehˈia
auē	aˈu"eː
haea	hˈa͡ɪa
haeretanga	hˌa͡ɪretˈaŋa
hanumi	hanˈu"mi
haurau	hˌau"rˈau"
her	hˈer
hiako	hiˈakɔ
hianga	hiˈaŋa
hikitia	hˌikitˈia
hokomaha	hˌɔkɔmˈaha
horekau	hˌɔrekˈau"
horomia	hˌɔrɔmˈia
horonga	hɔrˈɔŋa
hunaia	hu"nˈa͡ɪa
huti	hˈu"ti
hīkoitanga	hˌiːko͡ɪtˈaŋa
inanahi	ˌinanˈahi
iriiri	ˌiriˈiri
kaiaka	ka͡ɪˈaka
kaiora	ka͡ɪˈɔra
kaioraora	kˌa͡ɪɔrˈa͡ʊra
kaiparau	kˌa͡ɪparˈau"
kaitaka	ka͡ɪtˈaka
kaiwhakarongo	kˌa͡ɪfakarˈɔŋɔ
kaiwhakataetae	kˌa͡ɪfakatˈa͡ɪta͡ɪ
kakaho	kakˈahɔ
karangaranga	kˌaraŋarˈaŋa
karawhiua	kˌarafiˈu"a
kauneke	kˌau"nˈeke
kautia	kˌau"tˈia
kea	kˈea
kekeno	kekˈenɔ
kit	kˈit
kitakita	kˌitakˈita
kohukohu	kˌɔhu"kˈɔhu"
kohurutia	kˌɔhu"ru"tˈia
koretake	kˌɔretˈake
koromatua	kˌɔrɔmatˈu"a
kukune	ku"kˈu"ne
kāuta	kaːˈu"ta
kōingo	kɔːˈiŋɔ
kōpura	kɔːpˈu"ra
kūpapa	ku"ːpˈapa
m	m
maatauranga	mˌaatˌau"rˈaŋa
maipi	mˈa͡ɪpi
man	mˈan
maramatanga	mˌaramatˈaŋa
matahuhua	mˌatahu"hˈu"a
matewai	matˈewa͡ɪ
miniti	minˈiti
mākutu	maːkˈu"tu"
ne	nˈe
ngoikoretanga	ŋˌo͡ɪkɔretˈaŋa
nāu	nˈaːu"
omanga	ɔmˈaŋa
paa	pˈaa
paamu	paˈamu"
papare	papˈare
papariki	pˌaparˈiki
papatono	pˌapatˈɔnɔ
perana	perˈana
pi	pˈi
pirinoa	pˌirinˈɔa
pohutukawa	pˌɔhu"tu"kˈawa
porangi	pɔrˈaŋi
poutāpeta	pˌou"taːpˈeta
puihi	pu"ˈihi
pupuhihia	pˌu"pu"hihˈia
pākehā	paːkˈehaː
pāpātanga	pˌaːpaːtˈaŋa
pīrori	piːrˈɔri
pūhui	pu"ːhˈu"i
raau	raˈau"
rekareka	rˌekarˈeka
rika	rˈika
rikarika	rˌikarˈika
rimurapa	rˌimu"rˈapa
ripo	rˈipɔ
roha	rˈɔha
rongonga	rɔŋˈɔŋa
taane	taˈane
takitoru	tˌakitˈɔru"
tales	t ˈa (͡e͡n)ˈɛl(͡m͡i) ˈe (͡e͡n)ˈɛs(͡m͡i)
talk	t ˈa (͡e͡n)ˈɛl(͡m͡i) k
tamata	tamˈata
tangotango	tˌaŋɔtˈaŋɔ
tapoko	tapˈɔkɔ
tapuae	tapˈu"a͡ɪ
tarāwaho	tˌaraːwˈahɔ
tauhohenga	tˌau"hɔhˈeŋa
tauihu	tˌau"ˈihu"
tautohetia	tˌau"tˌɔhetˈia
tauwhāiti	tˌau"faːˈiti
tawa	tˈawa
tawhio	tafˈiɔ
tepu	tˈepu"
tipuranga	tˌipu"rˈaŋa
tirotirohanga	tˌirɔtˌirɔhˈaŋa
titaha	titˈaha
tokarewa	tˌɔkarˈewa
tokowaru	tˌɔkɔwˈaru"
tupunga	tu"pˈu"ŋa
two	twˈɔ
tä	tˈa
tākihi	taːkˈihi
tāwara	taːwˈara
tīhi	tˈiːhi
tīmatahia	tˌiːmatahˈia
tīpune	tiːpˈu"ne
tōia	tɔːˈia
utauta	ˌu"taˈu"ta
were	wˈere
whakaatungia	fˌakaˌatu"ŋˈia
whakae	fˈaka͡ɪ
whakahouhia	fˌakahˌou"hˈia
whakakitea	fˌakakitˈea
whakakīa	fˌakakˈiːa
whakakīkī	fˌakakˈiːkiː
whakanekeneke	fˌakanˌekenˈeke
whakangau	fˌakaŋˈau"
whakaotia	fˌaka͡ʊtˈia
whakapuakihia	fˌakapˌu"akihˈia
whakapākehātia	fˌakapˌaːkehaːtˈia
whakarerenga	fˌakarerˈeŋa
whakarārangitanga	fˌakarˌaːraŋitˈaŋa
whakatairangatia	fˌakatˌa͡ɪraŋatˈia
whakatangihia	fˌakatˌaŋihˈia
whakatetonga	fˌakatetˈɔŋa
whakatikatikahia	fˌakatˌikatˌikahˈia
whakawhiwhinga	fˌakafifˈiŋa
whakawhānuitia	fˌakafˌaːnu"itˈia
whatinga	fatˈiŋa
whia	fˈia
whāngaia	faːŋˈa͡ɪa
whāngaihia	fˌaːŋa͡ɪhˈia
whēkau	feːkˈau"
wickED	w ˈi (͡e͡n)sˈiː(͡m͡i) k ˌe(͡e͡n)dˈiː(͡m͡i)
winika	winˈika
xi	(͡e͡n)ˈɛks(͡m͡i) ˈi
Āhea	aːhˈea
Ākina	aːkˈina
Āwhinatia	ˌaːfinatˈia
āpitihanga	ˌaːpitihˈaŋa
Apiata	ˌapiˈata
Apopo	apˈɔpɔ
Arahura	ˌarahˈu"ra
Archive	ˈa r (͡e͡n)sˈiː(͡m͡i) h ˈi (͡e͡n)vˈiː(͡m͡i) ˈe
Ardern	ˈa r (͡e͡n)dˈiː(͡m͡i) ˈe r n
Aro	ˈarɔ
British	(͡e͡n)bˈiː(͡m͡i) r ˈi t ˈi (͡e͡n)ˈɛs(͡m͡i) h
Buller	(͡e͡n)bˈiː(͡m͡i) ˈu" (͡e͡n)ˈɛl ˈɛl(͡m͡i) ˈe r
CMS	(͡e͡n)sˌiː(͡m͡i)m(͡e͡n)ˈɛs(͡m͡i)
Center	(͡e͡n)sˈiː(͡m͡i) ˈe n t ˈe r
Centres	(͡e͡n)sˈiː(͡m͡i) ˈe n t r ˈe (͡e͡n)ˈɛs(͡m͡i)
Claims	(͡e͡n)sˈiː ˈɛl(͡m͡i) ˈa ˈi m (͡e͡n)ˈɛs(͡m͡i)
Daniel	(͡e͡n)dˈiː(͡m͡i) ˈa n ˈi ˈe (͡e͡n)ˈɛl(͡m͡i)
Division	(͡e͡n)dˈiː(͡m͡i) ˈi (͡e͡n)vˈiː(͡m͡i) ˈi (͡e͡n)ˈɛs(͡m͡i) ˈi ˈɔ n
Elsdon	ˈe (͡e͡n)ˈɛl ˈɛs dˈiː(͡m͡i) ˈɔ n
Erangi	erˈaŋi
Francis	(͡e͡n)ˈɛf(͡m͡i) r ˈa n (͡e͡n)sˈiː(͡m͡i) ˈi (͡e͡n)ˈɛs(͡m͡i)
Helicopter	h ˈe (͡e͡n)ˈɛl(͡m͡i) ˈi (͡e͡n)sˈiː(͡m͡i) ˈɔ p t ˈe r
Hilda	h ˈi (͡e͡n)ˈɛl dˈiː(͡m͡i) ˈa
Himi	hˈimi
Himiona	hˌimiˈɔna
Hongongoi	hɔŋˈɔŋo͡ɪ
Hospital	h ˈɔ (͡e͡n)ˈɛs(͡m͡i) p ˈi t ˈa (͡e͡n)ˈɛl(͡m͡i)
Huhuti	hu"hˈu"ti
Huringa	hu"rˈiŋa
Hāpai	hˈaːpa͡ɪ
Hēkeretari	hˌeːkeretˈari
Io	ˈiɔ
Itāriana	ˌitaːriˈana
Iwikau	ˌiwikˈau"
Jacinda	(͡e͡n)d͡ʒˈe͡ɪ(͡m͡i) ˈa (͡e͡n)sˈiː(͡m͡i) ˈi n (͡e͡n)dˈiː(͡m͡i) ˈa
Junior	(͡e͡n)d͡ʒˈe͡ɪ(͡m͡i) ˈu" n ˈi ˈɔ r
Kaihoko	ka͡ɪhˈɔkɔ
Kaihokohoko	kˌa͡ɪhɔkɔhˈɔkɔ
Kairēhita	kˌa͡ɪreːhˈita
Kani	kˈani
Kararaina	kˌararˈa͡ɪna
Karipori	kˌaripˈɔri
Kawa	kˈawa
Kawenga	kawˈeŋa
Kiritaki	kˌiritˈaki
Komene	kɔmˈene
Kānata	kaːnˈata
Kōhine	kɔːhˈine
Kōkiritia	kˌɔːkiritˈia
Kōpae	kˈɔːpa͡ɪ
Mahue	mahˈu"e
Maia	mˈa͡ɪa
Maioha	ma͡ɪˈɔha
MakaawhioTe	mˌakaafˈiɔ tˈe
Maketū	makˈetu"ː
Mango	mˈaŋɔ
Manukura	mˌanu"kˈu"ra
Maranga	marˈaŋa
Meri	mˈeri
Mihingare	mˌihiŋˈare
Morris	m ˈɔ r r ˈi (͡e͡n)ˈɛs(͡m͡i)
Muaūpoko	mˌu"au"ːpˈɔkɔ
Music	m ˈu" (͡e͡n)ˈɛs(͡m͡i) ˈi (͡e͡n)sˈiː(͡m͡i)
Māehe	maːˈehe
Mīharo	miːhˈarɔ
NIWA	nˈiwa
Navy	n ˈa (͡e͡n)vˈiː wˈa͡ɪ(͡m͡i)
Nepia	nepˈia
Ngahue	ŋahˈu"e
Ngaro	ŋˈarɔ
Ngatiporou	ŋˌatipɔrˈou"
Nōema	nɔːˈema
Nōu	nˈɔːu"
Oro	ˈɔrɔ
Pahiatua	pˌahiatˈu"a
Pehea	pehˈea
Penei	penˈei
Performing	p ˈe r (͡e͡n)ˈɛf(͡m͡i) ˈɔ r m ˈi n (͡e͡n)d͡ʒˈiː(͡m͡i)
Pine	pˈine
Politicians	p ˈɔ (͡e͡n)ˈɛl(͡m͡i) ˈi t ˈi (͡e͡n)sˈiː(͡m͡i) ˈi ˈa n (͡e͡n)ˈɛs(͡m͡i)
Poronīhia	pˌɔrɔniːhˈia
Porourangi	pˌɔrou"rˈaŋi
Price	p r ˈi (͡e͡n)sˈiː(͡m͡i) ˈe
Prominent	prɔmˈinent
Pukemiro	pˌu"kemˈirɔ
Punga	pˈu"ŋa
Puritia	pˌu"ritˈia
Pāti	pˈaːti
Pēhia	peːhˈia
Pēnei	peːnˈei
Pēnā	pˈeːnaː
Pūkeko	pu"ːkˈekɔ
Pūrehuroa	pˌu"ːrehu"rˈɔa
Raina	rˈa͡ɪna
Rangihoua	rˌaŋihoˈu"a
Reedy	r ˈe ˈe (͡e͡n)dˈiː wˈa͡ɪ(͡m͡i)
Rima	rˈima
Ringa	rˈiŋa
Ruahine	rˌu"ahˈine
Ruatoki	rˌu"atˈɔki
Rugby	r ˈu" (͡e͡n)d͡ʒˈiː bˈiː wˈa͡ɪ(͡m͡i)
Rukupō	ru"kˈu"pɔː
Rātou	raːtˈou"
Rīpera	riːpˈera
Solomon	(͡e͡n)ˈɛs(͡m͡i) ˈɔ (͡e͡n)ˈɛl(͡m͡i) ˈɔ m ˈɔ n
Stirling	(͡e͡n)ˈɛs(͡m͡i) t ˈi r (͡e͡n)ˈɛl(͡m͡i) ˈi n (͡e͡n)d͡ʒˈiː(͡m͡i)
Stuart	(͡e͡n)ˈɛs(͡m͡i) t ˈu" ˈa r t
TGH	t(͡e͡n)d͡ʒˈiː(͡m͡i)h
Taane	taˈane
Takuta	takˈu"ta
Tarahiti	tˌarahˈiti
Taraia	tarˈa͡ɪa
Tatū	tˈatu"ː
Taupiri	tˌau"pˈiri
Tauwhao	taˈu"fa͡ʊ
Tiamani	tˌiamˈani
Timoti	timˈɔti
Tomoana	tˌɔmɔˈana
Tuhoro	tu"hˈɔrɔ
Tupai	tˈu"pa͡ɪ
Tutekohi	tˌu"tekˈɔhi
Tāmanuhiri	tˌaːmanu"hˈiri
Tūmatanui	tˌu"ːmatanˈu"i
Waitohi	wa͡ɪtˈɔhi
Wallace	w ˈa (͡e͡n)ˈɛl ˈɛl(͡m͡i) ˈa (͡e͡n)sˈiː(͡m͡i) ˈe
Whakatika	fˌakatˈika
Whakawhitiwhitinga	fˌakafˌitifitˈiŋa
Whangaparaoa	fˌaŋaparˈa͡ʊa
Wharekahika	fˌarekahˈika
Whero	fˈerɔ
Whāingaroa	fˌaːiŋarˈɔa
Whārangi	faːrˈaŋi
Women	wˈɔmen
also	ˈa (͡e͡n)ˈɛl ˈɛs(͡m͡i) ˈɔ
anana	anˈana
angitūtanga	ˌaŋitu"ːtˈaŋa
atarau	ˌatarˈau"
aunoa	ˌau"nˈɔa
ca	(͡e͡n)sˈiː(͡m͡i) ˈa
disabled	(͡e͡n)dˈiː(͡m͡i) ˈi (͡e͡n)ˈɛs(͡m͡i) ˈa (͡e͡n)bˈiː ˈɛl(͡m͡i) ˈe (͡e͡n)dˈiː(͡m͡i)
editors	ˈe (͡e͡n)dˈiː(͡m͡i) ˈi t ˈɔ r (͡e͡n)ˈɛs(͡m͡i)
email	ˈe m ˈa ˈi (͡e͡n)ˈɛl(͡m͡i)
haereere	hˌa͡ɪreˈere
haha	hˈaha
hakahaka	hˌakahˈaka
hapuku	hapˈu"ku"
haukū	haˈu"ku"ː
helicopter	h ˈe (͡e͡n)ˈɛl(͡m͡i) ˈi (͡e͡n)sˈiː(͡m͡i) ˈɔ p t ˈe r
hoehoe	hwˈehwe
hoha	hˈɔha
huatanga	hˌu"atˈaŋa
huru	hˈu"ru"
hāpiripiri	hˌaːpiripˈiri
hēhē	hˈeːheː
hīnau	hiːnˈau"
inumia	ˌinu"mˈia
iro	ˈirɔ
kahupapa	kˌahu"pˈapa
kaiao	kˈa͡ɪa͡ʊ
kaihāpai	ka͡ɪhˈaːpa͡ɪ
kaiurungi	kˌa͡ɪu"rˈu"ŋi
kaiwhakauru	kˌa͡ɪfakaˈu"ru"
kapukapu	kˌapu"kˈapu"
kapuni	kapˈu"ni
karengo	karˈeŋɔ
kauhanga	kˌau"hˈaŋa
kauruku	kˌau"rˈu"ku"
kauwae	kaˈu"wa͡ɪ
kurikuri	kˌu"rikˈu"ri
kë	kˈe
kēne	kˈeːne
kōmiti	kɔːmˈiti
literature	(͡e͡n)ˈɛl(͡m͡i) ˈi t ˈe r ˈa t ˈu" r ˈe
lxxxiii	(͡e͡n)ˈɛl ˈɛks ˈɛks ˈɛks(͡m͡i) ˈi ˈi ˈi
maharahara	mˌaharahˈara
maharatia	mˌaharatˈia
maihi	mˈa͡ɪhi
maire	mˈa͡ɪre
makuku	makˈu"ku"
mataitai	matˈa͡ɪta͡ɪ
matakuikui	mˌatakˌu"ikˈu"i
matapōkere	mˌatapɔːkˈere
mauiui	mˌau"iˈu"i
maungārongo	mˌau"ŋaːrˈɔŋɔ
mawehe	mawˈehe
meremere	mˌeremˈere
minenga	minˈeŋa
mohoao	mɔhˈɔa͡ʊ
mumura	mu"mˈu"ra
murunga	mu"rˈu"ŋa
māhanga	maːhˈaŋa
mānukanuka	mˌaːnu"kanˈu"ka
mārie	maːrˈie
mātinitini	mˌaːtinitˈini
nahanaha	nˌahanˈaha
ngakia	ŋakˈia
ngangahau	ŋˌaŋahˈau"
ngaunga	ŋaˈu"ŋa
noti	nˈɔti
nukua	nu"kˈu"a
nupepa	nu"pˈepa
other	ˈɔther
pakapaka	pˌakapˈaka
panana	panˈana
papakāinga	pˌapakaːˈiŋa
parapara	pˌarapˈara
peeke	peˈeke
pihanga	pihˈaŋa
pikopiko	pˌikɔpˈikɔ
place	p (͡e͡n)ˈɛl(͡m͡i) ˈa (͡e͡n)sˈiː(͡m͡i) ˈe
poapoa	pˌɔapˈɔa
pohatu	pɔhˈatu"
poitarawhiti	pˌo͡ɪtarafˈiti
pokanga	pɔkˈaŋa
puha	pˈu"ha
punarua	pˌu"narˈu"a
puoru	pu"ˈɔru"
pä	pˈa
pāmahana	pˌaːmahˈana
pāti	pˈaːti
pīkau	piːkˈau"
pūmautanga	pˌu"ːmau"tˈaŋa
rahaki	rahˈaki
raho	rˈahɔ
rangitaki	rˌaŋitˈaki
rapea	rapˈea
raupapahia	rˌau"pˌapahˈia
raupō	raˈu"pɔː
rawekehia	rˌawekehˈia
rehurehu	rˌehu"rˈehu"
riha	rˈiha
rātonga	raːtˈɔŋa
rēhitatanga	rˌeːhitatˈaŋa
taitapa	ta͡ɪtˈapa
takahitanga	tˌakahitˈaŋa
takakino	tˌakakˈinɔ
tanuku	tanˈu"ku"
taramea	tˌaramˈea
tautō	taˈu"tɔː
tieki	tiˈeki
titikaha	tˌitikˈaha
tohenga	tɔhˈeŋa
tohumate	tˌɔhu"mˈate
toke	tˈɔke
tuahu	tu"ˈahu"
tukuruatia	tˌu"ku"rˌu"atˈia
tukutahi	tˌu"ku"tˈahi
tumau	tu"mˈau"
tuuturu	tˌu"u"tˈu"ru"
tāhuna	taːhˈu"na
tāpaetia	tˌaːpa͡ɪtˈia
tēneki	teːnˈeki
tīni	tˈiːni
tōmuatanga	tˌɔːmu"atˈaŋa
uriuri	ˌu"riˈu"ri
urungi	u"rˈu"ŋi
visa	(͡e͡n)vˈiː(͡m͡i) ˈi (͡e͡n)ˈɛs(͡m͡i) ˈa
wahangote	wˌahaŋˈɔte
wahangū	wahˈaŋu"ː
waireka	wa͡ɪrˈeka
wani	wˈani
wawahi	wawˈahi
weri	wˈeri
weriweri	wˌeriwˈeri
whae	fˈa͡ɪ
whaiti	fˈa͡ɪti
whakaangi	fˌakaˈaŋi
whakahihi	fˌakahˈihi
whakahuahua	fˌakahˌu"ahˈu"a
whakahuihui	fˌakahˌu"ihˈu"i
whakakapinga	fˌakakapˈiŋa
whakakaupapa	fˌakakˌau"pˈapa
whakakā	fakˈakaː
whakamanawa	fˌakamanˈawa
whakamaru	fˌakamˈaru"
whakamihia	fˌakamihˈia
whakangaromia	fˌakaŋˌarɔmˈia
whakaparahako	fˌakapˌarahˈakɔ
whakapokenga	fˌakapɔkˈeŋa
whakaputahia	fˌakapˌu"tahˈia
whakarereketanga	fˌakarˌereketˈaŋa
whakarihariha	fˌakarˌiharˈiha
whakatautau	fˌakatˌau"tˈau"
whakatematau	fˌakatˌematˈau"
whakatikahia	fˌakatˌikahˈia
whakatoi	fakˈato͡ɪ
whakatokia	fˌakatɔkˈia
whakawaiwai	fˌakawˈa͡ɪwa͡ɪ
whakawhiu	fˌakafˈiu"
whakawhānuihia	fˌakafˌaːnu"ihˈia
whiwhia	fifˈia
whänui	fanˈu"i
whāngote	faːŋˈɔte
wähanga	wahˈaŋa
wāhitau	wˌaːhitˈau"
â	(͡e͡n)ˌe͡ɪsˈɜːkəmflˌɛks(͡m͡i)
āhuru	aːhˈu"ru"
ēhara	eːhˈara
ētita	eːtˈita
Īhu	ˈiːhu"
ōkiko	ɔːkˈikɔ
Adobe	ˈa (͡e͡n)dˈiː(͡m͡i) ˈɔ (͡e͡n)bˈiː(͡m͡i) ˈe
All	ˈa (͡e͡n)ˈɛl ˈɛl(͡m͡i)
Ama	ˈama
Anaru	anˈaru"
Antarctica	ˈa n t ˈa r (͡e͡n)sˈiː(͡m͡i) t ˈi (͡e͡n)sˈiː(͡m͡i) ˈa
Arihia	ˌarihˈia
Arowhenua	ˌarɔfenˈu"a
Awatere	ˌawatˈere
Baker	(͡e͡n)bˈiː(͡m͡i) ˈa k ˈe r
Bank	(͡e͡n)bˈiː(͡m͡i) ˈa n k
Bob	(͡e͡n)bˈiː(͡m͡i) ˈɔ (͡e͡n)bˈiː(͡m͡i)
Bunbury	(͡e͡n)bˈiː(͡m͡i) ˈu" n (͡e͡n)bˈiː(͡m͡i) ˈu" r (͡e͡n)wˈa͡ɪ(͡m͡i)
CORE	(͡e͡n)sˈiː(͡m͡i) ˈɔ r ˈe
Chile	(͡e͡n)sˈiː(͡m͡i) h ˈi (͡e͡n)ˈɛl(͡m͡i) ˈe
Clarke	(͡e͡n)sˈiː ˈɛl(͡m͡i) ˈa r k ˈe
Cook	(͡e͡n)sˈiː(͡m͡i) ˈɔ ˈɔ k
Cullen	(͡e͡n)sˈiː(͡m͡i) ˈu" (͡e͡n)ˈɛl ˈɛl(͡m͡i) ˈe n
De	(͡e͡n)dˈiː(͡m͡i) ˈe
Drive	(͡e͡n)dˈiː(͡m͡i) r ˈi (͡e͡n)vˈiː(͡m͡i) ˈe
Ema	ˈema
Europe	ˌeu"rˈɔpe
Fire	(͡e͡n)ˈɛf(͡m͡i) ˈi r ˈe
Fish	(͡e͡n)ˈɛf(͡m͡i) ˈi (͡e͡n)ˈɛs(͡m͡i) h
From	(͡e͡n)ˈɛf(͡m͡i) r ˈɔ m
Gallery	(͡e͡n)d͡ʒˈiː(͡m͡i) ˈa (͡e͡n)ˈɛl ˈɛl(͡m͡i) ˈe r (͡e͡n)wˈa͡ɪ(͡m͡i)
Gazette	(͡e͡n)d͡ʒˈiː(͡m͡i) ˈa (͡e͡n)zˈɛd(͡m͡i) ˈe t t ˈe
Gold	(͡e͡n)d͡ʒˈiː(͡m͡i) ˈɔ (͡e͡n)ˈɛl dˈiː(͡m͡i)
Greymouth	(͡e͡n)d͡ʒˈiː(͡m͡i) r ˈe (͡e͡n)wˈa͡ɪ(͡m͡i) m ˈɔ ˈu" t h
Hautanga	hˌau"tˈaŋa
Hea	hˈea
Heeni	heˈeni
Hekenukumai	hˌekenu"kˈu"ma͡ɪ
Hemana	hemˈana
Hill	h ˈi (͡e͡n)ˈɛl ˈɛl(͡m͡i)
Hohepa	hɔhˈepa
Hokinga	hɔkˈiŋa
Homepage	h ˈɔ m ˈe p ˈa (͡e͡n)d͡ʒˈiː(͡m͡i) ˈe
Honoa	hɔnˈɔa
Horror	hˈɔrrɔr
Huarahi	hˌu"arˈahi
Huata	hu"ˈata
Hērangi	heːrˈaŋi
Hētana	heːtˈana
Hōtaka	hɔːtˈaka
Irihāpeti	ˌirihaːpˈeti
Itāria	ˌitaːrˈia
Jeffery	(͡e͡n)d͡ʒˈe͡ɪ(͡m͡i) ˈe (͡e͡n)ˈɛf ˈɛf(͡m͡i) ˈe r (͡e͡n)wˈa͡ɪ(͡m͡i)
Kahawai	kahˈawa͡ɪ
Kaikoura	kˌa͡ɪkoˈu"ra
Kano	kˈanɔ
Kaporeihana	kˌapɔrˌeihˈana
Kapua	kapˈu"a
Kaumātua	kˌau"maːtˈu"a
Kerikeri	kˌerikˈeri
Kino	kˈinɔ
Koata	kɔˈata
Koutou	kˌou"tˈou"
Kāo	kˈaːɔ
Kēnana	keːnˈana
Law	(͡e͡n)ˈɛl(͡m͡i) ˈa w
Learn	(͡e͡n)ˈɛl(͡m͡i) ˈe ˈa r n
Lee	(͡e͡n)ˈɛl(͡m͡i) ˈe ˈe
Mahinga	mahˈiŋa
Maiharanui	mˌa͡ɪharanˈu"i
Makere	makˈere
Mangu	mˈaŋu"
Maraea	marˈa͡ɪa
Marangai	marˈaŋa͡ɪ
Maritime	mˌaritˈime
Matuku	matˈu"ku"
Mayor	m ˈa (͡e͡n)wˈa͡ɪ(͡m͡i) ˈɔ r
Meinga	meˈiŋa
Mokena	mɔkˈena
Motueka	mˌɔtu"ˈeka
Mt	mt
Mōmona	mɔːmˈɔna
NIR	nˈir
Nainoa	na͡ɪnˈɔa
Ngahere	ŋahˈere
Ngaiterangi	ŋˌa͡ɪterˈaŋi
Nick	n ˈi (͡e͡n)sˈiː(͡m͡i) k
Niho	nˈihɔ
Nina	nˈina
Nukutaurua	nˌu"ku"tˌau"rˈu"a
Nāhinara	nˌaːhinˈara
Overview	ˈɔ (͡e͡n)vˈiː(͡m͡i) ˈe r (͡e͡n)vˈiː(͡m͡i) ˈi ˈe w
Pangarau	pˌaŋarˈau"
Patua	patˈu"a
Peihopa	pˌeihˈɔpa
Pem	pˈem
Poroumata	pˌɔrou"mˈata
Porowini	pˌɔrɔwˈini
Poutāpeta	pˌou"taːpˈeta
Professor	p r ˈɔ (͡e͡n)ˈɛf(͡m͡i) ˈe (͡e͡n)ˈɛs ˈɛs(͡m͡i) ˈɔ r
Public	p ˈu" (͡e͡n)bˈiː ˈɛl(͡m͡i) ˈi (͡e͡n)sˈiː(͡m͡i)
Puka	pˈu"ka
Pāpori	paːpˈɔri
QuickTime	(͡e͡n)kjˈuː(͡m͡i) ˈu" ˈi (͡e͡n)sˈiː(͡m͡i) k tˈime
Race	r ˈa (͡e͡n)sˈiː(͡m͡i) ˈe
Rapanga	rapˈaŋa
ResourcesJavaScript	r ˈe (͡e͡n)ˈɛs(͡m͡i) ˈɔ ˈu" r (͡e͡n)sˈiː(͡m͡i) ˈe (͡e͡n)ˈɛs d͡ʒˈe͡ɪ(͡m͡i) ˈa (͡e͡n)vˈiː(͡m͡i) ˈa (͡e͡n)ˈɛs sˈiː(͡m͡i) r ˈi p t
Robinson	r ˈɔ (͡e͡n)bˈiː(͡m͡i) ˈi n (͡e͡n)ˈɛs(͡m͡i) ˈɔ n
Rommel	r ˈɔ m m ˈe (͡e͡n)ˈɛl(͡m͡i)
Rongomaurikura	rˌɔŋɔmˌau"rikˈu"ra
Roroa	rɔrˈɔa
Ruataupare	rˌu"atˌau"pˈare
Saturday	(͡e͡n)ˈɛs(͡m͡i) ˈa t ˈu" r (͡e͡n)dˈiː(͡m͡i) ˈa (͡e͡n)wˈa͡ɪ(͡m͡i)
Seddon	(͡e͡n)ˈɛs(͡m͡i) ˈe (͡e͡n)dˈiː dˈiː(͡m͡i) ˈɔ n
Snapper	(͡e͡n)ˈɛs(͡m͡i) n ˈa p p ˈe r
Sue	(͡e͡n)ˈɛs(͡m͡i) ˈu" ˈe
SunSmart	(͡e͡n)ˈɛs(͡m͡i) ˈu" n (͡e͡n)ˈɛs(͡m͡i) m ˈa r t
Sydney	(͡e͡n)ˈɛs wˈa͡ɪ dˈiː(͡m͡i) n ˈe (͡e͡n)wˈa͡ɪ(͡m͡i)
Tags	t ˈa (͡e͡n)d͡ʒˈiː ˈɛs(͡m͡i)
Taika	tˈa͡ɪka
Takiura	tˌakiˈu"ra
Tamarau	tˌamarˈau"
Tarakawa	tˌarakˈawa
Taumarere	tˌau"marˈere
Tautohua	tˌau"tɔhˈu"a
Teko	tˈekɔ
Tikipunga	tˌikipˈu"ŋa
Tona	tˈɔna
Two	twˈɔ
Tāhū	tˈaːhu"ː
Tūranganui	tˌu"ːraŋanˈu"i
UNESCO	ˈu" n ˈe (͡e͡n)ˈɛs sˈiː(͡m͡i) ˈɔ
Uawa	u"ˈawa
Uhia	u"hˈia
VC	(͡e͡n)vˌiːsˈiː(͡m͡i)
Wahawaha	wˌahawˈaha
Waihau	wa͡ɪhˈau"
Waiomatatini	wˌa͡ɪɔmˌatatˈini
We	wˈe
Weka	wˈeka
Westport	w ˈe (͡e͡n)ˈɛs(͡m͡i) t p ˈɔ r t
Whaanga	faˈaŋa
Whaia	fˈa͡ɪa
Whaitua	fa͡ɪtˈu"a
Whakahau	fˌakahˈau"
Whakapiki	fˌakapˈiki
Whakarapa	fˌakarˈapa
Whakaruruhau	fˌakarˌu"ru"hˈau"
Whakarōpūhia	fˌakarˌɔːpu"ːhˈia
Whakarōpūngia	fˌakarˌɔːpu"ːŋˈia
Whakatairitea	fˌakatˌa͡ɪritˈea
Whakataki	fˌakatˈaki
Whakatō	fakˈatɔː
Whakawhitinga	fˌakafitˈiŋa
Whangamata	fˌaŋamˈata
Wharepukapuka	fˌarepˌu"kapˈu"ka
Wharf	w h ˈa r (͡e͡n)ˈɛf(͡m͡i)
Whatahoro	fˌatahˈɔrɔ
WickEdStudy	w ˈi (͡e͡n)sˈiː(͡m͡i) k ˈe (͡e͡n)dˈiː ˈɛs(͡m͡i) t ˈu" (͡e͡n)dˈiː wˈa͡ɪ(͡m͡i)
against	ˈa (͡e͡n)d͡ʒˈiː(͡m͡i) ˈa ˈi n (͡e͡n)ˈɛs(͡m͡i) t
akina	akˈina
am	ˈam
aromatawaia	ˌarɔmˌatawˈa͡ɪa
arorangi	ˌarɔrˈaŋi
arowhai	arˈɔfa͡ɪ
auare	ˌau"ˈare
awhikiri	ˌafikˈiri
awhinatia	ˌafinatˈia
ekea	ekˈea
government	(͡e͡n)d͡ʒˈiː(͡m͡i) ˈɔ (͡e͡n)vˈiː(͡m͡i) ˈe r n m ˈe n t
h	h
haeata	ha͡ɪˈata
hahae	hˈaha͡ɪ
haratau	hˌaratˈau"
haua	haˈu"a
haumano	hˌau"mˈanɔ
hauwarea	hˌau"warˈea
hekaheka	hˌekahˈeka
hiwa	hˈiwa
hoake	hɔˈake
hoi	hˈo͡ɪ
hoka	hˈɔka
hongere	hɔŋˈere
huanui	hˌu"anˈu"i
hukea	hu"kˈea
hungawai	hu"ŋˈawa͡ɪ
hīmene	hiːmˈene
hōanga	hɔːˈaŋa
ihumanea	ˌihu"manˈea
implants	ˈi m p (͡e͡n)ˈɛl(͡m͡i) ˈa n t (͡e͡n)ˈɛs(͡m͡i)
inaki	inˈaki
inati	inˈati
include	ˈi n (͡e͡n)sˈiː ˈɛl(͡m͡i) ˈu" (͡e͡n)dˈiː(͡m͡i) ˈe
inihua	ˌinihˈu"a
into	ˈintɔ
kaikauwhau	kˌa͡ɪkau"fˈau"
kaikerēme	kˌa͡ɪkerˈeːme
kaimātakitaki	kˌa͡ɪmaːtˌakitˈaki
kaiuru	ka͡ɪˈu"ru"
kaiwhakaputa	kˌa͡ɪfakapˈu"ta
kakenga	kakˈeŋa
kamera	kamˈera
karaipiture	kˌara͡ɪpitˈu"re
karakiatia	kˌarakˌiatˈia
kaurori	kˌau"rˈɔri
ketia	ketˈia
kiki	kˈiki
kirikā	kirˈikaː
kirīmi	kirˈiːmi
kohuke	kɔhˈu"ke
koke	kˈɔke
koranehe	kˌɔranˈehe
koroke	kɔrˈɔke
koroputa	kˌɔrɔpˈu"ta
korou	kɔrˈou"
kuhua	ku"hˈu"a
kukupa	ku"kˈu"pa
kukuti	ku"kˈu"ti
kuwaha	ku"wˈaha
kāika	kaːˈika
kārangaranga	kˌaːraŋarˈaŋa
kōhi	kˈɔːhi
kōhuru	kɔːhˈu"ru"
kōpu	kˈɔːpu"
kūare	ku"ːˈare
kūhuka	ku"ːhˈu"ka
link	(͡e͡n)ˈɛl(͡m͡i) ˈi n k
maaka	maˈaka
maara	maˈara
mahora	mahˈɔra
maikuku	ma͡ɪkˈu"ku"
maina	mˈa͡ɪna
matemateaone	mˌatemˌateˈa͡ʊne
matewhawhati	mˌatefafˈati
meake	meˈake
mekemeke	mˌekemˈeke
mete	mˈete
moemoehia	mwˌemwehˈia
moohiotia	mˌɔɔhˌiɔtˈia
mounu	moˈu"nu"
mumps	m ˈu" m p (͡e͡n)ˈɛs(͡m͡i)
māhorahora	mˌaːhɔrahˈɔra
māwhaiwhai	maːfˈa͡ɪfa͡ɪ
nawai	nˈawa͡ɪ
ngaherehere	ŋˌaherehˈere
ngakinga	ŋakˈiŋa
ngawha	ŋˈafa
ngawhere	ŋafˈere
ngāherehere	ŋˌaːherehˈere
ngāngara	ŋaːŋˈara
niu	nˈiu"
notemea	nˌɔtemˈea
nōku	nˈɔːku"
nōu	nˈɔːu"
ohinga	ɔhˈiŋa
okiokinga	ˌɔkiɔkˈiŋa
onge	ˈɔŋe
orokati	ˌɔrɔkˈati
orooro	ˌɔrɔˈɔrɔ
pakaruhia	pˌakaru"hˈia
pangarau	pˌaŋarˈau"
paopao	pˈa͡ʊpa͡ʊ
papaneke	pˌapanˈeke
paraharaha	pˌaraharˈaha
parau	parˈau"
parehe	parˈehe
parekareka	pˌarekarˈeka
people	p ˈe ˈɔ p (͡e͡n)ˈɛl(͡m͡i) ˈe
pikau	pikˈau"
piripiri	pˌiripˈiri
pitomata	pˌitɔmˈata
player	p (͡e͡n)ˈɛl(͡m͡i) ˈa (͡e͡n)wˈa͡ɪ(͡m͡i) ˈe r
poriro	pɔrˈirɔ
poutiriao	pˌou"tirˈia͡ʊ
pākia	paːkˈia
pāorooro	pˌaːɔrɔˈɔrɔ
pātū	pˈaːtu"ː
pūare	pu"ːˈare
pūeru	pu"ːˈeru"
pūhou	pu"ːhˈou"
rangatū	raŋˈatu"ː
rarua	rarˈu"a
rauawa	rˌau"ˈawa
rimurimu	rˌimu"rˈimu"
roko	rˈɔkɔ
rāpihi	raːpˈihi
rārangitia	rˌaːraŋitˈia
rīriri	riːrˈiri
seems	(͡e͡n)ˈɛs(͡m͡i) ˈe ˈe m (͡e͡n)ˈɛs(͡m͡i)
set	(͡e͡n)ˈɛs(͡m͡i) ˈe t
taana	taˈana
tahia	tahˈia
tahora	tahˈɔra
takaroa	tˌakarˈɔa
tamarikitanga	tˌamarˌikitˈaŋa
tapatapahi	tˌapatapˈahi
tapawha	tapˈafa
taraute	tˌaraˈu"te
tauaki	tˌau"ˈaki
taupua	tˌau"pˈu"a
taupū	taˈu"pu"ː
tautiaki	tˌau"tiˈaki
tauwehe	tˌau"wˈehe
tene	tˈene
three	thrˈee
through	t h r ˈɔ ˈu" (͡e͡n)d͡ʒˈiː(͡m͡i) h
tiakarete	tˌiakarˈete
tiima	tiˈima
titia	titˈia
tohutao	tɔhˈu"ta͡ʊ
tohutoa	tˌɔhu"tˈɔa
topuni	tɔpˈu"ni
tuakiritanga	tˌu"akˌiritˈaŋa
tuawha	tu"ˈafa
tunutunu	tˌu"nu"tˈu"nu"
turia	tu"rˈia
tāea	taːˈea
tāiri	taːˈiri
tākai	tˈaːka͡ɪ
tākoha	taːkˈɔha
tāruaruatia	tˌaːru"ˌaru"atˈia
tātua	taːtˈu"a
tāwharau	tˌaːfarˈau"
tēnehi	teːnˈehi
tūmanakohia	tˌu"ːmanˌakɔhˈia
tūtohutanga	tˌu"ːtɔhu"tˈaŋa
tūwatawata	tˌu"ːwatawˈata
waehere	wa͡ɪhˈere
waharoa	wˌaharˈɔa
waimeha	wa͡ɪmˈeha
waitohua	wˌa͡ɪtɔhˈu"a
werowero	wˌerɔwˈerɔ
whakaatangia	fˌakaˌataŋˈia
whakahawea	fˌakahawˈea
whakahihiri	fˌakahihˈiri
whakairotia	fˌaka͡ɪrɔtˈia
whakakeke	fˌakakˈeke
whakakorenga	fˌakakɔrˈeŋa
whakamanamana	fˌakamˌanamˈana
whakamaramatanga	fˌakamˌaramatˈaŋa
whakamatauria	fˌakamˌatau"rˈia
whakamohiotia	fˌakamˌɔhiɔtˈia
whakapaea	fˌakapˈa͡ɪa
whakapeto	fˌakapˈetɔ
whakarangatira	fˌakarˌaŋatˈira
whakarata	fˌakarˈata
whakaraupapahia	fˌakarˌau"pˌapahˈia
whakareka	fˌakarˈeka
whakarua	fˌakarˈu"a
whakatūwhera	fˌakatu"ːfˈera
wikitōria	wˌikitɔːrˈia
Āhitana	ˌaːhitˈana
āniwaniwa	ˌaːniwanˈiwa
ātanga	aːtˈaŋa
āteha	aːtˈeha
ātārangi	ˌaːtaːrˈaŋi
āwhio	aːfˈiɔ
Ahau	ahˈau"
Ahia	ahˈia
Ahumahi	ˌahu"mˈahi
Akona	akˈɔna
Albert	ˈa (͡e͡n)ˈɛl bˈiː(͡m͡i) ˈe r t
Alternatively	ˈa (͡e͡n)ˈɛl(͡m͡i) t ˈe r n ˈa t ˈi (͡e͡n)vˈiː(͡m͡i) ˈe (͡e͡n)ˈɛl wˈa͡ɪ(͡m͡i)
And	ˈa n (͡e͡n)dˈiː(͡m͡i)
ApiTrak	ˈapi trˈak
Armstrong	ˈa r m (͡e͡n)ˈɛs(͡m͡i) t r ˈɔ n (͡e͡n)d͡ʒˈiː(͡m͡i)
AwardsPrime	ˈa w ˈa r (͡e͡n)dˈiː ˈɛs(͡m͡i) prˈime
BOP	(͡e͡n)bˈiː(͡m͡i) ˈɔ p
Base	(͡e͡n)bˈiː(͡m͡i) ˈa (͡e͡n)ˈɛs(͡m͡i) ˈe
Bird	(͡e͡n)bˈiː(͡m͡i) ˈi r (͡e͡n)dˈiː(͡m͡i)
Canal	(͡e͡n)sˈiː(͡m͡i) ˈa n ˈa (͡e͡n)ˈɛl(͡m͡i)
Dance	(͡e͡n)dˈiː(͡m͡i) ˈa n (͡e͡n)sˈiː(͡m͡i) ˈe
Dublin	(͡e͡n)dˈiː(͡m͡i) ˈu" (͡e͡n)bˈiː ˈɛl(͡m͡i) ˈi n
Emergency	ˈe m ˈe r (͡e͡n)d͡ʒˈiː(͡m͡i) ˈe n (͡e͡n)sˈiː wˈa͡ɪ(͡m͡i)
Fats	(͡e͡n)ˈɛf(͡m͡i) ˈa t (͡e͡n)ˈɛs(͡m͡i)
Fe	(͡e͡n)ˈɛf(͡m͡i) ˈe
Field	(͡e͡n)ˈɛf(͡m͡i) ˈi ˈe (͡e͡n)ˈɛl dˈiː(͡m͡i)
Free	(͡e͡n)ˈɛf(͡m͡i) r ˈe ˈe
GDP	(͡e͡n)d͡ʒˌiːdˈiː(͡m͡i)p
Haimona	ha͡ɪmˈɔna
Hapani	hapˈani
Haumia	hˌau"mˈia
Haunga	haˈu"ŋa
Healthline	h ˈe ˈa (͡e͡n)ˈɛl(͡m͡i) t h (͡e͡n)ˈɛl(͡m͡i) ˈi n ˈe
Herangi	herˈaŋi
Heteroptera	hˌeterɔptˈera
Hineahuone	hˌineˌahu"ˈɔne
Hinerangi	hˌinerˈaŋi
Hinewai	hinˈewa͡ɪ
Historical	h ˈi (͡e͡n)ˈɛs(͡m͡i) t ˈɔ r ˈi (͡e͡n)sˈiː(͡m͡i) ˈa (͡e͡n)ˈɛl(͡m͡i)
HistoryDDC	h ˈi (͡e͡n)ˈɛs(͡m͡i) t ˈɔ r (͡e͡n)wˈa͡ɪ dˌiːdˌiːsˈiː(͡m͡i)
Hoahoa	hˌɔahˈɔa
Hopukina	hˌɔpu"kˈina
Hurihuri	hˌu"rihˈu"ri
Innovation	ˈi n n ˈɔ (͡e͡n)vˈiː(͡m͡i) ˈa t ˈi ˈɔ n
Jamie	(͡e͡n)d͡ʒˈe͡ɪ(͡m͡i) ˈa m ˈi ˈe
Jane	(͡e͡n)d͡ʒˈe͡ɪ(͡m͡i) ˈa n ˈe
Jeremy	(͡e͡n)d͡ʒˈe͡ɪ(͡m͡i) ˈe r ˈe m (͡e͡n)wˈa͡ɪ(͡m͡i)
Jordan	(͡e͡n)d͡ʒˈe͡ɪ(͡m͡i) ˈɔ r (͡e͡n)dˈiː(͡m͡i) ˈa n
K	k
KO	kˈɔ
Kahui	kahˈu"i
Kaimai	kˈa͡ɪma͡ɪ
Kaitātaki	kˌa͡ɪtaːtˈaki
Kanikani	kˌanikˈani
Kapu	kˈapu"
Kaumatua	kˌau"matˈu"a
Kea	kˈea
Keri	kˈeri
Kerēme	kerˈeːme
Kiki	kˈiki
Korokī	kɔrˈɔkiː
Koura	koˈu"ra
Kuaha	ku"ˈaha
Kumara	ku"mˈara
Kunenga	ku"nˈeŋa
Kāpehu	kaːpˈehu"
Kōrerotia	kˌɔːrerɔtˈia
Lincoln	(͡e͡n)ˈɛl(͡m͡i) ˈi n (͡e͡n)sˈiː(͡m͡i) ˈɔ (͡e͡n)ˈɛl(͡m͡i) n
Line	(͡e͡n)ˈɛl(͡m͡i) ˈi n ˈe
London	(͡e͡n)ˈɛl(͡m͡i) ˈɔ n (͡e͡n)dˈiː(͡m͡i) ˈɔ n
MMP	mmp
Maimoatanga	mˌa͡ɪmɔatˈaŋa
Manakotanga	mˌanakɔtˈaŋa
Mangakāhia	mˌaŋakaːhˈia
Mangere	maŋˈere
Maramataka	mˌaramatˈaka
Mars	m ˈa r (͡e͡n)ˈɛs(͡m͡i)
Matthew	mˈatthew
Medium	m ˈe (͡e͡n)dˈiː(͡m͡i) ˈi ˈu" m
Mina	mˈina
Minister	m ˈi n ˈi (͡e͡n)ˈɛs(͡m͡i) t ˈe r
Momo	mˈɔmɔ
Moteatea	mˌɔteatˈea
Motorway	m ˈɔ t ˈɔ r w ˈa (͡e͡n)wˈa͡ɪ(͡m͡i)
Māmoe	mˈaːmwe
Mātāmua	mˌaːtaːmˈu"a
NA	nˈa
Nathan	nˈathan
Ngahuru	ŋahˈu"ru"
Ngaitai	ŋˈa͡ɪta͡ɪ
Ngāmotu	ŋaːmˈɔtu"
Nihoniho	nˌihɔnˈihɔ
Niwa	nˈiwa
Noel	n ˈɔ ˈe (͡e͡n)ˈɛl(͡m͡i)
Norman	nˈɔrman
Ohia	ɔhˈia
Opera	ɔpˈera
Oreore	ˌɔreˈɔre
Paeko	pˈa͡ɪkɔ
Panuku	panˈu"ku"
Paraparaumu	pˌarapˌaraˈu"mu"
Part	pˈart
Pehi	pˈehi
Pena	pˈena
Pene	pˈene
Phyllis	p h (͡e͡n)wˈa͡ɪ ˈɛl ˈɛl(͡m͡i) ˈi (͡e͡n)ˈɛs(͡m͡i)
Pipitea	pˌipitˈea
Plymouth	p (͡e͡n)ˈɛl wˈa͡ɪ(͡m͡i) m ˈɔ ˈu" t h
Poihana	po͡ɪhˈana
Productions	p r ˈɔ (͡e͡n)dˈiː(͡m͡i) ˈu" (͡e͡n)sˈiː(͡m͡i) t ˈi ˈɔ n (͡e͡n)ˈɛs(͡m͡i)
Puia	pu"ˈia
Pāwhiri	paːfˈiri
Pēke	pˈeːke
Quay	(͡e͡n)kjˈuː(͡m͡i) ˈu" ˈa (͡e͡n)wˈa͡ɪ(͡m͡i)
Rakaumangamanga	rˌakaˌu"maŋamˈaŋa
Ratapu	ratˈapu"
Ray	r ˈa (͡e͡n)wˈa͡ɪ(͡m͡i)
Read	r ˈe ˈa (͡e͡n)dˈiː(͡m͡i)
Representatives	r ˈe p r ˈe (͡e͡n)ˈɛs(͡m͡i) ˈe n t ˈa t ˈi (͡e͡n)vˈiː(͡m͡i) ˈe (͡e͡n)ˈɛs(͡m͡i)
Reri	rˈeri
Ripoata	rˌipɔˈata
Rolleston	r ˈɔ (͡e͡n)ˈɛl ˈɛl(͡m͡i) ˈe (͡e͡n)ˈɛs(͡m͡i) t ˈɔ n
Rona	rˈɔna
Rongomai	rɔŋˈɔma͡ɪ
Rongomātāne	rˌɔŋɔmaːtˈaːne
Ruka	rˈu"ka
Rāapa	raːˈapa
Rākaipaaka	rˌaːka͡ɪpaˈaka
Saints	(͡e͡n)ˈɛs(͡m͡i) ˈa ˈi n t (͡e͡n)ˈɛs(͡m͡i)
Serco	(͡e͡n)ˈɛs(͡m͡i) ˈe r (͡e͡n)sˈiː(͡m͡i) ˈɔ
Sharples	(͡e͡n)ˈɛs(͡m͡i) h ˈa r p (͡e͡n)ˈɛl(͡m͡i) ˈe (͡e͡n)ˈɛs(͡m͡i)
Sim	(͡e͡n)ˈɛs(͡m͡i) ˈi m
Sonny	(͡e͡n)ˈɛs(͡m͡i) ˈɔ n n (͡e͡n)wˈa͡ɪ(͡m͡i)
Taiaroa	tˌa͡ɪarˈɔa
Tangihōro	tˌaŋihˈɔːrɔ
Tangotango	tˌaŋɔtˈaŋɔ
Tararua	tˌararˈu"a
Tarata	tarˈata
Tatou	tatˈou"
Taurahere	tˌau"rahˈere
Tautoru	tˌau"tˈɔru"
Tawhito	tafˈitɔ
Teira	teˈira
Tiakina	tˌiakˈina
Tihei	tihˈei
Tira	tˈira
Tireiniamu	tˌireˌiniˈamu"
Toia	tˈo͡ɪa
Tokaanu	tˌɔkaˈanu"
Tokorima	tˌɔkɔrˈima
Tokowhitu	tˌɔkɔfˈitu"
Tonu	tˈɔnu"
Tuahiwi	tˌu"ahˈiwi
Tumatauenga	tˌu"matˌau"ˈeŋa
Twyford	t w (͡e͡n)wˈa͡ɪ ˈɛf(͡m͡i) ˈɔ r (͡e͡n)dˈiː(͡m͡i)
Tāwhai	tˈaːfa͡ɪ
Tēna	tˈeːna
UN	ˈu"n
USA	ˈu" (͡e͡n)ˈɛs(͡m͡i) ˈa
Uara	u"ˈara
Uira	u"ˈira
Victory	(͡e͡n)vˈiː(͡m͡i) ˈi (͡e͡n)sˈiː(͡m͡i) t ˈɔ r (͡e͡n)wˈa͡ɪ(͡m͡i)
Video	(͡e͡n)vˈiː(͡m͡i) ˈi (͡e͡n)dˈiː(͡m͡i) ˈe ˈɔ
Vision	(͡e͡n)vˈiː(͡m͡i) ˈi (͡e͡n)ˈɛs(͡m͡i) ˈi ˈɔ n
Wa	wˈa
Waimakariri	wˌa͡ɪmakarˈiri
Waitematā	wˌa͡ɪtemˈataː
Wanaka	wanˈaka
Ward	w ˈa r (͡e͡n)dˈiː(͡m͡i)
Wendy	w ˈe n (͡e͡n)dˈiː wˈa͡ɪ(͡m͡i)
Whakanoho	fˌakanˈɔhɔ
Whakarae	fakˈara͡ɪ
Whakawhetai	fˌakafˈeta͡ɪ
Whena	fˈena
Whiria	firˈia
Whiu	fˈiu"
Williamson	w ˈi (͡e͡n)ˈɛl ˈɛl(͡m͡i) ˈi ˈa m (͡e͡n)ˈɛs(͡m͡i) ˈɔ n
Work	wˈɔrk
Your	(͡e͡n)wˈa͡ɪ(͡m͡i) ˈɔ ˈu" r
Youth	(͡e͡n)wˈa͡ɪ(͡m͡i) ˈɔ ˈu" t h
Zespri	(͡e͡n)zˈɛd(͡m͡i) ˈe (͡e͡n)ˈɛs(͡m͡i) p r ˈi
aana	aˈana
address	ˈa (͡e͡n)dˈiː dˈiː(͡m͡i) r ˈe (͡e͡n)ˈɛs ˈɛs(͡m͡i)
ahopae	ahˈɔpa͡ɪ
ahotakakame	ˌahɔtˌakakˈame
angiangi	ˌaŋiˈaŋi
arapū	arˈapu"ː
aromatawaihia	ˌarɔmˌatawa͡ɪhˈia
business	(͡e͡n)bˈiː(͡m͡i) ˈu" (͡e͡n)ˈɛs(͡m͡i) ˈi n ˈe (͡e͡n)ˈɛs ˈɛs(͡m͡i)
carabid	(͡e͡n)sˈiː(͡m͡i) ˈa r ˈa (͡e͡n)bˈiː(͡m͡i) ˈi (͡e͡n)dˈiː(͡m͡i)
choice	(͡e͡n)sˈiː(͡m͡i) h ˈɔ ˈi (͡e͡n)sˈiː(͡m͡i) ˈe
collection	(͡e͡n)sˈiː(͡m͡i) ˈɔ (͡e͡n)ˈɛl ˈɛl(͡m͡i) ˈe (͡e͡n)sˈiː(͡m͡i) t ˈi ˈɔ n
hahau	hahˈau"
haoa	hˈa͡ʊa
harakore	hˌarakˈɔre
hoari	hɔˈari
hopua	hɔpˈu"a
horu	hˈɔru"
hotu	hˈɔtu"
huraina	hu"rˈa͡ɪna
hurumanu	hˌu"ru"mˈanu"
hängai	hˈaŋa͡ɪ
hāpara	haːpˈara
hēkona	heːkˈɔna
hōngere	hɔːŋˈere
hōtera	hɔːtˈera
ihupuku	ˌihu"pˈu"ku"
interviews	ˈi n t ˈe r (͡e͡n)vˈiː(͡m͡i) ˈi ˈe w (͡e͡n)ˈɛs(͡m͡i)
ita	ˈita
its	ˈi t (͡e͡n)ˈɛs(͡m͡i)
kahanga	kahˈaŋa
kaiarataki	kˌa͡ɪaratˈaki
kaiuiui	kˌa͡ɪu"iˈu"i
kaiwawao	ka͡ɪwˈawa͡ʊ
kaiwhaiwāhi	kˌa͡ɪfa͡ɪwˈaːhi
kaiwhakatakoto	kˌa͡ɪfakˌatakˈɔtɔ
kakahi	kakˈahi
kakapa	kakˈapa
kakati	kakˈati
kaokao	kˈa͡ʊka͡ʊ
kapakapa	kˌapakˈapa
kapene	kapˈene
kaporeihana	kˌapɔrˌeihˈana
karakara	kˌarakˈara
kauanga	kˌau"ˈaŋa
kawai	kˈawa͡ɪ
kaweake	kˌaweˈake
kina	kˈina
kinotia	kˌinɔtˈia
koanga	kɔˈaŋa
koeko	kwˈekɔ
koikoi	kˈo͡ɪko͡ɪ
konumohe	kˌɔnu"mˈɔhe
kotikoti	kˌɔtikˈɔti
koukou	kˌou"kˈou"
kunenga	ku"nˈeŋa
kāpā	kˈaːpaː
kōwhatu	kɔːfˈatu"
mahea	mahˈea
mahuetanga	mˌahu"etˈaŋa
mahuta	mahˈu"ta
maiangi	ma͡ɪˈaŋi
makatea	mˌakatˈea
manatū	manˈatu"ː
manukanuka	mˌanu"kanˈu"ka
mapu	mˈapu"
marohi	marˈɔhi
matamata	mˌatamˈata
matawā	matˈawaː
mauherea	mˌau"herˈea
maurea	mˌau"rˈea
mimi	mˈimi
ml	m(͡e͡n)ˈɛl(͡m͡i)
motuhenga	mˌɔtu"hˈeŋa
māhaki	maːhˈaki
māraurau	mˌaːrau"rˈau"
māro	mˈaːrɔ
ngao	ŋˈa͡ʊ
ngārahu	ŋaːrˈahu"
niao	nˈia͡ʊ
oanahi	ˌɔanˈahi
oioi	ˈo͡ɪo͡ɪ
ori	ˈɔri
oropuare	ˌɔrɔpu"ˈare
paari	paˈari
pahūtanga	pˌahu"ːtˈaŋa
paitia	pa͡ɪtˈia
paitini	pa͡ɪtˈini
pakia	pakˈia
panuitia	pˌanu"itˈia
paparahi	pˌaparˈahi
papānga	papˈaːŋa
paramanawa	pˌaramanˈawa
piritahi	pˌiritˈahi
poitūkohu	pˌo͡ɪtu"ːkˈɔhu"
poutama	pˌou"tˈama
pukai	pˈu"ka͡ɪ
puranga	pu"rˈaŋa
purere	pu"rˈere
puri	pˈu"ri
pāhi	pˈaːhi
pāuna	paːˈu"na
pēhitanga	pˌeːhitˈaŋa
pīpīwai	piːpˈiːwa͡ɪ
pōnānā	pɔːnˈaːnaː
pōuritanga	pˌɔːu"ritˈaŋa
pūhuruhurutanga	pˌu"ːhu"rˌu"hu"ru"tˈaŋa
pūtoi	pˈu"ːto͡ɪ
raparapa	rˌaparˈapa
ratarata	rˌatarˈata
raupatunga	rˌau"patˈu"ŋa
references	r ˈe (͡e͡n)ˈɛf(͡m͡i) ˈe r ˈe n (͡e͡n)sˈiː(͡m͡i) ˈe (͡e͡n)ˈɛs(͡m͡i)
remu	rˈemu"
rerekore	rˌerekˈɔre
rewena	rewˈena
ronaki	rɔnˈaki
ruirui	rˌu"irˈu"i
rukuruku	rˌu"ku"rˈu"ku"
style	(͡e͡n)ˈɛs(͡m͡i) t (͡e͡n)wˈa͡ɪ ˈɛl(͡m͡i) ˈe
taaea	taˈa͡ɪa
tahuritanga	tˌahu"ritˈaŋa
tainga	tˈa͡ɪŋa
takatāpui	tˌakataːpˈu"i
takinga	takˈiŋa
takune	takˈu"ne
taote	tˈa͡ʊte
tapae	tˈapa͡ɪ
tapoi	tˈapo͡ɪ
taupā	taˈu"paː
tautika	tˌau"tˈika
tauāki	tˌau"ˈaːki
tawatawa	tˌawatˈawa
tawhiri	tafˈiri
teneti	tenˈeti
tineia	tˌineˈia
tioro	tiˈɔrɔ
tiria	tirˈia
tiu	tˈiu"
tokohia	tˌɔkɔhˈia
tongi	tˈɔŋi
tonohia	tˌɔnɔhˈia
torea	tɔrˈea
torokaha	tˌɔrɔkˈaha
totohe	tɔtˈɔhe
tuarangi	tˌu"arˈaŋi
tuhipoka	tˌu"hipˈɔka
tukupū	tu"kˈu"pu"ː
tutukitanga	tˌu"tu"kitˈaŋa
tërä	tˈera
tāmia	taːmˈia
tāmure	taːmˈu"re
tātarihia	tˌaːtarihˈia
tāwhai	tˈaːfa͡ɪ
tōpūtanga	tˌɔːpu"ːtˈaŋa
tūemi	tu"ːˈemi
tūhāhā	tu"ːhˈaːhaː
tūmāia	tˌu"ːmaːˈia
tūrama	tu"ːrˈama
tūtae	tˈu"ːta͡ɪ
waikura	wa͡ɪkˈu"ra
warowaihā	wˌarɔwˈa͡ɪhaː
wawetia	wˌawetˈia
whaanau	fˌaanˈau"
whaanui	fˌaanˈu"i
whaikiko	fa͡ɪkˈikɔ
whakaahuahanga	fˌakaˌahu"ahˈaŋa
whakaakongia	fˌakaˌakɔŋˈia
whakahihiko	fˌakahihˈikɔ
whakahoa	fˌakahˈɔa
whakahuatanga	fˌakahˌu"atˈaŋa
whakahēngia	fˌakaheːŋˈia
whakairohia	fˌaka͡ɪrɔhˈia
whakangao	fakˈaŋa͡ʊ
whakanoa	fˌakanˈɔa
whakanōhia	fˌakanɔːhˈia
whakapiripiri	fˌakapˌiripˈiri
whakapotonga	fˌakapɔtˈɔŋa
whakapāho	fˌakapˈaːhɔ
whakapākehā	fˌakapaːkˈehaː
whakarōpūtia	fˌakarˌɔːpu"ːtˈia
whakatara	fˌakatˈara
whakatatū	fˌakatˈatu"ː
whakatenatenahia	fˌakatˌenatˌenahˈia
whakateraki	fˌakaterˈaki
whakatupatohia	fˌakatˌu"patɔhˈia
whakatuu	fˌakatˈu"u"
whakawhenumi	fˌakafenˈu"mi
whawha	fˈafa
whawhaitanga	fˌafa͡ɪtˈaŋa
whākōkī	faːkˈɔːkiː
witi	wˈiti
¾	
ïnanga	inˈaŋa
āwhinatanga	ˌaːfinatˈaŋa
ē	ˈeː
īpae	ˈiːpa͡ɪ
ōritetanga	ˌɔːritetˈaŋa
ARF	ˈa r (͡e͡n)ˈɛf(͡m͡i)
Acrobat	ˈa (͡e͡n)sˈiː(͡m͡i) r ˈɔ (͡e͡n)bˈiː(͡m͡i) ˈa t
Akaroa	ˌakarˈɔa
Akau	akˈau"
Akomanga	ˌakɔmˈaŋa
America	ˈa m ˈe r ˈi (͡e͡n)sˈiː(͡m͡i) ˈa
Amohau	ˌamɔhˈau"
Anahera	ˌanahˈera
Anne	ˈanne
Aoniwaho	ˌa͡ʊniwˈahɔ
Ararau	ˌararˈau"
Arataki	ˌaratˈaki
Arthur	ˈarthu"r
Ashburton	ˈa (͡e͡n)ˈɛs(͡m͡i) h (͡e͡n)bˈiː(͡m͡i) ˈu" r t ˈɔ n
AtoJs	ˈatɔ (͡e͡n)d͡ʒˌe͡ɪˈɛs(͡m͡i)
Awanui	ˌawanˈu"i
Awanuiārangi	ˌawanˌu"iaːrˈaŋi
Awhina	afˈina
Browne	(͡e͡n)bˈiː(͡m͡i) r ˈɔ w n ˈe
Browse	(͡e͡n)bˈiː(͡m͡i) r ˈɔ w (͡e͡n)ˈɛs(͡m͡i) ˈe
Bulletin	(͡e͡n)bˈiː(͡m͡i) ˈu" (͡e͡n)ˈɛl ˈɛl(͡m͡i) ˈe t ˈi n
CO	(͡e͡n)sˈiː(͡m͡i) ˈɔ
CTRL	(͡e͡n)sˌiː(͡m͡i)tr(͡e͡n)ˈɛl(͡m͡i)
Carrington	(͡e͡n)sˈiː(͡m͡i) ˈa r r ˈi n (͡e͡n)d͡ʒˈiː(͡m͡i) t ˈɔ n
Charisma	(͡e͡n)sˈiː(͡m͡i) h ˈa r ˈi (͡e͡n)ˈɛs(͡m͡i) m ˈa
Countdown	(͡e͡n)sˈiː(͡m͡i) ˈɔ ˈu" n t (͡e͡n)dˈiː(͡m͡i) ˈɔ w n
Culture	(͡e͡n)sˈiː(͡m͡i) ˈu" (͡e͡n)ˈɛl(͡m͡i) t ˈu" r ˈe
Dargaville	(͡e͡n)dˈiː(͡m͡i) ˈa r (͡e͡n)d͡ʒˈiː(͡m͡i) ˈa (͡e͡n)vˈiː(͡m͡i) ˈi (͡e͡n)ˈɛl ˈɛl(͡m͡i) ˈe
Download	(͡e͡n)dˈiː(͡m͡i) ˈɔ w n (͡e͡n)ˈɛl(͡m͡i) ˈɔ ˈa (͡e͡n)dˈiː(͡m͡i)
Epsom	ˈe p (͡e͡n)ˈɛs(͡m͡i) ˈɔ m
Evans	ˈe (͡e͡n)vˈiː(͡m͡i) ˈa n (͡e͡n)ˈɛs(͡m͡i)
Features	(͡e͡n)ˈɛf(͡m͡i) ˈe ˈa t ˈu" r ˈe (͡e͡n)ˈɛs(͡m͡i)
Film	(͡e͡n)ˈɛf(͡m͡i) ˈi (͡e͡n)ˈɛl(͡m͡i) m
French	(͡e͡n)ˈɛf(͡m͡i) r ˈe n (͡e͡n)sˈiː(͡m͡i) h
GP	(͡e͡n)d͡ʒˈiː(͡m͡i)p
Games	(͡e͡n)d͡ʒˈiː(͡m͡i) ˈa m ˈe (͡e͡n)ˈɛs(͡m͡i)
Graeme	(͡e͡n)d͡ʒˈiː(͡m͡i) r ˈa ˈe m ˈe
Guide	(͡e͡n)d͡ʒˈiː(͡m͡i) ˈu" ˈi (͡e͡n)dˈiː(͡m͡i) ˈe
Haami	haˈami
Harata	harˈata
Harrison	h ˈa r r ˈi (͡e͡n)ˈɛs(͡m͡i) ˈɔ n
Head	h ˈe ˈa (͡e͡n)dˈiː(͡m͡i)
Hekeretari	hˌekeretˈari
Hema	hˈema
Hipkins	h ˈi p k ˈi n (͡e͡n)ˈɛs(͡m͡i)
Holdings	h ˈɔ (͡e͡n)ˈɛl dˈiː(͡m͡i) ˈi n (͡e͡n)d͡ʒˈiː ˈɛs(͡m͡i)
Hore	hˈɔre
Horoi	hˈɔro͡ɪ
Hudson	h ˈu" (͡e͡n)dˈiː ˈɛs(͡m͡i) ˈɔ n
Hāpara	haːpˈara
Hāpuku	haːpˈu"ku"
Hāriata	hˌaːriˈata
Hēoi	hˈeːo͡ɪ
IT	ˈit
Information	ˈi n (͡e͡n)ˈɛf(͡m͡i) ˈɔ r m ˈa t ˈi ˈɔ n
Invercargill	ˈi n (͡e͡n)vˈiː(͡m͡i) ˈe r (͡e͡n)sˈiː(͡m͡i) ˈa r (͡e͡n)d͡ʒˈiː(͡m͡i) ˈi (͡e͡n)ˈɛl ˈɛl(͡m͡i)
Iron	ˈirɔn
JPS	(͡e͡n)d͡ʒˌe͡ɪ(͡m͡i)p(͡e͡n)ˈɛs(͡m͡i)
Justice	(͡e͡n)d͡ʒˈe͡ɪ(͡m͡i) ˈu" (͡e͡n)ˈɛs(͡m͡i) t ˈi (͡e͡n)sˈiː(͡m͡i) ˈe
Karl	k ˈa r (͡e͡n)ˈɛl(͡m͡i)
Karu	kˈaru"
Katia	katˈia
Kendall	k ˈe n (͡e͡n)dˈiː(͡m͡i) ˈa (͡e͡n)ˈɛl ˈɛl(͡m͡i)
Kereama	kˌereˈama
Kereone	kˌereˈɔne
Kohimarama	kˌɔhimarˈama
Konohi	kɔnˈɔhi
Koohi	kɔˈɔhi
Koroki	kɔrˈɔki
Kuhuna	ku"hˈu"na
Kākāriki	kˌaːkaːrˈiki
Kōwae	kˈɔːwa͡ɪ
La	(͡e͡n)ˈɛl(͡m͡i) ˈa
Lance	(͡e͡n)ˈɛl(͡m͡i) ˈa n (͡e͡n)sˈiː(͡m͡i) ˈe
Lewis	(͡e͡n)ˈɛl(͡m͡i) ˈe w ˈi (͡e͡n)ˈɛs(͡m͡i)
Lily	(͡e͡n)ˈɛl(͡m͡i) ˈi (͡e͡n)ˈɛl wˈa͡ɪ(͡m͡i)
Lizzie	(͡e͡n)ˈɛl(͡m͡i) ˈi (͡e͡n)zˈɛd zˈɛd(͡m͡i) ˈi ˈe
Mahaki	mahˈaki
Manaakitanga	mˌanaˌakitˈaŋa
Management	m ˈa n ˈa (͡e͡n)d͡ʒˈiː(͡m͡i) ˈe m ˈe n t
Manawanui	mˌanawanˈu"i
Mangōroa	mˌaŋɔːrˈɔa
Mapi	mˈapi
Marangaranga	mˌaraŋarˈaŋa
Marine	marˈine
Mason	m ˈa (͡e͡n)ˈɛs(͡m͡i) ˈɔ n
Matatika	mˌatatˈika
Maungatautari	mˌau"ŋˌatau"tˈari
McGregor	m(͡e͡n)sˈiː d͡ʒˈiː(͡m͡i) r ˈe (͡e͡n)d͡ʒˈiː(͡m͡i) ˈɔ r
Menulog	m ˈe n ˈu" (͡e͡n)ˈɛl(͡m͡i) ˈɔ (͡e͡n)d͡ʒˈiː(͡m͡i)
Mereana	mˌereˈana
Milne	m ˈi (͡e͡n)ˈɛl(͡m͡i) n ˈe
Miramar	mirˈamar
Mita	mˈita
Moko	mˈɔkɔ
Moore	mɔˈɔre
Muller	m ˈu" (͡e͡n)ˈɛl ˈɛl(͡m͡i) ˈe r
Murirangawhenua	mˌu"rirˌaŋafenˈu"a
Māia	maːˈia
Neil	n ˈe ˈi (͡e͡n)ˈɛl(͡m͡i)
Newsletter	n ˈe w (͡e͡n)ˈɛs ˈɛl(͡m͡i) ˈe t t ˈe r
Ngaa	ŋˈaa
Ngarimu	ŋarˈimu"
Ngaruawahia	ŋˌaru"ˌawahˈia
Ngātoroirangi	ŋˌaːtɔro͡ɪrˈaŋi
Ngāwai	ŋˈaːwa͡ɪ
Niue	niˈu"e
Nohinohi	nˌɔhinˈɔhi
Nākahi	naːkˈahi
Oct	ˈɔ (͡e͡n)sˈiː(͡m͡i) t
Orion	ɔrˈiɔn
Paerau	pa͡ɪrˈau"
Panoni	panˈɔni
Panuitia	pˌanu"itˈia
Para	pˈara
Parliament	p ˈa r (͡e͡n)ˈɛl(͡m͡i) ˈi ˈa m ˈe n t
Patea	patˈea
Pirīmia	pˌiriːmˈia
Poto	pˈɔtɔ
Pouherenga	pˌou"herˈeŋa
Pourangahua	pˌou"rˌaŋahˈu"a
Professional	p r ˈɔ (͡e͡n)ˈɛf(͡m͡i) ˈe (͡e͡n)ˈɛs ˈɛs(͡m͡i) ˈi ˈɔ n ˈa (͡e͡n)ˈɛl(͡m͡i)
Property	p r ˈɔ p ˈe r t (͡e͡n)wˈa͡ɪ(͡m͡i)
Publications	p ˈu" (͡e͡n)bˈiː ˈɛl(͡m͡i) ˈi (͡e͡n)sˈiː(͡m͡i) ˈa t ˈi ˈɔ n (͡e͡n)ˈɛs(͡m͡i)
Pumi	pˈu"mi
Pārongo	paːrˈɔŋɔ
Pōwhiri	pɔːfˈiri
Queen	(͡e͡n)kjˈuː(͡m͡i) ˈu" ˈe ˈe n
Rachel	r ˈa (͡e͡n)sˈiː(͡m͡i) h ˈe (͡e͡n)ˈɛl(͡m͡i)
Rahoroi	rahˈɔro͡ɪ
Rangihīroa	rˌaŋihiːrˈɔa
Rangimarie	rˌaŋimarˈie
Rangitukia	rˌaŋitu"kˈia
Rangitīkei	rˌaŋitiːkˈei
Rangiuru	rˌaŋiˈu"ru"
Rapa	rˈapa
Raukōkore	rˌau"kɔːkˈɔre
Revere	r ˈe (͡e͡n)vˈiː(͡m͡i) ˈe r ˈe
Ripeka	ripˈeka
Riu	rˈiu"
Ruapekapeka	rˌu"apˌekapˈeka
Ruatāhuna	rˌu"ataːhˈu"na
Rukuhia	rˌu"ku"hˈia
Runga	rˈu"ŋa
Settlements	(͡e͡n)ˈɛs(͡m͡i) ˈe t t (͡e͡n)ˈɛl(͡m͡i) ˈe m ˈe n t (͡e͡n)ˈɛs(͡m͡i)
Sidney	(͡e͡n)ˈɛs(͡m͡i) ˈi (͡e͡n)dˈiː(͡m͡i) n ˈe (͡e͡n)wˈa͡ɪ(͡m͡i)
Spain	(͡e͡n)ˈɛs(͡m͡i) p ˈa ˈi n
Square	(͡e͡n)ˈɛs kjˈuː(͡m͡i) ˈu" ˈa r ˈe
TP	tp
Taiohi	ta͡ɪˈɔhi
Taipa	tˈa͡ɪpa
Tamehana	tˌamehˈana
Tangihanga	tˌaŋihˈaŋa
Tatari	tatˈari
Tekapo	tekˈapɔ
Temara	temˈara
Temi	tˈemi
Thames	t h ˈa m ˈe (͡e͡n)ˈɛs(͡m͡i)
Tinana	tinˈana
Tipa	tˈipa
Tipu	tˈipu"
Tirotiro	tˌirɔtˈirɔ
Tohaina	tɔhˈa͡ɪna
Tohutoro	tˌɔhu"tˈɔrɔ
Toihau	to͡ɪhˈau"
Tokowaru	tˌɔkɔwˈaru"
Tomokanga	tˌɔmɔkˈaŋa
Tribunal	t r ˈi (͡e͡n)bˈiː(͡m͡i) ˈu" n ˈa (͡e͡n)ˈɛl(͡m͡i)
Turanganui	tˌu"raŋanˈu"i
Turangawaewae	tˌu"raŋawˈa͡ɪwa͡ɪ
Tāia	taːˈia
Tōia	tɔːˈia
UK	ˈu"k
Vensa	(͡e͡n)vˈiː(͡m͡i) ˈe n (͡e͡n)ˈɛs(͡m͡i) ˈa
Waahi	waˈahi
Waikare	wa͡ɪkˈare
Waimamaku	wˌa͡ɪmamˈaku"
Waiorua	wˌa͡ɪɔrˈu"a
Wakefield	w ˈa k ˈe (͡e͡n)ˈɛf(͡m͡i) ˈi ˈe (͡e͡n)ˈɛl dˈiː(͡m͡i)
Watson	w ˈa t (͡e͡n)ˈɛs(͡m͡i) ˈɔ n
Whaiaro	fa͡ɪˈarɔ
Whakaingoatia	fˌaka͡ɪŋˌɔatˈia
Whakairia	fˌaka͡ɪrˈia
Whakatauiratia	fˌakatˌau"ˌiratˈia
Whakatauritea	fˌakatˌau"ritˈea
Whakatu	fakˈatu"
Whakaurua	fˌakau"rˈu"a
Wheke	fˈeke
Whenuanui	fˌenu"anˈu"i
Whitireia	fˌitireˈia
Whitu	fˈitu"
Whāngārei	fˌaːŋaːrˈei
Whāngārā	faːŋˈaːraː
Winiata	wˌiniˈata
akitu	akˈitu"
aromatawaitanga	ˌarɔmˌatawa͡ɪtˈaŋa
ati	ˈati
awenga	awˈeŋa
awhitia	ˌafitˈia
ei	ˈei
gallery	(͡e͡n)d͡ʒˈiː(͡m͡i) ˈa (͡e͡n)ˈɛl ˈɛl(͡m͡i) ˈe r (͡e͡n)wˈa͡ɪ(͡m͡i)
hainahia	hˌa͡ɪnahˈia
haumako	hˌau"mˈakɔ
haurongo	hˌau"rˈɔŋɔ
hauropi	hˌau"rˈɔpi
hekeretari	hˌekeretˈari
hoahoatanga	hˌɔahˌɔatˈaŋa
hohoko	hɔhˈɔkɔ
house	h ˈɔ ˈu" (͡e͡n)ˈɛs(͡m͡i) ˈe
huakore	hˌu"akˈɔre
hunuku	hu"nˈu"ku"
hēneti	heːnˈeti
hūmarie	hˌu"ːmarˈie
hūware	hu"ːwˈare
iTunes	ˈi t ˈu" n ˈe (͡e͡n)ˈɛs(͡m͡i)
iana	iˈana
iranga	irˈaŋa
iringa	irˈiŋa
iroiro	irˈo͡ɪrɔ
ito	ˈitɔ
kaikiri	ka͡ɪkˈiri
kaingia	ka͡ɪŋˈia
kaipāho	ka͡ɪpˈaːhɔ
kaitango	ka͡ɪtˈaŋɔ
kaitaunaki	kˌa͡ɪtau"nˈaki
kaituhituhi	kˌa͡ɪtu"hitˈu"hi
kaitukumahi	kˌa͡ɪtu"ku"mˈahi
kani	kˈani
kapia	kapˈia
kapiti	kapˈiti
kapoa	kapˈɔa
kaponga	kapˈɔŋa
kareti	karˈeti
karia	karˈia
katipoo	kˌatipˈɔɔ
kauaka	kˌau"ˈaka
kauta	kaˈu"ta
kg	k(͡e͡n)d͡ʒˈiː(͡m͡i)
kirirarau	kˌirirarˈau"
koeke	kwˈeke
kongakonga	kˌɔŋakˈɔŋa
kono	kˈɔnɔ
koropuku	kˌɔrɔpˈu"ku"
koropupu	kˌɔrɔpˈu"pu"
koru	kˈɔru"
ku	kˈu"
kōhure	kɔːhˈu"re
kōkiritanga	kˌɔːkiritˈaŋa
kōkōwai	kɔːkˈɔːwa͡ɪ
kōnui	kɔːnˈu"i
kōtahi	kɔːtˈahi
maamaa	mˌaamˈaa
mahimahi	mˌahimˈahi
mahingia	mˌahiŋˈia
maihea	ma͡ɪhˈea
manaia	manˈa͡ɪa
manomanotia	mˌanɔmˌanɔtˈia
marathon	marˈathɔn
mariko	marˈikɔ
matapakia	mˌatapakˈia
matapakihia	mˌatapˌakihˈia
mataurangamaori	mˌataˌu"raŋamˈa͡ʊri
match	m ˈa t (͡e͡n)sˈiː(͡m͡i) h
maumaharatanga	mˌau"mˌaharatˈaŋa
miere	miˈere
mitia	mitˈia
mohe	mˈɔhe
mokowhiti	mˌɔkɔfˈiti
motocyclist	m ˈɔ t ˈɔ (͡e͡n)sˈiː wˈa͡ɪ sˈiː ˈɛl(͡m͡i) ˈi (͡e͡n)ˈɛs(͡m͡i) t
märama	marˈama
māhana	maːhˈana
ngangahu	ŋaŋˈahu"
ngangare	ŋaŋˈare
ngangau	ŋaŋˈau"
ngaringari	ŋˌariŋˈari
ngeetehi	ŋˌeetˈehi
ngote	ŋˈɔte
ngoto	ŋˈɔtɔ
ngāhau	ŋaːhˈau"
ngō	ŋˈɔː
noo	nˈɔɔ
oha	ˈɔha
paiheneti	pˌa͡ɪhenˈeti
paina	pˈa͡ɪna
pakitau	pˌakitˈau"
pakoko	pakˈɔkɔ
papaka	papˈaka
papaku	papˈaku"
papatau	pˌapatˈau"
parakatihi	pˌarakatˈihi
pehia	pehˈia
pekepeke	pˌekepˈeke
penihana	pˌenihˈana
piana	piˈana
pine	pˈine
pokapu	pɔkˈapu"
pokepoke	pˌɔkepˈɔke
poroa	pɔrˈɔa
porohe	pɔrˈɔhe
porotaka	pˌɔrɔtˈaka
project	p r ˈɔ (͡e͡n)d͡ʒˈe͡ɪ(͡m͡i) ˈe (͡e͡n)sˈiː(͡m͡i) t
pukohu	pu"kˈɔhu"
pukuhohe	pˌu"ku"hˈɔhe
pumanawa	pˌu"manˈawa
punanga	pu"nˈaŋa
pungapunga	pˌu"ŋapˈu"ŋa
pura	pˈu"ra
purenga	pu"rˈeŋa
purotu	pu"rˈɔtu"
purutia	pˌu"ru"tˈia
pütea	pu"tˈea
pāka	pˈaːka
pātahi	paːtˈahi
pērātia	pˌeːraːtˈia
pīataata	pˌiːataˈata
pōraruraru	pˌɔːraru"rˈaru"
pūmahara	pˌu"ːmahˈara
rangapū	raŋˈapu"ː
raumata	rˌau"mˈata
raurau	rˌau"rˈau"
raurēkau	rˌau"reːkˈau"
rautō	raˈu"tɔː
reia	reˈia
rengarenga	rˌeŋarˈeŋa
rongona	rɔŋˈɔna
rore	rˈɔre
rīpeka	riːpˈeka
rōpere	rɔːpˈere
students	(͡e͡n)ˈɛs(͡m͡i) t ˈu" (͡e͡n)dˈiː(͡m͡i) ˈe n t (͡e͡n)ˈɛs(͡m͡i)
taera	tˈa͡ɪra
tahanga	tahˈaŋa
tahere	tahˈere
tahuti	tahˈu"ti
taitai	tˈa͡ɪta͡ɪ
taituarā	tˌa͡ɪtu"ˈaraː
takakau	tˌakakˈau"
takatakahi	tˌakatakˈahi
takupu	takˈu"pu"
taotu	tˈa͡ʊtu"
tapiritia	tˌapiritˈia
tapā	tˈapaː
tarewa	tarˈewa
taumanu	tˌau"mˈanu"
taumarumaru	tˌau"mˌaru"mˈaru"
tauraro	tˌau"rˈarɔ
tautitotito	tˌau"tˌitɔtˈitɔ
tauwhitiwhitinga	tˌau"fˌitifitˈiŋa
tewhatewha	tˌefatˈefa
tiimata	tˌiimˈata
tiko	tˈikɔ
toheroa	tˌɔherˈɔa
topa	tˈɔpa
tukupara	tˌu"ku"pˈara
tumeke	tu"mˈeke
tupuranga	tˌu"pu"rˈaŋa
tāpiripiri	tˌaːpiripˈiri
tētē	tˈeːteː
tūhonoa	tˌu"ːhɔnˈɔa
tūtei	tu"ːtˈei
tūtuki	tu"ːtˈu"ki
tūturutanga	tˌu"ːtu"ru"tˈaŋa
ukauka	ˌu"kaˈu"ka
waahana	wˌaahˈana
waerehe	wa͡ɪrˈehe
waihonga	wa͡ɪhˈɔŋa
wairākau	wˌa͡ɪraːkˈau"
wanawana	wˌanawˈana
wawatatia	wˌawatatˈia
we	wˈe
weroa	werˈɔa
wetereo	wˌeterˈeɔ
whaihanga	fa͡ɪhˈaŋa
whaiāipo	fˌa͡ɪaːˈipɔ
whakahautia	fˌakahˌau"tˈia
whakahere	fˌakahˈere
whakahiki	fˌakahˈiki
whakairinga	fˌaka͡ɪrˈiŋa
whakamaoritanga	fˌakamˌa͡ʊritˈaŋa
whakamauru	fˌakamaˈu"ru"
whakamātūtū	fˌakamaːtˈu"ːtu"ː
whakamōmona	fˌakamɔːmˈɔna
whakapakaritia	fˌakapˌakaritˈia
whakapoke	fˌakapˈɔke
whakapumau	fˌakapu"mˈau"
whakapāha	fˌakapˈaːha
whakapūmautanga	fˌakapˌu"ːmau"tˈaŋa
whakarerekēngia	fˌakarˌerekeːŋˈia
whakarākai	fˌakarˈaːka͡ɪ
whakatapu	fˌakatˈapu"
whakatapua	fˌakatapˈu"a
whakatenetene	fˌakatˌenetˈene
whakatepe	fˌakatˈepe
whakaterea	fˌakaterˈea
whakatewhatewha	fˌakatˌefatˈefa
whakatūpatotanga	fˌakatˌu"ːpatɔtˈaŋa
whakatūranga	fˌakatu"ːrˈaŋa
whakawaia	fˌakawˈa͡ɪa
whakawehenga	fˌakawehˈeŋa
whakawhāitihia	fˌakafˌaːitihˈia
whakawākia	fˌakawaːkˈia
whakawāngia	fˌakawaːŋˈia
whanautanga	fˌanau"tˈaŋa
wharepukapuka	fˌarepˌu"kapˈu"ka
whika	fˈika
wiriwiri	wˌiriwˈiri
world	w ˈɔ r (͡e͡n)ˈɛl dˈiː(͡m͡i)
wākena	waːkˈena
wānangatia	wˌaːnaŋatˈia
ô	(͡e͡n)ˌə͡ʊsˈɜːkəmflˌɛks(͡m͡i)
Ānō	ˈaːnɔː
āhuarangi	ˌaːhu"arˈaŋi
ākene	aːkˈene
āmati	aːmˈati
āraitia	ˌaːra͡ɪtˈia
īmera	iːmˈera
Ōhinemutu	ˌɔːhinemˈu"tu"
