lyfta	lɪʰta
trøll	tʰɹœtl
sýning	sʊiːnɪŋk
lampa	lam̥pa
atli	aʰtlɪ
dimmbrúnur	tɪmːpɹʉuːnʊr
samkyndur	sam̥t͡ʃɪntʊɹ
fulkubbi	fʊl̥kʊpːɪ
ungari	ʊŋkaɹɪ
gass	kasː
torg	tʰɔɹk
síga	sʊiːja
visundur	visʊntʊɹ
tóm	tʰɔuːn
krúna	kɹʉuːna
einkjumaður	ɔiɲ̊t͡ʃːʊmɛaːvʊɹ
búgvi	bɪɡvi
firði	fiːɹɪ
hiplingur	hɪʰplɪŋkʊɹ
horur	hoːɹʊɹ
hvørkikyn	kfœɹ̥tʃɪtʃʰiːn
tjøra	tʲʰøːɹa
róm	ɹouːm
mær	mɛaːɹ
sandur	santʊɹ
h	h
kengura	kʰɛŋkuːɹa
krím	kɹʊiːjm
tunna	tʰʊnːa
spaði	spɛaːjɪ
viðgerð	vit͡ʃːeːɹ
ári	ɔɑːɹɪ
kunta	kʰʊn̥ta
eli	eːliː
smiðja	smiːja
góðska	kœska
piparrót	pʰiːpaɹœuːt
napoleon	napʰoːlɪɔn
boara	poːaɹa
dádýr	tɔɑːtʊiːɹ
pund	pʰʊnt
pávi	pʰɔɑːvɪ
veitsla	vaiːʃla
minuttur	minʊtːʊɹ
familja	famɪlja
jú	jʉuːw
keks	kʰɛʰks
býur	pʊiːjʊɹ
grátur	krɔɑːʰtʊɹ
skinfluga	ʃɪn̥fluːa
tjóðverji	tʃʰɔuːwvɛɹjɪ
nátan	nɔɑːʰtan
mangur	mɛŋkʊɹ
fullur	fʊtlʊɹ
plantur	plan̥tʊɹ
k	kʰ
jeppur	jɛʰpːʊɹ
ræ	rɛaː
ólavur	ɔuːlavʊɹ
frøði	fɾøːjɪ
leikføri	laiːkføːɹɪ
sunniva	sʊnːɪva
kirkja	t͡ʃʰɪr̥t͡ʃa
vetrartíð	veːtɹaɹtʰʊiːj
tøkk	tʰœʰkː
havur	hɛaːvʊɹ
ge	keː
melón	melɔoːn
bál	pɔɑːl
veðrakjøt	vɛkɹatʃʰøːʰt
gulur	kuːlʊɹ
rukka	ɹʊʰkːa
dós	tɔuːs
ont	ɔn̥t
garður	kɛaːɹʊɹ
tól	tʰɔuːl
drunnhvíti	tɹʊnːkvʊiːtɪ
dollari	tɔlːaɹɪ
gjógv	tʃɔɑːjɪr
mjødn	mjœtn
vín	vʊiːn
meðan	meːan
baka	pɛaːʰka
stigbending	stiːpɛntɪŋk
pannukøka	pʰanːʊkʰøːʰka
breiður	pɹaijʊɹ
hurð	huːɹ
sveisari	svaisarɪ
turkmenistan	tʰʊɹ̥kmeːnɪstan
altar	al̥taɹ
havið	hɛaːvɪ
frøðingur	fɹøːjɪnkʊɹ
fýlum	fʊiːlʊn
selma	sɛlma
torleivur	tʰɔɹlaiːvʊɹ
greypfrukt	kɾɛiːpfɾʊʰkt
síða	sʊiːja
valborgarmessa	valpɔɹkaɹmɛsːa
klipp	kʰlɪʰpː
umskera	ʊmʃeːɹa
mistilteinur	mɪstɪltʰaiːnʊɹ
pungur	pʰuŋkʊɹ
petti	pʰɛʰtːɪ
bryggja	pɾɪt͡ʃːa
ok	oːʰk
bidna	pɪtnːa
plantuolja	plan̥tʊɔlja
spann	spanː
hákallur	hɔɑːkatlʊɹ
benin	peniːn
kettu	t͡ʃʰɛʰtːʊ
ragnheiður	ɹaknhaiːjʊɹ
jarma	jaɹma
nudla	nʊtla
skipari	ʃiːpaɹɪ
andlát	anlɔɑːʰt
plumba	pʰlʊmpa
satt	saʰtː
stavur	stɛaːvʊɹ
bast	past
arnar	aɻɳaɹ
blýggj	plʊt͡ʃː
biva	piːva
sálva	sɔlva
fani	fɛaːnɪ
eyðkvæmi	ɛʰkːvɛaːmɪ
alisfrøði	ɛaːlɪsfɾøːjɪ
skemtiteknari	ʃɛm̥tɪtʰɛknaɹɪ
knútur	kʰnʉuːtʊɹ
sáð	sɔɑː
likka	lɪʰkːa
kuffert	kʰʊfːɛɹ̥ʈ
sú	sʉuː
svar	svɛaːɹ
sjokuláta	ʃoːʰkʊlɔɑːʰta
fønari	føːnaɹɪ
tjørnuvíkingur	tʃʰœtnuvɪʃɪnkʊɹ
fossar	fɔsːaɹ
ata	ɛaːʰta
skøta	skøːʰta
súla	sʉuːla
reyðkollur	ɹɛiːjkʰɔtlʊɹ
búi	pʉuːwɪ
trúbót	tʰɹʉuːwpɔuːt
kjadd	tʃʰatː
kelda	tʃʰɛlta
dóttir	tœʰtːɪɹ
nevna	nɛvna
mjúkur	mjʉuːkʊɹ
handski	han̥ːʃɪ
kjølur	t͡ʃʰøːlʊɹ
edikur	eːtɪʰkːʊɹ
flugusoppur	fluːʊsɔʰpːʊɹ
floti	floːʰtɪ
dagur	tɛaːvʊɹ
brekka	pɾɛʰkːa
t	tʰ
finnland	fɪnːlant
grótbræðing	kɾɔuːtpɾɛaːjɪŋk
langavi	lɛŋkɛaːvɪ
goti	koːʰtɪ
klæði	kʰlɛaːjɪ
eystur	ɛstʊɹ
otur	oːʰtʊɹ
hælur	hɛaːlʊɹ
varð	vɛaːɹ
hørpa	hœɹ̥pa
ekki	ɛʰt͡ʃːɪ
upplýsing	ʊʰplʊiːjsiŋk
skel	ʃeːl
kýr	kʰʊiːjr
eygnaviðgerð	ɛknavit͡ʃːeːɹ
standmynd	stantmɪnt
árni	ɔdnɪ
teisti	tʰaiːstɪ
a	ɛaː
dómur	tɔuːmʊɹ
tarmur	tʰaɹmʊɹ
mjólkarsukur	mjœl̥kaɹsuːkʊɹ
trýsta	tɾʊiːʃta
hattvíkingur	haʰtːɪʃɪŋkʊɹ
fitisýra	fiːtɪsʊiːɹa
gjósa	t͡ʃɔuːsa
svangur	svɛŋkʊɹ
sjeikur	ʃaiːkʊɹ
tík	tʰʊiːjk
ættir	aʰtːɪɹ
øvundsjúkur	øːvʊnʃʉuːkʊɹ
lag	lɛaː
pakistan	pʰaʰkistan
tó	tʰouː
keypmannahavn	tʃʰɛʰpmanːahavn
jallur	jatlʊɹ
hjørð	jøːɹ
tónleikari	tʰɔuːnlaikaɹɪ
genta	t͡ʃɛn̥ta
slektbólkur	slɛʰktpœl̥kʊɹ
landslag	lanslɛaː
einkja	ɔiɲ̊t͡ʃːa
fjara	fjɛaːɹa
drúva	tɾʉuːva
pera	pʰeːɹa
geit	kaiːt
dagný	taknʊiː
kanning	kʰanːɪŋk
maður	mɛaːvʊɹ
heiðarýpa	haiːjaɹʊiːpa
týðari	tʰʊiːjaɹɪ
kavi	kʰɛaːvɪ
ja	jɛaː
pætursmessa	pʰɛaːtʊʂmɛsːa
list	lɪst
kasta	kʰasta
ormum	ɔɹmʊn
talorð	tʰɛaːloːɹ
kvennkyn	kfɛn̥ːtʃʰiːn
njálur	nʲɔɑːlʊɹ
horn	hɔtn
tog	tʰoː
fluga	fluːwʊ
bjóða	pjɔuːwa
l	l
kólna	kʰœlna
fýla	fʊiːla
hora	hoːɹa
trý	tɾʊiː
lundi	lʊntɪ
ungarskur	ʊŋkaʂkʊɹ
oddbjørn	ɔtpjœtn
floyta	flɔiːjta
ferðagjald	feːɹatʃalt
eftir	ɛʰtːɪɹ
mestur	mɛstʊɹ
siga	siːja
kraft	kɹaft
munum	muːnʊn
sigarett	sikaɹɛʰtː
standa	stanta
epli	eːʰplɪ
skorsteinur	skɔʂstaiːnʊɹ
babbað	papːa
tóm	tʰɔuːm
rái	ɹɔɑːjɪ
jonn	jɔnː
aprikosa	apɹikoːsa
gongur	kɔŋkʊɹ
flysa	fliːsa
oyðin	ɔiːjɪn
fólk	fœl̥k
krakkur	kɹaʰkːʊɹ
stórur	stɔuːɹʊɹ
kallkyn	kʰal̥tʃʰiːn
undirætt	ʊntɪɹaʰtː
smiður	smiːjʊɹ
kalkun	kʰal̥kʰuːn
perutræ	pʰeɛːɹʊtɹɛaː
øðuskel	øːvʊʃeːl
eimur	aiːmʊɹ
fuglfirðingur	fʊl̥fɪɹɪŋkʊɹ
banki	paɲ̊t͡ʃɪ
skák	skɔɑːʰk
soppur	sɔʰpːʊɹ
kvøða	kvøːa
flogvøllur	floːvœtlʊɹ
duga	tuːwa
ala	ɛaːla
múrur	mʉuːɹʊɹ
frysta	fɾɪsta
krógv	kʰɾɛkv
samband	sampant
økja	øːʰtʃa
føroyskt	føːɹɪst
krúpa	kʰɹʉuːpa
systir	sɪstɪɹ
gangi	kɛɲt͡ʃɪ
sátan	sɔɑːʰtan
agað	ɛːa
hatur	hɛaːʰtʊɹ
krossur	kʰɹɔsːʊɹ
bratsj	pɾaʰt͡ʃː
forhúð	fɔɹhʉuː
venjingardystur	vɛnjɪŋkaɹtɪstʊɹ
nørdur	nœɻʈʊɹ
vinur	viːnʊɹ
grønlendskt	kɾœnlɛŋ̊kst
hest	hɛst
berjalyngur	pɛɹjalɪŋkʊɹ
deyvur	tɛiːvʊɹ
ari	ɛaːɹɪ
kvirra	kvɪɹːa
vetrarbreyt	veːʰtɹaɹpɾɛiːt
havørn	hɛaːvœɻɳ
oksi	ɔʰksɪ
runnur	ɹʊnːʊɹ
kjøra	t͡ʃʰøːɹa
sigfríður	sɪkfɾʊiːjʊɹ
starv	starv
tari	tʰɛaːɹɪ
ást	ɔst
sveinur	svaiːnʊɹ
hamara	hɛaːmaɹa
vitur	viːtʊɹ
ættum	aʰtːʊn
lýri	lʊiːɹɪ
dimmbláur	tɪmːplɔaːwʊɹ
mætur	mɛaːʰtʊɹ
leggur	lɛkːʊɹ
mýrisnípa	mʊiːɹɪsnʊiːpa
sálarmessa	sɔaːlaɹmɛsːa
vakt	vaʰkt
toy	tʰœiː
kjarni	tʃʰatnɪ
høvn	hœvn
kór	kʰɔuːɹ
fótbóltsvøllur	fɔuːtpœl̥tsvœtlʊɹ
asni	asnɪ
eiður	aiːjʊɹ
árið	ɔɑːɹɪ
páll	pʰɔtl
dimmreyður	tɪmːɹɛiːjʊɹ
neyt	nɛiːt
setningur	sɛtnɪŋkʊɹ
skriva	skɾiːva
yvirhópur	iːvɪɹhɔuːpʊɹ
sild	sɪlt
ríki	ɹʊiːtʃɪ
bláur	plɔɑːvʊɹ
bævur	pɛaːvʊɹ
münchen	mʏn̥ʃɛn
ítróttur	ʊitɹœʰtːʊɹ
sekki	sɛʰt͡ʃːɪ
mer	meːɹ
kúnum	kʰʉunːʊn
týrur	tʰʊiːjɹʊɹ
skjól	ʃɔuːl
neyvleiki	nɛiːvlaiːʰt͡ʃɪ
fár	fɔaːɹ
skúm	skʉuːm
motta	mɔʰtːa
veit	vaiːt
kræklingur	kɹɛaːklɪŋkʊɹ
hjún	tʃʰʉuːn
sverri	svɛɹːɪ
sorg	sɔɹk
ráð	ɹɔɑː
skeið	skaiːj
yngd	ɪŋkt
kusa	kʰuːsa
kort	kʰɔɻ̊ʈ
fall	fatl
lyngur	lɪŋkʊɹ
harpa	haɹ̥pa
fyrisetingarorð	fiːɹɪsetɪŋkaɹoːɹ
tættur	tʰaʰtːʊɹ
rókur	ɹɔuːkʊɹ
íbúgvi	ʊipɪkvɪ
fylgja	fɪʎtʃa
vandi	vantɪ
granni	kɾanːɪ
ásbjørn	ɔspjœtn
r	ɹ
hús	hʉuːs
koyta	kʰɔita
eygnalækni	ɛknalahknɪ
gingu	t͡ʃɪŋkʊ
vára	vɔaːɹa
skipa	ʃiːpa
saltsýra	sal̥tsʊiːɹa
ragnarøk	ɹaknaɹøːʰk
gull	kʊtl
køttur	kʰœʰtːʊɹ
fata	fɛaːʰta
stjørnufrøði	ʃœtnʊfrøːjɪ
skaði	skɛaːjɪ
føri	føːɹɪ
fjør	fjøːɹ
sett	sɛʰtː
leiftur	laʰktʊɹ
ulka	ʊl̥ka
rann	ranː
vjetnam	vjɛʰtnam
degnum	tɛknʊn
dýsa	tʊiːsa
mágur	mɔaːvʊɹ
gudfrøði	kʊfːɾøːjɪ
regin	ɹeːjɪn
kvið	kfiːj
stubbi	stʊpːɪ
illur	ɪtlʊɹ
do	toː
bjørn	pjœtn
vínber	vʊinpeɛːɹ
sjúrður	ʃʉuːɹʊɹ
gingið	t͡ʃɪɲt͡ʃɪ
kommuna	kʰɔmuːna
brundur	pɾʊntʊɹ
sámi	sɔɑːmɪ
líggja	lʊɪt͡ʃːa
vavv	vavː
verkstaður	vɛɹ̥kstɛaːvʊɹ
vinalag	viːnalɛa
hond	hɔnt
ý	ʊiː
eysturoy	ɛstʊrɔiː
kyndilsmessa	tʃʰɪntɪlsmɛsːa
fjørður	fjøːɹʊɹ
bergur	pɛɹkʊɹ
hvønn	kfœnː
skjøldur	ʃœltʊɹ
tøknifrøði	tʰœʰknɪfrøːjɪ
rødd	ɹœtː
alga	alka
grindahvalur	krɪntakʰvɛaːlʊɹ
jarn	jatn
miðøld	miːœlt
áttu	ɔʰtːʊ
ertnasúpan	ɛɻ̊tɳasʉuːpan
álvheiður	ɔlvhaiːjʊɹ
gervi	tʃɛɹvɪ
sætt	saʰtː
gáta	kɔɑːta
kráka	kʰɾɔɑːʰka
trúgva	tɹɪkva
rópa	ɹɔuːpa
grikki	kɾɪʰt͡ʃːɪ
skál	skɔɑːl
so	soː
hvæl	kvɛaːl
skúvoyingur	skʉuːvɪŋkʊɹ
neyst	nɛst
knettasúpan	kʰnɛʰtːasʉuːwpan
álvaratos	ɔlvaratʰoːs
fitna	fɪʰtna
russland	ɹʊsːlant
tummasmessa	tʰʊmːasmɛsːa
fjós	fjɔus
jólamaður	jɔuːlamɛaːvʊɹ
eyga	ɛiːja
greivi	kraiːvɪ
romi	ɹoːmɪ
krókur	kʰɾɔuːkʊɹ
sjúkur	ʃʉuːkʊɹ
hjalti	jal̥tɪ
verð	veːɹ
talvfólk	tʰalfœl̥k
g	k
monika	moːnɪka
s	s
jennur	jɛnːʊɹ
venjing	vɛnjɪŋk
ernst	ɛɻɳst
karin	kʰɛaːɹɪn
staður	stɛaːvʊɹ
vær	vɛaːɹ
inda	ɪnta
húgva	hɪkva
muskattnøt	muskaʰtːnøːʰt
leyv	lɛiːv
fýrikur	fʊiːɹɪkʊɹ
hara	hɛaːɹa
lína	lʊiːna
spennandi	spɛnːantɪ
sagnorð	saknoːɹ
onnu	ɔnːʊ
landslið	lansliːj
fríður	fɹʊiːjʊɹ
seiður	saiːjʊɹ
orði	oːɹɪ
stór	stɔuːɹ
váttur	vɔʰtːʊɹ
ask	ask
lógvi	lɛkvɪ
verji	vɛɹjɪ
torbergur	tʰɔɹpɛɹkʊɹ
verða	veːɹa
gosoyggj	ɡoːsɔit͡ʃː
lægd	lakt
iran	iːɹan
kvæði	kvɛaːjɪ
ingimundur	ɪɲt͡ʃɪmʊntʊɹ
áki	ɔɑːʰt͡ʃɪ
ryta	ɹiːta
baksturvøra	paʰkstʊɹvøːɹa
teldupostur	tʰɛltʊpʰɔstʊɹ
lyfta	lɪfta
lords	lɔɻʈs
ivi	iːvɪ
v	v
sakaris	sɛaːʰkaɹɪs
pílatræ	pʰʊiːlatʰɾɛaː
koppur	kʰɔʰpːʊɹ
støða	støːva
upphædd	ʊʰpːhatː
met	meːʰt
bei	paiːj
puma	pʰuːma
middagur	mɪtːɛaːvʊɹ
strutsur	stɹʊsːʊɹ
lág	lɔɑː
turriklæði	tʰʊɹːɪklɛaːjɪ
fiskari	fɪskarɪ
váð	vɔɑː
ið	ʊiːj
valdmikil	vaɬmiːt͡ʃɪl
nøt	nøːʰt
hørur	høːɹʊɹ
týdningarmikil	tʰʊitnɪŋkaɹmiːt͡ʃɪl
ferðsla	fɛʂla
soð	soː
knøttur	kʰnœʰtːʊɹ
storkur	stɔɹ̥kʊɹ
lík	lʊiːjk
tjøra	t͡ʃʰøːɹa
vindur	vɪntʊɹ
d	t
ørmum	œɹmʊn
bjarti	bjaɻ̊ʈɪ
dýrd	tʊiɹt
munnum	mʊnːʊn
teppi	tʰɛʰpːɪ
húni	hʉuːnɪ
ísur	ʊiːsʊɹ
hvønn	kvœnː
trúgv	tʰɹɪkv
knútur	knʉuːtʊɹ
strutsur	stɹʊtsʊɹ
geil	kaiːl
niðurlond	niːjʊɹlɔnd̥
kunoyingur	kʰuːnɪŋkʊɹ
vón	vɔuːn
aksal	aʰksal
gunnar	kʊnːaɹ
flesk	flɛsk
nikka	nɪʰkːa
sigar	sikaːɹ
skalv	skalv
soviposi	soːvɪpʰoːsɪ
ú	ʉuː
fossi	fɔsːɪ
ysta	ɪsta
lansa	lan̥sa
múr	mʉuːɹ
kukka	kʰʊʰkːa
ljósstyrki	ljɔusːtɪɻ̊t͡ʃɪ
hittittiskur	hɪʰtːɪʰtɪskʊɹ
jodd	jɔtː
mangan	mɛŋkan
arnbjørn	aɻɳpjœtn
tøka	tʰøːʰka
arnheiður	aɻɳhaiːjʊɹ
er	eːɹ
kassi	kasːɪ
hvassur	kvasːʊɹ
leita	laiːta
vesi	veːsɪ
kiribati	kiɹipɑːti
knappaborð	kʰnaʰpːapoːɹ
orangutang	oɹaŋkʊtaŋk
skegg	ʃɛkː
vatn	vaʰtn
pláss	plɔsː
null	nʊlː
sápa	sɔɑːʰpa
kjarnasýra	t͡ʃʰatnasʊiːɹa
bakarí	pɛaːʰkaɹʊi
varúlvur	vɛaːɹʏlvʊɹ
kviður	kfiːjʊɹ
india	ɪntia
ásmundur	ɔsmʊntʊɹ
sýra	sʊiːɹa
kokusnøt	kʰoːʰkʊsnøːʰt
finnur	fɪnːʊr
júgur	jʉuːwʊɹ
márur	mɔɑːɹʊɹ
orkuframleiðsla	ɔɻ̥kʊfɹanlaiʃla
hársápa	hɔʂɔɑːʰpa
ær	ɛaːɹ
astma	asma
sjórænari	ʃɔuɹɛaːnaɹɪ
søtt	sœʰtː
jarðnøt	jaɹnœʰt
kirsuber	t͡ʃʰɪɻ̊ʂʊpeːɹ
stórum	stɔuːɹʊn
skúvoy	skʉuːvɪ
systkin	sɪst͡ʃʰɪn
didda	tɪtːa
fura	fuːɹa
bending	pɛntɪŋk
heimta	haim̥ta
ævi	ɛaːvɪ
bylgja	pɪʎt͡ʃa
teitur	tʰaiːtʊɹ
klára	klɔɑːɹa
blá	plɔɑː
ert	ɛɻ̊ʈ
eingilsmaður	ɔiɲtʃɪlsmɛaːvʊɹ
birgir	bɪrdʒɪr
ljósur	ljɔuːsʊɹ
prógv	pɾɛkv
abbabarn	apːapatn
fjøður	fjɛaːɹaɹ
teldubræv	tʰɛltʊpɹɛaːv
eg	eː
torn	tʰɔɻɳ
gangið	kɛɲt͡ʃɪ
telefon	tʰelefoːn
longa	lɔŋka
eigi	aiːjɪ
varði	vɛaːɹɪ
stjóri	stjɔuːɹɪ
hegri	hɛkɹɪ
pasta	pʰasta
seg	seː
tjørn	cʰœtn
nýsæland	nʊiːjsɛaːlant
gaffil	kafːɪl
kot	kʰoːʰt
kríggj	kɹʊitʃ
tanki	tʰɛɲ̊tʃɪ
stokkhólmur	stɔʰkhœlmʊɹ
krossfiskur	kɹɔsːfɪskʊɹ
vákn	vɔʰkn
kikari	t͡ʃʰiːkaɹɪ
æsa	ɛaːsa
lá	lɔɑː
fornur	fɔtnʊɹ
bróstmøði	pɹœstmøːjɪ
heiðra	haira
brenna	pɾɛnːa
hjúpa	t͡ʃʰʉuːpa
hav	hɛaːv
gágguskel	kɔkːʊʃeːl
svølta	svœl̥ta
høvur	høːvʊɹ
geykur	t͡ʃɛiːkʊɹ
arinbjørn	ɛaːɹɪnpjœtn
morð	moːɹ
lógvi	lɛkfɪ
steinbítur	staiːnpʊiːtʊɹ
hjallur	t͡ʃʰatlʊɹ
núgv	nɪkf
bløða	pløːa
hvalur	kʰvɛaːlʊɹ
rá	ɹɔɑː
torpur	tʰɔɹ̥pʊɹ
krypil	kɾiːpɪl
ross	ɹɔsː
grundøki	kɹʊntøːʰtʃɪ
páskir	pʰɔʃːɪɹ
spark	spaɹ̥k
sum	sʊmː
trýggj	tɾʊit͡ʃː
gøtuskeggi	køːʰtʊʃɛt͡ʃːɪ
djúpur	t͡ʃʉuːpʊɹ
doyggja	tɔt͡ʃːa
terna	tʰɛtna
spurt	spʊɻ̊ʈ
vágur	vɔɑːvʊɹ
gleði	kleːjɪ
umsókn	ʊmsœʰkn
degnum	teːnʊn
tjóðhátíð	tʃʰɔuːwhɔɑːtʰʊiːj
sýria	sʊiːɹija
punktum	pʊŋktʊm
dansur	tansʊɹ
tannlækni	tʰanːlaʰknɪ
bera	peːɹa
greipa	kɹaiːpa
árnfirðingur	ɔn̥fɪɹɪŋɡʊɹ
um	ʊmː
miði	miːjɪ
køliskáp	kʰølɪskɔɑːʰp
læmingi	lɛaːmɪɲt͡ʃɪ
hildur	hɪltʊɹ
kambur	kʰampʊɹ
gísli	kʊiʃlɪ
toft	tʰɔft
ermi	ɛɹmɪ
gera	t͡ʃeːɹa
bunki	pʊɲ̊t͡ʃɪ
leiftur	laiʰtːʊɹ
ahorn	ahɔɻɳ
løgfrøði	lœkfɾøːjɪ
fimti	fɪm̥tɪ
samur	sɛaːmʊɹ
gras	kɹɛaːs
spin	spiːn
farmaskip	faɹmaʃiːp
súpanarskeið	sʉuːpanaɹskaiːj
pípa	pʰʊiːpa
vikuskifti	viːkʊʃɪftɪ
skeppa	ʃɛʰpːa
b	p
læa	le̞ːa
verkur	vɛɹ̥kʊɹ
tak	tʰɛaːʰk
mandla	manla
fám	fɔɑːm
føroyingur	føːɹɪŋkʊɹ
mars	maʂː
glymja	klɪmja
njál	nʲɔɑːl
alda	alta
mat	mɛaːt
veggur	vɛkːʊɹ
sátt	sɔʰtː
neon	neːɔn
froskmansbúni	frɔskmanspʉuːnɪ
tvist	tvɪst
spermur	spɛɹmʊɹ
moska	mɔska
hol	hoːl
milt	mɪl̥t
æður	eːʊɹ
kvið	kʰviːj
vøllur	vœtlʊɹ
stuðul	stuːwʊl
sámal	sɔaːmal
tonga	tʰɔŋka
nei	naiː
rita	ɹiːta
fílur	fʊiːlʊɹ
eyðolvur	ɛiːjɔlvʊɹ
bilur	piːlʊɹ
herðar	heːɹaɹ
angola	aŋkoːla
kenna	t͡ʃʰɛnːa
hampur	ham̥pʊɹ
gil	t͡ʃiːl
namibia	namiːpia
hundur	hʊntʊɹ
skarð	skɛaːɹ
salmiakk	salmiaʰkː
hvørsfall	kvœʂfatl
ótálmaður	œuːtɔlmavʊɹ̥
hagi	hɛaːjɪ
vika	viːka
tváa	tʰvɔːa
nógvur	nɛkvʊɹ
lóg	lɔuːw
stjóri	ʃɔuːɹɪ
rógvi	ɹɛkvɪ
kúbein	kʰʉuːwpaiːjn
urt	ʊɻ̊ʈ
væringi	vɛaːɹɪɲt͡ʃɪ
bispur	pɪspʊɹ
blý	plʊiː
kykna	t͡ʃʰɪʰkna
árstíð	ɔʂːtʰʊiːj
kirna	t͡ʃɪtna
myrra	mɪɹːa
sanna	sanːa
morgnar	mɔtnaɹ
gágga	kɔkːa
høgguslokkur	hœkːslɔʰkːʊɹ
giraffur	t͡ʃiɹafːʊɹ
ægir	ɛaːjɪr
ungi	ʊɲt͡ʃɪ
kvøða	kvøːva
tummi	tʰʊmːɪ
høsn	hœsn
spurvur	spʊɹvʊɹ
fræ	fɹɛaː
pínslarváttur	pʰʊiːn̥slaɺvɔʰtːʊɹ
te	tʰeː
hár	hɔaːɹ
gvagg	kvakː
ólukka	ɔuːlʊʰkːa
fostur	fɔstʊɹ
apaldur	ɛaːʰpaltʊɹ
rokkur	ɹɔʰkːʊɹ
dýpd	tʊipt
vøka	vøːʰka
langskip	lɛŋkʃiːp
ungarn	ʊŋkaɻɳ
álvur	ɔlvʊɹ
j	j
kaðal	ke̞ːal
valnøt	valnøːʰt
speki	speːʰt͡ʃɪ
føða	føːa
nev	neːv
skeyt	ʃɛiːt
nálatræ	nɔɑːlatɹɛaː
jólakort	jɔuːlakʰɔɹ̥ʈ
mamma	mamːa
tora	tʰoːɹa
talsmaður	tʰalsmɛaːvʊɹ
jakslur	jakslʊɹ
mánaður	mɔɑːnavʊɹ
høggormur	hœkːɔɹmʊɹ
sálarfrøði	sɔaːlaɹfɹøːjɪ
hind	hɪnt
møttul	mœʰtːʊl
sikiloy	siːt͡ʃɪlɔiːj
líkur	lʊiːkʊɹ
dag	tɛaː
køka	kʰøːʰka
sá	sɔɑː
gildi	tʃɪldɪ
lás	lɔɑːs
hin	hiːn
júgv	jɪkf
tollaksmessa	tʰɔtlaksmɛsːa
fátækur	fɔɑːtʰɛaːʰkʊɹ
gotland	kɔːʰtlant
plantuslag	plan̥tʊslɛaː
illa	ɪtla
jaga	jeːa
øki	øːʰtʃɪ
bologna	polɔɲːa
taska	tʰaska
p	pʰ
snið	sniːj
hársápa	hɔɑːɹsɔɑːʰpa
eyð	ɛiːj
okn	ɔʰkn
trælur	tʰɹɛaːlʊɹ
vaðmal	vamːal
tunga	tʰʊŋka
kjósa	t͡ʃʰɔuːsa
gullasj	kʊlːaʃ
leykur	lɛiːkʊɹ
fongsul	fɔŋ̊ksʊl
fróður	fɾouːwʊɹ
volga	vɔlka
vár	vɔaːɹ
mørður	møːɹʊɹ
vindstyrki	vɪnstʏɻ̥ʈ͡ʂɪ
silas	siːlas
fylgisveinur	fɪʎtʃɪsvaiːjnʊɹ
biðja	piːja
vestfall	vɛstfatl
enn	ɛnː
faðir	fɛaːjɪɹ
fjall	fjatl
terna	tʰɛɻɳa
sag	sɛaː
nærhendis	nɛarɪndɪs
yrking	ɪɹ̥tʃɪŋk
barmur	paɹmʊɹ
tosti	tʰɔstɪ
ull	ʊtl
blóð	plɔuːw
lynur	liːnʊɹ
dáta	tɔɑːʰta
slips	slɪʰps
konufólk	kʰoːnʊfœl̥k
tign	tʰɪkn
akur	ɛaːʰkʊɹ
hávur	hɔɑːvʊɹ
søtum	søːʰtʊn
fløttur	flœʰtːʊɹ
til	tʰiːl
júst	jʏst
ali	ɛaːlɪ
viðoyingur	viːjɪŋkʊɹ
app	aʰpː
húsbóndi	hʏspœntɪ
fæ	fɛaː
vik	viːk
djóralækni	t͡ʃɔuːɹalahknɪ
tit	tiːt
akslatræ	akslatɾɛaː
háur	hɔɑːvʊɹ
fjallatindur	fjatlatʰɪntʊɹ
lý	lʊiː
far	fɛaːɹ
gø	køː
skittur	ʃɪʰtʊɹ
geypa	t͡ʃɛiːpa
ganga	kɛŋka
sandoy	santɪ
grækarismessa	kɹɛaːʰkaɹɪsmɛsːa
matur	mɛaːʰtʊɹ
e	eː
dreymur	tɾɛiːmʊɹ
væl	vɛaːl
fonn	fɔnː
rúsdrekka	ɹʉuːstɹɛʰkːa
eitil	aiːjtɪl
munnur	mʊnːʊɹ
dagsljós	taksljɔuːs
slag	slɛaː
drong	tɾɔŋk
torkil	tʰɔɹ̥tʃɪl
valur	vɛaːlʊɹ
undirslag	ʊntɪɹslɛaː
líð	lʊiː
sjón	ʃɔuːn
ravnur	ɹavnʊɹ
aðal	ɛːal
tørva	tʰœɹva
bíða	pʊija
einir	aiːjnɪɹ
spyrji	spɪɹjɪ
eigur	aiːjʊɹ
vegur	veːvʊɹ
laga	leːa
skip	ʃiːp
fundur	fʊntʊɹ
viður	viːjʊɹ
ekkja	ɛʰt͡ʃːa
suðuroyingur	suːɹɪŋkʊɹ
her	heːɹ
steikja	staiːt͡ʃa
øska	œska
ferðaseðil	feːɹaseːjɪl
oknagras	ɔʰknakrɛaːs
fiskaørn	fɪskaœɻɳ
yrkjari	ɪɹ̥tʃaɹɪ
kvørkveggja	kvœɹ̥kvɛtʃːa
mørur	møːɹʊɹ
mangan	maŋkan
skola	skoːla
í	ʊiː
veikur	vaikʊr
undirfylki	ʊntɪɹfɪl̥t͡ʃɪ
ryggur	ɹɪkːʊɹ
fyrrapartur	fɪɹːapʰaɻ̊ʈʊɹ
táttur	tʰɔʰtːʊɹ
møna	møːna
føroyaskøra	fœɹjaskøːɹa
japan	jaːpan
aka	ɛaːʰka
framtíð	fɾam̥tʰʊiːj
revtík	ɹɛftʊiːjk
fikutræ	fiːkʊtɹɛaː
hattur	haʰtːʊɹ
lordur	lɔɻʈʊɹ
tóna	tʰɔuna
sabbatur	sapːaʰtʊɹ
hjørtur	jœɻ̥ʈʊɹ
jónatan	jouːnatʰanː
hópur	hɔuːwpʊɹ
jaksul	jaksʊl
mega	meːa
nugga	nʊkːa
svín	svʊin
fjarstýra	fjaɹ̥stʊiːjɹa
grøta	kɾøːʰta
keypmaður	tʃʰɛʰpːmɛaːvʊɹ
skóti	skɔuːtɪ
gløggur	klœkːʊɹ
banka	paŋ̊ka
gjá	t͡ʃɔɑː
toka	tʰoːʰka
beður	peːvʊɹ
blak	plɛaːk
há	hɔɑː
søldfirðingur	sœl̥fɪɹɪŋkʊɹ
sára	sɔɑːɹa
máni	mɔɑːnɪ
bakari	pɛaːʰkaɹɪ
foreldur	fɔɹɛltʊɹ
hæl	hɛaːl
støddfrøði	stœtːfɹøːjɪ
langabbi	lɛŋkapːɪ
spógvi	spɛkvɪ
ymisleiki	iːmɪslaiːt͡ʃɪ
vetrarblóma	veːtɹaɹplɔuːma
fríur	fɾʊiːjʊɹ
losti	lɔstɪ
meyrusýra	mɛiːɹʊsʊiːɹa
undur	ʊntʊɹ
skarv	skaɹv
tænasta	tʰɛanasta
trygging	tʰɹɪt͡ʃːɪŋk
gjógv	t͡ʃɛkv
tiltak	tiːl̥tʱɛaːʰk
brennivín	pɹɛnːɪvʊiːjn
fuglafrøði	fʊklafɾøːjɪ
revur	ɹeːvʊɹ
húsfrú	hʉuːsfrʉuː
stóra	stɔuːɹa
kenniorð	tʃʰɛnːɪoːɹ
kíkur	kʊiːjkʊɹ
geldingur	tʃɛltɪŋkʊɹ
fosfor	fɔsfoɹ
spøk	spøːʰk
tol	tʰoːl
skyr	ʃiːɹ
gir	kiːɹ
fuglasúpan	fʊklasʉuːpan
verpa	vɛɹ̥pa
spyrja	spɪɹja
tún	tʰʉuːn
faks	faks
herbúni	heːrpʉunɪ
ørn	œɻɳ
umstøður	ʊmstøːvʊɹ
tunnil	tʰʊnːɪl
tema	tʰeːma
óðin	ɔuːwɪn
brosma	pɾɔsma
litur	liːtʊɹ
lán	lɔɑːn
torleiki	tʰɔɹlaiːt͡ʃɪ
grann	kɾanː
y	iː
forsøgn	foːɹ̥sœkn
nevna	nɛu̯na
graður	kɾɛaːvʊɹ
karniffil	kʰaɹnɪfːɪl
tíðindamaður	tʰʊiːjɪntamɛaːvʊɹ
mási	mɔaːsɪ
árarnar	ɔaːɹaɹnaɹ
kili	t͡ʃʰiːlɪ
orð	oːɹ
fjøður	fjøːvʊɹ
fílum	fʊiːlʊn
vokk	vɔʰkː
tíðindi	tʰʊiːjɪntɪ
bagal	peːal
skrápur	skɹɔɑːʰpʊɹ
tøva	tʰøːva
ætta	aʰtːa
jakki	jaʰt͡ʃːɪ
skein	skaiːn
ske	skeː
eista	aiːʃta
oyra	ɔira
løn	løːn
hít	hʊiːt
strond	strɔnt
kai	kʰaiː
nýsilvur	nʊiːsɪlvʊɹ
víkingaøld	vʊiːtʃɪŋkaœlt
bankarnir	paŋ̊kaɹnɪɹ
altari	al̥tarɪ
svimjibuksur	svimjɪpʊksʊɹ
dýraætt	tʊiːɹaaʰtː
stova	stɔːva
hassj	haʃː
tjald	tʃʰalt
plantuætt	plan̥tʊaʰtː
svínoyingur	svʊinɪŋkʊɹ
urða	uːɹa
kristus	kʰɾɪstʊs
grønmeti	kɹœnmeːʰtɪ
gjørð	t͡ʃøːɹ
kør	kʰøːɹ
snjósólja	snjɔuːsœlja
baltasar	pal̥tasaɹ
gylvi	t͡ʃɪlvɪ
veðurfrøði	veːvʊrfrøːjɪ
ve	veː
hobbi	hopːɪ
ikki	ɪʰtʃːɪ
gýtt	kʊiʰtː
øða	øːa
landafrøði	lantafɹøːjɪ
spina	spiːna
bólgna	pœlna
dýraslag	tʊiːɹaslɛaː
brúka	pɹʉuːka
tamarhald	tʰɛaːmaɹhalt
laki	lɛaːʰt͡ʃɪ
heiður	haijʊr
u	uː
gløgg	klœkː
dimmgrønur	tɪŋːkɹøœːnʊɹ
vomb	vɔmp
signa	sɪkna
tvørsøgn	tvœʂːœkn
sæð	sɛaː
helvt	hɛl̥t
grøv	kɾøːv
reindýr	ɹɔindʊiːɹ
týð	tʰʊiː
lúka	lʉuːka
ekka	ɛʰkːa
blindleiki	plɪntlaiːt͡ʃɪ
pápa	pʰɔɑːʰpa
par	pʰɛaːɹ
gjør	t͡ʃøːɹ
skúgvur	skɪkvʊɹ
tyrla	tʰɪɻɭa
síl	sʊiːl
skerpikjøt	ʃɛɹ̥pɪtʃʰøːʰt
sjeyndi	ʃɛntɪ
kragi	kʰrɛaːjɪ
økismenning	øːʰtʃɪsmɛnːɪŋk
korsika	kʰɔʂɪka
tailand	tʰaiːlant
brúður	pɹʉuːwʊɹ
íri	ʊiːɹɪ
krónur	kʰɹɔuːnʊɹ
stýrivolt	stʊiɹɪvɔl̥t
arni	aɻɳɪ
pikti	pʰɪʰktɪ
lord	lɔɻʈ
slóð	slɔuː
míl	mʊiːl
tamur	tʰɛaːmʊɹ
aðalheiður	e̞ːalhaiːjʊɹ
eyðun	ɛiːjʊn
traðk	tʰɹaʰkː
fljóð	fljɔuː
spyrjið	spɪɹjɪ
knívur	knʊiːvʊɹ
ost	ɔst
argið	aɹt͡ʃɪ
akarn	ɛaːʰkaɻɳ
kagari	kʰe̞ːaɹɪ
stari	stɛaːɹɪ
guðrun	kuːɹʊn
mogga	mɔkːa
vanuatu	vanuɑːtu
gekk	t͡ʃɛʰkː
lækni	laʰknɪ
siv	siːv
vinstur	vɪn̥stʊɹ
taka	tʰɛaːʰka
leingi	lɔɲtʃɪ
kava	kʰɛaːva
babba	papːa
handil	hantɪl
stýrimaður	stʊiːjɹɪmɛaːvʊɹ
hevur	heːvʊɹ
vetur	veːʰtʊr
padda	pʰatːa
sitja	siːt͡ʃa
ferð	feːɹ
girnd	t͡ʃɪɻɳʈ
túgva	tɪkva
píka	pʰʊiːka
lansi	lan̥sɪ
støð	støː
glaður	klɛaːvʊɹ
fara	fɛaːɹa
hestur	hɛstʊɹ
last	last
binda	pɪnta
á	ɔɑː
havn	haun
ása	ɔɑːsa
súltutoy	sʏl̥tʊtʰɔiː
kálvi	kʰɔlvɪ
appilsintræ	aʰpːɪlsiːntʰɹɛaː
lagna	lakna
alaska	alaska
mynd	mɪnt
trupul	tɹuːpʊl
fyrsta	fɪsta
baldur	paltʊɹ
megin	meːjɪn
sekund	sekʊnt
riv	ɹiːv
meðan	miːjan
banka	pɛŋ̊ka
hædd	hatː
leysur	lɛiːsʊɹ
vív	vʊiːv
oddur	ɔtːʊɹ
binding	pɪntɪŋk
veður	veːvʊɹ
drúgvur	tɾɪkvʊɹ
gníggja	knʊit͡ʃːa
tin	tʰiːn
djórafrøði	t͡ʃɔuːɹafɹøːjɪ
rín	ɹʊiːn
búni	pʉuːnɪ
viðføri	vifːøːɹɪ
lýðveldi	lʊiːvɛltɪ
tvætl	tʰvaʰtl
kallur	kʰaʰtlʊɹ
vápn	vɔʰpn
volt	vɔl̥t
yvirlit	iːvɪɹliːt
renna	ɹɛnːa
jákup	jɔɑːʰkʊp
kanada	kanata
livur	liːvʊɹ
íkorni	ʊiːkɔtnɪ
fisksúpan	fɪsksʉupan
streymur	stɹɛiːjmʊɹ
berur	pɛːɹʊɹ
hálka	hɔl̥ka
korea	kʰoɹeːa
ýla	ʊiːla
himmal	hɪmːal
eingilskur	ɔɲt͡ʃɪlskʊɹ
protesa	pɾotʰeːsa
hvølpur	kʰvœl̥pʊɹ
lodna	lɔtna
tjóðbúni	tʃʰɔuːwpʉuːnɪ
sandoy	santɔiː
mannbjørn	manːpjœtn
høll	hœtl
ýa	ʊiːja
sálmur	sɔlmʊr
avi	ɛaːvɪ
hunangur	huːnɛŋkʊɹ
tá	tʰɔɑː
nú	nʉuː
elgur	ɛlkʊɹ
itu	iːtu
shamanur	ʃamanʊɹ
heyst	hɛst
guð	kuː
elv	ɛlv
festi	fɛstɪ
svíma	svʊiːma
jól	jɔuːl
prýði	pɹʊiːjɪ
bókstavarað	pœkstɛaːvarɛaː
oljuber	ɔljʊpeɛːɹ
sváva	svɔɑːva
kálvur	kʰɔlvʊɹ
hýsa	hʊiːjsa
fiskiørn	fɪstʃɪœɻɳ
leðurbløka	leːvʊɹpløːʰka
stað	stɛaː
føroyskum	føːɹɪskʊn
tjatsi	t͡ʃʰaʰtsɪ
betageisling	pɛːʰtakaiʃlɪŋk
keisari	kʰaiːsaɹɪ
lettland	lɛʰtːlant
leið	laiːj
gáva	kɔɑːva
tala	tʰɛaːla
skómakari	skɔuːmɛaːʰkaɹɪ
benjardøgg	pɛɲːaɹtœkː
rói	rɔuːwɪ
oyggj	ɔt͡ʃː
kúnni	kʰʏnːɪ
kunna	kʰʊnːa
svørð	svøːɹ
veruleiki	veːɹʊlaiːtʃɪ
mortítlingur	mɔɹ̥tʰʊitlɪŋkʊɹ
døgnfluga	tøœːmfluːa
kahútt	kʰahʏʰtː
øða	øːva
svá	svɔɑː
hali	hɛaːlɪ
momma	mɔmːa
teg	tʰeː
vongur	vɔŋkʊɹ
bøur	pøːvʊɹ
gyðja	t͡ʃiːja
toskur	tʰɔskʊɹ
føroyar	fœɹjaɹ
kvala	kvɛaːla
bjór	pjɔuːɹ
tráður	tɹɔɑːvʊɹ
tænari	tʰɛanaɹɪ
kins	t͡ʃɪn̥s
sæbjørn	sɛaːpjœtn
ljóð	ljɔuː
gæs	ɡɛas
sáa	sɔːa
skurðlækni	skuːrlaʰknɪ
mykines	miːtʃɪneːs
m	m
fen	feːn
móður	mɔuːvʊɹ
fiti	fiːtɪ
jaksla	jaksla
svøvnur	svœvnʊɹ
annu	anːʊ
skjóta	ʃɔuːta
veðurvánir	veːvʊɹvɔɑːnɪɹ
fremmandafólk	fɾɛmːantafœl̥k
pálsmessa	pʰɔlsmɛsːa
fugloyingur	fʊklɪŋkʊɹ
timbur	tʰɪmpʊɹ
vindeyga	vɪntɛiːja
mettur	mɛʰtːʊɹ
jarðarskorpa	jɛaːɹaɹʂkɔɻ̥pa
hjørdis	jœɻʈɪs
iva	iːva
jesus	jeːsʊs
koltur	kʰɔl̥tʊɹ
sukur	suːkʊɹ
vøddi	vœtːɪ
sár	sɔaːɹ
volapúkk	voːlapʰʏʰkː
hertogi	hɛɹ̥tʰɔjɪ
yvirætt	iːvɪɹaʰtː
ásur	ɔɑːsʊɹ
fúti	fʉuːtɪ
dýr	tʊiːjɹ
mununum	muːnʊnʊn
boari	poːaɹɪ
lata	lɛaːta
styrki	stɪɻ̊t͡ʃɪ
skomm	skɔmː
stig	stiːj
eiðið	aiːjɪ
tómur	tʰɔuːmʊɹ
tal	tʰɛaːl
hørður	høːɹʊɹ
gestur	t͡ʃɛstʊɹ
gávur	kɔɑːvʊɹ
drúvusukur	tɹʉuːʋʊsuːkʊɹ
dyr	tiːɹ
ur	uːɹ
hørgur	hœɹkʊɹ
meyra	mɛiːɹa
fagur	fɛaːvʊɹ
tjúkkur	t͡ʃʰʏʰkːʊɹ
jarðskjálvti	jaɹ̥ʃɔl̥tɪ
spæta	spɛaːʰta
sprákari	spɹɔɑːʰkaɹɪ
hjálmur	t͡ʃʰɔlmʊɹ
onnur	ɔnːʊɹ
knæ	kn̥ɛaː
ø	øː
boppa	pɔʰpːa
jaksli	jakslɪ
gjógv	t͡ʃoːaɹ
doyða	tɔiːja
føroyakort	fœɹjakʰɔɻ̊ʈ
dýna	tʊiːna
ingibjørg	ɪɲt͡ʃɪpjœrk
tingfundur	tʰɪŋkfʊntʊɹ
herðablað	heːɹaplaɛː
fløska	flœska
gás	kɔɑːs
strongur	stɹɔŋkʊɹ
bleikur	plaiːjkʊɹ
tjóðveldi	t͡ʃʰɔuːvɛltɪ
kári	kʰɔɑːɹɪ
piparrót	pʰiːpaɹɔuːt
olivinolja	ɔliːʋɪnɔlja
tórur	tʰɔuːɹʊɹ
ríða	ɹʊiːja
ytstur	ɪstʊɹ
judo	juːto
glas	klɛaːs
konsertferð	kɔnsɛɻ̊ʈfeːɹ
løgregla	lœkɹɛkla
sjúkrahús	ʃʉuːkɹahʉuːs
lús	lʉuːs
ílatog	ʊiːlatoː
vertur	vɛɹ̥ʈʊɹ
urð	uːɹ
smør	smøːɹ
øðrum	øːɹʊn
tóra	tʰɔuːɹa
knæ	knɛaː
nál	nɔɑːl
mosi	moːsɪ
purra	pʰʊɹːa
se	seː
ver	veːɹ
mikudagur	miːkʊtɛaːwʊɹ
marita	mɛaːɹɪta
morreyður	mɔɹːɛiːjʊɹ
hugsan	hʊksan
glúmur	klʉuːmʊɹ
hagfrøði	hakfɹøːjɪ
glæma	klɛaːma
skósmiður	skɔuːsmiːjʊɹ
ljótur	lʲɔuːtʊɹ
skemt	ʃɛm̥t
spaki	spɛaːʰt͡ʃɪ
fregnartænasta	fɾɛknaɹtʰɛaːnasta
langur	lɛŋkʊɹ
nepal	neːʰpal
barki	paɹ̥t͡ʃɪ
mál	mɔɑːl
sjókort	ʃɔukɔɻ̊ʈ
grønleykur	kɾœnlɛiːkʊɹ
rún	ɹʉuːn
brúkaranavn	prʉuːwkaɹanaun
nýrasteinur	nʊiːɹastaiːnʊɹ
frakki	fraʰt͡ʃɪ
persilla	pʰɛɻ̥ʂɪlːa
ytstur	ɪkstʊɹ
ærgið	aɹt͡ʃɪ
grikkaland	kɾɪʰkːalant
ýr	ʊiːjɹ
fles	fleːs
tónleikur	tʰɔuːnlaiːjkʊɹ
hvat	kvɛaːʰt
edd	ɛtː
borgarstjóri	pɔɹkaɹʃɔuːwɹɪ
benjamin	pɛnjamin
ísa	ʊiːsa
tollur	tʰɔtlʊɹ
búð	pʉuːw
havn	havn
gonga	kɔŋka
sesamfræ	seːsamfɾɛaː
samlega	samleːva
ørur	øːɹʊɹ
døgg	tœkː
hugur	huːvʊɹ
menn	mɛnː
klokka	kʰlɔʰkːa
dreki	tɹɛːʰt͡ʃɪ
ugla	ʊkla
askur	askʊɹ
bókstavur	pœʰkstɛaːvʊɹ
lendi	lɛntɪ
bil	piːl
týðing	tʰʊiːjɪŋk
heiði	haiːjɪ
kálksótt	kʰɔl̥ksœʰtː
elvur	ɛlvʊɹ
elduvíkingur	ɛltʊvʊiʃɪŋkʊɹ
kál	kʰɔaːl
umseting	ʊmseːtɪŋk
skarlak	skaɻɭak
verkætlan	vɛɹ̥kaʰtlan
n	n
tryggingarfelag	tʰɹɪt͡ʃːɪŋkaɹfeːla
appilsindjús	aʰpːɪlsiːnt͡ʃʉuːs
milti	mɪl̥tɪ
erla	ɛɻɭa
nema	neːma
kelling	tʃʰɛtlɪŋk
gøta	køːʰta
vørður	vøːɹʊɹ
beð	peː
norðurland	noːrʊrlant
deyvleiki	tɛiːvlaiːʰt͡ʃɪ
kymru	tʃʰɪmɹʊ
høggmynd	hœɡːmɪnd
unnur	ʊnːʊɹ
vingul	vɪŋkʊl
fika	fiːka
lulla	lʊlːa
belti	pɛl̥tɪ
verður	veːɹʊɹ
gjógv	tʃɛkf
tonn	tʰɔnː
króna	kɹɔuːna
var	vɛaːɹ
tosta	tʰɔsta
otto	ɔʰtːʊ
stikkari	stɪʰkːaɹɪ
spakur	spɛaːʰkʊɹ
átjan	ɔaːʰt͡ʃan
epl	ɛpl
bogi	poːjɪ
nábúgvi	nɔɑːpɪkvɪ
døgum	tøːvʊn
eyður	ɛiːjʊɹ
elri	ɛlɹɪ
smyril	smiːɹɪl
brotsmaður	brɔtsmɛaːvʊɹ
jarðber	jaɹpeɛːɹ
song	sɔŋk
gestablídni	tʃɛstaplʊitnɪ
eftirlit	ɛʰtːɪɹliːt
undirhópur	ʊntɪɹhɔuːpʊɹ
slovenia	sloveːnia
bráður	pɾɔɑːvʊɹ
heilagur	haiːlavʊɹ
frískur	fɾʊiʃkʊɹ
nossa	nɔsːa
enskur	ɛn̥skʊɹ
sáta	sɔɑːʰta
hallur	hatlʊɹ
stóru	stɔuːɹʊ
magur	mɛaːvʊɹ
játta	jɔʰtːa
pipar	pʰiːpaɹ
púta	pʰʉuːta
john	jɔnː
kollfirðingur	kɔl̥fɪɹɪŋkʊɹ
músabróðir	mʉuːsapɾɔuːwɪɹ
jólatræ	jɔuːlatʰɹɛaː
íslendingur	ʊiʃlɛntɪŋkʊɹ
árnafjørður	ɔtnafjøːɹʊɹ
bakkus	paʰkːʊs
tjaldursegg	tʃʰaltʊɹsɛkː
nakki	naʰt͡ʃːɪ
viðfang	vɪfːɛŋk
teir	tʰaiːɹ
veðrur	vɛkɹʊɹ
yngri	ɪŋkɾɪ
brynhild	pɾiːnɪlt
piparnøt	pʰiːpaɹnøːʰt
happ	haʰpː
hvala	kvɛaːla
marur	mɛaːɹʊɹ
elli	ɛtlɪ
frændi	frantɪ
nýta	nʊiːta
hví	kʰvʊiː
høkja	høːʰt͡ʃa
dúgva	tɪkva
dorg	tɔɹk
argi	aɹt͡ʃɪ
taivan	tʰaiːvan
íggj	ʊit͡ʃː
