kan	kˈan
fi	fˈi
hin	hˈin
akka	ˈakːa
isaa	ɪsˈaː
ture	tˈure
kana	kˈana
yoo	?ˈoː
tokko	tˈokːo
waan	wˈaːn
yeroo	ˌ?erˈoː
keessa	kˈeːssa
keessatti	keːssˈatːɪ
itti	ˈitːɪ
gara	ɡˈara
koo	kˈoː
irratti	ɪrrˈatːɪ
dha	ðˈa
kun	kˈun
jiru	d͡ʒˈiru
keessaa	kˈeːssaː
bara	bˈara
nama	nˈama
booda	bˈoːda
na	nˈa
isa	ˈisa
ni	nˈi
irraa	ɪrrˈaː
mana	mˈana
qabu	k`ˈabu
garuu	ɡarˈuː
qaba	k`ˈaba
irra	ˈirra
osoo	osˈoː
ishee	ɪʃˈeː
hanga	hˈanɡa
malee	malˈeː
immoo	ɪmmˈoː
natti	nˈatːɪ
jira	d͡ʒˈira
inni	ˈinnɪ
bakka	bˈakːa
of	ˈof
isaanii	ɪsˈaːnɪː
Yeroo	ˌ?erˈoː
keenya	kˈeːɲa
wal	wˈal
Oromoo	ˌoromˈoː
kunis	kˈunɪs
adda	ˈadːa
sana	sˈana
baayyee	baːˈ??eː
walitti	walˈitːɪ
jedhu	d͡ʒˈeðu
guddaa	ɡudːˈaː
ykn	ˈ?kn
isaan	ɪsˈaːn
wajjin	wˈad͡ʒd͡ʒɪn
jedhamu	d͡ʒeðˈamu
Piiter	pˈiːter
hunda	hˈunda
karaa	karˈaː
Bara	bˈara
biraa	bɪrˈaː
hojii	hod͡ʒˈiː
kutaa	kutˈaː
kanaa	kanˈaː
afaan	afˈaːn
erga	ˈerɡa
ol	ˈol
guyyaa	ɡuˈ??aː
waliin	walˈiːn
ani	ˈanɪ
jedhee	d͡ʒeðˈeː
qofa	k`ˈofa
haa	hˈaː
naa	nˈaː
amma	ˈamma
biyya	bɪˈ??a
Garuu	ɡarˈuː
naannoo	nˈaːnnoː
turan	tˈuran
akkan	ˈakːan
immo	ˈimmo
sitti	sˈitːɪ
kanaan	kanˈaːn
waggaa	waɡːˈaː
lafa	lˈafa
Aanaa	ˈaːnaː
kessatti	kessˈatːɪ
maqaa	mak`ˈaː
argamu	arɡˈamu
kessa	kˈessa
akkasumas	ˌakːasˈumas
jechuun	d͡ʒet͡ʃˈuːn
nu	nˈu
sadarkaa	sˌadarkˈaː
Kana	kˈana
Akka	ˈakːa
lama	lˈama
ummata	ummˈata
dura	dˈura
jechuu	d͡ʒet͡ʃˈuː
miti	mˈitɪ
warra	wˈarra
ammoo	ammˈoː
maal	mˈaːl
Afrikaa	ˌafrɪkˈaː
akkuma	akːˈuma
Kan	kˈan
ittiin	ɪtːˈiːn
gadi	ɡˈadɪ
si	sˈi
Afaan	afˈaːn
Kiitii	kˈiːtɪː
abbaa	abːˈaː
kuni	kˈunɪ
addaa	adːˈaː
namoota	namˈoːta
jedhama	d͡ʒeðˈama
kee	kˈeː
namni	nˈamnɪ
nan	nˈan
harka	hˈarka
jalqabaa	d͡ʒˌalk`abˈaː
humna	hˈumna
taane	tˈaːne
Itoophiyaa	ˌitoːΦˌi?ˈaː
Faandaan	fˈaːndaːn
iddoo	ɪdːˈoː
haala	hˈaːla
jalqabe	d͡ʒalk`ˈabe
jiran	d͡ʒˈiran
gosa	ɡˈosa
yeroon	ˌ?erˈoːn
Kunis	kˈunɪs
ofii	ofˈiː
bishaan	bɪʃˈaːn
Kanaaf	kanˈaːf
isaas	ɪsˈaːs
iyyuu	ɪˈ??uː
mataa	matˈaː
Haa	hˈaː
tokkoo	tokːˈoː
aanaa	ˈaːnaː
addunyaa	ˌadːuɲˈaː
dandeenye	dandˈeːɲe
jedhe	d͡ʒˈeðe
walii	walˈiː
garaa	ɡarˈaː
kanin	kˈanɪn
kiyya	kɪˈ??a
siin	sˈiːn
waraanaa	warˈaːnaː
sababa	sabˈaba
jalqaba	d͡ʒalk`ˈaba
jecha	d͡ʒˈet͡ʃa
qaban	k`ˈaban
magaalaa	maɡˈaːlaː
hafe	hˈafe
kanatti	kanˈatːɪ
Waan	wˈaːn
Amma	ˈamma
illee	ɪllˈeː
lamaan	lamˈaːn
beeku	bˈeːku
godhe	ɡˈoðe
seenaa	sˈeːnaː
sun	sˈun
Obbo	ˈobːo
hunduu	hundˈuː
jireenya	d͡ʒɪrˈeːɲa
mootummaa	mˌoːtummˈaː
odoo	odˈoː
sirna	sˈirna
yaada	?ˈaːda
fuula	fˈuːla
jala	d͡ʒˈala
kiitii	kˈiːtɪː
obbo	ˈobːo
ti	tˈi
argama	arɡˈama
dhugaa	ðuɡˈaː
kanan	kˈanan
waraana	warˈaːna
Maargoot	mˈaːrɡoːt
dhufe	ðˈufe
naan	nˈaːn
namoonni	namˈoːnnɪ
yokan	?ˈokan
bira	bˈira
gaarii	ɡˈaːrɪː
qabne	k`ˈabne
gidduu	ɡɪdːˈuː
jiruu	d͡ʒɪrˈuː
namaa	namˈaː
too	tˈoː
Eeyyee	eːˈ??eː
Teslaan	teslˈaːn
jedhamee	d͡ʒˌeðamˈeː
darbee	darbˈeː
dhibee	ðɪbˈeː
addaan	adːˈaːn
duukaa	dˈuːkaː
haaraa	hˈaːraː
jedha	d͡ʒˈeða
Sana	sˈana
hedduu	hedːˈuː
qabdu	k`ˈabdu
biratti	bɪrˈatːɪ
gaafa	ɡˈaːfa
icciitii	ɪt͡ʃ`t͡ʃ`ˈiːtɪː
ijoollee	ɪd͡ʒˈoːlleː
ishii	ɪʃˈiː
Addunyaa	ˌadːuɲˈaː
hundi	hˈundɪ
keenyaa	kˈeːɲaː
turre	tˈurre
xiqqoo	t`ɪk`ːˈoː
ija	ˈid͡ʒa
rakkoo	rakːˈoː
waanti	wˈaːntɪ
Oromoon	ˌoromˈoːn
argate	arɡˈate
guddaan	ɡudːˈaːn
jalaa	d͡ʒalˈaː
kanaaf	kanˈaːf
meeshaa	mˈeːʃaː
miira	mˈiːra
qaama	k`ˈaːma
turte	tˈurte
Abbaa	abːˈaː
aadaa	ˈaːdaː
fakkaata	fakːˈaːta
jaarraa	d͡ʒˈaːrraː
muraasa	murˈaːsa
Gadaa	ɡadˈaː
godhu	ɡˈoðu
jalatti	d͡ʒalˈatːɪ
sii	sˈiː
Erga	ˈerɡa
isheen	ɪʃˈeːn
waanan	wˈaːnan
dhufu	ðˈufu
kaasee	kˈaːseː
qabdi	k`ˈabdɪ
tokkoon	tokːˈoːn
Egaa	eɡˈaː
Mana	mˈana
guutuu	ɡˈuːtuː
maatii	mˈaːtɪː
manaa	manˈaː
qabsoo	k`absˈoː
barnoota	barnˈoːta
bayye	baˈ??e
caalaa	t͡ʃ`ˈaːlaː
duraa	durˈaː
hidhaa	hɪðˈaː
jedhanii	d͡ʒˌeðanˈiː
ammaa	ammˈaː
ati	ˈatɪ
irraan	ɪrrˈaːn
sammuu	sammˈuː
Akkuma	akːˈuma
akkam	ˈakːam
fakkaatu	fakːˈaːtu
himuu	hɪmˈuː
nyaata	ɲˈaːta
seelii	sˈeːlɪː
Kun	kˈun
beeka	bˈeːka
lafaa	lafˈaː
lammaffaa	lˌammaffˈaː
sanaa	sanˈaː
uummata	uːmmˈata
Yoo	?ˈoː
gochuu	ɡot͡ʃˈuː
kudha	kˈuða
Namoonni	namˈoːnnɪ
achi	ˈat͡ʃɪ
akkasii	ˌakːasˈiː
gidduutti	ɡɪdːˈuːtːɪ
godha	ɡˈoða
wayita	wˌa?ˈita
Aanaan	ˈaːnaːn
Ani	ˈanɪ
Inni	ˈinnɪ
Sababiin	sˌababˈiːn
aabbaa	ˈaːbːaː
isaatti	ɪsˈaːtːɪ
namatti	namˈatːɪ
carraa	t͡ʃ`arrˈaː
dhimma	ðˈimma
jedhamuun	d͡ʒˌeðamˈuːn
jedheen	d͡ʒeðˈeːn
jettee	d͡ʒetːˈeː
amantii	ˌamantˈiː
isaani	ɪsˈaːnɪ
kompitara	kˌompɪtˈara
nutti	nˈutːɪ
sanatti	sanˈatːɪ
tokkotti	tokːˈotːɪ
warri	wˈarrɪ
Akkasumas	ˌakːasˈumas
dhufee	ðufˈeː
aadde	ˈaːdːe
barumsaa	bˌarumsˈaː
haadha	hˈaːða
kamiyyuu	kˌamɪˈ??uː
sagantaa	sˌaɡantˈaː
barbaadu	barbˈaːdu
darbe	dˈarbe
dheeraa	ðˈeːraː
fayyadamuun	fˌa??ˌadamˈuːn
hojjatu	hod͡ʒd͡ʒˈatu
kitaaba	kɪtˈaːba
osoon	osˈoːn
seera	sˈeːra
Guyyaa	ɡuˈ??aː
akkas	ˈakːas
deeme	dˈeːme
jette	d͡ʒˈetːe
kaan	kˈaːn
meetira	meːtˈira
nuu	nˈuː
seete	sˈeːte
siif	sˈiːf
sirriitti	sɪrrˈiːtːɪ
takkaa	takːˈaː
argaman	arɡˈaman
lakkoofsa	lakːˈoːfsa
sarkiyuutii	sˌarkɪ?ˈuːtɪː
turee	turˈeː
yoon	?ˈoːn
Maqaan	mak`ˈaːn
dhiiga	ðˈiːɡa
dirqama	dɪrk`ˈama
himu	hˈimu
Aadde	ˈaːdːe
Karaa	karˈaː
Waraana	warˈaːna
dhukkuba	ðukːˈuba
durii	durˈiː
uume	ˈuːme
barumsa	barˈumsa
beekkama	beːkːˈama
duraan	durˈaːn
fedhii	feðˈiː
garee	ɡarˈeː
jirru	d͡ʒˈirru
jirutti	d͡ʒɪrˈutːɪ
meeshaalee	meːʃˈaːleː
sagalee	sˌaɡalˈeː
yookaan	?ˈoːkaːn
Maal	mˈaːl
Namni	nˈamnɪ
caala	t͡ʃ`ˈaːla
dhufan	ðˈufan
jiraatu	d͡ʒɪrˈaːtu
kkf	kˌaːkˌaːfˈaː
naaf	nˈaːf
qorannoo	k`ˌorannˈoː
shan	ʃˈan
walakkaa	wˌalakːˈaː
Oromiyaa	ˌoromˌi?ˈaː
cimaa	t͡ʃ`ɪmˈaː
ilma	ˈilma
jirti	d͡ʒˈirtɪ
kooti	kˈoːtɪ
sadii	sadˈiː
sanyii	saɲˈiː
taatu	tˈaːtu
yaalii	?ˈaːlɪː
Dhugaa	ðuɡˈaː
ajaja	ad͡ʒˈad͡ʒa
amala	amˈala
ammas	ˈammas
barnootaa	barnˈoːtaː
dhaloota	ðalˈoːta
dubbii	dubːˈiː
mootummaan	mˌoːtummˈaːn
nuti	nˈutɪ
qabatee	k`ˌabatˈeː
taate	tˈaːte
uffata	uffˈata
Waggaa	waɡːˈaː
Yuurooppi	ˌ?uːrˈoːpːɪ
arge	ˈarɡe
baayyeen	baːˈ??eːn
bifa	bˈifa
deemu	dˈeːmu
ergaa	erɡˈaː
gochaa	ɡot͡ʃˈaː
godhee	ɡoðˈeː
hime	hˈime
isaaf	ɪsˈaːf
ofitti	ofˈitːɪ
tajaajila	tˌad͡ʒaːd͡ʒˈila
Itti	ˈitːɪ
Yeroon	ˌ?erˈoːn
and	ˈand
dhufeenya	ðufˈeːɲa
gochuun	ɡot͡ʃˈuːn
harmee	harmˈeː
jiraachuu	d͡ʒɪrˈaːt͡ʃuː
kanas	kˈanas
mucaa	mut͡ʃ`ˈaː
waantota	waːntˈota
Yuunivarsiitii	ˌ?uːnˌivarsˈiːtɪː
akkamitti	ˌakːamˈitːɪ
fudhatee	fˌuðatˈeː
gad	ɡˈad
gale	ɡˈale
ganna	ɡˈanna
hundaa	hundˈaː
ilaalcha	ɪlˈaːlt͡ʃa
jedhan	d͡ʒˈeðan
karantii	kˌarantˈiː
kootti	kˈoːtːɪ
laga	lˈaɡa
mala	mˈala
malees	malˈeːs
qabata	k`abˈata
salphaa	salΦˈaː
wanti	wˈantɪ
Abbaan	abːˈaːn
Fakkeenyaaf	fakːˈeːɲaːf
Haala	hˈaːla
aabbaan	ˈaːbːaːn
ala	ˈala
ammayyaa	ˌammaˈ??aː
dhalate	ðalˈate
gaaffii	ɡˈaːffɪː
haga	hˈaɡa
harmeen	harmˈeːn
kanarratti	kˌanarrˈatːɪ
kompitaraa	kˌompɪtarˈaː
qabaachuu	k`abˈaːt͡ʃuː
saba	sˈaba
the	thˈe
wayii	wˌa?ˈiː
Innis	ˈinnɪs
Maraatoonii	mˌaraːtˈoːnɪː
Piiteriin	pˌiːterˈiːn
baatirii	bˌaːtɪrˈiː
barsiisaa	barsˈiːsaː
dhumaa	ðumˈaː
eenyu	ˈeːɲu
fayyadamu	fˌa??adˈamu
gogaa	ɡoɡˈaː
kuma	kˈuma
maaltu	mˈaːltu
miirri	mˈiːrrɪ
mirga	mˈirɡa
olii	olˈiː
otoo	otˈoː
qofaa	k`ofˈaː
tiyya	tɪˈ??a
xiqqaate	t`ɪk`ːˈaːte
Magaalaa	maɡˈaːlaː
afur	ˈafur
argamti	arɡˈamtɪ
bahee	bahˈeː
dhiibbaa	ðˈiːbːaː
dhuma	ðˈuma
dorgommii	dˌorɡommˈiː
jalqabu	d͡ʒalk`ˈabu
miliyoona	mˌilɪ?ˈoːna
miseensa	mɪsˈeːnsa
oduu	odˈuː
qabuu	k`abˈuː
xiqqaa	t`ɪk`ːˈaː
yaaliin	?ˈaːlɪːn
Gara	ɡˈara
Hanga	hˈanɡa
Kuush	kˈuːʃ
Namoota	namˈoːta
anaa	anˈaː
as	ˈas
balaa	balˈaː
dubartii	dˌubartˈiː
gala	ɡˈala
gargaarsa	ɡarɡˈaːrsa
ilaaluu	ɪlˈaːluː
jalqabee	d͡ʒˌalk`abˈeː
jedhaman	d͡ʒeðˈaman
maqaan	mak`ˈaːn
olaanaa	olˈaːnaː
onnee	onnˈeː
tti	tːˈi
wantoota	wantˈoːta
yerro	?ˈerro
Mariin	marˈiːn
barate	barˈate
duubatti	duːbˈatːɪ
fufe	fˈufe
gudda	ɡˈudːa
hafan	hˈafan
harkaa	harkˈaː
hima	hˈima
hojjatame	hˌod͡ʒd͡ʒatˈame
ifa	ˈifa
jalqaban	d͡ʒalk`ˈaban
n	nˈa
Isa	ˈisa
abbaan	abːˈaːn
baayyen	baːˈ??en
beekkamu	beːkːˈamu
daangaa	dˈaːnɡaː
dabalatee	dˌabalatˈeː
deebiin	dˈeːbɪːn
dhufa	ðˈufa
dhufuu	ðufˈuː
fayyadaman	fˌa??adˈaman
galgala	ɡalɡˈala
gammachuu	ɡˌammat͡ʃˈuː
godhame	ɡoðˈame
hagam	hˈaɡam
hundumaa	hˌundumˈaː
jechuudha	d͡ʒet͡ʃˈuːða
jireenyaa	d͡ʒɪrˈeːɲaː
keessoo	kˈeːssoː
km	kˌaːmˈaː
kunii	kunˈiː
maaliif	mˈaːlɪːf
qabee	k`abˈeː
qarqara	k`ark`ˈara
qilleensa	k`ɪllˈeːnsa
qillensa	k`ɪllˈensa
qulqulluu	k`ˌulk`ullˈuː
sochii	sot͡ʃˈiː
yaadu	?ˈaːdu
Dubbii	dubːˈiː
anis	ˈanɪs
argatu	arɡˈatu
baayyinaan	bˌaː??ɪnˈaːn
bahaa	bahˈaː
dhibeen	ðɪbˈeːn
dubbatu	dubːˈatu
ergan	ˈerɡan
galee	ɡalˈeː
gossa	ɡˈossa
hojjachuu	hˌod͡ʒd͡ʒat͡ʃˈuː
jedhame	d͡ʒeðˈame
jedhamuu	d͡ʒˌeðamˈuː
jirra	d͡ʒˈirra
lubbuu	lubːˈuː
nagaa	naɡˈaː
qabame	k`abˈame
seene	sˈeːne
sirrii	sɪrrˈiː
ummatta	ummˈatːa
umurii	ˌumurˈiː
waa	wˈaː
Laga	lˈaɡa
Warri	wˈarrɪ
amana	amˈana
ana	ˈana
baate	bˈaːte
barbaada	barbˈaːda
beekama	beːkˈama
biroo	bɪrˈoː
biyyaa	bɪˈ??aː
biyyoota	bˌi??ˈoːta
deemee	dˈeːmeː
dhiigaa	ðˈiːɡaː
eenyummaa	ˌeːɲummˈaː
galaa	ɡalˈaː
galu	ɡˈalu
gochuuf	ɡot͡ʃˈuːf
godina	ɡodˈina
hamaa	hamˈaː
jiraatan	d͡ʒɪrˈaːtan
kanneen	kannˈeːn
kophaa	koΦˈaː
lamaa	lamˈaː
lubbuun	lubːˈuːn
olitti	olˈitːɪ
takka	tˈakːa
tiraanzisterii	tˌiraːntsˌisterˈiː
umrii	umrˈiː
xumure	t`umˈure
yaaduu	?ˈaːduː
Bakka	bˈakːa
Kutaa	kutˈaː
Olompiikii	ˌolompˈiːkɪː
aangoo	ˈaːnɡoː
afuura	afˈuːra
ammaatti	ammˈaːtːɪ
barbaachisaa	bˌarbaːt͡ʃɪsˈaː
bilisa	bɪlˈisa
buufata	buːfˈata
deebii	dˈeːbɪː
fayyadamuu	fˌa??ˌadamˈuː
fudhate	fuðˈate
gadii	ɡadˈiː
gahu	ɡˈahu
galatti	ɡalˈatːɪ
guutuutti	ɡuːtˈuːtːɪ
haalli	hˈaːllɪ
hedduun	hedːˈuːn
hundaaf	hundˈaːf
isaati	ɪsˈaːtɪ
jalqabaaf	d͡ʒˌalk`abˈaːf
jechi	d͡ʒˈet͡ʃɪ
jedhamutti	d͡ʒˌeðamˈutːɪ
jiraachaa	d͡ʒɪrˈaːt͡ʃaː
marsaa	marsˈaː
mata	mˈata
muraasni	murˈaːsnɪ
ogummaa	ˌoɡummˈaː
qabanii	k`ˌabanˈiː
qubee	k`ubˈeː
taanaan	tˈaːnaːn
waraanni	warˈaːnnɪ
Anis	ˈanɪs
Finfinnee	fˌinfɪnnˈeː
Isaan	ɪsˈaːn
Kireeler	kɪrˈeːler
Koloneel	kˌolonˈeːl
Mootummaa	mˌoːtummˈaː
Oliiqaa	olˈiːk`aː
Qananiisaan	k`ˌananˈiːsaːn
Teslaa	teslˈaː
barreeffama	bˌarreːffˈama
barreesse	barrˈeːsse
beekkamaa	bˌeːkːamˈaː
biraan	bɪrˈaːn
deemuu	dˈeːmuː
dhabuu	ðabˈuː
dhiisuu	ðˈiːsuː
durbaa	durbˈaː
gama	ɡˈama
guddate	ɡudːˈate
hamma	hˈamma
ifatti	ɪfˈatːɪ
iin	ˈiːn
isaanis	ɪsˈaːnɪs
jechoota	d͡ʒet͡ʃˈoːta
kompitarri	kˌompɪtˈarrɪ
laata	lˈaːta
mooraa	mˈoːraː
qaamaa	k`ˈaːmaː
qawwee	k`awwˈeː
saffisa	saffˈisa
san	sˈan
tokkoyyuu	tˌokːoˈ??uː
Agarii	ˌaɡarˈiː
Arsii	arsˈiː
Dr	dˌaːrˈaː
anniisaa	annˈiːsaː
barreessuu	barrˈeːssuː
biraatti	bɪrˈaːtːɪ
damee	damˈeː
fishiinii	fɪʃˈiːnɪː
gaazii	ɡˈaːtsɪː
gabaabaa	ɡabˈaːbaː
guddina	ɡudːˈina
hawaasa	hawˈaːsa
hojjate	hod͡ʒd͡ʒˈate
jijjiirama	d͡ʒˌid͡ʒd͡ʒɪːrˈama
mootii	mˈoːtɪː
nuun	nˈuːn
saayinsii	sˌaː?ɪnsˈiː
salphaatti	salΦˈaːtːɪ
sanaan	sanˈaːn
seenee	sˈeːneː
uumuu	ˈuːmuː
vaayiresii	vˌaː?ˌiresˈiː
yookan	?ˈoːkan
Aabbaan	ˈaːbːaːn
Hayila	hˌa?ˈila
Kaleessa	kalˈeːssa
abdii	abdˈiː
addaatti	adːˈaːtːɪ
agarsiisa	ˌaɡarsˈiːsa
alaa	alˈaː
dubartoota	dˌubartˈoːta
dubbata	dubːˈata
faa	fˈaː
fakkaatiin	fakːˈaːtɪːn
fudhachuu	fˌuðat͡ʃˈuː
ganama	ɡanˈama
godhan	ɡˈoðan
hojiirra	hod͡ʒˈiːrra
ibsu	ˈibsu
isaaniif	ɪsˈaːnɪːf
isaanitti	ˌisaːnˈitːɪ
kanarraa	kˌanarrˈaː
kanuma	kanˈuma
kenna	kˈenna
kilometers	kˌilomˈeters
kolonii	kˌolonˈiː
oole	ˈoːle
parsentii	pˌarsentˈiː
qabate	k`abˈate
qabatu	k`abˈatu
qabna	k`ˈabna
qabuuf	k`abˈuːf
ummataa	ˌummatˈaː
voolteejii	voːltˈeːd͡ʒɪː
yaadannoo	ˌ?aːdannˈoː
yookiin	?ˈoːkɪːn
Abbabaan	ˌabːabˈaːn
Haalli	hˈaːllɪ
Jeneraal	d͡ʒˌenerˈaːl
KHG	kˌaːhˌaːɡˈaː
Waraanni	warˈaːnnɪ
agarsiisu	ˌaɡarsˈiːsu
armaan	armˈaːn
asii	asˈiː
baha	bˈaha
bahan	bˈahan
balbala	balbˈala
barachuu	bˌarat͡ʃˈuː
barbaachisu	bˌarbaːt͡ʃˈisu
beekne	bˈeːkne
bulchiinsa	bult͡ʃˈiːnsa
dafee	dafˈeː
dandeettii	dandˈeːtːɪː
deeman	dˈeːman
dhiira	ðˈiːra
dhiiraa	ðˈiːraː
dijitaalaa	dˌid͡ʒɪtˈaːlaː
dubbachuuf	dˌubːat͡ʃˈuːf
eegale	eːɡˈale
elektirikii	ˌelektˌirɪkˈiː
fudhatama	fˌuðatˈama
garba	ɡˈarba
gita	ɡˈita
guyyoota	ɡˌu??ˈoːta
halkan	hˈalkan
hojiin	hod͡ʒˈiːn
hojjachaa	hˌod͡ʒd͡ʒat͡ʃˈaː
ibolaa	ˌibolˈaː
kennu	kˈennu
kuusaa	kˈuːsaː
lamatti	lamˈatːɪ
mallattoo	mˌallatːˈoː
mirgaa	mɪrɡˈaː
namicha	namˈit͡ʃa
nyaataa	ɲˈaːtaː
odeeffannoo	ˌodeːffannˈoː
ofirraa	ˌofɪrrˈaː
oolu	ˈoːlu
qabeenya	k`abˈeːɲa
qabnu	k`ˈabnu
qabxii	k`abt`ˈiː
square	sk`uˈare
Ameerikaa	ˌameːrɪkˈaː
Biriiten	bɪrˈiːten
Boodarra	boːdˈarra
Caamsaa	t͡ʃ`ˈaːmsaː
Dargii	darɡˈiː
Godina	ɡodˈina
Kuni	kˈunɪ
Meeppeen	mˈeːpːeːn
Sheek	ʃˈeːk
Tarii	tarˈiː
The	thˈe
antiraaksii	ˌantɪrˈaːksɪː
baaxii	bˈaːt`ɪː
bahe	bˈahe
bahuu	bahˈuː
barattoota	bˌaratːˈoːta
beekamu	beːkˈamu
bilisummaa	bˌilɪsummˈaː
boodarra	boːdˈarra
deema	dˈeːma
deemuun	dˈeːmuːn
fayyadama	fˌa??adˈama
gahaa	ɡahˈaː
galuu	ɡalˈuː
guutummaa	ɡˌuːtummˈaː
hojjatan	hod͡ʒd͡ʒˈatan
hoo	hˈoː
in	ˈin
innis	ˈinnɪs
isheef	ɪʃˈeːf
kaanii	kˈaːnɪː
kabaja	kabˈad͡ʒa
kallattii	kˌallatːˈiː
kenne	kˈenne
kennuu	kennˈuː
kessaa	kessˈaː
kudhan	kˈuðan
loon	lˈoːn
lubbu	lˈubːu
mara	mˈara
qabamee	k`ˌabamˈeː
qofatu	k`ofˈatu
siinqee	sˈiːnk`eː
siyaasaa	sˌi?ˈaːsaː
suuta	sˈuːta
tasa	tˈasa
tasaa	tasˈaː
tolu	tˈolu
ummanni	ummˈannɪ
wagga	wˈaɡːa
ABOn	ˈabon
Firaansi	fɪrˈaːnsɪ
Harmeen	harmˈeːn
Jalqaba	d͡ʒalk`ˈaba
Mosee	mosˈeː
Nama	nˈama
Osoo	osˈoː
Piyeer	pˌi?ˈeːr
Roontigan	roːntˈiɡan
Shaampiyoonaa	ʃˌaːmpɪ?ˈoːnaː
Waanti	wˈaːntɪ
aansee	ˈaːnseː
afaanii	afˈaːnɪː
akkamii	ˌakːamˈiː
alatti	alˈatːɪ
argachuu	ˌarɡat͡ʃˈuː
argamtu	arɡˈamtu
baasu	bˈaːsu
baatee	bˈaːteː
ballina	ballˈina
barbaade	barbˈaːde
baruumsaa	barˈuːmsaː
biiroo	bˈiːroː
dheeraaf	ðˈeːraːf
dhuunfaa	ðˈuːnfaː
diimaa	dˈiːmaː
fakkii	fakːˈiː
fidu	fˈidu
gargaara	ɡarɡˈaːra
goota	ɡˈoːta
guddoo	ɡudːˈoː
ilmaan	ɪlmˈaːn
jaalala	d͡ʒaːlˈala
jirre	d͡ʒˈirre
jirtu	d͡ʒˈirtu
keessan	kˈeːssan
keessattis	keːssˈatːɪs
kennaa	kennˈaː
kibba	kˈibːa
kuufannoo	kˌuːfannˈoː
lammii	lammˈiː
mitii	mɪtˈiː
mormii	mormˈiː
qabamu	k`abˈamu
qarshii	k`arʃˈiː
raadiyoo	rˌaːdɪ?ˈoː
sirni	sˈirnɪ
tokkoffa	tokːˈoffa
torba	tˈorba
warraa	warrˈaː
yoomillee	ˌ?oːmɪllˈeː
ABO	ˈabo
Ammas	ˈammas
Gaafa	ɡˈaːfa
Haaluma	haːlˈuma
Hoolaandi	hoːlˈaːndɪ
Isaanis	ɪsˈaːnɪs
Maalumaafuu	mˌaːlumˈaːfuː
Maccaa	mat͡ʃ`t͡ʃ`ˈaː
Marii	marˈiː
Poorchugaal	pˌoːrt͡ʃuɡˈaːl
Sababa	sabˈaba
Waaqayyo	wˌaːk`aˈ??o
aartii	ˈaːrtɪː
achii	at͡ʃˈiː
achuma	at͡ʃˈuma
adunya	adˈuɲa
amantaa	ˌamantˈaː
argatan	arɡˈatan
argee	arɡˈeː
ayyaana	ˌa??ˈaːna
biyyotta	bˌi??ˈotːa
boodas	bˈoːdas
caalu	t͡ʃ`ˈaːlu
darbuu	darbˈuː
dhagahame	ðˌaɡahˈame
dhibba	ðˈibːa
dubbachuu	dˌubːat͡ʃˈuː
dubbate	dubːˈate
dubbisuu	dˌubːɪsˈuː
duraatti	durˈaːtːɪ
eegaa	ˈeːɡaː
eessa	ˈeːssa
fayyaa	faˈ??aː
gaafate	ɡaːfˈate
gargar	ɡˈarɡar
ibsa	ˈibsa
ifaa	ɪfˈaː
jedhamti	d͡ʒeðˈamtɪ
jedhuun	d͡ʒeðˈuːn
jettu	d͡ʒˈetːu
kamiiyyuu	kˌamɪːˈ??uː
konkolaataa	kˌonkolˈaːtaː
koon	kˈoːn
loltoota	loltˈoːta
magaala	maɡˈaːla
narra	nˈarra
niwuukilaaraa	nˌiwuːkɪlˈaːraː
ofiin	ofˈiːn
qabuun	k`abˈuːn
qodaa	k`odˈaː
qooda	k`ˈoːda
saddeet	sadːˈeːt
taatee	tˈaːteː
tokkoffaa	tˌokːoffˈaː
tooftaa	tˈoːftaː
torban	tˈorban
tureef	turˈeːf
ulfaataa	ulfˈaːtaː
uuma	ˈuːma
uummanni	uːmmˈannɪ
wanta	wˈanta
yaadaa	?ˈaːdaː
Baalee	bˈaːleː
Bilisummaa	bˌilɪsummˈaː
Garba	ɡˈarba
Hojii	hod͡ʒˈiː
Maaliif	mˈaːlɪːf
Magaalaan	maɡˈaːlaːn
Tulluu	tullˈuː
Walumaa	wˌalumˈaː
a	ˈaː
akkana	akːˈana
akkasuma	ˌakːasˈuma
argitee	ˌarɡɪtˈeː
baasee	bˈaːseː
barruu	barrˈuː
bineensota	bˌineːnsˈota
biyyatti	bˌi??ˈatːɪ
boombii	bˈoːmbɪː
caalaatti	t͡ʃ`aːlˈaːtːɪ
dabarsu	dabˈarsu
dachaa	dat͡ʃˈaː
darbu	dˈarbu
deemaa	dˈeːmaː
dhagahamu	ðˌaɡahˈamu
dhiigni	ðˈiːɡnɪ
dhiisee	ðˈiːseː
fiyuuzyinii	fˌi?ˌuːʒɪnˈiː
fudhatu	fuðˈatu
fuudhee	fˈuːðeː
guddachaa	ɡˌudːat͡ʃˈaː
gurguddaa	ɡˌurɡudːˈaː
guutummaan	ɡˌuːtummˈaːn
guyyaan	ɡuˈ??aːn
hangan	hˈanɡan
ijoollummaa	ˌid͡ʒoːllummˈaː
ilaaluun	ɪlˈaːluːn
irraatti	ɪrrˈaːtːɪ
ittin	ˈitːɪn
jedhuu	d͡ʒeðˈuː
jennee	d͡ʒennˈeː
kenname	kennˈame
kitaabota	kˌitaːbˈota
lola	lˈola
lolaa	lolˈaː
maashinii	mˌaːʃɪnˈiː
mudate	mudˈate
narratti	narrˈatːɪ
qabaatu	k`abˈaːtu
qabachuu	k`ˌabat͡ʃˈuː
qabaman	k`abˈaman
raajii	rˈaːd͡ʒɪː
sirba	sˈirba
tahuu	tahˈuː
tapha	tˈaΦa
tokkoof	tokːˈoːf
turu	tˈuru
waanin	wˈaːnɪn
waldaa	waldˈaː
xalayaa	t`ˌala?ˈaː
yaalaa	?ˈaːlaː
yommuu	ˌ?ommˈuː
Adda	ˈadːa
Baatiriin	bˌaːtɪrˈiːn
Dhuguman	ðuɡˈuman
Gadaan	ɡadˈaːn
Haroon	harˈoːn
II	ˈiː
Jechi	d͡ʒˈet͡ʃɪ
Kitaaba	kɪtˈaːba
Meeppee	mˈeːpːeː
Naannoo	nˈaːnnoː
Naazii	nˈaːtsɪː
Raashiyaa	rˌaːʃɪ?ˈaː
Sababni	sabˈabnɪ
Ummata	ummˈata
aanee	ˈaːneː
achitti	at͡ʃˈitːɪ
adii	adˈiː
argame	arɡˈame
argatte	arɡˈatːe
arguu	arɡˈuː
asattoo	ˌasatːˈoː
bakki	bˈakːɪ
beekta	bˈeːkta
boqonnaa	bˌok`onnˈaː
bulchaa	bult͡ʃˈaː
daldalaa	dˌaldalˈaː
duree	durˈeː
gaafatiin	ɡˌaːfatˈiːn
gahe	ɡˈahe
galle	ɡˈalle
galtee	ɡaltˈeː
gargaaruu	ɡarɡˈaːruː
gidiraa	ɡˌidɪrˈaː
godhamu	ɡoðˈamu
gurguddoo	ɡˌurɡudːˈoː
haati	hˈaːtɪ
hafeen	hafˈeːn
hafne	hˈafne
halluu	hallˈuː
humnaa	humnˈaː
ilaalu	ɪlˈaːlu
ishe	ˈiʃe
jedhamtu	d͡ʒeðˈamtu
jiraata	d͡ʒɪrˈaːta
jiranii	d͡ʒˌiranˈiː
kiyyaa	kɪˈ??aː
kootii	kˈoːtɪː
maatiin	mˈaːtɪːn
manni	mˈannɪ
miidhaa	mˈiːðaː
nafxanyaa	nˌaft`aɲˈaː
nuuf	nˈuːf
per	pˈer
qophii	k`oΦˈiː
seena	sˈeːna
shanii	ʃanˈiː
sodaa	sodˈaː
sodaan	sodˈaːn
taasise	taːsˈise
tahe	tˈahe
tajaajilaa	tˌad͡ʒaːd͡ʒɪlˈaː
tajaajilu	tˌad͡ʒaːd͡ʒˈilu
tarii	tarˈiː
tola	tˈola
umriin	umrˈiːn
uummataa	ˌuːmmatˈaː
waanta	wˈaːnta
xixiqqoo	t`ˌit`ɪk`ːˈoː
Dhihaa	ðɪhˈaː
Duusel	dˈuːsel
Guyyaan	ɡuˈ??aːn
Humna	hˈumna
I	ˈiː
Jimmaa	d͡ʒɪmmˈaː
Kompitaroonni	kˌompɪtarˈoːnnɪ
Laatinii	lˌaːtɪnˈiː
Mahaammad	mahˈaːmmad
Mee	mˈeː
Mootummaan	mˌoːtummˈaːn
Naayil	naːˈ?ɪl
Oliiqaan	olˈiːk`aːn
Si	sˈi
Taayitaa	tˌaː?ɪtˈaː
Ummanni	ummˈannɪ
Waaqni	wˈaːk`nɪ
Walakkaa	wˌalakːˈaː
Xaaliyaanii	t`ˌaːlɪ?ˈaːnɪː
ajajaa	ˌad͡ʒad͡ʒˈaː
akkamiin	ˌakːamˈiːn
amanu	amˈanu
argu	ˈarɡu
barachaa	bˌarat͡ʃˈaː
bare	bˈare
barreeffame	bˌarreːffˈame
birra	bˈirra
bittaa	bɪtːˈaː
dabalataa	dˌabalatˈaː
dabarse	dabˈarse
dabarsuu	dˌabarsˈuː
darban	dˈarban
dhaaba	ðˈaːba
dhagahama	ðˌaɡahˈama
diina	dˈiːna
diinagdee	dˌiːnaɡdˈeː
dubbatama	dˌubːatˈama
faayidaa	fˌaː?ɪdˈaː
fayyadame	fˌa??adˈame
fii	fˈiː
foon	fˈoːn
gatii	ɡatˈiː
guddicha	ɡudːˈit͡ʃa
hafu	hˈafu
herregaa	hˌerreɡˈaː
horii	horˈiː
ibsuuf	ɪbsˈuːf
isaatiin	ɪsˈaːtɪːn
isaatin	ɪsˈaːtɪn
isatti	ɪsˈatːɪ
jechaa	d͡ʒet͡ʃˈaː
jirruu	d͡ʒɪrrˈuː
kennameef	kˌennamˈeːf
km²	kˌaːmˈaː lˈama
lafee	lafˈeː
leenjii	lˈeːnd͡ʒɪː
madda	mˈadːa
maraatoonii	mˌaraːtˈoːnɪː
murtii	murtˈiː
qaamni	k`ˈaːmnɪ
qilleensaa	k`ɪllˈeːnsaː
reefu	rˈeːfu
sadarka	sadˈarka
summii	summˈiː
tilmaamaan	tɪlmˈaːmaːn
urjii	urd͡ʒˈiː
uumama	uːmˈama
waaqa	wˈaːk`a
waggoota	waɡːˈoːta
warqee	wark`ˈeː
yihuudota	ˌ?ɪhuːdˈota
Abbabaa	ˌabːabˈaː
Abdiisaa	abdˈiːsaː
Arabaa	ˌarabˈaː
Bahaa	bahˈaː
Booranaa	bˌoːranˈaː
Dhuma	ðˈuma
Firaanki	fɪrˈaːnkɪ
Hagayya	hˌaɡaˈ??a
Harmee	harmˈeː
Islaamaa	ɪslˈaːmaː
Kanaafuu	kanˈaːfuː
Kanas	kˈanas
Kunii	kunˈiː
Of	ˈof
Sillaasee	sɪllˈaːseː
Waldaa	waldˈaː
abjuu	abd͡ʒˈuː
ajajni	ad͡ʒˈad͡ʒnɪ
akkanaa	ˌakːanˈaː
akkuman	akːˈuman
anaaloogii	ˌanaːlˈoːɡɪː
baane	bˈaːne
baayoogaazii	bˌaː?oːɡˈaːtsɪː
bayinna	bˌa?ˈinna
bayyee	baˈ??eː
beekan	bˈeːkan
beektu	bˈeːktu
bineensa	bɪnˈeːnsa
bishaanii	bɪʃˈaːnɪː
biyyi	bɪˈ??ɪ
bulaa	bulˈaː
daldala	daldˈala
dandeessu	dandˈeːssu
daqiiqaa	dak`ˈiːk`aː
deebisee	dˌeːbɪsˈeː
dhahaa	ðahˈaː
dhigaa	ðɪɡˈaː
dhihaa	ðɪhˈaː
dhiifama	ðɪːfˈama
dhiphina	ðɪΦˈina
dhukkubbii	ðˌukːubːˈiː
faallaa	fˈaːllaː
fakkaatan	fakːˈaːtan
fida	fˈida
fiduu	fɪdˈuː
fiigicha	fɪːɡˈit͡ʃa
filannoo	fˌilannˈoː
galgalaa	ɡˌalɡalˈaː
gammachuun	ɡˌammat͡ʃˈuːn
goone	ɡˈoːne
gootummaa	ɡˌoːtummˈaː
gurra	ɡˈurra
gurraacha	ɡurrˈaːt͡ʃa
guyyaatti	ɡˌu??ˈaːtːɪ
haasaa	hˈaːsaː
himi	hˈimɪ
hunduma	hundˈuma
ijaan	ɪd͡ʒˈaːn
jaalalli	d͡ʒaːlˈallɪ
jechuunis	d͡ʒet͡ʃˈuːnɪs
jedhus	d͡ʒˈeðus
jenne	d͡ʒˈenne
kaaba	kˈaːba
malle	mˈalle
muka	mˈuka
murteesse	murtˈeːsse
qabattu	k`abˈatːu
rakkisaa	rˌakːɪsˈaː
rakkoon	rakːˈoːn
sababiinsaas	sˌababˈiːnsaːs
siree	sɪrˈeː
speed	spˈeːd
turiin	turˈiːn
weerara	weːrˈara
yaadadhu	ˌ?aːdˈaðu
yaade	?ˈaːde
yerootti	ˌ?erˈoːtːɪ
Agariin	ˌaɡarˈiːn
Haroo	harˈoː
Huseen	husˈeːn
Jaarraa	d͡ʒˈaːrraː
Jarman	d͡ʒˈarman
Jechuun	d͡ʒet͡ʃˈuːn
Kaaba	kˈaːba
Koongoo	kˈoːnɡoː
Kutaan	kutˈaːn
Minilik	mɪnˈilɪk
New	nˈew
Niwuu	nɪwˈuː
Noobelii	nˌoːbelˈiː
Sirni	sˈirnɪ
Takka	tˈakːa
Waaqa	wˈaːk`a
akkaataa	akːˈaːtaː
amino	amˈino
ardii	ardˈiː
arganne	arɡˈanne
baase	bˈaːse
bahu	bˈahu
bakkee	bakːˈeː
baratee	bˌaratˈeː
bodda	bˈodːa
boolla	bˈoːlla
calu	t͡ʃ`ˈalu
dabalaa	dˌabalˈaː
dandeenyu	dandˈeːɲu
de	dˈe
dhaan	ðˈaːn
dhiba	ðˈiba
dhufeenyi	ðufˈeːɲɪ
dubbisee	dˌubːɪsˈeː
egaa	eɡˈaː
fagoo	faɡˈoː
fedhu	fˈeðu
fudhachuun	fˌuðat͡ʃˈuːn
fudhatan	fuðˈatan
galan	ɡˈalan
geesse	ɡˈeːsse
giddu	ɡˈidːu
gootu	ɡˈoːtu
guddoon	ɡudːˈoːn
hiriyaa	hˌirɪ?ˈaː
hojjata	hod͡ʒd͡ʒˈata
hubachuu	hˌubat͡ʃˈuː
ijoolleen	ɪd͡ʒˈoːlleːn
isii	ɪsˈiː
ittuma	ɪtːˈuma
jaalatu	d͡ʒaːlˈatu
jabaa	d͡ʒabˈaː
ka	kˈa
kam	kˈam
kamiinuu	kamˈiːnuː
kanaafis	kanˈaːfɪs
koos	kˈoːs
lakkaawwamu	lˌakːaːwwˈamu
maali	mˈaːlɪ
maddii	madːˈiː
mataan	matˈaːn
mootummoota	mˌoːtummˈoːta
nyaatu	ɲˈaːtu
oduun	odˈuːn
paatentii	pˌaːtentˈiː
qabaa	k`abˈaː
qabatte	k`abˈatːe
raawwachuu	rˌaːwwat͡ʃˈuː
rakkina	rakːˈina
riikardii	rˌiːkardˈiː
sadaffaa	sˌadaffˈaː
seenan	sˈeːnan
seeran	sˈeːran
tarminaalii	tˌarmɪnˈaːlɪː
tilmaaman	tɪlmˈaːman
tokkollee	tˌokːollˈeː
tokkootti	tokːˈoːtːɪ
utuu	utˈuː
uumamuu	ˌuːmamˈuː
waadaa	wˈaːdaː
waantonni	waːntˈonnɪ
wajjiin	wad͡ʒd͡ʒˈiːn
wave	wˈave
Aabbaa	ˈaːbːaː
Amajjii	ˌamad͡ʒd͡ʒˈiː
Ammoo	ammˈoː
Badhaasa	baðˈaːsa
Barnoota	barnˈoːta
Barumsa	barˈumsa
Bitootessa	bˌitoːtˈessa
Dhibeen	ðɪbˈeːn
Ebla	ˈebla
Harargee	hˌararɡˈeː
Hojiin	hod͡ʒˈiːn
Ijiipti	ɪd͡ʒˈiːptɪ
Itoophiyaan	ˌitoːΦˌi?ˈaːn
Kanaafis	kanˈaːfɪs
Kompitarri	kˌompɪtˈarrɪ
Miira	mˈiːra
Nuti	nˈutɪ
Oromo	orˈomo
Qofa	k`ˈofa
Raphael	raΦˈael
Shawaa	ʃawˈaː
Ummatni	ummˈatnɪ
Warra	wˈarra
World	wˈorld
aanu	ˈaːnu
agarsiise	ˌaɡarsˈiːse
alla	ˈalla
ammallee	ˌammallˈeː
anii	anˈiː
argamani	ˌarɡamˈanɪ
argamuu	ˌarɡamˈuː
argan	ˈarɡan
argatee	ˌarɡatˈeː
asoosama	ˌasoːsˈama
baasuu	bˈaːsuː
barreeffamaa	bˌarreːffamˈaː
baruu	barˈuː
beekamaa	bˌeːkamˈaː
beekuu	bˈeːkuː
biyyattii	bˌi??atːˈiː
dararaa	dˌararˈaː
darbaa	darbˈaː
density	densˈit?
dhaabbata	ðaːbːˈata
dheerina	ðeːrˈina
dhufanii	ðˌufanˈiː
dide	dˈide
duraaf	durˈaːf
duuba	dˈuːba
eegalee	ˌeːɡalˈeː
elektiroonikii	ˌelektˌiroːnɪkˈiː
faana	fˈaːna
fincaanii	fɪnt͡ʃ`ˈaːnɪː
fufuun	fufˈuːn
gargaaru	ɡarɡˈaːru
gargara	ɡarɡˈara
gas	ɡˈas
godheen	ɡoðˈeːn
gubbaa	ɡubːˈaː
guddatee	ɡˌudːatˈeː
hallu	hˈallu
hawwii	hawwˈiː
hidhame	hɪðˈame
hiriyoota	hˌirɪ?ˈoːta
hojjachuuf	hˌod͡ʒd͡ʒat͡ʃˈuːf
ibsutti	ɪbsˈutːɪ
isaaniis	ɪsˈaːnɪːs
ittan	ˈitːan
jedhamanii	d͡ʒˌeðamanˈiː
jedhanitti	d͡ʒˌeðanˈitːɪ
jedhutti	d͡ʒeðˈutːɪ
jiddu	d͡ʒˈidːu
jiraate	d͡ʒɪrˈaːte
kaase	kˈaːse
keenyatti	keːɲˈatːɪ
keessati	keːssˈatɪ
keessattuu	kˌeːssatːˈuː
koof	kˈoːf
koree	korˈeː
kufe	kˈufe
manneen	mannˈeːn
maraa	marˈaː
mijataa	mˌid͡ʒatˈaː
moggaafame	mˌoɡːaːfˈame
mosee	mosˈeː
murteessaa	murtˈeːssaː
muuziqaa	mˌuːtsɪk`ˈaː
namichi	namˈit͡ʃɪ
nyaachuu	ɲˈaːt͡ʃuː
oola	ˈoːla
otuu	otˈuː
parsentiin	pˌarsentˈiːn
qabduu	k`abdˈuː
qofaan	k`ofˈaːn
qonnaa	k`onnˈaː
qonnaan	k`onnˈaːn
quba	k`ˈuba
raawwatu	raːwwˈatu
ragaa	raɡˈaː
rakkisa	rakːˈisa
seenu	sˈeːnu
sekendii	sˌekendˈiː
shakkii	ʃakːˈiː
tilmaama	tɪlmˈaːma
turetti	turˈetːɪ
tuubii	tˈuːbɪː
walaloo	wˌalalˈoː
yeroof	ˌ?erˈoːf
Akkam	ˈakːam
Akkuman	akːˈuman
Alamuun	ˌalamˈuːn
Ana	ˈana
Ayyaana	ˌa??ˈaːna
Bakki	bˈakːɪ
Daawud	dˈaːwud
Dambii	dambˈiː
Dargiin	darɡˈiːn
Dhuguma	ðuɡˈuma
Dhukkubni	ðukːˈubnɪ
Haati	hˈaːtɪ
Habashaa	hˌabaʃˈaː
Hayilasillaasee	hˌa?ˌilasɪllˈaːseː
Inumaayyuu	ˌinumaːˈ??uː
Kibbaa	kɪbːˈaː
Kunimmoo	kˌunɪmmˈoː
Magarsaa	mˌaɡarsˈaː
Manni	mˈannɪ
Marsiin	marsˈiːn
Onesmoos	ˌonesmˈoːs
Oromoota	ˌoromˈoːta
Qabsoo	k`absˈoː
Qorannoo	k`ˌorannˈoː
Qorannoon	k`ˌorannˈoːn
Sadarkaa	sˌadarkˈaː
Seelii	sˈeːlɪː
Tiraanzisteriin	tˌiraːntsˌisterˈiːn
Walitti	walˈitːɪ
Wallagga	wallˈaɡːa
afaanota	ˌafaːnˈota
amalli	amˈallɪ
anaan	anˈaːn
argaa	arɡˈaː
argachuun	ˌarɡat͡ʃˈuːn
atumti	atˈumtɪ
baadiyyaa	bˌaːdɪˈ??aː
baasuuf	bˈaːsuːf
baatii	bˈaːtɪː
baatiriin	bˌaːtɪrˈiːn
badhaasa	baðˈaːsa
badu	bˈadu
bahanii	bˌahanˈiː
ballini	ballˈinɪ
bayee	bˌa?ˈeː
chaarjii	t͡ʃˈaːrd͡ʒɪː
daandii	dˈaːndɪː
dandeenya	dandˈeːɲa
dhaqee	ðak`ˈeː
dhibaa	ðɪbˈaː
dhibbantaa	ðˌibːantˈaː
dhibbeentaa	ðɪbːˈeːntaː
dhiyaatan	ðˌi?ˈaːtan
dhiyoo	ðˌi?ˈoː
dogoggora	dˌoɡoɡːˈora
duratti	durˈatːɪ
fagaatee	faɡˈaːteː
fakkaatee	fakːˈaːteː
fakki	fˈakːɪ
fedhiin	feðˈiːn
fiildii	fˈiːldɪː
fiixee	fˈiːt`eː
funyaan	fuɲˈaːn
fuuldura	fuːldˈura
gaaffiin	ɡˈaːffɪːn
gadda	ɡˈadːa
gaddi	ɡˈadːɪ
galuuf	ɡalˈuːf
gargari	ɡarɡˈarɪ
geessu	ɡˈeːssu
godhaa	ɡoðˈaː
godhuu	ɡoðˈuː
guddisuu	ɡˌudːɪsˈuː
haalota	haːlˈota
haaraan	hˈaːraːn
hariiroo	harˈiːroː
hidda	hˈidːa
hidhaatti	hɪðˈaːtːɪ
hiika	hˈiːka
himaa	hɪmˈaː
himee	hɪmˈeː
hoogganaa	hˌoːɡːanˈaː
ibse	ˈibse
ibsuu	ɪbsˈuː
intala	ɪntˈala
irrattis	ɪrrˈatːɪs
ishiin	ɪʃˈiːn
isin	ˈisɪn
ittisuuf	ˌitːɪsˈuːf
jedhamani	d͡ʒˌeðamˈanɪ
jedhetti	d͡ʒeðˈetːɪ
jijjirama	d͡ʒˌid͡ʒd͡ʒɪrˈama
jirran	d͡ʒˈirran
jirtuu	d͡ʒɪrtˈuː
kaabaa	kˈaːbaː
kaleessaa	kalˈeːssaː
kanarra	kanˈarra
karantiin	kˌarantˈiːn
karoora	karˈoːra
keemikaalaa	kˌeːmɪkˈaːlaː
keenyaan	kˈeːɲaːn
keessummaa	kˌeːssummˈaː
kennuuf	kennˈuːf
kuniis	kunˈiːs
kutta	kˈutːa
loltuu	loltˈuː
makame	makˈame
mee	mˈeː
michuu	mɪt͡ʃˈuː
mitteenii	mɪtːˈeːnɪː
moggaa	moɡːˈaː
mucayyoo	mˌut͡ʃ`aˈ??oː
namootaa	namˈoːtaː
niitii	nˈiːtɪː
odeessuu	odˈeːssuː
qabachuuf	k`ˌabat͡ʃˈuːf
qabaniif	k`ˌabanˈiːf
qabattee	k`ˌabatːˈeː
qabeenyaa	k`abˈeːɲaː
qabnee	k`abnˈeː
qabneef	k`abnˈeːf
raawwatamu	rˌaːwwatˈamu
saxaxa	sat`ˈat`a
seenaan	sˈeːnaːn
shoora	ʃˈoːra
sirumaa	sˌirumˈaː
tilmaamuu	tɪlmˈaːmuː
tilmamaan	tˌilmamˈaːn
toluu	tolˈuː
turuu	turˈuː
umuriin	ˌumurˈiːn
uumu	ˈuːmu
waanuma	waːnˈuma
yaadni	?ˈaːdnɪ
Achiin	at͡ʃˈiːn
Amaara	amˈaːra
Ballina	ballˈina
Baqqalaa	bˌak`ːalˈaː
Biiroo	bˈiːroː
Biyya	bɪˈ??a
Dhimma	ðˈimma
Dilbata	dɪlbˈata
Dorgommii	dˌorɡommˈiː
Finfinneetti	fˌinfɪnnˈeːtːɪ
Ganda	ɡˈanda
Hayileen	hˌa?ɪlˈeːn
Indiyaa	ˌindɪ?ˈaː
Kanarraan	kˌanarrˈaːn
Kanarratti	kˌanarrˈatːɪ
Kitaabni	kɪtˈaːbnɪ
Kurii	kurˈiː
Lafa	lˈafa
Oromoof	ˌoromˈoːf
Oromoonni	ˌoromˈoːnnɪ
Oromootti	ˌoromˈoːtːɪ
Rakkoo	rakːˈoː
Seenaa	sˈeːnaː
Tokko	tˈokːo
Tokkummaa	tˌokːummˈaː
Tsahaay	tsahˈaː?
WBO	wbˈo
Wallaggaa	wˌallaɡːˈaː
Westiingihaawus	wˌestɪːnɡɪhˈaːwus
addunyaan	ˌadːuɲˈaːn
ajjeesee	ad͡ʒd͡ʒˈeːseː
akkasitti	ˌakːasˈitːɪ
argine	arɡˈine
arguuf	arɡˈuːf
baakteeriyaa	bˌaːkteːrˌi?ˈaː
baayyina	bˌaː??ˈina
bahaatti	bahˈaːtːɪ
barachuuf	bˌarat͡ʃˈuːf
barbaachisa	bˌarbaːt͡ʃˈisa
bareedaa	barˈeːdaː
barreessee	barrˈeːsseː
battalumatti	bˌatːalumˈatːɪ
bayyinan	bˌa??ˈinan
beektaa	bˈeːktaː
beekuun	bˈeːkuːn
bekkama	bekːˈama
biqiltuu	bˌik`ɪltˈuː
bitaa	bɪtˈaː
booddee	bˈoːdːeː
busaa	busˈaː
carraan	t͡ʃ`arrˈaːn
cina	t͡ʃ`ˈina
cinaa	t͡ʃ`ɪnˈaː
dabalata	dˌabalˈata
dabarsee	dˌabarsˈeː
dadhabe	daðˈabe
dandii	dandˈiː
deemuuf	dˈeːmuːf
dhaabe	ðˈaːbe
dhabee	ðabˈeː
dhokannaa	ðˌokannˈaː
dhufeera	ðufˈeːra
dursaa	dursˈaː
eessaa	ˈeːssaː
elektrikii	ˌelektrɪkˈiː
fakkaate	fakːˈaːte
falmaa	falmˈaː
fesashi	fesˈaʃɪ
fide	fˈide
fudhanne	fuðˈanne
fufee	fufˈeː
fufuu	fufˈuː
funaantuu	funˈaːntuː
gaafachuu	ɡˌaːfat͡ʃˈuː
gaariin	ɡˈaːrɪːn
gabatee	ɡˌabatˈeː
galaanaa	ɡalˈaːnaː
galche	ɡˈalt͡ʃe
gammoojjii	ɡammˈoːd͡ʒd͡ʒɪː
gamoo	ɡamˈoː
garaagaraa	ɡˌaraːɡarˈaː
garagaraa	ɡˌaraɡarˈaː
godheera	ɡoðˈeːra
guutame	ɡuːtˈame
guutuun	ɡˈuːtuːn
haasofne	haːsˈofne
hafee	hafˈeː
hagas	hˈaɡas
haphii	haΦˈiː
hojjetu	hod͡ʒd͡ʒˈetu
hulaa	hulˈaː
ilaala	ɪlˈaːla
ilaallama	ˌilaːllˈama
isaaniitti	ˌisaːnˈiːtːɪ
ispoorii	ɪspˈoːrɪː
jalqabde	d͡ʒalk`ˈabde
jalqabne	d͡ʒalk`ˈabne
jedhurraa	d͡ʒˌeðurrˈaː
jettiin	d͡ʒetːˈiːn
jirus	d͡ʒˈirus
kaa	kˈaː
kaayyoo	kaːˈ??oː
kaleessa	kalˈeːssa
kanaatti	kanˈaːtːɪ
kennan	kˈennan
kiilomeetira	kˌiːlomeːtˈira
kootiin	kˈoːtɪːn
laabiraatorii	lˌaːbɪrˌaːtorˈiː
lamaanuu	lamˈaːnuː
maalii	mˈaːlɪː
male	mˈale
mataasaa	matˈaːsaː
miseensota	mˌiseːnsˈota
moo	mˈoː
mucaan	mut͡ʃ`ˈaːn
murteessuu	murtˈeːssuː
nyaatan	ɲˈaːtan
obboleettii	ˌobːolˈeːtːɪː
oolle	ˈoːlle
oromoo	ˌoromˈoː
plate	plˈate
qabachu	k`abˈat͡ʃu
qabamanii	k`ˌabamanˈiː
qabamuu	k`ˌabamˈuː
qabatanii	k`ˌabatanˈiː
qabeeyyii	k`ˌabeːˈ??ɪː
qabiyyee	k`ˌabɪˈ??eː
qabsoon	k`absˈoːn
qoratu	k`orˈatu
raadaarii	raːdˈaːrɪː
rakkisu	rakːˈisu
saalaa	sˈaːlaː
sabdaneessaa	sˌabdanˈeːssaː
saffisaan	sˌaffɪsˈaːn
sagal	sˈaɡal
sammuun	sammˈuːn
seenuu	sˈeːnuː
semiikondaakterii	sˌemɪːkˌondaːkterˈiː
tarkaanfii	tarkˈaːnfɪː
tiin	tˈiːn
tiyoorii	tˌi?ˈoːrɪː
tiyyaa	tɪˈ??aː
tokkon	tˈokːon
ulfaata	ulfˈaːta
uumaa	ˈuːmaː
uumame	uːmˈame
uummame	uːmmˈame
uummamu	uːmmˈamu
vacuum	vat͡ʃ`ˈuːm
walakkaan	wˌalakːˈaːn
waliinii	walˈiːnɪː
walqunnamtii	wˌalk`unnamtˈiː
xiqqo	t`ˈik`ːo
xiyyeeffannoo	t`ˌi??ˌeːffannˈoː
yaa	?ˈaː
yaadaan	?ˈaːdaːn
yaalan	?ˈaːlan
yaale	?ˈaːle
yihuudotaa	ˌ?ɪhˌuːdotˈaː
