பல	pˈʌlʌ
என	ʲˈenʌ
உலக	ˈulʌɡʌ
ஆக	ˈaːɡʌ
வட	vˈʌɖʌ
of	(͡e͡n)ɒv(͡t͡a)
அரச	ˈaɹʌsʌ
த	tˈʌ
ஐ	ˈa͡ɪ
நகர	nˈʌɡʌɹʌ
சமய	sˈʌmʌjʌ
இன	ˈinʌ
நடன	nˈʌɖʌnʌ
ஏ	jˈeː
மத	mˈʌdʌ
and	(͡e͡n)and(͡t͡a)
தர	tˈʌɹʌ
இதர	ˈidʌɹʌ
ஆன	ˈaːnʌ
மன	mˈʌnʌ
வர	vˈʌɹʌ
The	(͡e͡n)ðə(͡t͡a)
A	ˈeːj
the	(͡e͡n)ðə(͡t͡a)
எ	ʲˈe
II	(͡e͡n)ɹˌə͡ʊmən tˈuː(͡t͡a)
சக	sˈʌɡʌ
சம	sˈʌmʌ
இதய	ˈidʌjʌ
C	sˈiː
அ	ˈa
III	(͡e͡n)ɹˌə͡ʊmən θɹˈiː(͡t͡a)
in	(͡e͡n)ˈɪn(͡t͡a)
இலவச	ˈilʌvˌʌsʌ
I	ˈaːj
கன	ɡˈʌnʌ
x	ˈɛks
B	bˈiː
மர	mˈʌɹʌ
பயண	pˈʌjʌɳʌ
பட	pˈʌɖʌ
n	ˈɛn
மரண	mˈʌɹʌɳʌ
கழக	kˈʌɻʌɡʌ
ஊடக	ˈuːɖʌɡʌ
பண	pˈʌɳʌ
இ	ˈi
இட	ˈiɖʌ
ஓ	ˈoː
வன	vˈʌnʌ
a	ˈeːj
சமண	sˈʌmʌɳʌ
O	ˈoː
அவசர	ˈavʌsˌʌɹʌ
நல	nˈʌlʌ
வளர	vˈʌɭʌɹʌ
X	ˈɛks
உதவ	ˈudʌvʌ
V	vˈiː
உயர	ˈujʌɹʌ
வள	vˈʌɭʌ
H	ˈeːt͡ʃ
IV	(͡e͡n)ɹˌə͡ʊmən fˈɔː(͡t͡a)
ஆலய	ˈaːlʌjʌ
S	ˈɛs
de	(͡e͡n)də(͡t͡a)
N	ˈɛn
India	(͡e͡n)ˈɪndiə(͡t͡a)
F	ˈɛf
R	ˈaːr
or	(͡e͡n)ɔː(͡t͡a)
T	tʰˈiː
P	pˈiː
தடகள	tˈʌɖʌɡˌʌɭʌ
ஈ	ˈiː
தள	tˈʌɭʌ
K	kˈeːj
உணர	ˈuɳʌɹʌ
தல	tˈʌlʌ
அக	ˈaɡʌ
உப	ˈubʌ
for	(͡e͡n)fɔː(͡t͡a)
p	pˈiː
E	ˈiː
D	dˈiː
M	ˈɛm
ரக	ɹˈʌɡʌ
to	(͡e͡n)tuː(͡t͡a)
National	(͡e͡n)nˈaʃənə͡l(͡t͡a)
ஆ	ˈaː
பழ	pˈʌɻʌ
ஊரக	ˈuːɹʌɡʌ
New	(͡e͡n)njˈuː(͡t͡a)
John	(͡e͡n)d͡ʒˈɒn(͡t͡a)
க	kˈʌ
International	(͡e͡n)ˌɪntənˈaʃənə͡l(͡t͡a)
pp	(͡e͡n)pˌiːpˈiː(͡t͡a)
சகல	sˈʌɡʌlʌ
கள	kˈʌɭʌ
ஈய	ˈiːjʌ
CO	(͡e͡n)kˈə͡ʊ(͡t͡a)
மனநல	mˈʌnʌnˌʌlʌ
IP	(͡e͡n)ˌa͡ɪpˈiː(͡t͡a)
pH	pˈiː ˈeːt͡ʃ
on	(͡e͡n)ˈɒn(͡t͡a)
b	bˈiː
University	(͡e͡n)jˌuːnɪvˈɜːsɪti(͡t͡a)
L	ˈɛl
WWE	(͡e͡n)dˌʌbə͡ljˌuːdˌʌbə͡ljˌuːˈiː(͡t͡a)
அகல	ˈaɡʌlʌ
Indian	(͡e͡n)ˈɪndi͡ən(͡t͡a)
G	d͡ʒˈiː
ஆவண	ˈaːvʌɳʌ
f	ˈɛf
by	(͡e͡n)bˈa͡ɪ(͡t͡a)
Tamil	tˈʌmiɻ
பரவ	pˈʌɹʌvʌ
History	(͡e͡n)hˈɪstəɹi(͡t͡a)
World	(͡e͡n)wˈɜːld(͡t͡a)
WWF	(͡e͡n)dˌʌbə͡ljˌuːdˌʌbə͡ljˌuːˈɛf(͡t͡a)
c	sˈiː
கவச	kˈʌvʌsʌ
Institute	(͡e͡n)ˈɪnstɪtjˌuːt(͡t͡a)
Press	(͡e͡n)pɹˈɛs(͡t͡a)
ஓட	ˈoːɖʌ
ஏற	ʲˈeːrʌ
OH	(͡e͡n)ˈə͡ʊ(͡t͡a)
y	wˈaːj
பரத	bˈʌɹʌdʌ
VoIP	(͡e͡n)vˈə͡ʊ ˌa͡ɪpˈiː(͡t͡a)
system	(͡e͡n)sˈɪstəm(͡t͡a)
DC	(͡e͡n)dˌiːsˈiː(͡t͡a)
கனரக	ɡˈʌnʌɹˌʌɡʌ
USB	(͡e͡n)jˌuːˌɛsbˈiː(͡t͡a)
m	ˈɛm
PDF	(͡e͡n)pˌiːdˌiːˈɛf(͡t͡a)
US	(͡e͡n)jˌuːˈɛs(͡t͡a)
Y	wˈaːj
அகர	ˈaɡʌɹʌ
k	kˈeːj
College	(͡e͡n)kˈɒlɪd͡ʒ(͡t͡a)
Singh	(͡e͡n)sˈɪŋ(͡t͡a)
தன	dˈʌnʌ
ஈழ	ˈiːɻʌ
கல	kˈʌlʌ
ப	pˈʌ
Society	(͡e͡n)səsˈa͡ɪ͡əti(͡t͡a)
s	ˈɛs
U	jˈuː
ஆகம	ˈaːɡʌmʌ
உள	ˈuɭʌ
நவ	nˈʌvʌ
et	(͡e͡n)ˈɛt(͡t͡a)
Nokia	(͡e͡n)nˈə͡ʊkiə(͡t͡a)
Research	(͡e͡n)ɹɪsˈɜːt͡ʃ(͡t͡a)
Retrieved	(͡e͡n)ɹɪtɹˈiːvd(͡t͡a)
மண	mˈʌɳʌ
James	(͡e͡n)d͡ʒˈe͡ɪmz(͡t͡a)
Pg	(͡e͡n)pˌiːd͡ʒˈiː(͡t͡a)
உ	ˈu
School	(͡e͡n)skˈuːl(͡t͡a)
DVD	(͡e͡n)dˌiːvˌiːdˈiː(͡t͡a)
ISO	(͡e͡n)ˈa͡ɪzə͡ʊ(͡t͡a)
Z	zˈɛd
ஆட	ˈaːɖʌ
J	d͡ʒˈeːj
page	(͡e͡n)pˈe͡ɪd͡ʒ(͡t͡a)
Chemistry	(͡e͡n)kˈɛmɪstɹi(͡t͡a)
IQ	(͡e͡n)ˈɪk(͡t͡a)
System	(͡e͡n)sˈɪstəm(͡t͡a)
r	ˈaːr
DNS	(͡e͡n)dˌiːˌɛnˈɛs(͡t͡a)
David	(͡e͡n)dˈe͡ɪvɪd(͡t͡a)
α	(͡e͡l)ˈalfa(͡t͡a)
DNA	(͡e͡n)dˌiːˌɛnˈe͡ɪ(͡t͡a)
Windows	(͡e͡n)wˈɪndə͡ʊz(͡t͡a)
UK	(͡e͡n)jˌuːkˈe͡ɪ(͡t͡a)
e	ˈiː
அமர	ˈamʌɹʌ
ஆய	ˈaːjʌ
ஈர	ˈiːɹʌ
GE	(͡e͡n)d͡ʒˈiː(͡t͡a)
i	ˈaːj
இள	ˈiɭʌ
Dr	(͡e͡n)dˈɒktə(͡t͡a)
Robert	(͡e͡n)ɹˈɒbət(͡t͡a)
William	(͡e͡n)wˈɪli͡əm(͡t͡a)
Life	(͡e͡n)lˈa͡ɪf(͡t͡a)
PC	(͡e͡n)pˌiːsˈiː(͡t͡a)
HTML	(͡e͡n)ˌe͡ɪt͡ʃtˌiːˌɛmˈɛl(͡t͡a)
St	(͡e͡n)sənt(͡t͡a)
Thomas	(͡e͡n)tˈɒməs(͡t͡a)
ச	sˈʌ
வசன	vˈʌsʌnʌ
Day	(͡e͡n)dˈe͡ɪ(͡t͡a)
VI	(͡e͡n)vˌiːˈa͡ɪ(͡t͡a)
பவள	pˈʌvʌɭʌ
வ	vˈʌ
ATP	(͡e͡n)ˈatp(͡t͡a)
NO	(͡e͡n)nˈə͡ʊ(͡t͡a)
RFC	(͡e͡n)ˌɑːɹˌɛfsˈiː(͡t͡a)
Science	(͡e͡n)sˈa͡ɪ͡əns(͡t͡a)
d	dˈiː
Q	kjˈuː
தவ	dˈʌvʌ
American	(͡e͡n)ɐmˈɛɹɪkən(͡t͡a)
Book	(͡e͡n)bˈʊk(͡t͡a)
Technology	(͡e͡n)tɛknˈɒləd͡ʒi(͡t͡a)
β	(͡e͡l)vˈita(͡t͡a)
AB	(͡e͡n)ˈab(͡t͡a)
MHz	(͡e͡n)mˈɛɡəhˌɜːts(͡t͡a)
Michael	(͡e͡n)mˈa͡ɪkə͡l(͡t͡a)
தசம	dˈʌsʌmʌ
English	(͡e͡n)ˈɪŋɡlɪʃ(͡t͡a)
Great	(͡e͡n)ɡɹˈe͡ɪt(͡t͡a)
York	(͡e͡n)jˈɔːk(͡t͡a)
from	(͡e͡n)fɹɒm(͡t͡a)
CH	(͡e͡n)sˌiːˈe͡ɪt͡ʃ(͡t͡a)
George	(͡e͡n)d͡ʒˈɔːd͡ʒ(͡t͡a)
Google	(͡e͡n)ɡˈuːɡə͡l(͡t͡a)
ம	mˈʌ
Association	(͡e͡n)ɐsˌə͡ʊsɪˈe͡ɪʃən(͡t͡a)
Sir	(͡e͡n)sˌɜː(͡t͡a)
Sri	(͡e͡n)sɹˌiː(͡t͡a)
மகர	mˈʌɡʌɹʌ
NH	(͡e͡n)ˌɛnˈe͡ɪt͡ʃ(͡t͡a)
Richard	(͡e͡n)ɹˈɪt͡ʃəd(͡t͡a)
al	(͡e͡n)ˈal(͡t͡a)
t	tʰˈiː
Å	(͡e͡n)ˌe͡ɪɹˈɪŋɡ(͡t͡a)
No	(͡e͡n)nˈə͡ʊ(͡t͡a)
Paul	(͡e͡n)pˈɔːl(͡t͡a)
W	dˈʌbʌljuː
acid	(͡e͡n)ˈasɪd(͡t͡a)
g	d͡ʒˈiː
ABC	(͡e͡n)ˌe͡ɪbˌiːsˈiː(͡t͡a)
AI	(͡e͡n)ˌe͡ɪˈa͡ɪ(͡t͡a)
SO	(͡e͡n)sˈə͡ʊ(͡t͡a)
v	vˈiː
Act	(͡e͡n)ˈakt(͡t͡a)
Council	(͡e͡n)kˈa͡ʊnsə͡l(͡t͡a)
House	(͡e͡n)hˈa͡ʊs(͡t͡a)
London	(͡e͡n)lˈʌndən(͡t͡a)
அயன	ˈajʌnʌ
ஒ	ˈo
கவர	kˈʌvʌɹʌ
சமதள	sˈʌmʌdˌʌɭʌ
IBM	(͡e͡n)ˌa͡ɪbˌiːˈɛm(͡t͡a)
Madras	(͡e͡n)mədɹˈɑːs(͡t͡a)
Oxford	(͡e͡n)ˈɒksfəd(͡t͡a)
Park	(͡e͡n)pˈɑːk(͡t͡a)
SAP	(͡e͡n)sˈap(͡t͡a)
Service	(͡e͡n)sˈɜːvɪs(͡t͡a)
Engineering	(͡e͡n)ˌɛnd͡ʒɪnˈi͡əɹɪŋ(͡t͡a)
Group	(͡e͡n)ɡɹˈuːp(͡t͡a)
Journal	(͡e͡n)d͡ʒˈɜːnə͡l(͡t͡a)
River	(͡e͡n)ɹˈɪvə(͡t͡a)
State	(͡e͡n)stˈe͡ɪt(͡t͡a)
q	kjˈuː
θ	(͡e͡l)θˈita(͡t͡a)
ட	ɖˈʌ
Encyclopedia	(͡e͡n)ɛnsˌa͡ɪklə͡ʊpˈiːdi͡ə(͡t͡a)
FIFA	(͡e͡n)fˈiːfə(͡t͡a)
NET	(͡e͡n)nˈɛt(͡t͡a)
km	(͡e͡n)kˌe͡ɪˈɛm(͡t͡a)
உலர	ˈulʌɹʌ
ஊற	ˈuːrʌ
எனற	ʲˈenʌrʌ
Ceylon	(͡e͡n)se͡ɪlˈɒn(͡t͡a)
Charles	(͡e͡n)t͡ʃˈɑːlz(͡t͡a)
Church	(͡e͡n)t͡ʃˈɜːt͡ʃ(͡t͡a)
In	(͡e͡n)ˈɪn(͡t͡a)
MTV	(͡e͡n)ˌɛmtˌiːvˈiː(͡t͡a)
Page	(͡e͡n)pˈe͡ɪd͡ʒ(͡t͡a)
Royal	(͡e͡n)ɹˈɔ͡ɪə͡l(͡t͡a)
வலய	vˈʌlʌjʌ
BC	(͡e͡n)bˌiːsˈiː(͡t͡a)
CIS	(͡e͡n)sˈɪs(͡t͡a)
Dictionary	(͡e͡n)dˈɪkʃənəɹi(͡t͡a)
General	(͡e͡n)d͡ʒˈɛnəɹə͡l(͡t͡a)
La	(͡e͡n)lˌa(͡t͡a)
Law	(͡e͡n)lˈɔː(͡t͡a)
Time	(͡e͡n)tˈa͡ɪm(͡t͡a)
VII	(͡e͡n)ɹˌə͡ʊmən sˈɛvən(͡t͡a)
h	ˈeːt͡ʃ
உதய	ˈudʌjʌ
பரம	pˈʌɹʌmʌ
FA	(͡e͡n)fˈɑː(͡t͡a)
LCD	(͡e͡n)ˌɛlsˌiːdˈiː(͡t͡a)
law	(͡e͡n)lˈɔː(͡t͡a)
number	(͡e͡n)nˈʌmbə(͡t͡a)
ஏரண	ʲˈeːɹʌɳʌ
ஜன	d͡ʒˈʌnʌ
Khan	(͡e͡n)kˈɑːn(͡t͡a)
SAT	(͡e͡n)sˈat(͡t͡a)
An	(͡e͡n)an(͡t͡a)
British	(͡e͡n)bɹˈɪtɪʃ(͡t͡a)
FFT	(͡e͡n)ˌɛfˌɛftˈiː(͡t͡a)
HIV	(͡e͡n)ˌe͡ɪt͡ʃˌa͡ɪvˈiː(͡t͡a)
Joseph	(͡e͡n)d͡ʒˈə͡ʊsəf(͡t͡a)
Man	(͡e͡n)mˈan(͡t͡a)
Red	(͡e͡n)ɹˈɛd(͡t͡a)
SNMP	(͡e͡n)ˌɛsˌɛnˌɛmpˈiː(͡t͡a)
South	(͡e͡n)sˈa͡ʊθ(͡t͡a)
Temple	(͡e͡n)tˈɛmpə͡l(͡t͡a)
WCW	(͡e͡n)dˌʌbə͡ljˌuːsˌiːdˈʌbə͡ljˌuː(͡t͡a)
z	zˈɛd
ஈஐ	ˈiːa͡ɪ
August	(͡e͡n)ˈɔːɡəst(͡t͡a)
Central	(͡e͡n)sˈɛntɹə͡l(͡t͡a)
Company	(͡e͡n)kˈʌmpəni(͡t͡a)
Earth	(͡e͡n)ˈɜːθ(͡t͡a)
Henry	(͡e͡n)hˈɛnɹi(͡t͡a)
Peter	(͡e͡n)pˈiːtə(͡t͡a)
TV	(͡e͡n)tˌiːvˈiː(͡t͡a)
Times	(͡e͡n)tˈa͡ɪmz(͡t͡a)
United	(͡e͡n)juːnˈa͡ɪtɪd(͡t͡a)
theory	(͡e͡n)θˈi͡əɹi(͡t͡a)
அபய	ˈabʌjʌ
CD	(͡e͡n)sˌiːdˈiː(͡t͡a)
De	(͡e͡n)də(͡t͡a)
District	(͡e͡n)dˈɪstɹɪkt(͡t͡a)
Kumar	(͡e͡n)kuːmˈɑː(͡t͡a)
Museum	(͡e͡n)mjuːzˈi͡əm(͡t͡a)
NTSC	(͡e͡n)ˌɛntˌiːˌɛssˈiː(͡t͡a)
Social	(͡e͡n)sˈə͡ʊʃə͡l(͡t͡a)
Union	(͡e͡n)jˈuːni͡ən(͡t͡a)
Vol	(͡e͡n)vˈɒl(͡t͡a)
is	(͡e͡n)ɪz(͡t͡a)
அற	ˈarʌ
ஆழ	ˈaːɻʌ
Al	(͡e͡n)ˈal(͡t͡a)
Development	(͡e͡n)dɪvˈɛləpmənt(͡t͡a)
EU	(͡e͡n)ˌiːjˈuː(͡t͡a)
HD	(͡e͡n)ˌe͡ɪt͡ʃdˈiː(͡t͡a)
IEEE	(͡e͡n)ˌa͡ɪˌiːˌiːˈiː(͡t͡a)
LDAP	(͡e͡n)ˈɛldˈap(͡t͡a)
Mary	(͡e͡n)mˈe͡əɹi(͡t͡a)
OS	(͡e͡n)ˌə͡ʊˈɛs(͡t͡a)
SI	(͡e͡n)sˈiː(͡t͡a)
syndrome	(͡e͡n)sˈɪndɹə͡ʊm(͡t͡a)
இமய	ˈimʌjʌ
இரக	ˈiɹʌɡʌ
உபகரண	ˈubʌɡˌʌɹʌɳʌ
ஊ	ˈuː
ASP	(͡e͡n)ˈasp(͡t͡a)
CFC	(͡e͡n)sˌiːˌɛfsˈiː(͡t͡a)
Devi	(͡e͡n)dɪvi(͡t͡a)
Health	(͡e͡n)hˈɛlθ(͡t͡a)
On	(͡e͡n)ˈɒn(͡t͡a)
Rao	(͡e͡n)ɹˈa͡ʊ(͡t͡a)
Van	(͡e͡n)vˈan(͡t͡a)
XML	(͡e͡n)ˌɛksˌɛmˈɛl(͡t͡a)
cm	(͡e͡n)sˌiːˈɛm(͡t͡a)
function	(͡e͡n)fˈʌŋkʃən(͡t͡a)
reaction	(͡e͡n)ɹɪˈakʃən(͡t͡a)
μ	(͡e͡l)mˈi(͡t͡a)
உணவக	ˈuɳʌvˌʌɡʌ
April	(͡e͡n)ˈe͡ɪpɹə͡l(͡t͡a)
Christian	(͡e͡n)kɹˈɪst͡ʃən(͡t͡a)
Grand	(͡e͡n)ɡɹˈand(͡t͡a)
January	(͡e͡n)d͡ʒˈanjuːəɹi(͡t͡a)
OSPF	(͡e͡n)ˈɒspf(͡t͡a)
Sea	(͡e͡n)sˈiː(͡t͡a)
Theory	(͡e͡n)θˈi͡əɹi(͡t͡a)
Volume	(͡e͡n)vˈɒljuːm(͡t͡a)
der	(͡e͡n)dˈe͡ə(͡t͡a)
la	(͡e͡n)lˌa(͡t͡a)
π	(͡e͡l)pˈi(͡t͡a)
மகத	mˈʌɡʌdʌ
AD	(͡e͡n)ˈad(͡t͡a)
API	(͡e͡n)ˌe͡ɪpˌiːˈa͡ɪ(͡t͡a)
Corporation	(͡e͡n)kˌɔːpəɹˈe͡ɪʃən(͡t͡a)
High	(͡e͡n)hˈa͡ɪ(͡t͡a)
Hz	(͡e͡n)ˌe͡ɪt͡ʃzˈɛd(͡t͡a)
Microsoft	(͡e͡n)mˈa͡ɪkɹəsˌɒft(͡t͡a)
Modern	(͡e͡n)mˈɒdən(͡t͡a)
Number	(͡e͡n)nˈʌmbə(͡t͡a)
Power	(͡e͡n)pˈa͡ʊə(͡t͡a)
See	(͡e͡n)sˈiː(͡t͡a)
as	(͡e͡n)az(͡t͡a)
des	(͡e͡n)dˈɛs(͡t͡a)
o	ˈoː
Arts	(͡e͡n)ˈɑːts(͡t͡a)
Basilica	(͡e͡n)bazˈɪlɪkə(͡t͡a)
City	(͡e͡n)sˈɪti(͡t͡a)
Edward	(͡e͡n)ˈɛdwəd(͡t͡a)
Industrial	(͡e͡n)ɪndˈʌstɹɪəl(͡t͡a)
LCA	(͡e͡n)ˌɛlsˌiːˈe͡ɪ(͡t͡a)
List	(͡e͡n)lˈɪst(͡t͡a)
May	(͡e͡n)mˈe͡ɪ(͡t͡a)
Medical	(͡e͡n)mˈɛdɪkə͡l(͡t͡a)
My	(͡e͡n)mˈa͡ɪ(͡t͡a)
San	(͡e͡n)sˌan(͡t͡a)
Space	(͡e͡n)spˈe͡ɪs(͡t͡a)
language	(͡e͡n)lˈaŋɡwɪd͡ʒ(͡t͡a)
nm	(͡e͡n)ˌɛnˈɛm(͡t͡a)
அவல	ˈavʌlʌ
சமரச	sˈʌmʌɹˌʌsʌ
AC	(͡e͡n)ˌe͡ɪsˈiː(͡t͡a)
Ancient	(͡e͡n)ˈe͡ɪnʃənt(͡t͡a)
Black	(͡e͡n)blˈak(͡t͡a)
CEO	(͡e͡n)sˌiːˌiːˈə͡ʊ(͡t͡a)
CPU	(͡e͡n)sˌiːpˌiːjˈuː(͡t͡a)
Foundation	(͡e͡n)fa͡ʊndˈe͡ɪʃən(͡t͡a)
Government	(͡e͡n)ɡˈʌvənmənt(͡t͡a)
ISBN	(͡e͡n)ˌa͡ɪˌɛsbˌiːˈɛn(͡t͡a)
Martin	(͡e͡n)mˈɑːtɪn(͡t͡a)
Na	(͡e͡n)nˈɑː(͡t͡a)
QoS	(͡e͡n)kˈə͡ʊ(͡t͡a) ˈɛs
USA	(͡e͡n)jˌuːˌɛsˈe͡ɪ(͡t͡a)
VIII	(͡e͡n)ɹˌə͡ʊmən ˈe͡ɪt(͡t͡a)
White	(͡e͡n)wˈa͡ɪt(͡t͡a)
cell	(͡e͡n)sˈɛl(͡t͡a)
cells	(͡e͡n)sˈɛlz(͡t͡a)
tree	(͡e͡n)tɹˈiː(͡t͡a)
with	(͡e͡n)wɪð(͡t͡a)
ஆள	ˈaːɭʌ
ந	nˈʌ
Art	(͡e͡n)ˈɑːt(͡t͡a)
BBC	(͡e͡n)bˌiːbˌiːsˈiː(͡t͡a)
Battle	(͡e͡n)bˈatə͡l(͡t͡a)
Center	(͡e͡n)sˈɛntə(͡t͡a)
Centre	(͡e͡n)sˈɛntə(͡t͡a)
Hindu	(͡e͡n)hˈɪnduː(͡t͡a)
Island	(͡e͡n)ˈa͡ɪlənd(͡t͡a)
Jaffna	(͡e͡n)d͡ʒˈafnə(͡t͡a)
NTFS	(͡e͡n)ˌɛntˌiːˌɛfˈɛs(͡t͡a)
Natural	(͡e͡n)nˈat͡ʃəɹə͡l(͡t͡a)
Organic	(͡e͡n)ɔːɡˈanɪk(͡t͡a)
XI	(͡e͡n)ɹˌə͡ʊmən ɪlˈɛvən(͡t͡a)
log	(͡e͡n)lˈɒɡ(͡t͡a)
model	(͡e͡n)mˈɒdə͡l(͡t͡a)
எழ	ʲˈeɻʌ
ஓர	ˈoːɹʌ
சதம	sˈʌdʌmʌ
தவற	tˈʌvʌrʌ
CPA	(͡e͡n)sˌiːpˌiːˈe͡ɪ(͡t͡a)
Cl	(͡e͡n)sˌiːˈɛl(͡t͡a)
Commission	(͡e͡n)kəmˈɪʃən(͡t͡a)
DBMS	(͡e͡n)dˌiːbˌiːˌɛmˈɛs(͡t͡a)
Energy	(͡e͡n)ˈɛnəd͡ʒi(͡t͡a)
Hall	(͡e͡n)hˈɔːl(͡t͡a)
Jean	(͡e͡n)d͡ʒˈiːn(͡t͡a)
Lepus	(͡e͡n)lˈɛpəs(͡t͡a)
Party	(͡e͡n)pˈɑːti(͡t͡a)
RNA	(͡e͡n)ˌɑːɹˌɛnˈe͡ɪ(͡t͡a)
Ram	(͡e͡n)ɹˈam(͡t͡a)
WHO	(͡e͡n)hˈuː(͡t͡a)
Women	(͡e͡n)wˈɪmɪn(͡t͡a)
disease	(͡e͡n)dɪzˈiːz(͡t͡a)
history	(͡e͡n)hˈɪstəɹi(͡t͡a)
water	(͡e͡n)wˈɔːtə(͡t͡a)
தட	dˈʌɖʌ
ரத	ɹˈʌdʌ
Cambridge	(͡e͡n)kˈe͡ɪmbɹɪd͡ʒ(͡t͡a)
Culture	(͡e͡n)kˈʌlt͡ʃə(͡t͡a)
Digital	(͡e͡n)dˈɪd͡ʒɪtə͡l(͡t͡a)
First	(͡e͡n)fˈɜːst(͡t͡a)
Information	(͡e͡n)ˌɪnfəmˈe͡ɪʃən(͡t͡a)
Inorganic	(͡e͡n)ˌɪnɔːɡˈanɪk(͡t͡a)
King	(͡e͡n)kˈɪŋ(͡t͡a)
Language	(͡e͡n)lˈaŋɡwɪd͡ʒ(͡t͡a)
Nadu	(͡e͡n)nˈɑːduː(͡t͡a)
Network	(͡e͡n)nˈɛtwɜːk(͡t͡a)
SEC	(͡e͡n)sˈɛk(͡t͡a)
September	(͡e͡n)sɛptˈɛmbə(͡t͡a)
at	(͡e͡n)at(͡t͡a)
ஓத	ˈoːdʌ
கண	kˈʌɳʌ
மரகத	mˈʌɹʌɡˌʌdʌ
AT	(͡e͡n)at(͡t͡a)
Air	(͡e͡n)ˈe͡ə(͡t͡a)
Brown	(͡e͡n)bɹˈa͡ʊn(͡t͡a)
CIA	(͡e͡n)sˌiːˌa͡ɪˈe͡ɪ(͡t͡a)
Delhi	(͡e͡n)dˈɛli(͡t͡a)
East	(͡e͡n)ˈiːst(͡t͡a)
Force	(͡e͡n)fˈɔːs(͡t͡a)
HCl	(͡e͡n)ˌe͡ɪt͡ʃsˌiːˈɛl(͡t͡a)
IPsec	(͡e͡n)a͡ɪ sˈɛk(͡t͡a)
March	(͡e͡n)mˈɑːt͡ʃ(͡t͡a)
MeV	(͡e͡n)mˌiː(͡t͡a) vˈiː
News	(͡e͡n)njˈuːz(͡t͡a)
November	(͡e͡n)nə͡ʊvˈɛmbə(͡t͡a)
PIN	(͡e͡n)pˈɪn(͡t͡a)
Survey	(͡e͡n)sˈɜːve͡ɪ(͡t͡a)
War	(͡e͡n)wˈɔː(͡t͡a)
an	(͡e͡n)an(͡t͡a)
energy	(͡e͡n)ˈɛnəd͡ʒi(͡t͡a)
ஃ	ˈʌɡh
ஆவன	ˈaːvʌnʌ
AMD	(͡e͡n)ˌe͡ɪˌɛmdˈiː(͡t͡a)
Board	(͡e͡n)bˈɔːd(͡t͡a)
CGI	(͡e͡n)sˌiːd͡ʒˌiːˈa͡ɪ(͡t͡a)
Code	(͡e͡n)kˈə͡ʊd(͡t͡a)
Handbook	(͡e͡n)hˈandbʊk(͡t͡a)
Human	(͡e͡n)hjˈuːmən(͡t͡a)
ID	(͡e͡n)a͡ɪdˈiː(͡t͡a)
ISDN	(͡e͡n)ˈɪsdən(͡t͡a)
IX	(͡e͡n)ɹˌə͡ʊmən nˈa͡ɪn(͡t͡a)
Internet	(͡e͡n)ˈɪntənˌɛt(͡t͡a)
Land	(͡e͡n)lˈand(͡t͡a)
Ph	(͡e͡n)pˌiːˈe͡ɪt͡ʃ(͡t͡a)
Rh	(͡e͡n)ˌɑːɹˈe͡ɪt͡ʃ(͡t͡a)
UEFA	(͡e͡n)jˈuːfə(͡t͡a)
UV	(͡e͡n)jˌuːvˈiː(͡t͡a)
Web	(͡e͡n)wˈɛb(͡t͡a)
effect	(͡e͡n)ɪfˈɛkt(͡t͡a)
point	(͡e͡n)pˈɔ͡ɪnt(͡t͡a)
sequence	(͡e͡n)sˈiːkwəns(͡t͡a)
u	jˈuː
von	(͡e͡n)vˈɒn(͡t͡a)
½	ˈaɹa͡ɪ
σ	(͡e͡l)sˈiɣma(͡t͡a)
ஆர	ˈaːɹʌ
உர	ˈuɹʌ
ஏல	ʲˈeːlʌ
Ca	(͡e͡n)kˈɑː(͡t͡a)
Common	(͡e͡n)kˈɒmən(͡t͡a)
DCS	(͡e͡n)dˌiːsˌiːˈɛs(͡t͡a)
Ed	(͡e͡n)ˈɛd(͡t͡a)
Education	(͡e͡n)ˌɛd͡ʒuːkˈe͡ɪʃən(͡t͡a)
Empire	(͡e͡n)ˈɛmpa͡ɪ͡ə(͡t͡a)
IDE	(͡e͡n)ˈa͡ɪd(͡t͡a)
IFRS	(͡e͡n)ˈɪfrz(͡t͡a)
Index	(͡e͡n)ˈɪndɛks(͡t͡a)
LTE	(͡e͡n)ˌɛltˌiːˈiː(͡t͡a)
League	(͡e͡n)lˈiːɡ(͡t͡a)
Louis	(͡e͡n)lˈuːi(͡t͡a)
MB	(͡e͡n)ˌɛmbˈiː(͡t͡a)
October	(͡e͡n)ɒktˈə͡ʊbə(͡t͡a)
Open	(͡e͡n)ˈə͡ʊpən(͡t͡a)
PLC	(͡e͡n)pˌiːˌɛlsˈiː(͡t͡a)
Public	(͡e͡n)pˈʌblɪk(͡t͡a)
Rights	(͡e͡n)ɹˈa͡ɪts(͡t͡a)
Sastri	(͡e͡n)sˈastɹi(͡t͡a)
Sciences	(͡e͡n)sˈa͡ɪ͡ənsɪz(͡t͡a)
data	(͡e͡n)dˈe͡ɪtə(͡t͡a)
ed	(͡e͡n)ˈɛd(͡t͡a)
edition	(͡e͡n)ɪdˈɪʃən(͡t͡a)
process	(͡e͡n)pɹˈə͡ʊsɛs(͡t͡a)
time	(͡e͡n)tˈa͡ɪm(͡t͡a)
ஏக	ʲˈeːɡʌ
Bank	(͡e͡n)bˈaŋk(͡t͡a)
CE	(͡e͡n)sˈiː(͡t͡a)
Control	(͡e͡n)kəntɹˈə͡ʊl(͡t͡a)
EPA	(͡e͡n)ˈɛpə(͡t͡a)
From	(͡e͡n)fɹɒm(͡t͡a)
GSM	(͡e͡n)d͡ʒˌiːˌɛsˈɛm(͡t͡a)
Hill	(͡e͡n)hˈɪl(͡t͡a)
IIS	(͡e͡n)ˌa͡ɪˌa͡ɪˈɛs(͡t͡a)
IT	(͡e͡n)ˌa͡ɪtˈiː(͡t͡a)
Java	(͡e͡n)d͡ʒˈɑːvə(͡t͡a)
Lake	(͡e͡n)lˈe͡ɪk(͡t͡a)
Lanka	(͡e͡n)lˈaŋkə(͡t͡a)
Liber	(͡e͡n)lˈa͡ɪbə(͡t͡a)
Master	(͡e͡n)mˈastə(͡t͡a)
McG	(͡e͡n)mə(͡t͡a) d͡ʒˈiː
Muhammad	(͡e͡n)məhˈamɪd(͡t͡a)
Music	(͡e͡n)mjˈuːzɪk(͡t͡a)
One	(͡e͡n)wˈɒn(͡t͡a)
Protocol	(͡e͡n)pɹˈə͡ʊtəkˌɒl(͡t͡a)
Revolution	(͡e͡n)ɹˌɛvəlˈuːʃən(͡t͡a)
Saint	(͡e͡n)sˈe͡ɪnt(͡t͡a)
TCP	(͡e͡n)tˌiːsˌiːpˈiː(͡t͡a)
da	(͡e͡n)dˈɑː(͡t͡a)
gene	(͡e͡n)d͡ʒˈiːn(͡t͡a)
mmHg	(͡e͡n)ˌɛmˈɛm ˌe͡ɪt͡ʃd͡ʒˈiː(͡t͡a)
சத	sˈʌdʌ
பழக	pˈʌɻʌɡʌ
Asia	(͡e͡n)ˈe͡ɪʃə(͡t͡a)
Award	(͡e͡n)ɐwˈɔːd(͡t͡a)
CAD	(͡e͡n)kˈad(͡t͡a)
Canon	(͡e͡n)kˈanən(͡t͡a)
Demand	(͡e͡n)dɪmˈand(͡t͡a)
FM	(͡e͡n)ˌɛfˈɛm(͡t͡a)
Federation	(͡e͡n)fˌɛdəɹˈe͡ɪʃən(͡t͡a)
Film	(͡e͡n)fˈɪlm(͡t͡a)
Francis	(͡e͡n)fɹˈansɪs(͡t͡a)
Golden	(͡e͡n)ɡˈə͡ʊldən(͡t͡a)
HTTP	(͡e͡n)ˌe͡ɪt͡ʃtˌiːtˌiːpˈiː(͡t͡a)
Kingdom	(͡e͡n)kˈɪŋdəm(͡t͡a)
Little	(͡e͡n)lˈɪtə͡l(͡t͡a)
Management	(͡e͡n)mˈanɪd͡ʒmənt(͡t͡a)
Maria	(͡e͡n)mɐɹˈiːə(͡t͡a)
Movement	(͡e͡n)mˈuːvmənt(͡t͡a)
Operation	(͡e͡n)ˌɒpəɹˈe͡ɪʃən(͡t͡a)
Our	(͡e͡n)ˌa͡ʊə(͡t͡a)
Police	(͡e͡n)pəlˈiːs(͡t͡a)
Pontificalis	(͡e͡n)pɒntˈɪfɪkˈɑːliz(͡t͡a)
SDK	(͡e͡n)ˌɛsdˌiːkˈe͡ɪ(͡t͡a)
method	(͡e͡n)mˈɛθəd(͡t͡a)
science	(͡e͡n)sˈa͡ɪ͡əns(͡t͡a)
van	(͡e͡n)vˈan(͡t͡a)
ஊக	ˈuːɡʌ
கவன	ɡˈʌvʌnʌ
Africa	(͡e͡n)ˈafɹɪkə(͡t͡a)
CRT	(͡e͡n)sˌiːˌɑːtˈiː(͡t͡a)
Chemical	(͡e͡n)kˈɛmɪkə͡l(͡t͡a)
December	(͡e͡n)dɪsˈɛmbə(͡t͡a)
EOS	(͡e͡n)ɪˈə͡ʊz(͡t͡a)
Elements	(͡e͡n)ˈɛlɪmənts(͡t͡a)
February	(͡e͡n)fˈɛbɹuːəɹi(͡t͡a)
Free	(͡e͡n)fɹˈiː(͡t͡a)
GDP	(͡e͡n)d͡ʒˌiːdˌiːpˈiː(͡t͡a)
Home	(͡e͡n)hˈə͡ʊm(͡t͡a)
July	(͡e͡n)d͡ʒuːlˈa͡ɪ(͡t͡a)
KPMG	(͡e͡n)kˌe͡ɪpˌiːˌɛmd͡ʒˈiː(͡t͡a)
Kerala	(͡e͡n)kˈɛɹələ(͡t͡a)
Lady	(͡e͡n)lˈe͡ɪdi(͡t͡a)
Li	(͡e͡n)lˈa͡ɪ(͡t͡a)
Limited	(͡e͡n)lˈɪmɪtɪd(͡t͡a)
Manual	(͡e͡n)mˈanjuːə͡l(͡t͡a)
NADH	(͡e͡n)nˈad(͡t͡a)
North	(͡e͡n)nˈɔːθ(͡t͡a)
Nuclear	(͡e͡n)njˈuːkli͡ə(͡t͡a)
Part	(͡e͡n)pˈɑːt(͡t͡a)
Physics	(͡e͡n)fˈɪzɪks(͡t͡a)
RAM	(͡e͡n)ɹˈam(͡t͡a)
SOAP	(͡e͡n)sˈə͡ʊp(͡t͡a)
UNICEF	(͡e͡n)jˈuːnɪsˌɛf(͡t͡a)
West	(͡e͡n)wˈɛst(͡t͡a)
line	(͡e͡n)lˈa͡ɪn(͡t͡a)
state	(͡e͡n)stˈe͡ɪt(͡t͡a)
zone	(͡e͡n)zˈə͡ʊn(͡t͡a)
ஆல	ˈaːlʌ
உவம	ˈuvʌmʌ
கனக	kˈʌnʌɡʌ
தடய	tˈʌɖʌjʌ
மக	mˈʌɡʌ
மட	mˈʌɖʌ
Age	(͡e͡n)ˈe͡ɪd͡ʒ(͡t͡a)
Alfred	(͡e͡n)ˈalfɹɪd(͡t͡a)
Arthur	(͡e͡n)ˈɑːθə(͡t͡a)
Books	(͡e͡n)bˈʊks(͡t͡a)
China	(͡e͡n)t͡ʃˈa͡ɪnə(͡t͡a)
Club	(͡e͡n)klˈʌb(͡t͡a)
Fe	(͡e͡n)fˈiː(͡t͡a)
Fort	(͡e͡n)fˈɔːt(͡t͡a)
God	(͡e͡n)ɡˈɒd(͡t͡a)
ISP	(͡e͡n)ˌa͡ɪˌɛspˈiː(͡t͡a)
Imperial	(͡e͡n)ɪmpˈi͡əɹiə͡l(͡t͡a)
Jesus	(͡e͡n)d͡ʒˈiːzəs(͡t͡a)
Johann	(͡e͡n)jˈə͡ʊhan(͡t͡a)
Kamath	(͡e͡n)kˈamaθ(͡t͡a)
LDL	(͡e͡n)ˌɛldˌiːˈɛl(͡t͡a)
MIT	(͡e͡n)ˌɛmˌa͡ɪtˈiː(͡t͡a)
MRI	(͡e͡n)ˌɛmˌɑːɹˈa͡ɪ(͡t͡a)
Mount	(͡e͡n)mˈa͡ʊnt(͡t͡a)
NBC	(͡e͡n)ˌɛnbˌiːsˈiː(͡t͡a)
Paris	(͡e͡n)pˈaɹɪs(͡t͡a)
Project	(͡e͡n)pɹˈɒd͡ʒɛkt(͡t͡a)
Published	(͡e͡n)pˈʌblɪʃt(͡t͡a)
Roman	(͡e͡n)ɹˈə͡ʊmən(͡t͡a)
Rural	(͡e͡n)ɹˈʊ͡əɹə͡l(͡t͡a)
Si	(͡e͡n)sˈiː(͡t͡a)
Trust	(͡e͡n)tɹˈʌst(͡t͡a)
XII	(͡e͡n)ɹˌə͡ʊmən twˈɛlv(͡t͡a)
Year	(͡e͡n)jˈi͡ə(͡t͡a)
mRNA	ˈɛm (͡e͡n)ˌɑːɹˌɛnˈe͡ɪ(͡t͡a)
mate	(͡e͡n)mˈe͡ɪt(͡t͡a)
matrix	(͡e͡n)mˈe͡ɪtɹɪks(͡t͡a)
network	(͡e͡n)nˈɛtwɜːk(͡t͡a)
therapy	(͡e͡n)θˈɛɹəpi(͡t͡a)
ல	lˈʌ
ABB	(͡e͡n)ˈab(͡t͡a)
AM	(͡e͡n)am(͡t͡a)
Abdul	(͡e͡n)ˈabdʊl(͡t͡a)
All	(͡e͡n)ˈɔːl(͡t͡a)
Analysis	(͡e͡n)ɐnˈaləsˌɪs(͡t͡a)
Auto	(͡e͡n)ˈɔːtə͡ʊ(͡t͡a)
Co	(͡e͡n)kˈə͡ʊ(͡t͡a)
DFT	(͡e͡n)dˌiːˌɛftˈiː(͡t͡a)
Daniel	(͡e͡n)dˈanjə͡l(͡t͡a)
EA	(͡e͡n)ˈiː(͡t͡a)
El	(͡e͡n)ˌɛl(͡t͡a)
FDA	(͡e͡n)ˌɛfdˌiːˈe͡ɪ(͡t͡a)
GPRS	(͡e͡n)d͡ʒˌiːpˌiːˌɑːɹˈɛs(͡t͡a)
Gandhi	(͡e͡n)ɡˈɑːndi(͡t͡a)
Gazetteer	(͡e͡n)ɡəzɪtˈi͡ə(͡t͡a)
Global	(͡e͡n)ɡlˈə͡ʊbə͡l(͡t͡a)
Greenwood	(͡e͡n)ɡɹˈiːnwʊd(͡t͡a)
Holy	(͡e͡n)hˈə͡ʊli(͡t͡a)
Jacob	(͡e͡n)d͡ʒˈe͡ɪkəb(͡t͡a)
Lawrence	(͡e͡n)lˈɒɹəns(͡t͡a)
Library	(͡e͡n)lˈa͡ɪbɹəɹi(͡t͡a)
MGM	(͡e͡n)ˌɛmd͡ʒˌiːˈɛm(͡t͡a)
Mark	(͡e͡n)mˈɑːk(͡t͡a)
NSS	(͡e͡n)ˌɛnˌɛsˈɛs(͡t͡a)
ST	(͡e͡n)sənt(͡t͡a)
Star	(͡e͡n)stˈɑː(͡t͡a)
Stephen	(͡e͡n)stˈiːvən(͡t͡a)
Story	(͡e͡n)stˈɔːɹi(͡t͡a)
Vietnam	(͡e͡n)vˌiːətnˈɑːm(͡t͡a)
di	(͡e͡n)dˌɪ(͡t͡a)
engineering	(͡e͡n)ˌɛnd͡ʒɪnˈi͡əɹɪŋ(͡t͡a)
field	(͡e͡n)fˈiːld(͡t͡a)
mm	(͡e͡n)ˌɛmˈɛm(͡t͡a)
ppm	(͡e͡n)pˌiːpˌiːˈɛm(͡t͡a)
rate	(͡e͡n)ɹˈe͡ɪt(͡t͡a)
இல	ˈilʌ
ய	jˈʌ
வண	vˈʌɳʌ
ABO	(͡e͡n)ɐbˈə͡ʊ(͡t͡a)
AU	(͡e͡n)ˌə͡ʊ(͡t͡a)
Academy	(͡e͡n)ɐkˈadəmi(͡t͡a)
Administration	(͡e͡n)ɐdmˌɪnɪstɹˈe͡ɪʃən(͡t͡a)
Advanced	(͡e͡n)ɐdvˈanst(͡t͡a)
Architecture	(͡e͡n)ˈɑːkɪtˌɛkt͡ʃə(͡t͡a)
As	(͡e͡n)az(͡t͡a)
By	(͡e͡n)bˈa͡ɪ(͡t͡a)
CBS	(͡e͡n)sˌiːbˌiːˈɛs(͡t͡a)
Carl	(͡e͡n)kˈɑːl(͡t͡a)
Cu	(͡e͡n)kˈuː(͡t͡a)
Cup	(͡e͡n)kˈʌp(͡t͡a)
Earnshaw	(͡e͡n)ˈɜːnʃɔː(͡t͡a)
IKEA	(͡e͡n)a͡ɪkˈiːə(͡t͡a)
IRS	(͡e͡n)ˌa͡ɪˌɑːɹˈɛs(͡t͡a)
Inc	(͡e͡n)ˈɪŋk(͡t͡a)
LAN	(͡e͡n)lˈan(͡t͡a)
Le	(͡e͡n)lə(͡t͡a)
MW	(͡e͡n)ˌɛmdˈʌbə͡ljˌuː(͡t͡a)
Mac	(͡e͡n)mˈak(͡t͡a)
Medicine	(͡e͡n)mˈɛdsən(͡t͡a)
Mg	(͡e͡n)ˌɛmd͡ʒˈiː(͡t͡a)
NBA	(͡e͡n)ˌɛnbˌiːˈe͡ɪ(͡t͡a)
Of	(͡e͡n)ɒv(͡t͡a)
Office	(͡e͡n)ˈɒfɪs(͡t͡a)
PLM	(͡e͡n)pˌiːˌɛlˈɛm(͡t͡a)
Peace	(͡e͡n)pˈiːs(͡t͡a)
Pope	(͡e͡n)pˈə͡ʊp(͡t͡a)
Post	(͡e͡n)pˈə͡ʊst(͡t͡a)
Prize	(͡e͡n)pɹˈa͡ɪz(͡t͡a)
Publishing	(͡e͡n)pˈʌblɪʃɪŋ(͡t͡a)
RO	(͡e͡n)ɹˈə͡ʊ(͡t͡a)
Raja	(͡e͡n)ɹˈɑːd͡ʒə(͡t͡a)
Reddy	(͡e͡n)ɹˈɛdi(͡t͡a)
Review	(͡e͡n)ɹɪvjˈuː(͡t͡a)
SQL	(͡e͡n)ˌɛskjˌuːˈɛl(͡t͡a)
Santa	(͡e͡n)sˈantə(͡t͡a)
States	(͡e͡n)stˈe͡ɪts(͡t͡a)
UVB	(͡e͡n)ˈʌvb(͡t͡a)
Virtual	(͡e͡n)vˈɜːt͡ʃuːə͡l(͡t͡a)
Water	(͡e͡n)wˈɔːtə(͡t͡a)
Western	(͡e͡n)wˈɛstən(͡t͡a)
art	(͡e͡n)ˈɑːt(͡t͡a)
day	(͡e͡n)dˈe͡ɪ(͡t͡a)
kHz	kˈeːj (͡e͡n)ˌe͡ɪt͡ʃzˈɛd(͡t͡a)
km²	(͡e͡n)skwˌe͡əkɪlˈɒmɪtəz(͡t͡a)
mph	(͡e͡n)ˌɛmpˌiːˈe͡ɪt͡ʃ(͡t͡a)
pages	(͡e͡n)pˈe͡ɪd͡ʒɪz(͡t͡a)
series	(͡e͡n)sˈi͡əɹiz(͡t͡a)
sp	(͡e͡n)ˌɛspˈiː(͡t͡a)
space	(͡e͡n)spˈe͡ɪs(͡t͡a)
ƒ	(͡e͡n)kurijzˌɔːɹɑːˈonrɑːˈonbdɔːɹɑːirdɳˈɔːɹɑː(͡t͡a)
γ	(͡e͡l)ɣˈama(͡t͡a)
δ	(͡e͡l)ðˈelta(͡t͡a)
ஔ	ˈa͡ʊ
யவன	jˈʌvʌnʌ
ழ	ɻˈʌ
Airport	(͡e͡n)ˈe͡əpɔːt(͡t͡a)
Asian	(͡e͡n)ˈe͡ɪʒən(͡t͡a)
Bay	(͡e͡n)bˈe͡ɪ(͡t͡a)
Big	(͡e͡n)bˈɪɡ(͡t͡a)
Bill	(͡e͡n)bˈɪl(͡t͡a)
CT	(͡e͡n)sˌiːtˈiː(͡t͡a)
Chandra	(͡e͡n)t͡ʃˈʌndɹə(͡t͡a)
Committee	(͡e͡n)kəmˈɪti(͡t͡a)
Data	(͡e͡n)dˈe͡ɪtə(͡t͡a)
European	(͡e͡n)jˌʊ͡əɹəpˈi͡ən(͡t͡a)
Jan	(͡e͡n)d͡ʒˈan(͡t͡a)
June	(͡e͡n)d͡ʒˈuːn(͡t͡a)
Knight	(͡e͡n)nˈa͡ɪt(͡t͡a)
Krishna	(͡e͡n)kɹˈɪʃnə(͡t͡a)
Lehman	(͡e͡n)lˈe͡ɪmən(͡t͡a)
Lewis	(͡e͡n)lˈuːɪs(͡t͡a)
Light	(͡e͡n)lˈa͡ɪt(͡t͡a)
Memory	(͡e͡n)mˈɛməɹi(͡t͡a)
NT	(͡e͡n)ˌɛntˈiː(͡t͡a)
PD	(͡e͡n)pˌiːdˈiː(͡t͡a)
PM	(͡e͡n)pˌiːˈɛm(͡t͡a)
PSTN	(͡e͡n)pˌiːˌɛstˌiːˈɛn(͡t͡a)
Pb	(͡e͡n)pˌiːbˈiː(͡t͡a)
Period	(͡e͡n)pˈi͡əɹɪəd(͡t͡a)
Perl	(͡e͡n)pˈɜːl(͡t͡a)
SEO	(͡e͡n)sˈiːə͡ʊ(͡t͡a)
Server	(͡e͡n)sˈɜːvə(͡t͡a)
Smith	(͡e͡n)smˈɪθ(͡t͡a)
Software	(͡e͡n)sˈɒftwe͡ə(͡t͡a)
Special	(͡e͡n)spˈɛʃə͡l(͡t͡a)
Thanjavur	(͡e͡n)θˈand͡ʒɐvˌɜː(͡t͡a)
USD	jˈues dˈolʌz
Valley	(͡e͡n)vˈalɪ(͡t͡a)
Walter	(͡e͡n)wˈɒltə(͡t͡a)
Zn	(͡e͡n)zˌɛdˈɛn(͡t͡a)
amp	(͡e͡n)ˈamp(͡t͡a)
area	(͡e͡n)ˈe͡əɹi͡ə(͡t͡a)
en	(͡e͡n)ˈɛn(͡t͡a)
minor	(͡e͡n)mˈa͡ɪnə(͡t͡a)
per	(͡e͡n)pɜː(͡t͡a)
period	(͡e͡n)pˈi͡əɹɪəd(͡t͡a)
value	(͡e͡n)vˈaljuː(͡t͡a)
vol	(͡e͡n)vˈɒl(͡t͡a)
w	dˈʌbʌljuː
²	ˈiɹʌɳɖʉ
வரத	vˈʌɹʌdʌ
AG	(͡e͡n)ˈaɡ(͡t͡a)
ARM	(͡e͡n)ˈɑːm(͡t͡a)
Alexander	(͡e͡n)ˌalɪɡzˈandə(͡t͡a)
Army	(͡e͡n)ˈɑːmi(͡t͡a)
Article	(͡e͡n)ˈɑːtɪkə͡l(͡t͡a)
Assembly	(͡e͡n)ɐsˈɛmblɪ(͡t͡a)
Bitcoin	(͡e͡n)bˈɪtkɔ͡ɪn(͡t͡a)
Cathedral	(͡e͡n)kɐθˈiːdɹə͡l(͡t͡a)
Cell	(͡e͡n)sˈɛl(͡t͡a)
Chinese	(͡e͡n)t͡ʃa͡ɪnˈiːz(͡t͡a)
Dam	(͡e͡n)dˈam(͡t͡a)
Days	(͡e͡n)dˈe͡ɪz(͡t͡a)
Economics	(͡e͡n)ˌiːkənˈɒmɪks(͡t͡a)
Express	(͡e͡n)ɛkspɹˈɛs(͡t͡a)
FC	(͡e͡n)ˌɛfsˈiː(͡t͡a)
FRS	(͡e͡n)ˌɛfˌɑːɹˈɛs(͡t͡a)
For	(͡e͡n)fɔː(͡t͡a)
Green	(͡e͡n)ɡɹˈiːn(͡t͡a)
Heritage	(͡e͡n)hˈɛɹɪtɪd͡ʒ(͡t͡a)
Hg	(͡e͡n)ˌe͡ɪt͡ʃd͡ʒˈiː(͡t͡a)
Hong	(͡e͡n)hˈɒŋ(͡t͡a)
ITIL	(͡e͡n)ˈɪtɪl(͡t͡a)
Jain	(͡e͡n)d͡ʒˈe͡ɪn(͡t͡a)
LED	(͡e͡n)lˈɛd(͡t͡a)
Mk	(͡e͡n)ˌɛmkˈe͡ɪ(͡t͡a)
Mohammad	(͡e͡n)mə͡ʊhˈamɪd(͡t͡a)
NAAC	(͡e͡n)nˈɑːk(͡t͡a)
NGC	(͡e͡n)ˌɛnd͡ʒˌiːsˈiː(͡t͡a)
NaOH	(͡e͡n)nˈɑːɹ ˈə͡ʊ(͡t͡a)
Nations	(͡e͡n)nˈe͡ɪʃənz(͡t͡a)
Ni	(͡e͡n)nˈa͡ɪ(͡t͡a)
Official	(͡e͡n)əfˈɪʃə͡l(͡t͡a)
Oriental	(͡e͡n)ˌɔːɹɪˈɛntə͡l(͡t͡a)
PO	(͡e͡n)pˈə͡ʊ(͡t͡a)
Philosophical	(͡e͡n)fˌɪləsˈɒfɪkə͡l(͡t͡a)
Philosophy	(͡e͡n)fɪlˈɒsəfi(͡t͡a)
Poetry	(͡e͡n)pˈə͡ʊɪtɹi(͡t͡a)
Protection	(͡e͡n)pɹətˈɛkʃən(͡t͡a)
RC	(͡e͡n)ˌɑːsˈiː(͡t͡a)
ROM	(͡e͡n)ɹˈɒm(͡t͡a)
SH	(͡e͡n)ˌɛsˈe͡ɪt͡ʃ(͡t͡a)
Sarah	(͡e͡n)sˈe͡əɹə(͡t͡a)
Solar	(͡e͡n)sˈə͡ʊlə(͡t͡a)
Standard	(͡e͡n)stˈandəd(͡t͡a)
Street	(͡e͡n)stɹˈiːt(͡t͡a)
Study	(͡e͡n)stˈʌdi(͡t͡a)
UGC	(͡e͡n)ˈʌɡk(͡t͡a)
Wilson	(͡e͡n)wˈɪlsən(͡t͡a)
chemistry	(͡e͡n)kˈɛmɪstɹi(͡t͡a)
complex	(͡e͡n)kˈɒmplɛks(͡t͡a)
control	(͡e͡n)kəntɹˈə͡ʊl(͡t͡a)
del	(͡e͡n)dˈɛl(͡t͡a)
family	(͡e͡n)fˈamɪli(͡t͡a)
group	(͡e͡n)ɡɹˈuːp(͡t͡a)
mass	(͡e͡n)mˈas(͡t͡a)
see	(͡e͡n)sˈiː(͡t͡a)
up	(͡e͡n)ˈʌp(͡t͡a)
war	(͡e͡n)wˈɔː(͡t͡a)
λ	(͡e͡l)lˈamða(͡t͡a)
ஔடவ	ˈa͡ʊɖʌvʌ
சயன	sˈʌjʌnʌ
சரவண	sˈʌɹʌvˌʌɳʌ
தச	tˈʌsʌ
தசரத	dˈʌsʌɹˌʌdʌ
நட	nˈʌɖʌ
AA	(͡e͡n)ˈɑː(͡t͡a)
ADSL	(͡e͡n)ˌe͡ɪdˌiːˌɛsˈɛl(͡t͡a)
Anna	(͡e͡n)ˈanə(͡t͡a)
BA	(͡e͡n)bˈɑː(͡t͡a)
BJT	(͡e͡n)bˌiːd͡ʒˌe͡ɪtˈiː(͡t͡a)
BRI	(͡e͡n)bɹˈa͡ɪ(͡t͡a)
Bureau	(͡e͡n)bjˈʊ͡əɹə͡ʊ(͡t͡a)
CERN	(͡e͡n)sˈɜːn(͡t͡a)
CRC	(͡e͡n)sˌiːˌɑːsˈiː(͡t͡a)
CW	(͡e͡n)sˌiːdˈʌbə͡ljˌuː(͡t͡a)
Chennai	(͡e͡n)t͡ʃˈɛna͡ɪ(͡t͡a)
Daily	(͡e͡n)dˈe͡ɪli(͡t͡a)
Das	(͡e͡n)dˈas(͡t͡a)
Elizabeth	(͡e͡n)ɪlˈɪzəbəθ(͡t͡a)
Encyclopaedia	(͡e͡n)ɛnsˌa͡ɪkləpˈiːdi͡ə(͡t͡a)
Festival	(͡e͡n)fˈɛstɪvə͡l(͡t͡a)
Field	(͡e͡n)fˈiːld(͡t͡a)
Ford	(͡e͡n)fˈɔːd(͡t͡a)
GHz	(͡e͡n)ɡˈɪɡəhˌɜːts(͡t͡a)
GUI	(͡e͡n)ɡˈuːi(͡t͡a)
IAF	(͡e͡n)ˈa͡ɪaf(͡t͡a)
ICC	(͡e͡n)ˈa͡ɪk(͡t͡a)
Islam	(͡e͡n)ɪslˈɑːm(͡t͡a)
Ka	(͡e͡n)kˈɑː(͡t͡a)
LLC	(͡e͡n)ˌɛlˌɛlsˈiː(͡t͡a)
Last	(͡e͡n)lˈast(͡t͡a)
Literature	(͡e͡n)lˈɪtɹɪt͡ʃə(͡t͡a)
Lord	(͡e͡n)lˈɔːd(͡t͡a)
MBA	(͡e͡n)ˌɛmbˌiːˈe͡ɪ(͡t͡a)
MD	(͡e͡n)ˌɛmdˈiː(͡t͡a)
MOID	(͡e͡n)mˈɔ͡ɪd(͡t͡a)
MS	(͡e͡n)ˌɛmˈɛs(͡t͡a)
Malaysia	(͡e͡n)məlˈe͡ɪzi͡ə(͡t͡a)
Mission	(͡e͡n)mˈɪʃən(͡t͡a)
Model	(͡e͡n)mˈɒdə͡l(͡t͡a)
OR	(͡e͡n)ɔː(͡t͡a)
Old	(͡e͡n)ˈə͡ʊld(͡t͡a)
Pillai	(͡e͡n)pˈɪla͡ɪ(͡t͡a)
Point	(͡e͡n)pˈɔ͡ɪnt(͡t͡a)
RSS	(͡e͡n)ˌɑːɹˌɛsˈɛs(͡t͡a)
Radio	(͡e͡n)ɹˈe͡ɪdɪˌə͡ʊ(͡t͡a)
Samuel	(͡e͡n)sˈamjuːl(͡t͡a)
Sanctuary	(͡e͡n)sˈaŋktjuːəɹi(͡t͡a)
Scrivener	(͡e͡n)skɹˈɪvənə(͡t͡a)
Security	(͡e͡n)sɪkjˈʊ͡əɹɪti(͡t͡a)
Singapore	(͡e͡n)sˈɪŋɡɐpˌɔː(͡t͡a)
Station	(͡e͡n)stˈe͡ɪʃən(͡t͡a)
Studies	(͡e͡n)stˈʌdiz(͡t͡a)
TNT	(͡e͡n)tˌiːˌɛntˈiː(͡t͡a)
Two	(͡e͡n)tˈuː(͡t͡a)
UI	(͡e͡n)jˌuːˈa͡ɪ(͡t͡a)
URL	(͡e͡n)jˌuːˌɑːɹˈɛl(͡t͡a)
Wilhelm	(͡e͡n)wˈɪlhɛlm(͡t͡a)
XIII	(͡e͡n)ɹˌə͡ʊmən θˈɜːtiːn(͡t͡a)
XP	(͡e͡n)ˌɛkspˈiː(͡t͡a)
absolute	(͡e͡n)ˈabsəlˌuːt(͡t͡a)
abstract	(͡e͡n)ˈabstɹakt(͡t͡a)
common	(͡e͡n)kˈɒmən(͡t͡a)
cycle	(͡e͡n)sˈa͡ɪkə͡l(͡t͡a)
force	(͡e͡n)fˈɔːs(͡t͡a)
knot	(͡e͡n)nˈɒt(͡t͡a)
life	(͡e͡n)lˈa͡ɪf(͡t͡a)
light	(͡e͡n)lˈa͡ɪt(͡t͡a)
mi	(͡e͡n)mˈa͡ɪ(͡t͡a)
people	(͡e͡n)pˈiːpə͡l(͡t͡a)
power	(͡e͡n)pˈa͡ʊə(͡t͡a)
red	(͡e͡n)ɹˈɛd(͡t͡a)
synthesis	(͡e͡n)sˈɪnθəsˌɪs(͡t͡a)
type	(͡e͡n)tˈa͡ɪp(͡t͡a)
vector	(͡e͡n)vˈɛktə(͡t͡a)
ஏவ	ʲˈeːvʌ
தகன	dˈʌɡʌnʌ
ALT	(͡e͡n)ˈɒlt(͡t͡a)
ASCII	(͡e͡n)ˈaskɪ(͡t͡a)
Action	(͡e͡n)ˈakʃən(͡t͡a)
African	(͡e͡n)ˈafɹɪkən(͡t͡a)
Apple	(͡e͡n)ˈapə͡l(͡t͡a)
Au	(͡e͡n)ˌə͡ʊ(͡t͡a)
Authority	(͡e͡n)ɐθˈɒɹɪti(͡t͡a)
Bachelor	(͡e͡n)bˈat͡ʃələ(͡t͡a)
Business	(͡e͡n)bˈɪznəs(͡t͡a)
Civil	(͡e͡n)sˈɪvə͡l(͡t͡a)
Class	(͡e͡n)klˈas(͡t͡a)
Court	(͡e͡n)kˈɔːt(͡t͡a)
Dance	(͡e͡n)dˈans(͡t͡a)
Death	(͡e͡n)dˈɛθ(͡t͡a)
Department	(͡e͡n)dɪpˈɑːtmənt(͡t͡a)
ECW	(͡e͡n)ˈɛkwə(͡t͡a)
EEG	(͡e͡n)ˈiːɡ(͡t͡a)
EPOC	(͡e͡n)ˈɛpɒk(͡t͡a)
Economic	(͡e͡n)ˌiːkənˈɒmɪk(͡t͡a)
Edition	(͡e͡n)ɪdˈɪʃən(͡t͡a)
Environment	(͡e͡n)ɛnvˈa͡ɪɹənmənt(͡t͡a)
FBI	(͡e͡n)ˌɛfbˌiːˈa͡ɪ(͡t͡a)
Family	(͡e͡n)fˈamɪli(͡t͡a)
Fire	(͡e͡n)fˈa͡ɪ͡ə(͡t͡a)
Garden	(͡e͡n)ɡˈɑːdən(͡t͡a)
Giovanni	(͡e͡n)d͡ʒəvˈɑːni(͡t͡a)
Gupta	(͡e͡n)ɡˈʊptə(͡t͡a)
ICT	(͡e͡n)ˈa͡ɪkt(͡t͡a)
IETF	(͡e͡n)ˌa͡ɪˌiːtˌiːˈɛf(͡t͡a)
IR	(͡e͡n)ˈɜː(͡t͡a)
Ibn	(͡e͡n)ˈɪbən(͡t͡a)
Ice	(͡e͡n)ˈa͡ɪs(͡t͡a)
Lee	(͡e͡n)lˈiː(͡t͡a)
Magazine	(͡e͡n)mˌaɡɐzˈiːn(͡t͡a)
Method	(͡e͡n)mˈɛθəd(͡t͡a)
Mn	(͡e͡n)ˌɛmˈɛn(͡t͡a)
Mo	(͡e͡n)mˈə͡ʊ(͡t͡a)
OC	(͡e͡n)ˈɒk(͡t͡a)
OSI	(͡e͡n)ˈə͡ʊsi(͡t͡a)
Organization	(͡e͡n)ˌɔːɡɐna͡ɪzˈe͡ɪʃən(͡t͡a)
PA	(͡e͡n)pˈɑː(͡t͡a)
PCB	(͡e͡n)pˌiːsˌiːbˈiː(͡t͡a)
PID	(͡e͡n)pˈɪd(͡t͡a)
Physical	(͡e͡n)fˈɪzɪkə͡l(͡t͡a)
Presidency	(͡e͡n)pɹˈɛzɪdənsi(͡t͡a)
Provincial	(͡e͡n)pɹəvˈɪnʃə͡l(͡t͡a)
Republic	(͡e͡n)ɹɪpˈʌblɪk(͡t͡a)
Rice	(͡e͡n)ɹˈa͡ɪs(͡t͡a)
Road	(͡e͡n)ɹˈə͡ʊd(͡t͡a)
Rose	(͡e͡n)ɹˈə͡ʊz(͡t͡a)
SIM	(͡e͡n)sˈɪm(͡t͡a)
SOA	(͡e͡n)sˈə͡ʊə(͡t͡a)
Second	(͡e͡n)sˈɛkənd(͡t͡a)
Secondary	(͡e͡n)sˈɛkəndəɹi(͡t͡a)
Simon	(͡e͡n)sˈa͡ɪmən(͡t͡a)
Sons	(͡e͡n)sˈʌnz(͡t͡a)
Southern	(͡e͡n)sˈʌðən(͡t͡a)
Taylor	(͡e͡n)tˈe͡ɪlə(͡t͡a)
Theft	(͡e͡n)θˈɛft(͡t͡a)
Tourism	(͡e͡n)tˈʊ͡əɹɪzəm(͡t͡a)
UML	(͡e͡n)ˈʌmə͡l(͡t͡a)
Wiberg	(͡e͡n)wˈa͡ɪbɜːɡ(͡t͡a)
Xbox	(͡e͡n)ˈɛksbˈɒks(͡t͡a)
center	(͡e͡n)sˈɛntə(͡t͡a)
constant	(͡e͡n)kˈɒnstənt(͡t͡a)
ibn	(͡e͡n)ˈɪbən(͡t͡a)
no	(͡e͡n)nˈə͡ʊ(͡t͡a)
pKa	pˈiː (͡e͡n)kˈɑː(͡t͡a)
ratio	(͡e͡n)ɹˈe͡ɪʃɪˌə͡ʊ(͡t͡a)
rule	(͡e͡n)ɹˈuːl(͡t͡a)
set	(͡e͡n)sˈɛt(͡t͡a)
source	(͡e͡n)sˈɔːs(͡t͡a)
unit	(͡e͡n)jˈuːnɪt(͡t͡a)
vs	(͡e͡n)vˌiːˈɛs(͡t͡a)
படல	pˈʌɖʌlʌ
பரவச	pˈʌɹʌvˌʌsʌ
ரமண	ɹˈʌmʌɳʌ
ADA	(͡e͡n)ˈe͡ɪdə(͡t͡a)
ATM	(͡e͡n)ˌe͡ɪtˌiːˈɛm(͡t͡a)
AV	(͡e͡n)ˈav(͡t͡a)
Agency	(͡e͡n)ˈe͡ɪd͡ʒənsi(͡t͡a)
Bible	(͡e͡n)bˈa͡ɪbə͡l(͡t͡a)
Britannica	(͡e͡n)bɹɪtˈanɪkə(͡t͡a)
CCD	(͡e͡n)sˌiːsˌiːdˈiː(͡t͡a)
Child	(͡e͡n)t͡ʃˈa͡ɪld(͡t͡a)
Cr	(͡e͡n)sˌiːˈɑː(͡t͡a)
Cultural	(͡e͡n)kˈʌlt͡ʃəɹə͡l(͡t͡a)
Design	(͡e͡n)dɪzˈa͡ɪn(͡t͡a)
Donald	(͡e͡n)dˈɒnə͡ld(͡t͡a)
ETS	(͡e͡n)ˈɛts(͡t͡a)
Early	(͡e͡n)ˈɜːlɪ(͡t͡a)
Eric	(͡e͡n)ˈɛɹɪk(͡t͡a)
FTE	(͡e͡n)ˌɛftˌiːˈiː(͡t͡a)
Federal	(͡e͡n)fˈɛdəɹə͡l(͡t͡a)
Fellow	(͡e͡n)fˈɛlə͡ʊ(͡t͡a)
FireWire	(͡e͡n)fˈa͡ɪ͡ə wˈa͡ɪ͡ə(͡t͡a)
French	(͡e͡n)fɹˈɛnt͡ʃ(͡t͡a)
HDL	(͡e͡n)ˌe͡ɪt͡ʃdˌiːˈɛl(͡t͡a)
HK	(͡e͡n)ˌe͡ɪt͡ʃkˈe͡ɪ(͡t͡a)
HPLC	(͡e͡n)ˌe͡ɪt͡ʃpˌiːˌɛlsˈiː(͡t͡a)
Hare	(͡e͡n)hˈe͡ə(͡t͡a)
Harris	(͡e͡n)hˈaɹɪs(͡t͡a)
Historical	(͡e͡n)hɪstˈɒɹɪkə͡l(͡t͡a)
Homo	(͡e͡n)hˈə͡ʊmə͡ʊ(͡t͡a)
ITU	(͡e͡n)ˈɪtuː(͡t͡a)
Introduction	(͡e͡n)ˌɪntɹədˈʌkʃən(͡t͡a)
Johnson	(͡e͡n)d͡ʒˈɒnsən(͡t͡a)
Justice	(͡e͡n)d͡ʒˈʌstɪs(͡t͡a)
Line	(͡e͡n)lˈa͡ɪn(͡t͡a)
Mathematical	(͡e͡n)mˌaθɪmˈatɪkə͡l(͡t͡a)
Mathematics	(͡e͡n)mˌaθɪmˈatɪks(͡t͡a)
Mountain	(͡e͡n)mˈa͡ʊntɪn(͡t͡a)
Narayan	(͡e͡n)nˈaɹe͡ɪən(͡t͡a)
Nature	(͡e͡n)nˈe͡ɪt͡ʃə(͡t͡a)
Ocean	(͡e͡n)ˈə͡ʊʃən(͡t͡a)
Otto	(͡e͡n)ˈɒtə͡ʊ(͡t͡a)
Pages	(͡e͡n)pˈe͡ɪd͡ʒɪz(͡t͡a)
Pr	(͡e͡n)pˌiːˈɑː(͡t͡a)
Province	(͡e͡n)pɹˈɒvɪns(͡t͡a)
Publishers	(͡e͡n)pˈʌblɪʃəz(͡t͡a)
Radiation	(͡e͡n)ɹˌe͡ɪdɪˈe͡ɪʃən(͡t͡a)
Real	(͡e͡n)ɹˈi͡əl(͡t͡a)
Region	(͡e͡n)ɹˈiːd͡ʒən(͡t͡a)
Report	(͡e͡n)ɹɪpˈɔːt(͡t͡a)
Rock	(͡e͡n)ɹˈɒk(͡t͡a)
Roger	(͡e͡n)ɹˈɒd͡ʒə(͡t͡a)
SCSI	(͡e͡n)skˈʌzi(͡t͡a)
SF	(͡e͡n)ˌɛsˈɛf(͡t͡a)
Sb	(͡e͡n)ˌɛsbˈiː(͡t͡a)
Scientific	(͡e͡n)sa͡ɪ͡əntˈɪfɪk(͡t͡a)
Scott	(͡e͡n)skˈɒt(͡t͡a)
Services	(͡e͡n)sˈɜːvɪsɪz(͡t͡a)
Shah	(͡e͡n)ʃˈɑː(͡t͡a)
Sodium	(͡e͡n)sˈə͡ʊdi͡əm(͡t͡a)
Statistical	(͡e͡n)stɐtˈɪstɪkə͡l(͡t͡a)
TPS	(͡e͡n)tˌiːpˌiːˈɛs(͡t͡a)
Tales	(͡e͡n)tˈe͡ɪlz(͡t͡a)
Three	(͡e͡n)θɹˈiː(͡t͡a)
Tiger	(͡e͡n)tˈa͡ɪɡə(͡t͡a)
Tom	(͡e͡n)tˈɒm(͡t͡a)
Tractatus	(͡e͡n)tɹˈaktatəs(͡t͡a)
Type	(͡e͡n)tˈa͡ɪp(͡t͡a)
UMTS	(͡e͡n)jˌuːˌɛmtˌiːˈɛs(͡t͡a)
Universal	(͡e͡n)jˌuːnɪvˈɜːsə͡l(͡t͡a)
Unix	(͡e͡n)jˈuːnɪks(͡t͡a)
VTP	(͡e͡n)vˌiːtˌiːpˈiː(͡t͡a)
XX	(͡e͡n)ɹˌə͡ʊmən twˈɛnti(͡t͡a)
Young	(͡e͡n)jˈʌŋ(͡t͡a)
article	(͡e͡n)ˈɑːtɪkə͡l(͡t͡a)
black	(͡e͡n)blˈak(͡t͡a)
born	(͡e͡n)bˈɔːn(͡t͡a)
cc	(͡e͡n)sˌiːsˈiː(͡t͡a)
culture	(͡e͡n)kˈʌlt͡ʃə(͡t͡a)
functions	(͡e͡n)fˈʌŋkʃənz(͡t͡a)
heat	(͡e͡n)hˈiːt(͡t͡a)
internal	(͡e͡n)ɪntˈɜːnə͡l(͡t͡a)
potential	(͡e͡n)pətˈɛnʃə͡l(͡t͡a)
radiation	(͡e͡n)ɹˌe͡ɪdɪˈe͡ɪʃən(͡t͡a)
structure	(͡e͡n)stɹˈʌkt͡ʃə(͡t͡a)
technology	(͡e͡n)tɛknˈɒləd͡ʒi(͡t͡a)
ve	(͡e͡n)vˈiː(͡t͡a)
அமல	ˈamʌlʌ
அயலக	ˈajʌlˌʌɡʌ
இரத	ɹˈʌdʌ
கச	kˈʌsʌ
சன	sˈʌnʌ
தகர	tˈʌɡʌɹʌ
நம	nˈʌmʌ
நர	nˈʌɹʌ
வல	vˈʌlʌ
ALA	(͡e͡n)ɐlˈa(͡t͡a)
AST	(͡e͡n)ˈast(͡t͡a)
Ali	(͡e͡n)ˈɑːli(͡t͡a)
Andrew	(͡e͡n)ˈandɹuː(͡t͡a)
Ann	(͡e͡n)ˈan(͡t͡a)
Anthony	(͡e͡n)ˈantəni(͡t͡a)
BMW	(͡e͡n)bˌiːˌɛmdˈʌbə͡ljˌuː(͡t͡a)
Benjamin	(͡e͡n)bˈɛnd͡ʒəmɪn(͡t͡a)
Bernard	(͡e͡n)bˈɜːnəd(͡t͡a)
Br	(͡e͡n)bˌiːˈɑː(͡t͡a)
Bruce	(͡e͡n)bɹˈuːs(͡t͡a)
CA	(͡e͡n)kˈɑː(͡t͡a)
CDMA	(͡e͡n)sˌiːdˌiːˌɛmˈe͡ɪ(͡t͡a)
CN	(͡e͡n)sˌiːˈɛn(͡t͡a)
Capital	(͡e͡n)kˈapɪtə͡l(͡t͡a)
Castle	(͡e͡n)kˈasə͡l(͡t͡a)
Catherine	(͡e͡n)kˈaθɹɪn(͡t͡a)
Catholic	(͡e͡n)kˈaθlɪk(͡t͡a)
Chief	(͡e͡n)t͡ʃˈiːf(͡t͡a)
Community	(͡e͡n)kəmjˈuːnɪti(͡t͡a)
Computer	(͡e͡n)kəmpjˈuːtə(͡t͡a)
Congress	(͡e͡n)kˈɒŋɡɹɛs(͡t͡a)
DHA	(͡e͡n)dˌiːˌe͡ɪt͡ʃˈe͡ɪ(͡t͡a)
DR	(͡e͡n)dˌiːˈɑː(͡t͡a)
Divine	(͡e͡n)dɪvˈa͡ɪn(͡t͡a)
ESOP	(͡e͡n)ˈɛsəp(͡t͡a)
Eccles	(͡e͡n)ˈɛkə͡lz(͡t͡a)
Educational	(͡e͡n)ˌɛd͡ʒuːkˈe͡ɪʃənə͡l(͡t͡a)
Encyclopædia	(͡e͡n)ɛnsˌa͡ɪkləpˈe͡ɪdi͡ə(͡t͡a)
Eusebius	(͡e͡n)juːsˈiːbɪəs(͡t͡a)
FTP	(͡e͡n)ˌɛftˌiːpˈiː(͡t͡a)
Father	(͡e͡n)fˈɑːðə(͡t͡a)
Food	(͡e͡n)fˈuːd(͡t͡a)
Frank	(͡e͡n)fɹˈaŋk(͡t͡a)
Frederick	(͡e͡n)fɹˈɛdəɹˌɪk(͡t͡a)
Freedom	(͡e͡n)fɹˈiːdəm(͡t͡a)
GPS	(͡e͡n)d͡ʒˌiːpˌiːˈɛs(͡t͡a)
GaAs	(͡e͡n)ɡˈɑːɹ az(͡t͡a)
Geographies	(͡e͡n)d͡ʒɪˈɒɡɹəfiz(͡t͡a)
Heinrich	(͡e͡n)hˈa͡ɪnɹɪt͡ʃ(͡t͡a)
How	(͡e͡n)hˈa͡ʊ(͡t͡a)
Is	(͡e͡n)ɪz(͡t͡a)
Jones	(͡e͡n)d͡ʒˈə͡ʊnz(͡t͡a)
José	(͡e͡n)hə͡ʊsˈe͡ɪ(͡t͡a)
Linux	(͡e͡n)lˈɪnʌks(͡t͡a)
Long	(͡e͡n)lˈɒŋ(͡t͡a)
Ltd	(͡e͡n)lˈɪmɪtɪd(͡t͡a)
Me	(͡e͡n)mˈiː(͡t͡a)
Middle	(͡e͡n)mˈɪdə͡l(͡t͡a)
Miller	(͡e͡n)mˈɪlə(͡t͡a)
Mohan	(͡e͡n)mˈə͡ʊhan(͡t͡a)
Monthly	(͡e͡n)mˈʌnθli(͡t͡a)
Moore	(͡e͡n)mˈʊ͡ə(͡t͡a)
NPN	(͡e͡n)ˌɛnpˌiːˈɛn(͡t͡a)
Nelson	(͡e͡n)nˈɛlsən(͡t͡a)
Newman	(͡e͡n)njˈuːmən(͡t͡a)
Organisation	(͡e͡n)ˌɔːɡɐna͡ɪzˈe͡ɪʃən(͡t͡a)
Origin	(͡e͡n)ˈɒɹɪd͡ʒˌɪn(͡t͡a)
PHP	(͡e͡n)pˌiːˌe͡ɪt͡ʃpˈiː(͡t͡a)
PS	(͡e͡n)pˌiːˈɛs(͡t͡a)
Plant	(͡e͡n)plˈant(͡t͡a)
Portuguese	(͡e͡n)pˌɔːt͡ʃəɡˈiːz(͡t͡a)
Publications	(͡e͡n)pˌʌblɪkˈe͡ɪʃənz(͡t͡a)
RPC	(͡e͡n)ˌɑːpˌiːsˈiː(͡t͡a)
Railway	(͡e͡n)ɹˈe͡ɪlwe͡ɪ(͡t͡a)
Records	(͡e͡n)ɹˈɛkɔːdz(͡t͡a)
Reu	(͡e͡n)ɹˈuː(͡t͡a)
RhD	(͡e͡n)ˌɑːɹˈe͡ɪt͡ʃ(͡t͡a) dˈiː
SEER	(͡e͡n)sˈiːə(͡t͡a)
Sen	(͡e͡n)sˈɛn(͡t͡a)
Source	(͡e͡n)sˈɔːs(͡t͡a)
Species	(͡e͡n)spˈiːsiːz(͡t͡a)
Sun	(͡e͡n)sˈʌn(͡t͡a)
Synthesis	(͡e͡n)sˈɪnθəsˌɪs(͡t͡a)
TFTP	(͡e͡n)tˌiːˌɛftˌiːpˈiː(͡t͡a)
TSH	(͡e͡n)tˌiːˌɛsˈe͡ɪt͡ʃ(͡t͡a)
Ti	(͡e͡n)tˈa͡ɪ(͡t͡a)
Travancore	(͡e͡n)tɹˈavaŋkˌɔː(͡t͡a)
Tree	(͡e͡n)tɹˈiː(͡t͡a)
UP	(͡e͡n)ˈʌp(͡t͡a)
Wild	(͡e͡n)wˈa͡ɪld(͡t͡a)
Wolf	(͡e͡n)wˈʊlf(͡t͡a)
Works	(͡e͡n)wˈɜːks(͡t͡a)
Yadav	(͡e͡n)jˈadav(͡t͡a)
basilica	(͡e͡n)bazˈɪlɪkə(͡t͡a)
case	(͡e͡n)kˈe͡ɪs(͡t͡a)
disorder	(͡e͡n)dɪsˈɔːdə(͡t͡a)
ft	(͡e͡n)ˌɛftˈiː(͡t͡a)
gas	(͡e͡n)ɡˈas(͡t͡a)
golden	(͡e͡n)ɡˈə͡ʊldən(͡t͡a)
j	d͡ʒˈeːj
kg	(͡e͡n)kˌe͡ɪd͡ʒˈiː(͡t͡a)
oil	(͡e͡n)ˈɔ͡ɪl(͡t͡a)
out	(͡e͡n)ˈa͡ʊt(͡t͡a)
philosophy	(͡e͡n)fɪlˈɒsəfi(͡t͡a)
positive	(͡e͡n)pˈɒzɪtˌɪv(͡t͡a)
primary	(͡e͡n)pɹˈa͡ɪməɹi(͡t͡a)
root	(͡e͡n)ɹˈuːt(͡t͡a)
sin	(͡e͡n)sˈɪn(͡t͡a)
star	(͡e͡n)stˈɑː(͡t͡a)
stem	(͡e͡n)stˈɛm(͡t͡a)
temple	(͡e͡n)tˈɛmpə͡l(͡t͡a)
test	(͡e͡n)tˈɛst(͡t͡a)
tube	(͡e͡n)tjˈuːb(͡t͡a)
அழ	ˈaɻʌ
ஈல	ˈiːlʌ
ஏஏ	ʲˈeːeː
சட	sˈʌɖʌ
மல	mˈʌlʌ
மலர	mˈʌlʌɹʌ
ABS	(͡e͡n)ˈabz(͡t͡a)
ACT	(͡e͡n)ˈakt(͡t͡a)
Academic	(͡e͡n)ˌakədˈɛmɪk(͡t͡a)
Ag	(͡e͡n)ˈaɡ(͡t͡a)
Anne	(͡e͡n)ˈan(͡t͡a)
Area	(͡e͡n)ˈe͡əɹi͡ə(͡t͡a)
Arnold	(͡e͡n)ˈɑːnə͡ld(͡t͡a)
BCE	(͡e͡n)bˌiːsˌiːˈiː(͡t͡a)
BPH	(͡e͡n)bˌiːpˌiːˈe͡ɪt͡ʃ(͡t͡a)
Bird	(͡e͡n)bˈɜːd(͡t͡a)
Birds	(͡e͡n)bˈɜːdz(͡t͡a)
Blaze	(͡e͡n)blˈe͡ɪz(͡t͡a)
Blood	(͡e͡n)blˈʌd(͡t͡a)
Blue	(͡e͡n)blˈuː(͡t͡a)
CDM	(͡e͡n)sˌiːdˌiːˈɛm(͡t͡a)
CIDR	(͡e͡n)sˈɪdə(͡t͡a)
CNN	(͡e͡n)sˌiːˌɛnˈɛn(͡t͡a)
Der	(͡e͡n)dˈe͡ə(͡t͡a)
Diego	(͡e͡n)dɪˈe͡ɪɡə͡ʊ(͡t͡a)
EMV	(͡e͡n)ˈɛmv(͡t͡a)
ERP	(͡e͡n)ˈɜːp(͡t͡a)
Electronic	(͡e͡n)ɪlɛktɹˈɒnɪk(͡t͡a)
Foot	(͡e͡n)fˈʊt(͡t͡a)
Friedrich	(͡e͡n)fɹˈiːdɹɪt͡ʃ(͡t͡a)
Front	(͡e͡n)fɹˈʌnt(͡t͡a)
GA	(͡e͡n)ɡˈɑː(͡t͡a)
GATT	(͡e͡n)ɡˈat(͡t͡a)
GNU	(͡e͡n)ɡənˈuː(͡t͡a)
GPa	(͡e͡n)d͡ʒˌiːpˌiːˈe͡ɪ(͡t͡a)
GTA	(͡e͡n)d͡ʒˌiːtˌiːˈe͡ɪ(͡t͡a)
German	(͡e͡n)d͡ʒˈɜːmən(͡t͡a)
HI	(͡e͡n)hˈa͡ɪ(͡t͡a)
HP	(͡e͡n)ˌe͡ɪt͡ʃpˈiː(͡t͡a)
Hans	(͡e͡n)hˈanz(͡t͡a)
Helen	(͡e͡n)hˈɛlən(͡t͡a)
Herbert	(͡e͡n)hˈɜːbət(͡t͡a)
Higher	(͡e͡n)hˈa͡ɪə(͡t͡a)
Hiltebeitel	(͡e͡n)hˈɪltɪbˌe͡ɪtə͡l(͡t͡a)
Holleman	(͡e͡n)hˈɒlɛmən(͡t͡a)
Howard	(͡e͡n)hˈa͡ʊəd(͡t͡a)
IAS	(͡e͡n)ˈa͡ɪəz(͡t͡a)
IC	(͡e͡n)ˈa͡ɪk(͡t͡a)
IEC	(͡e͡n)ˈa͡ɪk(͡t͡a)
ILM	(͡e͡n)ˈɪlm(͡t͡a)
IS	(͡e͡n)ɪz(͡t͡a)
Industry	(͡e͡n)ˈɪndʌstɹi(͡t͡a)
Iron	(͡e͡n)ˈa͡ɪ͡ən(͡t͡a)
JPEG	(͡e͡n)d͡ʒˈe͡ɪpˈɛɡ(͡t͡a)
JSP	(͡e͡n)d͡ʒˌe͡ɪˌɛspˈiː(͡t͡a)
Jack	(͡e͡n)d͡ʒˈak(͡t͡a)
Japan	(͡e͡n)d͡ʒəpˈan(͡t͡a)
Kane	(͡e͡n)kˈe͡ɪn(͡t͡a)
Kong	(͡e͡n)kˈɒŋ(͡t͡a)
Korea	(͡e͡n)kɔɹˈiːə(͡t͡a)
Kumbakonam	(͡e͡n)kˈʌmbɐkˌɒnɑːm(͡t͡a)
Layer	(͡e͡n)lˈe͡ɪə(͡t͡a)
Legislative	(͡e͡n)lˈɛd͡ʒɪslətˌɪv(͡t͡a)
Liberation	(͡e͡n)lˌɪbəɹˈe͡ɪʃən(͡t͡a)
Living	(͡e͡n)lˈɪvɪŋ(͡t͡a)
Love	(͡e͡n)lˈʌv(͡t͡a)
MCC	(͡e͡n)ˌɛmsˌiːsˈiː(͡t͡a)
Market	(͡e͡n)mˈɑːkɪt(͡t͡a)
Medal	(͡e͡n)mˈɛdə͡l(͡t͡a)
Media	(͡e͡n)mˈiːdiːə(͡t͡a)
Motion	(͡e͡n)mˈə͡ʊʃən(͡t͡a)
Mr	(͡e͡n)mˈɪstə(͡t͡a)
Mukherjee	(͡e͡n)mʊkˈɜːd͡ʒiː(͡t͡a)
NAD	(͡e͡n)nˈad(͡t͡a)
Nair	(͡e͡n)nˈe͡ə(͡t͡a)
Nicholas	(͡e͡n)nˈɪkələs(͡t͡a)
Order	(͡e͡n)ˈɔːdə(͡t͡a)
PAL	(͡e͡n)pˈal(͡t͡a)
PH	(͡e͡n)pˌiːˈe͡ɪt͡ʃ(͡t͡a)
Patrick	(͡e͡n)pˈatɹɪk(͡t͡a)
PhD	(͡e͡n)pˌiːˈe͡ɪt͡ʃ(͡t͡a) dˈiː
Pierre	(͡e͡n)pɪˈe͡ə(͡t͡a)
Prasad	(͡e͡n)pɹˈasad(͡t͡a)
Psychology	(͡e͡n)sa͡ɪkˈɒləd͡ʒi(͡t͡a)
Pure	(͡e͡n)pjˈʊ͡ə(͡t͡a)
Quantum	(͡e͡n)kwˈɒntəm(͡t͡a)
RAF	(͡e͡n)ɹˈaf(͡t͡a)
RFID	(͡e͡n)ˈɑːfˈɪd(͡t͡a)
RJR	(͡e͡n)ˌɑːd͡ʒˌe͡ɪˈɑː(͡t͡a)
Roy	(͡e͡n)ɹˈɔ͡ɪ(͡t͡a)
SIDC	(͡e͡n)sˈɪdk(͡t͡a)
Sanskrit	(͡e͡n)sˈanskɹɪt(͡t͡a)
Sewall	(͡e͡n)sˈuːɔːl(͡t͡a)
SiO	(͡e͡n)sˈiː(͡t͡a) ˈoː
Smoothed	(͡e͡n)smˈuːðd(͡t͡a)
Sunspot	(͡e͡n)sˈʌnspɒt(͡t͡a)
Table	(͡e͡n)tˈe͡ɪbə͡l(͡t͡a)
Taluk	(͡e͡n)tˈalʌk(͡t͡a)
Tea	(͡e͡n)tˈiː(͡t͡a)
Test	(͡e͡n)tˈɛst(͡t͡a)
Text	(͡e͡n)tˈɛkst(͡t͡a)
Transport	(͡e͡n)tɹˈanspɔːt(͡t͡a)
Treatise	(͡e͡n)tɹˈiːtɪz(͡t͡a)
UDP	(͡e͡n)jˌuːdˌiːpˈiː(͡t͡a)
UUCP	(͡e͡n)jˌuːjˌuːsˌiːpˈiː(͡t͡a)
Unit	(͡e͡n)jˈuːnɪt(͡t͡a)
WAP	(͡e͡n)wˈap(͡t͡a)
Warren	(͡e͡n)wˈɒɹən(͡t͡a)
Way	(͡e͡n)wˈe͡ɪ(͡t͡a)
We	(͡e͡n)wiː(͡t͡a)
Wood	(͡e͡n)wˈʊd(͡t͡a)
Yang	(͡e͡n)jˈaŋ(͡t͡a)
You	(͡e͡n)juː(͡t͡a)
Zone	(͡e͡n)zˈə͡ʊn(͡t͡a)
algorithm	(͡e͡n)ˈalɡəɹˌɪθəm(͡t͡a)
also	(͡e͡n)ˈɔːlsə͡ʊ(͡t͡a)
base	(͡e͡n)bˈe͡ɪs(͡t͡a)
circuit	(͡e͡n)sˈɜːkɪt(͡t͡a)
city	(͡e͡n)sˈɪti(͡t͡a)
court	(͡e͡n)kˈɔːt(͡t͡a)
dB	dˈiː bˈiː
death	(͡e͡n)dˈɛθ(͡t͡a)
digital	(͡e͡n)dˈɪd͡ʒɪtə͡l(͡t͡a)
do	(͡e͡n)dˈuː(͡t͡a)
elements	(͡e͡n)ˈɛlɪmənts(͡t͡a)
factor	(͡e͡n)fˈaktə(͡t͡a)
film	(͡e͡n)fˈɪlm(͡t͡a)
fish	(͡e͡n)fˈɪʃ(͡t͡a)
government	(͡e͡n)ɡˈʌvənmənt(͡t͡a)
house	(͡e͡n)hˈa͡ʊs(͡t͡a)
indica	(͡e͡n)ˈɪndɪkə(͡t͡a)
l	ˈɛl
library	(͡e͡n)lˈa͡ɪbɹəɹi(͡t͡a)
lines	(͡e͡n)lˈa͡ɪnz(͡t͡a)
music	(͡e͡n)mjˈuːzɪk(͡t͡a)
open	(͡e͡n)ˈə͡ʊpən(͡t͡a)
phase	(͡e͡n)fˈe͡ɪz(͡t͡a)
principle	(͡e͡n)pɹˈɪnsɪpə͡l(͡t͡a)
processing	(͡e͡n)pɹˈə͡ʊsɛsɪŋ(͡t͡a)
programming	(͡e͡n)pɹˈə͡ʊɡɹamɪŋ(͡t͡a)
school	(͡e͡n)skˈuːl(͡t͡a)
sea	(͡e͡n)sˈiː(͡t͡a)
secondary	(͡e͡n)sˈɛkəndəɹi(͡t͡a)
social	(͡e͡n)sˈə͡ʊʃə͡l(͡t͡a)
solar	(͡e͡n)sˈə͡ʊlə(͡t͡a)
species	(͡e͡n)spˈiːsiːz(͡t͡a)
standard	(͡e͡n)stˈandəd(͡t͡a)
virus	(͡e͡n)vˈa͡ɪɹəs(͡t͡a)
wave	(͡e͡n)wˈe͡ɪv(͡t͡a)
µm	(͡e͡n)mˌa͡ɪkɹə͡ʊˈɛm(͡t͡a)
ε	(͡e͡l)ˈepsilˌon(͡t͡a)
ஆற	ˈaːrʌ
எகர	ʲˈeɡʌɹʌ
ஒகர	ˈoɡʌɹʌ
கர	kˈʌɹʌ
ஜ	d͡ʒˈʌ
நரச	nˈʌɹʌsʌ
AIR	(͡e͡n)ˈe͡ə(͡t͡a)
AP	(͡e͡n)ˈap(͡t͡a)
AS	(͡e͡n)az(͡t͡a)
Adams	(͡e͡n)ˈadəmz(͡t͡a)
Agricultural	(͡e͡n)ˌaɡɹɪkˈʌlt͡ʃəɹə͡l(͡t͡a)
America	(͡e͡n)ɐmˈɛɹɪkə(͡t͡a)
Animal	(͡e͡n)ˈanɪmə͡l(͡t͡a)
Antonio	(͡e͡n)antˈə͡ʊnɪˌə͡ʊ(͡t͡a)
Applied	(͡e͡n)ɐplˈa͡ɪd(͡t͡a)
Arc	(͡e͡n)ˈɑːk(͡t͡a)
Atomic	(͡e͡n)ɐtˈɒmɪk(͡t͡a)
Australia	(͡e͡n)ɒstɹˈe͡ɪli͡ə(͡t͡a)
BAFTA	(͡e͡n)bˈaftə(͡t͡a)
BIOS	(͡e͡n)bˈa͡ɪə͡ʊz(͡t͡a)
Bombay	(͡e͡n)bˈɒmbe͡ɪ(͡t͡a)
Bridge	(͡e͡n)bɹˈɪd͡ʒ(͡t͡a)
Britain	(͡e͡n)bɹˈɪtən(͡t͡a)
Buddhist	(͡e͡n)bˈʊdɪst(͡t͡a)
CB	(͡e͡n)sˌiːbˈiː(͡t͡a)
CBSE	(͡e͡n)sˌiːbˌiːˌɛsˈiː(͡t͡a)
CITES	(͡e͡n)sˈa͡ɪts(͡t͡a)
Captain	(͡e͡n)kˈaptɪn(͡t͡a)
Chamber	(͡e͡n)t͡ʃˈe͡ɪmbə(͡t͡a)
Chicago	(͡e͡n)ʃɪkˈɑːɡə͡ʊ(͡t͡a)
Children	(͡e͡n)t͡ʃˈɪldɹən(͡t͡a)
Christ	(͡e͡n)kɹˈa͡ɪst(͡t͡a)
Classical	(͡e͡n)klˈasɪkə͡l(͡t͡a)
Coast	(͡e͡n)kˈə͡ʊst(͡t͡a)
Conference	(͡e͡n)kˈɒnfɹəns(͡t͡a)
DDT	(͡e͡n)dˌiːdˌiːtˈiː(͡t͡a)
DN	(͡e͡n)dˌiːˈɛn(͡t͡a)
DSL	(͡e͡n)dˌiːˌɛsˈɛl(͡t͡a)
Declaration	(͡e͡n)dˌɛkləɹˈe͡ɪʃən(͡t͡a)
Doctor	(͡e͡n)dˈɒktə(͡t͡a)
Double	(͡e͡n)dˈʌbə͡l(͡t͡a)
Electric	(͡e͡n)ɪlˈɛktɹɪk(͡t͡a)
End	(͡e͡n)ˈɛnd(͡t͡a)
England	(͡e͡n)ˈɪŋɡlənd(͡t͡a)
Estate	(͡e͡n)ɪstˈe͡ɪt(͡t͡a)
Eugene	(͡e͡n)jˈuːd͡ʒiːn(͡t͡a)
Explorer	(͡e͡n)ɛksplˈɔːɹə(͡t͡a)
GPL	(͡e͡n)d͡ʒˌiːpˌiːˈɛl(͡t͡a)
Gas	(͡e͡n)ɡˈas(͡t͡a)
Ge	(͡e͡n)d͡ʒˈiː(͡t͡a)
Giant	(͡e͡n)d͡ʒˈa͡ɪənt(͡t͡a)
Giuseppe	(͡e͡n)d͡ʒˈɪjuːsˌɛp(͡t͡a)
Gold	(͡e͡n)ɡˈə͡ʊld(͡t͡a)
IMAX	(͡e͡n)ɪmˈaks(͡t͡a)
IPL	(͡e͡n)ˈɪpə͡l(͡t͡a)
IU	(͡e͡n)ˈɪuː(͡t͡a)
IUPAC	(͡e͡n)ˈɪjuːpˌak(͡t͡a)
Indira	(͡e͡n)ɪndˈi͡əɹə(͡t͡a)
Iran	(͡e͡n)ɪɹˈan(͡t͡a)
JHVH	(͡e͡n)d͡ʒˌe͡ɪˌe͡ɪt͡ʃvˌiːˈe͡ɪt͡ʃ(͡t͡a)
Jr	(͡e͡n)d͡ʒˌe͡ɪˈɑː(͡t͡a)
Judaism	(͡e͡n)d͡ʒˈuːde͡ɪˌɪzəm(͡t͡a)
KOH	(͡e͡n)kˈə͡ʊ(͡t͡a)
Karl	(͡e͡n)kˈɑːl(͡t͡a)
Large	(͡e͡n)lˈɑːd͡ʒ(͡t͡a)
Lost	(͡e͡n)lˈɒst(͡t͡a)
MA	(͡e͡n)mˈɑː(͡t͡a)
MIS	(͡e͡n)mˈɪs(͡t͡a)
Malik	(͡e͡n)mˈalɪk(͡t͡a)
Marine	(͡e͡n)məɹˈiːn(͡t͡a)
Max	(͡e͡n)mˈaks(͡t͡a)
Mohamed	(͡e͡n)mə͡ʊhˈamɪd(͡t͡a)
Moon	(͡e͡n)mˈuːn(͡t͡a)
NASA	(͡e͡n)nˈasɐ(͡t͡a)
NATO	(͡e͡n)nˈe͡ɪtə͡ʊ(͡t͡a)
NFS	(͡e͡n)ˌɛnˌɛfˈɛs(͡t͡a)
Night	(͡e͡n)nˈa͡ɪt(͡t͡a)
Norman	(͡e͡n)nˈɔːmən(͡t͡a)
Note	(͡e͡n)nˈə͡ʊt(͡t͡a)
ONGC	(͡e͡n)ˈɒŋk(͡t͡a)
Optical	(͡e͡n)ˈɒptɪkə͡l(͡t͡a)
Org	(͡e͡n)ˈɔːɡ(͡t͡a)
Perry	(͡e͡n)pˈɛɹi(͡t͡a)
Plate	(͡e͡n)plˈe͡ɪt(͡t͡a)
Principia	(͡e͡n)pɹɪnsˈɪpi͡ə(͡t͡a)
Programme	(͡e͡n)pɹˈə͡ʊɡɹam(͡t͡a)
RCA	(͡e͡n)ˌɑːsˌiːˈe͡ɪ(͡t͡a)
RF	(͡e͡n)ˌɑːɹˈɛf(͡t͡a)
RFP	(͡e͡n)ˌɑːɹˌɛfpˈiː(͡t͡a)
RSA	(͡e͡n)ˌɑːɹˌɛsˈe͡ɪ(͡t͡a)
Race	(͡e͡n)ɹˈe͡ɪs(͡t͡a)
Rai	(͡e͡n)ɹˈa͡ɪ(͡t͡a)
Ray	(͡e͡n)ɹˈe͡ɪ(͡t͡a)
Re	(͡e͡n)ɹˌiː(͡t͡a)
Religion	(͡e͡n)ɹɪlˈɪd͡ʒən(͡t͡a)
Resource	(͡e͡n)ɹɪzˈɔːs(͡t͡a)
Rev	(͡e͡n)ɹˈɛv(͡t͡a)
Russell	(͡e͡n)ɹˈʌsə͡l(͡t͡a)
Russia	(͡e͡n)ɹˈʌʃə(͡t͡a)
SIS	(͡e͡n)sˈɪs(͡t͡a)
SS	(͡e͡n)ˌɛsˈɛs(͡t͡a)
SWF	(͡e͡n)ˌɛsdˌʌbə͡ljˌuːˈɛf(͡t͡a)
SWNT	(͡e͡n)ˌɛsdˌʌbə͡ljˌuːˌɛntˈiː(͡t͡a)
Seven	(͡e͡n)sˈɛvən(͡t͡a)
Sharma	(͡e͡n)ʃˈɑːmə(͡t͡a)
Sinha	(͡e͡n)sˈɪnhə(͡t͡a)
Sound	(͡e͡n)sˈa͡ʊnd(͡t͡a)
Standards	(͡e͡n)stˈandədz(͡t͡a)
Stanley	(͡e͡n)stˈanli(͡t͡a)
Stone	(͡e͡n)stˈə͡ʊn(͡t͡a)
Structure	(͡e͡n)stɹˈʌkt͡ʃə(͡t͡a)
Stuart	(͡e͡n)stjˈuːət(͡t͡a)
Swami	(͡e͡n)swˈɑːmi(͡t͡a)
Te	(͡e͡n)tˈiː(͡t͡a)
TiCl	(͡e͡n)tˈa͡ɪ sˌiːˈɛl(͡t͡a)
Total	(͡e͡n)tˈə͡ʊtə͡l(͡t͡a)
Town	(͡e͡n)tˈa͡ʊn(͡t͡a)
Truth	(͡e͡n)tɹˈuːθ(͡t͡a)
UTC	(͡e͡n)jˌuːtˌiːsˈiː(͡t͡a)
Universe	(͡e͡n)jˈuːnɪvˌɜːs(͡t͡a)
Victoria	(͡e͡n)vɪktˈɔːɹi͡ə(͡t͡a)
WTO	(͡e͡n)dˌʌbə͡ljˌuːtˌiːˈə͡ʊ(͡t͡a)
What	(͡e͡n)wˌɒt(͡t͡a)
Wiley	(͡e͡n)wˈa͡ɪli(͡t͡a)
Work	(͡e͡n)wˈɜːk(͡t͡a)
XY	(͡e͡n)ˌɛkswˈa͡ɪ(͡t͡a)
YHWH	(͡e͡n)ˈɪhʊ(͡t͡a)
Your	(͡e͡n)jɔː(͡t͡a)
activity	(͡e͡n)aktˈɪvɪti(͡t͡a)
ad	(͡e͡n)ˈad(͡t͡a)
air	(͡e͡n)ˈe͡ə(͡t͡a)
arts	(͡e͡n)ˈɑːts(͡t͡a)
blood	(͡e͡n)blˈʌd(͡t͡a)
ca	(͡e͡n)kˈɑː(͡t͡a)
chemical	(͡e͡n)kˈɛmɪkə͡l(͡t͡a)
cognitive	(͡e͡n)kˈɒɡnɪtˌɪv(͡t͡a)
curve	(͡e͡n)kˈɜːv(͡t͡a)
district	(͡e͡n)dˈɪstɹɪkt(͡t͡a)
domain	(͡e͡n)dəmˈe͡ɪn(͡t͡a)
dose	(͡e͡n)dˈə͡ʊs(͡t͡a)
double	(͡e͡n)dˈʌbə͡l(͡t͡a)
educational	(͡e͡n)ˌɛd͡ʒuːkˈe͡ɪʃənə͡l(͡t͡a)
equation	(͡e͡n)ɪkwˈe͡ɪʒən(͡t͡a)
file	(͡e͡n)fˈa͡ɪl(͡t͡a)
good	(͡e͡n)ɡˈʊd(͡t͡a)
ii	(͡e͡n)ɹˌə͡ʊmən tˈuː(͡t͡a)
key	(͡e͡n)kˈiː(͡t͡a)
lens	(͡e͡n)lˈɛnz(͡t͡a)
linear	(͡e͡n)lˈɪni͡ə(͡t͡a)
man	(͡e͡n)mˈan(͡t͡a)
medicine	(͡e͡n)mˈɛdsən(͡t͡a)
membrane	(͡e͡n)mˈɛmbɹe͡ɪn(͡t͡a)
motion	(͡e͡n)mˈə͡ʊʃən(͡t͡a)
movement	(͡e͡n)mˈuːvmənt(͡t͡a)
negative	(͡e͡n)nˈɛɡətˌɪv(͡t͡a)
notation	(͡e͡n)nə͡ʊtˈe͡ɪʃən(͡t͡a)
private	(͡e͡n)pɹˈa͡ɪvət(͡t͡a)
rRNA	ˈaːr (͡e͡n)ˌɑːɹˌɛnˈe͡ɪ(͡t͡a)
silencing	(͡e͡n)sˈa͡ɪlənsɪŋ(͡t͡a)
studies	(͡e͡n)stˈʌdiz(͡t͡a)
triangle	(͡e͡n)tɹˈa͡ɪaŋɡə͡l(͡t͡a)
und	(͡e͡n)ˈʌnd(͡t͡a)
visual	(͡e͡n)vˈɪʒuːə͡l(͡t͡a)
web	(͡e͡n)wˈɛb(͡t͡a)
white	(͡e͡n)wˈa͡ɪt(͡t͡a)
Ω	(͡e͡l)omˈeɣa(͡t͡a)
ஆசன	ˈaːsʌnʌ
ஆபரண	ˈaːbʌɹˌʌɳʌ
இத	ˈidʌ
ஈழவ	ˈiːɻʌvʌ
உகர	ˈuɡʌɹʌ
எம	ʲˈemʌ
ஐஓ	ˈa͡ɪoː
ககர	kˈʌɡʌɹʌ
கரண	kˈʌɹʌɳʌ
சதய	sˈʌdʌjʌ
சலன	sˈʌlʌnʌ
ர	ɹˈʌ
லய	lˈʌjʌ
ஹர	hˈʌɹʌ
