aandelenemissie	aːndeːləneːmɪsi
aankooien	aːnkoːi̯ən
aansmeden	aːnsmeːdən
aantal	aːntɑl
aantocht	aːntɔxt
aard	aːrt
aardhoop	aːrtɦoːp
aardslang	aːrtslɑŋ
aarswis	aːrsʋɪs
achterbuurt	ɑxtərbyːrt
achterhuis	ɑxtərɦœy̯s
achternicht	ɑxtərnɪxt
achtertocht	ɑxtərtɔxt
acrostichon	aːkrɔstixɔn
addergebroed	ɑdərɣəbrut
adeldom	aːdəldɔm
ademnood	aːdəmnoːt
adenoom	aːdənoːm
adrenocorticaal	aːdreːnoːkɔrtikaːl
adrie	aːdri
afbedelen	ɑfbeːdələn
afbreken	ɑvbreːkən
afgaan	ɑfxaːn
afgodisch	ɑfxoːdis
afstraffing	ɑfstrɑfɪŋ
aftroeven	ɑftruvən
afwerking	ɑfʋɛrkɪŋ
aldaar	ɑldaːr
aldehyde	ɑldəɦidə
alledaagsheid	ɑlədaːxsɦɛi̯t
alruin	ɑlrœy̯n
ambras	ɑmbrɑs
ambt	ɑmpt
amfibisch	ɑmfibis
analyse	aːnaːliːzə
anatomie	aːnaːtoːmi
angola	ɑŋɣoːlaː
angstgegner	ɑŋstɡeːɡnər
anneke	ɑnəkə
arbeidsman	ɑrbɛi̯tsmɑn
arbeidspool	ɑrbɛi̯tspuːl
archivarius	ɑrxivaːriʏs
archont	ɑrxɔnt
armeens	ɑrmeːns
artsenijkunde	ɑrtsənɛi̯kʏndə
baarmoederhals	baːrmudərɦɑls
baboes	baːbus
bakkerij	bɑkərɛi̯
bakt	bɑkt
bami	baːmi
bandsperfilter	bɑntspɛrfɪltər
bangerik	bɑŋərɪk
barones	baːrɔnɛs
bastaardklaproos	bɑstaːrtklɑproːs
beboeting	bəbutɪŋ
bedek	bədɛk
bedekken	bədɛkən
bedekte	bədɛktə
bedlamp	bɛtlɑmp
bedremmelen	bədrɛmələn
bedvriendin	bɛtfrindɪn
begeerd	bəɣeːrt
begeren	bəɣeːrən
behandelaar	bəɦɑndəlaːr
behandelen	bəɦɑndələn
behartenswaardig	bəɦɑrtənsʋaːrdəx
bei	bɛi̯
beklijven	bəklɛi̯vən
bekroning	bəkroːnɪŋ
belastingdruk	bəlɑstɪŋdrʏk
beletsel	bəlɛtsəl
benaaien	bənaːi̯ən
bengaals	bɛŋɣaːls
bereider	bərɛi̯dər
bermlamp	bɛrmlɑmp
berokken	bərɔkən
besparen	bəspaːrən
beter	beːtər
betuttelen	bətʏtələn
bewettigen	bəʋɛtəɣən
bewijsmiddel	bəʋɛi̯smɪdəl
bewolking	bəʋɔlkɪŋ
bewoording	bəʋoːrdɪŋ
bezabberen	bəzɑbərən
bidon	bidɔn
bierazijn	biːraːzɛi̯n
bierbrouwer	biːrbrɑu̯ər
bijwerking	bɛiʋɛrkɪŋ
bijwoord	bɛi̯ʋoːrt
binden	bɪndən
binnentrekken	bɪnəntrɛkən
biosfeer	bioːsfeːr
bisdom	bɪsdɔm
bivakkeren	bivɑkeːrən
bladgroente	blɑtxruntə
blaren	blaːrən
bloedschande	blutsxɑndə
boenen	bunən
boevengilde	buvənɣɪldə
bom	bɔm
bondgenoot	bɔntxənoːt
botergeil	boːtərɣɛi̯l
bovenbuur	boːvənbyːr
bovenwinds	boːvənʋɪnts
branden	brɑndən
brandweervrouw	brɑntʋeːrvrɑu̯
breinaald	brɛi̯naːlt
breinvlies	brɛi̯nvlis
broeden	brudən
broer	bruːr
brokken	brɔkən
brombeer	brɔmbeːr
brooche	broːxə
buikworm	bœy̯kʋɔrm
buis	bœy̯s
bunker	bʏŋkər
canapé	kaːnaːpeː
cassette	kɑsɛtə
chemicaliëntanker	xeːmikaːliəntɛŋkər
circumfix	sɪrkʏmfɪks
citroenappel	sitrunɑpəl
corrie	kɔri
curiosum	kyːrioːzʏm
cytoskelet	sitoːskəlɛt
dagvaarden	dɑxfaːrdən
dam	dɑm
dapper	dɑpər
debiteur	deːbitøːr
delen	deːlən
demoduleren	deːmoːdyleːrən
dempen	dɛmpən
dichtkundig	dɪxtkʏndəx
dierenrechtenactivisme	diːrənrɛxtənɑktivɪsmə
dierenwelzijn	diːrənʋɛlzɛi̯n
dierhalve	diːrɦɑlvə
dierperk	diːrpɛrk
dobber	dɔbər
doodgegaan	doːtxəɣaːn
dooiaanval	doːi̯aːnvɑl
doordrijven	doːrdrɛi̯vən
dopers	doːpərs
drekpoëet	drɛkpoːeːt
duffels	dʏfəls
duivenhuis	dœy̯vənɦœy̯s
dukaat	dykaːt
ecoduct	eːkoːdʏkt
eiken	ɛi̯kən
elk	ɛlk
endocarp	ɛndoːkɑrp
epigrafisch	eːpiɣraːfis
epoche	eːpɔxə
ernstvuurwerk	ɛrnstfyːrʋɛrk
factie	fɑksi
factureren	fɑktyreːrən
faunist	fɑu̯nɪst
filtervoeder	fɪltərvudər
flipperspel	flɪpərspɛl
fonkelen	fɔŋkələn
fonologie	fonɔlɔɣi
fosfaat	fɔsfaːt
galliër	ɣɑliə
gedaagde	ɣədaːxdə
gedachtig	ɣədɑxtəx
geduldig	ɣədʏldəx
gegrepen	ɣəɣreːpən
geldigheid	ɣɛldəxɦɛi̯t
gemoeder	ɣəmudər
genitiefobject	ɣeːnitifɔpjɛkt
genua	ɣeːnyʋaː
gevaar	ɣəvaːr
gezinsmoord	ɣəzɪnsmoːrt
geïnterviewde	ɣəɪntərvjudə
gleuf	ɣløːf
gloed	ɣlut
godheid	ɣɔtɦɛi̯t
goeie	ɣujə
golfpapier	ɣɔlfpaːpiːr
groeneveld	ɣrunəvɛlt
gruwel	ɣryəl
haai	ɦaːi̯
hammam	ɦɑmɑm
hang	ɦɑŋ
heggenmus	ɦɛɣənmʏs
heidendom	ɦɛi̯dəndɔm
helena	ɦeːleːnaː
hem	ɦɛm
hersenkind	ɦɛrsənkɪnt
heterogeniteit	ɦeːtəroːɣeːnitɛi̯t
heur	ɦøːr
hongaars	ɦɔŋɣaːrs
hoorzitting	ɦoːrzɪtɪŋ
hospitaalkerkschip	ɦɔspitaːlkɛrksxɪp
houtprent	ɦɑu̯tprɛnt
hugenoot	ɦyɣənoːt
icoon	ikoːn
ijsbeer	ɛi̯sbeːr
ijshoen	ɛi̯sɦun
ijsplateau	ɛi̯splaːtoː
inchoatief	ɪŋxoːaːtif
ingewanden	ɪnɣəʋɑndən
instrument	ɪnstrymɛnt
interviews	ɪntərvjus
jenevervrienden	jəneːvərvrindən
jurk	jʏrk
kaas	kaːs
kalefateren	kaːləfaːtərən
kan	kɑn
kapmes	kɑpmɛs
karbouw	kɑrbɑu̯
katoen	kaːtun
kattenkruid	kɑtənkrœy̯t
keek	keːk
kernfysica	kɛrnfizikaː
kerosine	keːroːzinə
kerriepoeder	kɛripudər
kiesstelsel	kistɛlsəl
kijkoperatie	kɛi̯koːpəraːtsi
kikker	kɪkər
klapper	klɑpər
klappernoot	klɑpərnoːt
klauwen	klɑu̯ən
kleden	kleːdən
kleinodiën	klɛi̯noːdiən
klimaat	klimaːt
kling	klɪŋ
klootzak	kloːtzɑk
knap	knɑp
knappen	knɑpən
knekelstad	kneːkəlstɑt
knil	knɪl
koemelk	kumɛlk
kokerjuffer	koːkərjʏfər
kombuis	kɔmbœy̯s
kommavlinder	kɔmaːvlɪndər
kortheidshalve	kɔrtɦɛi̯tsɦɑlvə
kosmonaut	kɔsmoːnɑu̯t
kost	kɔst
kozijn	koːzɛi̯n
kraamwijn	kraːmʋɛi̯n
krant	krɑnt
krentenbol	krɛntənbɔl
lactoscoop	lɑktoːskoːp
landadel	lɑntaːdəl
langharig	lɑŋɦaːrəx
langtong	lɑŋtɔŋ
lauwerkrans	lɑu̯ərkrɑns
ledebraken	leːdəbraːkən
leren	leːrən
levensbeschrijving	leːvənsbəsxrɛi̯vɪŋ
lever	leːvər
leverpastei	leːvərpɑstɛi̯
lezer	leːzər
lipstick	lɪpstɪk
loempia	lumpiaː
luchtbombardement	lʏxtbɔmbɑrdəmɛnt
luteren	lyteːrən
makreel	maːkreːl
mandril	mɑndrɪl
martyrium	mɑrtiːriʏm
matrijs	maːtrɛi̯s
matroos	maːtroːs
meerjarig	meːrjaːrəx
meetinstrument	meːtɪnstrymɛnt
mekander	məkɑndər
mensachtige	mɛnsɑxtəɣə
mezekouw	meːzəkɑu̯
middenin	mɪdənɪn
miezerd	mizərt
mijnwerkershelm	mɛi̯nʋɛrkərsɦɛlm
milonga	milɔŋɡaː
miltvuurbos	mɪltfyːrbɔs
minister	minɪstər
minziek	mɪnzik
mis	mɪs
monique	moːnik
monocultuur	moːnoːkʏltyːr
moorden	moːrdən
moorkop	moːrkɔp
mouillering	mui̯eːrɪŋ
muf	mʏf
naargelang	naːrɣəlɑŋ
nachtpo	nɑxtpoː
nachtpot	nɑxtpɔt
nageboorte	naːɣəboːrtə
nasaleren	naːzaːleːrən
nasmaak	naːsmaːk
natiestaat	naːtsistaːt
natuurgids	naːtuːrɣɪts
net	nɛt
noordvaarder	noːrtfaːrdər
ochtendhumeur	ɔxtəntɦymøːr
oliemolen	oːlimoːlən
onaards	ɔnaːrts
oncoloog	ɔnkoːloːx
onderscheidend	ɔndərsxɛi̯dənt
ondicht	ɔndɪxt
ongehoorzaamheid	ɔnɣəɦɔːrzaːmɦɛi̯t
ontbossen	ɔntbɔsən
ontfermen	ɔntfɛrmən
ontgrendelen	ɔntɣrɛndələn
ontluizen	ɔntlœy̯zən
ontnemen	ɔntneːmən
ontworstelen	ɔntʋɔrstələn
onzichtbaarheid	ɔnzɪxtbaːrɦɛi̯t
oorlogvoering	oːrlɔxfuːrɪŋ
oplichtster	ɔplɪxtstər
organist	ɔrɣaːnɪst
overhalen	oːvərɦaːlən
overmoed	oːvərmut
paard	paːrt
paardenfluisteraar	paːrdənflœy̯stəraːr
paasbaken	paːsbaːkən
paasfeest	paːsfeːst
pakt	pɑkt
paradepaard	paːraːdəpaːrt
parendans	paːrəndɑns
paringsdans	paːrɪŋsdɑns
pergamum	pɛrɣaːmʏm
perifrastisch	peːrifrɑstis
pijpensteel	pɛi̯pənsteːl
pimpel	pɪmpəl
pinakel	pinaːkəl
plezierjacht	pləziːrjɑxt
plosief	ploːzif
pluim	plœy̯m
pluk	plʏk
poppen	pɔpən
portret	pɔrtrɛt
potentie	poːtɛnsi
prisoen	prizun
proef	pruf
prostituee	prɔstityeː
pyriet	piːrit
reddingsvest	rɛdɪŋsfɛst
regentes	reːɣɛntɛs
remparachute	rɛmpaːraːʃyt
rentmeester	rɛntmeːstər
roodbaars	roːtbaːrs
roofkunst	roːfkʏnst
rotjeknor	rɔtjəknɔr
rotten	rɔtən
salto	sɑltoː
sappig	sɑpəx
saterfries	saːtərfris
scalperen	skɑlpeːrən
scapulier	skaːpyliːr
schans	sxɑns
schatting	sxɑtɪŋ
schizofreen	sxitsoːfreːn
scrip	skrɪp
selderij	sɛldərɛi̯
seraf	seːrɑf
serafijn	seːraːfɛi̯n
sirene	sirɛnə
sjacheren	ʃɑxərən
slagboom	slɑxboːm
sloegen	sluɣən
sluier	slœy̯ər
smaadrede	smaːtreːdə
smeltpunt	smɛltpʏnt
smetstof	smɛtstɔf
smetvrees	smɛtfreːs
sneer	sneːr
snoepreep	snupreːp
spandoek	spɑnduk
speelfilm	speːlfɪlm
spelleider	spɛlɛi̯dər
spierwit	spiːrʋɪt
spinhuis	spɪnɦœy̯s
spookstad	spoːkstɑt
stabiel	staːbil
stamhoofd	stɑmɦoːft
stamkroeg	stɑmkrux
steenvrucht	steːnvrʏxt
sterrenbeeld	stɛrənbeːlt
stik	stɪk
stink	stɪŋk
stoottoon	stoːtoːn
stram	strɑm
tamil	taːmil
tandplak	tɑntplɑk
tas	tɑs
taxi	tɑksi
teerzand	teːrzɑnt
tekenen	teːkənən
themapark	teːmaːpɑrk
theose	teːoːzə
tittel	tɪtəl
tjiftjaf	tjɪftjɑf
toerfiets	tuːrfits
toonladder	toːnlɑdər
torren	tɔrən
tovergodin	toːvərɣoːdɪn
transmens	trɑnsmɛns
triplan	triplɑn
troef	truf
tsarendynastie	tsaːrəndinɑsti
tuigleren	tœy̯xleːərn
tuinstad	tœy̯nstɑt
uitdelgen	œy̯dɛlɣən
uitspraakwoordenboekjes	œy̯tspraːkʋoːrdənbukjəs
uitstellen	œy̯tstɛlən
uitwerpsel	œy̯tʋɛrpsəl
valg	vɑlx
vangt	vɑŋt
vaticaanstad	vaːtikaːnstɑt
veteraantje	veterantjə
veto	veːtoː
viel	vil
vierkant	viːrkɑnt
vliegtuigslurf	vlixtœy̯xslʏrf
voetafdruk	vutɑfdrʏk
voor	voːr
voorbeeldzin	voːrbeːltsɪn
voorgebergte	voːrɣəbɛrxtə
voorpoot	voːrpoːt
vrijspraak	vrɛi̯spraːk
vuurzee	vyːrzeː
waakvlam	ʋaːkflɑm
wade	ʋaːdə
wagenpark	ʋaːɣənpɑrk
wederhalen	ʋeːdərɦaːlən
wind	ʋɪnt
windstoot	ʋɪntstoːt
wiri	ʋiri
woekerhypotheek	ʋukərɦipoːteːk
woen	ʋun
wolven	ʋɔlvən
wormvormig	ʋɔrmvɔrməx
wortelen	ʋɔrtələn
xylofoon	ksiloːfoːn
zaan	zaːn
zandvoort	zɑntfoːrt
zaterdag	zaːtərdɑx
zegswijze	zɛxsʋɛi̯zə
zenuwoorlog	zeːnyu̯oːrlɔx
zieder	zidər
zinnebeeld	zɪnəbeːlt
zinnelijk	zɪnələk
zitskiester	zɪtskistər
zomer	zoːmər
zona	zoːnaː
zorgen	zɔrɣən
zowat	zoːʋɑt
zowel	zoːʋɛl
zoönotisch	zoːoːnoːtis
zuivering	zœy̯vərɪŋ
zullen	zʏlən
zwemvlies	zʋɛmvlis
