የሌሎች	jˈəlelot͡ʃ
አለባበስ	ʔˈaləβaβəs
መልካም	mˈəlɨkam
በገጠር	bˈəɡət`ər
የቴዎድሮስ	jˈətewodɨros
ወንዝ	wˈənɨz
መልእክተኛ	mˈəlɨʔɨkɨtəɲa
የሚሰሩ	jˈəmisəru
እንግሊዝ	ʔˈɨnɨɡɨliz
ከሥልጣን	kˈəsɨlɨt`an
ታደሰ	tˈadəsə
ናምሩድ	nˈamɨrud
በራሳቸው	bˈərasat͡ʃəw
ጊዜያት	ɡˈizejat
ሊታይ	lˈitaj
በቻይና	bˈət͡ʃajɨna
የተጠቀሰው	jˈətət`ək`əsəw
የሚገኝ	jˈəmiɡəɲ
ግራኝ	ɡˈɨraɲ
ወንጀል	wˈənɨd͡ʒəl
ገብ	ɡˈəb
በጊዜው	bˈəɡizew
ሲሞቱ	sˈimotu
አያሌ	ʔˈajale
ካልሆነ	kˈalɨhonə
ሞተ	mˈotə
ነበረች	nˈəβərət͡ʃ
ተሰብስበው	tˈəsəβɨsɨβəw
እነ	ʔˈɨnə
የተነሣ	jˈətənəsa
የቴሌቪዥን	jˈəteleviʒɨn
የተፈለፈ	jˈətəfələfə
ሆን	hˈon
የኖቤል	jˈənoβel
ሸንጎ	ʃˈənɨɡo
ያሕል	jˈahɨl
ፕሮግራሞች	pˈɨroɡɨramot͡ʃ
ሚዲያ	mˈidija
በዚህ	bˈəziç
ቢጫ	bˈit͡ʃ`a
መሰል	mˈəsəl
አገዛዝ	ʔˈaɡəzaz
ልጆቹ	lˈɨd͡ʒot͡ʃu
የሚለየው	jˈəmiləjəw
ቁጥሩ	k`ˈut`ɨru
ቁና	k`ˈuna
ሀገር	hˈaɡər
እንዳለው	ʔˈɨnɨdaləw
አቀማመጥ	ʔˈak`əmamət`
አገው	ʔˈaɡəw
መሆን	mˈəhon
ስራዎች	sˈɨrawot͡ʃ
ሰባ	sˈəβa
አዒሻ	ʔˈaʔiʃa
ከአምስት	kˈəʔamɨsɨt
አንተ	ʔˈanɨtə
ከተማዋ	kˈətəmawa
ልዩነቶች	lˈɨjunətot͡ʃ
የለውም	jˈələwɨm
ይሄው	jˈɨhew
ኒው	nˈiw
በአመጽ	bˈəʔaməts
ሠርቶ	sˈərɨto
ቤተክርስቲያን	bˈetəkɨrɨsɨtijan
ልጅ	lˈɨd͡ʒ
ይኖሩ	jˈɨnoru
የትምህርት	jˈətɨmɨhɨrɨt
የአንድነት	jˈəʔanɨdɨnət
የታዘዘ	jˈətazəzə
ሄዶ	hˈedo
ጫፍ	t͡ʃ`ˈaf
ትምህርታቸውን	tˈɨmɨhɨrɨtat͡ʃəwɨn
ክሮሞሶም	kˈɨromosom
ዙርያ	zˈurɨja
የለሽ	jˈələʃ
የራዲዮ	jˈəradijo
ገዳማ	ɡˈədama
በተጨማሪም	bˈətət͡ʃ`əmarim
ለመሥራት	lˈəməsɨrat
ወገብ	wˈəɡəb
ቅሬታ	k`ˈɨreta
የተሸፈነ	jˈətəʃəfənə
እራስን	ʔˈɨrasɨn
በቤተ	bˈəβetə
ባንክ	bˈanɨk
በሁለት	bˈəhulət
ቀውስ	k`ˈəwɨs
ፍጥነት	fˈɨt`ɨnət
ተንቀሳቃሽ	tˈənɨk`əsak`aʃ
በአጼ	bˈəʔatse
ራይሆልት	rˈajɨholɨt
በታሪክ	bˈətarik
በዓፄ	bˈəʔatse
በመጨረሻ	bˈəmət͡ʃ`ərəʃa
መምህራን	mˈəmɨhɨran
ተጨማሪ	tˈət͡ʃ`əmari
በፍጥነት	bˈəfɨt`ɨnət
ዲ	dˈi
ሕግ	hˈɨɡ
አይነተኛ	ʔˈajɨnətəɲa
ዓለቃ	ʔˈalək`a
አብረው	ʔˈaβɨrəw
ሰብዓዊ	sˈəβɨʔawi
ዘውዱን	zˈəwɨdun
ጋዜጠኞች	ɡˈazet`əɲot͡ʃ
ይገኝ	jˈɨɡəɲ
በዘመኑ	bˈəzəmənu
ውጤቱ	wˈɨt`etu
ድንገት	dˈɨnɨɡət
ለመወሰን	lˈəməwəsən
ከውጭ	kˈəwɨt͡ʃ`
ጎሳዎች	ɡˈosawot͡ʃ
ግንባር	ɡˈɨnɨβar
ተከታዩ	tˈəkətaju
በሰው	bˈəsəw
በባዶ	bˈəβado
በጥንታዊ	bˈət`ɨnɨtawi
ትቶ	tˈɨto
ትንቢት	tˈɨnɨβit
የተነሳው	jˈətənəsaw
ጎሳ	ɡˈosa
ከገባ	kˈəɡəβa
እየሆነ	ʔˈɨjəhonə
ነቢያት	nˈəβijat
ኃላፊነት	hˈalafinət
ሀይል	hˈajɨl
ነገዶች	nˈəɡədot͡ʃ
ነጥቦች	nˈət`ɨβot͡ʃ
ነፃ	nˈətsa
የተለያዩ	jˈətələjaju
አዘጋጅ	ʔˈazəɡad͡ʒ
ዕጅግ	ʔˈɨd͡ʒɨɡ
ልጅና	lˈɨd͡ʒɨna
ድግግሞሽ	dˈɨɡɨɡɨmoʃ
ስልጣኔ	sˈɨlɨt`ane
በፍቅር	bˈəfɨk`ɨr
የተገነባ	jˈətəɡənəβa
ሐሙስ	hˈamus
አልፋቤት	ʔˈalɨfaβet
ሜዳሊያ	mˈedalija
ውቤ	wˈɨβe
ነገርን	nˈəɡərɨn
እራሳቸው	ʔˈɨrasat͡ʃəw
ያለባቸው	jˈaləβat͡ʃəw
የተላከ	jˈətəlakə
አምስተኛው	ʔˈamɨsɨtəɲaw
አመቱ	ʔˈamətu
ዳይሬክተር	dˈajɨrekɨtər
እንዳለ	ʔˈɨnɨdalə
ትልልቅ	tˈɨlɨlɨk`
የብርሃን	jˈəβɨrɨhan
ስልጣን	sˈɨlɨt`an
ጠባቂ	t`ˈəβak`i
የልጆች	jˈəlɨd͡ʒot͡ʃ
እያንዳንዱ	ʔˈɨjanɨdanɨdu
የአንድ	jˈəʔanɨd
በተለይም	bˈətələjɨm
ደግሞ	dˈəɡɨmo
ጣኦታት	t`ˈaʔotat
ሲጀምር	sˈid͡ʒəmɨr
በተለያየ	bˈətələjajə
ሄኖክ	hˈenok
ቤከር	bˈekər
ቢቂላ	bˈik`ila
፩ኛ	ɲˈa
የዱር	jˈədur
አስፈላጊ	ʔˈasɨfəlaɡi
ጄኔራል	d͡ʒˈeneral
በዚያች	bˈəzijat͡ʃ
እነርሱ	ʔˈɨnərɨsu
ፊት	fˈit
አጻጻፍ	ʔˈatsatsaf
ሆነና	hˈonəna
ለማውጣት	lˈəmawɨt`at
ለመፍጠር	lˈəməfɨt`ər
አባቶች	ʔˈaβatot͡ʃ
ጥቅምት	t`ˈɨk`ɨmɨt
ቀኖች	k`ˈənot͡ʃ
መድረስ	mˈədɨrəs
የመላው	jˈəməlaw
ለማስወገድ	lˈəmasɨwəɡəd
ሙስሊም	mˈusɨlim
የእርሻ	jˈəʔɨrɨʃa
በሀገሪቱ	bˈəhaɡəritu
ጋዜጣ	ɡˈazet`a
ሕገ	hˈɨɡə
ምክንያቱም	mˈɨkɨnɨjatum
ሉቃስ	lˈuk`as
ሙከራዎች	mˈukərawot͡ʃ
ሥጋ	sˈɨɡa
ቅርስ	k`ˈɨrɨs
በመጀመሪያው	bˈəməd͡ʒəmərijaw
እኛ	ʔˈɨɲa
ከሌሎቹ	kˈəlelot͡ʃu
ደጃዝማች	dˈəd͡ʒazɨmat͡ʃ
ሁሉንም	hˈulunɨm
በአሁኑ	bˈəʔahunu
ተብሎ	tˈəβɨlo
በመሆኑ	bˈəməhonu
በጊዜ	bˈəɡize
አውሮጳውያን	ʔˈawɨrop`awɨjan
ሳዑዲ	sˈaʔudi
አባይ	ʔˈaβaj
መንኮራኩር	mˈənɨkorakur
ተጽዕኖ	tˈətsɨʔɨno
ዋሻ	wˈaʃa
ደጋፊዎች	dˈəɡafiwot͡ʃ
በምዕራብ	bˈəmɨʔɨrab
ከቤተ	kˈəβetə
ገጹ	ɡˈətsu
ገመድ	ɡˈəməd
ገብስ	ɡˈəβɨs
አጠገብ	ʔˈat`əɡəb
የስፖርት	jˈəsɨporɨt
ቅርጽ	k`ˈɨrɨts
በሽታዎች	bˈəʃɨtawot͡ʃ
ሃይሎች	hˈajɨlot͡ʃ
ስእል	sˈɨʔɨl
ዝና	zˈɨna
ክርክር	kˈɨrɨkɨr
የዕብራይስጥና	jˈəʔɨβɨrajɨsɨt`ɨna
የደም	jˈədəm
የካቲት	jˈəkatit
በየቦታው	bˈəjəβotaw
የስታትስቲክስ	jˈəsɨtatɨsɨtikɨs
ጎበዝ	ɡˈoβəz
ድርድር	dˈɨrɨdɨr
ባሕላዊ	bˈahɨlawi
እነኚህ	ʔˈɨnəɲiç
የሚሰራ	jˈəmisəra
ሊቅ	lˈik`
ዋንጫ	wˈanɨt͡ʃ`a
ግንቡ	ɡˈɨnɨβu
ፊልሞች	fˈilɨmot͡ʃ
አደገኛ	ʔˈadəɡəɲa
ህዝቦች	hˈɨzɨβot͡ʃ
የእንስሳት	jˈəʔɨnɨsɨsat
በሰሜን	bˈəsəmen
የሳይንስና	jˈəsajɨnɨsɨna
ውህደት	wˈɨhɨdət
ወፍጮ	wˈəfɨt͡ʃ`o
ተፈራ	tˈəfəra
እንደነበሩ	ʔˈɨnɨdənəβəru
ጀርመን	d͡ʒˈərɨmən
ለመናገር	lˈəmənaɡər
ትርጓሜውም	tˈɨrɨɡwamewɨm
የመጣው	jˈəmət`aw
ሲጻፍ	sˈitsaf
ቋንቋቸው	k`wˈanɨk`wat͡ʃəw
የምርምር	jˈəmɨrɨmɨr
በንጉሱ	bˈənɨɡusu
ጉባኤ	ɡˈuβaʔe
ምኒልክ	mˈɨnilɨk
ሕመም	hˈɨməm
ጥላቻ	t`ˈɨlat͡ʃa
ኦሮምኛ	ʔˈoromɨɲa
የተባሉ	jˈətəβalu
ወለድ	wˈələd
በጽሑፍ	bˈətsɨhuf
በዚች	bˈəzit͡ʃ
ከዚያም	kˈəzijam
ርቀት	rˈɨk`ət
ነጭ	nˈət͡ʃ`
ፓተንቶች	pˈatənɨtot͡ʃ
በብሉይ	bˈəβɨluj
የተወለደው	jˈətəwələdəw
ተደጋጋሚ	tˈədəɡaɡami
መጽሐፍትን	mˈətsɨhafɨtɨn
ግራ	ɡˈɨra
ለውጥን	lˈəwɨt`ɨn
የገዛው	jˈəɡəzaw
ሁሉን	hˈulun
አብዛኞቹ	ʔˈaβɨzaɲot͡ʃu
የተሰሩ	jˈətəsəru
አንዷ	ʔˈanɨdwa
የዩናይትድ	jˈəjunajɨtɨd
አማካይነት	ʔˈamakajɨnət
ያም	jˈam
ጋሜት	ɡˈamet
እንኳ	ʔˈɨnɨkwa
ውበት	wˈɨβət
ግዕዝኤዲት	ɡˈɨʔɨzɨʔedit
ተከተለው	tˈəkətələw
የቅርብ	jˈək`ɨrɨb
ለመድረስ	lˈəmədɨrəs
የሚታወቀው	jˈəmitawək`əw
ቀመር	k`ˈəmər
አቅድ	ʔˈak`ɨd
እራሱን	ʔˈɨrasun
አንዳንድ	ʔˈanɨdanɨd
መሪዎች	mˈəriwot͡ʃ
በታች	bˈətat͡ʃ
በሆኑ	bˈəhonu
ሥር	sˈɨr
ክፍያ	kˈɨfɨja
በትንሹ	bˈətɨnɨʃu
የስሜን	jˈəsɨmen
ለ	lˈə
ከበደ	kˈəβədə
ሽልማት	ʃˈɨlɨmat
አሚና	ʔˈamina
ስሞች	sˈɨmot͡ʃ
መገናኛ	mˈəɡənaɲa
ጠላት	t`ˈəlat
እንዲችል	ʔˈɨnɨdit͡ʃɨl
ነቢዩ	nˈəβiju
የሕንድ	jˈəhɨnɨd
የኪሽ	jˈəkiʃ
ደስታ	dˈəsɨta
አስተማማኝ	ʔˈasɨtəmamaɲ
ጥይት	t`ˈɨjɨt
ባሕር	bˈahɨr
ቁጥር	k`ˈut`ɨr
መደብ	mˈədəb
ዋጋ	wˈaɡa
ምሥራቅ	mˈɨsɨrak`
ቀዳዳ	k`ˈədada
ስለዚህ	sˈɨləziç
ማኅበር	mˈahɨβər
ስለዚሁ	sˈɨləzihu
የተቃውሞ	jˈətək`awɨmo
አቡጊዳ	ʔˈaβuɡida
ያ	jˈa
ይሆናል	jˈɨhonal
ሲገኙ	sˈiɡəɲu
መሠረት	mˈəsərət
ተነሥቶ	tˈənəsɨto
ለምሳሌ	lˈəmɨsale
ሲታይ	sˈitaj
ውቅር	wˈɨk`ɨr
ደጋማ	dˈəɡama
ይሆን	jˈɨhon
የሃይማኖት	jˈəhajɨmanot
ትክክለኛ	tˈɨkɨkɨləɲa
ጊዜውን	ɡˈizewɨn
ለመጠቀም	lˈəmət`ək`əm
ፈረንሳይ	fˈərənɨsaj
በዚያም	bˈəzijam
የትኛው	jˈətɨɲaw
ኩባንያ	kˈuβanɨja
ሰውን	sˈəwɨn
የእብድ	jˈəʔɨβɨd
ለዘላለም	lˈəzəlaləm
ውህድ	wˈɨhɨd
ተጽእኖ	tˈətsɨʔɨno
በሙሉ	bˈəmulu
ቄሣር	k`ˈesar
ኧ	ʔˈə
ጠንካራ	t`ˈənɨkara
ጨርቅ	t͡ʃ`ˈərɨk`
ፈጠራ	fˈət`əra
ድንጋዮች	dˈɨnɨɡajot͡ʃ
በእውነት	bˈəʔɨwɨnət
ሲገባ	sˈiɡəβa
ስምንት	sˈɨmɨnɨt
ላባርና	lˈaβarɨna
በየዓመቱ	bˈəjəʔamətu
ቁቤ	k`ˈuβe
የሙቀት	jˈəmuk`ət
ዘመነ	zˈəmənə
ሚስቶች	mˈisɨtot͡ʃ
ያካተተ	jˈakatətə
በመጀመሪያ	bˈəməd͡ʒəmərija
መሣርያ	mˈəsarɨja
ተደርጎ	tˈədərɨɡo
ነቢይ	nˈəβij
አጭር	ʔˈat͡ʃ`ɨr
እኔ	ʔˈɨne
ፍጹም	fˈɨtsum
ኅልዮት	hˈɨlɨjot
በተለመደው	bˈətələmədəw
በበሽታው	bˈəβəʃɨtaw
ከልጅነቱ	kˈəlɨd͡ʒɨnətu
በሒሳብ	bˈəhisab
እጥፍ	ʔˈɨt`ɨf
የህይወት	jˈəhɨjɨwət
የአካባቢ	jˈəʔakaβaβi
ጌታ	ɡˈeta
ምጣኔ	mˈɨt`ane
በሚባለው	bˈəmiβaləw
ደንቦች	dˈənɨβot͡ʃ
ከተባለው	kˈətəβaləw
የሚያሳይ	jˈəmijasaj
ምሳሌዎች	mˈɨsalewot͡ʃ
ግጥሞች	ɡˈɨt`ɨmot͡ʃ
ስራወችን	sˈɨrawət͡ʃɨn
ክፉኛ	kˈɨfuɲa
የዓማርኛ	jˈəʔamarɨɲa
በመቶ	bˈəməto
ቅጣት	k`ˈɨt`at
ደቂቃ	dˈək`ik`a
ያለ	jˈalə
ሆኖ	hˈono
መጽሐፈ	mˈətsɨhafə
የሚሆነውን	jˈəmihonəwɨn
የዶክተሩን	jˈədokɨtərun
የኤድስ	jˈəʔedɨs
የውስጥ	jˈəwɨsɨt`
አስተያየት	ʔˈasɨtəjajət
ኢትዮጵያዊ	ʔˈitɨjop`ɨjawi
ድንቅ	dˈɨnɨk`
በነዚህ	bˈənəziç
ቁስ	k`ˈus
መቀየር	mˈək`əjər
ያልሆኑ	jˈalɨhonu
ማስቀመጥ	mˈasɨk`əmət`
ጥፋት	t`ˈɨfat
ዕቅድ	ʔˈɨk`ɨd
ከእናታቸው	kˈəʔɨnatat͡ʃəw
ስያሜው	sˈɨjamew
ከራስ	kˈəras
መጽሐፋቸው	mˈətsɨhafat͡ʃəw
ኃይሌ	hˈajɨle
አራተኛው	ʔˈaratəɲaw
ሕንጻዎች	hˈɨnɨtsawot͡ʃ
ሰማይ	sˈəmaj
ኖህ	nˈox
ድል	dˈɨl
ብለን	bˈɨlən
ለራሳቸው	lˈərasat͡ʃəw
ኣኃዞች	ʔˈahazot͡ʃ
ተገቢ	tˈəɡəβi
ሳጥን	sˈat`ɨn
የፋርስ	jˈəfarɨs
ህብረተሰብ	hˈɨβɨrətəsəb
ስርአት	sˈɨrɨʔat
ሂደት	hˈidət
ቅጽል	k`ˈɨtsɨl
አጥር	ʔˈat`ɨr
ጽሕፈቶች	tsˈɨhɨfətot͡ʃ
ፊታውራሪ	fˈitawɨrari
ለማሳየት	lˈəmasajət
የእንግሊዝ	jˈəʔɨnɨɡɨliz
የኪነ	jˈəkinə
ቁምፊ	k`ˈumɨfi
እሱም	ʔˈɨsum
በአሥራ	bˈəʔasɨra
አስተዳዳሪ	ʔˈasɨtədadari
ወንድሙ	wˈənɨdɨmu
እግር	ʔˈɨɡɨr
መጠሪያ	mˈət`ərija
እጁ	ʔˈɨd͡ʒu
ተመልሶ	tˈəməlɨso
ቤተሰብ	bˈetəsəb
እኒህን	ʔˈɨnihɨn
እንቅፋት	ʔˈɨnɨk`ɨfat
ቀስ	k`ˈəs
ክፍለ	kˈɨfɨlə
ገጥመው	ɡˈət`ɨməw
ቀደምት	k`ˈədəmɨt
ተሟጋቾች	tˈəmwaɡat͡ʃot͡ʃ
ነገሥት	nˈəɡəsɨt
አለቆች	ʔˈalək`ot͡ʃ
ነገስት	nˈəɡəsɨt
መረጃዎችን	mˈərəd͡ʒawot͡ʃɨn
በሕግ	bˈəhɨɡ
አበቦች	ʔˈaβəβot͡ʃ
ከብት	kˈəβɨt
ለመሆኑ	lˈəməhonu
መጥፎ	mˈət`ɨfo
ሕዝቡ	hˈɨzɨβu
ቀይሮ	k`ˈəjɨro
በፋርስ	bˈəfarɨs
አውሮፓ	ʔˈawɨropa
መጀመርያ	mˈəd͡ʒəmərɨja
የአቶ	jˈəʔato
ክብ	kˈɨb
ከእግዚአብሔር	kˈəʔɨɡɨziʔaβɨher
በተጨባጭ	bˈətət͡ʃ`əβat͡ʃ`
መወለድ	mˈəwələd
አብጃድ	ʔˈaβɨd͡ʒad
ደሞ	dˈəmo
በድንገት	bˈədɨnɨɡət
ከአንዳንድ	kˈəʔanɨdanɨd
ሚካኤልን	mˈikaʔelɨn
ከባህር	kˈəβahɨr
ዞራስተር	zˈorasɨtər
መኻል	mˈəhal
ጳጳሱ	p`ˈap`asu
ረጅም	rˈəd͡ʒɨm
ሚሊዮን	mˈilijon
ለኢትዮጵያ	lˈəʔitɨjop`ɨja
ካርል	kˈarɨl
ከሚባለው	kˈəmiβaləw
ክንድ	kˈɨnɨd
የምግብ	jˈəmɨɡɨb
የሚነገር	jˈəminəɡər
የተሰኘ	jˈətəsəɲə
የደርግ	jˈədərɨɡ
በከፊል	bˈəkəfil
ኣዲስ	ʔˈadis
ባህርይ	bˈahɨrɨj
ተወዳዳሪ	tˈəwədadari
ብዬ	bˈɨje
በሽታ	bˈəʃɨta
በበርካታ	bˈəβərɨkata
ቁርአን	k`ˈurɨʔan
ጣልያን	t`ˈalɨjan
ሰብአዊ	sˈəβɨʔawi
የምዕራብ	jˈəmɨʔɨrab
ተክለ	tˈəkɨlə
መንግሥትን	mˈənɨɡɨsɨtɨn
በነበሩበት	bˈənəβəruβət
እራሱ	ʔˈɨrasu
ነፍሰ	nˈəfɨsə
የሞገድ	jˈəmoɡəd
ኢምንት	ʔˈimɨnɨt
መድኃኒት	mˈədɨhanit
የተወደደ	jˈətəwədədə
ድርጅት	dˈɨrɨd͡ʒɨt
ስትል	sˈɨtɨl
ሚኒስቴር	mˈinisɨter
መስራት	mˈəsɨrat
ለአንድ	lˈəʔanɨd
የሚኖር	jˈəminor
የድሮ	jˈədɨro
ምሽት	mˈɨʃɨt
የነበረውን	jˈənəβərəwɨn
አፍ	ʔˈaf
ከአባታቸው	kˈəʔaβatat͡ʃəw
የድንጋይ	jˈədɨnɨɡaj
ጉብኝት	ɡˈuβɨɲɨt
ከሚገኙ	kˈəmiɡəɲu
ይግባኝ	jˈɨɡɨβaɲ
ስሞቹ	sˈɨmot͡ʃu
በአንዳንድ	bˈəʔanɨdanɨd
እሱን	ʔˈɨsun
እንደሆኑ	ʔˈɨnɨdəhonu
መሐመድ	mˈəhaməd
እስካሁንም	ʔˈɨsɨkahunɨm
መሆናቸውን	mˈəhonat͡ʃəwɨn
ካቶሊክ	kˈatolik
ከማንኛውም	kˈəmanɨɲawɨm
ጠዋት	t`ˈəwat
ክስ	kˈɨs
በላዩ	bˈəlaju
ይሁን	jˈɨhun
መቃብር	mˈək`aβɨr
ዉስጥ	wˈusɨt`
ዝርዮች	zˈɨrɨjot͡ʃ
ሆስፒታል	hˈosɨpital
እያሱ	ʔˈɨjasu
በስተሰሜን	bˈəsɨtəsəmen
ተስፋ	tˈəsɨfa
ጥልቀት	t`ˈɨlɨk`ət
ከግብጽ	kˈəɡɨβɨts
ዳ	dˈa
ዓላማ	ʔˈalama
በተቃራኒ	bˈətək`arani
አንደኛው	ʔˈanɨdəɲaw
በሕዝብ	bˈəhɨzɨb
የበላይ	jˈəβəlaj
ግብጽ	ɡˈɨβɨts
የአውሮፓ	jˈəʔawɨropa
ወራት	wˈərat
ቄስ	k`ˈes
ብቅ	bˈɨk`
በስተ	bˈəsɨtə
እርግጥ	ʔˈɨrɨɡɨt`
ሰው	sˈəw
በነጻ	bˈənətsa
መዝገቦች	mˈəzɨɡəβot͡ʃ
ተቀምጦ	tˈək`əmɨt`o
ሴቶች	sˈetot͡ʃ
አሸንፎ	ʔˈaʃənɨfo
በሰፊው	bˈəsəfiw
አገሩ	ʔˈaɡəru
ስማቸውን	sˈɨmat͡ʃəwɨn
ሙሉ	mˈulu
ትንታኔ	tˈɨnɨtane
እንዳገኘ	ʔˈɨnɨdaɡəɲə
አይቶ	ʔˈajɨto
ኢየሱስን	ʔˈijəsusɨn
ማርቲን	mˈarɨtin
የወሎ	jˈəwəlo
በማሪ	bˈəmari
መጣ	mˈət`a
እርዳታ	ʔˈɨrɨdata
እርሱም	ʔˈɨrɨsum
የአምክንዮ	jˈəʔamɨkɨnɨjo
ባቢሎንን	bˈaβilonɨn
ምትክ	mˈɨtɨk
ገበሬ	ɡˈəβəre
ምዕራፍ	mˈɨʔɨraf
ከሱ	kˈəsu
ከሚገኙት	kˈəmiɡəɲut
ጅረት	d͡ʒˈɨrət
ሳር	sˈar
የተባበሩት	jˈətəβaβərut
አይደለም	ʔˈajɨdələm
ቀለሞችን	k`ˈələmot͡ʃɨn
ማንም	mˈanɨm
ፋንታ	fˈanɨta
ይታያል	jˈɨtajal
ጋር	ɡˈar
ጫካ	t͡ʃ`ˈaka
ወቅት	wˈək`ɨt
ዕድል	ʔˈɨdɨl
አማኞች	ʔˈamaɲot͡ʃ
ዘፈኖች	zˈəfənot͡ʃ
የአሜሪካ	jˈəʔamerika
ጋዜጠኝነት	ɡˈazet`əɲɨnət
ጣዖት	t`ˈaʔot
በነበረበት	bˈənəβərəβət
ወጣ	wˈət`a
እነርሱም	ʔˈɨnərɨsum
አምላክ	ʔˈamɨlak
የልጅ	jˈəlɨd͡ʒ
ለዘመኑ	lˈəzəmənu
ብርሃን	bˈɨrɨhan
፪ኛው	ɲˈaw
በቀስ	bˈək`əs
አረፍተ	ʔˈarəfɨtə
ድርጊቶች	dˈɨrɨɡitot͡ʃ
አመጽ	ʔˈaməts
አንዲት	ʔˈanɨdit
የአባይ	jˈəʔaβaj
ከግሪኩ	kˈəɡɨriku
ነግሦ	nˈəɡɨso
ቀለም	k`ˈələm
ዘመናዊው	zˈəmənawiw
ከእስር	kˈəʔɨsɨr
ጼዴቅ	tsˈedek`
የእግር	jˈəʔɨɡɨr
በጥይት	bˈət`ɨjɨt
ሳይሆን	sˈajɨhon
የሚያስተምር	jˈəmijasɨtəmɨr
በዓማርኛ	bˈəʔamarɨɲa
አንቺ	ʔˈanɨt͡ʃi
መታወቂያ	mˈətawək`ija
ኢብን	ʔˈiβɨn
ቅርሶች	k`ˈɨrɨsot͡ʃ
ይመልከቱ	jˈɨməlɨkətu
ባላቸው	bˈalat͡ʃəw
በቋሚ	bˈək`wami
በስራ	bˈəsɨra
ጀርባ	d͡ʒˈərɨβa
በጥንቱ	bˈət`ɨnɨtu
አለ	ʔˈalə
የሌላ	jˈəlela
ታዋቂ	tˈawak`i
የተለመደ	jˈətələmədə
የሚሰራው	jˈəmisəraw
ቃላት	k`ˈalat
በዚያን	bˈəzijan
ፕሮጀክት	pˈɨrod͡ʒəkɨt
ከኢትዮጵያ	kˈəʔitɨjop`ɨja
በስሙ	bˈəsɨmu
ኢየሩሳሌም	ʔˈijərusalem
በኃላ	bˈəhala
ቱትሞስ	tˈutɨmos
ለሌላ	lˈəlela
ቁራጭ	k`ˈurat͡ʃ`
አለቃም	ʔˈalək`am
በአራት	bˈəʔarat
አደጋ	ʔˈadəɡa
ጥቃቅን	t`ˈɨk`ak`ɨn
ባሁኑ	bˈahunu
ልዩነት	lˈɨjunət
ከዚያው	kˈəzijaw
እንዲያገኙ	ʔˈɨnɨdijaɡəɲu
ጥገኛ	t`ˈɨɡəɲa
እንደሆነች	ʔˈɨnɨdəhonət͡ʃ
ስብሰባ	sˈɨβɨsəβa
ጥርስ	t`ˈɨrɨs
የሚገኝበት	jˈəmiɡəɲɨβət
ባህላዊ	bˈahɨlawi
እያሉ	ʔˈɨjalu
በቶሎ	bˈətolo
ቁልፍ	k`ˈulɨf
በዛ	bˈəza
መዝሙር	mˈəzɨmur
ሰራሽ	sˈəraʃ
ጽንሰ	tsˈɨnɨsə
ተቃዋሚ	tˈək`awami
ጠንቅ	t`ˈənɨk`
ጦርነቶች	t`ˈorɨnətot͡ʃ
ገበያ	ɡˈəβəja
ወኪል	wˈəkil
ሪፑብሊክ	rˈipuβɨlik
ከመቶ	kˈəməto
ወደፊት	wˈədəfit
ምስሎች	mˈɨsɨlot͡ʃ
ለዓለም	lˈəʔaləm
ሃይሉ	hˈajɨlu
መኖር	mˈənor
ለማግኘት	lˈəmaɡɨɲət
ንጉሰ	nˈɨɡusə
እንዳልሆነ	ʔˈɨnɨdalɨhonə
የእግዚአብሔር	jˈəʔɨɡɨziʔaβɨher
የራሳቸውን	jˈərasat͡ʃəwɨn
ክብረ	kˈɨβɨrə
መምህሮች	mˈəmɨhɨrot͡ʃ
የተወለዱ	jˈətəwələdu
በቁርአን	bˈək`urɨʔan
ተጠቃሚ	tˈət`ək`ami
ከሩቅ	kˈəruk`
በቀላሉ	bˈək`əlalu
ቀለሞች	k`ˈələmot͡ʃ
ቀረጥ	k`ˈərət`
በመካከለኛ	bˈəməkakələɲa
ህይወት	hˈɨjɨwət
ኢየሱስም	ʔˈijəsusɨm
መጽሐፉ	mˈətsɨhafu
ፖለቲካ	pˈolətika
ተማሪዎችን	tˈəmariwot͡ʃɨn
ለመጥቀስ	lˈəmət`ɨk`əs
አበባ	ʔˈaβəβa
የሕዝብ	jˈəhɨzɨb
በመቀየር	bˈəmək`əjər
ሄደው	hˈedəw
ከሌላ	kˈəlela
ቁጥሩም	k`ˈut`ɨrum
ጽላቶች	tsˈɨlatot͡ʃ
መናገር	mˈənaɡər
ማግኘት	mˈaɡɨɲət
ኃይሉ	hˈajɨlu
በሳይንሳዊ	bˈəsajɨnɨsawi
ስብስብ	sˈɨβɨsɨb
ሃይል	hˈajɨl
ማረጋገጫ	mˈarəɡaɡət͡ʃ`a
ዘኢትዮጵያ	zˈəʔitɨjop`ɨja
ምርቶች	mˈɨrɨtot͡ʃ
ማዕዘን	mˈaʔɨzən
የሰራው	jˈəsəraw
ትርፍ	tˈɨrɨf
አመለካከት	ʔˈamələkakət
ሃያ	hˈaja
ማህበረሰቦች	mˈahɨβərəsəβot͡ʃ
ወጣቶች	wˈət`atot͡ʃ
ሀይሮግሊፍ	hˈajɨroɡɨlif
ይዘቱ	jˈɨzətu
በህይወት	bˈəhɨjɨwət
የምትገኝ	jˈəmɨtɨɡəɲ
ዘመናዊ	zˈəmənawi
ዮሴፍ	jˈosef
አንስተኛ	ʔˈanɨsɨtəɲa
መንደሮች	mˈənɨdərot͡ʃ
ተመራማሪወች	tˈəməramariwət͡ʃ
ሆና	hˈona
ከጣልያን	kˈət`alɨjan
ቋንቋው	k`wˈanɨk`waw
ካሉት	kˈalut
በቋንቋ	bˈək`wanɨk`wa
ሁለተኛ	hˈulətəɲa
በከነዓን	bˈəkənəʔan
ሁኖ	hˈuno
የአገር	jˈəʔaɡər
መልዕክት	mˈəlɨʔɨkɨt
የሚሠራ	jˈəmisəra
ሥርዓተ	sˈɨrɨʔatə
ሐይቅ	hˈajɨk`
የብሔረሰቡ	jˈəβɨherəsəβu
አፈር	ʔˈafər
ምክንያቶች	mˈɨkɨnɨjatot͡ʃ
እስልምና	ʔˈɨsɨlɨmɨna
አብዛኛዎቹ	ʔˈaβɨzaɲawot͡ʃu
ቱቦ	tˈuβo
ወልደ	wˈəlɨdə
ለረዥም	lˈərəʒɨm
የከፍተኛ	jˈəkəfɨtəɲa
አዳም	ʔˈadam
ጽሕፈት	tsˈɨhɨfət
ነገሥቱን	nˈəɡəsɨtun
በሌላው	bˈəlelaw
መፅሐፍ	mˈətsɨhaf
አርዕስት	ʔˈarɨʔɨsɨt
አስረካቢ	ʔˈasɨrəkaβi
ከመሆኑም	kˈəməhonum
በግድ	bˈəɡɨd
የሚሰጠው	jˈəmisət`əw
ቁመት	k`ˈumət
የላቀ	jˈəlak`ə
ማዕከሉ	mˈaʔɨkəlu
ኤም	ʔˈem
መ	mˈə
ተወካዮች	tˈəwəkajot͡ʃ
ማታ	mˈata
የአርጀንቲና	jˈəʔarɨd͡ʒənɨtina
አስተኔ	ʔˈasɨtəne
ክሬዲት	kˈɨredit
ሲገቡ	sˈiɡəβu
ዘመቻ	zˈəmət͡ʃa
ነዳጅ	nˈədad͡ʒ
ከንቲባ	kˈənɨtiβa
ነፋስ	nˈəfas
ተቋማት	tˈək`wamat
ምስጢር	mˈɨsɨt`ir
ብዛቱ	bˈɨzatu
ምነው	mˈɨnəw
በየጊዜው	bˈəjəɡizew
ገለልተኛ	ɡˈələlɨtəɲa
ዘይት	zˈəjɨt
የክብር	jˈəkɨβɨr
ቅጠሉ	k`ˈɨt`əlu
የመሳሰሉትን	jˈəməsasəlutɨn
በማየት	bˈəmajət
አተር	ʔˈatər
ሲገኝ	sˈiɡəɲ
በማሰብ	bˈəmasəb
ስላሴ	sˈɨlase
ስድስት	sˈɨdɨsɨt
በዝርዝሩ	bˈəzɨrɨzɨru
የብር	jˈəβɨr
ቮልቴጅ	vˈolɨted͡ʒ
ዕድሜያቸው	ʔˈɨdɨmejat͡ʃəw
አመራር	ʔˈamərar
መላእክት	mˈəlaʔɨkɨt
ከሞላ	kˈəmola
ግዛት	ɡˈɨzat
እድሜው	ʔˈɨdɨmew
በውነት	bˈəwɨnət
የመካከለኛው	jˈəməkakələɲaw
ተናጋሪ	tˈənaɡari
ለመርዳት	lˈəmərɨdat
ለፍርድ	lˈəfɨrɨd
ፅንስ	tsˈɨnɨs
የሚለውን	jˈəmiləwɨn
የሌላውን	jˈəlelawɨn
በሮማይስጥ	bˈəromajɨsɨt`
ሳለ	sˈalə
ሕይወታቸው	hˈɨjɨwətat͡ʃəw
አለኝ	ʔˈaləɲ
ፈርዖኖች	fˈərɨʔonot͡ʃ
ኤፍ	ʔˈef
ጀግና	d͡ʒˈəɡɨna
የፈረስ	jˈəfərəs
ለማየት	lˈəmajət
ኅዋ	hˈɨwa
ዛሬ	zˈare
የተባለውን	jˈətəβaləwɨn
ሁላቸው	hˈulat͡ʃəw
ሀሣብ	hˈasab
በግብፅ	bˈəɡɨβɨts
በዛሬው	bˈəzarew
ሲባል	sˈiβal
ደግሞም	dˈəɡɨmom
ሊታወቅ	lˈitawək`
ኮሚቴ	kˈomite
መጻሕፍት	mˈətsahɨfɨt
የአራት	jˈəʔarat
ነዋሪ	nˈəwari
የቤተሰብ	jˈəβetəsəb
ሰኔ	sˈəne
የተሳሳተ	jˈətəsasatə
ነበርና	nˈəβərɨna
በሥነ	bˈəsɨnə
ድሃ	dˈɨha
ስነ	sˈɨnə
ብቻ	bˈɨt͡ʃa
ምግባር	mˈɨɡɨβar
ውስጣዊ	wˈɨsɨt`awi
ዋና	wˈana
ሊቃውንት	lˈik`awɨnɨt
የተባለው	jˈətəβaləw
እንዲሄድ	ʔˈɨnɨdihed
መጻፍ	mˈətsaf
ይልቁኑ	jˈɨlɨk`unu
ኃያል	hˈajal
የሰውን	jˈəsəwɨn
የሙያ	jˈəmuja
ግኝት	ɡˈɨɲɨt
ጨረራ	t͡ʃ`ˈərəra
መልስ	mˈəlɨs
ወስዶ	wˈəsɨdo
ለማመልከት	lˈəmaməlɨkət
መርከቦች	mˈərɨkəβot͡ʃ
ኣራት	ʔˈarat
በራሂ	bˈərahi
የሴት	jˈəset
ተመሳሳይ	tˈəməsasaj
ከእንጨት	kˈəʔɨnɨt͡ʃ`ət
ወታደር	wˈətadər
የግስበት	jˈəɡɨsɨβət
አልፋ	ʔˈalɨfa
ከሁለቱ	kˈəhulətu
ስላለ	sˈɨlalə
ቅኔ	k`ˈɨne
እስቴትስ	ʔˈɨsɨtetɨs
ተደርገው	tˈədərɨɡəw
ከግዕዙ	kˈəɡɨʔɨzu
ባለስልጣን	bˈaləsɨlɨt`an
ይሁዳ	jˈɨhuda
የለውጥ	jˈələwɨt`
የበሽታ	jˈəβəʃɨta
ዘርፍ	zˈərɨf
ዕድገት	ʔˈɨdɨɡət
ሲጽፍ	sˈitsɨf
ከነገሠ	kˈənəɡəsə
በመልካም	bˈəməlɨkam
እንዳለበት	ʔˈɨnɨdaləβət
ትምህርቱን	tˈɨmɨhɨrɨtun
በማመን	bˈəmamən
ኣሥር	ʔˈasɨr
ጽላት	tsˈɨlat
ቢላል	bˈilal
የግእዝ	jˈəɡɨʔɨz
ቀጥታ	k`ˈət`ɨta
ከዚሁ	kˈəzihu
የዓመት	jˈəʔamət
ተሳታፊዎች	tˈəsatafiwot͡ʃ
እንደዚያ	ʔˈɨnɨdəzija
እንቁላል	ʔˈɨnɨk`ulal
ሽማግሌ	ʃˈɨmaɡɨle
ተቀባይነት	tˈək`əβajɨnət
ጋብቻ	ɡˈaβɨt͡ʃa
መዓዛ	mˈəʔaza
ጉዳዩ	ɡˈudaju
አትክልት	ʔˈatɨkɨlɨt
ጥበብ	t`ˈɨβəb
መንግሥታቸው	mˈənɨɡɨsɨtat͡ʃəw
ለመግለጽ	lˈəməɡɨləts
መንገድ	mˈənɨɡəd
ከተማን	kˈətəman
አጥንት	ʔˈat`ɨnɨt
ጡት	t`ˈut
የሆኑትን	jˈəhonutɨn
በመጀመርያው	bˈəməd͡ʒəmərɨjaw
አይነት	ʔˈajɨnət
አባትና	ʔˈaβatɨna
እንደሚሆን	ʔˈɨnɨdəmihon
አውራጃ	ʔˈawɨrad͡ʒa
ምልክት	mˈɨlɨkɨt
ዘገባ	zˈəɡəβa
በትንሽ	bˈətɨnɨʃ
በሱመር	bˈəsumər
ለመጻፍ	lˈəmətsaf
አድርጎ	ʔˈadɨrɨɡo
ተጋድሎ	tˈəɡadɨlo
በመነሳት	bˈəmənəsat
ዶክተሩ	dˈokɨtəru
አንድላይ	ʔˈanɨdɨlaj
ሰፍነጎች	sˈəfɨnəɡot͡ʃ
በኣንድና	bˈəʔanɨdɨna
የማሪ	jˈəmari
ገብርኤል	ɡˈəβɨrɨʔel
ዮሴፉስ	jˈosefus
ተነስቶ	tˈənəsɨto
የተነሳ	jˈətənəsa
ጥቂት	t`ˈɨk`it
ቁም	k`ˈum
ሪቻርድ	rˈit͡ʃarɨd
ምንጭ	mˈɨnɨt͡ʃ`
ሰዉ	sˈəwu
ሃይማኖቱን	hˈajɨmanotun
ነዋሪዎች	nˈəwariwot͡ʃ
በጦር	bˈət`or
በዓላት	bˈəʔalat
ማተሚያ	mˈatəmija
ሲደርሱ	sˈidərɨsu
ፖርቱጋል	pˈorɨtuɡal
ክፍላገር	kˈɨfɨlaɡər
የመንገድ	jˈəmənɨɡəd
ማንኛውም	mˈanɨɲawɨm
ህንጻ	hˈɨnɨtsa
የሚጠጉ	jˈəmit`əɡu
በአላህ	bˈəʔalax
ሕጻን	hˈɨtsan
ቀንድ	k`ˈənɨd
በሶርያ	bˈəsorɨja
ማስታወቂያ	mˈasɨtawək`ija
ዘውዴ	zˈəwɨde
ሥላሴን	sˈɨlasen
ገጸ	ɡˈətsə
አስቀድሞ	ʔˈasɨk`ədɨmo
ጠጅ	t`ˈəd͡ʒ
የብሪታንያ	jˈəβɨritanɨja
በግል	bˈəɡɨl
ማየት	mˈajət
ባለሙያ	bˈaləmuja
እንግዲህ	ʔˈɨnɨɡɨdiç
አካላት	ʔˈakalat
ባለፉት	bˈaləfut
ተቀብሎ	tˈək`əβɨlo
መርዛም	mˈərɨzam
ቦታውን	bˈotawɨn
በጀርመን	bˈəd͡ʒərɨmən
እውነተኛ	ʔˈɨwɨnətəɲa
ረሃብ	rˈəhab
የህዝብ	jˈəhɨzɨb
አልፈው	ʔˈalɨfəw
ስም	sˈɨm
አረመኔ	ʔˈarəməne
አማራ	ʔˈamara
ክብር	kˈɨβɨr
ግልጽ	ɡˈɨlɨts
የሴቶች	jˈəsetot͡ʃ
ተያይዞ	tˈəjajɨzo
ሲተረጎም	sˈitərəɡom
ቀላል	k`ˈəlal
ዓይነት	ʔˈajɨnət
መከራ	mˈəkəra
ከዚህ	kˈəziç
አራት	ʔˈarat
ሠላሳ	sˈəlasa
ወደታች	wˈədətat͡ʃ
አግብቶ	ʔˈaɡɨβɨto
ያሳያል	jˈasajal
መድፍ	mˈədɨf
ኤንድ	ʔˈenɨd
አገራት	ʔˈaɡərat
ጽሁፍ	tsˈɨhuf
እጃቸውን	ʔˈɨd͡ʒat͡ʃəwɨn
በተለይ	bˈətələj
መዝገበ	mˈəzɨɡəβə
በንጉሥ	bˈənɨɡus
የአየርላንድ	jˈəʔajərɨlanɨd
እራሳቸውን	ʔˈɨrasat͡ʃəwɨn
ከነዓን	kˈənəʔan
ሀብታም	hˈaβɨtam
መረጃ	mˈərəd͡ʒa
መንግስት	mˈənɨɡɨsɨt
በጎ	bˈəɡo
ፕሮግራም	pˈɨroɡɨram
ሰራተኞች	sˈəratəɲot͡ʃ
ስለሚችል	sˈɨləmit͡ʃɨl
በመርከብ	bˈəmərɨkəb
የገጠር	jˈəɡət`ər
በዓመት	bˈəʔamət
ወግ	wˈəɡ
የኣሉት	jˈəʔalut
በአማራ	bˈəʔamara
ጣይቱ	t`ˈajɨtu
ጥናት	t`ˈɨnat
ትርዒት	tˈɨrɨʔit
ጠብቆ	t`ˈəβɨk`o
ደርሰው	dˈərɨsəw
አደን	ʔˈadən
ፈርዖን	fˈərɨʔon
ቤቱን	bˈetun
ዝንባሌ	zˈɨnɨβale
ጃንሆይ	d͡ʒˈanɨhoj
አንስታይን	ʔˈanɨsɨtajɨn
የሚኖርበት	jˈəminorɨβət
ሩቅ	rˈuk`
ሰገድ	sˈəɡəd
የእሳት	jˈəʔɨsat
ሮማ	rˈoma
እነዚህ	ʔˈɨnəziç
ጊዜያዊ	ɡˈizejawi
ሴት	sˈet
ጎደል	ɡˈodəl
ጆሮ	d͡ʒˈoro
ልጁን	lˈɨd͡ʒun
ማንነት	mˈanɨnət
ተቋሙ	tˈək`wamu
ኢንዱስትሪ	ʔˈinɨdusɨtɨri
ቃለ	k`ˈalə
ኦርቶዶክስ	ʔˈorɨtodokɨs
በማተሚያ	bˈəmatəmija
ነገሮች	nˈəɡərot͡ʃ
ተመሳሳይነት	tˈəməsasajɨnət
ሳይንስ	sˈajɨnɨs
ጸሐፊ	tsˈəhafi
በተደጋጋሚ	bˈətədəɡaɡami
እድሜ	ʔˈɨdɨme
ዓረፍተ	ʔˈarəfɨtə
የጋራ	jˈəɡara
ጎሣዎች	ɡˈosawot͡ʃ
ከጥንታዊ	kˈət`ɨnɨtawi
ባለሙያዎች	bˈaləmujawot͡ʃ
መጠን	mˈət`ən
ኤምኔም	ʔˈemɨnem
እንደሚከተለው	ʔˈɨnɨdəmikətələw
አቀፍ	ʔˈak`əf
የሚመራው	jˈəmiməraw
ያንን	jˈanɨn
የተሰጠው	jˈətəsət`əw
ግመት	ɡˈɨmət
ነጻ	nˈətsa
በራሷ	bˈəraswa
ያስተምር	jˈasɨtəmɨr
እረኛ	ʔˈɨrəɲa
ይበልጥ	jˈɨβəlɨt`
ከወይዘሮ	kˈəwəjɨzəro
ቴሌቪዥን	tˈeleviʒɨn
አፈወርቅ	ʔˈafəwərɨk`
ፍጡር	fˈɨt`ur
ፎቶ	fˈoto
ይሁንና	jˈɨhunɨna
ጤና	t`ˈena
በአይርላንድ	bˈəʔajɨrɨlanɨd
ሥፍራው	sˈɨfɨraw
መርገጫዎች	mˈərɨɡət͡ʃ`awot͡ʃ
አዋቂ	ʔˈawak`i
አንድ	ʔˈanɨd
መንፈስ	mˈənɨfəs
ገደብ	ɡˈədəb
ይኼ	jˈɨhe
ባስሊዮስ	bˈasɨlijos
ሐረር	hˈarər
ዝናብ	zˈɨnab
አሉ	ʔˈalu
ጥቁር	t`ˈɨk`ur
የኢኮኖሚ	jˈəʔikonomi
ዓለም	ʔˈaləm
ምቹ	mˈɨt͡ʃu
ይሄም	jˈɨhem
በተነሳ	bˈətənəsa
ከሕንዳዊ	kˈəhɨnɨdawi
የቀረበው	jˈək`ərəβəw
ቃሉ	k`ˈalu
ሠራተኞች	sˈəratəɲot͡ʃ
ንጉሠ	nˈɨɡusə
የዘመናዊ	jˈəzəmənawi
ድልድይ	dˈɨlɨdɨj
ከከነዓን	kˈəkənəʔan
እማሆይ	ʔˈɨmahoj
በምድር	bˈəmɨdɨr
ባለቤት	bˈaləβet
ጆን	d͡ʒˈon
መቀመጥ	mˈək`əmət`
የኖረው	jˈənorəw
በተረፈ	bˈətərəfə
እኑስ	ʔˈɨnus
የምህንድስና	jˈəmɨhɨnɨdɨsɨna
ልዑካን	lˈɨʔukan
የተለዩ	jˈətələju
የታሪክ	jˈətarik
እኮ	ʔˈɨko
እንደሚቻል	ʔˈɨnɨdəmit͡ʃal
እንግሊዞች	ʔˈɨnɨɡɨlizot͡ʃ
ፕሬስ	pˈɨres
ልጇን	lˈɨd͡ʒwan
በቀላል	bˈək`əlal
ዘሮች	zˈərot͡ʃ
ቦምብ	bˈomɨb
ግፊት	ɡˈɨfit
እንደሚችሉ	ʔˈɨnɨdəmit͡ʃɨlu
ይፋ	jˈɨfa
ሠራሽ	sˈəraʃ
ቴአትር	tˈeʔatɨr
የጦር	jˈət`or
ግብ	ɡˈɨb
ወይዘሮ	wˈəjɨzəro
አቀራረብ	ʔˈak`ərarəb
ተፈጥሮ	tˈəfət`ɨro
አሜሪካዊ	ʔˈamerikawi
ከሰማይ	kˈəsəmaj
ሰሎሞን	sˈəlomon
ኮሌጅ	kˈoled͡ʒ
የቆየ	jˈək`ojə
ባንድ	bˈanɨd
ዶ	dˈo
ዙር	zˈur
በሚገባ	bˈəmiɡəβa
ኖሮ	nˈoro
ሲደርስ	sˈidərɨs
ስጦታ	sˈɨt`ota
ሲኖሩት	sˈinorut
የበሬ	jˈəβəre
ከንጉሥ	kˈənɨɡus
ዜጎች	zˈeɡot͡ʃ
ሳርጎን	sˈarɨɡon
በመስጠት	bˈəməsɨt`ət
ሆነ	hˈonə
እስክንድር	ʔˈɨsɨkɨnɨdɨr
ናት	nˈat
መብላት	mˈəβɨlat
መሠረታዊ	mˈəsərətawi
ተዋናይ	tˈəwanaj
ዜና	zˈena
ስለነበር	sˈɨlənəβər
ዝግጅት	zˈɨɡɨd͡ʒɨt
አስር	ʔˈasɨr
እስራኤል	ʔˈɨsɨraʔel
ለህዝብ	lˈəhɨzɨb
ተማሪዎች	tˈəmariwot͡ʃ
ተስማሚ	tˈəsɨmami
ሊባኖስ	lˈiβanos
ዘመድ	zˈəməd
ሳሙኤል	sˈamuʔel
ሬዲዮ	rˈedijo
ክልል	kˈɨlɨl
በረካ	bˈərəka
ከተማና	kˈətəmana
የአዲስ	jˈəʔadis
ኢስላም	ʔˈisɨlam
በእንግሊዝ	bˈəʔɨnɨɡɨliz
ተብለው	tˈəβɨləw
የጠበቀ	jˈət`əβək`ə
አምክንዮ	ʔˈamɨkɨnɨjo
ደቀ	dˈək`ə
ክርስቲያኖች	kˈɨrɨsɨtijanot͡ʃ
የአማርኛ	jˈəʔamarɨɲa
ለጥቂት	lˈət`ɨk`it
ነብይ	nˈəβɨj
ወንዶቹ	wˈənɨdot͡ʃu
አራተኛ	ʔˈaratəɲa
በማህበራዊ	bˈəmahɨβərawi
ቅጠል	k`ˈɨt`əl
ሠፈሮች	sˈəfərot͡ʃ
በዋና	bˈəwana
ማርያም	mˈarɨjam
ጋዜጠኛ	ɡˈazet`əɲa
ሰባት	sˈəβat
ጫና	t͡ʃ`ˈana
የዛኔ	jˈəzane
አንቀጽ	ʔˈanɨk`əts
አሜሪካ	ʔˈamerika
ጥሩ	t`ˈɨru
የሚቆጠር	jˈəmik`ot`ər
ዕውቀት	ʔˈɨwɨk`ət
የኑሮ	jˈənuro
ውጭ	wˈɨt͡ʃ`
ዉ	wˈu
ያህል	jˈahɨl
በሌላ	bˈəlela
የእርሱ	jˈəʔɨrɨsu
በስፋት	bˈəsɨfat
እስፔሊንግ	ʔˈɨsɨpelinɨɡ
ኦሮሞ	ʔˈoromo
ከአላህ	kˈəʔalax
ህዝብ	hˈɨzɨb
የወርቅ	jˈəwərɨk`
አቋም	ʔˈak`wam
እርሱን	ʔˈɨrɨsun
አዝማች	ʔˈazɨmat͡ʃ
የሚቀርብ	jˈəmik`ərɨb
ግጥም	ɡˈɨt`ɨm
አይጥ	ʔˈajɨt`
ያተኮረ	jˈatəkorə
ኬሚካዊ	kˈemikawi
ኢያሱ	ʔˈijasu
ሦስት	sˈosɨt
ንጉሥና	nˈɨɡusɨna
ይታወቅ	jˈɨtawək`
አውሬ	ʔˈawɨre
የነበረ	jˈənəβərə
በእስራኤል	bˈəʔɨsɨraʔel
ጠቅላላ	t`ˈək`ɨlala
ተለይተው	tˈələjɨtəw
ምክኒያት	mˈɨkɨnijat
መልአክ	mˈəlɨʔak
ብር	bˈɨr
ተሳታፊ	tˈəsatafi
ቅርጾች	k`ˈɨrɨtsot͡ʃ
ለጎን	lˈəɡon
ተኩል	tˈəkul
ሃያላት	hˈajalat
በተገኙበት	bˈətəɡəɲuβət
ተናጋሪዎች	tˈənaɡariwot͡ʃ
ቢትወደድ	bˈitɨwədəd
አቅጣጫ	ʔˈak`ɨt`at͡ʃ`a
የነበሩ	jˈənəβəru
የአይሁድ	jˈəʔajɨhud
ኣዳዲስ	ʔˈadadis
ሕዝባዊ	hˈɨzɨβawi
ማርች	mˈarɨt͡ʃ
ስኳር	sˈɨkwar
ተጽፎ	tˈətsɨfo
ለተለያዩ	lˈətələjaju
ስፍራዎች	sˈɨfɨrawot͡ʃ
የኬጥያውያን	jˈəket`ɨjawɨjan
ሥራውን	sˈɨrawɨn
እናት	ʔˈɨnat
ኪሎሜትር	kˈilometɨr
ጉልበት	ɡˈulɨβət
በውጭ	bˈəwɨt͡ʃ`
ሹም	ʃˈum
መሆኑ	mˈəhonu
ኬክሮስ	kˈekɨros
እንደ	ʔˈɨnɨdə
እምነቶች	ʔˈɨmɨnətot͡ʃ
በወቅቱ	bˈəwək`ɨtu
ለማስቀመጥ	lˈəmasɨk`əmət`
ቁጭ	k`ˈut͡ʃ`
ወደዚህ	wˈədəziç
የሚጫወቱት	jˈəmit͡ʃ`awətut
የሕዝቡ	jˈəhɨzɨβu
የቀድሞው	jˈək`ədɨmow
እምቅ	ʔˈɨmɨk`
ሲኖረው	sˈinorəw
ምስጋና	mˈɨsɨɡana
ፈርዖኑ	fˈərɨʔonu
ምሽግ	mˈɨʃɨɡ
ከነዚህም	kˈənəzihɨm
ይመስላል	jˈɨməsɨlal
ወሬ	wˈəre
ማን	mˈan
ስርወ	sˈɨrɨwə
ም	mˈɨ
ለማረጋገጥ	lˈəmarəɡaɡət`
ከደቡብ	kˈədəβub
ቺ	t͡ʃˈi
መስከረም	mˈəsɨkərəm
መግባት	mˈəɡɨβat
የሚጠቀሙ	jˈəmit`ək`əmu
አዳዲስ	ʔˈadadis
ጊዮርጊስ	ɡˈijorɨɡis
ተወለዱ	tˈəwələdu
ያዘ	jˈazə
በከንቱ	bˈəkənɨtu
የነበር	jˈənəβər
ፈረስ	fˈərəs
ከእነዚህ	kˈəʔɨnəziç
ምስራቅ	mˈɨsɨrak`
ችላ	t͡ʃˈɨla
በኤሌክትሪክ	bˈəʔelekɨtɨrik
ርዕዮተ	rˈɨʔɨjotə
የመጀመሪያዋ	jˈəməd͡ʒəmərijawa
ሌላም	lˈelam
ሲሉ	sˈilu
ከፍታ	kˈəfɨta
ብሎ	bˈɨlo
አርአያ	ʔˈarɨʔaja
በሚገኙ	bˈəmiɡəɲu
ባሻ	bˈaʃa
በመግባት	bˈəməɡɨβat
ኃይለኛ	hˈajɨləɲa
ርስት	rˈɨsɨt
ደስ	dˈəs
ልማድ	lˈɨmad
ለ፫	lˈə
ኦሪት	ʔˈorit
መጽሐፍ	mˈətsɨhaf
ሀ	hˈa
ሲጀመር	sˈid͡ʒəmər
ጽሑፍ	tsˈɨhuf
ምዕራብ	mˈɨʔɨrab
ለማድረግ	lˈəmadɨrəɡ
ትይዩ	tˈɨjɨju
ሥራዎች	sˈɨrawot͡ʃ
ማመን	mˈamən
አጫጭር	ʔˈat͡ʃ`at͡ʃ`ɨr
እንዲሠራ	ʔˈɨnɨdisəra
ሁኔታዎች	hˈunetawot͡ʃ
ሀረም	hˈarəm
ተቃራኒ	tˈək`arani
ሕይወት	hˈɨjɨwət
ክልሎች	kˈɨlɨlot͡ʃ
ጾታ	tsˈota
ኢየሱስ	ʔˈijəsus
የአገሩ	jˈəʔaɡəru
መርገጫ	mˈərɨɡət͡ʃ`a
የፍርድ	jˈəfɨrɨd
መጡ	mˈət`u
አመታት	ʔˈamətat
እሳቸውም	ʔˈɨsat͡ʃəwɨm
ለማቅረብ	lˈəmak`ɨrəb
ሰዓት	sˈəʔat
ዘይቤ	zˈəjɨβe
መውሰድ	mˈəwɨsəd
ታዲያ	tˈadija
ብለው	bˈɨləw
ግድግዳ	ɡˈɨdɨɡɨda
ሙሐመድ	mˈuhaməd
ቅደም	k`ˈɨdəm
ሰንበት	sˈənɨβət
የደረሱ	jˈədərəsu
በፍጹም	bˈəfɨtsum
ሂክሶስ	hˈikɨsos
ድንጋይ	dˈɨnɨɡaj
ገዙ	ɡˈəzu
ሠራዊት	sˈərawit
ከሞተ	kˈəmotə
የሮማውያን	jˈəromawɨjan
ተዋሕዶ	tˈəwahɨdo
ድርሰት	dˈɨrɨsət
በሕዝቡ	bˈəhɨzɨβu
ቅዱስ	k`ˈɨdus
የሚታየው	jˈəmitajəw
ዩ	jˈu
ይቅርታ	jˈɨk`ɨrɨta
የባቢሎን	jˈəβaβilon
የአፍሪቃ	jˈəʔafɨrik`a
ስሟ	sˈɨmwa
ተከራካሪ	tˈəkərakari
ቅድስት	k`ˈɨdɨsɨt
አውሮፕላን	ʔˈawɨropɨlan
ከሚል	kˈəmil
ጉዳይ	ɡˈudaj
በተደረገው	bˈətədərəɡəw
ያላቸውን	jˈalat͡ʃəwɨn
ንፋስ	nˈɨfas
አባቱን	ʔˈaβatun
ሚስቱ	mˈisɨtu
የተባሉትን	jˈətəβalutɨn
ፀሐፊ	tsˈəhafi
የጽሑፍ	jˈətsɨhuf
ግዕዝ	ɡˈɨʔɨz
ለማስላት	lˈəmasɨlat
ስንኳ	sˈɨnɨkwa
ደሴት	dˈəset
የተወሰነ	jˈətəwəsənə
ዶላር	dˈolar
ከጥቅም	kˈət`ɨk`ɨm
መኪና	mˈəkina
ይፋዊ	jˈɨfawi
የአንድን	jˈəʔanɨdɨn
በግሪክ	bˈəɡɨrik
ትውፊት	tˈɨwɨfit
በሚገኝ	bˈəmiɡəɲ
ሠራዊቱ	sˈərawitu
ስሌት	sˈɨlet
መንታ	mˈənɨta
ብዙውን	bˈɨzuwɨn
ሥራዎችን	sˈɨrawot͡ʃɨn
ከዛ	kˈəza
ዝቅተኛ	zˈɨk`ɨtəɲa
ፊደሉን	fˈidəlun
ይገኛል	jˈɨɡəɲal
መጠነ	mˈət`ənə
የሁለቱ	jˈəhulətu
በተለያዩ	bˈətələjaju
መጽሓፍ	mˈətsɨhaf
ሐዋርያት	hˈawarɨjat
በኣሁኑ	bˈəʔahunu
በብዛት	bˈəβɨzat
ይኖር	jˈɨnor
ትተው	tˈɨtəw
የተያያዘ	jˈətəjajazə
ግዕዝን	ɡˈɨʔɨzɨn
እነዚህም	ʔˈɨnəzihɨm
ወልድ	wˈəlɨd
ቢሊዮን	bˈilijon
ደረቅ	dˈərək`
ይጠቀሙበት	jˈɨt`ək`əmuβət
ዘርፎች	zˈərɨfot͡ʃ
የቱርክ	jˈəturɨk
በህዝብ	bˈəhɨzɨb
ዝሆን	zˈɨhon
ውስጥ	wˈɨsɨt`
ነሽ	nˈəʃ
የመጨረሻ	jˈəmət͡ʃ`ərəʃa
የሚያገለግሉ	jˈəmijaɡələɡɨlu
በዘመናቸው	bˈəzəmənat͡ʃəw
በሁለተኛ	bˈəhulətəɲa
አማልክት	ʔˈamalɨkɨt
ደራሲ	dˈərasi
ጥሩነሽ	t`ˈɨrunəʃ
እርስ	ʔˈɨrɨs
ነገር	nˈəɡər
ትግራይ	tˈɨɡɨraj
ልዕልት	lˈɨʔɨlɨt
ታላቁ	tˈalak`u
ግርጌ	ɡˈɨrɨɡe
በዳግማዊ	bˈədaɡɨmawi
ጉልህ	ɡˈulɨx
መንገደኞች	mˈənɨɡədəɲot͡ʃ
መገንዘብ	mˈəɡənɨzəb
ዙፋኑ	zˈufanu
ለንጉሠ	lˈənɨɡusə
ህይወቱ	hˈɨjɨwətu
ግማሽ	ɡˈɨmaʃ
የህትመት	jˈəhɨtɨmət
እንጂ	ʔˈɨnɨd͡ʒi
ጀመረ	d͡ʒˈəmərə
ኮምፕዩተራይዝ	kˈomɨpɨjutərajɨz
ሔሩ	hˈeru
መስኮች	mˈəsɨkot͡ʃ
የሚደረግ	jˈəmidərəɡ
የመጀመሪያውን	jˈəməd͡ʒəmərijawɨn
ህጻን	hˈɨtsan
ትዝታ	tˈɨzɨta
ዋስትና	wˈasɨtɨna
ለቀው	lˈək`əw
ሆቴል	hˈotel
ፍፁም	fˈɨtsum
ተግባር	tˈəɡɨβar
ሥርዓቱ	sˈɨrɨʔatu
ግንብ	ɡˈɨnɨb
ወይን	wˈəjɨn
ወርሮ	wˈərɨro
የግጥም	jˈəɡɨt`ɨm
መጀመርያው	mˈəd͡ʒəmərɨjaw
በአማርኛ	bˈəʔamarɨɲa
በኒህ	bˈəniç
የታወቁት	jˈətawək`ut
የተፈጥሮ	jˈətəfət`ɨro
ሴራ	sˈera
መለኪያ	mˈələkija
የሞት	jˈəmot
ባሪያ	bˈarija
መላምት	mˈəlamɨt
ሁሉም	hˈulum
ትውልድ	tˈɨwɨlɨd
በአዲስ	bˈəʔadis
መዝገብ	mˈəzɨɡəb
ንብረት	nˈɨβɨrət
በብዙዎች	bˈəβɨzuwot͡ʃ
ከሚገኘው	kˈəmiɡəɲəw
ሳንቲ	sˈanɨti
ንጉሱ	nˈɨɡusu
ሰቀል	sˈək`əl
ካሉ	kˈalu
ከኛ	kˈəɲa
ሂሳብ	hˈisab
የተሠራው	jˈətəsəraw
የነበሩት	jˈənəβərut
ለመቀበል	lˈəmək`əβəl
ቢል	bˈil
ከስልጣን	kˈəsɨlɨt`an
ብረት	bˈɨrət
መስቀል	mˈəsɨk`əl
ደራስያን	dˈərasɨjan
የተሰኙት	jˈətəsəɲut
ኢትዮጵያን	ʔˈitɨjop`ɨjan
ኢንተርኔት	ʔˈinɨtərɨnet
የሚውሉ	jˈəmiwɨlu
ልጁ	lˈɨd͡ʒu
የመጣ	jˈəmət`a
ከቦታ	kˈəβota
ከሰው	kˈəsəw
በመጽሐፉ	bˈəmətsɨhafu
ተነስተው	tˈənəsɨtəw
ስደት	sˈɨdət
ሥፍራ	sˈɨfɨra
አረቢያ	ʔˈarəβija
ተረት	tˈərət
ኣጠቃቀም	ʔˈat`ək`ak`əm
የግንባታ	jˈəɡɨnɨβata
የብርሃንን	jˈəβɨrɨhanɨn
መልኩ	mˈəlɨku
ሰዎች	sˈəwot͡ʃ
ሰንሰለት	sˈənɨsələt
እንስሳት	ʔˈɨnɨsɨsat
ያልሆነ	jˈalɨhonə
ዘር	zˈər
እስቲ	ʔˈɨsɨti
ልምድ	lˈɨmɨd
መልክ	mˈəlɨk
በእንግሊዝኛ	bˈəʔɨnɨɡɨlizɨɲa
ባቡር	bˈaβur
ወሳኝ	wˈəsaɲ
ቆምጬ	k`ˈomɨt͡ʃ`e
መጫወት	mˈət͡ʃ`awət
ትንሽ	tˈɨnɨʃ
ብሔራዊ	bˈɨherawi
በርሳቸው	bˈərɨsat͡ʃəw
ሊኖሩ	lˈinoru
ከአሥራ	kˈəʔasɨra
ሕዝቡን	hˈɨzɨβun
ግምገማ	ɡˈɨmɨɡəma
ሁከት	hˈukət
የንግድ	jˈənɨɡɨd
በብዙ	bˈəβɨzu
ለሁለተኛ	lˈəhulətəɲa
የሚከተሉት	jˈəmikətəlut
መሀል	mˈəhal
ብሔሮች	bˈɨherot͡ʃ
ካረፈ	kˈarəfə
ዋነኛ	wˈanəɲa
በተካሄደው	bˈətəkahedəw
ክስተቶች	kˈɨsɨtətot͡ʃ
ንግሥት	nˈɨɡɨsɨt
ሻይ	ʃˈaj
ባጭሩ	bˈat͡ʃ`ɨru
ብሩስ	bˈɨrus
ይሠራ	jˈɨsəra
አስተዋፅኦ	ʔˈasɨtəwatsɨʔo
እንዴ	ʔˈɨnɨde
የሚሆኑ	jˈəmihonu
በባቢሎን	bˈəβaβilon
የክርስቶስ	jˈəkɨrɨsɨtos
የሚባለው	jˈəmiβaləw
ጀኔራል	d͡ʒˈəneral
የንጉሥ	jˈənɨɡus
ጌታችን	ɡˈetat͡ʃɨn
ይሙት	jˈɨmut
ፈንታ	fˈənɨta
ሁኔታ	hˈuneta
በሮማውያን	bˈəromawɨjan
የሚናገር	jˈəminaɡər
ጳጳሳት	p`ˈap`asat
ብላታ	bˈɨlata
ኬጥያውያን	kˈet`ɨjawɨjan
ኮከብ	kˈokəb
አርማ	ʔˈarɨma
ግብዣ	ɡˈɨβɨʒa
ቁመቱ	k`ˈumətu
ትራምፕ	tˈɨramɨp
ንግግር	nˈɨɡɨɡɨr
ሰሌዳ	sˈəleda
እዚህ	ʔˈɨziç
ምርምር	mˈɨrɨmɨr
ቫይረስ	vˈajɨrəs
ብርቱካን	bˈɨrɨtukan
በ	bˈə
ትምና	tˈɨmɨna
የጌታችን	jˈəɡetat͡ʃɨn
የትም	jˈətɨm
የጥበብ	jˈət`ɨβəb
የህክምና	jˈəhɨkɨmɨna
በተፈጥሮ	bˈətəfət`ɨro
ዮሐንስ	jˈohanɨs
ሴቶቹ	sˈetot͡ʃu
ሲኖሩ	sˈinoru
እየጨመረ	ʔˈɨjət͡ʃ`əmərə
ፈር	fˈər
የሚል	jˈəmil
በተደረገ	bˈətədərəɡə
የመሆን	jˈəməhon
ሄርኩሌስ	hˈerɨkules
ሐብለ	hˈaβɨlə
ዋሚ	wˈami
ኤላማውያን	ʔˈelamawɨjan
የግዴታ	jˈəɡɨdeta
ገነት	ɡˈənət
ንጉሣዊ	nˈɨɡusawi
በሆነ	bˈəhonə
በቃል	bˈək`al
ፋብሪካ	fˈaβɨrika
መምህር	mˈəmɨhɨr
ግምገማዎች	ɡˈɨmɨɡəmawot͡ʃ
ሰ	sˈə
ሥርወ	sˈɨrɨwə
ሲሰጥ	sˈisət`
የሚገኙ	jˈəmiɡəɲu
ወዴት	wˈədet
ከተማዎች	kˈətəmawot͡ʃ
የታተመው	jˈətatəməw
ለማወቅ	lˈəmawək`
በታሪካዊ	bˈətarikawi
ስለዚህም	sˈɨləzihɨm
ስዕል	sˈɨʔɨl
መጽሔት	mˈətsɨhet
የከተማዋ	jˈəkətəmawa
መጽሃፍ	mˈətsɨhaf
የስራ	jˈəsɨra
ደህንነት	dˈəhɨnɨnət
የፍልስፍና	jˈəfɨlɨsɨfɨna
ጻድቅ	tsˈadɨk`
ዳግም	dˈaɡɨm
የሬዲዮ	jˈəredijo
ሌላኛው	lˈelaɲaw
ሻለቃ	ʃˈalək`a
የሚናገረው	jˈəminaɡərəw
ከሌሎች	kˈəlelot͡ʃ
ዘመናት	zˈəmənat
በየቀኑ	bˈəjək`ənu
ይህም	jˈɨhɨm
በሁለቱ	bˈəhulətu
አስፈላጊነት	ʔˈasɨfəlaɡinət
ሆኑ	hˈonu
ዋናዎቹ	wˈanawot͡ʃu
አላት	ʔˈalat
አካል	ʔˈakal
ልዩ	lˈɨju
ራዲዮ	rˈadijo
ቀረ	k`ˈərə
ከሰኔ	kˈəsəne
አምልኮ	ʔˈamɨlɨko
ችግር	t͡ʃˈɨɡɨr
ከቅርብ	kˈək`ɨrɨb
ስሙን	sˈɨmun
ክለብ	kˈɨləb
ጎን	ɡˈon
ግንቦት	ɡˈɨnɨβot
ጎንደር	ɡˈonɨdər
ኮድ	kˈod
ዘላቂ	zˈəlak`i
ሰዎችም	sˈəwot͡ʃɨm
ጦር	t`ˈor
ኢትዮጵያውያን	ʔˈitɨjop`ɨjawɨjan
ስላለው	sˈɨlaləw
የኮሶ	jˈəkoso
ዕለተ	ʔˈɨlətə
በኤርትራ	bˈəʔerɨtɨra
አባታችን	ʔˈaβatat͡ʃɨn
ሃሙራቢ	hˈamuraβi
በቀዳሚ	bˈək`ədami
ፍጡራን	fˈɨt`uran
በሞት	bˈəmot
ሕንፃ	hˈɨnɨtsa
ዕውቅና	ʔˈɨwɨk`ɨna
በቀድሞው	bˈək`ədɨmow
እንዲያገኝ	ʔˈɨnɨdijaɡəɲ
በጦርነቱ	bˈət`orɨnətu
እርምጃ	ʔˈɨrɨmɨd͡ʒa
ነህ	nˈəx
ለትምህርት	lˈətɨmɨhɨrɨt
ለአንተ	lˈəʔanɨtə
በማሸነፍ	bˈəmaʃənəf
የአለም	jˈəʔaləm
መሆኑን	mˈəhonun
ሰዐወ	sˈəʔawə
ባዮች	bˈajot͡ʃ
ፈተና	fˈətəna
ብቸኛው	bˈɨt͡ʃəɲaw
ጤንነት	t`ˈenɨnət
መስፍን	mˈəsɨfɨn
የርሱ	jˈərɨsu
ለማጥፋት	lˈəmat`ɨfat
ወዲያ	wˈədija
በአገር	bˈəʔaɡər
መለየት	mˈələjət
ይህን	jˈɨhɨn
ቅሉ	k`ˈɨlu
ዳግማዊ	dˈaɡɨmawi
ውቅያኖስ	wˈɨk`ɨjanos
ተልእኮ	tˈəlɨʔɨko
ኪም	kˈim
በጠቅላላ	bˈət`ək`ɨlala
ወይም	wˈəjɨm
ተጫዋች	tˈət͡ʃ`awat͡ʃ
በስተቀር	bˈəsɨtək`ər
መሆናቸው	mˈəhonat͡ʃəw
ልማት	lˈɨmat
አስተዳደር	ʔˈasɨtədadər
ተወላጅ	tˈəwəlad͡ʒ
ማእከል	mˈaʔɨkəl
በማቅረብ	bˈəmak`ɨrəb
አባላት	ʔˈaβalat
ፍለጋ	fˈɨləɡa
ትምሕርት	tˈɨmɨhɨrɨt
በፈረንሳይ	bˈəfərənɨsaj
የዓመቱ	jˈəʔamətu
መቸም	mˈət͡ʃəm
ወንድም	wˈənɨdɨm
ሙከራ	mˈukəra
እስጢፋኖስ	ʔˈɨsɨt`ifanos
ቡድንንና	bˈudɨnɨnɨna
በመቀጠል	bˈəmək`ət`əl
ብርሃኑ	bˈɨrɨhanu
ሰላም	sˈəlam
በእነዚህ	bˈəʔɨnəziç
በዚህም	bˈəzihɨm
ሥራው	sˈɨraw
የውጭ	jˈəwɨt͡ʃ`
ተማሪ	tˈəmari
በቅርብ	bˈək`ɨrɨb
ሁለቱንም	hˈulətunɨm
ቡድኖች	bˈudɨnot͡ʃ
ጋ	ɡˈa
አዳራሽ	ʔˈadaraʃ
ሞክሼ	mˈokɨʃe
ጉዳዮች	ɡˈudajot͡ʃ
አዛዥ	ʔˈazaʒ
ስለሌለ	sˈɨləlelə
በሌሎች	bˈəlelot͡ʃ
በግብጽ	bˈəɡɨβɨts
ፊደሎች	fˈidəlot͡ʃ
የአሦር	jˈəʔasor
ፈጣን	fˈət`an
እንዳሉ	ʔˈɨnɨdalu
መቼ	mˈət͡ʃe
ወንድማቸው	wˈənɨdɨmat͡ʃəw
ር	rˈɨ
ሌባ	lˈeβa
የወጣ	jˈəwət`a
የትውልድ	jˈətɨwɨlɨd
እንቅስቃሴ	ʔˈɨnɨk`ɨsɨk`ase
ድሮ	dˈɨro
በቀኝ	bˈək`əɲ
አናባቢ	ʔˈanaβaβi
መካነ	mˈəkanə
ሶስት	sˈosɨt
ገጽ	ɡˈəts
ንጥረ	nˈɨt`ɨrə
ውኃ	wˈɨha
ላቲን	lˈatin
ብልት	bˈɨlɨt
አብሮ	ʔˈaβɨro
ጥረት	t`ˈɨrət
ህግጋት	hˈɨɡɨɡat
እንኳን	ʔˈɨnɨkwan
ጣልያንን	t`ˈalɨjanɨn
በዳ	bˈəda
በተያያዘ	bˈətəjajazə
ቀዳማዊ	k`ˈədamawi
ዞን	zˈon
መግለጫ	mˈəɡɨlət͡ʃ`a
ካለው	kˈaləw
ለመሆን	lˈəməhon
የሚወክል	jˈəmiwəkɨl
ገዢ	ɡˈəʒi
ምንትዋብ	mˈɨnɨtɨwab
ውጪ	wˈɨt͡ʃ`i
ሌሎችን	lˈelot͡ʃɨn
አምባሳደር	ʔˈamɨβasadər
የፖለቲካ	jˈəpolətika
ሰማያዊ	sˈəmajawi
ብሎም	bˈɨlom
የቀርከሃ	jˈək`ərɨkəha
ክቡር	kˈɨβur
ንግስት	nˈɨɡɨsɨt
ዴሞክራሲያዊ	dˈemokɨrasijawi
በእግር	bˈəʔɨɡɨr
የአረመኔ	jˈəʔarəməne
ምድረ	mˈɨdɨrə
ዝነኛ	zˈɨnəɲa
በሆነው	bˈəhonəw
ማክ	mˈak
አፍሪካ	ʔˈafɨrika
አዕምሮ	ʔˈaʔɨmɨro
ከጥቂት	kˈət`ɨk`it
በቂ	bˈək`i
የጎንደር	jˈəɡonɨdər
ያደረጉ	jˈadərəɡu
የተዘጋጁ	jˈətəzəɡad͡ʒu
የጊዜ	jˈəɡize
በጻፈው	bˈətsafəw
ጭራ	t͡ʃ`ˈɨra
ከሞት	kˈəmot
ይልቅ	jˈɨlɨk`
ኤን	ʔˈen
ወንዶች	wˈənɨdot͡ʃ
የራሳቸው	jˈərasat͡ʃəw
እጁን	ʔˈɨd͡ʒun
የደብረ	jˈədəβɨrə
ተመልሰው	tˈəməlɨsəw
የራሱን	jˈərasun
ነበረ	nˈəβərə
ውድቀት	wˈɨdɨk`ət
ክፍተት	kˈɨfɨtət
ከባቢ	kˈəβaβi
ምልክቶችን	mˈɨlɨkɨtot͡ʃɨn
ከሌላው	kˈəlelaw
ካሳ	kˈasa
ኣበራ	ʔˈaβəra
በሕንድ	bˈəhɨnɨd
ሠንጠረዥ	sˈənɨt`ərəʒ
ተራራ	tˈərara
በክልሉ	bˈəkɨlɨlu
አብዛኛው	ʔˈaβɨzaɲaw
በንጉሡ	bˈənɨɡusu
ሊባል	lˈiβal
መመለስ	mˈəmələs
ተከታዮቹ	tˈəkətajot͡ʃu
ሴማዊ	sˈemawi
የነበሩትን	jˈənəβərutɨn
አምስት	ʔˈamɨsɨt
ተክሌ	tˈəkɨle
ድርጊት	dˈɨrɨɡit
ፓተንት	pˈatənɨt
ታሪክ	tˈarik
አካላዊ	ʔˈakalawi
ተፈጥሮአዊ	tˈəfət`ɨroʔawi
መጻሕፍትን	mˈətsahɨfɨtɨn
የገዛ	jˈəɡəza
ውስጡ	wˈɨsɨt`u
እህት	ʔˈɨhɨt
መዲና	mˈədina
በጋዜጠኝነት	bˈəɡazet`əɲɨnət
ሲሆኑ	sˈihonu
ባደረጉት	bˈadərəɡut
መኖሪያ	mˈənorija
በሚከተሉት	bˈəmikətəlut
ማነስ	mˈanəs
እንዲሁም	ʔˈɨnɨdihum
ማይል	mˈajɨl
ሲመጣ	sˈimət`a
አንድነት	ʔˈanɨdɨnət
እቃ	ʔˈɨk`a
ባለበት	bˈaləβət
ግንዛቤ	ɡˈɨnɨzaβe
አብዛኛውን	ʔˈaβɨzaɲawɨn
ምስል	mˈɨsɨl
ቀበሌ	k`ˈəβəle
ቤተሠብ	bˈetəsəb
ስሜን	sˈɨmen
መያዝ	mˈəjaz
ጌታዬ	ɡˈetaje
ወጣት	wˈət`at
ወደኋላ	wˈədəhwala
ያክል	jˈakɨl
ውጤቶች	wˈɨt`etot͡ʃ
ከጥፋት	kˈət`ɨfat
ዲሞክራሲያዊ	dˈimokɨrasijawi
ጉባዔ	ɡˈuβaʔe
አርበኛ	ʔˈarɨβəɲa
እሺ	ʔˈɨʃi
አሉት	ʔˈalut
ላለፉት	lˈaləfut
የሂሳብ	jˈəhisab
እስረኛ	ʔˈɨsɨrəɲa
አሁን	ʔˈahun
ለመግደል	lˈəməɡɨdəl
ድንጋጌ	dˈɨnɨɡaɡe
ትንሹ	tˈɨnɨʃu
ነገሠ	nˈəɡəsə
የመሳሰሉ	jˈəməsasəlu
በኩፋሌ	bˈəkufale
አገልጋይ	ʔˈaɡəlɨɡaj
አክልበ	ʔˈakɨlɨβə
ዙፋኑን	zˈufanun
ደብረ	dˈəβɨrə
ከነበሩ	kˈənəβəru
የሚረዳ	jˈəmirəda
አሰራር	ʔˈasərar
ደ	dˈə
የጥንቱ	jˈət`ɨnɨtu
ታይ	tˈaj
ልጇ	lˈɨd͡ʒwa
ልደት	lˈɨdət
ዩኒኮድ	jˈunikod
የሆነ	jˈəhonə
አንደኛ	ʔˈanɨdəɲa
ጳውሎስ	p`ˈawɨlos
በሚገኘው	bˈəmiɡəɲəw
ሪፐብሊክ	rˈipəβɨlik
ተስፋዬ	tˈəsɨfaje
የቁጥር	jˈək`ut`ɨr
ማድረግ	mˈadɨrəɡ
መንግስቱ	mˈənɨɡɨsɨtu
በመስራት	bˈəməsɨrat
የሚከተለው	jˈəmikətələw
የመላእክት	jˈəməlaʔɨkɨt
በተባለ	bˈətəβalə
ወስደው	wˈəsɨdəw
የሁሉም	jˈəhulum
አንጻር	ʔˈanɨtsar
የዚህን	jˈəzihɨn
ወዳጅ	wˈədad͡ʒ
እንዲኖረው	ʔˈɨnɨdinorəw
ናቸው	nˈat͡ʃəw
ገዥ	ɡˈəʒ
የ	jˈə
ምድር	mˈɨdɨr
የባሕር	jˈəβahɨr
ታይፕራይተር	tˈajɨpɨrajɨtər
አንዱ	ʔˈanɨdu
ልቦለድ	lˈɨβoləd
ሁለቱም	hˈulətum
ቆየ	k`ˈojə
ምክትል	mˈɨkɨtɨl
ማርሻል	mˈarɨʃal
እንዲገባ	ʔˈɨnɨdiɡəβa
አንስቶ	ʔˈanɨsɨto
የሀገሩ	jˈəhaɡəru
በፖለቲካ	bˈəpolətika
ማዘንጊያ	mˈazənɨɡija
ከነርሱ	kˈənərɨsu
ነጋዴ	nˈəɡade
በማድረግ	bˈəmadɨrəɡ
ነገድ	nˈəɡəd
የሚሰጥ	jˈəmisət`
ዝርያዎች	zˈɨrɨjawot͡ʃ
የክርስትና	jˈəkɨrɨsɨtɨna
እያንዳንዱን	ʔˈɨjanɨdanɨdun
እዚያም	ʔˈɨzijam
አዲስ	ʔˈadis
ሀይሉ	hˈajɨlu
ህመም	hˈɨməm
ጥቅሞች	t`ˈɨk`ɨmot͡ʃ
ሰአት	sˈəʔat
መልሶ	mˈəlɨso
የተሰራ	jˈətəsəra
የሚመራ	jˈəmiməra
ስጋ	sˈɨɡa
እንግሊዝኛ	ʔˈɨnɨɡɨlizɨɲa
አኩሪ	ʔˈakuri
ያደረገ	jˈadərəɡə
የወጣው	jˈəwət`aw
ከመሆኑ	kˈəməhonu
አይሆንም	ʔˈajɨhonɨm
ተጓዥ	tˈəɡwaʒ
ስሙም	sˈɨmum
ስልክ	sˈɨlɨk
መብራት	mˈəβɨrat
ከዛም	kˈəzam
ሞላ	mˈola
ወገኖች	wˈəɡənot͡ʃ
ንጉሡን	nˈɨɡusun
ሳይሆኑ	sˈajɨhonu
የተረፉት	jˈətərəfut
ወንዶችና	wˈənɨdot͡ʃɨna
ኳስ	kwˈas
ነበረበት	nˈəβərəβət
የት	jˈət
ዘመቻዎች	zˈəmət͡ʃawot͡ʃ
ተፅዕኖ	tˈətsɨʔɨno
ኤል	ʔˈel
አመነምሃት	ʔˈamənəmɨhat
ፕሮፌሰር	pˈɨrofesər
ማናቸውም	mˈanat͡ʃəwɨm
ተወስዶ	tˈəwəsɨdo
ቢሆንም	bˈihonɨm
ብዙም	bˈɨzum
ሐሣዊ	hˈasawi
ክርስቲያኑ	kˈɨrɨsɨtijanu
በሴት	bˈəset
ሥርዓት	sˈɨrɨʔat
ክረምት	kˈɨrəmɨt
ከጎን	kˈəɡon
ባሕርይ	bˈahɨrɨj
የአካባቢውን	jˈəʔakaβaβiwɨn
ኅልው	hˈɨlɨw
ጥራት	t`ˈɨrat
አሕዛብ	ʔˈahɨzab
ለፊት	lˈəfit
አንድም	ʔˈanɨdɨm
ከነብዩ	kˈənəβɨju
ቅዱስን	k`ˈɨdusɨn
እንዳሉት	ʔˈɨnɨdalut
የእጅ	jˈəʔɨd͡ʒ
ዓመት	ʔˈamət
ገብረ	ɡˈəβɨrə
ራዕይ	rˈaʔɨj
ያለውን	jˈaləwɨn
በተግባር	bˈətəɡɨβar
አንዳንዶቹ	ʔˈanɨdanɨdot͡ʃu
ሊገኙ	lˈiɡəɲu
ታላላቅ	tˈalalak`
ባል	bˈal
ከቤት	kˈəβet
አቡነ	ʔˈaβunə
ፍርድ	fˈɨrɨd
ጊዜም	ɡˈizem
ሳምንታት	sˈamɨnɨtat
ኛው	ɲˈaw
ባንዲራ	bˈanɨdira
እንዲህም	ʔˈɨnɨdihɨm
የአካባቢው	jˈəʔakaβaβiw
የሚቆጠሩ	jˈəmik`ot`əru
ሶበክሆተፕ	sˈoβəkɨhotəp
ፊደሉ	fˈidəlu
ኤርትራ	ʔˈerɨtɨra
ሐሳብ	hˈasab
የመሰለ	jˈəməsələ
እኚህ	ʔˈɨɲiç
የተወለደ	jˈətəwələdə
ተቋም	tˈək`wam
እንደዚህ	ʔˈɨnɨdəziç
አገሪቱ	ʔˈaɡəritu
የባህር	jˈəβahɨr
ለውጦች	lˈəwɨt`ot͡ʃ
ቆዳ	k`ˈoda
ግብር	ɡˈɨβɨr
ኪሎ	kˈilo
የሚባለውን	jˈəmiβaləwɨn
የሚደርስ	jˈəmidərɨs
በበኩሉ	bˈəβəkulu
ግሪኮች	ɡˈɨrikot͡ʃ
የባቡር	jˈəβaβur
መብቶች	mˈəβɨtot͡ʃ
ለሌሎች	lˈəlelot͡ʃ
እያለ	ʔˈɨjalə
የደቡብ	jˈədəβub
የሚጠራው	jˈəmit`əraw
የወረዱት	jˈəwərədut
የግብፅ	jˈəɡɨβɨts
ዋነኛው	wˈanəɲaw
የመሳሰሉት	jˈəməsasəlut
አጼ	ʔˈatse
ሌላ	lˈela
በተባለው	bˈətəβaləw
ሳይንሳዊ	sˈajɨnɨsawi
ቀጥተኛ	k`ˈət`ɨtəɲa
ኤንመርካር	ʔˈenɨmərɨkar
ቢሆኑም	bˈihonum
ሀብት	hˈaβɨt
የመኪና	jˈəməkina
የሁለተኛ	jˈəhulətəɲa
በመጋቢት	bˈəməɡaβit
ገዝቶ	ɡˈəzɨto
የቀይ	jˈək`əj
ከእርሱ	kˈəʔɨrɨsu
የእስልምና	jˈəʔɨsɨlɨmɨna
ጥሪ	t`ˈɨri
ዕረፍት	ʔˈɨrəfɨt
ዓመታቸው	ʔˈamətat͡ʃəw
ስራ	sˈɨra
በመጽሐፍ	bˈəmətsɨhaf
ሁሴን	hˈusen
ዐዋጅ	ʔˈawad͡ʒ
አስራ	ʔˈasɨra
ልሳናት	lˈɨsanat
ትዝ	tˈɨz
መዋዕል	mˈəwaʔɨl
ሕብረት	hˈɨβɨrət
ይሄውም	jˈɨhewɨm
በእርግጥ	bˈəʔɨrɨɡɨt`
ግዙፍ	ɡˈɨzuf
ይባል	jˈɨβal
ሄክታር	hˈekɨtar
ታሪኩ	tˈariku
መርዝ	mˈərɨz
ነብዩ	nˈəβɨju
ስልኮች	sˈɨlɨkot͡ʃ
ለሞት	lˈəmot
ንዑስ	nˈɨʔus
ያው	jˈaw
ሜዳ	mˈeda
ሰሜናዊ	sˈəmenawi
ለተወሰነ	lˈətəwəsənə
ሳምንት	sˈamɨnɨt
ዲግሪ	dˈiɡɨri
ዝርዝር	zˈɨrɨzɨr
የኖረ	jˈənorə
ዙፋን	zˈufan
መክተብ	mˈəkɨtəb
ትምህርቶች	tˈɨmɨhɨrɨtot͡ʃ
በጥሩ	bˈət`ɨru
ኑሮ	nˈuro
የአላህ	jˈəʔalax
ጣልያኖች	t`ˈalɨjanot͡ʃ
በዘመናት	bˈəzəmənat
ጭንቀት	t͡ʃ`ˈɨnɨk`ət
አረንጓዴ	ʔˈarənɨɡwade
በግዞት	bˈəɡɨzot
ቢያንስ	bˈijanɨs
ቅጂዎች	k`ˈɨd͡ʒiwot͡ʃ
ገላነሽ	ɡˈəlanəʃ
ጽፎ	tsˈɨfo
የሚያመለክት	jˈəmijamələkɨt
ፓትርያርክ	pˈatɨrɨjarɨk
ባርነት	bˈarɨnət
ፍሰት	fˈɨsət
የተሰኘውን	jˈətəsəɲəwɨn
የሚታወቅ	jˈəmitawək`
መገኘት	mˈəɡəɲət
ይዞ	jˈɨzo
ወለል	wˈələl
በዚያው	bˈəzijaw
ተሠርቶ	tˈəsərɨto
አንጄሎ	ʔˈanɨd͡ʒelo
በሸንጎ	bˈəʃənɨɡo
ገጾች	ɡˈətsot͡ʃ
ሕጋዊ	hˈɨɡawi
የነገሠው	jˈənəɡəsəw
ለእርሱ	lˈəʔɨrɨsu
በስሕተት	bˈəsɨhɨtət
ስብስቦች	sˈɨβɨsɨβot͡ʃ
ስያሜዎች	sˈɨjamewot͡ʃ
ጋዝ	ɡˈaz
በተባለች	bˈətəβalət͡ʃ
መጋቢት	mˈəɡaβit
ክርስቲያናት	kˈɨrɨsɨtijanat
አገሩን	ʔˈaɡərun
ለብቻው	lˈəβɨt͡ʃaw
ኪንግ	kˈinɨɡ
ጠረፍ	t`ˈərəf
ወንዞች	wˈənɨzot͡ʃ
አፈ	ʔˈafə
በሰፊ	bˈəsəfi
በብሔራዊ	bˈəβɨherawi
አርበኞች	ʔˈarɨβəɲot͡ʃ
የሆኑ	jˈəhonu
የተጻፉ	jˈətətsafu
ሌሎችንም	lˈelot͡ʃɨnɨm
ለረጅም	lˈərəd͡ʒɨm
ጊዘ	ɡˈizə
ይሉት	jˈɨlut
ለብዙ	lˈəβɨzu
የቤት	jˈəβet
ቀበሌዎች	k`ˈəβəlewot͡ʃ
ጥበብን	t`ˈɨβəβɨn
አማካኝነት	ʔˈamakaɲɨnət
ስሜት	sˈɨmet
እናታቸው	ʔˈɨnatat͡ʃəw
ግድም	ɡˈɨdɨm
ደብር	dˈəβɨr
ለእግዚአብሔር	lˈəʔɨɡɨziʔaβɨher
ፈጽሞ	fˈətsɨmo
እንዲኖር	ʔˈɨnɨdinor
ወይ	wˈəj
ጽዮን	tsˈɨjon
ዕቃ	ʔˈɨk`a
ግን	ɡˈɨn
ብላ	bˈɨla
ፆታ	tsˈota
የሚችሉ	jˈəmit͡ʃɨlu
ከተማ	kˈətəma
መጀመሪያ	mˈəd͡ʒəmərija
አንዳንዴም	ʔˈanɨdanɨdem
ውክሉ	wˈɨkɨlu
ሚናስ	mˈinas
የመጣውን	jˈəmət`awɨn
ክፍለመደብ	kˈɨfɨləmədəb
በላቲን	bˈəlatin
ሞገድ	mˈoɡəd
አሁንም	ʔˈahunɨm
በመቀጠልም	bˈəmək`ət`əlɨm
መንበር	mˈənɨβər
በደም	bˈədəm
መንገዱ	mˈənɨɡədu
በልዩ	bˈəlɨju
ሰነዶች	sˈənədot͡ʃ
የሚኖሩት	jˈəminorut
የወረዳው	jˈəwərədaw
ረድፍ	rˈədɨf
ልክ	lˈɨk
ተክሉ	tˈəkɨlu
ይህች	jˈɨhɨt͡ʃ
በመውሰድ	bˈəməwɨsəd
ብዜት	bˈɨzet
እንዳላቸው	ʔˈɨnɨdalat͡ʃəw
ተለይቶ	tˈələjɨto
ሶፍትዌር	sˈofɨtɨwer
ሥራዊት	sˈɨrawit
መሣሪያዎች	mˈəsarijawot͡ʃ
ውግያ	wˈɨɡɨja
ደጅ	dˈəd͡ʒ
በውስጡ	bˈəwɨsɨt`u
በኦሮምኛ	bˈəʔoromɨɲa
ረዥም	rˈəʒɨm
እገዛ	ʔˈɨɡəza
ጸጥታ	tsˈət`ɨta
ቋንቋን	k`wˈanɨk`wan
የሚያሳየው	jˈəmijasajəw
መዋቅር	mˈəwak`ɨr
ዘፋኝ	zˈəfaɲ
ጀምረው	d͡ʒˈəmɨrəw
ይሄ	jˈɨhe
ታቦር	tˈaβor
ክፉ	kˈɨfu
መቆጣጠር	mˈək`ot`at`ər
ሲጓዝ	sˈiɡwaz
ርዕሰ	rˈɨʔɨsə
በአገሪቱ	bˈəʔaɡəritu
መሠረተ	mˈəsərətə
ፀሓይ	tsˈəhaj
ባለው	bˈaləw
በርሱ	bˈərɨsu
ዕውነተኛ	ʔˈɨwɨnətəɲa
ሙቀት	mˈuk`ət
ቀጥ	k`ˈət`
እንዲመጣ	ʔˈɨnɨdimət`a
በርግጥ	bˈərɨɡɨt`
ተገዥ	tˈəɡəʒ
ሎሬንዞ	lˈorenɨzo
መፍትሔ	mˈəfɨtɨhe
የፈረንሳይ	jˈəfərənɨsaj
የሚውል	jˈəmiwɨl
ቦታ	bˈota
ሊያስከትል	lˈijasɨkətɨl
ጀርመናዊ	d͡ʒˈərɨmənawi
የሰላም	jˈəsəlam
ኤ	ʔˈe
አይርላንድን	ʔˈajɨrɨlanɨdɨn
በመጨመር	bˈəmət͡ʃ`əmər
ሹመት	ʃˈumət
ጠቅላይ	t`ˈək`ɨlaj
ገብቶ	ɡˈəβɨto
ቢሆን	bˈihon
ስራወች	sˈɨrawət͡ʃ
መሰረተ	mˈəsərətə
ተጠቃሚዎች	tˈət`ək`amiwot͡ʃ
ዳኛ	dˈaɲa
ሰማዕት	sˈəmaʔɨt
መካ	mˈəka
ሳባ	sˈaβa
ሱልጣን	sˈulɨt`an
መቀመጫ	mˈək`əmət͡ʃ`a
የሁለት	jˈəhulət
እስካሁን	ʔˈɨsɨkahun
ሕዝብ	hˈɨzɨb
ተባለ	tˈəβalə
ተጫዋቾች	tˈət͡ʃ`awat͡ʃot͡ʃ
ደረጃውን	dˈərəd͡ʒawɨn
ተፈሪ	tˈəfəri
ሲመለሱ	sˈimələsu
መንገዶች	mˈənɨɡədot͡ʃ
አል	ʔˈal
የተለያየ	jˈətələjajə
አበበ	ʔˈaβəβə
በባሕር	bˈəβahɨr
የማዕረግ	jˈəmaʔɨrəɡ
ሠው	sˈəw
መጽሀፍ	mˈətsɨhaf
ሐምሌ	hˈamɨle
ከመጽሐፍ	kˈəmətsɨhaf
ታሪካዊ	tˈarikawi
ውሀ	wˈɨha
ውጫዊ	wˈɨt͡ʃ`awi
ከአቶ	kˈəʔato
የእምነት	jˈəʔɨmɨnət
መስመሮች	mˈəsɨmərot͡ʃ
ግዛቱ	ɡˈɨzatu
ማስረጃ	mˈasɨrəd͡ʒa
ዐፄ	ʔˈatse
ተማሪወች	tˈəmariwət͡ʃ
ልጆችን	lˈɨd͡ʒot͡ʃɨn
በማስቀመጥ	bˈəmasɨk`əmət`
ያለምንም	jˈaləmɨnɨm
ኃይል	hˈajɨl
ዜማ	zˈema
ዓማርኛ	ʔˈamarɨɲa
ቡድን	bˈudɨn
ለማከም	lˈəmakəm
የምድር	jˈəmɨdɨr
የሮሜ	jˈərome
ፍላጎት	fˈɨlaɡot
የተሠራ	jˈətəsəra
መታሰቢያ	mˈətasəβija
በሚከተለው	bˈəmikətələw
ድምር	dˈɨmɨr
ለጊዜው	lˈəɡizew
መጥቶ	mˈət`ɨto
በከፍተኛ	bˈəkəfɨtəɲa
መስፋፋት	mˈəsɨfafat
ሃሳቦች	hˈasaβot͡ʃ
እግሩ	ʔˈɨɡɨru
እኔን	ʔˈɨnen
ሕዝቦች	hˈɨzɨβot͡ʃ
ጃፓን	d͡ʒˈapan
ቤቱ	bˈetu
ሀሳብ	hˈasab
ስለሆነ	sˈɨləhonə
ጨረር	t͡ʃ`ˈərər
አካባቢዎች	ʔˈakaβaβiwot͡ʃ
መንግሥትና	mˈənɨɡɨsɨtɨna
ገፅ	ɡˈəts
ልሳነ	lˈɨsanə
ልኮ	lˈɨko
ድረ	dˈɨrə
በተመለከተ	bˈətəmələkətə
ሰኑስረት	sˈənusɨrət
አምስተኛ	ʔˈamɨsɨtəɲa
ዝምድና	zˈɨmɨdɨna
የመጡ	jˈəmət`u
የግብጽ	jˈəɡɨβɨts
የሲቪል	jˈəsivil
ዘውድ	zˈəwɨd
ቅራኔ	k`ˈɨrane
ይላሉ	jˈɨlalu
እኛን	ʔˈɨɲan
ትርጓሜ	tˈɨrɨɡwame
በመንግሥት	bˈəmənɨɡɨsɨt
ደም	dˈəm
የአባቱን	jˈəʔaβatun
በሚለው	bˈəmiləw
በሁሉም	bˈəhulum
የዝናብ	jˈəzɨnab
በነበረው	bˈənəβərəw
ዘመን	zˈəmən
ግንኙነት	ɡˈɨnɨɲunət
ትክክል	tˈɨkɨkɨl
ተቀጥሮ	tˈək`ət`ɨro
ዶሮ	dˈoro
በመጨረሻው	bˈəmət͡ʃ`ərəʃaw
ደረሰ	dˈərəsə
በዕብራይስጥ	bˈəʔɨβɨrajɨsɨt`
በሚባል	bˈəmiβal
ተብላ	tˈəβɨla
እውን	ʔˈɨwɨn
አሥራ	ʔˈasɨra
ክህነት	kˈɨhɨnət
የሥራ	jˈəsɨra
ደራሲው	dˈərasiw
ትርጉሙ	tˈɨrɨɡumu
የምትባል	jˈəmɨtɨβal
ለንጉሱ	lˈənɨɡusu
አከፋፈል	ʔˈakəfafəl
በኋላ	bˈəhwala
ጥቅስ	t`ˈɨk`ɨs
ነገስታት	nˈəɡəsɨtat
ኃይለ	hˈajɨlə
ብርቱ	bˈɨrɨtu
ታማኝነት	tˈamaɲɨnət
ሰውነት	sˈəwɨnət
እሳቸው	ʔˈɨsat͡ʃəw
መንፈሳዊ	mˈənɨfəsawi
የአረብ	jˈəʔarəb
ውሃ	wˈɨha
እሱ	ʔˈɨsu
ምድርን	mˈɨdɨrɨn
ወራሪ	wˈərari
ልማዶች	lˈɨmadot͡ʃ
የተሞላ	jˈətəmola
ፖለቲካዊ	pˈolətikawi
ያላት	jˈalat
ኢኮኖሚ	ʔˈikonomi
መጨረሻው	mˈət͡ʃ`ərəʃaw
የመረጃ	jˈəmərəd͡ʒa
ክበብ	kˈɨβəb
አምባገነን	ʔˈamɨβaɡənən
ተከታይ	tˈəkətaj
ትእዛዝ	tˈɨʔɨzaz
ካውንቲ	kˈawɨnɨti
ሌዊ	lˈewi
የዓፄ	jˈəʔatse
ፈላስፋ	fˈəlasɨfa
መስሪያ	mˈəsɨrija
በማገልገል	bˈəmaɡəlɨɡəl
የተወለዱት	jˈətəwələdut
የተሰኙ	jˈətəsəɲu
አይርላንድ	ʔˈajɨrɨlanɨd
አዳል	ʔˈadal
ለኛ	lˈəɲa
የሌለው	jˈəleləw
በደረሰበት	bˈədərəsəβət
ክንፍ	kˈɨnɨf
አንዱን	ʔˈanɨdun
ዜግነት	zˈeɡɨnət
መነሳት	mˈənəsat
በስደት	bˈəsɨdət
በመያዝ	bˈəməjaz
በሽታውን	bˈəʃɨtawɨn
ሐረግ	hˈarəɡ
መላኩ	mˈəlaku
ፓርላማ	pˈarɨlama
የመንፈስ	jˈəmənɨfəs
ማዶ	mˈado
የላቲን	jˈəlatin
ደርሶ	dˈərɨso
መሪነት	mˈərinət
ስፍራ	sˈɨfɨra
ለሰዎች	lˈəsəwot͡ʃ
ቤተ	bˈetə
ዩኒቨርስቲ	jˈunivərɨsɨti
በቅዱስ	bˈək`ɨdus
ሳይቀር	sˈajɨk`ər
መሰረት	mˈəsərət
ምን	mˈɨn
ኦፍ	ʔˈof
እርሱ	ʔˈɨrɨsu
ቪዛ	vˈiza
መጥተው	mˈət`ɨtəw
ደረጃ	dˈərəd͡ʒa
ለመከላከል	lˈəməkəlakəl
ፊልም	fˈilɨm
ዘፈኖችን	zˈəfənot͡ʃɨn
አባሎች	ʔˈaβalot͡ʃ
የደረሰ	jˈədərəsə
ከርሱ	kˈərɨsu
እናንተ	ʔˈɨnanɨtə
በአንድ	bˈəʔanɨd
በሀገራችን	bˈəhaɡərat͡ʃɨn
ጠላቶች	t`ˈəlatot͡ʃ
በማናቸውም	bˈəmanat͡ʃəwɨm
ቁስል	k`ˈusɨl
ሺህ	ʃˈiç
ላሊበላ	lˈaliβəla
ለሚለው	lˈəmiləw
በተለምዶ	bˈətələmɨdo
ቆይቶ	k`ˈojɨto
በይፋ	bˈəjɨfa
ድምጾች	dˈɨmɨtsot͡ʃ
የአገሬው	jˈəʔaɡərew
ባህልና	bˈahɨlɨna
ኅብረት	hˈɨβɨrət
ስምንተኛ	sˈɨmɨnɨtəɲa
የኛ	jˈəɲa
ረጃጅም	rˈəd͡ʒad͡ʒɨm
ይችላሉ	jˈɨt͡ʃɨlalu
እስከ	ʔˈɨsɨkə
ገጽታ	ɡˈətsɨta
የጣልያን	jˈət`alɨjan
ወደ	wˈədə
ሦስተኛ	sˈosɨtəɲa
አካባቢው	ʔˈakaβaβiw
ዝቅ	zˈɨk`
እናታችን	ʔˈɨnatat͡ʃɨn
በአብዛኛው	bˈəʔaβɨzaɲaw
እንደነበር	ʔˈɨnɨdənəβər
ህጎች	hˈɨɡot͡ʃ
ሲጨምር	sˈit͡ʃ`əmɨr
ሙሴ	mˈuse
ቂም	k`ˈim
ባሕል	bˈahɨl
በኣንድ	bˈəʔanɨd
ቫይረሱ	vˈajɨrəsu
በአሜሪካ	bˈəʔamerika
ነገሩን	nˈəɡərun
የኢንተርኔት	jˈəʔinɨtərɨnet
መንስኤ	mˈənɨsɨʔe
የጥንታዊ	jˈət`ɨnɨtawi
ገቢ	ɡˈəβi
ቪ	vˈi
ፍሬ	fˈɨre
ስህተት	sˈɨhɨtət
የእስፓንያ	jˈəʔɨsɨpanɨja
ያሉት	jˈalut
ቅጥ	k`ˈɨt`
ከአዲስ	kˈəʔadis
በተባሉ	bˈətəβalu
በእሳት	bˈəʔɨsat
የግድ	jˈəɡɨd
ሁኔታው	hˈunetaw
መጻህፍት	mˈətsahɨfɨt
ፊልሙ	fˈilɨmu
ጨዋታዎች	t͡ʃ`ˈəwatawot͡ʃ
እስራኤላውያን	ʔˈɨsɨraʔelawɨjan
ቋንቋ	k`wˈanɨk`wa
የሚመጡ	jˈəmimət`u
የኢትዮጵያ	jˈəʔitɨjop`ɨja
ግዛቶች	ɡˈɨzatot͡ʃ
ወዲህ	wˈədiç
እጅግ	ʔˈɨd͡ʒɨɡ
ምናልባትም	mˈɨnalɨβatɨm
ለወዳጅነት	lˈəwədad͡ʒɨnət
በደስታ	bˈədəsɨta
ኢትዮጵያ	ʔˈitɨjop`ɨja
ፈልጎ	fˈəlɨɡo
ላይም	lˈajɨm
ዳር	dˈar
የአውሮጳ	jˈəʔawɨrop`a
በሆነበት	bˈəhonəβət
ዜማዎችን	zˈemawot͡ʃɨn
የግዕዝን	jˈəɡɨʔɨzɨn
አገሮች	ʔˈaɡərot͡ʃ
ቅዱሳን	k`ˈɨdusan
ገብተው	ɡˈəβɨtəw
መመገብ	mˈəməɡəb
አይን	ʔˈajɨn
ትምህርቷን	tˈɨmɨhɨrɨtwan
አጋማሽ	ʔˈaɡamaʃ
ተግባራዊ	tˈəɡɨβarawi
ሐውልት	hˈawɨlɨt
ከታች	kˈətat͡ʃ
ቅድመ	k`ˈɨdɨmə
ውድድሩን	wˈɨdɨdɨrun
ወዲያው	wˈədijaw
ተወዳጅ	tˈəwədad͡ʒ
መላ	mˈəla
ጥበቃ	t`ˈɨβək`a
ማቅረብ	mˈak`ɨrəb
ሕንድ	hˈɨnɨd
ነጋዴዎች	nˈəɡadewot͡ʃ
ነገሥቱ	nˈəɡəsɨtu
ሕያው	hˈɨjaw
እኒህ	ʔˈɨniç
የሚፈጠር	jˈəmifət`ər
ቢኖር	bˈinor
መልሰው	mˈəlɨsəw
ክሮኖስ	kˈɨronos
ዜማዎች	zˈemawot͡ʃ
በሕይወት	bˈəhɨjɨwət
ስፋት	sˈɨfat
ፍልስፍና	fˈɨlɨsɨfɨna
በከተማው	bˈəkətəmaw
እየሰራ	ʔˈɨjəsəra
ጽሑፉ	tsˈɨhufu
ምንጊዜም	mˈɨnɨɡizem
መወሰኛ	mˈəwəsəɲa
ቅርፅ	k`ˈɨrɨts
ይቅር	jˈɨk`ɨr
በሌሎችም	bˈəlelot͡ʃɨm
አንዴ	ʔˈanɨde
አምባ	ʔˈamɨβa
ከቶ	kˈəto
ቀለማት	k`ˈələmat
ጎርፍ	ɡˈorɨf
ያለበት	jˈaləβət
በግ	bˈəɡ
አውጥቶ	ʔˈawɨt`ɨto
ጀምሮ	d͡ʒˈəmɨro
ለምን	lˈəmɨn
ልምምድ	lˈɨmɨmɨd
አጠያያቂ	ʔˈat`əjajak`i
ወጣቱ	wˈət`atu
ዱቄት	dˈuk`et
ለዚህም	lˈəzihɨm
ከዚያ	kˈəzija
ካቴድራል	kˈatedɨral
የተባለ	jˈətəβalə
ሦስተኛው	sˈosɨtəɲaw
ተጨባጭ	tˈət͡ʃ`əβat͡ʃ`
ያሉ	jˈalu
ከሆነ	kˈəhonə
ቤት	bˈet
መነሻ	mˈənəʃa
ከአለት	kˈəʔalət
በትጋት	bˈətɨɡat
ሕግጋት	hˈɨɡɨɡat
በተወለደ	bˈətəwələdə
በጦርነት	bˈət`orɨnət
ኮሎኔል	kˈolonel
የታወቀው	jˈətawək`əw
አቡበክር	ʔˈaβuβəkɨr
በመጀመርያ	bˈəməd͡ʒəmərɨja
በአዲሱ	bˈəʔadisu
ፕሬዝዳንት	pˈɨrezɨdanɨt
ዘንድ	zˈənɨd
ቀሪው	k`ˈəriw
የመሬት	jˈəməret
የሚባል	jˈəmiβal
ውጤት	wˈɨt`et
ሞት	mˈot
አገራቸውን	ʔˈaɡərat͡ʃəwɨn
ከሁለት	kˈəhulət
ጠቃሚ	t`ˈək`ami
ሌላውን	lˈelawɨn
ቤታቸው	bˈetat͡ʃəw
ዘፍጥረት	zˈəfɨt`ɨrət
የኤርትራ	jˈəʔerɨtɨra
ወንድና	wˈənɨdɨna
ዘወትር	zˈəwətɨr
ሲገመት	sˈiɡəmət
ሌሎች	lˈelot͡ʃ
ውድ	wˈɨd
ተመርቆ	tˈəmərɨk`o
ማህበር	mˈahɨβər
ምክር	mˈɨkɨr
ወጥቶ	wˈət`ɨto
ባህል	bˈahɨl
ሕይወታቸውን	hˈɨjɨwətat͡ʃəwɨn
አከባቢ	ʔˈakəβaβi
መረብ	mˈərəb
ይህንንም	jˈɨhɨnɨnɨm
የኣሉ	jˈəʔalu
አማርኛ	ʔˈamarɨɲa
ርዕስ	rˈɨʔɨs
ዳንጉን	dˈanɨɡun
ዑደት	ʔˈudət
የኖሩ	jˈənoru
ትውፊቶች	tˈɨwɨfitot͡ʃ
ያለው	jˈaləw
አ	ʔˈa
ለመግዛት	lˈəməɡɨzat
እድል	ʔˈɨdɨl
አንበሶች	ʔˈanɨβəsot͡ʃ
የሥነ	jˈəsɨnə
ንድፍ	nˈɨdɨf
ሲል	sˈil
የዓለም	jˈəʔaləm
የሆኑት	jˈəhonut
ቀበሮ	k`ˈəβəro
ከነሱም	kˈənəsum
ስርዓት	sˈɨrɨʔat
ከእዚህ	kˈəʔɨziç
ገደማ	ɡˈədəma
ጥንቃቄ	t`ˈɨnɨk`ak`e
አገራቸው	ʔˈaɡərat͡ʃəw
ለማንበብ	lˈəmanɨβəb
ወዲያውም	wˈədijawɨm
የግዕዝ	jˈəɡɨʔɨz
አጠቃቀም	ʔˈat`ək`ak`əm
ውድድሮችን	wˈɨdɨdɨrot͡ʃɨn
በሐዲስ	bˈəhadis
ወሲባዊ	wˈəsiβawi
ተመራማሪ	tˈəməramari
በአውሮጳ	bˈəʔawɨrop`a
ቀጥሎም	k`ˈət`ɨlom
ነው	nˈəw
የአሁኑ	jˈəʔahunu
ይላል	jˈɨlal
ግፍ	ɡˈɨf
ተገኙ	tˈəɡəɲu
በቁጥጥር	bˈək`ut`ɨt`ɨr
እቃዎች	ʔˈɨk`awot͡ʃ
ሃይማኖታዊ	hˈajɨmanotawi
መካከለኛ	mˈəkakələɲa
ስምምነት	sˈɨmɨmɨnət
ማዕከል	mˈaʔɨkəl
ድምፅ	dˈɨmɨts
ማቴዎስ	mˈatewos
ሳሉ	sˈalu
የአካድ	jˈəʔakad
ዳንኤል	dˈanɨʔel
በእጅ	bˈəʔɨd͡ʒ
ልውውጥ	lˈɨwɨwɨt`
ኹኔታ	hˈuneta
ከአባቱ	kˈəʔaβatu
በኋላም	bˈəhwalam
ምላሽ	mˈɨlaʃ
ማለትም	mˈalətɨm
ሌሊት	lˈelit
ሆኗል	hˈonwal
መግቢያ	mˈəɡɨβija
ታላቅ	tˈalak`
ገንዘብ	ɡˈənɨzəb
ሁለቱ	hˈulətu
ብርሃንና	bˈɨrɨhanɨna
ትርጉሞች	tˈɨrɨɡumot͡ʃ
ሰጥቶ	sˈət`ɨto
ጥርጣሬ	t`ˈɨrɨt`are
በተገኘ	bˈətəɡəɲə
ተሸካሚ	tˈəʃəkami
ስትሆን	sˈɨtɨhon
አሞራውያን	ʔˈamorawɨjan
እናቴ	ʔˈɨnate
ኤሌክትሪክ	ʔˈelekɨtɨrik
ውድድሮች	wˈɨdɨdɨrot͡ʃ
ገዳይ	ɡˈədaj
የግሪክ	jˈəɡɨrik
መልዕክቱ	mˈəlɨʔɨkɨtu
ከነዚህ	kˈənəziç
ከስድስት	kˈəsɨdɨsɨt
መካከለኛው	mˈəkakələɲaw
ዕብራይስጥ	ʔˈɨβɨrajɨsɨt`
ምድብ	mˈɨdɨb
ብቻውን	bˈɨt͡ʃawɨn
በተጨማሪ	bˈətət͡ʃ`əmari
ምንም	mˈɨnɨm
ሚካኤል	mˈikaʔel
አለቃ	ʔˈalək`a
ጆርጅ	d͡ʒˈorɨd͡ʒ
እሷም	ʔˈɨswam
ቅርብ	k`ˈɨrɨb
ሃይማኖቶች	hˈajɨmanotot͡ʃ
በዘር	bˈəzər
ትላልቅ	tˈɨlalɨk`
ትብብር	tˈɨβɨβɨr
የመጀመሪያ	jˈəməd͡ʒəmərija
በገዛ	bˈəɡəza
በምን	bˈəmɨn
ስለነበረ	sˈɨlənəβərə
መጨረሻ	mˈət͡ʃ`ərəʃa
የሃይል	jˈəhajɨl
በዙሪያው	bˈəzurijaw
የዛሬ	jˈəzare
የሚለው	jˈəmiləw
የኣማርኛ	jˈəʔamarɨɲa
ክፍለዘመን	kˈɨfɨləzəmən
እነዚህን	ʔˈɨnəzihɨn
ክልክል	kˈɨlɨkɨl
ጣልቃ	t`ˈalɨk`a
ለሰው	lˈəsəw
አገልግሎት	ʔˈaɡəlɨɡɨlot
ነበረው	nˈəβərəw
የሚገኙት	jˈəmiɡəɲut
በሚል	bˈəmil
የጉዞ	jˈəɡuzo
ዓመተ	ʔˈamətə
ራሱ	rˈasu
ነጻነቷን	nˈətsanətwan
አኒዩስ	ʔˈanijus
በቀን	bˈək`ən
እንደሚለው	ʔˈɨnɨdəmiləw
ጠመንጃ	t`ˈəmənɨd͡ʒa
አደባባይ	ʔˈadəβaβaj
የሚባሉ	jˈəmiβalu
ሊኖር	lˈinor
ለነዚህ	lˈənəziç
ነጻነት	nˈətsanət
ጥሬ	t`ˈɨre
የተባሉት	jˈətəβalut
ቲያትር	tˈijatɨr
ሰፈር	sˈəfər
ታናሽ	tˈanaʃ
በመካከለኛው	bˈəməkakələɲaw
ን	nˈɨ
መጻፊያ	mˈətsafija
እድሜያቸው	ʔˈɨdɨmejat͡ʃəw
ነጻነቱን	nˈətsanətun
ትልቁ	tˈɨlɨk`u
ሽብር	ʃˈɨβɨr
ማረፊያ	mˈarəfija
ያገኘው	jˈaɡəɲəw
እነሱ	ʔˈɨnəsu
ለይቶ	lˈəjɨto
የሙዚቃ	jˈəmuzik`a
ነሐሴ	nˈəhase
የጽሕፈት	jˈətsɨhɨfət
የተሻለ	jˈətəʃalə
አጥኝው	ʔˈat`ɨɲɨw
እነሆ	ʔˈɨnəho
ባሻገር	bˈaʃaɡər
ህዳር	hˈɨdar
ፈቃድ	fˈək`ad
ምግብ	mˈɨɡɨb
እንጅ	ʔˈɨnɨd͡ʒ
አይነቶች	ʔˈajɨnətot͡ʃ
መሰረቶች	mˈəsərətot͡ʃ
የኢየሱስ	jˈəʔijəsus
የታወቁ	jˈətawək`u
ዳሪዮስ	dˈarijos
እርሷ	ʔˈɨrɨswa
ስርጭት	sˈɨrɨt͡ʃ`ɨt
ሥራ	sˈɨra
ለሕዝብ	lˈəhɨzɨb
የዘር	jˈəzər
ፈላስፎች	fˈəlasɨfot͡ʃ
ቁሶች	k`ˈusot͡ʃ
ከተማው	kˈətəmaw
የስነ	jˈəsɨnə
አቡ	ʔˈaβu
አላህ	ʔˈalax
ምድራዊ	mˈɨdɨrawi
ጨረቃ	t͡ʃ`ˈərək`a
ማህበሩ	mˈahɨβəru
ምት	mˈɨt
ሊቀ	lˈik`ə
የተዘጋጀው	jˈətəzəɡad͡ʒəw
እርሻ	ʔˈɨrɨʃa
የዚሁ	jˈəzihu
በቅድስት	bˈək`ɨdɨsɨt
ነበር	nˈəβər
ዳምጠው	dˈamɨt`əw
ሃይቅ	hˈajɨk`
የኦሮሞ	jˈəʔoromo
ምርት	mˈɨrɨt
እንቅስቃሴዎች	ʔˈɨnɨk`ɨsɨk`asewot͡ʃ
ባህር	bˈahɨr
እስላማዊ	ʔˈɨsɨlamawi
የፖርቱጋል	jˈəporɨtuɡal
እረፍት	ʔˈɨrəfɨt
በግልጽ	bˈəɡɨlɨts
ምንድን	mˈɨnɨdɨn
የካቶሊክ	jˈəkatolik
የውሃ	jˈəwɨha
ለማጥናት	lˈəmat`ɨnat
ለምግብነት	lˈəmɨɡɨβɨnət
ስመ	sˈɨmə
በሰዎች	bˈəsəwot͡ʃ
በደንብ	bˈədənɨb
አመጣጥ	ʔˈamət`at`
ቀዳሚ	k`ˈədami
ብዙ	bˈɨzu
ምሁራን	mˈɨhuran
የሰብዓዊ	jˈəsəβɨʔawi
በመድረክ	bˈəmədɨrək
አባል	ʔˈaβal
ቶሎ	tˈolo
በቀር	bˈək`ər
መቶ	mˈəto
ብሄራዊ	bˈɨherawi
ይገናኛሉ	jˈɨɡənaɲalu
ሰልፎች	sˈəlɨfot͡ʃ
አዳኝ	ʔˈadaɲ
በምትባል	bˈəmɨtɨβal
ያደረገው	jˈadərəɡəw
የሚገኘውን	jˈəmiɡəɲəwɨn
በቦታው	bˈəβotaw
ሚና	mˈina
ከላይ	kˈəlaj
የመንግስት	jˈəmənɨɡɨsɨt
ለመስጠት	lˈəməsɨt`ət
የቋንቋ	jˈək`wanɨk`wa
ህግ	hˈɨɡ
ቋንቋዎች	k`wˈanɨk`wawot͡ʃ
በዘፍጥረት	bˈəzəfɨt`ɨrət
በከተማዋ	bˈəkətəmawa
ወላጅ	wˈəlad͡ʒ
የሚመስል	jˈəmiməsɨl
ስጋት	sˈɨɡat
ምንጮች	mˈɨnɨt͡ʃ`ot͡ʃ
ዳዊት	dˈawit
ምናልባት	mˈɨnalɨβat
በወታደራዊ	bˈəwətadərawi
ደንብ	dˈənɨb
የዝሆን	jˈəzɨhon
ምክንያት	mˈɨkɨnɨjat
ባቢሎን	bˈaβilon
በመጠቀም	bˈəmət`ək`əm
እንዚራን	ʔˈɨnɨziran
መረጃዎች	mˈərəd͡ʒawot͡ʃ
መሰረታዊ	mˈəsərətawi
አስተዋጽኦ	ʔˈasɨtəwatsɨʔo
ክፍሉ	kˈɨfɨlu
በኩል	bˈəkul
ችሎታ	t͡ʃˈɨlota
ጥቃት	t`ˈɨk`at
ዘዴ	zˈəde
በመፍጠር	bˈəməfɨt`ər
ኗሪ	nwˈari
ቡናማ	bˈunama
ቻርልስ	t͡ʃˈarɨlɨs
ክፍት	kˈɨfɨt
ግቢ	ɡˈɨβi
ክርስቶስን	kˈɨrɨsɨtosɨn
የተገኘ	jˈətəɡəɲə
ኖረ	nˈorə
የኔ	jˈəne
በመርታት	bˈəmərɨtat
በትክክል	bˈətɨkɨkɨl
የተፈጠረ	jˈətəfət`ərə
ሰላማዊ	sˈəlamawi
ይቻላል	jˈɨt͡ʃalal
ቆጠራ	k`ˈot`əra
ከእናቱ	kˈəʔɨnatu
የአገሪቱን	jˈəʔaɡəritun
ዓክልበ	ʔˈakɨlɨβə
ድምጽ	dˈɨmɨts
ጥንድ	t`ˈɨnɨd
አማካሪ	ʔˈamakari
የእንጨት	jˈəʔɨnɨt͡ʃ`ət
ሰባቱ	sˈəβatu
አርጎ	ʔˈarɨɡo
አሠራር	ʔˈasərar
የጻፈው	jˈətsafəw
ባለሥልጣናት	bˈaləsɨlɨt`anat
የሰውነት	jˈəsəwɨnət
በሃይል	bˈəhajɨl
ግለሰቦች	ɡˈɨləsəβot͡ʃ
የፆታ	jˈətsota
ከተማውን	kˈətəmawɨn
ለገበያ	lˈəɡəβəja
የሚሆኑት	jˈəmihonut
ሲስተም	sˈisɨtəm
መልእክት	mˈəlɨʔɨkɨt
ምክንያቱ	mˈɨkɨnɨjatu
ሌላው	lˈelaw
ወድቆ	wˈədɨk`o
ተይዞ	tˈəjɨzo
ከሁሉም	kˈəhulum
ይገኛሉ	jˈɨɡəɲalu
ለመላው	lˈəməlaw
ሲናገር	sˈinaɡər
ኤድስ	ʔˈedɨs
ግጭት	ɡˈɨt͡ʃ`ɨt
ዶክቶር	dˈokɨtor
ማሞ	mˈamo
በእርሱ	bˈəʔɨrɨsu
ፊደላት	fˈidəlat
ይችላል	jˈɨt͡ʃɨlal
የሚኖሩ	jˈəminoru
ማዕረግ	mˈaʔɨrəɡ
ወርቅ	wˈərɨk`
አባ	ʔˈaβa
በእዚህ	bˈəʔɨziç
ባልታወቀ	bˈalɨtawək`ə
ወለተ	wˈələtə
ሰራዊት	sˈərawit
ይችል	jˈɨt͡ʃɨl
አይተው	ʔˈajɨtəw
ቤቶች	bˈetot͡ʃ
በመሥራት	bˈəməsɨrat
ሸለቆ	ʃˈələk`o
ቀርቶ	k`ˈərɨto
ከጥንት	kˈət`ɨnɨt
በግፍ	bˈəɡɨf
ስኬታማ	sˈɨketama
በሁለቱም	bˈəhulətum
ተለዋዋጭ	tˈələwawat͡ʃ`
እሳት	ʔˈɨsat
ውድር	wˈɨdɨr
በርስ	bˈərɨs
ለሁለት	lˈəhulət
አንድን	ʔˈanɨdɨn
ኢጣልያ	ʔˈit`alɨja
በሮማ	bˈəroma
ማሽን	mˈaʃɨn
አጋጣሚ	ʔˈaɡat`ami
ሥነ	sˈɨnə
ተይዘው	tˈəjɨzəw
ስፖርት	sˈɨporɨt
ጉዞ	ɡˈuzo
አብ	ʔˈab
ራሱን	rˈasun
ተዋህዶ	tˈəwahɨdo
መሬት	mˈəret
ግለሰብ	ɡˈɨləsəb
አካባቢ	ʔˈakaβaβi
ቀድሞ	k`ˈədɨmo
ከፈጣሪ	kˈəfət`ari
ሁለተኛውን	hˈulətəɲawɨn
እህል	ʔˈɨhɨl
የከተማው	jˈəkətəmaw
የተገኙ	jˈətəɡəɲu
ባሩድ	bˈarud
ህብረት	hˈɨβɨrət
መለያ	mˈələja
ከሥነ	kˈəsɨnə
ታቦት	tˈaβot
ሲ	sˈi
የተወሰኑ	jˈətəwəsənu
ውሸት	wˈɨʃət
ሃገር	hˈaɡər
አባታቸው	ʔˈaβatat͡ʃəw
ባብዛኛው	bˈaβɨzaɲaw
የሚመጣ	jˈəmimət`a
ተክል	tˈəkɨl
መደቦች	mˈədəβot͡ʃ
በአገራችን	bˈəʔaɡərat͡ʃɨn
ትግርኛ	tˈɨɡɨrɨɲa
በታላቅ	bˈətalak`
ጽኑ	tsˈɨnu
የሚያደርገው	jˈəmijadərɨɡəw
ሲያገለግሉ	sˈijaɡələɡɨlu
ዕድሜው	ʔˈɨdɨmew
መስዋዕት	mˈəsɨwaʔɨt
እንድትሆን	ʔˈɨnɨdɨtɨhon
የቻለ	jˈət͡ʃalə
በተከታታይ	bˈətəkətataj
በሥራ	bˈəsɨra
ገዛ	ɡˈəza
በአለም	bˈəʔaləm
በሰላም	bˈəsəlam
ናሙና	nˈamuna
ዎቹ	wˈot͡ʃu
በሁለተኛው	bˈəhulətəɲaw
መድረክ	mˈədɨrək
ድጋፍ	dˈɨɡaf
ኣንድ	ʔˈanɨd
በሁሉ	bˈəhulu
ሥፍራዎች	sˈɨfɨrawot͡ʃ
ማስተማር	mˈasɨtəmar
ይህንን	jˈɨhɨnɨn
በመቃወም	bˈəmək`awəm
የኖሩት	jˈənorut
በተገኘው	bˈətəɡəɲəw
የሚያሳዩ	jˈəmijasaju
የንጉሠ	jˈənɨɡusə
ከግሪክ	kˈəɡɨrik
አቶ	ʔˈato
አንዳች	ʔˈanɨdat͡ʃ
የሚሉት	jˈəmilut
ስሙ	sˈɨmu
ሥራቸው	sˈɨrat͡ʃəw
ሙዚቃ	mˈuzik`a
ሰንደቅ	sˈənɨdək`
ገዳም	ɡˈədam
ተሽከርካሪ	tˈəʃɨkərɨkari
በስሜን	bˈəsɨmen
ቆፋሪዎች	k`ˈofariwot͡ʃ
ትዕዛዝ	tˈɨʔɨzaz
እና	ʔˈɨna
ሀገሩ	hˈaɡəru
አሦር	ʔˈasor
ከጊዜ	kˈəɡize
አልጋ	ʔˈalɨɡa
አቅም	ʔˈak`ɨm
ወርረው	wˈərɨrəw
እለት	ʔˈɨlət
በአየር	bˈəʔajər
ጉድ	ɡˈud
በሚቀጥለው	bˈəmik`ət`ɨləw
ያለበትን	jˈaləβətɨn
ፈራጅ	fˈərad͡ʒ
ለማምጣት	lˈəmamɨt`at
ያደረጉት	jˈadərəɡut
ስር	sˈɨr
ቅጂ	k`ˈɨd͡ʒi
በረራ	bˈərəra
ግምት	ɡˈɨmɨt
የካልኩለስ	jˈəkalɨkuləs
አጠቃላይ	ʔˈat`ək`alaj
የሰው	jˈəsəw
ጸሐፊዎች	tsˈəhafiwot͡ʃ
ቁጥጥር	k`ˈut`ɨt`ɨr
ከተሞች	kˈətəmot͡ʃ
ግብፅ	ɡˈɨβɨts
አርፈው	ʔˈarɨfəw
እንዲሆን	ʔˈɨnɨdihon
ፋሲል	fˈasil
በትምህርት	bˈətɨmɨhɨrɨt
ክምችት	kˈɨmɨt͡ʃɨt
አገረ	ʔˈaɡərə
ግልገል	ɡˈɨlɨɡəl
ቴዎድሮስ	tˈewodɨros
ብሔረሰብ	bˈɨherəsəb
ጣቢያ	t`ˈaβija
በተመሳሳይ	bˈətəməsasaj
አድርገው	ʔˈadɨrɨɡəw
ያንጊዜ	jˈanɨɡize
ከተማቸው	kˈətəmat͡ʃəw
ለመክፈል	lˈəməkɨfəl
እንዴት	ʔˈɨnɨdet
የሚሉ	jˈəmilu
ሰፊ	sˈəfi
ችሎታው	t͡ʃˈɨlotaw
ሁሉ	hˈulu
የሆነውን	jˈəhonəwɨn
ጨምሮ	t͡ʃ`ˈəmɨro
ካለ	kˈalə
አንበሳ	ʔˈanɨβəsa
የብሔራዊ	jˈəβɨherawi
የተዘጋጀ	jˈətəzəɡad͡ʒə
በኮምፕዩተር	bˈəkomɨpɨjutər
እርግጠኛ	ʔˈɨrɨɡɨt`əɲa
ከሦስት	kˈəsosɨt
አብዮታዊ	ʔˈaβɨjotawi
አባት	ʔˈaβat
ሚልዮን	mˈilɨjon
እንስሳ	ʔˈɨnɨsɨsa
ምርጫ	mˈɨrɨt͡ʃ`a
አስቸጋሪ	ʔˈasɨt͡ʃəɡari
መምጣት	mˈəmɨt`at
እንዲሁ	ʔˈɨnɨdihu
የመኖሪያ	jˈəmənorija
በዚሁ	bˈəzihu
የፊልም	jˈəfilɨm
አቆጣጠር	ʔˈak`ot`at`ər
መንግሥታት	mˈənɨɡɨsɨtat
ፍንዳታ	fˈɨnɨdata
የሚኖረው	jˈəminorəw
ሲሞት	sˈimot
ቀጭኔ	k`ˈət͡ʃ`ɨne
ድርብ	dˈɨrɨb
ሳይንቲስቶች	sˈajɨnɨtisɨtot͡ʃ
ወደብ	wˈədəb
ወይንም	wˈəjɨnɨm
የቻይና	jˈət͡ʃajɨna
ሽግግር	ʃˈɨɡɨɡɨr
እንዲመለስ	ʔˈɨnɨdimələs
ነክ	nˈək
ትልቅ	tˈɨlɨk`
ማንኛውንም	mˈanɨɲawɨnɨm
የደረሰው	jˈədərəsəw
የአፍሪካ	jˈəʔafɨrika
ዴ	dˈe
መማር	mˈəmar
ፍቅር	fˈɨk`ɨr
ሰማንያ	sˈəmanɨja
እንደራሴ	ʔˈɨnɨdərase
ወርቃማ	wˈərɨk`ama
አላቸው	ʔˈalat͡ʃəw
ስልት	sˈɨlɨt
ጓደኛ	ɡwˈadəɲa
አህጉር	ʔˈahɨɡur
ሌሎችም	lˈelot͡ʃɨm
ዝርዝሮች	zˈɨrɨzɨrot͡ʃ
በተለየ	bˈətələjə
ሊሆኑ	lˈihonu
ግዛታቸውን	ɡˈɨzatat͡ʃəwɨn
የሚኖሩበት	jˈəminoruβət
የሁሉ	jˈəhulu
የአይርላንድ	jˈəʔajɨrɨlanɨd
የጤና	jˈət`ena
እያደገ	ʔˈɨjadəɡə
መንግስታት	mˈənɨɡɨsɨtat
እንዲያውም	ʔˈɨnɨdijawɨm
ቅድሚያ	k`ˈɨdɨmija
ረቂቅ	rˈək`ik`
ረገድ	rˈəɡəd
በቅርቡ	bˈək`ɨrɨβu
ፍርስራሽ	fˈɨrɨsɨraʃ
ለመሄድ	lˈəməhed
አካውንት	ʔˈakawɨnɨt
ዳቦ	dˈaβo
የበረራ	jˈəβərəra
ክብደት	kˈɨβɨdət
ሃሳብ	hˈasab
ዩናይትድ	jˈunajɨtɨd
ሊሆን	lˈihon
ቀን	k`ˈən
ጣና	t`ˈana
በጭራሽ	bˈət͡ʃ`ɨraʃ
ስያሜ	sˈɨjame
የአምላክ	jˈəʔamɨlak
ሳንቲሞች	sˈanɨtimot͡ʃ
ጣሊያን	t`ˈalijan
ከነበረው	kˈənəβərəw
ቅጠሎች	k`ˈɨt`əlot͡ʃ
ጥቅሙ	t`ˈɨk`ɨmu
እየሱስ	ʔˈɨjəsus
ሳንጃክ	sˈanɨd͡ʒak
የአገሪቱ	jˈəʔaɡəritu
የአሜሪካን	jˈəʔamerikan
ፍጻሜ	fˈɨtsame
ለማለት	lˈəmalət
የሚሰጡ	jˈəmisət`u
ክብርና	kˈɨβɨrɨna
በቀይ	bˈək`əj
አየር	ʔˈajər
ኅብረተሠብ	hˈɨβɨrətəsəb
በመጨረሻም	bˈəmət͡ʃ`ərəʃam
ከሚለው	kˈəmiləw
ማህበራዊ	mˈahɨβərawi
የተጀመረው	jˈətəd͡ʒəmərəw
ቀናት	k`ˈənat
በመወሰዱ	bˈəməwəsədu
ዝርዝሩ	zˈɨrɨzɨru
የተመሠረተው	jˈətəməsərətəw
ሕክምና	hˈɨkɨmɨna
የቆዳ	jˈək`oda
ተቃውሞ	tˈək`awɨmo
መውጣት	mˈəwɨt`at
የሚገልጽ	jˈəmiɡəlɨts
በሚባሉ	bˈəmiβalu
በዶክተሩ	bˈədokɨtəru
ማርቆስ	mˈarɨk`os
በርግጥም	bˈərɨɡɨt`ɨm
ትንንሽ	tˈɨnɨnɨʃ
ባሉ	bˈalu
ዛሬም	zˈarem
ከብዙ	kˈəβɨzu
ብዛት	bˈɨzat
ከዚህም	kˈəzihɨm
ባህሎች	bˈahɨlot͡ʃ
በቃ	bˈək`a
በኢየሩሳሌም	bˈəʔijərusalem
ኣንድን	ʔˈanɨdɨn
በውኑ	bˈəwɨnu
ላይ	lˈaj
ማለቱ	mˈalətu
ትምህርትን	tˈɨmɨhɨrɨtɨn
በሰብአዊ	bˈəsəβɨʔawi
ኣንዱ	ʔˈanɨdu
በጣልያን	bˈət`alɨjan
የተጻፈው	jˈətətsafəw
የነዚህ	jˈənəziç
ዓመቱ	ʔˈamətu
ህዋሳት	hˈɨwasat
ካህናቱ	kˈahɨnatu
ሰፋ	sˈəfa
ጣፋጭ	t`ˈafat͡ʃ`
ያገኘ	jˈaɡəɲə
ከዓለም	kˈəʔaləm
ሠፈር	sˈəfər
ጳጳስ	p`ˈap`as
ኪዳን	kˈidan
ጣሊያኖች	t`ˈalijanot͡ʃ
የመንግሥት	jˈəmənɨɡɨsɨt
በግራ	bˈəɡɨra
ቤቴ	bˈete
ተሸላሚ	tˈəʃəlami
ማውጣት	mˈawɨt`at
ቦታዎች	bˈotawot͡ʃ
ባለ	bˈalə
ሲሆን	sˈihon
ዓማርኛውን	ʔˈamarɨɲawɨn
እስላም	ʔˈɨsɨlam
የቀሩት	jˈək`ərut
እስያ	ʔˈɨsɨja
ካሣ	kˈasa
መንግሥታዊ	mˈənɨɡɨsɨtawi
ዳሩ	dˈaru
አድርገን	ʔˈadɨrɨɡən
በመውጣት	bˈəməwɨt`at
ነፃነት	nˈətsanət
በመጽሐፈ	bˈəmətsɨhafə
ዘመኑ	zˈəmənu
ከሆኑ	kˈəhonu
ልጆች	lˈɨd͡ʒot͡ʃ
ወንበር	wˈənɨβər
ተከታታይ	tˈəkətataj
ባህሪ	bˈahɨri
ውሾች	wˈɨʃot͡ʃ
ቡና	bˈuna
በስማቸው	bˈəsɨmat͡ʃəw
ሥልጣኔ	sˈɨlɨt`ane
በድሮ	bˈədɨro
የሚያገለግል	jˈəmijaɡələɡɨl
ውድድር	wˈɨdɨdɨr
በቀጥታ	bˈək`ət`ɨta
ፌዴሬሽኑ	fˈedereʃɨnu
በራስ	bˈəras
ና	nˈa
እርግጥኛ	ʔˈɨrɨɡɨt`ɨɲa
ወጥተው	wˈət`ɨtəw
ፕሬዚዳንት	pˈɨrezidanɨt
ትክክለኛውን	tˈɨkɨkɨləɲawɨn
ወሎ	wˈəlo
ዜሮ	zˈero
በአጭር	bˈəʔat͡ʃ`ɨr
ቦይ	bˈoj
በውስጣቸው	bˈəwɨsɨt`at͡ʃəw
የተስፋፋ	jˈətəsɨfafa
ወዘተ	wˈəzətə
ማስታወሻ	mˈasɨtawəʃa
የባህል	jˈəβahɨl
ኤችአይቪ	ʔˈet͡ʃɨʔajɨvi
ኤረን	ʔˈerən
ከኣንድ	kˈəʔanɨd
የላፕላስ	jˈəlapɨlas
ከራሱ	kˈərasu
ይሄን	jˈɨhen
የለም	jˈələm
ከንጉሠ	kˈənɨɡusə
ታሪክና	tˈarikɨna
ሁለት	hˈulət
ውጊያ	wˈɨɡija
ክርስቶስ	kˈɨrɨsɨtos
ድንጋዩ	dˈɨnɨɡaju
በውሃ	bˈəwɨha
ወረዳ	wˈərəda
ጨው	t͡ʃ`ˈəw
የኤሌክትሪክ	jˈəʔelekɨtɨrik
በረሃ	bˈərəha
ግድብ	ɡˈɨdɨb
ቁጥራቸው	k`ˈut`ɨrat͡ʃəw
አዲሱን	ʔˈadisun
እግዚአብሔር	ʔˈɨɡɨziʔaβɨher
መንደር	mˈənɨdər
በጥንቃቄ	bˈət`ɨnɨk`ak`e
በሽታው	bˈəʃɨtaw
ሲሄድ	sˈihed
የቅዱስ	jˈək`ɨdus
ተመልካች	tˈəməlɨkat͡ʃ
ተወላጆች	tˈəwəlad͡ʒot͡ʃ
በዚያ	bˈəzija
የስልጣን	jˈəsɨlɨt`an
አልነበረም	ʔˈalɨnəβərəm
ሚኒስትር	mˈinisɨtɨr
ጥምረት	t`ˈɨmɨrət
ሰውም	sˈəwɨm
የምሥራቅ	jˈəmɨsɨrak`
አና	ʔˈana
ሆኖም	hˈonom
ዓፄ	ʔˈatse
የሽግግር	jˈəʃɨɡɨɡɨr
ጠጣር	t`ˈət`ar
የሳይንስ	jˈəsajɨnɨs
የሚገኘው	jˈəmiɡəɲəw
ዶክተር	dˈokɨtər
ቀጥሎ	k`ˈət`ɨlo
ወንጌል	wˈənɨɡel
የታወቀ	jˈətawək`ə
ለቆ	lˈək`o
መሣሪያ	mˈəsarija
በዓለም	bˈəʔaləm
ንጉሥ	nˈɨɡus
ለውጥ	lˈəwɨt`
ጠጠር	t`ˈət`ər
ጸሐፍት	tsˈəhafɨt
የሚጠጋ	jˈəmit`əɡa
ገበታ	ɡˈəβəta
በመሆኑም	bˈəməhonum
ሰልፍ	sˈəlɨf
ቤተሰቦች	bˈetəsəβot͡ʃ
ነውና	nˈəwɨna
መንግሥት	mˈənɨɡɨsɨt
ከአንድ	kˈəʔanɨd
ጎጃም	ɡˈod͡ʒam
መፈንቅለ	mˈəfənɨk`ɨlə
ቀኖና	k`ˈənona
ውድቅ	wˈɨdɨk`
የገንዘብ	jˈəɡənɨzəb
ለመኖር	lˈəmənor
ከባሕር	kˈəβahɨr
የቤተክርስቲያን	jˈəβetəkɨrɨsɨtijan
ድርሻ	dˈɨrɨʃa
የኮምፕዩተር	jˈəkomɨpɨjutər
ለመያዝ	lˈəməjaz
ሁለቱን	hˈulətun
ማለፍ	mˈaləf
የዚህ	jˈəziç
ተከተል	tˈəkətəl
የቤተ	jˈəβetə
በሬ	bˈəre
የተመሠረተ	jˈətəməsərətə
የወንድ	jˈəwənɨd
ነገሥታት	nˈəɡəsɨtat
በደብረ	bˈədəβɨrə
መካከል	mˈəkakəl
የተጻፈ	jˈətətsafə
የጥናት	jˈət`ɨnat
ፌዴሬሽን	fˈedereʃɨn
ጸባይ	tsˈəβaj
እንጨት	ʔˈɨnɨt͡ʃ`ət
በየወሩ	bˈəjəwəru
እኩል	ʔˈɨkul
ጄነራል	d͡ʒˈenəral
የዘውድ	jˈəzəwɨd
በርካታ	bˈərɨkata
የመጨረሻው	jˈəmət͡ʃ`ərəʃaw
ዝርያ	zˈɨrɨja
ለሁሉም	lˈəhulum
መቀነስ	mˈək`ənəs
የቆመ	jˈək`omə
ታህሳስ	tˈahɨsas
በመላ	bˈəməla
አነስተኛ	ʔˈanəsɨtəɲa
ጥልቅ	t`ˈɨlɨk`
ብለህ	bˈɨləx
ቅጥር	k`ˈɨt`ɨr
ለመስራት	lˈəməsɨrat
መተካት	mˈətəkat
ሰወች	sˈəwət͡ʃ
የሚችለው	jˈəmit͡ʃɨləw
ለአጭር	lˈəʔat͡ʃ`ɨr
መሄድ	mˈəhed
በመባል	bˈəməβal
በነበሩት	bˈənəβərut
ሶርያ	sˈorɨja
ይዘው	jˈɨzəw
ሄራክሌስ	hˈerakɨles
ከባድ	kˈəβad
ዘዴዎች	zˈədewot͡ʃ
ስንት	sˈɨnɨt
ማይክል	mˈajɨkɨl
ጊዜው	ɡˈizew
ሆድ	hˈod
ለዚሁ	lˈəzihu
ጎሣ	ɡˈosa
በክብር	bˈəkɨβɨr
ኤች	ʔˈet͡ʃ
ጨካኝ	t͡ʃ`ˈəkaɲ
ቀበሮዎች	k`ˈəβərowot͡ʃ
ተጓዦች	tˈəɡwaʒot͡ʃ
ነጠላ	nˈət`əla
ያሉትን	jˈalutɨn
አለቃው	ʔˈalək`aw
ሸዋ	ʃˈəwa
ግሪክ	ɡˈɨrik
የጋብቻ	jˈəɡaβɨt͡ʃa
ከሰሜን	kˈəsəmen
ኋንግ	hwˈanɨɡ
በጠቅላላው	bˈət`ək`ɨlalaw
ፈጣሪ	fˈət`ari
ግንድ	ɡˈɨnɨd
በሌሎቹ	bˈəlelot͡ʃu
ሰሜን	sˈəmen
በእንግሊዞች	bˈəʔɨnɨɡɨlizot͡ʃ
የፍቅር	jˈəfɨk`ɨr
ጸሎት	tsˈəlot
ዲግሪውን	dˈiɡɨriwɨn
ከሚባሉት	kˈəmiβalut
ጨለማ	t͡ʃ`ˈələma
ጴጥሮስ	p`ˈet`ɨros
ክስተት	kˈɨsɨtət
ሶቅራጠስ	sˈok`ɨrat`əs
የአገራችን	jˈəʔaɡərat͡ʃɨn
አልበም	ʔˈalɨβəm
ተራራማ	tˈərarama
ለርሱ	lˈərɨsu
ለመመለስ	lˈəməmələs
ሰዓታት	sˈəʔatat
ፕላቶ	pˈɨlato
ድረስ	dˈɨrəs
በምንም	bˈəmɨnɨm
መድኅን	mˈədɨhɨn
መቅደላ	mˈək`ɨdəla
መሳፍንት	mˈəsafɨnɨt
የሮማ	jˈəroma
መቅደስ	mˈək`ɨdəs
የቀዳማዊ	jˈək`ədamawi
ሌሎቹ	lˈelot͡ʃu
አፍሪቃ	ʔˈafɨrik`a
እናም	ʔˈɨnam
ንግድ	nˈɨɡɨd
አኳያ	ʔˈakwaja
በአንዱ	bˈəʔanɨdu
አይሁዶች	ʔˈajɨhudot͡ʃ
ከ	kˈə
ግርማ	ɡˈɨrɨma
ሱልጣኔት	sˈulɨt`anet
ዙሪያ	zˈurija
ከሴት	kˈəset
የተባለች	jˈətəβalət͡ʃ
መክተቢያ	mˈəkɨtəβija
የበርካታ	jˈəβərɨkata
የጀመረው	jˈəd͡ʒəmərəw
ጸሐፊው	tsˈəhafiw
ላዕላይነት	lˈaʔɨlajɨnət
የሚታወቁ	jˈəmitawək`u
ይህ	jˈɨx
ጫማ	t͡ʃ`ˈama
የሆነው	jˈəhonəw
ወላጆች	wˈəlad͡ʒot͡ʃ
ቍጥሮች	k`wˈɨt`ɨrot͡ʃ
ትናንሽ	tˈɨnanɨʃ
መጠጥ	mˈət`ət`
ላይኛ	lˈajɨɲa
ከመሬት	kˈəməret
መኮንኖች	mˈəkonɨnot͡ʃ
ምስክር	mˈɨsɨkɨr
ቁጠራ	k`ˈut`əra
ሊቀመንበር	lˈik`əmənɨβər
ኮምፕዩተር	kˈomɨpɨjutər
መኮንን	mˈəkonɨn
ችግሮች	t͡ʃˈɨɡɨrot͡ʃ
ለመመሥረት	lˈəməməsɨrət
መሥሪያ	mˈəsɨrija
ነፍስ	nˈəfɨs
የሚሰጡዋቸውን	jˈəmisət`uwat͡ʃəwɨn
አንዳችም	ʔˈanɨdat͡ʃɨm
ሊግ	lˈiɡ
እስር	ʔˈɨsɨr
ቢሮ	bˈiro
ከሆኑት	kˈəhonut
የኢትዮጵያን	jˈəʔitɨjop`ɨjan
ክልሉ	kˈɨlɨlu
የፈጠረው	jˈəfət`ərəw
በተወለዱ	bˈətəwələdu
ታሪኮች	tˈarikot͡ʃ
የኖህ	jˈənox
ቴክኖሎጂ	tˈekɨnolod͡ʒi
እያንዳንዳቸው	ʔˈɨjanɨdanɨdat͡ʃəw
ይባሉ	jˈɨβalu
ዕብራውያን	ʔˈɨβɨrawɨjan
ዘ	zˈə
ከነበሩት	kˈənəβərut
ቅኝ	k`ˈɨɲ
ሙዚየም	mˈuzijəm
ምልክቶች	mˈɨlɨkɨtot͡ʃ
ህዋስ	hˈɨwas
ህጋዊ	hˈɨɡawi
በካፋ	bˈəkafa
የብረት	jˈəβɨrət
ውል	wˈɨl
ግንባታ	ɡˈɨnɨβata
ማናቸውንም	mˈanat͡ʃəwɨnɨm
ከዋክብት	kˈəwakɨβɨt
ንቅናቄ	nˈɨk`ɨnak`e
በዋናነት	bˈəwananət
በቫይረሱ	bˈəvajɨrəsu
ዛፍ	zˈaf
ክርስቲያን	kˈɨrɨsɨtijan
የመከላከያ	jˈəməkəlakəja
እናቱ	ʔˈɨnatu
ተጠቃሽ	tˈət`ək`aʃ
እዚያ	ʔˈɨzija
ሲያርፍ	sˈijarɨf
ዘመኖች	zˈəmənot͡ʃ
ዳርቻ	dˈarɨt͡ʃa
ስለጀመሩ	sˈɨləd͡ʒəməru
የተለየ	jˈətələjə
ዕለት	ʔˈɨlət
አርባ	ʔˈarɨβa
ለመጠበቅ	lˈəmət`əβək`
የቀለም	jˈək`ələm
በደቡብ	bˈədəβub
እኛም	ʔˈɨɲam
አብዮት	ʔˈaβɨjot
ለህትመት	lˈəhɨtɨmət
ዩኒቨርሲቲ	jˈunivərɨsiti
ከተለያዩ	kˈətələjaju
እዚያው	ʔˈɨzijaw
የሀገሪቱ	jˈəhaɡəritu
ኪዳነ	kˈidanə
በነፃ	bˈənətsa
አልባ	ʔˈalɨβa
ደካማ	dˈəkama
በኢትዮጵያ	bˈəʔitɨjop`ɨja
አሪስጣጣሊስ	ʔˈarisɨt`at`alis
ቃል	k`ˈal
ባሉበት	bˈaluβət
መስመር	mˈəsɨmər
ፎቅ	fˈok`
መምረጥ	mˈəmɨrət`
ለማክበር	lˈəmakɨβər
የፈጠራ	jˈəfət`əra
ይኸው	jˈɨhəw
ልብስ	lˈɨβɨs
በማስተማር	bˈəmasɨtəmar
ግዴታ	ɡˈɨdeta
ሃይማኖት	hˈajɨmanot
የራሱ	jˈərasu
እድገት	ʔˈɨdɨɡət
ሦስቱ	sˈosɨtu
የመጽሐፍ	jˈəmətsɨhaf
ሰላማ	sˈəlama
እሷ	ʔˈɨswa
አባቱ	ʔˈaβatu
ጓደኞቹ	ɡwˈadəɲot͡ʃu
አባቴ	ʔˈaβate
አምልኮት	ʔˈamɨlɨkot
መጨመር	mˈət͡ʃ`əmər
በጎንደር	bˈəɡonɨdər
አልፎ	ʔˈalɨfo
በዝርዝር	bˈəzɨrɨzɨr
የአንደኛ	jˈəʔanɨdəɲa
የወጡ	jˈəwət`u
ለየት	lˈəjət
በስም	bˈəsɨm
እየተባለ	ʔˈɨjətəβalə
እንቆቅልሽ	ʔˈɨnɨk`ok`ɨlɨʃ
በር	bˈər
በመሆናቸው	bˈəməhonat͡ʃəw
ካላቸው	kˈalat͡ʃəw
መሳሪያዎች	mˈəsarijawot͡ʃ
ካህን	kˈahɨn
የድምጽ	jˈədɨmɨts
ባርያ	bˈarɨja
ስምዎ	sˈɨmɨwo
በማንኛውም	bˈəmanɨɲawɨm
ንጉሡ	nˈɨɡusu
ቦታው	bˈotaw
ሥላሴ	sˈɨlase
በሂሳብ	bˈəhisab
መገለጫዎ	mˈəɡələt͡ʃ`awo
ምርጥ	mˈɨrɨt`
በመሄድ	bˈəməhed
ኣልቦ	ʔˈalɨβo
ጥያቄ	t`ˈɨjak`e
ማለት	mˈalət
አድርጋ	ʔˈadɨrɨɡa
ውይይት	wˈɨjɨjɨt
