bestridan	bestriːdɑn
andfang	ɑndfɑnɡ
heorte	xe͜orte
circuladl	kirkulɑːdl
spiwan	spiːwɑn
belifan	beliːfɑn
æthabban	ætxɑbbɑn
ticcen	titt͡ʃen
gegangan	jeɡɑnɡɑn
deorc	de͜ork
leohtlice	le͜oːxtliːt͡ʃe
æf	æf
blodwite	bloːdwiːte
forbugennys	forbuːɡennys
longe	lonɡe
feorr	fe͜orr
underwritan	underwriːtɑn
ymblicgan	ymblijjɑn
toberstan	toːberstɑn
þrysman	θrysmɑn
tæce	tæːt͡ʃe
spornan	spornɑn
hamfæreld	xɑːmfæreld
wuldordream	wuldordræ͜ɑːm
georn	je͜orn
eastream	æ͜ɑːstræ͜ɑːm
gesceadlic	jeʃɑdliːt͡ʃ
adælan	ɑːdæːlɑn
geþingian	ɡeθinɡiɑn
bæddon	bæːddon
firensynnig	firensynnij
hyldo	xyldo
pinungtol	piːnunɡtoːl
getregian	jetreɡiɑn
stedefæst	stedefæst
neo	ne͜oː
oferfeallan	oferfæ͜ɑllɑn
byre	byre
roþor	roːθor
andgit	ɑndjit
hreran	xreːrɑn
beowyrt	be͜oːwyrt
beodclaþ	be͜oːdklɑːθ
deman	deːmɑn
gewyrcan	jewyrt͡ʃɑn
wice	wike
þurhwlitan	θurxwliːtɑn
winter	winter
hloþian	xloːθiɑn
godhad	ɡodxɑːd
dwolmann	dwolmɑnn
synleas	synlæ͜ɑːs
we	weː
has	xɑːs
horu	xoru
stregdan	strejdɑn
teorian	te͜oːriɑn
reþe	reːθe
feogean	fe͜oːjɑn
westseaxe	westsæ͜ɑkse
tucian	tuːkiɑn
ungyrdan	unɡyrdɑn
wlætian	wlæːtiɑn
morþbealo	morθbæ͜ɑlo
hlowan	xloːwɑn
scolere	skoːlere
siþian	siːθiɑn
bærne	bærne
tom	toːm
syngian	synɣiɑn
forliden	forliden
eaþmodlic	æ͜ɑːθmoːdliːt͡ʃ
gecneordlæcan	jekne͜ordlæːt͡ʃɑn
styccemælum	stytt͡ʃemæːlum
ingefeallan	injefæ͜ɑllɑn
gripe	ɡripe
neodful	ne͜oːdful
selden	selden
gomen	ɡomen
bod	bod
toweorpan	toːwe͜orpɑn
stræl	stræːl
creopan	kre͜oːpɑn
sawelsceatt	sɑːwelʃæ͜ɑtt
ruhha	ruxxɑ
ceowaþ	t͡ʃe͜oːwɑθ
bletsung	bleːtsunɡ
petersilige	petersilije
feorweg	fe͜orwej
swogan	swoːɡɑn
beor	be͜oːr
feorhweard	fe͜orxwæ͜ɑrd
erschenn	erʃxenn
niwung	niːwunɡ
wyrgan	wyrjɑn
mænigo	mænijo
bædling	bædlinɡ
gerædan	jeræːdɑn
gedwolcræft	jedwolkræft
hyrstan	xyrstɑn
firenfull	firenfull
yþian	yːθiɑn
stig	stiːj
graf	ɡrɑːf
carig	kɑrij
horsc	xorʃ
geslean	jeslæ͜ɑːn
neahbuend	næ͜ɑːxbuːend
cearseld	kæ͜ɑrseld
frægning	fræjninɡ
earclænsend	æ͜ɑːrklæːnsend
giestliþe	ji͜ystliːθe
scoldon	ʃoldon
fullfyllan	fullfyllɑn
anwig	ɑːnwiːj
eaþmedan	æ͜ɑːθmeːdɑn
græs	ɡræs
nyten	nyːten
inciegan	int͡ʃi͜yːjɑn
betweox	betwe͜oːks
gecocsian	jekoːksiɑn
wroht	wroːxt
geþycfyldan	jeθykfyldɑn
tahtest	tɑːxtest
cweþaþ	kweθɑθ
acnyssan	ɑːknyssɑn
sunnanmorgen	sunnɑnmorɡen
neodlaþu	ne͜oːdlɑθu
cyrtel	kyrtel
bræþ	bræːθ
sceonca	ʃonkɑ
gecor	jekor
gastgedal	ɡɑːstjedɑːl
ened	ened
hwæþre	xwæθre
betweonan	betwe͜oːnɑn
wifmenn	wiːfmenn
minum	miːnum
staþoliend	stɑθoliend
eþelþrym	eːθelθrym
firenhycge	firenxyjje
nu	nuː
bridd	bridd
bec	beːt͡ʃ
underburg	underburɡ
underniman	undernimɑn
þegnian	θejniɑn
ealdmoder	æ͜ɑldmoːder
burg	burɡ
ælfhelm	ælfxelm
anfealdnes	ɑːnfæ͜ɑldnes
togeotan	toːje͜oːtɑn
fetian	fetiɑn
gecyndelic	jekyndeliːt͡ʃ
gor	ɡor
mære	mæːre
plegian	pleɡiɑn
utan	uːtɑn
ægres	æːjres
gestigan	jestiːɡɑn
blæced	blæːt͡ʃed
eþelleas	eːθellæ͜ɑːs
wintertid	wintertiːd
ænlæcan	æːnlæːt͡ʃɑn
bleoread	ble͜oːræ͜ɑːd
broga	broːɡɑ
wiodu	wi͜udu
frysa	frysɑ
en	ən
gemærsian	jemæːrsiɑn
larwita	lɑːrwitɑ
twiferlæcan	twifeːrlæːt͡ʃɑn
habban	xɑbbɑn
sunsunu	sunsunu
bisceop	biske͜op
lician	liːkiɑn
syþþan	syθθɑn
ac	ɑːk
spirian	spirjɑn
seaw	sæ͜ɑːw
ne	ne
wedertacen	wedertɑːken
mealmiht	mæ͜ɑlmixt
nære	næːre
þanecan	θɑneːkɑn
unwittig	unwittij
þrote	θrote
efenmetan	efenmetɑn
ecnes	eːknes
swuster	swuster
geliffæstan	jeliːffæstɑn
godwrecnes	ɡodwreknes
crecas	kreːkɑs
racenteag	rɑkentæ͜ɑːɡ
forgieman	forji͜yːmɑn
biwrecan	biwrekɑn
palent	pɑlent
maþelian	mɑθeliɑn
wuducoc	wudukok
lybesn	lybesn
geliesan	jeli͜yːsɑn
neom	ne͜om
ege	eje
unriht	unrixt
cederbeam	kederbæ͜ɑːm
feaw	fæ͜ɑːw
gewæpnian	jewæːpniɑn
hream	xræ͜ɑːm
onbutan	onbuːtɑn
wuldrung	wuldrunɡ
wætergelæt	wæterjelæːt
geeaþmedan	jeæ͜ɑːθmeːdɑn
anforlætan	ɑːnforlæːtɑn
forþgesceaft	forθjeʃæ͜ɑft
witena	witenɑ
mægþ	mæːɡθ
flod	floːd
belltacen	belltɑːken
deoplic	de͜oːpliːt͡ʃ
ofhabban	ofxɑbbɑn
hearma	xæ͜ɑrmɑ
feolo	fe͜olo
ansien	ɑnsi͜yːn
tomearcodnes	toːmæ͜ɑrkodnes
riman	riːmɑn
ymbceorfan	ymbt͡ʃe͜orfɑn
behon	bexoːn
wittig	wittij
leoþwyrhta	le͜oːθwyrxtɑ
bodan	bodɑn
beorma	be͜ormɑ
cyrran	t͡ʃyrrɑn
eorþhus	e͜orθxuːs
husc	xuʃ
gecanc	jekɑnk
ingang	inɡɑnɡ
burh	burx
tohopa	toːxopɑ
drencan	drent͡ʃɑn
mærsung	mæːrsunɡ
lox	loks
sceomfull	ʃe͜omfull
miere	mi͜yːre
clacu	klɑku
upbregdan	upbrejdɑn
gæten	ɡæːten
underþeodan	underθe͜oːdɑn
reordberend	re͜ordberend
fær	fæːr
calan	kɑlɑn
hleapan	xlæ͜ɑːpɑn
motung	moːtunɡ
sellan	sellɑn
read	ræ͜ɑːd
arcebiscoprice	ɑrt͡ʃebiʃʃopriːt͡ʃe
brec	breːt͡ʃ
unmennisclic	unmenniʃliːt͡ʃ
hired	xiːred
sciell	ʃell
wyrttun	wyrttuːn
ploh	ploːx
sceadan	ʃɑːdɑn
dwelian	dweliɑn
widmære	wiːdmæːre
ancleow	ɑnkle͜oːw
cranic	krɑnik
sunwliteg	sunwlitej
fleaxen	flæ͜ɑksen
til	til
siþþan	siθθɑn
strewian	streːwiɑn
ærendgewrit	æːrendjewrit
hildebord	xildebord
flet	flet
forgan	forɡɑːn
wiernan	wi͜yrnɑn
abecede	ɑːbeːkeːdeː
gierstandæg	ji͜yrstɑndæj
landbuend	lɑndbuːend
bearg	bæ͜ɑrɡ
geweald	jewæ͜ɑld
loca	lokɑ
sœcan	søːt͡ʃɑn
tænel	tæːnel
þurhsmeagan	θurxsmæ͜ɑːjɑn
ham	xɑːm
framcierran	frɑmt͡ʃi͜yrrɑn
nese	nese
freondlar	fre͜oːndlɑːr
secge	sejje
wealcol	wæ͜ɑlkol
besettan	besettɑn
fotadlig	foːtɑːdlij
gehælan	jexæːlɑn
ile	ile
fot	foːt
geagnian	jeɑːɡniɑn
rose	roːse
adrincan	ɑːdrinkɑn
fleam	flæ͜ɑːm
ascuniendlic	ɑːʃuːni͜yndliːt͡ʃ
frigedæg	friːjedæj
flaxe	flɑkse
ungewunelic	unjewuneliːt͡ʃ
scip	ʃip
gieman	ji͜yːmɑn
nabban	nɑbbɑn
stillan	stillɑn
foldbuend	foldbuːend
beladung	belɑːdunɡ
mangere	mɑnɡere
geþoftræden	jeθoftræːden
tocweþan	toːkweθɑn
ymbsnidennes	ymbsnidennes
feohtlac	fe͜oxtlɑːk
þrifeald	θrifæ͜ɑld
þæctigele	θæktijele
tellan	tellɑn
ilca	ilkɑ
gnornian	ɡnorniɑn
heofan	xe͜oːfɑn
generstede	jenerstede
hellrun	xellruːn
tan	tɑːn
langtwidig	lɑnɡtwiːdij
wæpnwifestre	wæːpnwiːfestre
swindan	swindɑn
yst	yːst
mislar	mislɑːr
geþrang	jeθrɑnɡ
sceolde	ʃolde
byrgan	byrjɑn
swellan	swellɑn
hasu	xɑsu
ætsamne	ætsɑmne
eades	æːɑ̯des
togesceadan	toːjeʃæ͜ɑːdɑn
reon	re͜oːn
foresceawian	foreʃæ͜ɑːwiɑn
forst	forst
gedigan	jediːjɑn
æcerceorl	ækert͡ʃe͜orl
wudian	wudiɑn
stod	stoːd
bewendan	bewendɑn
midniht	midnixt
ceaster	t͡ʃæ͜ɑster
genihtful	jenixtful
unsælig	unsæːlij
biþ	biθ
þeccean	θett͡ʃɑn
steort	ste͜ort
forþfaran	forθfɑrɑn
twæman	twæːmɑn
stepe	stepe
eastengle	æ͜ɑːstenɡle
mearc	mæ͜ɑrk
þeowian	θe͜oːwiɑn
ungelicnes	unjeliːknes
rædels	ræːdels
deagol	dæ͜ɑːɡol
bemurnan	bemurnɑn
bliþe	bliːθe
eoh	e͜oːx
morgen	morɡen
feht	fext
beæwnian	beæːwniɑn
seaxneating	sæ͜ɑksnæ͜ɑːtinɡ
smæccan	smætt͡ʃɑn
hramsa	xrɑmsɑ
wifgemana	wiːfjemɑːnɑ
ceasterleod	t͡ʃæ͜ɑsterle͜oːd
gewemmednes	jewemmednes
sorhleas	sorxlæ͜ɑːs
hors	xors
ætstandend	ætstɑndend
niþ	niːθ
wylfen	wylfen
weðer	weθer
seofonteoþa	se͜ofonte͜oːθɑ
ciricgeorn	t͡ʃirit͡ʃje͜orn
magon	mɑɣon
ælfsogoþa	ælfsoɡoθɑ
leoþcræft	le͜oːθkræft
sigan	siːɡɑn
plihtan	plixtɑn
bemænan	bemæːnɑn
crabba	krɑbbɑ
swat	swɑːt
neodian	ne͜oːdiɑn
þywan	θyːwɑn
geondlihtan	je͜ondliːxtɑn
cnucel	knukel
hrycgban	xryjjbɑːn
fuglere	fuɡlere
geliger	jelijer
þegnung	θejnunɡ
hwylc	xwylt͡ʃ
liegbære	li͜yːjbæːre
wuldrig	wuldrij
dæges	dæjes
gesittan	jesittɑn
ormæte	ormæːte
guþfruma	ɡuːθfrumɑ
siolufr	si͜ulufr
wæstmlic	wæstmliːt͡ʃ
beladian	belɑːdiɑn
uneaþe	unæ͜ɑːθe
ofsceadan	ofʃɑːdɑn
gestillan	jestillɑn
aniege	ɑːni͜yːje
wrecscipe	wrekʃipe
ætspringan	ætsprinɡɑn
botm	botm
byrne	byrne
rocettan	rot͡ʃettɑn
fisc	fiʃ
hringan	xrinjɑn
wynsum	wynsum
exanceaster	eksɑnt͡ʃæ͜ɑster
bur	buːr
fruma	frumɑ
tannere	tɑnnere
forþgeriman	forθjeriːmɑn
dwealde	dwæ͜ɑlde
greot	ɡre͜oːt
ciricsceatt	t͡ʃirit͡ʃʃæ͜ɑtt
freondlic	fre͜oːndliːt͡ʃ
broþorræden	broːθorræːden
werg	werɡ
earfoþnes	æ͜ɑrfoθnes
nytlic	nytliːt͡ʃ
miþan	miːθɑn
wull	wull
hæling	xæːlinɡ
slifan	sliːfɑn
geondgangan	je͜ondɡɑnɡɑn
tælmearc	tælmæ͜ɑrk
togecorennes	toːjekorennes
batian	bɑtiɑn
troh	trox
ufan	ufɑn
glær	ɡlæːr
andweard	ɑndwæ͜ɑrd
fuht	fuːxt
deorf	de͜orf
su	suː
wimpel	wimpel
wuldorsped	wuldorspeːd
eaþmodnes	æ͜ɑːθmoːdnes
sceaþ	ʃæ͜ɑːθ
meldian	meldiɑn
faran	fɑrɑn
onwegfæreld	onwejfæreld
wæstmbære	wæstmbæːre
dype	dyːpe
wamb	wɑmb
dreamleas	dræ͜ɑːmlæ͜ɑːs
geherian	jexerjɑn
becreopan	bekre͜oːpɑn
wuldormaga	wuldormɑːɡɑ
meolc	me͜olk
soncræft	soːnkræft
heall	xæ͜ɑll
scipe	ʃipe
wuldorlean	wuldorlæ͜ɑːn
solor	solor
feormian	fe͜ormiɑn
stigel	stijel
gespannan	jespɑnnɑn
leoda	le͜oːd
upcuman	upkumɑn
geardagum	jæ͜ɑːrdɑɡum
brucing	bruːkinɡ
æfweard	æfwæ͜ɑrd
soce	soːke
gægn	jæjn
norþman	norθmɑn
reafere	ræ͜ɑːfere
toþ	toːθ
streawberige	stræ͜ɑːwberije
durran	durrɑn
missprecan	missprekɑn
leafnesword	læ͜ɑːfnesword
cnawelæcing	knɑːwelæːt͡ʃinɡ
gifeþe	jifeθe
cymlic	kyːmliːt͡ʃ
ræscettung	ræʃettunɡ
eastre	æ͜ɑːstre
stælan	stæːlɑn
fela	felɑ
pæþes	pæθes
orlæg	orlæj
læring	læːrinɡ
þunresdæg	θunresdæj
misfoþ	misfoːθ
fædera	fæderɑ
æfgrynde	æfɡrynde
folm	folm
wocon	woːkon
miscennung	miskennunɡ
leht	leːxt
foran	forɑn
neawist	næ͜ɑːwist
wunne	wunne
fromcyrran	fromt͡ʃyrrɑn
petrus	petrus
regnboga	rejnboɡɑ
westan	weːstɑn
stæfn	stæfn
utfus	uːtfuːs
beowulf	be͜oːwulf
swigian	swiːɡiɑn
heahfore	xæ͜ɑxfore
boþen	boθen
brægen	bræjen
mago	mɑɡo
utgefeoht	uːtjefe͜oxt
gimstan	jimstɑːn
æfnian	æːfniɑn
wiþfaran	wiθfɑrɑn
gelibban	jelibbɑn
seaxe	sæ͜ɑkse
wohdæd	woːxdæːd
slæwþ	slæːwθ
manigfeald	mɑnijfæ͜ɑld
ham	xɑm
toworpennes	toːworpennes
ongemang	onjemɑnɡ
lobbe	lobbe
ontynan	ontyːnɑn
gestaþoliend	jestɑθoliend
endeleasnes	endelæ͜ɑːsnes
þeoh	θe͜oːx
ieldan	i͜yldɑn
mænan	mæːnɑn
metere	meːtere
twa	twɑː
hringsetl	xrinɡsetl
springan	sprinɡɑn
enig	eːnij
æþelbeorht	æθelbe͜orxt
dæd	dæːd
agangan	ɑːɡɑnɡɑn
twyfealdnys	twyfæ͜ɑldnys
þicgan	θijjɑn
wealhhnutu	wæ͜ɑlxxnutu
wegan	weɡɑn
gleawlice	ɡlæ͜ɑːwliːt͡ʃe
adl	ɑːdl
gecyndlim	jekyndlim
declinian	dekliːniɑn
lenden	lenden
cneordlæcan	kne͜ordlæːt͡ʃɑn
hæþ	xæːθ
sæd	sæd
undergangan	underɡɑnɡɑn
domern	doːmern
gelimplic	jelimpliːt͡ʃ
blican	bliːkɑn
fulnes	fuːlnes
hnutu	xnutu
hrinan	xriːnɑn
feower	fe͜oːwer
sealde	sæɑlde
forgengel	forɡenjel
gehlow	jexloːw
dynnan	dynnɑn
eorþern	e͜orθern
stanweorc	stɑːnwe͜ork
swica	swikɑ
reordian	re͜ordiɑn
lytel	lyːtel
wlite	wlite
scyrte	ʃyrte
plegol	pleɡol
talu	tɑlu
bædan	bædɑn
scoh	ʃoːx
sacum	sɑkum
ma	mɑː
niþernes	niθernes
gæmnian	ɡæmniɑn
oferflitan	oferfliːtɑn
col	kol
wingeard	wiːnjæ͜ɑrd
cnawan	knɑːwɑn
sawlian	sɑːwliɑn
boctreow	boːktre͜oːw
fieldstol	fi͜yldstoːl
liegfamblawende	li͜yːjfɑːmblɑːwende
æ	æː
pliht	plixt
twyfeald	twyfæ͜ɑld
cyninge	kyninɡe
undern	undern
sittan	sittɑn
reodmuþa	re͜oːdmuːθɑ
snaca	snɑkɑ
adreogan	ɑːdre͜oːɡɑn
yþung	yːθunɡ
twegen	tweːjen
seofonstierre	se͜ofonsti͜yrre
gewis	jewis
alædan	ɑːlæːdɑn
geara	jɑːrɑ
gehatland	jexɑːtlɑnd
sunlic	sunliːt͡ʃ
æfnan	æfnɑn
heortgryre	xe͜ortɡryre
geonre	je͜onre
æghwær	æːjxwæːr
carwielm	kɑrwi͜ylm
temian	temiɑn
min	miːn
ealc	æ͜ɑlt͡ʃ
ætwindan	ætwindɑn
þenden	θenden
ægenbald	æːjenbɑld
gegrundweallian	jeɡrundwæ͜ɑlliɑn
blæc	blæk
cwidboc	kwidboːk
fægernes	fæjernes
toeacan	toːæ͜ɑːkɑn
sweoras	swe͜oːrɑs
sundwudu	sundwudu
forslean	forslæ͜ɑːn
gehiewian	jexi͜yːwiɑn
drefing	dreːfinɡ
ymbstandennes	ymbstɑndennes
bucc	bukk
eac	æ͜ɑːk
legerstow	lejerstoːw
wierdan	wi͜yrdɑn
gesamnung	jesɑmnunɡ
gedritan	jedriːtɑn
gediegan	jedi͜yːjɑn
þæt	θæt
clæna	klæːnɑ
ymbseon	ymbse͜oːn
ielfetu	i͜ylfetu
gærshoppa	ɡærsxoppɑ
engellic	enjelliːt͡ʃ
ar	ɑːr
ortreowe	ortre͜oːwe
allic	ɑlliːt͡ʃ
gymend	jyːmend
hengst	xenɡst
husræden	xuːsræːden
rædingboc	ræːdinɡboːk
gewæstmbærian	jewæstmbæːriɑn
sceamol	ʃɑmol
grapian	ɡrɑːpiɑn
wineard	wiːnæ͜ɑrd
ða	θɑː
lunden	lunden
wordfæst	wordfæst
cempa	kempɑ
racentan	rɑkentɑn
bebycgan	bebyjjɑn
beald	bæ͜ɑld
framfæreld	frɑmfæreld
weorþian	we͜orθiɑn
unclæne	unklæːne
byme	byːme
leodhryre	le͜oːdxryre
cniht	knixt
sodomitisc	sodomitiʃ
gecierrednes	jet͡ʃi͜yrrednes
mist	mist
æmethwil	æːmetxwiːl
efete	efete
geond	je͜ond
þerh	θerx
gean	jæ͜ɑːn
þes	θeːs
lifer	lifer
morþ	morθ
fremedlæcan	fremedlæːt͡ʃɑn
eahta	æ͜ɑxtɑ
bot	boːt
idæges	iːdæjes
forhabban	forxɑbbɑn
þæs	θæs
landleod	lɑndle͜oːd
beorn	be͜orn
awlencan	ɑːwlent͡ʃɑn
weargcweþan	wæ͜ɑrɡkweθɑn
hror	xroːr
oferhealdan	oferxæ͜ɑldɑn
æsctir	æʃtiːr
no	noː
þurhbrengan	θurxbrenjɑn
wiceard	wiːt͡ʃæ͜ɑrd
wohfremmende	woːxfremmende
gesceadan	jeʃæ͜ɑːdɑn
wiþhycgan	wiθxyjjɑn
cyst	kyst
nægl	næjl
reowon	re͜oːwon
forclingan	forklinɡɑn
gieldan	ji͜yldɑn
cwealm	kwæ͜ɑlm
anlætan	ɑːnlæːtɑn
þurhsceotan	θurxʃe͜oːtɑn
mynet	mynet
cnotta	knottɑ
ciele	t͡ʃi͜yle
unweorþlic	unwe͜orθliːt͡ʃ
myrige	myrije
wide	wiːde
forþgangan	forθɡɑnɡɑn
edniwan	edniːwɑn
wesan	weːsɑn
gewitan	jewiːtɑn
mægþhad	mæjθxɑːd
holt	xolt
behatland	bexɑːtlɑnd
gied	ji͜yd
geondscriþan	je͜ondʃriːθɑn
flegan	fleːɡɑn
lignan	liːjnɑn
sidfæþmed	siːdfæθmed
hatheort	xɑːtxe͜ort
gemætan	jemæːtɑn
guþgewæde	ɡuːθjewæːde
cruma	krumɑ
hnuta	xnutɑ
bæl	bæːl
husl	xuːsl
gang	ɡɑnɡ
hæþen	xæːθen
ealneg	æ͜ɑlnej
wohfull	woːxfull
legen	lejen
sæl	sæːl
yld	yld
steorwiglere	ste͜orwijlere
hete	xete
neorxnawang	ne͜orksnɑwɑnɡ
nihtbealo	nixtbæ͜ɑlo
gifu	jifu
asittan	ɑːsittɑn
lago	lɑɡo
eosol	e͜osol
elþeodig	elθe͜oːdij
fletgefeoht	fletjefe͜oxt
læcedom	læːt͡ʃedoːm
yfemest	yfemest
untiegan	unti͜yːjɑn
strudan	struːdɑn
wearp	wæ͜ɑrp
incit	iŋkit
fet	feːt
iude	iude
styrung	styrunɡ
tæppe	tæppe
nest	nest
forwundian	forwundiɑn
starian	stɑriɑn
drefan	dreːfɑn
scytta	ʃyttɑ
marmstan	mɑrmstɑːn
hægtesse	xæɡtesse
firas	fiːrɑs
felan	feːlɑn
handseax	xɑndsæ͜ɑks
weardian	wæ͜ɑrdiɑn
ofgifan	ofjifɑn
sulh	sulx
cliewen	kli͜yːwen
þoden	θoden
forþsprecan	forθsprekɑn
pynca	pynkɑ
geblandan	jeblɑndɑn
swiþferhþ	swiːθferxθ
ofertogennes	ofertoɡennes
cyrf	kyrf
ealgian	æ͜ɑlɡiɑn
eahtatiene	æ͜ɑxtɑti͜yːne
werlic	werliːt͡ʃ
andgiettacen	ɑndji͜yttɑːken
manigfealdian	mɑnijfæ͜ɑldiɑn
toh	toːx
blæse	blæse
mynegian	myneɡiɑn
þyrelian	θyːreliɑn
fyr	fyr
becom	bekom
afigen	ɑːfijen
forcyrran	fort͡ʃyrrɑn
wiste	wiste
dafen	dɑfen
wiþerian	wiθeriɑn
wolberendlic	woːlberendliːt͡ʃ
hundfeald	xundfæ͜ɑld
læcehus	læːt͡ʃexuːs
ciricweg	t͡ʃirit͡ʃwej
ymbhycgan	ymbxyjjɑn
hobbe	xobbe
beacnung	bæ͜ɑːknunɡ
hreaðemus	xræ͜ɑːθemuːs
bæcestre	bækestre
yldan	yldɑn
ilfete	ilfete
modcræft	moːdkræft
gi	jiː
roþhund	roθxund
bloma	bloːmɑ
crocca	krokkɑ
underiendlic	underjendliːt͡ʃ
cuman	kumɑn
westen	weːsten
adrencan	ɑːdrent͡ʃɑn
siocol	si͜ukol
lætan	læːtɑn
wicing	wiːt͡ʃinɡ
gegyrwan	jejyrwɑn
gemana	jemɑːnɑ
wipian	wiːpiɑn
frignan	frijnɑn
drihtenlic	drixtenliːt͡ʃ
þroht	θroxt
fehtan	fextɑn
toliesan	toːli͜yːsɑn
sind	sind
ganot	ɡɑnot
awemman	ɑːwemmɑn
sumer	sumer
hengen	xenɡen
hrutan	xruːtɑn
asawan	ɑːsɑːwɑn
ford	ford
burhleoda	burxle͜oːdɑ
diofol	di͜uːfol
næs	næs
lar	lɑːr
slincan	slinkɑn
mægn	mæjn
læppa	læppɑ
ælfcynn	ælfkynn
freoh	fre͜oːx
ærendgast	æːrendɡɑːst
ceder	keder
bearneacen	bæ͜ɑrnæ͜ɑːken
bucc	buːkk
storm	storm
wiber	wiber
bicweþan	bikweθɑn
godcundnes	ɡodkundnes
adesa	ɑdesɑ
nigontiene	niɡonti͜yːne
wase	wɑːse
ahon	ɑːxoːn
spedan	speːdɑn
onsittan	onsittɑn
scencan	ʃent͡ʃɑn
folgian	folɡiɑn
adeadian	ɑːdæ͜ɑːdiɑn
hwæne	xwæne
salnes	sɑːlnes
sweltaþ	sweltɑθ
sumerhæte	sumerxæːte
wiþgripan	wiθɡriːpɑn
ripe	riːpe
heafodwind	xæ͜ɑːfodwind
wandian	wɑndiɑn
forewittig	forewittij
hond	xond
besceadan	beʃæ͜ɑːdɑn
of	of
besceadan	beʃɑːdɑn
slupan	sluːpɑn
betynan	betyːnɑn
utlenda	uːtlendɑ
þeowen	θe͜owen
bead	bæːɑ̯d
wyrtweard	wyrtwæ͜ɑrd
swæs	swæːs
drogen	droɡen
grut	ɡruːt
more	moːre
ofer	oːfer
andtimber	ɑndtimber
incund	inkund
geondspringan	je͜ondsprinɡɑn
atorbære	ɑːtorbæːre
wære	wæːre
foremearcung	foremæ͜ɑrkunɡ
scread	ʃræ͜ɑːd
eoforlic	e͜oforliːt͡ʃ
hnigan	xniːɡɑn
meox	me͜oks
paþum	pɑθum
swifan	swiːfɑn
oþstandan	oθstɑndɑn
ateon	ɑːte͜oːn
sandceosol	sɑndt͡ʃe͜osol
healsfang	xæ͜ɑlsfɑnɡ
scearseax	ʃæ͜ɑrsæ͜ɑks
ærest	æːrest
hriþerhyrde	xriːθerxyrde
readnes	ræ͜ɑːdnes
cweorn	kwe͜orn
foresecgan	foresejjɑn
reotan	re͜oːtɑn
flowan	floːwɑn
liegberende	li͜yːjberende
wæt	wæːt
gesmeah	jesmæ͜ɑːx
munec	munek
wiþsprecan	wiθsprekɑn
ræpling	ræːplinɡ
oferyþ	oferyːθ
eahtateoþa	æ͜ɑxtɑte͜oːθɑ
sweore	swe͜oːre
gæd	ɡæd
wudubora	wuduborɑ
foresetnes	foresetnes
ciricgriþ	t͡ʃirit͡ʃɡriθ
canc	kɑnk
cwene	kwene
yþlid	yːθlid
fostor	foːstor
wrenc	wrent͡ʃ
fulfremednes	fulfremednes
wihtware	wixtwɑre
þweran	θwerɑn
upfæreld	upfæreld
healsbeag	xæ͜ɑlsbæ͜ɑːɡ
forseoþan	forse͜oːθɑn
hordern	xordern
halgian	xɑːlɡiɑn
fylgan	fyljɑn
blæge	blæːje
þrop	θrop
swican	swiːkɑn
blæst	blæːst
wæccan	wætt͡ʃɑn
gecyrrednes	jet͡ʃyrrednes
pintel	pintel
scafan	ʃɑfɑn
orþonc	orθonk
anwadan	ɑnwɑdɑn
micelnes	mit͡ʃelnes
ahebban	ɑːxebbɑn
gewunelice	jewuneliːt͡ʃe
sur	suːr
dwimor	dwimor
samodeard	sɑmodæ͜ɑrd
lofian	lofiɑn
hwyrft	xwyrft
wite	wiːte
ciricbryce	t͡ʃirit͡ʃbryt͡ʃe
deorcnes	de͜orknes
sigelhweorfa	sijelxwe͜orfɑ
larcræft	lɑːrkræft
botleas	boːtlæ͜ɑːs
folcland	folklɑnd
weax	wæ͜ɑks
eanred	æ͜ɑːnred
gewunelic	jewuneliːt͡ʃ
þeaht	θæ͜ɑxt
modor	moːdor
oferspræce	oferspræːt͡ʃe
scildan	ʃildɑn
sæward	sæːwɑrd
forgyrdan	forɡyrdɑn
wræþþo	wræːθθo
met	met
formeltan	formeltɑn
þeof	θe͜oːf
þolemod	θolemoːd
dagian	dɑɡiɑn
camp	kɑmp
feh	fex
hwone	xwone
þeodenleas	θe͜oːdenlæ͜ɑːs
wieldan	wi͜yldɑn
findan	findɑn
forleosan	forle͜oːsɑn
nose	nose
gefera	jefeːrɑ
biorn	bi͜urn
sodome	sodome
egesa	ejesɑ
hlaw	xlɑːw
onfindan	onfindɑn
fægen	fæjen
læwede	læːwede
godspellisc	ɡoːdspelliʃ
wyrcan	wyrt͡ʃɑn
ymbgan	ymbɡɑːn
wuldorbeagian	wuldorbæ͜ɑːɡiɑn
tendan	tendɑn
ciefes	t͡ʃi͜yfes
wiht	wixt
wera	werɑ
gehiersum	jexi͜yːrsum
leah	læ͜ɑːx
lengþu	lenɡθu
regn	rejn
yþig	yːθij
onwreon	onwre͜oːn
bacan	bɑkɑn
owiht	oːwixt
hryscan	xryːʃʃɑn
liegspiwol	li͜yːjspiːwol
fola	folɑ
misfehþ	misfeːxθ
wolcn	wolkn
begretan	beɡreːtɑn
þyrscweald	θyrʃwæ͜ɑld
gewendan	jewendɑn
cwellan	kwellɑn
muþ	muːθ
lærestre	læːrestre
tungol	tunɡol
bebodræden	bebodræːden
misspowan	misspoːwɑn
gemyndfull	jemyndfull
hwettan	xwettɑn
tyhting	tyxtinɡ
minsian	minsiɑn
færeld	færeld
wiþinnan	wiθinnɑn
tun	tuːn
cenep	kenep
gecynde	jekynde
beweardian	bewæ͜ɑrdiɑn
wuduræden	wuduræːden
duce	duke
stoc	stok
ofþefian	ofθefiɑn
sinewealtnes	sinewæ͜ɑltnes
tyht	tyxt
efes	efes
tosyndrian	toːsyndriɑn
unefen	unefen
toweorpendlic	toːwe͜orpendliːt͡ʃ
beon	be͜oːn
not	not
galfull	ɡɑːlfull
nied	ni͜yːd
geligere	jelijere
bædeþ	bæːdeθ
scadan	ʃɑːdɑn
sniwde	sniːwde
goldwine	ɡoldwine
spitu	spitu
bæcere	bækere
sencgan	senjɑn
ispanisc	ispɑːniʃ
leode	le͜oːde
oferswyþan	oferswyːθɑn
firentacnian	firentɑːkniɑn
gewitt	jewitt
ælagol	æːlɑɡol
heortleas	xe͜ortlæ͜ɑːs
neahstow	næ͜ɑːxstoːw
sceaþian	ʃɑθiɑn
gislian	jiːsliɑn
yfelsung	yfelsunɡ
sæpig	sæpij
mundbyrd	mundbyrd
forgifnes	forjifnes
neotan	ne͜oːtɑn
bana	bɑnɑ
gold	ɡold
horig	xorij
ealdorman	æ͜ɑldormɑn
heafod	xæ͜ɑːfod
grimhelm	ɡriːmxelm
streng	strenɡ
þanc	θɑnk
treowwyrhta	tre͜oːwwyrxtɑ
salu	sɑlu
behropan	bexroːpɑn
ea	æ͜ɑː
heow	xe͜oːw
ciricþingere	t͡ʃirit͡ʃθinɡere
cyng	kynɡ
cyningrice	kyninɡriːt͡ʃe
gewinn	jewinn
goldsmiþ	ɡoldsmiθ
bledan	bleːdɑn
cleofan	kle͜oːfɑn
hol	xoːl
fiersn	fi͜yrsn
webb	webb
untrumian	untrumiɑn
ingeld	inɡeld
edlæcan	edlæːt͡ʃɑn
hærn	xærn
strengþu	strenɡθu
ripþ	riːpθ
fremeþe	fremeθe
nigonteoþa	niɡonte͜oːθɑ
ægenwulf	æːjenwulf
eþeldream	eːθeldræ͜ɑːm
gelotendæg	jelotendæj
ciricnytt	t͡ʃirit͡ʃnytt
gelecgan	jelejjɑn
gif	jif
hropan	xroːpɑn
liegegesa	li͜yːjejesɑ
feax	fæ͜ɑks
feowerteoþa	fe͜oːwerte͜oːθɑ
bealocwealm	bæ͜ɑlokwæ͜ɑlm
winestra	winestrɑ
wolbærnes	woːlbæːrnes
scrince	ʃrinke
andettan	ɑndettɑn
frymþ	frymθ
heremann	xeremɑnn
swiþra	swiːθrɑ
þæsma	θæːsmɑ
belimpan	belimpɑn
cærsiht	kærsixt
andgiete	ɑndji͜yte
onirnan	onirnɑn
hwara	xwɑːrɑ
heo	xe͜oː
sodomisc	sodomiʃ
heterof	xeteroːf
teran	terɑn
staþolung	stɑθolunɡ
fyrenþearf	fyrenθæ͜ɑrf
crycc	krytt͡ʃ
weorþscipe	we͜orθʃipe
ængle	ænɡle
bepæcan	bepæːt͡ʃɑn
neoðan	ne͜oθɑn
atorlic	ɑːtorliːt͡ʃ
ceald	t͡ʃæ͜ɑld
fenester	fenester
gesceap	jeʃæ͜ɑp
ripaþ	riːpɑθ
wealdend	wæ͜ɑldend
sel	seːl
awiht	ɑːwixt
genesan	jenesɑn
hwamm	xwɑmm
beofor	be͜ofor
geardagas	jæ͜ɑːrdɑɡɑs
fæla	fæːlɑ
mundgripe	mundɡripe
arfæst	ɑːrfæst
haldan	xɑldɑn
wulfheort	wulfxe͜ort
gyman	jyːmɑn
sperehealf	sperexæ͜ɑlf
gymeleasian	jyːmelæ͜ɑːsiɑn
wræcca	wrætt͡ʃɑ
hræfnsweart	xræfnswæ͜ɑrt
bocere	boːkere
son	soːn
cennan	kennɑn
friesa	fri͜ysɑ
þusend	θuːsend
helruna	xelruːnɑ
sting	stinɡ
siþ	siːθ
byrla	byrlɑ
gecorenscipe	jekorenʃipe
gehiegan	jexi͜yːjɑn
gesceon	jeʃe͜oːn
leoþ	le͜oːθ
eaþbede	æ͜ɑːθbeːde
ator	ɑːtor
sliefescoh	sli͜yːfeʃoːx
dæl	dæːl
edniewian	edni͜yːwiɑn
godleas	ɡoːdlæ͜ɑːs
friþowebba	friθowebbɑ
leng	lenj
wenian	weniɑn
sidu	sidu
þ	θ
deaþbed	dæ͜ɑːθbed
geþyldig	jeθyldij
clæþ	klæːθ
smitan	smiːtɑn
clus	kluːs
cynebot	kyneboːt
cribb	kribb
wyrmread	wyrmræ͜ɑːd
gehwylc	jexwylt͡ʃ
healfcwic	xæ͜ɑlfkwik
mot	moːt
gorian	ɡoriɑn
fiþere	fiθere
da	dɑː
hleoþrian	xle͜oːθriɑn
or	oːr
cy	kyː
friþsum	friθsum
hersum	xeːrsum
gerefa	jereːfɑ
mæcefisc	mæːt͡ʃefiʃ
rocc	rokk
bræð	bræθ
staþolnes	stɑθolnes
menniscnes	menniʃnes
tægl	tæjl
wærloga	wæːrloɡɑ
helpan	xelpɑn
muð	muːθ
þisses	θises
eaþe	æ͜ɑːθe
hæmed	xæːmed
tacen	tɑːken
oþ	oθ
nytwierþe	nytwi͜yrθe
bewacian	bewɑkiɑn
hæfde	hæfde
woruld	woruld
beatan	bæ͜ɑːtɑn
mamor	mɑmor
þrea	θræ͜ɑː
nawiht	nɑːwixt
hentan	xentɑn
eaþmodlice	æ͜ɑːθmoːdliːt͡ʃe
mennisc	menniʃ
œþel	øːθel
storc	stork
þwære	θwæːre
herian	xerjɑn
efenlic	efenliːt͡ʃ
gedal	jedɑːl
culfre	kulfre
wican	wiːkɑn
yfelum	yfelum
gelica	jeliːkɑ
nowend	noːwend
æppelwin	æppelwiːn
edgild	edjild
lamb	lɑmb
rind	rind
sele	sele
pehtas	pextɑs
cywþ	t͡ʃyːwθ
cwidræden	kwidræːden
dun	duːn
giestern	ji͜ystern
gastleas	ɡɑːstlæ͜ɑːs
þridda	θriddɑ
leof	le͜oːf
gæst	ɡæːst
gangan	ɡɑnɡɑn
gewealc	jewæ͜ɑlk
weodian	we͜oːdiɑn
gamen	ɡɑmen
wrixlan	wrikslɑn
untweolice	untwe͜oːliːt͡ʃe
breawern	bræ͜ɑːwern
oferwreon	oferwre͜oːn
handworht	xɑndworxt
uprodor	uprodor
niedwracu	ni͜yːdwrɑku
tohreran	toːxreːrɑn
wrid	wriːd
beslean	beslæ͜ɑːn
hreþmonaþ	xreːθmoːnɑθ
wusc	wuːsk
modorleas	moːdorlæ͜ɑːs
sægde	sæjde
giefu	ji͜yfu
sliepan	sli͜yːpɑn
brengan	brenjɑn
ge	je
ælædend	æːlæːdend
engle	enɡle
sawelcund	sɑːwelkund
geþogen	jeθoɡen
wylf	wylf
þwean	θwæ͜ɑːn
fiþre	fiθre
nyttung	nyttunɡ
rap	rɑːp
bæþhus	bæθxuːs
sweotol	swe͜otol
offrian	offriɑn
totwæmednes	toːtwæːmednes
hwæm	xwæːm
onwegacyrrednes	onwejɑːt͡ʃyrrednes
wagian	wɑɡiɑn
ceorle	t͡ʃe͜orle
leohtfæt	le͜oːxtfæt
earfeþe	æ͜ɑrfeθe
cyþlæcan	kyːθlæːt͡ʃɑn
wol	woːl
earfoþdæde	æ͜ɑrfoθdæːde
þegn	θejn
tomearcian	toːmæ͜ɑrkiɑn
run	ruːn
oferdrincere	oferdrinkere
rimcræft	riːmkræft
heorþgeneat	xe͜orθjenæ͜ɑːt
sunne	sunne
ricedom	riːt͡ʃedoːm
breahtm	bræ͜ɑxtm
æg	æːj
worold	worold
fordragan	fordrɑɡɑn
arabisc	ɑrɑbiʃ
geofonyþ	je͜ofonyːθ
tien	ti͜yːn
awuldrian	ɑːwuldriɑn
ielfen	i͜ylfen
sinniht	sinnixt
lufiend	lufiend
menniscu	mennisku
aldorleas	ɑldorlæ͜ɑːs
þeon	θe͜oːn
dran	drɑːn
sumur	sumur
oht	oːxt
fyrhtu	fyrxtu
onteon	onte͜oːn
copor	kopor
sigetacen	sijetɑːken
begong	beɡonɡ
wordpredicung	wordpredikunɡ
ceapstow	t͡ʃæ͜ɑːpstoːw
abroþen	ɑːbroθen
hyht	xyxt
cnyssung	knyssunɡ
wuldorheap	wuldorxæ͜ɑːp
deon	de͜oːn
leorningcild	le͜orninɡt͡ʃild
geol	joːl
cnyll	knyll
sceoh	ʃe͜oːx
eacan	æ͜ɑːkɑn
smales	smɑles
sid	siːd
eam	æ͜ɑm
simle	simle
clipola	klipolɑ
brant	brɑnt
gastgifu	ɡɑːstjifu
ieþe	i͜yːθe
ademan	ɑːdeːmɑn
hamm	xɑmm
wiergnes	wi͜yrjnes
ahyrdan	ɑːxyrdɑn
swæþer	swæθer
alh	ɑlx
genift	jenift
lam	lɑːm
openlic	openliːt͡ʃ
wiþblawan	wiθblɑːwɑn
ealdor	æ͜ɑldor
dægred	dæjreːd
þurhwunian	θurxwuniɑn
weorþmynd	we͜orθmynd
nemnan	nemnɑn
cyrictun	t͡ʃirit͡ʃtuːn
rand	rɑnd
forwenan	forweːnɑn
nihstig	nixstij
mæþel	mæθel
wyrcung	wyrt͡ʃunɡ
modgehygd	moːdjexyjd
hærnflota	xærnflotɑ
pinne	pinne
aræran	ɑːræːrɑn
læsest	læːsest
læwan	læːwɑn
costnian	kostniɑn
crincgan	krinjɑn
læce	læːt͡ʃe
landscipe	lɑndʃipe
rihtan	rixtɑn
scieldburg	ʃi͜yldburɡ
wudulic	wuduliːt͡ʃ
hnutum	xnutum
healf	xæ͜ɑlf
dilgian	dilɡiɑn
deoren	de͜oːren
aheardian	ɑːxæ͜ɑrdiɑn
hlið	xliθ
gedrefend	jedreːfend
weatacen	wæ͜ɑːtɑːken
wyrms	wyrms
forstes	forstes
snotingahamscir	snotinɡɑxɑːmʃiːr
fodor	foːdor
yþbord	yːθbord
glowan	ɡloːwɑn
þri	θriː
lof	lof
eorþnafola	e͜orθnɑfolɑ
wiþweorpan	wiθwe͜orpɑn
onsundrian	onsundriɑn
forhelan	forxelɑn
biscopwyrt	biʃʃopwyrt
gimmwyrhta	jimmwyrxtɑ
oneardiend	onæ͜ɑrdiend
hrof	xroːf
aþiedan	ɑːθi͜yːdɑn
nealæcan	næ͜ɑːlæːt͡ʃɑn
cos	kos
wiðersaca	wiθersɑkɑ
beleogan	bele͜oːɡɑn
bisæc	biːsæːt͡ʃ
beforan	beforɑn
tux	tuːks
sellicre	sellikre
sumor	sumor
cwedol	kwedol
yrfe	yrfe
rune	ruːne
nearunes	næ͜ɑrunes
mesan	meːsɑn
ætren	æːtren
screon	ʃre͜oːn
calu	kɑlu
myrgþ	myrjθ
wearh	wæ͜ɑrx
haleg	xɑːlej
dudda	duddɑ
geswerian	jeswerjɑn
unfealdan	unfæ͜ɑldɑn
geseþung	jeseːθunɡ
frumcynn	frumkynn
beclyppan	beklyppɑn
blanc	blɑnk
bæchus	bækxuːs
forcippian	fort͡ʃippiɑn
sunwlitig	sunwlitij
sceaduwe	ʃæ͜ɑduwe
steoran	ste͜oːrɑn
oretmæcg	oːretmæjj
catt	kɑtt
eorðe	e͜orθe
fengel	fenɡel
uþwitian	uːθwitiɑn
wrigian	wriːjiɑn
ingeþanc	injeθɑnk
sawlung	sɑːwlunɡ
ælfen	ælfen
weddung	weddunɡ
ceaw	t͡ʃæ͜ɑːw
staþolfæstlice	stɑθolfæstliːt͡ʃe
tunge	tunɡe
mægdenhad	mæjdenxɑːd
tweowa	twe͜owɑ
landhlaford	lɑndxlɑːford
stæfgefeg	stæfjefeːj
þridde	θridde
geofon	je͜ofon
drugon	druɡon
flocmælum	flokmæːlum
fregen	frejen
earfoþþrag	æ͜ɑrfoθθrɑːɡ
segen	sejen
beah	bæ͜ɑːx
syferæte	syːferæːte
modrige	moːdrije
naca	nɑkɑ
hronfisc	xronfiʃ
nerian	nerjɑn
becnyttan	beknyttɑn
ætstandan	ætstɑndɑn
bæcbord	bækbord
leohtbære	le͜oːxtbæːre
modsefa	moːdsefɑ
gebeotian	jebe͜oːtiɑn
flitcræft	fliːtkræft
anlicnes	ɑnliːknes
gicce	jitt͡ʃe
pleoh	ple͜ox
wuldorsang	wuldorsɑnɡ
gemanigfieldan	jemɑnijfi͜yldɑn
beforancweþan	beforɑnkweθɑn
syferlice	syːferliːt͡ʃe
wæter	wæter
fromhweorfan	fromxwe͜orfɑn
swete	sweːte
scield	ʃi͜yld
hlyst	xlyst
notian	notiɑn
hæferblæte	xæferblæːte
teman	teːmɑn
behæs	bexæːs
ciricmangung	t͡ʃirit͡ʃmɑnɡunɡ
asellan	ɑːsellɑn
fæsl	fæsl
feldbeo	feldbe͜oː
ceap	t͡ʃæ͜ɑːp
sæcst	sækst
þicce	θikke
cealdnys	t͡ʃæ͜ɑldnys
aulixes	ɑulikses
gedruncnian	jedrunkniɑn
heorra	xe͜orrɑ
beþiedan	beθi͜yːdɑn
gorettan	ɡorettɑn
smeþe	smeːθe
wæterig	wæterij
ærgod	æːrɡoːd
beheafdung	bexæ͜ɑːfdunɡ
molde	molde
ceosel	t͡ʃe͜osel
hnecca	xnekkɑ
spillan	spillɑn
hengon	xeːnɡon
recede	ret͡ʃede
moþþe	moθθe
wod	woːd
gebetan	jebeːtɑn
seonu	se͜onu
brægn	bræjn
sibbegedriht	sibbejedrixt
scear	ʃæ͜ɑːr
þeodenstol	θe͜oːdenstoːl
spane	spɑne
basu	bɑsu
gemangian	jemɑnɡiɑn
hreodan	xre͜oːdɑn
orc	ork
deah	dæ͜ɑːx
liþan	liːθɑn
þeod	θe͜oːd
bestreawian	bestræ͜ɑːwiɑn
geefenlæcan	jeefenlæːt͡ʃɑn
mene	mene
geligre	jelijre
gewitnes	jewitnes
recan	reːt͡ʃɑn
æcer	æker
edwist	edwist
teah	tæːɑx
neoþan	ne͜oθɑn
læwed	læːwed
fas	fɑs
fiellan	fi͜yllɑn
gemacian	jemɑkiɑn
gedefe	jedeːfe
toscriþan	toːʃriːθɑn
wordmittung	wordmittunɡ
freo	fre͜oː
griþian	ɡriθiɑn
eaþmodheort	æ͜ɑːθmoːdxe͜ort
geardum	jæɑrdum
bærlic	bærliːt͡ʃ
stearcmod	stæ͜ɑrkmoːd
profian	proːfiɑn
gefindan	jefindɑn
eln	eln
tir	tiːr
brad	brɑːd
amirran	ɑːmirrɑn
ahte	ɑːhte
beot	be͜oːt
ieþan	i͜yːθɑn
penning	penninɡ
wliteleas	wlitelæ͜ɑːs
forhycgan	forxyjjɑn
hwæt	xwæt
stan	stɑːn
foreþingian	foreθinɡiɑn
fyrd	fyrd
spyrigung	spyrijunɡ
þeodcyninga	θeːodkyniŋɡɑ
gehierendlic	jexi͜yːrendliːt͡ʃ
onhyrenes	onxyrenes
norþmann	norθmɑnn
openlice	openliːt͡ʃe
tigan	tiːjɑn
windbære	windbæːre
deop	de͜oːp
eadbald	æ͜ɑːdbɑld
dwelan	dwelɑn
sceat	ʃæ͜ɑːt
sæþeof	sæːθe͜oːf
drinc	drink
þol	θol
miht	mixt
scamleas	ʃɑmlæ͜ɑːs
framacyrran	frɑmɑːt͡ʃyrrɑn
æswician	æːswikiɑn
brycgbot	bryjjboːt
campstede	kɑmpstede
colian	koːliɑn
meos	me͜oːs
handscyldig	xɑndʃyldij
pinere	piːnere
ræswan	ræːswɑn
leoþwise	le͜oːθwiːse
acyrrednes	ɑːt͡ʃyrrednes
sniþan	sniːθɑn
seofonfeald	se͜ofonfæ͜ɑld
besittan	besittɑn
wrot	wroːt
hring	xrinɡ
bescieran	beʃi͜yrɑn
lof	loːf
gamenian	ɡɑmeniɑn
getwæfan	jetwæːfɑn
giemeleas	ji͜yːmelæ͜ɑːs
finn	finn
hlafordleas	xlɑːfordlæ͜ɑːs
mearþ	mæ͜ɑrθ
hunig	xunij
andefn	ɑndefn
hwelian	xweliɑn
sciene	ʃi͜yːne
innan	innɑn
oferbrecan	oferbrekɑn
þære	θæːre
wæterseoc	wæterse͜oːk
fregn	frejn
mecefisc	meːt͡ʃefiʃ
belecgan	belejjɑn
oxan	oksɑn
læste	læste
geerian	jeerjɑn
gesundfull	jesundfull
ceorlian	t͡ʃe͜orliɑn
ielfete	i͜ylfete
ielf	i͜ylf
solsece	solseke
licettere	liːt͡ʃettere
hronrad	xronrɑːd
sæ	sæː
ciricþegnung	t͡ʃirikθejnunɡ
preost	pre͜oːst
utlædan	uːtlæːdɑn
þignen	θijnen
oferweorpan	oferwe͜orpɑn
sicorlice	sikorliːt͡ʃe
þruh	θruːx
deadlic	dæ͜ɑːdliːt͡ʃ
agen	ɑːɡen
ranc	rɑnk
eorþbifung	e͜orθbifunɡ
spowan	spoːwɑn
edniwian	edniːwiɑn
grambære	ɡrɑmbæːre
hleapestre	xlæ͜ɑːpestre
gemæte	jemæːte
færinga	fæːrinɡɑ
andsware	ɑndswɑre
wordlaþu	wordlɑθu
steppan	steppɑn
bearneacnung	bæ͜ɑrnæ͜ɑːknunɡ
wyrdan	wyrdɑn
bewalwian	bewɑlwiɑn
wuldorfull	wuldorfull
efest	efest
unstæfwis	unstæfwiːs
gastlic	ɡɑːstliːt͡ʃ
dreogan	dre͜oːɡɑn
æfæst	æːfæst
sprædan	spræːdɑn
ærn	ærn
ampella	ɑmpellɑ
hriþer	xriːθer
gemetfæt	jemetvæt
geador	ɡæ͜ɑdor
oferstigendlic	oferstiːɡendliːt͡ʃ
bænen	bæːnen
bælfyr	bæːlfyːr
sicol	sikol
ƿ	w
forscrihan	forʃriːxɑn
wambadl	wɑmbɑːdl
þeos	θeːos
crafian	krɑfiɑn
mearh	mæ͜ɑrx
inbringan	inbrinɡɑn
eþelriht	eːθelrixt
gærstapa	ɡærstɑpɑ
regnwyrm	rejnwyrm
onginnan	onjinnɑn
sæyþ	sæːyːθ
hweol	xwe͜oːl
huntian	xuntiɑn
ebreisc	ebreːiʃ
dædhata	dæːdxɑtɑ
crypel	krypel
gedriht	jedrixt
ylpend	ylpend
hof	xoːf
sacan	sɑkɑn
gesceadan	jeʃɑːdɑn
scir	ʃiːr
ancor	ɑnkor
laf	lɑːf
sucan	suːkɑn
læceboc	læːt͡ʃeboːk
tolicgan	toːlijjɑn
wuldorgeflogena	wuldorjefloɡenɑ
mioluc	mi͜uluk
blat	blɑːt
clænlice	klæːnliːt͡ʃe
herung	xerunɡ
tonama	toːnɑmɑ
foremearcod	foremæ͜ɑrkod
miscyrran	mist͡ʃyrrɑn
tid	tiːd
wuldorhelm	wuldorxelm
edwenden	edwenden
meregrot	mereɡrot
bewæpnian	bewæːpniɑn
gegn	jejn
læs	læːs
feondræden	fe͜oːndræːden
metetid	metetiːd
hindrian	xindriɑn
ceasnes	t͡ʃæ͜ɑːsnes
stæfrof	stæfroːf
lyge	lyje
deorcynn	de͜oːrkynn
geondhierdan	je͜ondxi͜yrdɑn
telga	telɡɑ
rice	riːt͡ʃe
biscophad	biʃʃopxɑːd
gleobeam	ɡle͜oːbæ͜ɑːm
sceabb	ʃæ͜ɑbb
ielfcynn	i͜ylfkynn
stracian	strɑːkiɑn
wrætt	wræːtt
mindom	mindoːm
gripennis	ɡripennis
hellewite	xellewiːte
nytwyrþnes	nytwyrθnes
wil	wil
mealt	mæ͜ɑlt
hreowlice	xre͜oːwliːt͡ʃe
beþeccan	beθett͡ʃɑn
hleoþorcyme	xle͜oːθorkyme
cwalu	kwɑlu
næglian	næjliɑn
þus	θus
non	non
stede	stede
ferhþ	ferxθ
wita	witɑ
oferwinnan	oferwinnɑn
ber	beːr
besma	besmɑ
æðele	æθele
cildlic	t͡ʃildliːt͡ʃ
non	noːn
hæst	xæːst
wilcuma	wilkumɑ
gift	jift
gelæstan	jelæːstɑn
orsorglice	orsorɡliːt͡ʃe
apostata	ɑpostɑtɑ
dœg	døɡ
cnif	kniːf
ræscettan	ræʃettɑn
god	ɡod
fanu	fɑnu
hnægung	xnæːjunɡ
earn	æ͜ɑrn
hælu	xæːlu
igoþ	ijoθ
gewyrdelice	jewyrdeliːt͡ʃe
trega	treɡɑ
þyrstan	θyrstɑn
misdon	misdoːn
forgiemeleasian	forji͜yːmelæ͜ɑːsiɑn
ciricbelle	t͡ʃirit͡ʃbelle
hefignes	xefijnes
hwelp	xwelp
husul	xuːsul
þrymm	θrymm
tosamnian	toːsɑmniɑn
hlenca	xlent͡ʃɑ
sloh	sloːx
mannbære	mɑnnbæːre
sceatt	ʃæ͜ɑtt
torfian	torfiɑn
gebad	jebɑːd
cost	kost
wacnes	wɑːknes
gie	ji͜y
beweorpan	bewe͜orpɑn
ricu	riːku
hornbære	xornbæːre
wyrttruma	wyrttrumɑ
los	los
mearcian	mæ͜ɑrkiɑn
byrnan	byrnɑn
ger	jeːr
rinnan	rinnɑn
hiewian	xi͜yːwiɑn
spannan	spɑnnɑn
hrim	xriːm
heafodstol	xæ͜ɑːfodstoːl
fealh	fæ͜ɑlx
daroþ	dɑroθ
stænen	stæːnen
geogolere	je͜oːɡolere
yþhengest	yːθxenjest
scamfæst	ʃɑmfæst
geondrecan	je͜ondreːt͡ʃɑn
heawan	xæ͜ɑːwɑn
sagu	sɑɡu
deorfan	de͜orfɑn
þis	θis
manigfealdnes	mɑnijfæ͜ɑldnes
dædbana	dæːdbɑnɑ
fielleseoc	fi͜yllese͜oːk
hlaford	xlɑːford
fuldon	fuldoːn
neolnes	ne͜oːlnes
cipe	t͡ʃipe
wawa	wɑːwɑ
bere	bere
þeote	θe͜oːte
bigenga	biːjenɡɑ
sangboc	sɑnɡboːk
gefolgian	jefolɡiɑn
ferdwite	ferdwiːte
croppa	kroppɑ
babilonige	bɑbiloːnije
sahtlian	sɑxtliɑn
glæsen	ɡlæsen
betweonum	betwe͜oːnum
stearc	stæ͜ɑrk
soþlice	soːθliːt͡ʃe
panne	pɑnne
orþanc	orθɑnk
wand	wɑnd
monaþlic	moːnɑθliːt͡ʃ
staþolfæstnes	stɑθolfæstnes
dunn	dunn
bledsian	bleːdsiɑn
cancettan	kɑnkettɑn
larsmiþ	lɑːrsmiθ
cynn	kynn
weornan	we͜ornɑn
geliman	jeliːmɑn
gegang	jeɡɑnɡ
flewsa	fleːwsɑ
manigfealdan	mɑnijfæ͜ɑldɑn
ac	ɑk
fif	fiːf
firenlust	firenlust
edcyrr	edt͡ʃyrr
græf	ɡræf
penwihtsteort	penwixtste͜ort
wunian	wuniɑn
stol	stoːl
cwen	kweːn
readnys	ræ͜ɑːdnys
swincan	swinkɑn
efthweorfan	eftxwe͜orfɑn
ricen	riːt͡ʃen
wintersufel	wintersufel
fæcne	fæːkne
awacan	ɑːwɑkɑn
clipol	klipol
clæne	klæːne
hwosan	xwoːsɑn
arcebiscop	ɑrt͡ʃebiʃʃop
medemian	medemiɑn
infiht	infixt
agiefan	ɑːji͜yfɑn
nytt	nytt
sæternesdæg	sæternesdæj
befylan	befyːlɑn
domboc	doːmboːk
ætbregdendlic	ætbrejdendliːt͡ʃ
pinung	piːnunɡ
teors	te͜ors
stieran	sti͜yːrɑn
wiþteon	wiθte͜oːn
canne	kɑnne
godlic	ɡoːdliːt͡ʃ
guþbeorn	ɡuːθbe͜orn
elebeam	elebæ͜ɑːm
candel	kɑndel
geþweran	jeθwerɑn
anfealdlice	ɑːnfæ͜ɑldliːt͡ʃe
aseon	ɑːse͜oːn
afaran	ɑːfɑrɑn
gerimboc	jeriːmboːk
gærsstapa	ɡærsstɑpɑ
landfolc	lɑndfolk
frasung	frɑːsunɡ
befindan	befindɑn
adeliht	ɑdelixt
eaden	æ͜ɑːden
lucan	luːkɑn
ierfe	i͜yrfe
blostmbære	bloːstmbæːre
wordig	wordij
sundor	sundor
noma	nomɑ
ongefeoht	onjefe͜oxt
dreor	dre͜oːr
æmyrgan	æːmyrjɑn
leodmægen	le͜oːdmæjen
sæp	sæp
beacenstan	bæ͜ɑːkenstɑːn
gemagian	jemɑɡiɑn
aheardung	ɑːxæ͜ɑrdunɡ
castenere	kɑstenere
niwnes	niːwnes
samnung	sɑmnunɡ
onweorpan	onwe͜orpɑn
ædreseax	æːdresæ͜ɑks
lesan	lesɑn
mylen	mylen
eardiend	æ͜ɑrdiend
sendan	sendɑn
cnihtlic	knixtliːt͡ʃ
morþorscyldig	morθorʃyldij
horena	xoːrenɑ
celde	t͡ʃelde
dyhtig	dyxtij
blœdsian	bløːdsiɑn
getacnigendlic	jetɑːknijendliːt͡ʃ
þreatian	θræ͜ɑːtiɑn
wedd	wedd
iecan	i͜yːt͡ʃɑn
syfling	syflinɡ
langoþ	lɑnɡoθ
þonne	θonne
eorþæppel	e͜orθæppel
licgan	lijjɑn
eþelwynn	eːθelwynn
ferian	ferjɑn
þeahtian	θæ͜ɑxtiɑn
gierwan	ji͜yrwɑn
cranicwritere	krɑnikwriːtere
wohdom	woːxdoːm
twiccian	twikkiɑn
are	ɑːre
wuldorword	wuldorword
wedlac	wedlɑːk
flugol	fluɡol
gesund	jesund
getacnigendlice	jetɑːknijendliːt͡ʃe
maþum	mɑːθum
gecyþan	jekyːθɑn
egesian	ejesiɑn
misrædan	misræːdɑn
migoþa	miɡoθɑ
wexan	weksɑn
oþsceotan	oθʃe͜oːtɑn
feohbot	fe͜oxboːt
æfwyrdla	æfwyrdlɑ
hecg	xejj
onliesan	onli͜yːsɑn
oncweþan	onkweθɑn
gecidan	jet͡ʃiːdɑn
forliþan	forliːθɑn
biword	biːword
fyrtorr	fyːrtorr
cwictreow	kwiktre͜oːw
wihtsæta	wixtsæːtɑ
edcierr	edt͡ʃi͜yrr
caf	kɑːf
leodwynn	le͜oːdwynn
bestrican	bestriːkɑn
gredig	ɡreːdij
besengan	besenjɑn
meteþegn	meteθejn
wennan	wennɑn
seaxisc	sæ͜ɑksiʃ
rignan	rijnɑn
ciricsteall	t͡ʃirit͡ʃstæ͜ɑll
niþgeteon	niːθjete͜oːn
hyreborg	xyːreborɡ
swiera	swi͜yːrɑ
sweora	swe͜oːrɑ
hunigcamb	xunijkɑmb
gestaþolian	jestɑθoliɑn
spell	spell
erce	erke
gefea	jefæ͜ɑː
onsendon	onsendon
unwæterig	unwæterij
liþa	liːθɑ
cwide	kwide
ciricstig	t͡ʃirit͡ʃstiːj
sceapieg	ʃæ͜ɑːpi͜yːj
þurhseon	θurxse͜oːn
botian	boːtiɑn
leon	le͜oːn
forspendan	forspendɑn
cneorim	kne͜oːriːm
wiergen	wi͜yrjen
eþeleard	eːθelæ͜ɑrd
wæge	wæːje
mundian	mundiɑn
swimman	swimmɑn
seolc	se͜olk
forlætan	forlæːtɑn
ofgangende	ofɡɑnɡende
spicing	spiːkinɡ
sprengan	sprenjɑn
meting	meːtinɡ
stryndan	stryːndɑn
þurhbrucan	θurxbruːkɑn
nihtes	nixtes
discipul	diskipul
unwitod	unwitod
þegen	θejen
utgan	uːtɡɑːn
wundor	wundor
stræt	stræːt
malscrung	mɑlʃrunɡ
swogen	swoːɡen
wohnes	woːxnes
gifre	jiːfre
gefegnes	jefeːjnes
sword	sword
wacian	wɑkiɑn
unnytt	unnytt
gosheafoc	ɡoːsxæ͜ɑfok
hiwfæst	xiːwfæst
asyndrung	ɑːsyndrunɡ
healfdead	xæ͜ɑlfdæ͜ɑːd
gespræc	jespræːt͡ʃ
webba	webbɑ
blac	blɑːk
tawian	tɑwiɑn
deopnes	de͜oːpnes
dreorig	dre͜oːrij
gerisene	jerisene
þe	θe
forseon	forse͜oːn
cyrtenlæcan	kyrtenlæːt͡ʃɑn
wagþyrel	wɑːɡθyːrel
etan	etɑn
bedd	bedd
ielfadl	i͜ylfɑːdl
mærstan	mæːrstɑːn
gæstan	ɡæːstɑn
fearn	fæ͜ɑrn
hiwcuþnes	xiːwkuːθnes
weofod	we͜oːfod
ceosol	t͡ʃe͜osol
æmette	æːmette
wregendlic	wreːjendliːt͡ʃ
mægencræft	mæjenkræft
ylp	ylp
haswig	xɑswij
unwemme	unwemme
handboc	xɑndboːk
scearplice	ʃæ͜ɑrpliːt͡ʃe
sceaþan	ʃæ͜ɑθɑn
capian	kɑpiɑn
nigonfeald	niɡonfæ͜ɑld
wacor	wɑkor
upengel	upenjel
wælfyllo	wælfyllo
gegnum	jejnum
cranoc	krɑnok
hincian	xinkiɑn
slapan	slɑːpɑn
hyrne	xyrne
holm	xolm
nihtgenge	nixtɡenje
efenwiht	efenwixt
lofdæd	lofdæːd
pytt	pytt
gearn	jæ͜ɑrn
mangunghus	mɑnɡunɡxuːs
aweg	ɑːwej
termen	termen
gedrefednes	jedreːfednes
rætt	rætt
swamm	swɑmm
gecuman	jekumɑn
hæmedlac	xæːmedlɑːk
æthweorfan	ætxwe͜orfɑn
ryman	ryːmɑn
hosp	xosp
iohannes	joxɑnnes
stow	stoːw
glom	ɡloːm
forn	forn
drihten	drixten
elh	elx
fordon	fordoːn
ege	eːje
dreahtes	dræɑ̯htes
onlec	onleːt͡ʃ
beodern	be͜oːdern
meares	mæ͜ɑːres
easterne	æ͜ɑːsterne
forþteon	forθte͜oːn
antid	ɑːntiːd
loppe	loppe
fromcynn	fromkynn
drifan	driːfɑn
wan	wɑn
femne	feːmne
gesceadlic	jeʃɑːdliːt͡ʃ
ream	ræ͜ɑːm
feond	fe͜oːnd
swegl	swejl
toslitan	toːsliːtɑn
dah	dɑːx
yþgebland	yːθjeblɑnd
her	xeːr
æl	æl
burbyrde	buːrbyrde
wyrgen	wyrjen
ambeaht	ɑmbæ͜ɑxt
wen	weːn
samodwist	sɑmodwist
birhtu	birxtu
dwolma	dwolmɑ
þam	θɑːm
orsorgnes	orsorɡnes
banhus	bɑːnxuːs
foredeman	foredeːmɑn
moraþ	moːrɑθ
samodswegend	sɑmodsweːjend
deaþwerig	dæ͜ɑːθweːrij
seaxa	sæ͜ɑksɑ
buttorfleoge	buttorfle͜oːɡe
gewundian	jewundiɑn
hæmedwif	xæːmedwiːf
gearu	jæ͜ɑru
smiðian	smiθiɑn
þolian	θoliɑn
well	well
drusian	druːsiɑn
eowend	e͜owend
lafian	lɑfiɑn
scolu	ʃolu
hlinian	xliniɑn
geswin	jeswin
cneow	kne͜oːw
yfela	yfelɑ
frætwe	frætwe
seofoþa	se͜ofoθɑ
neoþeweard	ne͜oθewæ͜ɑrd
siwian	siwiɑn
meteþearfende	meteθæ͜ɑrfende
gefroren	jefroren
tysca	tyʃʃɑ
landfeoh	lɑndfe͜ox
sihþ	sixθ
bewepan	beweːpɑn
gestincan	jestinkɑn
mynetian	mynetiɑn
screawa	ʃræ͜ɑːwɑ
mislibban	mislibbɑn
firenligerian	firenlijerjɑn
rudig	rudij
ofercyrr	ofert͡ʃyrr
fægan	fæːjɑn
efenhleoþrian	efenxle͜oːθriɑn
cearwylm	t͡ʃæ͜ɑrwylm
hoþ	xoːθ
unlyft	unlyft
anad	ɑːnɑd
iw	iːw
sacende	sɑkende
hosan	xosɑn
wægholm	wæːjxolm
eþelfæsten	eːθelfæsten
geondstyrian	je͜ondstyrjɑn
gefrugnon	jefruːjnon
iow	i͜uːw
gesweor	jeswe͜oːr
oferwrigels	oferwriːɡels
flæsclic	flæːʃliːt͡ʃ
usc	uːsk
ceapa	t͡ʃæːɑ̯pɑ
gemetan	jemeːtɑn
freme	freme
forlædan	forlæːdɑn
wulfstan	wulfstɑːn
fyrdwite	fyrdwiːte
telg	telɡ
wiþerwinna	wiθerwinnɑ
eafoþ	æ͜ɑfoθ
giltig	ɡiltij
gemengan	jemenjɑn
þin	θiːn
wudu	wudu
sellic	selliːt͡ʃ
forwemman	forwemmɑn
rimere	riːmere
oferfaran	oferfɑrɑn
screadian	ʃræ͜ɑːdiɑn
niehsta	ni͜yːxstɑ
botwierþe	boːtwi͜yrθe
huntoþ	xuntoθ
staþolfæst	stɑθolfæst
sarnes	sɑːrnes
gastbana	ɡɑːstbɑnɑ
wrætlic	wræːtliːt͡ʃ
donua	donuɑ
efstan	efstɑn
hreaw	xræ͜ɑːw
cwysan	kwyːsɑn
eofor	e͜ofor
scamlic	ʃɑmliːt͡ʃ
grietu	ɡri͜yːtu
ascirigendlic	ɑːʃirijendliːt͡ʃ
december	dekember
dwelle	dwelle
ymbcyrr	ymbt͡ʃyrr
grætan	ɡræːtɑn
he	xeː
gecigendlic	jet͡ʃiːjendliːt͡ʃ
clænlic	klæːnliːt͡ʃ
freod	fre͜oːd
onmunan	onmunɑn
þoftscipe	θoftʃipe
þicnes	θiknes
gehiwcuþlician	jexiːwkuːθliːkiɑn
horshwæl	xorsxwæl
bædde	bæːdde
woruldlic	woruldliːt͡ʃ
wiergan	wi͜yrjɑn
scirgerefa	ʃiːrjereːfɑ
medern	meːdern
freolice	fre͜oːliːt͡ʃe
feorhbealo	fe͜orxbæ͜ɑlo
fæþm	fæθm
eald	æ͜ɑld
tosmeagan	toːsmæ͜ɑːjɑn
babilon	bɑbiloːn
carl	kɑrl
feondlic	fe͜oːndliːt͡ʃ
greosan	ɡre͜oːsɑn
gehycgan	jexyjjɑn
nacodnes	nɑkodnes
yrfenuma	yrfenumɑ
cycen	t͡ʃyːken
bepæcung	bepæːt͡ʃunɡ
grunnian	ɡrunniɑn
lungen	lunɡen
trahtian	trɑxtiɑn
sincfag	sinkfɑːɡ
spelc	spelk
weorþ	we͜orθ
elnboga	elnboɡɑ
yþfaru	yːθfɑru
lamp	lɑmp
windan	windɑn
hwergen	xwerjen
fæderen	fæderen
worda	wordɑ
goldmæstling	ɡoldmæstlinɡ
geleaful	jelæ͜ɑːful
ben	beːn
hwy	xwyː
þinne	θinne
winemæg	winemæːj
wær	wær
þerxold	θerksold
begripan	beɡriːpɑn
row	roːw
wigbære	wiːjbæːre
swingan	swinɡɑn
stærwritere	stæːrwriːtere
scyldwiga	ʃyldwiɡɑ
geonre	jonre
sweota	swe͜oːtɑ
arm	ɑrm
stær	stær
forcuman	forkumɑn
geolu	je͜olu
cietel	t͡ʃi͜ytel
fæst	fæst
spelcan	spelt͡ʃɑn
sien	si͜yːn
siððan	siθθɑn
tæcþ	tæːkθ
grim	ɡrim
adilgian	ɑːdilɡiɑn
fana	fɑnɑ
gastberend	ɡɑːstberend
bar	bɑːr
sixtigfeald	sikstijfæ͜ɑld
hundtwelftig	xundtwelftij
gerad	jerɑːd
undæd	undæːd
boca	boːkɑ
catte	kɑtte
hlafweard	xlɑːfwæ͜ɑrd
beteon	bete͜oːn
land	lɑnd
styria	styriɑ
onwican	onwiːkɑn
dolh	dolx
winterdæg	winterdæj
synnig	synnij
gemyþ	jemyːθ
hnitan	xniːtɑn
gewæpnod	jewæːpnod
þurhcreopan	θurxkre͜oːpɑn
eotaland	e͜oːtɑlɑnd
fugelere	fuɡelere
pearruc	pæ͜ɑrruk
rodorstol	rodorstoːl
wuldorbeah	wuldorbæ͜ɑːx
dœman	døːmɑn
leoþcræftig	le͜oːθkræftij
þoht	θoːxt
undeadlic	undæ͜ɑːdliːt͡ʃ
higian	xiːɡiɑn
dene	dene
forbrecan	forbrekɑn
scearu	ʃæ͜ɑru
þara	θɑːrɑ
bescyldigian	beʃyldiɡiɑn
sceaþa	ʃɑθɑ
feallan	fæ͜ɑllɑn
diht	dixt
stacga	stɑɡɡɑ
bismer	bismer
fang	fɑnɡ
metod	metod
ig	iːj
oþwendan	oːθwendɑn
ent	ent
anælan	ɑnæːlɑn
open	open
swilce	swilt͡ʃe
fætnes	fætnes
hara	xɑrɑ
wilweorþung	wilwe͜orθunɡ
underbugan	underbuːɡɑn
beorgan	be͜orɡɑn
witt	witt
dyrne	dyrne
genear	jenæ͜ɑr
bigspel	bijspel
cicen	kit͡ʃen
gearwe	jæ͜ɑrwe
wituma	witumɑ
geat	jæ͜ɑt
slæc	slæk
þrines	θriːnes
grundleas	ɡrundlæ͜ɑːs
wielm	wi͜ylm
mann	mɑnn
niþer	niθer
fotwielm	foːtwi͜ylm
ealdbacen	æ͜ɑldbɑken
mihte	miçte
edniwigend	edniːwijend
steorleas	ste͜oːrlæ͜ɑːs
geriht	jerixt
sægd	sæjd
eorþnafela	e͜orθnɑfelɑ
fyrst	fyrst
frecne	freːkne
swegel	swejel
fyrdrinc	fyrdrink
gefealdan	jefæ͜ɑldɑn
pinn	pinn
slecg	slejj
werleas	werlæ͜ɑːs
styrman	styrmɑn
ymbþringan	ymbθrinɡɑn
asyndrian	ɑːsyndriɑn
orgello	orɡello
inbrecan	inbrekɑn
slean	slæ͜ɑːn
untime	untiːme
isenordal	iːsenordɑːl
ciricþegn	t͡ʃirit͡ʃθejn
hwilum	xwiːlum
winterlic	winterliːt͡ʃ
tiw	tiːw
þeodan	θe͜oːdɑn
climban	klimbɑn
swin	swiːn
fictreow	fiːktre͜oːw
in	in
behlidan	bexliːdɑn
wist	wist
onsang	onsɑnɡ
cnossian	knossiɑn
anlaf	ɑnlɑf
werian	werjɑn
agenung	ɑːɡenunɡ
weaxcandel	wæ͜ɑkskɑndel
hundred	xundred
cynferþ	kynferθ
hland	xlɑnd
hoppestre	xoppestre
halgoland	xɑːlɡolɑnd
waccor	wɑkkor
nihtegale	nixteɡɑle
com	koːm
bedtid	bedtiːd
titt	titt
twirædness	twiræːdness
bilehwit	bilexwiːt
wudufæsten	wudufæsten
cælf	kælf
ægen	æːjen
gafolræden	ɡɑfolræːden
seolucen	se͜oluken
dragan	drɑɡɑn
agendfrea	ɑːɡendfræ͜ɑː
fæman	fæːmɑn
eowland	e͜owlɑnd
misfeng	misfeːnɡ
tapor	tɑpor
weland	welɑnd
þryccan	θrytt͡ʃɑn
cæg	kæːj
anhorn	ɑːnxorn
cirichad	t͡ʃirit͡ʃxɑːd
mycgnett	myjjnett
cedertreow	kedertre͜oːw
hlutor	xluːtor
sinceald	sint͡ʃæ͜ɑld
cyrr	t͡ʃyrr
sculdra	ʃuldrɑ
wicca	witt͡ʃɑ
forstoppian	forstoppiɑn
cystig	kystij
getwinn	jetwinn
genoh	jenoːx
sumorhus	sumorxuːs
hlafordlic	xlɑːfordliːt͡ʃ
blindnys	blindnys
gycce	jytt͡ʃe
defe	deːfe
geæhtle	jeæxtle
idel	iːdel
inn	inn
fyren	fyren
cofa	kofɑ
tyhtnes	tyxtnes
cnearr	knæ͜ɑrr
cynelic	kyneliːt͡ʃ
tu	tuː
temsian	temsiɑn
beornan	be͜ornɑn
bealohydig	bæ͜ɑloxyːdij
hellruna	xellruːnɑ
neowol	ne͜owol
geoc	je͜oːk
forhatan	forxɑːtɑn
becierran	bet͡ʃi͜yrrɑn
forhyrdan	forxyrdɑn
edniewung	edni͜yːwunɡ
ansyn	ɑnsyːn
gebyrde	jebyrde
færgryre	fæːrɡryre
wilgesiþ	wiljesiːθ
gespedsumian	jespeːdsumiɑn
leoþgiddung	le͜oːθjiddunɡ
efenniht	efennixt
nift	nift
gerecedness	jeret͡ʃedness
ymbwlatian	ymbwlɑːtiɑn
geþryccan	jeθrytt͡ʃɑn
forþwisian	forθwiːsiɑn
wiþmetendlic	wiθmetendliːt͡ʃ
rad	rɑːd
ciricgang	t͡ʃirit͡ʃɡɑnɡ
casern	kɑːsern
unmyltsiendlic	unmyltsiendliːt͡ʃ
cirictid	t͡ʃirit͡ʃtiːd
piper	piper
citelung	t͡ʃitelunɡ
ymbgangan	ymbɡɑnɡɑn
þegon	θeːɣon
wyrsa	wyrsɑ
hundteontig	xundte͜oːntij
hrif	xrif
wlanc	wlɑnk
bretland	bretlɑnd
forfon	forfoːn
heala	xæ͜ɑːlɑ
frumcyrr	frumt͡ʃyrr
gehiersumnes	jexi͜yːrsumnes
undruncen	undrunken
dædlic	dæːdliːt͡ʃ
hlosnian	xlosniɑn
þurhsiene	θurxsi͜yːne
dierne	di͜yrne
soþlic	soːθliːt͡ʃ
steorend	ste͜oːrend
þrowend	θroːwend
unhalig	unxɑːlij
þoncian	θonkiɑn
bold	bold
æfdyne	æfdyːne
hnesce	xneʃʃe
specan	spekɑn
blæd	blæd
wyrtian	wyrtiɑn
cirictun	t͡ʃiriktuːn
scearp	ʃæ͜ɑrp
alecgan	ɑːlejjɑn
blostm	bloːstm
ladung	lɑːdunɡ
wuldorfullice	wuldorfulliːt͡ʃe
scamol	ʃɑmol
ofhealdan	ofxæ͜ɑldɑn
fyrn	fyrn
grad	ɡrɑd
hyrdan	xyrdɑn
princ	prink
cweccan	kwett͡ʃɑn
bealdlice	bæ͜ɑldliːt͡ʃe
secan	seːt͡ʃɑn
user	uːser
geonga	junɡɑ
galdre	ɡɑldre
grammatic	ɡrɑmmɑtit͡ʃ
ungelæred	unjelæːred
þusendfeald	θuːsendfæ͜ɑld
stellan	stellɑn
seamestre	sæ͜ɑːmestre
sceacga	ʃɑɡɡɑ
swic	swik
gram	ɡrɑm
sunu	sunu
æsellend	æːsellend
cen	t͡ʃeːn
gebed	jebed
wælcyrge	wælkyrje
cnæwe	knæːwe
broþorleas	broːθorlæ͜ɑːs
hyr	xyːr
steartlian	stæ͜ɑrtliɑn
sæmeþe	sæːmeːθe
ongeancyrring	onjæ͜ɑːnt͡ʃyrrinɡ
cristesmæsse	kristesmæsse
anfeald	ɑːnfæ͜ɑld
feowertiene	fe͜oːwerti͜yːne
æwita	æːwitɑ
feldswamm	feldswɑmm
witan	wiːtɑn
gecnæwe	jeknæːwe
underbæc	underbæk
biemian	bi͜yːmiɑn
drægnet	dræjnet
sniðan	sniːθɑn
ful	ful
cynesetl	kynesetl
ierfa	i͜yrfɑ
ordal	ordɑːl
færeldboc	færeldboːk
stalu	stɑlu
syndrian	syndriɑn
col	koːl
feormeham	fe͜ormexɑːm
fær	fær
bæc	bæk
scrydan	ʃryːdɑn
wenan	weːnɑn
blostmian	bloːstmiɑn
dol	dol
acwician	ɑːkwikiɑn
cweman	kweːmɑn
milde	milde
wohfulnes	woːxfulnes
guþfugel	ɡuːθfuɡel
wyllen	wyllen
stirung	stirunɡ
heofonwuldor	xe͜ofonwuldor
þafung	θɑfunɡ
cropp	kropp
gebeacnian	jebæ͜ɑːkniɑn
mægden	mæjden
pyll	pyll
turfum	turfum
hit	xit
giestran	ji͜ystrɑn
mimor	mimor
scieldan	ʃi͜yldɑn
efor	efor
manig	mɑnij
blodgian	bloːdɡiɑn
stæna	stæːnɑ
leoþlic	le͜oːθliːt͡ʃ
wiþutan	wiθuːtɑn
unweder	unweder
ehta	extɑ
andcweþan	ɑndkweθɑn
framian	frɑmiɑn
broþ	broθ
ierre	i͜yrre
la	lɑː
feoht	fe͜oxt
oferwrecan	oferwrekɑn
bacu	bɑku
spinnan	spinnɑn
belt	belt
tyrf	tyrf
hringfinger	xrinɡfinɡer
deofol	de͜oːfol
alysan	ɑːlyːsɑn
lieglocc	li͜yːjlokk
ðorh	θorx
sigebeam	sijebæ͜ɑːm
alyfan	ɑːlyːfɑn
fordeman	fordeːmɑn
sundrian	sundriɑn
forþferde	forθfeːrde
reodan	re͜oːdɑn
oft	oft
bidon	bidon
ambiht	ɑmbixt
angsumnes	ɑnɡsumnes
gese	jeːse
gehiwian	jexiːwiɑn
leaslic	læ͜ɑːsliːt͡ʃ
gewædian	jewæːdiɑn
neart	næ͜ɑrt
hrimig	xriːmij
healdan	xæ͜ɑldɑn
lumpen	lumpen
feldælfen	feldælfen
laþ	lɑːθ
stæflic	stæfliːt͡ʃ
broþorlic	broːθorliːt͡ʃ
þingan	θinɡɑn
clænsian	klæːnsiɑn
uferor	uferor
cierran	t͡ʃi͜yrrɑn
bedclyfa	bedklyfɑ
geondmengan	je͜ondmenjɑn
mæghæmed	mæːjxæːmed
manscipe	mɑnskipe
rarian	rɑːriɑn
forewitan	forewitɑn
soþes	soːθes
scrobbesburh	ʃrobbesburx
æfest	æːfest
buc	buːk
carleasnes	kɑrlæ͜ɑːsnes
noþ	noːθ
refsan	refsɑn
imbe	imbe
biter	biter
læringmæden	læːrinɡmæːden
gebod	jebod
swiþe	swiːθe
slaga	slɑɡɑ
glitnian	ɡlitniɑn
swurd	swurd
þah	θɑːx
þænne	θænne
begang	beɡɑnɡ
forþsendan	forθsendɑn
gecnawan	jeknɑːwɑn
besingan	besinɡɑn
sec	seːk
sorg	sorɡ
landleas	lɑndlæ͜ɑːs
foregangan	foreɡɑnɡɑn
peohtas	pe͜oxtɑs
recenian	rekeniɑn
beotian	be͜oːtiɑn
wohsum	woːxsum
herebeorg	xerebe͜orɡ
wælhreownes	wælxre͜oːwnes
hnocc	xnokk
asweartian	ɑːswæ͜ɑrtiɑn
dæglic	dæjliːt͡ʃ
æscholt	æʃxolt
eastreamyþ	æ͜ɑːstræ͜ɑːmyːθ
sibræden	sibræːden
geat	jæ͜ɑːt
spelcean	spelt͡ʃɑn
blindnes	blindnes
befon	befoːn
samwist	sɑmwist
þrysmian	θrysmiɑn
eorcnan	e͜orknɑn
burna	burnɑ
biliþe	biliθe
beliefan	beli͜yːfɑn
crist	krist
gæt	ɡæːt
micelu	mit͡ʃelu
hranrad	xrɑnrɑːd
stor	stoːr
wiglung	wiɡlunɡ
alles	ɑlles
sceoliege	ʃe͜oːli͜yːje
grighund	ɡriːjxund
laþu	lɑθu
wuldorgimm	wuldorjimm
bledhwæt	bleːdxwæt
heahþrym	xæ͜ɑːxθrym
æþryttan	æːθryttɑn
hlimman	xlimmɑn
gecweþan	jekweθɑn
becweþan	bekweθɑn
ungleawnes	unɡlæ͜ɑːwnes
iudea	iudæ͜ɑ
sceotend	ʃe͜oːtend
hnah	xnɑːx
brydguma	bryːdɡumɑ
haga	xɑɡɑ
scitan	ʃiːtɑn
cræft	kræft
þreax	θræ͜ɑks
geywan	jeyːwɑn
bæcern	bækern
segl	sejl
wilisc	wiːliʃ
myln	myln
tæceþ	tæːt͡ʃeθ
monaþ	moːnɑθ
geleod	jele͜oːd
æþelhere	æθelxere
wese	weːse
tæhten	tæːxten
reþra	reːθrɑ
sunder	sunder
mægdenlic	mæjdenliːt͡ʃ
word	word
ciricgeriht	t͡ʃirit͡ʃjerixt
wynn	wynn
wuldrian	wuldriɑn
mið	miθ
ælan	æːlɑn
hornblawere	xornblɑːwere
healsgebedda	xæ͜ɑlsjebeddɑ
uder	uːder
ciricwica	t͡ʃirit͡ʃwiːt͡ʃɑ
stedefæstnes	stedefæstnes
gesyd	jesyd
edniwe	edniːwe
scufan	ʃuːfɑn
ofergesawan	oferjesɑːwɑn
geswincan	jeswinkɑn
munan	munɑn
gehealdsum	jexæ͜ɑldsum
hreþer	xreθer
gebeterian	jebeteriɑn
gespedan	jespeːdɑn
gesieltan	jesi͜yltɑn
leax	læ͜ɑks
gripe	ɡriːpe
langian	lɑnɡiɑn
ned	neːd
onmiddan	onmiddɑn
fnæs	fnæs
hlot	xlot
geostra	je͜ostrɑ
bolca	bolkɑ
þeodwiga	θe͜oːdwiɡɑ
bestyrian	bestyrjɑn
behabban	bexɑbbɑn
triwen	triwen
locc	lokk
leodstefn	le͜oːdstefn
wohfotede	woːxfoːtede
aweccan	ɑːwett͡ʃɑn
seofontig	se͜ofontij
cnyttan	knyttɑn
wræc	wræk
þeaw	θæ͜ɑːw
ambeht	ɑmbext
softe	soːfte
diere	di͜yːre
baþu	bɑθu
þefian	θefiɑn
muþa	muːθɑ
aberan	ɑːberɑn
frasian	frɑːsiɑn
geomor	je͜oːmor
bryttas	bryttɑs
ears	æ͜ɑrs
cwic	kwik
geþinge	jeθinɡe
geryne	jeryːne
wregan	wreːjɑn
ides	ides
wigle	wijle
fultumian	fultumiɑn
þerscan	θerʃɑn
swegan	sweːjɑn
anhende	ɑːnxende
unfulfremed	unfulfremed
gnagan	ɡnɑɡɑn
hlisa	xliːsɑ
sadol	sɑdol
geatwe	jæ͜ɑtwe
aseþan	ɑːseːθɑn
mædmonaþ	mæːdmoːnɑθ
cuþlæcan	kuːθlæːt͡ʃɑn
lichama	liːkxɑmɑ
geberan	jeberɑn
firenian	fireniɑn
neh	neːx
sugu	suɡu
asecgan	ɑːsejjɑn
fah	fɑːx
eft	eft
fiþerfete	fiθerfeːte
cenlice	keːnliːt͡ʃe
geswencednes	jeswent͡ʃednes
eagþyrel	æ͜ɑːɡθyːrel
þiestru	θi͜yːstru
weana	wæ͜ɑːnɑ
onhyring	onxyrinɡ
frægn	fræjn
warian	wɑriɑn
slief	sli͜yːf
wudufeoh	wudufe͜ox
sealdnes	sæ͜ɑldnes
andefera	ɑndeferɑ
hreac	xræ͜ɑːk
bewægnan	bewæjnɑn
yfelwillendnes	yfelwillendnes
bierhtu	bi͜yrxtu
axung	ɑːksunɡ
dropian	dropiɑn
flean	flæ͜ɑːn
foregenga	foreɡenjɑ
ætfleon	ætfle͜oːn
racenteagian	rɑkentæ͜ɑːɡiɑn
drænc	drænk
gebyrddæg	jebyrddæj
pislice	piːsliːt͡ʃe
hliþ	xliθ
clam	klɑːm
blind	blind
eadmund	æ͜ɑːdmund
wundorlic	wundorliːt͡ʃ
hæle	xæle
bærfot	bærfoːt
dreamcræft	dræ͜ɑːmkræft
clifiht	klifixt
sigorwuldor	siɡorwuldor
wiþmetan	wiθmetɑn
ih	ix
bieldan	bi͜yldɑn
rec	reːk
belyfan	belyːfɑn
seþan	seːθɑn
breowan	bre͜oːwɑn
gicel	jit͡ʃel
clipigendlic	klipijendliːt͡ʃ
sceafa	ʃɑfɑ
cædmon	kædmon
eare	æ͜ɑːre
afyllan	ɑːfyllɑn
wifian	wiːfiɑn
forealdian	foræ͜ɑldiɑn
gelæred	jelæːred
sorh	sorx
wlitig	wlitij
wifmann	wiːfmɑnn
gripul	ɡripul
wæterian	wæteriɑn
successe	sukkesse
þawian	θɑwiɑn
þæge	θæje
mete	mete
loc	lok
geþiedan	jeθi͜yːdɑn
last	lɑːst
gelimplice	jelimpliːt͡ʃe
selflic	selfliːt͡ʃ
wuldorfullian	wuldorfulliɑn
unrihtwisnes	unrixtwiːsnes
strynd	stryːnd
stæpe	stæpe
basnian	bɑːsniɑn
orceard	ort͡ʃæ͜ɑrd
wiþmetennes	wiθmetennes
þurhbirnan	θurxbirnɑn
mihtleas	mixtlæ͜ɑːs
bedul	bedul
geciegan	jet͡ʃi͜yːjɑn
bebeodan	bebe͜oːdɑn
ungleawscipe	unɡlæ͜ɑːwʃipe
þurhdreogan	θurxdre͜oːɡɑn
heals	xæ͜ɑls
lacnestre	lɑːknestre
æmete	æːmete
heah	xæ͜ɑːx
sweartnes	swæ͜ɑrtnes
tæcan	tæːt͡ʃɑn
timbrian	timbriɑn
wohhæmende	woːxxæːmende
orgol	orɡol
wacung	wɑkunɡ
maþa	mɑθɑ
swetlice	sweːtliːt͡ʃe
egland	eːjlɑnd
geþanc	jeθɑnk
gefere	jefeːre
forgieldan	forji͜yldɑn
rogian	roːɡiɑn
meolcan	me͜olkɑn
ræcan	ræːt͡ʃɑn
clyppan	klyppɑn
faþe	fɑθe
limpan	limpɑn
gesellan	jesellɑn
rodorlic	rodorliːt͡ʃ
deaþscyld	dæ͜ɑːθʃyld
bisæc	biːsæt͡ʃ
cycene	kyt͡ʃene
ongeanhweorfan	onjæ͜ɑːnxwe͜orfɑn
georne	je͜orne
þrowian	θroːwiɑn
gebland	jeblɑnd
oþian	oːθiɑn
ciricsceattweorc	t͡ʃirit͡ʃʃæ͜ɑttwe͜ork
gewuldrian	jewuldriɑn
marc	mɑrk
grindel	ɡrindel
biecnan	bi͜yːknɑn
drincan	drinkɑn
forbindan	forbindɑn
gemang	jemɑnɡ
hancred	xɑnkreːd
læt	læːt
ættrig	æːttrij
eaþmodig	æ͜ɑːθmoːdij
gescæphwil	jeʃæpxwiːl
plog	ploːɡ
elpend	elpend
steall	stæ͜ɑll
isig	iːsij
swiftnys	swiftnys
oþgripan	oθɡriːpɑn
fingerdocce	finɡerdokke
forblawan	forblɑːwɑn
deor	de͜oːr
hearg	xæ͜ɑrɡ
wælhreowlice	wælxre͜oːwliːt͡ʃe
þweorh	θwe͜orx
gemyndful	jemyndful
ðerh	θerx
bru	bruː
clæg	klæːj
adlian	ɑːdliɑn
grene	ɡreːne
dægweorc	dæjwe͜ork
hwearfian	xwæ͜ɑrfiɑn
sangestre	sɑnɡestre
medume	medume
healfweg	xæ͜ɑlfwej
gewanian	jewɑniɑn
ungewemmednes	unjewemmednes
melcan	melkɑn
sæcþ	sækθ
spendung	spendunɡ
midþolian	midθoliɑn
gesegen	jesejen
gleng	ɡlenj
fyrwet	fyrwet
dor	doːr
andgiet	ɑndji͜yt
teoþa	te͜oːθɑ
geondseon	je͜ondse͜oːn
seolcen	se͜olken
nytwyrþe	nytwyrθe
ofersceadan	oferʃæ͜ɑːdɑn
gielpe	jiylpe
gecyrran	jet͡ʃyrrɑn
forsecgan	forsejjɑn
sawan	sɑːwɑn
lyft	lyft
fæhþe	fæːhθe
aglæca	ɑːɡlæːt͡ʃɑ
castel	kɑstel
flæsc	flæːʃ
nacian	nɑkiɑn
deore	de͜oːre
druh	drux
unbryce	unbryt͡ʃe
wel	wel
linden	linden
swæcc	swækk
fæstnung	fæstnunɡ
edischenn	ediʃxenn
fæderlic	fæderliːt͡ʃ
wlitan	wliːtɑn
hælsung	xæːlsunɡ
wiga	wiɡɑ
sicor	sikor
heorþ	xe͜orθ
don	doːn
gastsunu	ɡɑːstsunu
ungewemmed	unjewemmed
foreberan	foreberɑn
haligdom	xɑːlijdoːm
hælendlic	xæːlendliːt͡ʃ
weardsteall	wæ͜ɑrdstæ͜ɑll
forsettan	forsettɑn
sceaðian	ʃɑθiɑn
misfehst	misfeːxst
hwit	xwiːt
beom	beːo̯m
israhel	isrɑxel
eardung	æ͜ɑrdunɡ
hreddan	xreddɑn
nyten	nyten
æðelhere	æθelxere
oroþ	oroθ
abrecan	ɑːbrekɑn
cynerice	kyneriːt͡ʃe
ofersteppan	ofersteppɑn
wæpenhus	wæːpenxuːs
neowolnes	ne͜owolnes
wegleas	wejlæ͜ɑːs
gelom	jeloːm
frymþu	frymθu
gefangian	jefɑnɡiɑn
giestrandæg	ji͜ystrɑndæj
toheawan	toːxæ͜ɑːwɑn
budda	buddɑ
geunderþeodan	jeunderθe͜oːdɑn
undernmæl	undernmæːl
wanian	wɑniɑn
weorpan	we͜orpɑn
line	liːne
scyndan	ʃyndɑn
beacen	bæ͜ɑːken
godþrym	ɡodθrym
bedelfan	bedelfɑn
wilnian	wilniɑn
ciricsocn	t͡ʃirit͡ʃsoːkn
stofn	stofn
geherigendlic	jexerijendliːt͡ʃ
drycræft	dryːkræft
þearf	θæ͜ɑrf
wiþhabban	wiθxɑbbɑn
sniwþ	sniːwθ
meotan	me͜otɑn
geweorc	jewe͜ork
tosceadan	toːʃæ͜ɑːdɑn
gedwolgod	jedwolɡod
gnidan	ɡniːdɑn
bitor	bitor
wir	wiːr
wiðsæcgan	wiθsæjjɑn
geondgeotan	je͜ondje͜oːtɑn
undercierran	undert͡ʃi͜yrrɑn
hwerfan	xwerfɑn
dom	doːm
blencan	blent͡ʃɑn
forlicgan	forliɡɡɑn
cocnian	koːkniɑn
loccian	lokkiɑn
dagung	dɑɡunɡ
distæf	distæf
lichamlice	liːkxɑmliːt͡ʃe
drepe	drepe
mase	mɑːse
flering	fleːrinɡ
finul	finul
cynig	kyniɡ
wendle	wendle
syferlic	syːferliːt͡ʃ
eorþhnutu	e͜orθxnutu
fla	flɑː
nahwær	nɑːxwæːr
crimman	krimmɑn
onlædan	onlæːdɑn
struta	struːtɑ
nicenned	niːkenned
twiscyldig	twiʃyldij
healfbrocen	xæ͜ɑlfbroken
grindere	ɡrindere
mec	mek
freogan	fre͜oːjɑn
eored	e͜oːred
wuduielfen	wudui͜ylfen
englisc	enɡliʃ
wyrrest	wyrrest
drihtenlice	drixtenliːt͡ʃe
wyrhta	wyrxtɑ
woden	woːden
uncnyttan	unknyttɑn
crincan	krinkɑn
eala	æ͜ɑːlɑː
eaþdæde	æ͜ɑːθdæːde
huuæt	xwæt
ferþ	ferθ
hroc	xroːk
us	uːs
meredeor	merede͜oːr
ceol	t͡ʃe͜oːl
beoran	be͜orɑn
acweþan	ɑːkweθɑn
swefniend	swefniend
wuldorcyning	wuldorkyninɡ
lundlaga	lundlɑɡɑ
þanne	θɑnne
ceorlfolc	t͡ʃe͜orlfolk
gæ	jæ
win	wiːn
gehathiertan	jexɑːtxi͜yrtɑn
hege	xeje
læwa	læːwɑ
asundrian	ɑːsundriɑn
portesmuþa	portesmuːθɑ
spreot	spre͜oːt
brœme	brøːme
fleard	flæ͜ɑrd
woriend	woːriend
onsendan	onsendɑn
toferan	toːfeːrɑn
ymbhabban	ymbxɑbbɑn
gegræppian	jeɡræppiɑn
þeowet	θe͜oːwet
predicung	predikunɡ
leþer	leθer
mynecenu	mynet͡ʃenu
fordrifan	fordriːfɑn
seolcwyrm	se͜olkwyrm
monað	moːnɑθ
pucel	puːkel
hræfn	xræfn
eam	æ͜ɑːm
pawa	pɑːwɑ
oferseon	oferse͜oːn
blætan	blæːtɑn
steor	ste͜oːr
undeop	unde͜oːp
scortlice	ʃortliːt͡ʃe
swaþrian	swɑθriɑn
fysian	fyːsiɑn
geleafa	jelæ͜ɑːfɑ
openung	openunɡ
colsweart	kolswæ͜ɑrt
burgræden	burɡræːden
portgerefa	portjereːfɑ
wrohtsawere	wroːxtsɑːwere
efen	efen
syferness	syːferness
pirige	pirije
tæc	tæːt͡ʃ
gelome	jeloːme
orsorgleas	orsorɡlæ͜ɑːs
forþgewitan	forθjewiːtɑn
efeneardian	efenæ͜ɑrdiɑn
leoflic	le͜oːfliːt͡ʃ
wæps	wæps
sweþel	sweθel
befæstan	befæstɑn
bebrecan	bebrekɑn
griþ	ɡriθ
slepan	sleːpɑn
ealdorlease	æɑ̯ldorlæːɑ̯se
eorclanstan	e͜orklɑnstɑːn
gangweg	ɡɑnɡwej
gedwola	jedwolɑ
spanu	spɑnu
hal	xɑːl
hlimme	xlimme
holegn	xolejn
niwe	niːwe
gen	jeːn
clipiendlic	klipiendliːt͡ʃ
uhtceare	uːhtt͡ʃæːɑ̯re
hiwcund	xiːwkund
tæcung	tæːt͡ʃunɡ
wurma	wurmɑ
hos	xoːs
wintrig	wintrij
beamweg	bæ͜ɑːmwej
wintergeweorp	winterjewe͜orp
claþas	klɑːθɑs
gealdor	jæ͜ɑldor
corona	koroːnɑ
wæstmbærnes	wæstmbæːrnes
ræs	ræːs
bocgestreon	boːkjestre͜oːn
webbestre	webbestre
sceawung	ʃæ͜ɑːwunɡ
toþsticca	toːθstikkɑ
edlæcung	edlæːt͡ʃunɡ
eafera	æ͜ɑferɑ
giellan	ji͜yllɑn
abroþennes	ɑːbroθennes
foda	foːdɑ
begbeam	bejbæ͜ɑːm
ifig	iːfij
ferht	ferxt
gefeallan	jefæ͜ɑllɑn
geþeodan	jeθe͜oːdɑn
gewemmend	jewemmend
wælniþ	wælniːθ
pinca	pinkɑ
wohbogen	woːxboɡen
reohhe	re͜oxxe
sellend	sellend
syfre	syːfre
ungehiersum	unjexi͜yːrsum
hygerof	xyjeroːf
uncumliþe	unkumliːθe
synderlic	synderliːt͡ʃ
fellan	fellɑn
eom	eo̯m
hafuc	xɑfuk
ymblocian	ymbloːkiɑn
heofon	xe͜ofon
fifteoþa	fiːfte͜oːθɑ
lutan	luːtɑn
bogan	boɡɑn
ciricwæd	t͡ʃirit͡ʃwæːd
forcel	forkel
ellærn	ellærn
diernan	di͜yrnɑn
ascacan	ɑːʃɑkɑn
woma	woːmɑ
sefte	seːfte
wodnesdæg	woːdnesdæj
ahabban	ɑːxɑbbɑn
geeardian	jeæ͜ɑrdiɑn
wiþercrist	wiθerkrist
frinan	friːnɑn
mearn	mæɑrn
froforgast	froːforɡɑːst
scriþaþ	ʃriːθɑθ
cealc	t͡ʃæ͜ɑlk
rædbora	ræːdborɑ
fleos	fle͜oːs
fæs	fæs
pal	pɑːl
ymblyt	ymblyt
brord	brord
reordon	re͜ordon
denn	denn
ingefeoht	injefe͜oxt
faroþ	fɑroθ
mimming	mimminɡ
fliete	fli͜yːte
cuþ	kuːθ
motan	moːtɑn
monanniht	moːnɑnnixt
þrostle	θrostle
sliefe	sli͜yːfe
wyrgþu	wyrɡθu
getreowe	jetre͜oːwe
glof	ɡloːf
meredeaþ	meredæ͜ɑːθ
glædman	ɡlædmɑn
feorhscyldig	fe͜orxʃyldij
sarig	sɑːrij
furþum	furθum
hlaforddom	xlɑːforddoːm
borg	borɡ
ceapmann	t͡ʃæ͜ɑːpmɑnn
heonan	xe͜onɑn
hoc	xok
gemanigfealdian	jemɑnijfæ͜ɑldiɑn
friþotacen	friθotɑːken
secg	sejj
miscweþan	miskweθɑn
smocian	smokiɑn
spræcleas	spræːt͡ʃlæ͜ɑːs
fæc	fæk
trendel	trendel
slipor	slipor
scieldweall	ʃi͜yldwæ͜ɑll
romfeoh	roːmfe͜ox
unwealt	unwæ͜ɑlt
eastermonaþ	æ͜ɑːstermoːnɑθ
seolfcwalu	se͜olfkwɑlu
ultor	ultor
anmedla	ɑnmedlɑ
wilian	wiliɑn
onmearcung	onmæ͜ɑrkunɡ
bysnian	bysniɑn
nihtlic	nixtliːt͡ʃ
ofersendan	ofersendɑn
lybb	lybb
wiþsacan	wiθsɑkɑn
iudeisc	juːdeːiʃ
gebeorg	jebe͜orɡ
dælniman	dæːlnimɑn
aþexe	ɑːθekse
grap	ɡrɑːp
gryre	ɡryre
predicere	predikere
wæflian	wæfliɑn
spellian	spelliɑn
inca	inkɑ
widuwe	widuwe
gesomnian	jesomniɑn
atr	ɑːtr
simbel	simbel
sweor	swe͜oːr
þorn	θorn
geoguþ	juɡuθ
simble	simble
twihycgan	twixyjjɑn
stredan	streːdɑn
beflowan	befloːwɑn
winstre	winstre
gebeorc	jebe͜ork
efencempa	efenkempɑ
beo	be͜oː
dilegian	dileɡiɑn
scipian	ʃipiɑn
hungor	xunɡor
geþeaht	jeθæ͜ɑxt
wacan	wɑkɑn
fox	foks
coss	koss
æcern	æːkern
glæde	ɡlæde
gewyscan	jewyːʃʃɑn
wæn	wæːn
menigu	meniju
hiwcuþ	xiːwkuːθ
bindan	bindɑn
frocga	froɡɡɑ
hamsteall	xɑːmstæ͜ɑll
clucge	kluɡɡe
ondrædan	ondræːdɑn
fleotan	fle͜oːtɑn
gefædera	jefæderɑ
wuduælfen	wuduælfen
bedyppan	bedyppɑn
hierdan	xi͜yrdɑn
wyrmcynn	wyrmkynn
sawelberend	sɑːwelberend
forebisgian	forebisjiɑn
hæmedceorl	xæːmedt͡ʃe͜orl
forbeodan	forbe͜oːdɑn
uhta	uːxtɑ
forþbringan	forθbrinɡɑn
eowan	e͜oːwɑn
wyrcend	wyrt͡ʃend
helrynegu	xelryːneju
bald	bɑld
lig	liːj
gehygd	jexyjd
liegfæmende	li͜yːjfæːmende
sinder	sinder
unripe	unriːpe
ciegan	t͡ʃi͜yːjɑn
morað	moːrɑθ
gedælan	jedæːlɑn
hefiglice	xefijliːt͡ʃe
midsumor	midsumor
weard	wæ͜ɑrd
ricsiend	riːksiend
andustrigan	ɑnduːstrijɑn
beod	be͜oːd
eaþ	æ͜ɑːθ
befæstnian	befæstniɑn
eahtoþa	æ͜ɑxtoθɑ
onhycgan	onxyɡɡɑn
sceawere	ʃæ͜ɑːwere
seax	sæ͜ɑks
reord	re͜ord
iewan	i͜yːwɑn
wierþe	wi͜yrθe
liegdraca	li͜yːjdrɑkɑ
hæfern	xæfern
lysu	lysu
eagan	æ͜ɑːɡɑn
gleawceasterscir	ɡlæ͜ɑːwt͡ʃæ͜ɑsterʃiːr
franca	frɑnkɑ
centland	kentlɑnd
wrecend	wrekend
loþa	loθɑ
gleawlic	ɡlæ͜ɑːwliːt͡ʃ
sæmann	sæːmɑnn
bræmel	bræːmel
cylu	kylu
gimm	jimm
þencan	θent͡ʃɑn
frosc	froʃ
wohful	woːxful
mynetere	mynetere
befealdan	befæ͜ɑldɑn
fician	fikiɑn
hra	xrɑː
sol	sol
mealm	mæ͜ɑlm
wascan	wɑskɑn
stanrocc	stɑːnrokk
norþweg	norθwej
sacaþ	sɑkɑθ
gleng	ɡlenɡ
þurhdufan	θurxduːfɑn
hlihhan	xlixxɑn
swencan	swent͡ʃɑn
giemeleast	ji͜yːmelæ͜ɑːst
tilian	tiliɑn
feola	fe͜olɑ
alibbend	ɑlibbend
streaw	stræ͜ɑːw
hlemman	xlemmɑn
fricgan	frijjɑn
bædaþ	bæːdɑθ
binnan	binnɑn
þurfan	θurfɑn
gesecan	jeseːt͡ʃɑn
ripst	riːpst
belendan	belendɑn
ungescead	unjeʃɑːd
sorhful	sorxful
gelæfan	jelæːfɑn
bymere	byːme
fleoge	fle͜oːɡe
ia	jɑː
togian	toɡiɑn
rim	riːm
sceon	ʃoːn
wohhian	woxxiɑn
bewyrcan	bewyrt͡ʃɑn
astandan	ɑːstɑndɑn
eornost	e͜ornost
cot	kot
ofteon	ofte͜oːn
hris	xriːs
campwisa	kɑmpwiːsɑ
fisclacu	fiʃlɑku
mengu	menju
garleac	ɡɑːrlæ͜ɑːk
hlæfdige	xlæːfdiːje
forgiemeleasnes	forji͜yːmelæ͜ɑːsnes
scyttan	ʃyttɑn
togeanes	toːjæ͜ɑːnes
aþum	ɑːθum
otor	otor
ciþ	t͡ʃiːθ
modstaþolnes	moːdstɑθolnes
andgitfullice	ɑndjitfulliːt͡ʃe
fiþerleas	fiθerlæ͜ɑːs
bestandan	bestɑndɑn
borian	boriɑn
wilde	wilde
getacniendlic	jetɑːkniendliːt͡ʃ
hwider	xwider
innera	innerɑ
turf	turf
mannleas	mɑnnlæ͜ɑːs
man	mɑnn
andcwiss	ɑndkwiss
from	from
edwendan	edwendɑn
temesian	temesiɑn
bisæcc	biːsætt͡ʃ
migan	miːɡɑn
fyrgengat	fyrjenɡɑːt
wæpnhus	wæːpnxuːs
openears	openæ͜ɑrs
ciese	t͡ʃi͜yːse
æbs	æbs
þrimilce	θrimilt͡ʃe
maþelode	mɑθelode
gefed	jefeːd
fagnian	fɑɡniɑn
fealdan	fæ͜ɑldɑn
leaf	læ͜ɑːf
widherian	wiːdxerjɑn
for	foːr
uhtcaru	uːxtkɑru
ost	oːst
net	net
wuldor	wuldor
frecen	freːken
unwindan	unwindɑn
hwistlian	xwistliɑn
forsecan	forseːt͡ʃɑn
besema	besemɑ
dwæscan	dwæːʃʃɑn
tiegan	ti͜yːjɑn
bycgen	byjjen
hig	xiːj
æfest	æfest
oncyrran	ont͡ʃyrrɑn
hunta	xuntɑ
godlic	ɡodliːt͡ʃ
gos	ɡoːs
gecocnian	jekoːkniɑn
feorbuend	fe͜orbuːend
recen	ret͡ʃen
upp	upp
eorþlic	e͜orθliːt͡ʃ
geondsprengan	je͜ondsprenjɑn
cepan	keːpɑn
racentum	rɑkentum
hopa	xopɑ
hnoll	xnoll
scand	ʃɑnd
onsteall	onstæ͜ɑll
tocyme	toːkyme
insendan	insendɑn
flat	flɑːt
hloþere	xloːθere
gescufan	jeʃuːfɑn
smicer	smiker
soþgiedd	soːθji͜ydd
syl	syːl
þurhwrecan	θurxwrekɑn
wæpn	wæːpn
fordwinan	fordwiːnɑn
tweo	twe͜oː
beag	bæ͜ɑːɡ
gathyrde	ɡɑːtxyrde
æþelboren	æθelboren
asciendlic	ɑːskiendliːt͡ʃ
giemeleasian	ji͜yːmelæ͜ɑːsiɑn
writan	wriːtɑn
gemyntan	jemyntɑn
fallan	fɑllɑn
drygan	dryːjɑn
neahgebur	næ͜ɑːxjebuːr
insiht	insixt
þritig	θriːtij
þuhsian	θuxsiɑn
leogere	le͜oːɡere
iermþ	i͜yrmθ
wuduwasa	wuduwɑːsɑ
wær	wæːr
hrincg	xrinɡɡ
clifstan	klifstɑːn
ece	et͡ʃe
seofontiene	se͜ofonti͜yːne
uncuþ	unkuːθ
niwellic	niwelliːt͡ʃ
writ	writ
onwendan	onwendɑn
solian	soliɑn
nefene	nefene
bret	bret
nosþyrel	nosθyːrel
geondsceawian	je͜ondskæ͜ɑːwiɑn
hæcce	xække
eoh	e͜ox
lad	lɑːd
foregan	foreɡɑːn
sacleas	sɑklæ͜ɑːs
nihtscada	nixtʃɑdɑ
andwyrdan	ɑndwyrdɑn
befeallan	befæ͜ɑllɑn
sparian	spɑriɑn
rædan	ræːdɑn
cræftig	kræftij
tohweorfan	toːxwe͜orfɑn
ascinan	ɑːʃiːnɑn
hwierfan	xwi͜yrfɑn
twæming	twæːminɡ
wehha	wexxɑ
abreoþan	ɑːbre͜oːθɑn
haligern	xɑːlijern
wæsp	wæsp
snotingaham	snotinɡɑxɑːm
fiþerbære	fiθerbæːre
clawan	klɑwɑn
hathiertan	xɑːtxi͜yrtɑn
toteon	toːte͜oːn
forsace	forsɑke
yþlad	yːθlɑːd
swefan	swefɑn
modþracu	moːdθrɑku
lænan	læːnɑn
arian	ɑːriɑn
stilnes	stilnes
rosen	roːsen
mierce	mi͜yrt͡ʃe
forgangan	forɡɑnɡɑn
mærsungtima	mæːrsunɡtiːmɑ
hreowlic	xre͜oːwliːt͡ʃ
fryhtu	fryxtu
wudere	wudere
abredwian	ɑːbredwiɑn
gebrucan	jebruːkɑn
wemman	wemmɑn
pocca	pokkɑ
unrihthæmed	unrixtxæːmed
bolgenmod	bolɡenmoːd
samodwyrcende	sɑmodwyrt͡ʃende
bece	beːt͡ʃe
beceorfan	bet͡ʃe͜orfɑn
al	ɑːl
gemede	jemeːde
þancweorþ	θɑnkwe͜orθ
sixfeald	siksfæ͜ɑld
randbeag	rɑndbæ͜ɑːɡ
twifere	twifeːre
miltsian	miltsiɑn
wohhandede	woːxxɑndede
brimliþend	brimliːθend
oþcyrran	oθt͡ʃyrrɑn
bereofan	bere͜oːfɑn
cearful	t͡ʃæ͜ɑrful
spadu	spɑdu
seocnes	se͜oːknes
herebeacen	xerebæ͜ɑːken
scendan	ʃendɑn
ascafan	ɑːʃɑfɑn
æl	æːl
wlencan	wlent͡ʃɑn
fyrest	fyrest
orleghwil	orlejxwiːl
hætt	xætt
cigan	t͡ʃiːjɑn
hænep	xænep
mægþhad	mæːjθxɑːd
æleputa	æːlepuːtɑ
mapuldor	mɑpuldor
æne	æːne
ganra	ɡɑnrɑ
æþelcyning	æθelkyninɡ
seolhyþa	se͜olxyːθɑ
hehþ	xeːxθ
leornungcniht	le͜ornunɡknixt
maguþegn	mɑɡuθejn
eftcierran	eftt͡ʃi͜yrrɑn
læst	læːst
pund	pund
nyllan	nyllɑn
clawan	klɑːwɑn
weorcræden	we͜orkræːden
geondstredan	je͜ondstreːdɑn
demend	deːmend
beran	berɑn
filmen	filmen
beblawan	beblɑːwɑn
utdragan	uːtdrɑɡɑn
gesælan	jesæːlɑn
giedding	ji͜yddinɡ
wiþersæc	wiθersæk
nytlicnes	nytliːt͡ʃnes
þystrian	θyːstriɑn
heafodece	xæ͜ɑːfodet͡ʃe
þræl	θræːl
winterrim	winterriːm
ymbcierran	ymbt͡ʃi͜yrrɑn
suþerne	suːθerne
geliþan	jeliːθɑn
wendan	wendɑn
unc	unk
discipul	diʃʃipul
hælend	xæːlend
flæscmete	flæːʃmete
fenix	feːniks
abroþennys	ɑːbroθennys
heafoc	xæ͜ɑfok
hæte	xæːte
fleogenda	fle͜oːɡendɑ
handgewrit	xɑndjewrit
moþfreten	moθfreten
leccan	lett͡ʃɑn
kyning	kyninɡ
bi	biː
freondræden	fre͜oːndræːden
hie	xi͜yː
þurhteon	θurxte͜oːn
ende	ende
wela	welɑ
sangcræft	sɑnɡkræft
nafola	nɑfolɑ
wunnon	wunnon
eftcyrran	eftt͡ʃyrrɑn
gemynd	jemynd
forsellan	forsellɑn
gehnycned	jehnykned
myrge	myrje
seldcuþ	seldkuːθ
hæfen	xæfen
bolt	bolt
gesewenlic	jesewenliːt͡ʃ
elp	elp
beweddian	beweddiɑn
geþicfieldan	jeθikfi͜yldɑn
ielde	i͜ylde
pipdream	piːpdræ͜ɑːm
cyren	t͡ʃyren
sealtan	sæ͜ɑltɑn
hliehhan	xli͜yxxɑn
guþbyrne	ɡuːθbyrne
forgietan	forji͜ytɑn
deofolseocnes	de͜oːfolse͜oːknes
swige	swiːje
nytan	nytɑn
wolnes	woːlnes
grecland	ɡreːklɑnd
mætan	mæːtɑn
frox	froks
orgel	orɡel
speld	speld
ben	ben
nearones	næ͜ɑrones
clawian	klɑwiɑn
mægelan	mæjelɑn
heard	xæ͜ɑrd
frambugan	frɑmbuːɡɑn
tife	tife
behof	bexoːf
byldan	byldɑn
fyrmest	fyrmest
hicel	xikel
foxhol	foksxol
forcyrring	fort͡ʃyrrinɡ
forloren	forloren
beofung	be͜ofunɡ
ryge	ryje
strand	strɑnd
menigeo	menijo
gieme	ji͜yːme
onhreran	onxreːrɑn
gyden	ɡyden
ful	fuːl
begrætan	beɡræːtɑn
dræn	dræːn
wuldornyttung	wuldornyttunɡ
weodmonaþ	we͜oːdmoːnɑθ
scamu	ʃɑmu
nigon	nijon
uferian	uferiɑn
eaca	æ͜ɑːkɑ
undeadlicnes	undæ͜ɑːdliːknes
edniewan	edni͜yːwɑn
gefær	jefæːr
lettan	lettɑn
uþmæte	uːθmæːte
lif	liːf
hwælhuntoþ	xwælxuntoθ
þisses	θisses
synbot	synboːt
luftacen	luftɑːken
ahierding	ɑːxi͜yrdinɡ
gyltig	ɡyltij
tudor	tuːdor
feaxnett	fæ͜ɑksnett
beobread	be͜oːbræ͜ɑːd
gestandan	jestɑndɑn
efenhleoþor	efenxle͜oːθor
ear	æ͜ɑːr
æcermann	ækermɑnn
wearnian	wæ͜ɑrniɑn
aþencan	ɑːθent͡ʃɑn
eorp	e͜orp
hiwisc	xiːwiʃ
upcund	upkund
droflic	droːfliːt͡ʃ
ymbstandend	ymbstɑndend
gedæfte	jedæfte
nægel	næjel
edlesendlic	edlesendliːt͡ʃ
oferlæfan	oferlæːfɑn
larlyst	lɑːrlyːst
æthealdan	ætxæ͜ɑldɑn
gewuldorfullian	jewuldorfulliɑn
rod	roːd
feorða	fe͜oːrθɑ
ælmiht	ælmixt
freolic	fre͜oːliːt͡ʃ
bryce	bryt͡ʃe
læden	læːden
dwild	dwild
wærwyrde	wærwyrde
drepan	drepɑn
tinclian	tinkliɑn
ic	it͡ʃ
domhus	doːmxuːs
paþas	pɑθɑs
cæggian	kæːɡɡiɑn
cræftleas	kræftlæ͜ɑːs
scytelfinger	ʃytelfinɡer
wendelsæ	wendelsæː
nyþernes	nyθernes
unlucan	unluːkɑn
lambru	lɑmbru
cycen	kyt͡ʃen
animan	ɑːnimɑn
tosundrian	toːsundriɑn
embwlatian	embwlɑːtiɑn
nemnigendlic	nemnijendliːt͡ʃ
ciricland	t͡ʃirit͡ʃlɑnd
heodæg	xe͜oːdæj
cynehelm	kynexelm
eode	eːo̯de
ascung	ɑːskunɡ
berige	berije
blandan	blɑndɑn
forsprecan	forsprekɑn
metesocn	metesoːkn
sweoster	swe͜oster
mangung	mɑnɡunɡ
inne	inne
losian	losiɑn
uncit	uŋkit
wesende	wesende
gewyscing	jewyːʃʃinɡ
flasce	flɑske
beclipian	beklipiɑn
normandig	normɑndij
cisel	t͡ʃisel
afulic	ɑfuliːt͡ʃ
sige	sije
leogan	le͜oːɡɑn
ymbhon	ymbxoːn
alegd	ɑːlejd
wiþbregdan	wiθbrejdɑn
clæppan	klæppɑn
geseon	jese͜oːn
eorþfæt	e͜orθfæt
eadbeald	æ͜ɑːdbæ͜ɑld
beþencan	beθent͡ʃɑn
liegetu	li͜yːjetu
byre	byːre
ætiewan	æti͜yːwɑn
bilewit	bilewit
carles	kɑrles
casere	kɑːsere
dweleþ	dweleθ
giet	ji͜yːt
ymbweorpan	ymbwe͜orpɑn
willian	williɑn
onscogan	onʃoːjɑn
runa	ruːnɑ
lange	lɑnɡe
miswritan	miswriːtɑn
delfan	delfɑn
scotfreo	skotfre͜oː
bewarian	bewɑriɑn
ancuman	ɑnkumɑn
wynfull	wynfull
bochus	boːkxuːs
gelp	jelp
untwifeald	untwifæ͜ɑld
lec	leːk
winterwylle	winterwylle
woda	woːdɑ
hindan	xindɑn
ofstandan	ofstɑndɑn
acwolen	ɑːkwolen
hwitel	xwiːtel
oþþingian	oθθinɡiɑn
sceaphierde	ʃæ͜ɑːpxi͜yrde
gelæran	jelæːrɑn
bereafian	beræ͜ɑːfiɑn
þiccet	θikket
up	up
hlud	xluːd
gesceaft	jeʃæ͜ɑft
þas	θɑːs
gestreon	jestre͜oːn
worn	worn
dream	dræ͜ɑːm
andian	ɑndiɑn
soþgied	soːθji͜yd
foregengel	foreɡenjel
munuc	munuk
writaþ	wriːtɑθ
bebod	bebod
roccian	rokkiɑn
winnan	winnɑn
geweorþan	jewe͜orθɑn
hloþbot	xloːθboːt
wang	wɑnɡ
wolbryne	woːlbryne
sweord	swe͜ord
tumbian	tumbiɑn
geswencan	jeswent͡ʃɑn
asundrodlic	ɑːsundrodliːt͡ʃ
inylfe	inylfe
notu	notu
bicnol	biːt͡ʃnol
wean	wæ͜ɑːn
dyne	dyne
beocere	be͜oːkere
flocc	flokk
scortian	ʃortiɑn
sex	seks
faru	fɑru
scyldigian	ʃyldiɡiɑn
cinan	t͡ʃiːnɑn
writere	wriːtere
yþmere	yːθmere
begreosan	beɡre͜oːsɑn
spearwa	spæ͜ɑrwɑ
gangere	ɡɑnɡere
onbæc	onbæk
loc	loːk
andlang	ɑndlɑnɡ
orðonc	orθonk
sweofot	swe͜ofot
utlæs	uːtlæːs
healm	xæ͜ɑlm
sæliþend	sæːliːθend
þeowdom	θe͜oːwdoːm
sunnanæfen	sunnɑnæːfen
eþelstow	eːθelstoːw
tuxas	tuːksɑs
niewnes	ni͜yːwnes
fæhþbot	fæːxθboːt
gehðu	jexθu
ceosung	t͡ʃe͜oːsunɡ
flota	flotɑ
behealdan	bexæ͜ɑldɑn
freolsiend	fre͜oːlsiend
merscig	merʃij
long	lonɡ
godcund	ɡodkund
hlid	xlid
togædre	toːɡædere
git	jit
rowan	roːwɑn
deaþscyldig	dæ͜ɑːθʃyldij
eleberge	eleberje
fricu	friku
acsung	ɑːksunɡ
liegfyr	li͜yːjfyːr
eadesa	æ͜ɑdesɑ
hræd	xræd
cyþan	kyːθɑn
cancer	kɑnker
spittan	spittɑn
renscur	reːnʃuːr
weler	weler
abraham	ɑbrɑxɑm
sealtian	sæ͜ɑltiɑn
mid	mid
wealh	wæ͜ɑlx
hælan	xæːlɑn
raredumle	rɑːredumle
acennedlic	ɑːkennedliːt͡ʃ
wyrm	wyrm
enlihtan	enliːxtɑn
hæþendom	xæːθendoːm
fegan	feːjɑn
ofost	ofost
blotmonaþ	bloːtmoːnɑθ
æced	æt͡ʃed
hwicce	xwitt͡ʃe
receleas	reːt͡ʃelæ͜ɑːs
æwan	æːwɑn
wiglere	wiɡlere
næht	næxt
winterceald	wintert͡ʃæ͜ɑld
wifhired	wiːfxiːred
fultumleas	fultumlæ͜ɑːs
gedwol	jedwol
hæmedscipe	xæːmedʃipe
begangan	beɡɑnɡɑn
hamleas	xɑːmlæ͜ɑːs
cwild	kwild
ded	deːd
biblioþece	bibli͜uθeːke
edstaþelian	edstɑθeliɑn
leasere	læ͜ɑːsere
wyrt	wyrt
bil	bil
utanlandes	uːtɑnlɑndes
nan	nɑːn
cwelaþ	kwelɑθ
wæscan	wæskɑn
þæc	θæk
nigoþa	nijoθɑ
siþfæt	siːθfæt
windruncen	wiːndrunken
hleoþrung	xle͜oːθrunɡ
nigonteoþa	nijonte͜oːθɑ
todreosan	toːdre͜oːsɑn
halignys	xɑːlijnys
sped	speːd
unscrydan	unʃryːdɑn
wacu	wɑku
wicce	witt͡ʃe
beado	bæ͜ɑdo
biddan	biddɑn
magu	mɑɡu
wreon	wre͜oːn
brastlian	brɑstliɑn
hramma	xrɑmmɑ
scyldleas	ʃyldlæ͜ɑːs
stæfleahtor	stæflæ͜ɑxtor
gyme	jyːme
wangtoþ	wɑnɡtoːθ
forneah	fornæ͜ɑːx
sibb	sibb
ymbhweorfan	ymbxwe͜orfɑn
giemeleasnes	ji͜yːmelæ͜ɑːsnes
wiþceosan	wiθt͡ʃe͜oːsɑn
arædan	ɑːræːdɑn
ciricfultum	t͡ʃirit͡ʃfultum
feldlic	feldliːt͡ʃ
tunglere	tunɡlere
byþ	byθ
eallswa	æ͜ɑllswɑː
leoden	le͜oːden
bysnigan	bysnijɑn
freoþuwebba	fre͜oθuwebbɑ
hremig	xreːmij
toætiecnes	toːæti͜yːt͡ʃnes
sticca	stikkɑ
forþgestigan	forθjestiːɡɑn
scottisc	skottiʃ
steopcild	ste͜oːpt͡ʃild
aþeotan	ɑːθe͜oːtɑn
hran	xrɑn
swan	swɑn
rinc	rink
eagæppel	æ͜ɑːɡæppel
gefer	jefeːr
hyf	xyːf
tiger	tiɡer
ciricragu	t͡ʃirit͡ʃrɑɡu
mircels	mirt͡ʃels
winhate	wiːnxɑːte
wucu	wuku
æþelcund	æθelkund
seod	se͜oːd
ligetsliht	liːjetslixt
fylþu	fyːlθu
sælan	sæːlɑn
geedfreolsian	jeedfre͜oːlsiɑn
deorwente	de͜orwente
begeotan	beje͜oːtɑn
merefisc	merefiʃ
mamrian	mɑːmriɑn
hriman	xriːmɑn
godscyldig	ɡodʃyldij
begieman	beji͜yːmɑn
fleohtan	fle͜oxtɑn
hereweg	xerewej
ifiht	iːfixt
oxnaford	oksnɑford
bitter	bitter
fulfremed	fulfremed
geþing	jeθinɡ
salor	sɑlor
gescad	jeʃɑːd
togeiecendlic	toːjei͜yːt͡ʃendliːt͡ʃ
freond	fre͜oːnd
guþrof	ɡuːθroːf
halh	hɑlx
wolgewinn	woːljewinn
sælþ	sæːlθ
þunrian	θunriɑn
fiscere	fiʃʃere
efensecgan	efensejjɑn
agnian	ɑːɡniɑn
bestyman	bestyːmɑn
wiþstandan	wiθstɑndɑn
cynferð	kynferθ
gador	ɡɑdor
inferan	infeːrɑn
norþanhymbre	norθɑnxymbre
giestranæfen	ji͜ystrɑnæːfen
gefeah	jefæɑx
wearr	wæ͜ɑrr
gespelia	jespeliɑ
þeah	θæ͜ɑːx
ordwulf	ordwulf
æglæca	æːɡlæːt͡ʃɑ
arwe	ɑːrwe
corenscipe	korenʃipe
floccmælum	flokkmæːlum
forberan	forberɑn
fyrhþe	fyrxθe
wlatian	wlɑːtiɑn
bora	borɑ
sengan	senjɑn
unscyld	unʃyld
undersecan	underseːt͡ʃɑn
geol	je͜oːl
bærnan	bærnɑn
eoforwicscir	e͜oforwiːt͡ʃʃiːr
affrica	ɑffrikɑ
gietan	ji͜ytɑn
modignes	moːdijnes
ealdnes	æ͜ɑldnes
stundmælum	stundmæːlum
cysa	kysɑ
hærfestlic	xærfestliːt͡ʃ
brytenlond	brytenlond
forspillan	forspillɑn
earnwulf	æ͜ɑrnwulf
modstaþol	moːdstɑθol
awendan	ɑːwendɑn
besmeagan	besmæ͜ɑːjɑn
byrþen	byrθen
strengest	strend͡ʒest
wa	wɑː
sigor	siɡor
ascrencan	ɑːʃrent͡ʃɑn
eþelmearc	eːθelmæ͜ɑrk
tobrecan	toːbrekɑn
wyrdstæf	wyrdstæf
paddoc	pɑddok
isiþes	iːsiːθes
ungewæpnod	unjewæːpnod
eoten	e͜oten
seoþan	se͜oːθɑn
helm	xelm
dydan	dyːdɑn
ofdune	ofduːne
oferbugan	oferbuːɡɑn
healice	xæ͜ɑːliːt͡ʃe
feltwurma	feltwurmɑ
disc	diʃ
steorfa	ste͜orfɑ
felafeald	felɑfæ͜ɑld
reccan	rett͡ʃɑn
gefan	jefɑn
besniwod	besniːwod
scieran	ʃi͜yrɑn
leodriht	le͜oːdrixt
pæcan	pæːt͡ʃɑn
deaf	dæ͜ɑːf
gemimor	jemimor
ridda	riddɑ
sunnandæg	sunnɑndæj
seþung	seːθunɡ
orlege	orleje
onlucan	onluːkɑn
laurbeam	lɑurbæ͜ɑːm
friclu	friklu
neodlice	ne͜oːdliːt͡ʃe
gierd	ji͜yrd
æwlic	æːwliːt͡ʃ
arisan	ɑːriːsɑn
foresendan	foresendɑn
legere	leːɡere
tæcen	tæːt͡ʃen
pægel	pæjel
heddern	xeːddern
sceafa	ʃæ͜ɑːfɑ
scranc	ʃrɑnk
sul	suːl
eornostlice	e͜ornostliːt͡ʃe
rift	rift
befrignan	befrijnɑn
aryþ	ɑːryːθ
þeodþrea	θe͜oːdθræ͜ɑː
togotennes	toːɡotennes
siftan	siftɑn
maga	mɑɡɑ
hwælhunta	xwælxuntɑ
unnytlice	unnytliːt͡ʃe
gealga	jæ͜ɑlɡɑ
heafodclaþ	xæ͜ɑːfodklɑːθ
holdræden	xoldræːden
fiscoþ	fiskoθ
gescierpt	jeʃi͜yrpt
sælig	sæːlij
punian	puːniɑn
geong	junɡ
fifta	fiːftɑ
masc	mɑːʃ
anlæcan	ɑːnlæːt͡ʃɑn
deag	dæ͜ɑːɡ
sægan	sæːjɑn
yþworian	yːθwoːriɑn
fleax	flæ͜ɑks
æcerweorc	ækerwe͜ork
getriewe	jetri͜yːwe
standan	stɑndɑn
bestieman	besti͜yːmɑn
þurhdrifan	θurxdriːfɑn
bædan	bæːdɑn
forgyman	forjyːmɑn
brædan	bræːdɑn
nillan	nillɑn
badian	bɑːdiɑn
smalan	smɑlɑn
fnæd	fnæd
onbindan	onbindɑn
þissum	θisum
larlic	lɑːrliːt͡ʃ
oxenaford	oksenɑford
larspell	lɑːrspell
nyttol	nyttol
forgymeleasnes	forjyːmelæ͜ɑːsnes
smiþian	smiθiɑn
twifealdnes	twifæ͜ɑldnes
bellan	bellɑn
æþeling	æθelinɡ
hwæg	xwæːj
cirice	t͡ʃirit͡ʃe
forþlædan	forθlæːdɑn
unsawen	unsɑːwen
targa	tɑrɡɑ
staca	stɑkɑ
ætlædan	ætlæːdɑn
godspelbodung	ɡodspelbodunɡ
forweorpan	forwe͜orpɑn
gerihte	jerixte
spedig	speːdij
heofonum	heofonum
beacenfyr	bæ͜ɑːkenfyːr
bensian	beːnsiɑn
snaw	snɑːw
adustrian	ɑduːstriɑn
maþm	mɑːθm
ceahhettan	t͡ʃæ͜ɑxxettɑn
binama	biːnɑmɑ
hedan	xeːdɑn
fremman	fremmɑn
reofan	re͜oːfɑn
hienþu	xi͜yːnθu
wiges	wiːɡes
hrægl	xræjl
þær	θæːr
þwang	θwɑnɡ
dwinan	dwiːnɑn
cweþe	kweθe
swapan	swɑːpɑn
elboga	elboɡɑ
eage	æ͜ɑːɡe
gylt	ɡylt
morbeam	moːrbæ͜ɑːm
wiccedom	witt͡ʃedoːm
bedu	bedu
secgan	sejjɑn
eoferwic	e͜oferwiːt͡ʃ
bidan	biːdɑn
forgiefendlic	forji͜yfendliːt͡ʃ
delf	delf
hunigsmæc	xunijsmæk
unwemming	unwemminɡ
bestingan	bestinɡɑn
nihtsumian	nixtsumiɑn
larboc	lɑːrboːk
cemban	kembɑn
wriþan	wriːθɑn
stanig	stɑːnij
hyrling	xyːrlinɡ
herþbelig	xerθbelij
landmearc	lɑndmæ͜ɑrk
freolsian	fre͜oːlsiɑn
rum	ruːm
onwrecan	onwrekɑn
helan	xelɑn
fennig	fennij
geondswogan	je͜ondswoːɡɑn
iermþu	i͜yrmθu
sixtig	sikstij
duguþ	duɡuθ
þuruh	θurux
hwil	xwiːl
lygen	lyjen
fyrstan	fyːrstɑːn
twelffeald	twelffæ͜ɑld
loh	loːx
seonoþ	se͜onoθ
oferreccan	oferrett͡ʃɑn
scrihan	ʃriːxɑn
el	el
cuþa	kuːθɑ
wifman	wiːfmɑn
ofsceadan	ofʃæ͜ɑːdɑn
steopdohtor	ste͜oːpdoxtor
steman	steːmɑn
agan	ɑːɡɑn
worð	worθ
neah	næ͜ɑːx
gescieppan	jeʃi͜yppɑn
ærendfæst	æːrendfæst
mara	mɑːrɑ
forestandan	forestɑndɑn
ondon	ondoːn
wyrcean	wyrt͡ʃɑn
hwosta	xwoːstɑ
dwellan	dwellɑn
mæran	mæːrɑn
wacian	wɑːkiɑn
sæteresdæg	sæteresdæj
gehatan	jexɑːtɑn
gise	jiːse
þurhbregdan	θurxbrejdɑn
sigehreþig	sijexreːθij
fulwihtan	fulwixtɑn
ascunian	ɑːʃuːniɑn
uterra	uːterrɑ
tæhte	tæːxte
bisæcc	biːsækk
ofgan	ofɡɑːn
godspellbodung	ɡodspelbodunɡ
æht	æːxt
deadlicnes	dæ͜ɑːdliːknes
winterburna	winterburnɑ
feldmore	feldmore
longsum	lonɡsum
wicing	wiːkinɡ
galdor	ɡɑldor
smeagan	smæ͜ɑːjɑn
wynful	wynful
hamelian	xɑmeliɑn
bolla	bollɑ
nebb	nebb
ceorlboren	t͡ʃe͜orlboren
wecgan	wejjɑn
gebetung	jebeːtunɡ
fyr	fyːr
wiersa	wi͜yrsɑ
trahtnian	trɑxtniɑn
blotan	bloːtɑn
gehreran	jexreːrɑn
geon	jon
lira	liːrɑ
onstellan	onstellɑn
bearn	bæ͜ɑrn
hreþig	xreːθij
ahreran	ɑːxreːrɑn
ealhswiþ	æ͜ɑlxswiːθ
godspelboc	ɡodspelboːk
crawe	krɑːwe
gebugan	jebuːɡɑn
wohgeorn	woːxje͜orn
eorþberie	e͜orθberie
weg	wej
godspeltraht	ɡodspeltrɑxt
geancyrr	jæ͜ɑːnt͡ʃyrr
ofsacan	ofsɑkɑn
uhtcearu	uːxtt͡ʃæ͜ɑru
ætrian	æːtriɑn
geap	jæ͜ɑːp
toþleas	toːθlæ͜ɑːs
folcgefeoht	folkjefe͜oxt
incniht	inknixt
solmonaþ	solmoːnɑθ
liffrea	liːffræ͜ɑː
wislemuþa	wiːslemuːθɑ
þreowa	θre͜owɑ
mecgan	mejjɑn
wordsawere	wordsɑːwere
ymbfær	ymbfær
sceamfæst	ʃɑmfæst
ciricburh	t͡ʃirit͡ʃburx
gerisena	jerisenɑ
persoc	persok
heahengel	xæ͜ɑːxenjel
fæmne	fæːmne
syxta	sykstɑ
andwis	ɑndwiːs
wuna	wunɑ
nafela	nɑfelɑ
unmann	unmɑnn
geþingan	jeθinɡɑn
fealg	fæ͜ɑlɡ
onwæcnan	onwæknɑn
gefelan	jefeːlɑn
wixlan	wikslɑn
nigon	niɡon
æwicnes	æːwiknes
frowe	froːwe
wælhreow	wælxre͜oːw
flan	flɑːn
æþelred	æθelred
unsyferness	unsyːferness
gesceadwis	jeʃɑːdwiːs
gebeagian	jebæ͜ɑːɡiɑn
mæst	mæːst
bannan	bɑnnɑn
andswarian	ɑndswɑriɑn
bysenian	byseniɑn
helan	xeːlɑn
meatte	mæ͜ɑtte
bymian	byːmiɑn
ylde	ylde
sealh	sæ͜ɑlx
landriht	lɑndrixt
weallan	wæ͜ɑllɑn
efen	eːfen
glæm	ɡlæːm
þurhbrecan	θurxbrekɑn
samcwic	sɑːmkwik
stream	stræ͜ɑːm
scop	ʃop
wæpnedhand	wæːpnedxɑnd
gewemming	jewemminɡ
gystian	jystiɑn
wæg	wæj
niþre	niθre
onælan	onæːlɑn
geanlæcan	jeɑːnlæːt͡ʃɑn
bleo	ble͜oː
reod	re͜oːd
hwealf	xwæ͜ɑlf
clænne	klæːnne
dæge	dæːje
blowan	bloːwɑn
under	under
anbugan	ɑnbuːɡɑn
wieltan	wi͜yltɑn
purs	purs
camplic	kɑmpliːt͡ʃ
þafian	θɑfiɑn
frig	friːj
sibbleger	sibblejer
ladian	lɑːdiɑn
modorlic	moːdorliːt͡ʃ
þurhsmugan	θurxsmuːɡɑn
niewlice	ni͜yːwliːt͡ʃe
campung	kɑmpunɡ
boda	bodɑ
heafodcirice	ɑnɡelt͡ʃirit͡ʃe
costian	kostiɑn
fandian	fɑndiɑn
baðanceaster	bɑθɑnt͡ʃæ͜ɑster
æcen	æːt͡ʃen
godwebben	ɡodwebben
utscyte	uːtʃyte
scrincan	ʃrinkɑn
hwinan	xwiːnɑn
heorot	xe͜orot
hreosan	xre͜oːsɑn
dælde	dæːlde
ælfadl	ælfɑːdl
þurhetan	θurxetɑn
oððe	oθθe
cneoris	kne͜oːris
þerscold	θerʃold
forgiefan	forji͜yfɑn
earhring	æ͜ɑːrxrinɡ
wynleas	wynlæ͜ɑːs
brycgian	bryjjiɑn
werwulf	werwulf
fnora	fnorɑ
medusetl	medusetl
lireht	liːrext
hyrde	xyːrde
mægeþ	mæːjeθ
abad	ɑːbɑːd
geagnigendlic	jɑːɡnijendliːt͡ʃ
soð	soːθ
þeodgestreon	θe͜oːdjestre͜oːn
behlehhan	bexlexxɑn
heretoga	xeretoɡɑ
iegstream	i͜yːjstræ͜ɑːm
biternes	biternes
wicga	wiɡɡɑ
þorp	θorp
hæfer	xæfer
eaxlegespann	æ͜ɑkslejespɑnn
giestranniht	ji͜ystrɑnnixt
hyll	xyll
tacne	tɑːkne
sierce	si͜yrt͡ʃe
scotland	skotlɑnd
samræden	sɑmræːden
sceal	ʃæɑl
log	loːɡ
acol	ɑːkol
unmæte	unmæːte
nearo	næ͜ɑro
gestaþolung	jestɑθolunɡ
scort	ʃort
fulwihtian	fulwixtiɑn
gedryht	jedryxt
sefa	sefɑ
æce	æt͡ʃe
freondleas	fre͜oːndlæ͜ɑːs
sicettan	sit͡ʃettɑn
hof	xof
wæge	we
sliþe	sliːθe
seolfor	se͜olfor
lucas	lukɑs
felahror	felɑxroːr
openian	openiɑn
hnyte	xnyte
oferhieran	oferxi͜yːrɑn
oferhleoþor	oferxle͜oːθor
cumpæder	kumpæder
rihte	rixte
portcwene	portkwene
geornlice	je͜ornliːt͡ʃe
cwealmbære	kwæ͜ɑlmbæːre
weorþlic	we͜orθliːt͡ʃ
belucan	beluːkɑn
folc	folk
hæftan	xæftɑn
halwœnde	xɑːlwønde
westerne	westerne
ciricstede	t͡ʃirit͡ʃstede
fealcen	fæ͜ɑlken
lac	lɑːk
dal	dɑl
getacnian	jetɑːkniɑn
ælmihtig	ælmixtij
gegaderian	jeɡɑderiɑn
hobanca	xoːbɑnkɑ
heafodling	xæ͜ɑːfodlinɡ
dafenian	dɑfeniɑn
hlehhan	xlexxɑn
geinnian	jeinniɑn
cealf	t͡ʃæ͜ɑlf
lareowlic	lɑːre͜oːwliːt͡ʃ
snoru	snoru
forlidennes	forlidennes
sangere	sɑnɡere
rædere	ræːdere
earh	æ͜ɑrx
abeodan	ɑːbe͜oːdɑn
elreordig	elre͜ordij
hlafhus	xlɑːfxuːs
geondstregdan	je͜ondstrejdɑn
fierd	fi͜yrd
ciricwæcce	t͡ʃirit͡ʃwætt͡ʃe
sigelic	sijeliːt͡ʃ
wea	wæ͜ɑː
goldhord	ɡoldxord
efenmære	efenmæːre
stæg	stæj
unrihtwis	unrixtwiːs
seofoða	se͜ofoθɑ
twinn	twinn
stempan	stempɑn
arstafas	ɑːrstɑfɑs
ciern	t͡ʃi͜yrn
geneat	jenæ͜ɑːt
set	set
ymbe	ymbe
twisla	twislɑ
tulge	tulɡe
hæsel	xæsel
cweðan	kweθɑn
andgietol	ɑndji͜ytol
seaxan	sæ͜ɑksɑn
eorþling	e͜orθlinɡ
geswincdæg	jeswinkdæj
tulge	tulje
elpendbænen	elpendbæːnen
hellegeat	xellejæ͜ɑt
hælþ	xæːlθ
unnytwyrþe	unnytwyrθe
eorþbeofung	e͜orθbe͜ofunɡ
genihtsum	jenixtsum
weorold	we͜orold
æðeling	æθelinɡ
boga	boɡɑ
oþer	oːθer
scyld	ʃyld
fæmende	fæːmende
surnes	suːrnes
monandæg	moːnɑndæj
þrawan	θrɑːwɑn
slege	sleje
blæhæwen	blæːxæːwen
þurhfæstnian	θurxfæstniɑn
gælan	ɡæːlɑn
asecan	ɑːseːt͡ʃɑn
gehwa	jexwɑː
manu	mɑnu
forsoc	forsoːk
gefrignan	jefrijnɑn
gefeoht	jefe͜oxt
deaw	dæ͜ɑːw
swiþost	swiːθost
getwisan	jetwisɑn
þærtogeanes	θæːrtoːjæ͜ɑːnes
cofgod	koːfɡod
ætrig	æːtrij
stanweall	stɑːnwæ͜ɑll
friþlic	friθliːt͡ʃ
myndleas	myndlæ͜ɑːs
botettan	boːtettɑn
hettan	xettɑn
wearg	wæ͜ɑrɡ
gefic	jefik
rinde	rinde
gehyrdan	jexyrdɑn
acierran	ɑːt͡ʃi͜yrrɑn
dogga	doɡɡɑ
nihtgenga	nixtɡenjɑ
æwbryce	æːwbryt͡ʃe
ineardian	inæ͜ɑrdiɑn
adlig	ɑːdlij
hreow	xre͜oːw
sumerhus	sumerxuːs
widmærsung	wiːdmæːrsunɡ
wlencu	wlenku
sieltan	si͜yltɑn
lyswen	lyswen
unforht	unforxt
hrissan	xrissɑn
tyhtere	tyxtere
hwistlere	xwistlere
alda	ɑldɑ
swetnes	sweːtnes
æsc	æʃ
fyndel	fyndel
sceallan	ʃæ͜ɑllɑn
fordrencan	fordrent͡ʃɑn
friþleas	friθlæ͜ɑːs
aþeodan	ɑːθe͜oːdɑn
steopmodor	ste͜oːpmoːdor
acwæle	ɑːkwæːle
toseþan	toːseːθɑn
þider	θider
mund	mund
aliesan	ɑːli͜yːsɑn
læstan	læːstɑn
adlieg	ɑːdli͜yːj
palentlic	pɑlentliːt͡ʃ
firentacen	firentɑːken
nat	nɑːt
clif	klif
tiwesdæg	tiːwesdæj
lagu	lɑɡu
burhbot	burxboːt
getot	jetot
smeart	smæ͜ɑrt
ofergangan	oferɡɑnɡɑn
basnung	bɑːsnunɡ
færgripe	fæːrɡripe
agymeleasian	ɑːjyːmelæ͜ɑːsiɑn
rysel	rysel
blæd	blæːd
forsacende	forsɑkende
ieg	i͜yːj
leoþorun	le͜oːθoruːn
lic	liːt͡ʃ
hnæpp	xnæpp
gieddian	ji͜yddiɑn
bucca	bukkɑ
scearpsiene	ʃæ͜ɑrpsi͜yːne
wintreow	wiːntre͜oːw
mod	moːd
acwinan	ɑːkwiːnɑn
bordclaþ	bordklɑːθ
muscelle	muskelle
eorcnanstan	e͜orknɑnstɑːn
hundseofontig	xundse͜ofontij
bretwalda	bretwɑldɑ
þystre	θyːstre
mæcg	mæjj
preowthwil	pre͜oːwtxwiːl
wrist	wrist
heortece	xe͜ortet͡ʃe
besellan	besellɑn
þeotan	θe͜oːtɑn
fyllan	fyllɑn
weald	wæ͜ɑld
wlisp	wlisp
wyrtruma	wyrtrumɑ
todæg	toːdæj
ciricmærsung	t͡ʃirit͡ʃmæːrsunɡ
yþworiende	yːθwoːriende
todrifan	toːdriːfɑn
lafor	lɑfor
ceorlleas	t͡ʃe͜orllæ͜ɑːs
behleapan	bexlæ͜ɑːpɑn
feolan	fe͜oːlɑn
utera	uːterɑ
nacod	nɑkod
gebyrian	jebyrjɑn
ligyþ	liːjyːθ
cnosl	knoːsl
gearcian	jæ͜ɑrkiɑn
dægfeorm	dæjfe͜orm
hergian	xerɡiɑn
forbugan	forbuːɡɑn
ofergang	oferɡɑnɡ
gelpan	jelpɑn
hær	xæːr
yr	yːr
meteswamm	meteswɑmm
bera	berɑ
dimm	dimm
ofersprædan	oferspræːdɑn
lacan	lɑːkɑn
hundnigontig	xundniɡontij
wealas	wæ͜ɑːlɑs
hælig	xæːlij
nafu	nɑfu
cynde	kynde
sweoras	swe͜orɑs
swæslæcan	swæːslæːt͡ʃɑn
þurhborian	θurxboriɑn
ræt	ræt
waru	wɑru
hyrdel	xyrdel
forþferan	forθfeːrɑn
smeagean	smæ͜ɑːjɑn
gebygan	jebyːjɑn
unseald	unsæ͜ɑld
fliema	fli͜yːmɑ
hatian	xɑtiɑn
mæsse	mæsse
ymbfæreld	ymbfæreld
gecyndboc	jekyndboːk
masc	mɑʃ
elreord	elre͜ord
sceaga	ʃɑɡɑ
nefne	nefne
settan	settɑn
unwæstmbære	unwæstmbæːre
facian	fɑːkiɑn
midþeahtian	midθæ͜ɑxtiɑn
æthrinan	ætxriːnɑn
ah	ɑx
grippan	ɡrippɑn
wadan	wɑdɑn
beorþegu	be͜oːrθeɡu
totwæman	toːtwæːmɑn
leod	le͜oːd
hiwen	xiːwen
bedrincan	bedrinkɑn
teon	te͜oːn
togædere	toːɡædere
ealdseaxan	æ͜ɑldsæ͜ɑksɑn
eaxl	æ͜ɑksl
sæwudu	sæːwudu
weorc	we͜ork
toiecnes	toːi͜yːt͡ʃnes
þryþswiþ	θryːθswiːθ
wenn	wenn
weaxan	wæ͜ɑksɑn
deaþbedd	dæ͜ɑːθbedd
cele	t͡ʃele
cyme	kyːme
eorð	e͜orθ
forsacan	forsɑkɑn
ætwegan	ætweɡɑn
gesoþian	jesoːθiɑn
winterselde	winterselde
ealdmodor	æ͜ɑldmoːdor
oferfæreld	oferfæreld
samod	sɑmod
steorn	ste͜orn
hringedstefna	xrinɡedstefnɑ
blostma	bloːstmɑ
hiersumnes	xi͜yːrsumnes
sceo	ʃe͜oː
dunstan	dunstɑːn
neowellic	ne͜owelliːt͡ʃ
ald	ɑld
tempel	tempel
wom	woːm
cearfullice	t͡ʃæ͜ɑrfulliːt͡ʃe
winterfeorm	winterfe͜orm
cnihthad	knixtxɑːd
friþlice	friθliːt͡ʃe
lædan	læːdɑn
bispellboc	biːspellboːk
sunnlic	sunnliːt͡ʃ
wund	wund
hnæpf	xnæpf
sum	sum
geondleohtend	je͜ondle͜oːxtend
gedwild	jedwild
beogang	be͜oːɡɑnɡ
utlaga	uːtlɑɡɑ
brego	breɡo
togean	toːjæ͜ɑːn
mihtig	mixtij
scefing	ʃeːfinɡ
het	heːt
nosu	nosu
wincel	wint͡ʃel
swætan	swæːtɑn
forebisen	forebiːsen
forþgewiten	forθjewiten
onhabban	onxɑbbɑn
metesacca	metesɑkkɑ
legerteam	lejertæ͜ɑːm
gedwolmann	jedwolmɑnn
uppe	uppe
geoc	jok
swerian	swerjɑn
twiefealdnes	twi͜yfæ͜ɑldnes
ceafor	t͡ʃæ͜ɑfor
leget	leːjet
mandæde	mɑːndæːde
cwene	kweːne
drehte	drehte
egesa	eːɡesɑ
efenhleoþrung	efenxle͜oːθrunɡ
hyrmann	xyːrmɑnn
þe	θeː
befeohtan	befe͜oxtɑn
wederas	wederɑs
cwicseolfor	kwikse͜olfor
lihtan	liːxtɑn
crecisc	kreːkiʃ
becwelan	bekwelɑn
georran	je͜orrɑn
æsce	æʃʃe
acwæl	ɑːkwæl
timpana	timpɑnɑ
forþrysmian	forθrysmiɑn
tieman	ti͜yːmɑn
stician	stikiɑn
guþbord	ɡuːθbord
sowhul	soːwxul
ofer	ofer
wintersetl	wintersetl
hu	xuː
cwæþ	kwæθ
þenian	θeːniɑn
hyge	xyje
gehieran	jexi͜yːrɑn
nicc	nitt͡ʃ
secgsceara	sejjʃɑrɑ
gefegan	jefeːjɑn
bealluc	bæ͜ɑlluk
nihtsum	nixtsum
arwald	ɑrwɑld
ræfan	ræːfɑn
geola	je͜oːlɑ
niewian	ni͜yːwiɑn
clæcleas	klæklæ͜ɑːs
campdom	kɑmpdoːm
regndropa	rejndropɑ
griellan	ɡri͜yllɑn
forsceadan	forʃɑːdɑn
bepæcend	bepæːt͡ʃend
feder	feder
ægwyrt	æːjwyrt
stanfah	stɑːnfɑːx
wintergetæl	winterjetæl
hundteontigoþa	xundte͜oːntiɡoθɑ
igil	ijil
fæhþu	fæːxθu
wafian	wɑfiɑn
turtle	turtle
geseþend	jeseːθend
bemiþan	bemiːθɑn
papa	pɑːpɑ
tonemnan	toːnemnɑn
wurde	wurde
selfæta	selfæːtɑ
liget	liːjet
deaþ	dæ͜ɑːθ
ange	ɑnɡe
bryne	bryːne
husbryne	xuːsbryne
bolster	bolster
hwelcnes	xwelknes
ymbþencan	ymbθent͡ʃɑn
onerian	onerjɑn
racian	rɑkiɑn
gefyllan	jefyllɑn
nic	nit͡ʃ
bysig	bysij
miercels	mi͜yrt͡ʃels
scite	ʃiːte
aþweran	ɑːθwerɑn
astyrian	ɑːstyrjɑn
hwæl	xwæl
ungewiss	unjewiss
gesmeagan	jesmæ͜ɑːjɑn
twentig	tweːntij
lage	lɑɡe
næster	næster
að	ɑːθ
plættan	plættɑn
eower	e͜oːwer
gegyrdan	ɡeɡyrdɑn
giest	ji͜yst
unligne	unliːjne
mægþblæd	mæjθblæd
dung	dunɡ
fatian	fɑtiɑn
tacnian	tɑːkniɑn
undon	undoːn
ærcebiscop	ært͡ʃebiʃʃop
hielfan	xi͜ylfɑn
hræþ	xræθ
woldæg	woːldæj
fielleseocnes	fi͜yllese͜oːknes
æghwylc	æːjxwylt͡ʃ
sepan	seːpɑn
gewita	jewitɑ
ufor	ufor
swicdom	swikdoːm
tiergan	ti͜yrjɑn
forweaxan	forwæ͜ɑksɑn
geoloca	je͜olokɑ
ilfetu	ilfetu
geongling	junɡlinɡ
atol	ɑtol
anfloga	ɑːnfloɡɑ
fifelcynn	fiːfelkynn
stæf	stæf
græse	ɡræse
twih	twiːx
lome	loːme
geac	jæ͜ɑːk
ungefæd	unjefæd
andfenge	ɑndfenje
ofercyrran	ofert͡ʃyrrɑn
pusa	pusɑ
byrðen	byrθen
ciricdor	t͡ʃirit͡ʃdoːr
reoma	re͜omɑ
singan	sinɡɑn
æce	æːt͡ʃe
seldan	seldɑn
færbu	færbu
sioluc	si͜uluk
beswincan	beswinkɑn
gerinnan	jerinnɑn
gelogian	jeloːɡiɑn
fultuman	fultumɑn
frumlida	frumlidɑ
besyrwan	besyrwɑn
nicor	nikor
horh	xorx
wintercearig	wintert͡ʃæ͜ɑrij
geolo	je͜olo
westseaxan	westsæ͜ɑksɑn
welund	welund
inlædan	inlæːdɑn
fleah	flæ͜ɑːx
clingan	klinɡɑn
beow	be͜oːw
worian	woːriɑn
striend	stri͜yːnd
fordælan	fordæːlɑn
æþelwulf	æθelwulf
spearlira	spæ͜ɑrlirɑ
hlystan	xlystɑn
bisnian	bisniɑn
docga	doɡɡɑ
beorþorþinen	be͜orθorθiːnen
forsæcþ	forsækθ
toweardnes	toːwæ͜ɑrdnes
woroldar	woroldɑːr
leafnes	læ͜ɑːfnes
blædnes	blæːdnes
geniedan	jeni͜yːdɑn
wraþ	wrɑːθ
gelyfan	jelyːfɑn
upgang	upɡɑnɡ
bodian	bodiɑn
axian	ɑːksiɑn
geunnan	jeunnɑn
nigonfeald	nijonfæ͜ɑld
hieran	xi͜yːrɑn
eagþyrl	æ͜ɑːɡθyːrl
rida	ridɑ
scedenig	ʃedeniːj
beþeodan	beθe͜oːdɑn
har	xɑːr
ascieppan	ɑːʃi͜yppɑn
wordhord	wordxord
reocan	re͜oːkɑn
onwacan	onwɑkɑn
middaneard	middɑnæ͜ɑrd
stæfcræft	stæfkræft
swinhyrde	swiːnxyrde
tigele	tijele
unlar	unlɑːr
fersc	ferʃ
heafodlic	xæ͜ɑːfodliːt͡ʃ
geondscinan	je͜ondskiːnɑn
aheawan	ɑːxæ͜ɑːwɑn
hlagol	xlɑɡol
ofersceadan	oferʃɑːdɑn
ymbgyrdan	ymbɡyrdɑn
bæddel	bæddel
hlyd	xlyːd
fæderleas	fæderlæ͜ɑːs
læn	læːn
nearanes	næ͜ɑrɑnes
swefn	swefn
læccan	lætt͡ʃɑn
anweald	ɑnwæ͜ɑld
gehweorfan	jexwe͜orfɑn
ræran	ræːrɑn
ara	ɑːrɑ
horcwene	xoːrkwene
daru	dɑru
genihtsumnes	jenixtsumnes
gemænscipe	jemæːnʃipe
eþel	eːθel
syx	syks
halga	xɑːlɡɑ
unwiþmetendlic	unwiθmetendliːt͡ʃ
sæmra	sæːmrɑ
lefan	leːfɑn
weninga	weːninɡɑ
hord	xord
ciricmitta	t͡ʃirit͡ʃmittɑ
sweg	sweːj
strengra	strenɡrɑ
pohha	poxxɑ
ahweorfan	ɑːxwe͜orfɑn
felt	felt
medu	medu
beorht	be͜orxt
staniht	stɑːnixt
licettung	liːt͡ʃettunɡ
lufestre	lufestre
swift	swift
awyrcan	ɑːwyrt͡ʃɑn
biemere	biːeme
tohladan	toːxlɑdɑn
þurhfaran	θurxfɑrɑn
eftniwung	eftniːwunɡ
sugan	suːɡɑn
walhhnutu	wɑlxxnutu
wæpen	wæːpen
agrapian	ɑːɡrɑːpiɑn
cyme	kyme
cumliþian	kumliːθiɑn
eg	eːj
siextigfeald	si͜ykstijfæ͜ɑld
fyst	fyːst
bryten	bryten
bryne	bryne
sunstede	sunstede
fæcele	fækele
ofersceadwian	oferʃɑdwiɑn
nytlice	nytliːt͡ʃe
ymbfaran	ymbfɑrɑn
cocc	kokk
besierwan	besi͜yrwɑn
a	ɑː
hryre	xryre
eorl	e͜orl
blinnan	blinnɑn
getalian	jetɑliɑn
bed	bed
tyhtendlic	tyxtendliːt͡ʃ
clut	kluːt
brycg	bryjj
oter	oter
diacon	diɑːkon
wrecnes	wreknes
musheafoc	muːsxæ͜ɑfok
leoran	le͜oːrɑn
cynd	kynd
unþeaw	unθæ͜ɑːw
gleow	ɡle͜oːw
studu	studu
stund	stund
egsian	ejsiɑn
belgan	belɡɑn
gearlic	jæ͜ɑːrliːt͡ʃ
flitan	fliːtɑn
matheus	mɑteus
glædlice	ɡlædliːt͡ʃe
þurst	θurst
nytennes	nytennes
næse	næse
gemæne	jemæːne
alor	ɑlor
samen	sɑmen
asceadan	ɑːʃɑːdɑn
ondfon	ondfoːn
þærmid	θæːrmid
hire	xire
heaþorinc	xæ͜ɑθorink
geþicgan	jeθiɡɡɑn
sealten	sæ͜ɑlten
hæleþ	xæleθ
geendian	jeendiɑn
cwenlic	kweːnliːt͡ʃ
efenwerod	efenwerod
geanian	jeɑːniɑn
ellen	ellen
templ	templ
bispell	biːspell
langaland	lɑnɡɑlɑnd
dreng	drenɡ
seofonnihte	se͜ofonnixte
twifete	twifeːte
undiere	undi͜yːre
scrincaþ	ʃrinkɑθ
fefor	fefor
hiwian	xiːwiɑn
slingan	slinɡɑn
hnigian	xniɡiɑn
styran	styːrɑn
ansund	ɑnsund
ælmesse	ælmesse
stelan	stelɑn
genog	jenoːɡ
dohtig	doxtij
ætiecan	æti͜yːt͡ʃɑn
andelbære	ɑndelbæːre
ofersawan	ofersɑːwɑn
geswutelian	jeswuteliɑn
geswiþan	jeswiːθɑn
wacol	wɑkol
nemning	nemninɡ
herigendlic	xerijendliːt͡ʃ
bread	bræ͜ɑːd
unhal	unxɑːl
stæpmælum	stæpmæːlum
famblawende	fɑːmblɑːwende
gymeleast	jyːmelæ͜ɑːst
gescead	jeʃɑːd
camb	kɑmb
lixan	liːksɑn
beorgan	be͜orjɑn
gripan	ɡriːpɑn
fadian	fɑdiɑn
inlenda	inlendɑ
hærfestmonaþ	xærfestmoːnɑθ
fus	fuːs
blendan	blendɑn
undersmeagan	undersmæ͜ɑːjɑn
grimman	ɡrimmɑn
blaw	blɑːw
geetan	jeetɑn
innung	innunɡ
wenunga	weːnunɡɑ
toætiecan	toːæti͜yːt͡ʃɑn
cumliþnes	kumliːθnes
edniewinga	edni͜yːwinɡɑ
godspellic	ɡoːdspelliːt͡ʃ
midde	midde
fotlic	foːtliːt͡ʃ
sona	soːnɑ
stælhran	stælxrɑːn
lama	lɑmɑ
nunne	nunne
mennisclic	menniʃliːt͡ʃ
sigegefeoht	sijejefe͜oxt
impian	impiɑn
hrost	xroːst
bodig	bodij
acwilþ	ɑːkwilθ
nasturcium	nɑsturkium
gefeohtdæg	jefe͜oxtdæj
gedwomer	jedwomer
geondyrnan	je͜ondyrnɑn
onfæreld	onfæreld
fyllu	fyllu
gutt	ɡutt
tirgan	tirjɑn
frician	friːkiɑn
earlæppa	æ͜ɑːrlæppɑ
þreotan	θre͜oːtɑn
ystan	yːstɑn
infæreld	infæreld
middes	middes
miscian	miskiɑn
betredan	betredɑn
scræf	ʃræf
growan	ɡroːwɑn
afremdung	ɑːfremdunɡ
gecid	jet͡ʃiːd
augustus	ɑuɡustus
gemanian	jemɑniɑn
min	min
þinen	θiːnen
æscas	æʃʃɑs
hægl	xæjl
heafodpanne	xæ͜ɑːfodpɑnne
sufel	sufel
blacian	blɑːkiɑn
swa	swɑː
stealcung	stæ͜ɑlkunɡ
drægnett	dræjnett
æftercweþan	æfterkweθɑn
domeadig	doːmæ͜ɑːdij
ieldra	iy̯ldrɑ
geomrian	joːmriɑn
genyttian	jenyttiɑn
heteniþ	xeteniːθ
foreceorfan	foret͡ʃe͜orfɑn
adihtan	ɑːdixtɑn
eaþbene	æ͜ɑːθbeːne
tacor	tɑːkor
late	lɑte
hiwcuþlice	xiːwkuːθliːt͡ʃe
mægðe	mæjθe
sweger	swejer
gebur	jebuːr
orsorgness	orsorɡness
gesincan	jesinkɑn
hæbbende	hæbbende
ad	ɑːd
yfele	yfele
hefon	xefon
lim	liːm
healftrendel	xæ͜ɑlftrendel
onhyriend	onxyrjend
granu	ɡrɑnu
gelodwyrt	jelodwyrt
bæðhus	bæθxuːs
lanu	lɑnu
searuhabbend	sæ͜ɑruxɑbbend
cuma	kumɑ
fæge	fæːje
smearcian	smæ͜ɑrkiɑn
forca	forkɑ
alibban	ɑlibbɑn
plumtreow	pluːmtre͜oːw
forbod	forbod
gemittan	jemittɑn
leodgebyrga	le͜oːdjebyrjɑ
wig	wiːj
scinan	ʃiːnɑn
eodor	e͜odor
neol	ne͜oːl
tyhten	tyxten
leoht	le͜oːxt
ægru	æːjru
cristendom	kristendoːm
oflecgan	oflejjɑn
husel	xuːsel
scrud	ʃruːd
mand	mɑnd
igland	iːjlɑnd
gelendan	jelendɑn
uncer	unker
list	list
tahten	tɑːxten
suþ	suːθ
geondflowan	je͜ondfloːwɑn
ragu	rɑɡu
æppelbære	æppelbæːre
hryþerhyrde	xryːθerxyrde
cwiesan	kwi͜yːsɑn
gesmeag	jesmæ͜ɑːɡ
cweme	kweːme
ungleaw	unɡlæ͜ɑːw
cudele	kudele
gegaderung	jeɡɑderunɡ
fordruncnian	fordrunkniɑn
twentigoþa	tweːntiɡoθɑ
hyþ	xyːθ
afon	ɑːfoːn
ecg	ejj
þeodisc	θe͜oːdiʃ
treowlice	tre͜oːwliːt͡ʃe
romanisc	roːmɑːniʃ
fenn	fenn
gingest	jind͡ʒest
swealwe	swæ͜ɑlwe
æmyrge	æːmyrje
þyrst	θyrst
drefend	dreːfend
getæl	jetæl
bispel	biːspel
tynder	tynder
tosceadan	toːʃɑːdɑn
þurhgan	θurxɡɑːn
oftust	oftust
hyllan	xyllɑn
gesetednes	jesetednes
bebaðian	bebɑθiɑn
persoctreow	persoktre͜oːw
æwignes	æːwiɡnes
drenc	drent͡ʃ
synn	synn
gædere	ɡædere
reafian	ræ͜ɑːfiɑn
mæl	mæːl
hreman	xreːmɑn
liþe	liːθe
angelcirice	ɑnɡelt͡ʃirit͡ʃe
treowe	tre͜oːwe
fierst	fi͜yrst
anhaga	ɑːnxɑɡɑ
gripend	ɡriːpend
ofgiefan	ofji͜yfɑn
hiwræden	xiːwræːden
freslond	freːslond
iggoþ	ijjoθ
unmiltsiendlic	unmiltsiendliːt͡ʃ
hladan	xlɑdɑn
mymerian	mymeriɑn
becwæl	bekwæl
muga	muːɡɑ
clipian	klipiɑn
liflic	liːfliːt͡ʃ
gereccan	jerett͡ʃɑn
breostcearu	bre͜oːstt͡ʃæ͜ɑru
foster	foːster
geondsmeagan	je͜ondsmæ͜ɑːjɑn
hengst	xenkst
wiers	wi͜yrs
gediht	jedixt
ruh	ruːx
coc	koːk
carful	kɑrful
wop	woːp
oþcwelan	oθkwelɑn
endeleas	endelæ͜ɑːs
neowelnes	ne͜owelnes
gecnos	jeknos
eþelstol	eːθelstoːl
wid	wiːd
sæweard	sæːwæ͜ɑrd
fyrwit	fyrwit
tocnyssan	toːknyssɑn
þar	θɑːr
timbrung	timbrunɡ
lacnian	lɑːkniɑn
swegelwuldor	swejelwuldor
hlæder	xlæːder
wine	wine
sprecan	sprekɑn
grasian	ɡrɑsiɑn
gemetan	jemetɑn
tunglen	tunɡlen
mæg	mæj
geræde	jeræːde
gilp	jilp
uþwitegung	uːθwiteɡunɡ
gefrunon	jefruːnon
biscoprice	biʃʃopriːt͡ʃe
frefran	freːfrɑn
cwice	kwit͡ʃe
slæpan	slæːpɑn
bewlitan	bewliːtɑn
ealdorleas	æ͜ɑldorlæ͜ɑːs
ciricsang	t͡ʃirit͡ʃsɑnɡ
scipwyrhta	ʃipwyrxtɑ
gleaw	ɡlæ͜ɑːw
lim	lim
bog	boːɡ
mearg	mæ͜ɑrɡ
giedd	ji͜ydd
hol	xol
herigendlice	xerijendliːt͡ʃe
mægþe	mæjθe
lyt	lyːt
æscen	æʃʃen
grunnettan	ɡrunnettɑn
geatan	jæ͜ɑːtɑn
þrotbolla	θrotbollɑ
sceadu	ʃɑdu
sceamfæstness	ʃɑmfæstness
iernan	i͜yrnɑn
þistel	θistel
eaþmodian	æ͜ɑːθmoːdiɑn
landrest	lɑndrest
wiþerhlinian	wiθerxliniɑn
gewegan	jeweɡɑn
asmeagan	ɑːsmæ͜ɑːjɑn
gewyrtian	jewyrtiɑn
horn	xorn
eolet	e͜olet
lufu	lufu
fredan	freːdɑn
ciricweard	t͡ʃirit͡ʃwæ͜ɑrd
leoma	le͜oːmɑ
lang	lɑnɡ
gerar	jerɑːr
orsorg	orsorɡ
acweorna	ɑːkwe͜ornɑ
þurh	θurx
hamettan	xɑːmettɑn
stowlic	stoːwliːt͡ʃ
windig	windij
lenctenadl	lenktenɑːdl
andhweorfan	ɑndxwe͜orfɑn
mæþlan	mæθlɑn
gerd	jerd
ofweorpan	ofwe͜orpɑn
nieht	ni͜yxt
weorþung	we͜orθunɡ
besprecan	besprekɑn
hopian	xopiɑn
bineoþan	bine͜oθɑn
geriman	jeriːmɑn
smiþ	smiθ
gielpan	ji͜ylpɑn
getellan	jetellɑn
micelian	mit͡ʃeliɑn
susl	suːsl
ametendlic	ɑːmetendliːt͡ʃ
wolcen	wolken
cerdic	t͡ʃerdit͡ʃ
fulian	fuːliɑn
behliehhan	bexli͜yxxɑn
huru	xuːru
holen	xolen
east	æ͜ɑːst
dryhten	dryxten
segn	sejn
glidan	ɡliːdɑn
unnytnes	unnytnes
wræþþu	wræːθθu
þeorf	θe͜orf
geondlacan	je͜ondlɑːkɑn
orblede	orbleːde
dic	diːt͡ʃ
nigoþa	niɡoθɑ
mancynn	mɑnkynn
wuldorgifu	wuldorjifu
blanca	blɑnkɑ
forniman	fornimɑn
feoh	fe͜ox
ælle	ælle
swylce	swylt͡ʃe
hlæne	xlæːne
ænlic	æːnliːt͡ʃ
cyning	kyninɡ
wracu	wrɑku
gescildnes	jeʃildnes
ferræden	feːrræːden
þyncþ	θynkθ
agengecyrran	ɑjeːnjet͡ʃyrrɑn
geposu	jeposu
gesiþ	jesiːθ
wolberende	woːlberende
ahatan	ɑːxɑːtɑn
hana	xɑnɑ
pæþ	pæθ
dogor	doːɡor
elra	elrɑ
tungolcræft	tunɡolkræft
misfangen	misfɑnɡen
þearm	θæ͜ɑrm
tam	tɑm
pintreow	piːntre͜oːw
slapian	slɑːpiɑn
geminsian	jeminsiɑn
byrgen	byrjen
wagrift	wɑːɡrift
weden	weːden
cymen	kymen
guþfremmend	ɡuːθfremmend
abufan	ɑbuːfɑn
seox	se͜oks
tægel	tæjel
clæman	klæːmɑn
dreccan	drett͡ʃɑn
glengan	ɡlenjɑn
begietan	beji͜ytɑn
innecund	innekund
oferhycgan	oferxyjjɑn
brytta	bryttɑ
endian	endiɑn
borgian	borɡiɑn
citelian	t͡ʃiteliɑn
gewrit	jewrit
æðelboren	æθelboren
feortan	fe͜ortɑn
bedragan	bedrɑɡɑn
sceaft	ʃæ͜ɑft
feorm	fe͜orm
italia	itɑliɑ
lythwon	lyːtxwoːn
winterhus	winterxuːs
uncamprof	unkɑmproːf
hwa	xwɑː
sweartian	swæ͜ɑrtiɑn
sceon	ʃe͜oːn
forelar	foːrelɑːr
breost	bre͜oːst
gyltend	ɡyltend
spere	spere
mægester	mæjester
þoft	θoft
crawan	krɑːwɑn
toweard	toːwæ͜ɑrd
iecend	i͜yːt͡ʃend
butere	butere
hiere	hiy̯re
acumendlic	ɑːkumendliːt͡ʃ
beacniendlic	bæ͜ɑːkniendliːt͡ʃ
cristen	kristen
ungelic	unjeliːt͡ʃ
fultum	fultum
æboc	æːboːk
steore	ste͜oːre
fiþrian	fiθriɑn
wrecca	wrett͡ʃɑ
þer	θeːr
nyht	nyxt
heofonlic	xe͜ofonliːt͡ʃ
gee	jeː
hemeþe	xemeθe
wisdom	wiːsdoːm
firensynn	firensynn
oneardian	onæ͜ɑrdiɑn
balca	bɑlkɑ
swyþ	swyːθ
lyb	lyb
wohlic	woːxliːt͡ʃ
wiþig	wiːθij
campian	kɑmpiɑn
abelgan	ɑːbelɡɑn
hliep	xli͜yːp
ongietan	onji͜ytɑn
firgengat	firɡenɡɑːt
afremdan	ɑːfremdɑn
cypren	kypren
reaf	ræ͜ɑːf
myltestre	myltestre
uprihte	uprixte
benn	benn
francrice	frɑnkriːt͡ʃe
næron	næːron
manswerian	mɑːnswerjɑn
fiftig	fiːftij
sceadan	ʃæ͜ɑːdɑn
forsewennes	forsewennes
ceorles	t͡ʃe͜orles
stulor	stulor
cwead	kwæ͜ɑːd
getwin	jetwin
staþolfæstnung	stɑθolfæstnunɡ
swiþhelm	swiːθxelm
ceoce	t͡ʃe͜oːke
folcræden	folkræːden
æcced	ætt͡ʃed
dead	dæ͜ɑːd
wealhhafoc	wæ͜ɑlxxɑfok
geo	juː
cipp	t͡ʃipp
gewealcan	jewæ͜ɑlkɑn
lemian	lemiɑn
fordrugian	fordruːɡiɑn
ahliehhan	ɑːxli͜yxxɑn
begen	beːjen
sawere	sɑːwere
æðelcyning	æθelkyninɡ
helmian	xelmiɑn
niþfull	niːθfull
winterscur	winterʃuːr
edniwinga	edniːwinɡɑ
bleaþ	blæ͜ɑːθ
læceseax	læːt͡ʃesæ͜ɑks
gelysan	jelyːsɑn
anginn	ɑnjinn
godspellboc	ɡodspelboːk
gemearcod	jemæ͜ɑrkod
findig	findij
locian	loːkiɑn
fagettan	fɑːɡettɑn
axigendlic	ɑːksijendliːt͡ʃ
ficol	fikol
æfter	æfter
wesend	wesend
had	xɑːd
leac	læ͜ɑːk
ælc	æːlt͡ʃ
cægbora	kæːjborɑ
hwylca	xwylkɑ
asprungennes	ɑːsprunɡennes
sima	siːmɑ
dryhtguma	dryxtɡumɑ
ælareow	æːlɑːre͜oːw
hlifian	xlifiɑn
cliwen	kliːwen
geonddrencan	je͜onddrent͡ʃɑn
æwiscnes	æːwiʃnes
sexred	seksreːd
agrisan	ɑːɡriːsɑn
bosig	boːsij
greotan	ɡre͜oːtɑn
gewlencan	jewlent͡ʃɑn
trymman	trymmɑn
fæmnhad	fæːmnxɑːd
tæppere	tæppere
iergþu	i͜yrjθu
piporian	piporiɑn
lifleas	liːflæ͜ɑːs
tofaran	toːfɑrɑn
ealu	æ͜ɑlu
bocian	boːkiɑn
buc	buk
gewintred	jewintred
dihtian	dixtiɑn
gleawe	ɡlæ͜ɑːwe
pol	poːl
gangern	ɡɑnɡern
flanþracu	flɑːnθrɑku
siexteoþa	si͜ykste͜oːθɑ
tunggelælle	tunɡjelælle
scandhus	ʃɑndxuːs
wisa	wiːsɑ
unswefn	unswefn
cleopian	kle͜opiɑn
gebyrd	jebyrd
mos	mos
anemnan	ɑːnemnɑn
forþgan	forθɡɑːn
wandeweorpe	wɑndewe͜orpe
hat	xɑːt
edcwician	edkwikiɑn
wiþcostian	wiθkostiɑn
scear	ʃæ͜ɑr
blase	blɑse
seo	se͜oː
ielfsciene	i͜ylfʃi͜yːne
plega	pleɡɑ
dreorignes	dre͜oːrijnes
oferridan	oferriːdɑn
singrene	sinɡreːne
innancund	innɑnkund
mil	miːl
est	eːst
steap	stæ͜ɑːp
efenwyrcan	efenwyrt͡ʃɑn
cu	kuː
bewrecan	bewrekɑn
gumcynn	ɡumkynn
oferhleapan	oferxlæ͜ɑːpɑn
bufan	bufɑn
haligmonaþ	xɑːlijmoːnɑθ
lead	læ͜ɑːd
foldbold	foldbold
wit	wit
ran	rɑːn
bæron	bæːron
forscrincan	forʃrinkɑn
forwrecan	forwrekɑn
fordrincan	fordrinkɑn
druncen	drunken
ur	uːr
hreowan	xre͜oːwɑn
laurberige	lɑurberije
gereccednyss	jerett͡ʃednyss
forscyldig	forʃyldij
willa	willɑ
þæm	θæːm
witod	witod
oferbru	oferbruː
spilcan	spilt͡ʃɑn
gecierran	jet͡ʃi͜yrrɑn
fælsian	fæːlsiɑn
werc	werk
dæfte	dæfte
comb	komb
pipor	pipor
wealcan	wæ͜ɑlkɑn
sawel	sɑːwel
foreþencan	foreθent͡ʃɑn
forgnagan	forɡnɑɡɑn
gehæp	jexæp
anlipig	ɑːnliːpij
fyrhþ	fyrxθ
stunt	stunt
æspe	æspe
ungeendiendlic	unjeendi͜yndliːt͡ʃ
brysan	bryːsɑn
wiþcweþan	wiθkweθɑn
unhiersumnes	unxi͜yːrsumnes
breogo	bre͜oɡo
wicu	wiku
scorian	ʃoriɑn
gebæc	jebæk
nafogar	nɑfoɡɑːr
niþgrimm	niːθɡrimm
forswerian	forswerjɑn
smeag	smæ͜ɑːɡ
fedan	feːdɑn
neowollic	ne͜owolliːt͡ʃ
asprungen	ɑːsprunɡen
efenling	efenlinɡ
hæleð	xæleθ
hnitu	xnitu
nemnian	nemniɑn
wealcian	wæ͜ɑlkiɑn
witnes	witnes
cwenland	kweːnlɑnd
scyldig	ʃyldij
þeofscyldig	θe͜oːfʃyldij
dema	deːmɑ
meteseax	metesæ͜ɑks
middelfinger	middelfinɡer
godspellian	ɡodspelliɑn
tacan	tɑkɑn
swæþ	swæθ
folclar	folklɑːr
ascunung	ɑːʃuːnunɡ
calend	kɑlend
fregnan	frejnɑn
cystan	kystɑn
twentigfeald	tweːntijfæ͜ɑld
infaran	infɑrɑn
hoc	xoːk
halpenige	xɑlpenije
tæppestre	tæppestre
gewemmednys	jewemmednys
ungenemnendlic	unjenemnendliːt͡ʃ
tieran	ti͜yːrɑn
midd	midd
þegenboren	θejenboren
scola	ʃolɑ
dry	dryː
hearm	xæ͜ɑrm
bisæc	biːsæk
elpenbænen	elpenbæːnen
segnian	sejniɑn
unmihtlic	unmixtliːt͡ʃ
benotian	benotiɑn
beþian	beθiɑn
reþig	reːθij
sacu	sɑku
blatian	blɑːtiɑn
drenccuppe	drent͡ʃkuppe
beþringan	beθrinɡɑn
gleomann	ɡle͜oːmɑnn
forgeald	forjæɑ̯ld
misfo	misfoː
yþan	yːθɑn
finta	fintɑ
þeodloga	θe͜oːdloɡɑ
twidælan	twidæːlɑn
cidan	t͡ʃiːdɑn
hose	xose
saga	sɑɡɑ
fyrhus	fyːrxuːs
sceþþan	ʃeθθɑn
guþcræft	ɡuːθkræft
halignis	xɑːlijnis
æfen	æːfen
gehyran	jexyːrɑn
miltheortnis	miltxe͜ortnis
wintergewæde	winterjewæːde
fers	fers
ċ	t͡ʃ
forberstan	forberstɑn
liegyþ	li͜yːjyːθ
ryþþa	ryθθɑ
acwincan	ɑːkwinkɑn
gemanigfyldan	jemɑnijfyldɑn
wisnes	wiːsnes
hraþe	xrɑθe
tæcende	tæːt͡ʃende
forcyrrednes	fort͡ʃyrrednes
herþan	xerθɑn
wundorful	wundorful
bismor	bismor
loddere	loddere
hæft	xæft
flaniht	flɑːnixt
geldan	jeldɑn
sceld	ʃeld
þeode	θe͜oːde
gesealdnis	jesæ͜ɑldnis
byrde	byrde
laurtreow	lɑurtre͜oːw
belean	belæ͜ɑːn
fæstan	fæstɑn
bebugan	bebuːɡɑn
bæst	bæst
geteal	jetæ͜ɑl
þeodwrecan	θe͜oːdwrekɑn
sægdon	sæjdon
fyhtan	fyːxtɑn
agenslaga	ɑːɡenslɑɡɑ
yþhof	yːθxof
licnes	liːknes
fingeræppel	finɡeræppel
manaþ	mɑːnɑːθ
hwilc	xwilt͡ʃ
þurhwadan	θurxwɑdɑn
pintrywen	piːntryːwen
feohtan	fe͜oxtɑn
þeccan	θett͡ʃɑn
unwislice	unwiːsliːt͡ʃe
færeldfreols	færeldfre͜oːls
eowu	e͜oːwu
nam	nɑm
gegierwan	jeji͜yrwɑn
seam	sæ͜ɑːm
fyxen	fyksen
miss	miss
wad	wɑːd
cearig	t͡ʃæ͜ɑrij
yfelsian	yfelsiɑn
him	him
myndgian	myndɡiɑn
handcops	xɑndkops
forswelgan	forswelɡɑn
gardene	ɡɑːrdene
incer	inker
eaþmod	æ͜ɑːθmoːd
ofercuman	oferkumɑn
gerecednes	jeret͡ʃednes
neat	næ͜ɑːt
gemyþe	jemyːθe
wifleas	wiːflæ͜ɑːs
beddrida	beddridɑ
micellice	mit͡ʃelliːt͡ʃe
hænan	xæːnɑn
husbonda	xuːsbondɑ
mus	muːs
hrepung	xrepunɡ
folclic	folkliːt͡ʃ
hwar	xwɑːr
generian	jenerjɑn
spryttan	spryttɑn
cwicbeam	kwikbæ͜ɑːm
spætan	spæːtɑn
streawian	stræ͜ɑːwiɑn
winterset	winterset
ahleoþrian	ɑːxle͜oːθriɑn
gafolrand	ɡɑfolrɑnd
glæs	ɡlæs
æðelred	æθelred
ðurh	θurx
ealswa	æ͜ɑlswɑː
steopsunu	ste͜oːpsunu
twiecge	twiejje
feohgift	fe͜oxjift
unforbugendlic	unforbuɡendliːt͡ʃ
luflic	lufliːt͡ʃ
hyngrian	xynɡriɑn
cinn	t͡ʃinn
gifta	jiftɑ
fiþerian	fiθeriɑn
mildheortnes	mildxe͜ortnes
gaderung	ɡɑderunɡ
scipere	ʃipere
eacen	æ͜ɑːken
hore	xoːre
gimwyrhta	jimwyrxtɑ
leornian	le͜orniɑn
behydan	bexyːdɑn
eafora	æ͜ɑforɑ
heardian	xæ͜ɑrdiɑn
wræþan	wræːθɑn
gifol	jifol
earsþerl	æ͜ɑrsθerl
bygan	byːjɑn
linnan	linnɑn
geomor	joːmor
meltan	meltɑn
nymþe	nymθe
wrencan	wrent͡ʃɑn
nemniendlic	nemniendliːt͡ʃ
cweornstan	kwe͜ornstɑːn
twig	twij
minlic	minliːt͡ʃ
gespowan	jespoːwɑn
cese	t͡ʃeːse
bewealwian	bewæ͜ɑlwiɑn
cenning	kenninɡ
hæf	xæf
sweorcan	swe͜orkɑn
eþian	eːθiɑn
sot	soːt
hearpere	xæ͜ɑrpere
þan	θɑːn
ræswung	ræːswunɡ
þefel	θefel
diedan	di͜yːdɑn
weod	we͜oːd
hrop	xroːp
unfrodnes	unfroːdnes
fræfel	fræfel
forceorfan	fort͡ʃe͜orfɑn
wundian	wundiɑn
team	tæ͜ɑːm
scinban	ʃinbɑːn
dyppan	dyppɑn
mæþelern	mæθelern
utfæreld	uːtfæreld
recan	rekɑn
edcwic	edkwik
ciricran	t͡ʃirit͡ʃrɑːn
wigsmiþ	wiːjsmiθ
liflice	liːfliːt͡ʃe
gastcund	ɡɑːstkund
hunigsmæc	xunijsmæt͡ʃ
firen	firen
woriende	woːriende
gesihþ	jesixθ
tima	tiːmɑ
seglian	sejliɑn
wogian	woːɡiɑn
þurhblawan	θurxblɑːwɑn
gewrecan	jewrekɑn
sceogan	ʃoːjɑn
heran	xeːrɑn
isearn	iːsæ͜ɑrn
wæx	wæks
ungod	unɡoːd
seohtre	se͜oxtre
heahfæder	xæ͜ɑːxfæder
scamian	ʃɑmiɑn
selfcwala	selfkwɑlɑ
mæstan	mæstɑn
agalan	ɑːɡɑlɑn
worþ	worθ
wiergþu	wi͜yrɡθu
unfæger	unfæjer
misfenge	misfeːnɡe
gecorennes	jekorennes
scua	ʃuːɑ
warnian	wɑrniɑn
lufestice	lufestit͡ʃe
fulwian	fulwiɑn
aweorpan	ɑːwe͜orpɑn
fealwian	fæ͜ɑlwiɑn
ceace	t͡ʃæ͜ɑːke
feccan	fett͡ʃɑn
wuldorspedig	wuldorspeːdij
þrescold	θreʃʃold
swatþyrel	swɑːtθyːrel
gielp	ji͜ylp
cyssan	kyssɑn
werod	werod
blodreow	bloːdre͜oːw
forma	formɑ
scyte	ʃyte
entisc	entiʃ
cwele	kwele
sæd	sæːd
gemotern	jemoːtern
infaru	infɑru
mycel	myt͡ʃel
seon	se͜oːn
butan	buːtɑn
cneoht	kne͜oxt
laþlic	lɑːθliːt͡ʃ
ungesewenlic	unjesewenliːt͡ʃ
fram	frɑm
bealu	bæ͜ɑlu
tosawan	toːsɑːwɑn
hildedeor	xildede͜oːr
acwelan	ɑːkwelɑn
hocg	xoɡɡ
wuldorfæder	wuldorfæder
aþreotan	ɑːθre͜oːtɑn
wæl	wæl
æbylgan	æːbyljɑn
nasu	nɑsu
an	ɑːn
bugan	buːɡɑn
beatere	bæ͜ɑːtere
rin	riːn
geþingþu	jeθinɡθu
bydel	bydel
gehierdan	jexi͜yrdɑn
sprecol	sprekol
geholian	jexoliɑn
bieme	biːeme
þyncan	θynt͡ʃɑn
sure	suːre
spelian	speliɑn
gehrespan	ɡexrespɑn
mædwe	mæːdwe
rihtwis	rixtwiːs
unrihtwif	unrixtwiːf
gesiþscipe	jesiːθʃipe
hleo	xle͜oː
irland	iːrlɑnd
tungolbære	tunɡolbæːre
hean	xæ͜ɑːn
behatan	bexɑːtɑn
onhyrian	onxyrjɑn
berstan	berstɑn
treow	tre͜oːw
wærc	wært͡ʃ
heafola	xæ͜ɑfolɑ
eoforwic	e͜oforwiːt͡ʃ
dropa	dropɑ
tannian	tɑnniɑn
blot	bloːt
weccan	wett͡ʃɑn
heardung	xæ͜ɑrdunɡ
hrædlice	xrædliːt͡ʃe
dumbnes	dumbnes
gelonda	jelondɑ
uht	uːxt
ripan	riːpɑn
hlydan	xlyːdɑn
ellor	ellor
henep	xenep
sceot	ʃot
gecyrring	jet͡ʃyrrinɡ
leoþere	le͜oːθere
angenga	ɑːnɡenjɑ
wielisc	wi͜yːliʃ
þille	θille
andwist	ɑndwist
gehrinan	jexriːnɑn
siextig	si͜ykstij
soþ	soːθ
mihtlic	mixtliːt͡ʃ
seofa	se͜ofɑ
anda	ɑndɑ
samodwunung	sɑmodwununɡ
besceaduwian	beʃɑduwiɑn
forþberan	forθberɑn
dyfan	dyːfɑn
me	meː
hela	xeːlɑː
elþeod	elθe͜oːd
wemming	wemminɡ
popig	popij
smelting	smeltinɡ
ymbsceawian	ymbʃæ͜ɑːwiɑn
hæsl	xæsl
sinhweorfan	sinxwe͜orfɑn
plætt	plætt
stupian	stuːpiɑn
gyrwan	jyrwɑn
tacn	tɑːkn
bolde	bolde
benemnan	benemnɑn
oferspræc	oferspræːt͡ʃ
isiht	iːsixt
æþelian	æθeliɑn
endlefta	endleftɑ
side	siːde
hygeþrym	xyjeθrym
earfoþe	æ͜ɑrfoθe
mere	mere
heaþolac	xæ͜ɑθolɑːk
swaru	swɑru
wudufugol	wudufuɡol
waroþ	wɑroθ
buend	buːend
wæternædre	wæternæːdre
gesceft	jeʃeft
wind	wind
ceorlisc	t͡ʃe͜orliʃ
wrungon	wrunɡon
forhierdan	forxi͜yrdɑn
wiþsettan	wiθsettɑn
breadru	bræːɑ̯dru
halbære	xɑːlbæːre
beadu	bæ͜ɑdu
spræcful	spræːt͡ʃful
lætsum	lætsum
cwæden	kwæːden
hrafyl	xrɑːfyl
heort	xe͜ort
gyrdan	ɡyrdɑn
twin	twin
to	toː
help	xelp
ceosan	t͡ʃe͜oːsɑn
nihthræfn	nixtxræfn
earfoþhwil	æ͜ɑrfoθxwiːl
gehon	jexoːn
þurhsecan	θurxseːt͡ʃɑn
setlgang	setlɡɑnɡ
godspelltraht	ɡodspeltrɑxt
horselene	xorselene
witegestre	wiːteɡestre
geiecendlic	jei͜yːt͡ʃendliːt͡ʃ
ealles	æ͜ɑlles
cuhyrde	kuːxyrde
stocc	stokk
cuwon	kuwon
pæca	pæːt͡ʃɑ
spær	spær
worc	work
muþleas	muːθlæ͜ɑːs
clawu	klɑwu
holdscipe	xoldskipe
gewindan	jewindɑn
syrce	syrt͡ʃe
fiscian	fiskiɑn
wuldorbeag	wuldorbæ͜ɑːɡ
gerene	jereːne
læcan	læːt͡ʃɑn
heof	xe͜oːf
meowle	me͜oːwle
wisian	wiːsiɑn
pæcung	pæːt͡ʃunɡ
wiþmetenlic	wiθmetenliːt͡ʃ
micellic	mit͡ʃelliːt͡ʃ
spinel	spinel
scyldignes	ʃyldijnes
wecg	wejj
slidan	sliːdɑn
sinnan	sinnɑn
gymeleas	jyːmelæ͜ɑːs
agenspræc	ɑːɡenspræːt͡ʃ
cycel	kyt͡ʃel
asettan	ɑːsettɑn
soþtacen	soːθtɑːken
onbidan	onbiːdɑn
hærenfagol	xæːrenfɑɡol
gaast	ɡɑːst
somnian	somniɑn
geleaffull	jelæ͜ɑːffull
genihtsumung	jenixtsumunɡ
liþ	liθ
nigontiene	nijonti͜yːne
forwyrcan	forwyrt͡ʃɑn
tunne	tunne
hreppan	xreppɑn
riht	rixt
wæs	wæs
elpendban	elpendbɑːn
slæpleast	slæːplæ͜ɑːst
lædere	læːdere
æhta	æxtɑ
dædbotnes	dæːdboːtnes
loppestre	loppestre
geswigra	jeswijrɑ
rihtere	rixtere
geteon	jete͜oːn
wisleland	wiːslelɑnd
salig	sɑlij
bisig	bisij
mærsian	mæːrsiɑn
freodom	fre͜oːdoːm
buan	buːɑn
druncnian	drunkniɑn
eastan	æ͜ɑːstɑn
wilddeor	wildde͜oːr
widsiþ	wiːdsiːθ
þwirel	θwirel
gewritan	jewriːtɑn
halig	xɑːlij
triewe	tri͜yːwe
lagustræt	lɑɡustræːt
esol	esol
æþelu	æθelu
gelædan	jelæːdɑn
ofn	ofn
bonda	bondɑ
gewyrtbox	jewyrtboks
feter	feter
tæppian	tæppiɑn
angbreost	ɑnɡbre͜oːst
ceo	t͡ʃe͜oː
dohte	dohte
leger	lejer
begeondan	bejondɑn
sægrund	sæːɡrund
welisc	weːliʃ
trig	trij
husbryce	xuːsbryt͡ʃe
fellen	fellen
manfordædla	mɑːnfordæːdlɑ
weoroldræden	we͜oroldræːden
nieten	ni͜yːten
missan	missɑn
wann	wɑnn
sang	sɑnɡ
andustrian	ɑnduːstriɑn
sculan	ʃulɑn
geondspætan	je͜ondspæːtɑn
bedcleofa	bedkle͜ofɑ
stice	stit͡ʃe
fretan	fretɑn
wansælig	wɑnsæːlij
hyscan	xyʃʃɑn
earwicga	æ͜ɑːrwiɡɡɑ
stæfwis	stæfwiːs
ascian	ɑːskiɑn
hela	xeːlɑ
unsoþ	unsoːθ
delu	delu
agiemeleasian	ɑːji͜yːmelæ͜ɑːsiɑn
ætgædere	ætɡædere
rudduc	rudduk
bedufan	beduːfɑn
þennan	θennɑn
sæt	sæːt
turnian	turniɑn
brecþ	brekθ
geddung	jeddunɡ
orsawle	orsɑːwle
þornig	θornij
torn	torn
deaþslege	dæ͜ɑːθsleje
gebiddan	jebiddɑn
fitt	fitt
hwelc	xwelt͡ʃ
oustrefeld	oustrefeld
hæs	xæːs
genugan	jenuɡɑn
heapmælum	xæ͜ɑːpmæːlum
cleafa	klæ͜ɑːfɑ
hyngran	xynɡrɑn
hafoc	xɑfok
sceadian	ʃæ͜ɑdiɑn
rædfæst	ræːdfæst
tohyht	toːxyxt
ciefese	t͡ʃi͜yfese
grillan	ɡrillɑn
maga	mɑːɡɑ
murnan	murnɑn
henn	xenn
wigan	wiːɡɑn
scogan	ʃoːjɑn
scandlic	ʃɑndliːt͡ʃ
stæppan	stæppɑn
wag	wɑːɡ
palmsunnandæg	pɑlmsunnɑndæj
forþscype	forθʃype
gal	ɡɑːl
gesamnian	jesɑmniɑn
gefæd	jefæd
wringan	wrinɡɑn
sæmest	sæːmest
ofercierran	ofert͡ʃi͜yrrɑn
cirichyll	t͡ʃirit͡ʃxyll
stirc	stirk
dwæs	dwæːs
roweþ	roːweθ
mynetsmiþþe	mynetsmiθθe
wandrian	wɑndriɑn
unfulfremednes	unfulfremednes
þa	θɑː
ridan	riːdɑn
rynel	rynel
tælan	tæːlɑn
cwœn	kwøːn
gat	ɡɑːt
þurhgefeoht	θurxjefe͜oxt
wancol	wɑnkol
ciricwag	t͡ʃirit͡ʃwɑːɡ
wintergegang	winterjeɡɑnɡ
gealla	jæ͜ɑllɑ
hogode	hoɣode
suord	sword
bæþ	bæθ
laur	lɑur
feowertig	fe͜oːwertij
weorþleas	we͜orθlæ͜ɑːs
pintreowen	piːntre͜oːwen
spyrd	spyrd
cwist	kwist
guþsele	ɡuːθsele
bugon	buɡon
ymbscinan	ymbʃiːnɑn
hilderæs	xilderæːs
sliepescoh	sli͜yːpeʃoːx
smeah	smæ͜ɑːx
isernsmiþ	iːsernsmiθ
wiþcwedennes	wiθkwedennes
hærfest	xærfest
geniman	jenimɑn
dryman	dryːmɑn
birce	birt͡ʃe
gietan	jetɑn
swylc	swylt͡ʃ
cnihtwesende	knixtwesende
dælan	dæːlɑn
asceadan	ɑːʃæ͜ɑːdɑn
getæsu	jetæːsu
eahtafeald	æ͜ɑxtɑfæ͜ɑld
girdan	ɡirdɑn
cyperen	kyperen
æppel	æppel
lacu	lɑku
mæd	mæːd
leo	le͜oː
atorcoppe	ɑːtorkoppe
sunnanniht	sunnɑnnixt
steorra	ste͜orrɑ
bewritan	bewriːtɑn
amore	ɑmore
sar	sɑːr
licþeote	liːkθe͜oːte
bræmelberie	bræːmelberie
amarian	ɑːmɑriɑn
wac	wɑːk
antimber	ɑntimber
slawlice	slɑːwliːt͡ʃe
understandan	understɑndɑn
beirnan	beirnɑn
geola	joːlɑ
isceald	iːst͡ʃæ͜ɑld
synder	synder
ore	ore
geondsawan	je͜ondsɑːwɑn
scipgefeoht	ʃipjefe͜oxt
wæteryþ	wæteryːθ
denu	denu
sceap	ʃæ͜ɑːp
fon	foːn
boclar	boːk
ingangan	inɡɑnɡɑn
bat	bɑːt
æftergengel	æfterɡenɡel
ladteow	lɑːdte͜oːw
neþan	neːθɑn
hagosteald	xɑɡostæ͜ɑld
tæht	tæːxt
læt	læt
wyllan	wyllɑn
cracian	krɑkiɑn
metan	metɑn
niþera	niθerɑ
gedwolspræc	jedwolspræːt͡ʃ
gelic	jeliːt͡ʃ
geteorigendlic	jete͜oːrijendliːt͡ʃ
edor	edor
ceaf	t͡ʃæ͜ɑf
andwig	ɑndwiːɡ
dunholm	dunxolm
micele	mit͡ʃele
ungemæte	unjemæːte
andswerian	ɑndswerjɑn
hildewæpen	xildewæːpen
spind	spind
mushafoc	muːsxɑfok
wih	wiːx
nibacen	niːbɑken
hraþor	xrɑθor
ymbfon	ymbfoːn
woh	woːx
ceac	t͡ʃæ͜ɑːk
esa	eːsɑ
bled	bleːd
gehyrde	jehyːrde
sadolian	sɑdoliɑn
þing	θinɡ
geworht	jeworxt
fotsceamol	foːtʃɑmol
here	xere
woþ	woːθ
hoga	xoɡɑ
eþelrice	eːθelriːt͡ʃe
wafian	wɑːfiɑn
brocen	broken
tolætan	toːlæːtɑn
ræd	ræːd
forhealdan	forxæ͜ɑldɑn
ymbsniþan	ymbsniːθɑn
lareowdom	lɑːre͜oːwdoːm
foresceawung	foreʃæ͜ɑːwunɡ
scyan	skyːɑn
gehiersumian	jexi͜yːrsumiɑn
snægl	snæjl
friþ	friθ
twæde	twæːde
snawig	snɑːwij
sawol	sɑːwol
searmonaþ	sæ͜ɑːrmoːnɑθ
forscyttan	forʃyttɑn
afor	ɑːfor
geondwadan	je͜ondwɑdɑn
willan	willɑn
hæftnung	xæftnunɡ
teond	te͜oːnd
smeċċan	smekkɑn
stybb	stybb
hwopan	xwoːpɑn
mimorian	mimoriɑn
heora	heo̯rɑ
singal	sinɡɑl
deofolseoc	de͜oːfolse͜oːk
ærendwreca	æːrendwrekɑ
þieder	θi͜yder
mor	moːr
holian	xoːliɑn
hunigbære	xunijbæːre
eaþmed	æ͜ɑːθmeːd
wefan	wefɑn
cnyllan	knyllɑn
garas	ɡɑːrɑs
glida	ɡlidɑ
mæst	mæst
undercyrran	undert͡ʃyrrɑn
bidaþ	biːdɑθ
apuldor	ɑpuldor
gielpword	ji͜ylpword
leohtlic	le͜oːxtliːt͡ʃ
on	on
fæss	fæss
hwon	xwon
cirse	t͡ʃirse
wagegan	wɑɡejɑn
feþer	feθer
langsumnes	lɑnɡsumnes
liefan	li͜yːfɑn
gebindan	jebindɑn
gerec	jerek
forcweþan	forkweθɑn
hearmcweþan	xæ͜ɑrmkweθɑn
dweorg	dwe͜orɡ
feowerfeald	fe͜oːwerfæ͜ɑld
underfon	underfoːn
full	full
holian	xoliɑn
cynegierd	kyneji͜yrd
hwærhwugu	xwæːrxwuɡu
feltwyrt	feltwyrt
dolg	dolɡ
gretan	ɡreːtɑn
torr	torr
tydre	tyːdre
œle	øle
towrecan	toːwrekɑn
weþe	weːθe
gewæde	jewæːde
wundorlice	wundorliːt͡ʃe
geclofa	ɡeklofɑ
sealtern	sæ͜ɑltern
horsc	xorsk
upflering	upfleːrinɡ
gesaweled	jesɑːweled
þrexwold	θrekswold
broc	broːk
dumb	dumb
bescitan	beʃiːtɑn
mæce	mæːt͡ʃe
undergan	underɡɑːn
weorcsum	we͜orksum
reht	rext
wohgestreon	woːxjestre͜oːn
onweg	onwej
hlaf	xlɑːf
wæterseocnes	wæterse͜oːknes
swiþlic	swiːθliːt͡ʃ
swiftnes	swiftnes
gesprecan	jesprekɑn
seþend	seːθend
þy	θyː
staþolfæstnian	stɑθolfæstniɑn
hræw	xræːw
cusceote	kuːʃote
forgifendlic	forjifendliːt͡ʃ
ymbhealdan	ymbxæ͜ɑldɑn
beodan	be͜oːdɑn
grin	ɡrin
cyneg	kyneɡ
potian	potiɑn
bepæcestre	bepæːt͡ʃestre
gitsian	jiːtsiɑn
beneotan	bene͜oːtɑn
diepe	di͜yːpe
feogan	fe͜oːjɑn
ambehtan	ɑmbextɑn
cetel	ketel
geatolic	jæ͜ɑtoliːt͡ʃ
clerc	klerk
pinness	piːnness
forþcuman	forθkumɑn
healfscyldig	xæ͜ɑlfʃyldij
wordgecwide	wordjekwide
benc	bent͡ʃ
wansceaft	wɑnʃæ͜ɑft
se	seː
forþflowan	forθfloːwɑn
swelc	swelt͡ʃ
merisc	meriʃ
hwelpian	xwelpiɑn
cierr	t͡ʃi͜yrr
seaxland	sæ͜ɑkslɑnd
smæl	smæl
þoftræden	θoftræːden
cempestre	kempestre
cweþan	kweθɑn
oferfylgan	oferfyljɑn
oferwadan	oferwɑdɑn
os	oːs
hawian	xɑːwiɑn
mæw	mæːw
hild	xild
feorh	fe͜orx
nioþan	ni͜uθɑn
hagena	xɑɡenɑ
splott	splott
weorod	we͜orod
geunsoþian	jeunsoːθiɑn
liegcwalu	li͜yːjkwɑlu
geostrandæg	je͜ostrɑndæj
bitan	biːtɑn
wæd	wæd
wiccan	witt͡ʃɑn
truwian	truːwiɑn
sawelleas	sɑːwellæ͜ɑːs
tyge	tyje
eftacennednes	eftɑːkennednes
stigon	stiɣon
tæcaþ	tæːt͡ʃɑθ
lysan	lyːsɑn
wuduland	wudulɑnd
firengeorn	firenje͜orn
spæc	spæːt͡ʃ
cwelan	kwelɑn
eadig	æ͜ɑːdij
syflige	syflije
firenlice	firenliːt͡ʃe
crudan	kruːdɑn
æþele	æθele
æmtian	æːmtiɑn
beslæpan	beslæːpɑn
unwis	unwiːs
tacnung	tɑːknunɡ
geteorodnes	jete͜oːrodnes
gefeon	jefe͜oːn
flanhræd	flɑːnxræd
cwæde	kwæːde
geondsendan	je͜ondsendɑn
neod	ne͜oːd
stæfwritere	stæfwriːtere
bearm	bæ͜ɑrm
ræswian	ræːswiɑn
bræs	bræs
feorsian	fe͜orsiɑn
gehwæde	jexwæːde
þurhdelfan	θurxdelfɑn
meaht	mæ͜ɑxt
briw	briːw
gehabban	jexɑbbɑn
cycen	t͡ʃyken
oþþon	oθθon
goldwrecan	ɡoldwrekɑn
mycg	myjj
geciegendlic	jet͡ʃi͜yːjendliːt͡ʃ
wealdende	wæ͜ɑldende
þringan	θrinɡɑn
firenlic	firenliːt͡ʃ
hold	xold
swyþe	swyːθe
forhatena	forxɑːtenɑ
sincgiefa	sinkji͜yfɑ
hoppian	xoppiɑn
scedeland	ʃedelɑnd
nyttian	nyttiɑn
ofersprecol	ofersprekol
fotadl	foːtɑːdl
hind	xind
penningmangere	penninɡmɑnɡere
nearu	næ͜ɑru
unnytlic	unnytliːt͡ʃ
geotan	je͜oːtɑn
cawel	kɑwel
hleonian	xle͜oniɑn
smicor	smikor
stæl	stæl
nydwracu	nyːdwrɑku
mereswin	mereswiːn
forfaran	forfɑrɑn
wlancian	wlɑnkiɑn
syll	syll
heregrima	xereɡriːmɑ
fundian	fundiɑn
geþolian	jeθoliɑn
ohthere	oxtxere
eadric	æ͜ɑːdriːk
efenlicnes	efenliːknes
orsorh	orsorx
sife	sife
gefræge	jefræːje
drof	droːf
freondlaþu	fre͜oːndlɑθu
brytland	brytlɑnd
stægel	stæːjel
steopfæder	ste͜oːpfæder
plume	pluːme
endedæg	endedæj
clyccan	klytt͡ʃɑn
romane	roːmɑːne
cyndelic	kyndeliːt͡ʃ
ametan	ɑːmetɑn
geogoþ	juɡoθ
into	intoː
trog	troɡ
ongean	onjæ͜ɑːn
aþecgan	ɑːθejjɑn
æcirn	æːkirn
eadgar	æ͜ɑːdɡɑːr
wyscan	wyːʃʃɑn
portesmuða	portesmuːθɑ
freondscipe	fre͜oːndʃipe
boxtreow	bokstre͜oːw
feasceaft	fæ͜ɑːʃæ͜ɑft
geiewan	jei͜yːwɑn
hwæþer	xwæθer
ceorliscnes	t͡ʃe͜orliʃnes
framhweorfan	frɑmxwe͜orfɑn
andwlitan	ɑndwliːtɑn
cyþþu	kyːθθu
tælg	tælɡ
flotian	flotiɑn
eþelstaþol	eːθelstɑθol
gemyndig	jemyndij
bihreosan	bixre͜oːsɑn
þec	θek
frecgan	frejjɑn
fæx	fæks
barum	bɑrum
fortredan	fortredɑn
wæstmian	wæstmiɑn
wohlice	woːxliːt͡ʃe
sawelhus	sɑːwelxuːs
inlic	inliːt͡ʃ
ciricfriþ	t͡ʃirit͡ʃfriθ
yþ	yːθ
wildor	wildor
beswican	beswiːkɑn
wiþgan	wiθɡɑːn
lencten	lenkten
hælo	xæːlo
francland	frɑnklɑnd
behlæstan	bexlæstɑn
hyran	xyːrɑn
middæg	middæj
scid	ʃiːd
mægþ	mæːjθ
witleas	witlæ͜ɑːs
ardæde	ɑːrdæːde
þanon	θɑnon
gisl	jiːsl
inhold	inxold
þurhscriþan	θurxʃriːθɑn
æt	æt
geondhyrdan	je͜ondxyrdɑn
slegel	slejel
forscieppan	forʃi͜yppɑn
næren	næːren
hwæder	xwæder
plantian	plɑntiɑn
fæstnian	fæstniɑn
liegnan	li͜yːjnɑn
wyrd	wyrd
all	ɑll
befeolan	befe͜oːlɑn
folde	folde
yferra	yferrɑ
coþu	koθu
cnafa	knɑfɑ
spann	spɑnn
begrafan	beɡrɑfɑn
efesian	efesiɑn
wodnes	woːdnes
wuduþistel	wuduθistel
dæg	dæj
cuþe	kuːθe
þeodcyning	θe͜oːdkyninɡ
reced	ret͡ʃed
cirichata	t͡ʃirit͡ʃxɑtɑ
gyccan	jytt͡ʃɑn
gesceapennys	jeʃæ͜ɑpennys
hunbeorht	xunbe͜orxt
unforbugendlice	unforbuɡendliːt͡ʃe
peorð	pe͜orθ
þrym	θrym
gamol	ɡɑmol
cweden	kweden
slaw	slɑːw
ængel	ænjel
acwele	ɑːkwele
brytmælum	brytmæːlum
nis	nis
hlisful	xliːsful
drugaþ	druːɡɑθ
tæsan	tæːsɑn
peru	peru
breoton	bre͜oton
sprecolnes	sprekolnes
untwiefeald	untwi͜yfæ͜ɑld
giemend	ji͜yːmend
æppelleaf	æppellæ͜ɑːf
wifhad	wiːfxɑːd
fealu	fæ͜ɑlu
ræden	ræːden
bennian	benniɑn
fæhþ	fæːxθ
wuffa	wuffɑ
ceod	ke͜od
tweogan	twe͜oːjɑn
tahte	tɑːxte
myrþra	myrθrɑ
oþþeodan	oθθe͜oːdɑn
welwillendnes	welwillendnes
widmærsian	wiːdmæːrsiɑn
hwisprian	xwispriɑn
sædeor	sæːde͜oːr
alimpan	ɑːlimpɑn
leohtberend	le͜oːxtberend
meare	mæ͜ɑːre
fearh	fæ͜ɑrx
feor	fe͜or
giend	ji͜ynd
leas	læ͜ɑːs
scrobbesbyrigscir	ʃrobbesbyrijʃiːr
cran	krɑn
wæcce	wætt͡ʃe
smoca	smokɑ
cnyssan	knyssɑn
swiþan	swiːθɑn
forheardian	forxæ͜ɑrdiɑn
sawal	sɑːwɑl
geseþan	jeseːθɑn
swinn	swinn
mannlice	mɑnnliːt͡ʃe
wylm	wylm
þursdæg	θursdæj
wohhæmed	woːxxæːmed
ryne	ryne
rom	roːm
bisenian	biseniɑn
wudig	wudij
talente	tɑlente
belæfan	belæːfɑn
sawelgedal	sɑːweljedɑːl
gelimpan	jelimpɑn
blondenfeax	blondenfæ͜ɑks
wuscbearn	wuːskbæ͜ɑrn
predician	predikiɑn
winterdun	winterduːn
swearm	swæ͜ɑrm
scearpnes	ʃæ͜ɑrpnes
gewican	jewiːkɑn
wiþerhabban	wiθerxɑbbɑn
þenian	θeniɑn
dreah	dræːɑ̯h
fieldestol	fi͜yldestoːl
forn	foːrn
swæfon	swæːfon
deagolnes	dæ͜ɑːɡolnes
fearr	fæ͜ɑrr
becuman	bekumɑn
feorþa	fe͜oːrθɑ
stif	stiːf
strange	strɑnɡe
þeox	θe͜oks
ealdfæder	æ͜ɑldfæder
ænglisc	ænɡliʃ
bred	bred
begyman	bejyːmɑn
slæpleas	slæːplæ͜ɑːs
beacn	bæ͜ɑːkn
abrastlian	ɑːbrɑstliɑn
næft	næft
læcecræft	læːt͡ʃekræft
besteman	besteːmɑn
ongegn	onjejn
sehtlian	sextliɑn
forlæran	forlæːrɑn
æþel	æːθel
grellan	ɡrellɑn
scrutnung	ʃruːtnunɡ
tienfeald	ti͜yːnfæ͜ɑld
dreman	dreːmɑn
edniewe	edni͜yːwe
duru	duru
efenwyrcung	efenwyrt͡ʃunɡ
æmetta	æːmettɑ
lippa	lippɑ
hæt	xæt
agen	ɑjeːn
ead	æ͜ɑːd
gesendan	jesendɑn
carte	kɑrte
tæhton	tæːxton
stubb	stubb
heore	xe͜oːre
finc	fint͡ʃ
witleast	witlæ͜ɑːst
sælic	sæːliːt͡ʃ
hundendleftig	xundendleftij
cyningdom	kyninɡdoːm
hryman	xryːmɑn
gæsne	ɡæːsne
agengehweorfan	ɑjeːnjexwe͜orfɑn
smugan	smuːɡɑn
usic	uːsit͡ʃ
wyrþe	wyrθe
larsum	lɑːrsum
ofgangendlic	ofɡɑnɡendliːt͡ʃ
ciricbot	t͡ʃirit͡ʃboːt
besmirwan	besmirwɑn
fæle	fæːle
cwician	kwikiɑn
forwlencan	forwlent͡ʃɑn
foresægdnes	foresæjdnes
gild	jild
dæl	dæl
genemnendlic	jenemnendliːt͡ʃ
wiþ	wiθ
oferteon	oferte͜oːn
healt	xæ͜ɑlt
mos	moːs
forliger	forlijer
gitsung	jiːtsunɡ
sceafmælum	ʃæ͜ɑfmæːlum
sceone	ʃe͜oːne
leodræden	le͜oːdræːden
bacas	bɑkɑs
magan	mɑɡɑn
þreotteoþa	θre͜oːtte͜oːθɑ
þreanied	θræ͜ɑːni͜yːd
efnettan	efnettɑn
hæfdon	hæfdon
styring	styrinɡ
forelocc	forelokk
sawolcund	sɑːwolkund
ræding	ræːdinɡ
deorfellen	de͜oːrfellen
wifer	wifer
heolca	xe͜olkɑ
yþlaf	yːθlɑːf
earm	æ͜ɑrm
foresteppan	foresteppɑn
stælwierþe	stæːlwi͜yrθe
þynne	θynne
nowiht	noːwixt
wuldorwerod	wuldorwerod
þearle	θæ͜ɑrle
heofonrice	xe͜ofonriːt͡ʃe
bebindan	bebindɑn
bescinan	beʃiːnɑn
stincan	stinkɑn
forbitan	forbiːtɑn
wearm	wæ͜ɑrm
rodfæstnian	roːdfæstniɑn
gegrapian	jeɡrɑːpiɑn
inlendisc	inlendiʃ
cann	kɑnn
gestrienendlic	jestri͜yːnendliːt͡ʃ
glisnian	ɡlisniɑn
mæseren	mæseren
weþer	weθer
micelmod	mit͡ʃelmoːd
nefa	nefɑ
wuduwe	wuduwe
rihtnes	rixtnes
mare	mɑre
gristel	ɡristel
socen	soːken
hynþu	xyːnθu
eotan	e͜otɑn
wenden	wenden
nytnes	nytnes
twelf	twelf
fæstnes	fæstnes
ligen	liːjen
amasian	ɑːmɑsiɑn
mangian	mɑnɡiɑn
faþu	fɑθu
styric	styrik
gleawscipe	ɡlæ͜ɑːwʃipe
forteon	forte͜oːn
griþleas	ɡriθlæ͜ɑːs
ge	jeː
wurþan	wurθɑn
hengest	xenjest
wiþlædan	wiθlæːdɑn
andig	ɑndij
oferhleoþrian	oferxle͜oːθriɑn
wemmend	wemmend
ærendian	æːrendiɑn
þrægan	θræːjɑn
unstaþolfæst	unstɑθolfæst
port	port
sumerlæcan	sumerlæːt͡ʃɑn
unscyldig	unʃyldij
stræc	stræk
dyncge	dynje
andsaca	ɑndsɑkɑ
modig	moːdij
beorhtlice	be͜orxtliːt͡ʃe
liegræscettung	li͜yːjræʃettunɡ
naso	nɑso
æfenglom	æːfenɡloːm
haca	xɑkɑ
swiftlice	swiftliːt͡ʃe
fell	fell
þyrel	θyːrel
geeaþmodian	jeæ͜ɑːθmoːdiɑn
mæden	mæːden
bræw	bræːw
cneht	knext
feall	fæ͜ɑll
bliss	bliss
sigorian	siɡoriɑn
amber	ɑmber
godspell	ɡodspell
leodcyning	le͜oːdkyninɡ
scealfor	ʃæ͜ɑlfor
ceoweþ	t͡ʃe͜oːweθ
blæcan	blæːt͡ʃɑn
wealhheafoc	wæ͜ɑlxxæ͜ɑfok
cyrnel	kyrnel
frecennes	freːkennes
misfonde	misfoːnde
þiccett	θikkett
heardlice	xæ͜ɑrdliːt͡ʃe
mamera	mɑmerɑ
geondbrædan	je͜ondbræːdɑn
bewindan	bewindɑn
lareow	lɑːre͜oːw
post	post
gyrdel	ɡyrdel
huþ	xuːθ
cræftiga	kræftiɡɑ
unbryce	unbryːt͡ʃe
gecnyttan	jeknyttɑn
sæfern	sæfern
reoc	re͜oːk
igeoþ	ijoθ
wiccung	witt͡ʃunɡ
nesan	nesɑn
deofolcund	de͜oːfolkund
þorfte	θorfte
innian	inniɑn
med	meːd
incuman	inkumɑn
genefa	jenefɑ
wyrs	wyrs
oferswiþness	oferswiːθness
bediernan	bedi͜yrnɑn
rodor	rodor
gebrot	jebrot
mæg	mæːj
bewlatian	bewlɑːtiɑn
sand	sɑnd
yþgewinn	yːθjewinn
geiecan	jei͜yːt͡ʃɑn
ð	θ
gatum	ɡɑːtum
brædepanne	bræːdepɑnne
horsclice	xorʃliːt͡ʃe
cyll	kyll
sel	sel
mengan	menjɑn
cwenfugol	kweːnfuɡol
grasu	ɡrɑsu
iegland	i͜yːjlɑnd
wrenna	wrennɑ
wæterleas	wæterlæ͜ɑːs
eall	æ͜ɑll
leofwende	le͜oːfwende
hreod	xre͜oːd
setlgangende	setlɡɑnɡende
tofeallan	toːfæ͜ɑllɑn
neaht	næ͜ɑxt
yce	yːt͡ʃe
þost	θost
gefon	jefoːn
gastlice	ɡɑːstliːt͡ʃe
beam	bæ͜ɑːm
apa	ɑpɑ
intinga	intinɡɑ
freht	frext
medren	meːdren
ymbeardiende	ymbæ͜ɑrdiende
seted	seted
freolac	fre͜oːlɑːk
sceotan	ʃe͜oːtɑn
besendan	besendɑn
forelædan	forelæːdɑn
wæteradl	wæterɑːdl
womm	womm
moras	moːrɑs
awrecan	ɑːwrekɑn
baca	bɑkɑ
sumorlic	sumorliːt͡ʃ
scoplic	ʃopliːt͡ʃ
witan	witɑn
beogol	be͜oːɡol
welwillende	welwillende
marcus	mɑrkus
inciegung	int͡ʃi͜yːjunɡ
gewærlæcan	jewærlæːt͡ʃɑn
myntan	myntɑn
scofl	ʃofl
regnian	rejniɑn
handcosp	xɑndkosp
untynan	untyːnɑn
æwisc	æːwiʃ
þunwange	θunwɑnɡe
winescipe	wineʃipe
gar	ɡɑːr
heord	xe͜ord
box	boks
æst	æːst
hwilwende	xwiːlwende
uncumliþnes	unkumliːθnes
towritan	toːwriːtɑn
dreahtest	dræɑ̯htest
gymeleasnys	jyːmelæ͜ɑːsnys
hrung	xrunɡ
wælreow	wælre͜oːw
cringan	krinɡɑn
slæp	slæːp
billum	billum
beagian	bæ͜ɑːɡiɑn
beard	bæ͜ɑrd
morgengiefu	morɡenji͜yfu
selfbana	selfbɑnɑ
ofersittan	ofersittɑn
gesacan	jesɑkɑn
dædbeta	dæːdbeːtɑ
hnægan	xnæːjɑn
bierce	bi͜yrt͡ʃe
sigortacen	siɡortɑːken
innefare	innefɑre
feldielfen	feldi͜ylfen
næfre	næːfre
ðæt	θæt
cræftiglice	kræftijliːt͡ʃe
anhealdan	ɑnxæ͜ɑldɑn
comon	koːmon
mealwe	mæ͜ɑlwe
gefrasian	jefrɑːsiɑn
smeage	smæːɑɣe
fæstlice	fæstliːt͡ʃe
untrum	untrum
swiþness	swiːθness
hiw	xiːw
eftbot	eftboːt
hneaw	xnæ͜ɑːw
gefog	jefoːɡ
horsern	xorsern
cild	t͡ʃild
gecyndespræc	jekyndespræːt͡ʃ
tela	telɑ
beterian	beteriɑn
ladmann	lɑːdmɑnn
ricsian	riːksiɑn
wealda	wæ͜ɑldɑ
derian	derjɑn
behofian	bexoːfiɑn
slawyrm	slɑːwyrm
efenwyrhta	efenwyrxtɑ
blondan	blondɑn
andwyrde	ɑndwyrde
ætbeon	ætbe͜oːn
wrað	wrɑːθ
stær	stæːr
utlendisc	uːtlendiʃ
liegbryne	li͜yːjbryne
lind	lind
westseaxa	westsæ͜ɑksɑ
eþelboda	eːθelbodɑ
cnapa	knɑpɑ
gebannan	jebɑnnɑn
gebedda	jebeddɑ
prud	pruːd
declinung	dekliːnunɡ
friþhus	friθxuːs
bedrifan	bedriːfɑn
genihtlice	jenixtliːt͡ʃe
swynhyrde	swyːnxyrde
cumb	kumb
gehwær	jexwæːr
drieman	dri͜yːmɑn
ymbgang	ymbɡɑnɡ
oxa	oksɑ
wynlic	wynliːt͡ʃ
framateon	frɑmɑːte͜oːn
seofon	se͜ofon
wangteþ	wɑnɡteːθ
hrindan	xrindɑn
æstel	æːstel
swebban	swebbɑn
bosm	boːsm
sniweþ	sniːweθ
endleofan	endle͜ofɑn
fesian	feːsiɑn
gota	ɡotɑ
dæglang	dæjlɑnɡ
ut	uːt
fierdfæreld	fi͜yrdfæreld
sibling	siblinɡ
niedhæs	ni͜yːdxæːs
drincere	drinkere
heafodmæg	xæ͜ɑːfodmæːj
getel	jetel
ciricend	t͡ʃirit͡ʃend
dwolcræft	dwolkræft
ymbliþan	ymbliːθɑn
codd	kodd
mapolder	mɑpolder
hulc	xulk
iraland	iːrɑlɑnd
wise	wiːse
scima	ʃiːmɑ
eldra	eldrɑ
mihtlice	mixtliːt͡ʃe
beorcan	be͜orkɑn
untrumnes	untrumnes
flacor	flɑkor
lyden	lyːden
esla	eslɑ
æfensteorra	æːfenste͜orrɑ
wos	woːs
stefn	stefn
hamor	xɑmor
seamere	sæ͜ɑːmere
mægenwudu	mæjenwudu
halignes	xɑːlijnes
cuwearm	kuːwæ͜ɑrm
niþerlic	niθerliːt͡ʃ
cerran	t͡ʃerrɑn
oncnyssan	onknyssɑn
snican	sniːkɑn
eorþe	e͜orθe
hierde	xi͜yrde
langsum	lɑnɡsum
bebaþian	bebɑθiɑn
freana	fræːɑ̯nɑ
deaþlicnes	dæ͜ɑːθliːt͡ʃnes
ægrum	æːjrum
mona	moːnɑ
gifstol	jifstoːl
þæcele	θæt͡ʃele
eþelturf	eːθelturf
na	nɑː
drenccuppe	drenkkuppe
purpuren	purpuren
bliþelice	bliːθeliːt͡ʃe
forespræc	forespræːt͡ʃ
gadrian	ɡɑdriɑn
geador	jæ͜ɑdor
misfengen	misfeːnɡen
welwillendlice	welwillendliːt͡ʃe
facn	fɑːkn
sodoma	sodom
bryt	bryt
þeawleas	θæ͜ɑːwlæ͜ɑːs
þaccian	θɑkkiɑn
lictun	liːktuːn
eagduru	æ͜ɑːɡduru
yþlida	yːθlidɑ
awyrgan	ɑːwyrjɑn
aswebban	ɑːswebbɑn
wæpengetæc	wæːpenjetæk
bogiht	boɡixt
þreapian	θræ͜ɑːpiɑn
fic	fiːk
plante	plɑnte
bemetan	bemetɑn
niman	nimɑn
hnot	xnot
sellendlic	sellendliːt͡ʃ
fæt	fæt
wasend	wɑːsend
glæd	ɡlæd
geflowan	jefloːwɑn
moru	moru
bicce	bitt͡ʃe
socn	soːkn
ymbsittend	ymbsittend
synful	synful
heahlareow	xæ͜ɑːxlɑːre͜oːw
screncan	ʃrent͡ʃɑn
tind	tind
scytefinger	ʃytefinɡer
wilnung	wilnunɡ
passion	pɑssi͜un
oncierran	ont͡ʃi͜yrrɑn
neowe	ne͜oːwe
fyrdsearu	fyrdsæ͜ɑru
ingehygd	injexyjd
tæcing	tæːt͡ʃinɡ
uþwita	uːθwitɑ
yrhþo	yrxθo
flor	floːr
hyrdon	hyːrdon
ungeþyldig	unjeθyldij
geafon	jæ͜ɑːfon
upgan	upɡɑːn
hatan	xɑːtɑn
ordfruma	ordfrumɑ
hæren	xæːren
widewe	widewe
eow	e͜oːw
spræc	spræːt͡ʃ
þurhgangan	θurxɡɑnɡɑn
cicen	t͡ʃiken
finger	finɡer
brim	brim
sæfæreld	sæːfæreld
dysig	dysij
seolf	se͜olf
ær	æːr
foretacen	foretɑːken
liesan	li͜yːsɑn
hriþ	xriθ
torht	torxt
æt	æːt
gesetnes	jesetnes
elfen	elfen
wæg	wæːj
betan	beːtɑn
hwitnes	xwiːtnes
gælsa	ɡæːlsɑ
amierran	ɑːmi͜yrrɑn
beomodor	be͜oːmoːdor
bendan	bendɑn
cenningtid	kenninɡtiːd
sciphlaford	ʃipxlɑːford
stielen	sti͜yːlen
husian	xuːsiɑn
wincian	winkiɑn
eftniewung	eftni͜yːwunɡ
feornes	fe͜ornes
wending	wendinɡ
onlihtan	onliːxtɑn
eolhsand	e͜olxsɑnd
giwian	jiwiɑn
frea	fræ͜ɑː
brocc	brokk
ræde	ræːde
heofonisc	xe͜ofoniʃ
middangeard	middɑnjæ͜ɑrd
ongeat	onjæɑt
hrycg	xryjj
mapulder	mɑpulder
firendæd	firendæːd
heafodædre	xæ͜ɑːfodæːdre
bescyldian	beʃyldiɑn
pleon	ple͜oːn
þreo	θre͜oː
geondhweorfan	je͜ondxwe͜orfɑn
gafol	ɡɑfol
freosan	fre͜oːsɑn
wealhþeow	wæ͜ɑlxθe͜oːw
wynsumness	wynsumness
nazarenisc	nɑtsɑreniʃ
mælan	mæːlɑn
hyse	xyse
heardheort	xæ͜ɑrdxe͜ort
þiedan	θi͜yːdɑn
stemn	stemn
ascirian	ɑːʃirjɑn
gesehtlian	jesextliɑn
leodmearc	le͜oːdmæ͜ɑrk
horhig	xorxij
sceolh	ʃe͜olx
nyd	nyːd
wrang	wrɑnɡ
scyldlæta	ʃyldlæːtɑ
wealhstod	wæ͜ɑlxstod
byrdling	byrdlinɡ
beþrawan	beθrɑːwɑn
acsian	ɑːksiɑn
ingan	inɡɑːn
guþmod	ɡuːθmoːd
liegloccod	li͜yːjlokkod
ærlice	æːrliːt͡ʃe
dædbot	dæːdboːt
stæfleahter	stæflæ͜ɑxter
namboc	nɑmboːk
andwirdan	ɑndwirdɑn
ancenned	ɑːnkenned
swote	swoːte
gewyscednes	jewyːʃʃednes
hiertan	xi͜yrtɑn
prica	prikɑ
gleo	ɡle͜oː
gecoronian	jekoroːniɑn
aliefan	ɑːli͜yːfɑn
bringan	brinɡɑn
onfon	onfoːn
æwlice	æːwliːt͡ʃe
betæcan	betæːt͡ʃɑn
togan	toːɡɑːn
godnes	ɡoːdnes
freadrihten	fræ͜ɑːdrixten
munt	munt
wange	wɑnɡe
sæbat	sæːbɑːt
gedon	jedoːn
þreat	θræ͜ɑːt
wiþercyrr	wiθert͡ʃyrr
bebbe	bebbe
oferfyllan	oferfyllɑn
medeme	medeme
morþslaga	morθslɑɡɑ
twifeald	twifæ͜ɑld
steam	stæ͜ɑːm
ræpan	ræːpɑn
wiþfon	wiθfoːn
gesettan	jesettɑn
tahton	tɑːxton
lendenu	lendenu
prim	priːm
geþeot	jeθe͜oːt
oferswiþan	oferswiːθɑn
geset	jeset
fæt	fæːt
cysel	t͡ʃysel
ætwesan	ætwesɑn
beginnan	bejinnɑn
hulian	xuːliɑn
riþ	riːθ
yfelcweþan	yfelkweθɑn
lufe	lufe
bewitan	bewitɑn
ungleawlice	unɡlæ͜ɑːwliːt͡ʃe
ymbhringan	ymbxrinjɑn
efenscyldig	efenʃyldij
sylf	sylf
weras	werɑs
dreamere	dræ͜ɑːmere
baðian	bɑθiɑn
hlæw	xlæːw
edstaþeliend	edstɑθeliend
hwamstan	xwɑmstɑːn
gelær	jelæːr
wlitebeorht	wlitebe͜orxt
snytan	snyːtɑn
gehende	jexende
sinwealt	sinwæ͜ɑlt
ciricboc	t͡ʃirit͡ʃboːk
neowel	ne͜owel
hnossian	xnossiɑn
magian	mɑɡiɑn
ymbeardian	ymbæ͜ɑrdiɑn
ofersprecolnes	ofersprekolnes
carcern	kɑrkern
earg	æ͜ɑrɡ
wundortacen	wundortɑːken
oferflowan	oferfloːwɑn
acwelaþ	ɑːkwelɑθ
licettan	liːt͡ʃettɑn
getaht	jetɑːxt
searo	sæ͜ɑro
oþþæt	oθθæt
æghwæþer	æːjxwæθer
gan	ɡɑːn
beacnian	bæ͜ɑːkniɑn
tealtrian	tæ͜ɑltriɑn
unwynsum	unwynsum
dufan	duːfɑn
tæcst	tæːkst
besmierwan	besmi͜yrwɑn
tynan	tyːnɑn
þyrelung	θyːrelunɡ
gaderian	ɡɑderiɑn
sinu	sinu
feþerbære	feθerbæːre
lufsum	lufsum
grund	ɡrund
bolle	bolle
hangian	xɑnɡiɑn
goldfah	ɡoldfɑːx
seomian	se͜omiɑn
milts	milts
fifel	fiːfel
scacan	ʃɑkɑn
sealt	sæ͜ɑlt
þyrre	θyrre
circul	t͡ʃirkul
sweartness	swæ͜ɑrtness
gylpword	jylpword
wudubære	wudubæːre
bræsen	bræsen
morþor	morθor
hwæs	xwæs
cicel	kit͡ʃel
cantware	kɑntwɑre
belædan	belæːdɑn
þeowan	θe͜oːwɑn
sigelhearwa	sijelxæ͜ɑrwɑ
aneged	ɑːneːjed
banleas	bɑːnlæ͜ɑːs
earendel	æ͜ɑːrendel
sandcorn	sɑndkorn
gewind	jewind
frofor	froːfor
ancleo	ɑnkle͜oː
innoþ	innoθ
iersian	i͜yrsiɑn
leassceawere	læ͜ɑːsʃæ͜ɑːwere
gehwædnys	jexwæːdnys
þiewen	θi͜ywen
læssa	læːssɑ
eadan	æ͜ɑːdɑn
gemet	jemet
toll	toll
gear	jæ͜ɑːr
great	ɡræ͜ɑːt
tyhtan	tyxtɑn
bercan	berkɑn
æled	æːled
swelgan	swelɡɑn
swinsian	swinsiɑn
godwebb	ɡodwebb
tumbere	tumbere
sæterndæg	sæterndæj
wudulæs	wudulæːs
þingian	θinɡiɑn
cocer	koker
geahl	jæ͜ɑxl
swiþ	swiːθ
borh	borx
framcynn	frɑmkynn
hwanon	xwɑnon
sceaphyrde	ʃæ͜ɑːpxyrde
wifhand	wiːfxɑnd
beorhthwil	be͜orxtxwiːl
oferwintran	oferwintrɑn
erian	erjɑn
corn	korn
unlust	unlust
horsminte	xorsminte
reoht	rixt
ciricþing	t͡ʃirit͡ʃθinɡ
firenum	firenum
hamcyme	xɑːmkyme
steorfan	ste͜orfɑn
smeortan	sme͜ortɑn
landfruma	lɑndfrumɑ
swan	swɑːn
unnan	unnɑn
ærs	ærs
edgeong	edjunɡ
forecweþan	forekweθɑn
lenctenlic	lenktenliːt͡ʃ
anfealdnys	ɑːnfæ͜ɑldnys
bræmbel	bræmbel
gecwician	jekwikiɑn
cac	kɑk
gewitan	jewitɑn
merian	merjɑn
wolde	wolde
untigan	untiːjɑn
fream	fræːɑ̯m
spildan	spildɑn
behegian	bexeɡiɑn
wicg	wijj
hæl	xæːl
cest	t͡ʃest
windscofl	windʃofl
trum	trum
gesweostor	jeswe͜ostor
hran	xrɑːn
rihtwisnes	rixtwiːsnes
eahtian	æ͜ɑxtiɑn
œfest	øfest
geweaxan	jewæ͜ɑksɑn
ofersprecan	ofersprekɑn
sluncon	slunkon
hwam	xwɑːm
wierrest	wi͜yrrest
bece	bet͡ʃe
feran	feːrɑn
wæscern	wæskern
ciricsangere	t͡ʃirit͡ʃsɑnɡere
abugan	ɑːbuːɡɑn
yfel	yfel
ænig	æːnij
ymb	ymb
hearding	xæ͜ɑrdinɡ
befleogan	befle͜oːɡɑn
bisgian	bisjiɑn
wohceapung	woːxt͡ʃæ͜ɑːpunɡ
fand	fɑnd
þryþ	θryːθ
geþencan	jeθent͡ʃɑn
geoluread	je͜oluræ͜ɑːd
wuldorhama	wuldorxɑmɑ
efel	efel
tolysan	toːlyːsɑn
gesceapennes	jeʃæ͜ɑpennes
scrimman	ʃrimmɑn
andweardian	ɑndwæ͜ɑrdiɑn
morþsliht	morθslixt
firenhycga	firenxyjjɑ
ban	bɑːn
gebidan	jebiːdɑn
orþian	orθiɑn
beflean	beflæ͜ɑːn
weder	weder
cent	kent
sceanca	ʃɑnkɑ
monaþ	monɑθ
underneoþan	underne͜oθɑn
psealm	psæ͜ɑlm
midwist	midwist
frician	frikiɑn
grafan	ɡrɑfɑn
forligerhus	forlijerxuːs
wudiht	wudixt
moder	moːder
forweorþan	forwe͜orθɑn
feondscipe	fe͜oːndʃipe
sweore	swe͜ore
neosian	ne͜oːsiɑn
ece	eːt͡ʃe
inlihtan	inliːxtɑn
hlysnan	xlysnɑn
heahflod	xæ͜ɑːxfloːd
efenbyrde	efenbyrde
ceapian	t͡ʃæ͜ɑːpiɑn
cinn	kinn
pryte	pryːte
hieg	xi͜yːj
brecan	brekɑn
egypte	eɡypte
gehebban	jexebbɑn
bord	bord
leodscipe	le͜oːdʃipe
healh	hæɑlx
þufbære	θuːfbæːre
earnian	æ͜ɑrniɑn
gewiht	jewixt
grimm	ɡrimm
gewyrcean	jewyrt͡ʃæ͜ɑn
endesæta	endesæːtɑ
wundrian	wundriɑn
gemœtan	jemøːtɑn
hælettung	xæːlettunɡ
tidlice	tiːdliːt͡ʃe
fulwiht	fulwixt
biterlice	biterliːt͡ʃe
onþracian	onθrɑkiɑn
ymbstandan	ymbstɑndɑn
monelic	moːneliːt͡ʃ
stenc	stent͡ʃ
eadweard	æ͜ɑːdwæ͜ɑrd
micel	mit͡ʃel
wælstow	wælstoːw
ymbcyrran	ymbt͡ʃyrrɑn
primsang	priːmsɑnɡ
raþe	rɑθe
tredan	tredɑn
anes	ɑːnes
sceaf	ʃæ͜ɑːf
gefredan	jefreːdɑn
hloþ	xloːθ
pullian	pulliɑn
frencisc	frent͡ʃiʃ
onettan	onettɑn
mylenhweol	mylenxwe͜oːl
geblowan	jebloːwɑn
læfan	læːfɑn
niwan	niːwɑn
onhyrdan	onxyrdɑn
treowsian	tre͜oːwsiɑn
cwomon	kwoːmon
weste	weːste
sinc	sink
plantsticca	plɑntstikkɑ
lifian	lifiɑn
fiell	fi͜yll
wunung	wununɡ
gylden	ɡylden
wiþercweþan	wiθerkweθɑn
blod	bloːd
swyftlice	swyftliːt͡ʃe
geliclic	jeliːkliːt͡ʃ
frec	frek
cwelende	kwelende
grindan	ɡrindɑn
godsibb	ɡodsibb
inweard	inwæ͜ɑrd
eftgemyndgian	eftjemyndjiɑn
restan	restɑn
gewat	jewɑːt
mægdencild	mæjdent͡ʃild
blissian	blissiɑn
feohern	fe͜oxern
cin	t͡ʃin
bryrdan	bryrdɑn
gemot	jemoːt
scrifan	ʃriːfɑn
hleapere	xlæ͜ɑːpere
edniewiend	edni͜yːwiend
firgen	firɡen
cildisc	t͡ʃildiʃ
manscyldig	mɑːnʃyldij
hlose	xloːse
oferdon	oferdoːn
senep	senep
giese	ji͜yːse
wæstmleas	wæstmlæ͜ɑːs
gea	jæ͜ɑː
stunian	stuniɑn
cuþlice	kuːθliːt͡ʃe
dugan	duɡɑn
stiele	sti͜yːle
ætsteall	ætstæ͜ɑll
bryce	bryːt͡ʃe
man	mɑn
genihtsumian	jenixtsumiɑn
styntan	styntɑn
anbyrdnes	ɑnbyrdnes
geswinc	jeswink
lodrung	lodrunɡ
smiþþe	smiθθe
wæpnedmann	wæːpnedmɑnn
nihtsumnes	nixtsumnes
unsyfre	unsyːfre
oferdrifan	oferdriːfɑn
dihtnian	dixtniɑn
hengen	xenjen
wong	wonɡ
cuppe	kuppe
drehtest	drehtest
nama	nɑmɑ
heoru	xe͜oru
ceorran	t͡ʃe͜orrɑn
alfæt	ɑːlfæt
biscop	biʃʃop
irnan	irnɑn
bletsian	bleːtsiɑn
gewemman	jewemmɑn
gyldan	jyldɑn
lagucræftig	lɑɡukræftij
herebeorgian	xerebe͜orɡiɑn
gedrefnes	jedreːfnes
wyrst	wyrst
famig	fɑːmij
gener	jener
geblissian	jeblissiɑn
wæstmbæru	wæstmbæːru
lindhæbbend	lindxæbbend
blawan	blɑːwɑn
gehiertan	jexi͜yrtɑn
wyda	wydɑ
gehyrsum	jexyːrsum
sicornes	sikornes
hine	hine
mildheortlic	mildxe͜ortliːt͡ʃ
drithen	dritxen
freols	fre͜oːls
ufeweard	ufewæ͜ɑrd
wyrp	wyrp
wuldorþrymm	wuldorθrymm
stig	stij
unlæd	unlæːd
wiglian	wiɡliɑn
hell	xell
onwoc	onwoːk
sealf	sæ͜ɑlf
hydan	xyːdɑn
godspel	ɡodspel
offestre	offeːstre
batweard	bɑːtwæ͜ɑrd
gebeor	jebe͜oːr
winterfylleþ	winterfylleθ
ymbsittan	ymbsittɑn
ungehiersumnes	unjexi͜yːrsumnes
abidan	ɑːbiːdɑn
cradol	krɑdol
gebicnian	jebiːkniɑn
hund	xund
inblawan	inblɑːwɑn
staþolian	stɑθoliɑn
geondfaran	je͜ondfɑrɑn
sygor	syɡor
macian	mɑkiɑn
lustfullice	lustfulliːt͡ʃe
runian	ruːniɑn
hatheortnes	xɑːtxe͜ortnes
ealdormann	æ͜ɑldormɑnn
unsyferlic	unsyːferliːt͡ʃ
hrieman	xri͜yːmɑn
ealuhus	æ͜ɑluxuːs
wiþheardian	wiθxæ͜ɑrdiɑn
motern	moːtern
ofersettan	ofersettɑn
ceallian	t͡ʃæ͜ɑlliɑn
þone	θone
genip	jenip
mennisclicnes	menniʃliːknes
wif	wiːf
forbærnan	forbærnɑn
twelfta	twelftɑ
gewritere	jewritere
heahstede	xæ͜ɑːxstede
fætels	fætels
sican	siːkɑn
wægnwyrhta	wæjnwyrxtɑ
swicol	swikol
nytwierþnes	nytwi͜yrθnes
ofslean	ofslæ͜ɑːn
unforesceawod	unforeʃæ͜ɑːwod
rasian	rɑːsiɑn
gebodian	jebodiɑn
geþuxian	jeθuksiɑn
grot	ɡrot
gæsthus	ɡæstxuːs
fægnian	fæjniɑn
ceorfan	t͡ʃe͜orfɑn
geþeon	jeθe͜oːn
wepan	weːpɑn
græses	ɡræses
dohtor	doxtor
spendan	spendɑn
aberendlic	ɑːberendliːt͡ʃ
mishieran	misxi͜yːrɑn
cliþa	kliːθɑ
leðer	leθer
sæcc	sætt͡ʃ
anige	ɑːniːje
seoc	se͜oːk
gelafian	jelɑfiɑn
bisignes	bisijnes
ofmunan	ofmunɑn
drefednes	dreːfednes
fnæst	fnæst
þancian	θɑnkiɑn
eorþ	e͜orθ
gefæstnian	jefæstniɑn
inburh	inburx
ærende	æːrende
deorling	de͜oːrlinɡ
sweorice	swe͜oːriːt͡ʃe
wendlas	wendlɑs
geþoht	jeθoːxt
oferdrincan	oferdrinkɑn
clysan	klyːsɑn
carian	kɑriɑn
ascufan	ɑːʃuːfɑn
geman	jemɑn
gemædan	jemæːdɑn
hætan	xæːtɑn
dægmæl	dæjmæːl
flodyþ	floːdyːθ
seoslig	se͜oːslij
ymbsellan	ymbsellɑn
hyrian	xyrjɑn
bleat	blæ͜ɑːt
annes	ɑːnnes
prician	prikiɑn
inlice	inliːt͡ʃe
hunden	xunden
fneosan	fne͜oːsɑn
þissum	θissum
þreotiene	θre͜oːti͜yːne
gærs	ɡærs
sceard	ʃæ͜ɑrd
oferlecgan	oferlejjɑn
grima	ɡriːmɑ
xerxis	kserksis
wohhæmere	woːxxæːmere
handweorc	xɑndwe͜ork
geþringan	jeθrinɡɑn
tyncen	tynt͡ʃen
hreþ	xreːθ
geteld	ɡeteld
cater	kɑter
eoforþring	e͜oforθrinɡ
eadwulf	æ͜ɑːdwulf
gedwimor	jedwimor
hus	xuːs
alan	ɑlɑn
forgeaf	forjæɑ̯f
leassagol	læ͜ɑːssɑɡol
tocyrran	toːt͡ʃyrrɑn
hæftling	xæftlinɡ
sniwan	sniːwɑn
hæman	xæːmɑn
healdsum	xæ͜ɑldsum
earmcearig	æ͜ɑrmt͡ʃæ͜ɑrij
wigweorþung	wiːjwe͜orθunɡ
anlec	ɑnleːt͡ʃ
hwælweg	xwælwej
wintergerim	winterjeriːm
spearca	spæ͜ɑrkɑ
eadburh	æ͜ɑdburx
geceosan	jet͡ʃe͜oːsɑn
florstan	floːrstɑːn
buton	buːton
dufenal	dufenɑl
þræd	θræːd
niewung	ni͜yːwunɡ
hyldu	xyldu
æþm	æːθm
fals	fɑls
geferræden	jefeːrræːden
foresteall	forestæ͜ɑll
mishyran	misxyːrɑn
sceara	ʃæːɑ̯rɑ
fiffeald	fiːffæ͜ɑld
wiþsacendlic	wiθsɑkendliːt͡ʃ
byrgenn	byrjenn
beorhtian	be͜orxtiɑn
dreosan	dre͜oːsɑn
cræftlic	kræftliːt͡ʃ
manslaga	mɑnslɑɡɑ
hwetstan	xwetstɑːn
bedreda	bedredɑ
sin	siːn
bryd	bryːd
ongitan	onjitɑn
slæpern	slæːpern
bodeg	bodej
unþanc	unθɑnk
hearpe	xæ͜ɑrpe
sincan	sinkɑn
wæd	wæːd
cyneþrym	kyneθrym
hundeahtatig	xundæ͜ɑxtɑtij
snegel	snejel
angsum	ɑnɡsum
is	iːs
weddian	weddiɑn
getæht	jetæːxt
babilonie	bɑbiloːnie
behindan	bexindɑn
æfwela	æfwelɑ
eglan	ejlɑn
gebigednes	jebiːjednes
uton	uton
hrisian	xrisiɑn
sweltan	sweltɑn
efnan	efnɑn
getwisa	jetwisɑ
bæc	bæt͡ʃ
wuduculfre	wudukulfre
cenþu	keːnθu
gelæte	jelæːte
nagan	nɑːɡɑn
geþeodnes	jeθe͜oːdnes
pearroc	pæ͜ɑrrok
risaþ	riːsɑθ
forhydan	forxyːdɑn
spyrian	spyrjɑn
cumliþe	kumliːθe
sceolu	ʃe͜olu
forslawian	forslɑːwiɑn
wearriht	wæ͜ɑrrixt
bita	bitɑ
leodgeþincþu	le͜oːdjeθinkθu
dustsceawung	duːstʃæ͜ɑːwunɡ
gelanda	jelɑndɑ
gefeohtan	jefe͜oxtɑn
gesundrian	jesundriɑn
modiglic	moːdijliːt͡ʃ
sciphere	ʃipxere
friþigend	friθijend
geferlæcan	jefeːrlæːt͡ʃɑn
frumsceaft	frumʃæ͜ɑft
bealo	bæ͜ɑlo
ægre	æːjre
fleo	fle͜oː
goshafoc	ɡoːsxɑfok
niwlice	niːwliːt͡ʃe
ciricæwe	t͡ʃirit͡ʃæːwe
trucian	trukiɑn
spurnan	spurnɑn
traht	trɑxt
gewinnan	jewinnɑn
bregdan	brejdɑn
bena	beːnɑ
dæge	dæje
raha	rɑːxɑ
oferwyrcan	oferwyrt͡ʃɑn
hadbot	xɑːdboːt
ceafl	t͡ʃæ͜ɑfl
unstaþolfæstnes	unstɑθolfæstnes
þurhclænsian	θurxklæːnsiɑn
gebygednys	jebyːjednys
nioðan	ni͜uθɑn
foreweard	forewæ͜ɑrd
blæwen	blæːwen
friþsumian	friθsumiɑn
lecgan	lejjɑn
agend	ɑːɡend
metgian	metɡiɑn
loga	loɡɑ
oþþe	oθθe
liccian	likkiɑn
sal	sɑːl
fealle	fæ͜ɑlle
forstandan	forstɑndɑn
ta	tɑː
sweard	swæ͜ɑrd
misfon	misfoːn
friþian	friθiɑn
þiestre	θi͜yːstre
inneweard	innewæ͜ɑrd
gecynd	jekynd
upeard	upæ͜ɑrd
burne	burne
clænan	klæːnɑn
guma	ɡumɑ
clud	kluːd
scipfæreld	ʃipfæreld
gecennan	ɡekennɑn
racente	rɑkente
dryge	dryːje
eftacenned	eftɑːkenned
ligetræsc	liːjetræʃ
denemearc	denemæ͜ɑrk
aldwine	ɑldwine
hragra	xrɑːɡrɑ
monaþblod	moːnɑθbloːd
flett	flett
segel	sejel
wer	wer
geondfeolan	je͜ondfe͜oːlɑn
adilegian	ɑːdileɡiɑn
hio	xi͜uː
fiftiene	fiːfti͜yːne
dust	duːst
dreoriglice	dre͜oːrijliːt͡ʃe
cornbære	kornbæːre
ofermod	ofermoːd
bedofen	bedofen
ofett	ofett
acwælon	ɑːkwæːlon
brand	brɑnd
cimban	t͡ʃimbɑn
mildelice	mildeliːt͡ʃe
wiffreond	wiːffre͜oːnd
hweg	xweːj
beclysan	beklyːsɑn
cunnan	kunnɑn
onbugan	onbuːɡɑn
cearu	t͡ʃæ͜ɑru
hyldræden	xyldræːden
forefon	forefoːn
hæring	xæːrinɡ
heahencgel	xæ͜ɑːxenjel
firenleahtor	firenlust
mearum	mæ͜ɑːrum
ule	uːle
bedecian	bedekiɑn
forbiernan	forbi͜yrnɑn
modcræftig	moːdkræftij
wrecan	wrekɑn
laþgeteona	lɑːθjete͜oːnɑ
sund	sund
genihtsumlice	jenixtsumliːt͡ʃe
weall	wæ͜ɑll
musfealle	muːsfæ͜ɑlle
tol	toːl
winterbiter	winterbiter
wuldorlic	wuldorliːt͡ʃ
tintregian	tintreɡiɑn
wæstmsceatt	wæstmʃæ͜ɑtt
ispania	ispɑːniɑ
wearn	wæ͜ɑrn
græg	ɡræːj
fearm	fæ͜ɑrm
mæsling	mæslinɡ
facentacen	fɑːkentɑːken
gesceawian	jeʃæ͜ɑːwiɑn
forbugennes	forbuːɡennes
drync	drynt͡ʃ
witodlice	witodliːt͡ʃe
gewuldorbeagian	jewuldorbæ͜ɑːɡiɑn
geræd	jeræːd
mawan	mɑːwɑn
hlafæta	xlɑːfæːtɑ
siexta	si͜ykstɑ
bedon	bedoːn
odissia	odissiɑ
denisc	deniʃ
fleon	fle͜oːn
beorg	be͜orɡ
lyften	lyften
ceowan	t͡ʃe͜oːwɑn
mishweorfan	misxwe͜orfɑn
cealdheort	t͡ʃæ͜ɑldxe͜ort
seolh	se͜olx
forswiþan	forswiːθɑn
forewritan	forewriːtɑn
timber	timber
scuwa	ʃuːwɑ
þerscweald	θerʃwæ͜ɑld
hefig	xefij
ahycgan	ɑːxyjjɑn
sweostor	swe͜ostor
waldhere	wɑldxere
friþ	friːθ
wæterflod	wæterfloːd
dracu	drɑku
gardena	ɡɑːrdenɑ
wogere	woːɡere
gemænelic	jemæːneliːt͡ʃ
dihtan	dixtɑn
stycce	stytt͡ʃe
witword	witword
hwerhwette	xwerxwette
scobl	ʃobl
ineardiend	inæ͜ɑrdiend
taht	tɑːxt
wrotan	wroːtɑn
fugol	fuɡol
soþe	soːθe
forsceadan	forʃæ͜ɑːdɑn
cyrlic	t͡ʃyrlik
oferheafod	oferxæ͜ɑːfod
foresettan	foresettɑn
hearmascinnen	xæ͜ɑrmɑʃinnen
aldor	ɑldor
west	west
stingan	stinɡɑn
unsur	unsuːr
winterlæcan	winterlæːt͡ʃɑn
racu	rɑku
bocstæf	boːkstæf
yfelwillende	yfelwillende
arleas	ɑːrlæ͜ɑːs
lustbære	lustbæːre
ehtan	eːxtɑn
heaþowæd	xæ͜ɑθowæːd
gyrstanniht	jyrstɑnnixt
hwær	xwæːr
unhlisa	unxliːsɑ
hweorfan	xwe͜orfɑn
oferlædan	oferlæːdɑn
hleotan	xle͜oːtɑn
becyrran	bet͡ʃyrrɑn
formest	formest
lieg	li͜yːj
fixen	fiksen
æwnian	æːwniɑn
norþ	norθ
inc	ink
þeoden	θe͜oːden
gamnian	ɡɑmniɑn
cnocian	knokiɑn
sealtnes	sæ͜ɑltnes
gecnyssan	jeknyssɑn
red	red
hlynsian	xlynsiɑn
libban	libbɑn
gewritræden	jewritræːden
sunbryne	sunbryne
weman	weːmɑn
þindan	θindɑn
hæþen	xæθen
misbeodan	misbe͜oːdɑn
geswican	jeswiːkɑn
larleast	lɑːrlæ͜ɑːst
brom	broːm
ciricgemana	t͡ʃirit͡ʃjemɑːnɑ
gecwidræden	jekwidræːden
scanca	ʃɑnkɑ
bestelan	bestelɑn
stridan	striːdɑn
hebban	xebbɑn
wesan	wesɑn
tusc	tuːsk
elene	elene
staþolfæstlic	stɑθolfæstliːt͡ʃ
forscyldigian	forʃyldiɡiɑn
behelmian	bexelmiɑn
bedælan	bedæːlɑn
picgbread	piɡɡbræ͜ɑːd
hyrde	xyrde
niewe	ni͜yːwe
hetting	xettinɡ
ele	ele
dæglanges	dæjlɑnɡes
fætt	fæːtt
ymbscriþan	ymbʃriːθɑn
scylding	ʃyldinɡ
geweorpan	jewe͜orpɑn
metan	meːtɑn
wyrnan	wyrnɑn
scriþan	ʃriːθɑn
forð	forθ
gesawan	jesɑːwɑn
þrag	θrɑːɡ
leoþian	le͜oːθiɑn
eotol	e͜otol
geniht	jenixt
beardleas	bæ͜ɑrdlæ͜ɑːs
mæssedæg	mæssedæj
gehwædnes	jexwæːdnes
meteleas	metelæ͜ɑːs
bon	boːn
ætberan	ætberɑn
horscamb	xorskɑmb
þeo	θe͜oː
onhweorfan	onxwe͜orfɑn
getacnung	jetɑːknunɡ
glædmann	ɡlædmɑnn
geþeode	jeθe͜oːde
deoplice	de͜oːpliːt͡ʃe
asceotan	ɑːʃe͜oːtɑn
naman	nɑmɑn
blacern	blɑːkern
scieppan	ʃi͜yppɑn
æfgælþ	æfɡælθ
belle	belle
gewiss	jewiss
unfrod	unfroːd
cene	keːne
biernan	bi͜yrnɑn
behweorfan	bexwe͜orfɑn
gehat	jexɑːt
hofor	xofor
lifgedal	liːfjedɑːl
cildhad	t͡ʃildxɑːd
dryht	dryxt
prætt	prætt
geondleccan	je͜ondlett͡ʃɑn
sinewealt	sinewæ͜ɑlt
elcor	elkor
ciriclic	t͡ʃirikliːt͡ʃ
heden	xeden
niþful	niːθful
onwadan	onwɑdɑn
geatwa	jæ͜ɑtwɑ
stiocian	sti͜ukiɑn
dag	dɑːɡ
dynt	dynt
loca	loːk
gemearcian	jemæ͜ɑrkiɑn
befreogan	befre͜oːjɑn
besincan	besinkɑn
meara	mæ͜ɑːrɑ
efenlice	efenliːt͡ʃe
forboden	forboden
glær	ɡlær
slitan	sliːtɑn
fina	finɑ
unsoþian	unsoːθiɑn
heahgast	xæ͜ɑːxɡɑːst
bescufan	beʃuːfɑn
sicerian	sikeriɑn
lus	luːs
gemærsung	jemæːrsunɡ
ælf	ælf
scucca	ʃukkɑ
beoceorl	be͜oːt͡ʃe͜orl
togang	toːɡɑnɡ
ure	uːre
giefan	ji͜yfɑn
selerædend	seleræːdend
gemære	jemæːre
utgang	uːtɡɑnɡ
ealh	æ͜ɑlx
swinc	swink
carr	kɑrr
unnytwierþe	unnytwi͜yrθe
birnan	birnɑn
wæpnian	wæːpniɑn
forsendan	forsendɑn
swinhierde	swiːnxi͜yrde
afol	ɑfol
giddung	jiddunɡ
earmhread	æ͜ɑrmxræ͜ɑːd
helma	xelmɑ
hron	xron
ungripendlic	unɡriːpendliːt͡ʃ
cunnian	kunniɑn
eorþberige	e͜orθberije
uu	w
beorsele	be͜oːrsele
myne	myne
andwlita	ɑndwlitɑ
onlysan	onlyːsɑn
eolh	e͜olx
ora	oːrɑ
heafdeht	xæ͜ɑːfdext
gisel	jiːsel
broþor	broːθor
gedreohlice	jedre͜oːxliːt͡ʃe
wæringwic	wæːrinɡwiːt͡ʃ
coc	kok
earsþyrel	æ͜ɑrsθyːrel
gerim	jeriːm
bacum	bɑkum
ord	ord
ribb	ribb
mægen	mæjen
copp	kopp
hierusalem	jerusɑlem
flyht	flyxt
eorþcræft	e͜orθkræft
wic	wiːt͡ʃ
wihtwara	wixtwɑrɑ
sæcgan	sæjjɑn
ostre	ostre
logian	loːɡiɑn
sceada	ʃæ͜ɑːdɑ
swilc	swilt͡ʃ
scene	ʃeːne
acyrran	ɑːt͡ʃyrrɑn
ielfsogoþa	i͜ylfsoɡoθɑ
oferlibban	oferlibbɑn
eardiendlic	æ͜ɑrdiendliːt͡ʃ
gecwide	jekwide
sencan	sent͡ʃɑn
stiepel	sti͜yːpel
bisigu	bisiju
siex	si͜yks
gesceaphwil	jeʃæ͜ɑpxwiːl
mencgan	menjɑn
yrnan	yrnɑn
hreaþemus	xræ͜ɑːθemuːs
dægsteorra	dæjste͜orrɑ
feld	feld
mynelic	myneliːt͡ʃ
for	for
ærendwreccan	æːrendwrett͡ʃɑn
linen	liːnen
geard	jæ͜ɑrd
nædl	næːdl
gesundful	jesundful
wiþþe	wiθθe
blodleas	bloːdlæ͜ɑːs
osle	oːsle
hierstan	xi͜yrstɑn
wærsagol	wærsɑɡol
wearte	wæ͜ɑrte
boclic	boːkliːt͡ʃ
gemunan	jemunɑn
leow	le͜oːw
dreorignys	dre͜oːrijnys
engel	enjel
teld	teld
ulan	uːlɑn
leodan	le͜oːdɑn
misscrydan	misʃryːdɑn
sceamu	ʃɑmu
gesnot	jesnot
godspellere	ɡodspellere
liegþracu	li͜yːjθrɑku
sawelþearf	sɑːwelθæ͜ɑrf
stapol	stɑpol
fenlic	fenliːt͡ʃ
scot	ʃot
deogol	de͜oːɡol
and	ɑnd
þærwiþ	θæːrwiθ
flicorian	flikoriɑn
ceorfdeor	t͡ʃe͜orfde͜oːr
sliefleas	sli͜yːflæ͜ɑːs
gesyndrian	jesyndriɑn
deaþlieg	dæ͜ɑːθli͜yːj
þunor	θunor
witodlic	witodliːt͡ʃ
strengþo	strenɡθo
þuma	θuːmɑ
forrædan	forræːdɑn
pis	piːs
fylan	fyːlɑn
fam	fɑːm
grundweall	ɡrundwæ͜ɑll
ing	inɡ
rof	roːf
genemnan	jenemnɑn
wisle	wiːsle
sciete	ʃi͜yːte
larbysen	lɑːrbyːsen
ute	uːte
beneoþan	bene͜oθɑn
cedrisc	kedriʃ
medumian	medumiɑn
sealtyþ	sæ͜ɑltyːθ
næglan	næjlɑn
scieppian	ʃi͜yppiɑn
hymele	xymele
becrafian	bekrɑfiɑn
mæger	mæjer
þryþswyþ	θryːθswyːθ
mersc	merʃ
wiccecræft	witt͡ʃekræft
misfoh	misfoːx
olfend	olfend
fremde	fremde
fifealde	fiːfæ͜ɑlde
selfcwalu	selfkwɑlu
ehtend	eːxtend
eþelland	eːθellɑnd
onhierdan	onxi͜yrdɑn
teru	teru
behreosan	bexre͜oːsɑn
surian	suːriɑn
siextiene	si͜yksti͜yːne
forstelan	forstelɑn
toflowan	toːfloːwɑn
geondferan	je͜ondfeːrɑn
hleorberg	xle͜oːrberɡ
hlæst	xlæst
teoru	te͜oru
melu	melu
began	beɡɑːn
swiþhun	swiːθxuːn
mislician	misliːkiɑn
geagniendlic	jɑːɡni͜yndliːt͡ʃ
belicgan	belijjɑn
eallic	æ͜ɑlliːt͡ʃ
leodweard	le͜oːdwæ͜ɑrd
ginian	jiniɑn
læran	læːrɑn
handlian	xɑndliɑn
sweflenum	sweflenum
misdæd	misdæːd
weallian	wæ͜ɑlliɑn
saht	sɑxt
foreseon	forese͜oːn
tolucan	toːluːkɑn
gewyscendlic	jewyːʃʃendliːt͡ʃ
geteorian	jete͜oːriɑn
scyldwite	ʃyldwiːte
tin	tin
þyrs	θyrs
acan	ɑkɑn
socc	sokk
niwian	niːwiɑn
forþgang	forθɡɑnɡ
searu	sæ͜ɑru
eardiende	æ͜ɑrdiende
ra	rɑː
forspennend	forspennend
boccræft	boːkkræft
hype	xype
gebringan	jebrinɡɑn
forecuman	forekumɑn
dwola	dwolɑ
scohwyrhta	ʃoːxwyrxtɑ
fæger	fæjer
nifol	nifol
ond	ond
befleon	befle͜oːn
merscmealwe	merʃmæ͜ɑlwe
ortgeard	ortjæ͜ɑrd
garsecg	ɡɑːrsejj
leafa	læ͜ɑːfɑ
spic	spit͡ʃ
oferhabban	oferxɑbbɑn
gombe	ɡombe
caserlic	kɑːserliːt͡ʃ
ahierdan	ɑːxi͜yrdɑn
hleor	xle͜oːr
hindanweard	xindɑnwæ͜ɑrd
hafela	xɑfelɑ
hwænne	xwænne
tæppa	tæppɑ
norþerne	norθerne
brun	bruːn
ungeswenced	unjeswent͡ʃed
grisan	ɡriːsɑn
eftgemyndig	eftjemyndij
