မြင်း	mjɪ́ɴ
ကျားလျှာ	t͡ɕáʃà
အိုလံပစ်	ʔòlàɴpɪʔ
ဓာတုဗေဒ	dàtṵbèda̰
ခြားနားချက်	t͡ɕʰánád͡ʑɛʔ
စာရွက်စာတမ်း	sàjwɛʔsàdáɴ
ညို	ɲò
ညီနောင်	ɲìnàʊɴ
ခေါက်ဆွဲသုပ်	kʰaʊʔsʰwɛ́θoʊʔ
တပ်မတော်	taʔmədɔ̀
ဖဦးထုပ်	pʰa̰ʔútʰoʊʔ
ပစ္စက္ခ	pɪʔsɛʔkʰa̰
သင်းဝင်	θɪ́ɴwɪ̀ɴ
ချဉ်	t͡ɕʰɪ̀ɴ
ဧက	ʔèka̰
ကွန်ပါ	kʊ̀ɴpà
ဟိတ်	heɪʔ
ဇွန်း	zʊ́ɴ
ထက်ဝယ်ဖွဲ့ခွေ	tʰɛʔwɛ̀pʰwɛ̰kʰwè
သဒ္ဓါကြေး	θədàt͡ɕé
ခြောက်လ	t͡ɕʰaʊʔla̰
နှော	n̥ɔ́
ဘေ့စ်ဘော	bḛsbɔ́
အုန်းနို့ခေါက်ဆွဲ	ʔóʊɴno̰kʰaʊʔsʰwɛ́
ဓာတ်ပြား	daʔpjà
ဧကာဒသမ	ʔèkàda̰θəma̰
ဟန်နီ	hàɴnì
မဇ္ဈဒေသ	mɪʔza̰dèθa̰
အဖုံဖုံ	ʔəpʰòʊɴbòʊɴ
မြေပုံသီး	mjèbòʊɴðí
တည်ဆောက်	tìsʰaʊʔ
အပူ	ʔəpù
ရေမိုင်	jèmàɪɴ
မုဒိမ်း	mṵdéɪɴ
ဘုရင်ခံ	bəjɪ̀ɴɡàɴ
ကတ်ကြေး	kaʔt͡ɕí
ဂိုဏ်းထောက်	ɡóndaʊʔ
နတ်သုဓာထမင်း	naʔθoʊʔdàtʰəmɪ́ɴ
ခေါက်ဆွဲ	kʰaʊʔsʰwɛ́
ချုပ်	t͡ɕʰoʊʔ
ကွန်ဒုံး	kʊ̀ɴdóʊɴ
ပွဲတော်	pwɛ́dɔ̀
သူရကန်	θùɹəkàɴ
မီးခွက်	míɡwɛʔ
သရက်ရွက်	θəjɛʔjwɛʔ
ထိုင်ခုံ	tʰàɪɴɡòʊɴ
သစ်	θɪʔ
ချို	t͡ɕʰò
စကားပြောကြေးနန်း	zəɡábjɔ́t͡ɕénáɴ
ပြာတာ	pjàtà
ဗမာ	bəmà
အကြမ်းဖက်သမား	ʔət͡ɕáɴpʰɛʔθəmá
ကတ္တီပါ	ɡədìbà
အာဇာနည်နေ့	ʔàzànìnḛ
ဂေါ်ရခါး	ɡɔ̀jəkʰá
ဆယ်	sʰɛ̀
ရနံ့	jəna̰ɴ
ဘကြီး	ba̰d͡ʑí
ပကောဋိ	pəkɔ́dḭ
အားလပ်ရက်	ʔálaʔjɛʔ
ပန်းချီ	bəd͡ʑì
နရန်း	nəjáɴ
နတ်	naʔ
ဗလ	bəla̰
လက်ကောက်	lɛʔkaʊʔ
မြင့်	mjɪ̰ɴ
မွှေး	m̥wé
စတေဒီယံ	sətèdìjàɴ
ဘား	pʰá
ကြိုးစား	t͡ɕózá
ဒီမှာ	dìm̥à
ပြည်သူပြည်သား	pjìðùpjìðá
လှလှ	l̥a̰l̥a̰
သန်လျင်းချိတ်	θàɴjɪ́ɴd͡ʑeɪʔ
မလိုင်	ma̰làɪɴ
သောဘိတ	θɔ́bḭta̰
စုံဖက်	sòʊɴpʰɛʔ
အပြာ	ʔəpjà
မိ	mḭ
ပိုးဟပ်ဖြူ	póhaʔpʰjù
မေမေ	mèmè
စအို	səʔò
ပန်းနာရင်ကျပ်	páɴnàjɪ̀ɴt͡ɕaʔ
ကို	kò
ဗလီ	bəlì
ဆေးဘဲဥ	sʰébɛ́ʔṵ
ဧည့်	ʔḛ
လမ်းဘေးဆိုင်	láɴbézàɪɴ
တည်း	tʰɛ́
ဒီမိုကရေစီ	dìmòkəɹèsì
မျိုးစု	mjózṵ
သမ္မတနိုင်ငံ	θəməda̰nàɪɴŋàɴ
ဈေးချို	zét͡ɕʰò
ဇင့်ခ်	zɪ̰ɴ
ရောင်း	jáʊɴ
ခရစ်	kʰəɹɪʔ
ဖာခေါင်း	pʰàɡáʊɴ
တံပူ	dəbù
စမူဆာ	səmùzà
ဖားပြုပ်	pʰəbjoʊʔ
မျက်နှာ	mjɛʔn̥à
တစ်ရာ	təjà
တပည့်တော်မ	dəbḭdɔ̀ma̰
အဘိုးကြီး	ʔəpʰód͡ʑí
သမိန်	θəmèɪɴ
စိတ်ဓာတ်	seɪʔdàt
ငရဲမင်း	ŋəjɛ́mɪ́ɴ
တည်တံ့	tìda̰ɴ
ကိုကာကိုလာ	kòkàkòlà
တန	ta̰na̰
လောလော	lɔ́lɔ́
သီးစုံချဉ်ရည်	θízòʊɴt͡ɕʰɪ̀ɴjì
ခွန်	kʰʊ̀ɴ
မယား	məjá
စိုထိုင်း	sòtʰáɪɴ
ပိုး	pó
ရေပိုက်	jèpaɪʔ
ဦးချို	ʔúd͡ʑò
သောင်းသောင်း	θáʊɴðáʊɴ
တော်ပြီ	tɔ̀bì
ပေါက်ဖော်	paʊʔpʰɔ̀
ချွေးမ	t͡ɕʰwéma̰
ပဲကြီး	pɛ́d͡ʑí
ဒံပေါက်	dàɴpaʊʔ
မီနူး	mìnú
ဂါထာ	ɡàtʰà
ဝါဏိဇ္ဇ	wàneɪʔza̰
လိုင်စင်	làɪɴsɪ̀ɴ
ပို	pò
သံဝါသ	θàɴwàθa̰
စကားလုံး	zəɡəlóʊɴ
ဒုက္ခိတ	doʊʔkʰḭta̰
သိ	θḭ
ဂရု	ɡəjṵ
ရတနာ	jɛ̀dənà
နှာခေါင်းပေါက်	n̥əkʰáʊɴbaʊʔ
ရာခိုင်နှုန်း	jàkʰàɪɴn̥óʊɴ
ဆားဘီးယား	sʰábíjá
မာတိကာ	màtḭkà
အဖျား	ʔəpʰjá
မဟာပိန္နဲ	məhàpèɪɴnɛ́
ဩဇာသီး	ʔɔ́zàθí
နှာမောင်း	n̥əmáʊɴ
ဖောင်	pʰàʊɴ
အိမ်ရှေ့မင်း	ʔèɪɴʃḛmɪ́ɴ
ဝ	wa̰
သုတေသန	θṵtèθəna̰
ဝါဂွမ်း	wàɡwáɴ
ပထမဘွဲ့	pa̰tʰəma̰bwɛ̰
တံဆိပ်	dəzeɪʔ
ဖွား	pʰwá
သုဓမ္မပူရ	θṵdəma̰pùɹa̰
စမတ်	səmaʔ
ရှူတင်	ʃùtɪ̀ɴ
ဥရုဂွေး	ʔṵɹṵʔṵɡwé
ထာဝရဥစ္စာ	tʰàwəja̰ʔoʊʔsà
အချင်း	ʔət͡ɕʰɪ́ɴ
ပုဒ်	poʊʔ
အမျိုးလေးပါး	ʔəmjólébá
မည်သည်	mìðì
ကျူးဘား	t͡ɕúbá
မကြာမတင်	mət͡ɕàmətɪ̀ɴ
နန်းပြားသုပ်	náɴbjáθoʊʔ
ပြဒါးချိန်	bədád͡ʑèɪɴ
ဘာ	bà
ဖာမ	pʰàma̰
မျိုးဥအိမ်	mjóʔṵʔèɪɴ
လေ	lè
အတိုင်း	ʔətáɪɴ
ဇီဝစက်	zìwa̰sɛʔ
ပညတ်	pjɪ̰ɴnaʔ
လျှပ်စီး	l̥jaʔsí
ဝလာဟကမြင်း	wəlàhəka̰mjɪ́ɴ
မီးခတ်	míɡaʔ
နှုတ်	n̥oʊʔ
အကြော်	ʔa̰t͡ɕɔ̀
ဘာလင်	bàlɪ̀ɴ
ဆွယ်တာ	sʰwɛ̀tà
ငါးမူး	ŋámú
တိုးတိုး	tódó
ကျို	t͡ɕò
ခနုံထုပ်	kʰənòʊɴdoʊʔ
စပါးလင်	zəbəlɪ̀ɴ
သစ်ပုပ်	θɪʔpoʊʔ
ဈာပန	zàpəna̰
စွင့်	swɪ̰ɴ
ပြဿဒါး	pjaʔðədá
လက်ဖက်	ləpʰɛʔ
ဟူးဟူး	húhú
တိုက်ပွဲ	taɪʔpwɛ́
တဆေး	təsʰé
သရဲ	θəjɛ́
နားကြပ်	nəd͡ʑaʔ
မိဘ	mḭba̰
ထုတ်လုပ်	tʰoʊʔloʊʔ
တန်ဆောင်မုန်း	dəzàʊɴmóʊɴ
ရေနံချောင်း	jènàɴt͡ɕʰáʊɴ
လင်းယဉ်	lɪ́ɴjɪ̀ɴ
နှင်းခဲ	n̥ɪ́ɴɡɛ́
ပုလဲ	pəlɛ́
ဆောင်း	sʰáʊɴ
စကြာ	sɛʔt͡ɕà
မာန်	màɴ
ပန်းပွတ်	bəbʊʔ
အင်္ဂလန်	ʔɪ̀ɴɡəlàɴ
ပြည်သူပိုင်	pjìðùbàɪɴ
အရီးကြီး	ʔəjíd͡ʑí
မျှစ်	m̥jɪʔ
မင်းသမီး	mɪ́ɴðəmí
ဖျောက်ဆိပ်	pʰjaʊʔsʰeɪʔ
စာမွဲ	səmwɛ́
လမ်းဆုံ	láɴzòʊɴ
ရပ်	jaʔ
ဖွဲ့စည်းပုံ	pʰwɛ̰zíbòʊɴ
တဲ	tɛ́
ရာဇ	jàza̰
ချစ်တီး	t͡ɕʰɪʔtí
ပြည်သူ့လွှတ်တော်	pjìðṵl̥ʊʔtɔ̀
လျှပ်စစ်ဓာတ်	l̥jaʔsɪʔdaʔ
အမြှုပ်	ʔəm̥joʊʔ
ငါးပိထောင်း	ŋápḭtʰáʊɴ
အငွေ့	ʔa̰ŋwḛ
တဏှင်္ကရာဘုရား	tən̥ɪ̀ɴkəɹàpʰəjá
ပရိက္ခရာ	pəɹeɪʔkʰəjà
ယဉ်ကျေးမှု	jɪ̀ɴt͡ɕém̥ṵ
အီးပေါက်	ʔípaʊʔ
ရက်ရာဇာ	jɛʔjàzà
ပဋိပက္ခဒေသ	pədḭpɛʔkʰa̰dèθa̰
ဂီတပညာ	ɡìta̰pa̰ɲà
စာစောင်	sàzàʊɴ
ရွှေတောင်	ʃwèdàʊɴ
ရော်ဘာ	ɹɔ̀bà
လေထု	lèdṵ
ဝေဿဘူ	wètθəbù
တနင်္လာ	tənɪ́ɴlà
မီးခိုး	míɡó
ရဝိန်	jəwèɪɴ
အဝင်	ʔəwɪ̀ɴ
ဆံ	sʰàɴ
တိတ်	teɪʔ
ကော်ပီ	kɔ̀pì
စစ်တုရင်	sɪʔbəjɪ̀ɴ
အော်	ʔɔ̀
စည်းပုံ	síbòʊɴ
ရှစ်	ʃɪʔ
အသုပ်	ʔəθoʊʔ
အားနာပါးနာ	ʔánàpánà
စွပ်ပြုတ်	sʊʔpjoʊʔ
ကွန်ကရစ်	kʊ̀ɴɡəɹɪʔ
ရာသီဥတု	jàðìʔṵdṵ
မုန့်အုပ်ကလေး	mo̰ʊɴʔoʊʔɡəlé
ရာဇသတ်	jàzəθaʔ
အပြာမယ်	ʔəpjàmɛ̀
ဆိုဆုံးမ	sʰòsʰóʊɴma̰
တိုက်	taɪʔ
ယောဇနာ	jɔ́zənà
တေးသွား	téðwá
အရောင်းအဝယ်	ʔəjáʊɴʔəwɛ̀
တောင်းပန်	táʊɴbàɴ
အိမ်မြှောင်	ʔèɪɴm̥jàʊɴ
အိန္ဒိယ	ʔèɪɴdḭja̰
ဇနပုဒ်	zənəpoʊʔ
ပူဇော်	pùzɔ̀
ကက်ပတိန်	kɛʔpətèɪɴ
ဗိုက်	baɪʔ
ဒကာ	dəɡà
ထွန်း	tʰʊ́ɴ
ခြေသည်း	t͡ɕʰèðé
လေးထောင့်	léda̰ʊɴ
အစွန်း	ʔəsʊ́ɴ
ကူးစက်ရောဂါ	kúzɛʔjɔ́ɡà
အာနီ	ʔànì
မုတ်ဆိတ်	moʊʔsʰeɪʔ
ထုတ်လုပ်မှု	tʰoʊʔloʊʔm̥ṵ
လို	lò
အမှန်တရား	ʔəm̥àɴtəjá
ခဏခဏ	kʰəna̰ɡəna̰
ဝမ်းနည်း	wáɴné
ရာဇဝတ်	jàzəwʊʔ
ဝါဏိဇ္ဇပဋိပက္ခ	wàneɪʔza̰pədḭpɛʔkʰa̰
အယ်လဘမ်	ʔɛ̀ləbàɴ
နာမည်	nàmjì
အခု	ʔəkʰṵ
စောပြာ	sɔ́bjà
မှန်စာ	m̥àɴzà
ပို့စကတ်	po̰səkaʔ
နိုင်ငံကူးလက်မှတ်	nàɪɴŋàɴɡúlɛʔm̥aʔ
ဩဌဇ	ʔɔ́tʰəza̰
လေထီး	lèdí
မင်းကွတ်	mɪ́ɴɡʊʔ
တောသီတင်း	tɔ́θìdɪ́ɴ
နွား	nwá
ရုပ်ကလာပ်	joʊʔkəlaʔ
ခို	kʰò
ယင်	jɪ̀ɴ
နတ်သုဓာ	naʔθoʊʔdà
နိုင်ဂျီးရီးယား	nàɪɴd͡ʑíɹíjá
ဆလိုဗားကီးယား	sʰəlòbákíjá
သံပရို	θàɴba̰jò
ပေါ်လစီ	pɔ̀ləsì
ကင်ပွန်း	kɪ̀ɴbʊ́ɴ
ခံယူချက်	kʰàɴjùd͡ʑɛʔ
ဗာတီကန်	bàtìkàɴ
ဘဏ္ဍာရေး	bàndàjé
တည်	tɛ̀
လုံခြုံရေး	lòʊɴd͡ʑòʊɴjé
နိုင်ငံ	nàɪɴŋàɴ
ခွေးရူးပြန်ရောဂါ	kʰwéjúbjàɴjɔ́ɡà
ရင်ဘတ်	jɪ̀ɴbaʔ
အတိုး	ʔətó
ဖျင်ဖျင်	pʰjɪ̀ɴbjɪ̀ɴ
ကြယ်	t͡ɕɛ̀
ခေါင်းဆောင်	ɡáʊɴsʰàʊɴ
ဟာနွိုင်း	hànwáɪɴ
လက်ခံ	lɛʔkʰàɴ
ရာဝဏ	ɹàwəna̰
မိုက်	maɪʔ
ထောက်ပံ့	tʰaʊʔpa̰ɴ
နိုဝင်ဘာ	nòwɪ̀ɴbà
ဘုရား	pʰəjá
စာရင်းကိုင်ပညာ	səjɪ́ɴɡàɪɴpjɪ̀ɴɲà
မ	mə
လက်ပံခါး	lɛʔpàɴɡá
ဗုဒ္ဓ	boʊʔda̰
ပုဏ္ဏား	pòʊɴná
ကောက်ရိုး	kaʊʔjó
ခေတ်	kʰɪʔ
ဒေါင်း	dáʊɴ
အမရပူရ	ʔəməja̰pùja̰
ယာဘ	jàba̰
ဖန်ခါး	pʰàɴɡá
ဘော်ဒါကြေး	bɔ̀dàt͡ɕé
ကုလားဖြူ	kələpʰjù
အတာ	ʔətà
ပန်းသေး	páɴðé
စုပ်စုပ်	soʊʔsoʊʔ
ဘင်း	bɪ́ɴ
ရှည်	ʃè
ဒန်း	dáɴ
ရိုက်	jaɪʔ
ဒါပေမဲ့	dàbèmɛ̰
အီနောင်	ʔìnàʊɴ
မော်လမြိုင်	mɔ̀ləmjàɪɴ
ဆူးပုပ်	sʰúboʊʔ
အကိုင်း	ʔəkáɪɴ
ရုပ်	joʊʔ
လငယ်	la̰ŋɛ̀
ဟင်္သာ	hɪ́ɴθà
နေ့စဉ်	nḛzɪ̀ɴ
ပေါက်စီ	paʊʔsì
ဘွား	bwá
ဒဂုံ	dəɡòʊɴ
အသီး	ʔəθí
ဂီတာ	ɡìtà
တီကေ့	tìkḛ
ဇာတိပ္ဖိုလ်စေ့	zàdeɪʔpʰòzḛ
ကြေးအိုး	t͡ɕéʔó
လုပ်	loʊʔ
ကင်း	kɪ́ɴ
တို	tò
နှောက်	n̥aʊʔ
အာတိတ်	ʔàteɪʔ
စိတ္တဇပန်းချီ	seɪʔdəza̰bəd͡ʑì
အမဲသားမစားပါဘူး	ʔəmɛ́ðáməsábàbú
ကျေးဇူးတင်	t͡ɕézútɪ̀ɴ
သန်လျင်း	θàɴləjɪ́ɴ
ကတ်	kaʔ
စီးပွားရေး	síbwájé
သရုပ်ဖော်	θəjoʊʔpʰɔ̀
နနွင်း	sʰənwɪ́ɴ
သံချေး	θàɴd͡ʑí
သူလိုငါလို	θùlòŋàlò
မကန်း	məɡáɴ
နိုင်ငံတော်သီချင်း	nàɪɴŋàɴdɔ̀θət͡ɕʰɪ́ɴ
သီတင်းကျွတ်	ðədɪ́ɴd͡ʑʊʔ
ရှေ့ဆက်	ʃḛzɛʔ
လင်မယား	lɪ̀ɴməjá
ကုဋေ	ɡədè
ပီယဒဿီဘုရား	pìja̰daʔθìpʰəjá
ထိပ်စုဖုရား	tʰeɪʔsṵpʰəjá
ဘိုကလေး	bòɡəlé
မူလ	mùla̰
ဇေ	zè
ယဝဒီပ	ja̰wa̰dìpa̰
ဂုန္တန်	ɡòʊɴdàɴ
စစ်ကိုင်း	zəɡáɪɴ
ဗီတာမင်	bìtàmɪ̀ɴ
ဗိုလ်ချုပ်ကြီး	bòd͡ʑoʊʔd͡ʑí
ကျိုင်းတုံ	t͡ɕáɪɴtòʊɴ
မျက်လှည့်	mjɛʔl̥ɛ̰
စင်	sɪ̀ɴ
ဖြည်းဖြည်းချင်း	pʰjípʰjít͡ɕʰɪ́ɴ
သီတင်း	ðədɪ́ɴ
ဂျပန်	d͡ʑəpàɴ
ဖန်ခါးသီး	pʰàɴɡáðí
ဥပေက္ခါ	ʔṵpɛʔkʰà
ခြ	t͡ɕʰa̰
သင်း	θɪ́ɴ
မြင်းခြံ	mjɪ́ɴd͡ʑàɴ
ငှါး	ŋ̊á
ဥဏ္ဏလုံမွေးရှင်	ʔòʊɴnəlòʊɴm̥wéʃɪ̀ɴ
လှပ	l̥a̰pa̰
ဘီနင်	bìnɪ̀ɴ
သံပရာ	θàɴbəjà
မတ်ပဲ	maʔpɛ́
နာနတ်သီး	nànaʔθí
စိမ်း	séɪɴ
ကတွတ်ယို	kədʊʔjò
ပိုက်သမား	paɪʔθəmá
ရင်းရဲ	jɪ́ɴjɛ́
ဝတ္ထု	wʊʔtʰṵ
အာဖရိက	ʔàpʰəɹḭka̰
ဘက္ကဒီးအစ်	bɛʔkədíʔɪʔ
ဉာဏ်ပူဇော်ခ	ɲànpùzɔ̀kʰa̰
လူသား	lùðá
စီးကလိပ်	síkəleɪʔ
ကာလ	kàla̰
ပန်းဆယ်မျိုး	páɴsʰɛ̀mjó
သရဏင်္ကရာ	θəɹənɪ̀ɴkəɹà
ဆွမ်းမွှေး	sʰʊ́ɴm̥wé
တံစဉ်း	dəzɪ́ɴ
ဝိနည်း	wḭní
မဟာဘွဲ့	məhàbwɛ̰
ဝမ်းကျ	wáɴd͡ʑa̰
ဝိနိစ္ဆယ	wḭneɪʔsəja̰ja̰
ကချေသည်	ka̰d͡ʑèðè
ကာကွယ်ဆေး	kàɡwɛ̀zé
ပလိပ်	pəleɪʔ
ဝနာ	wənà
မုန်ညင်းဆီ	mòʊɴɲɪ́ɴsʰì
ဘုံပိုင်	bòʊɴbàɪɴ
ဒိန်းမတ်	déɪɴmaʔ
ဘိသိက်	beɪʔθeɪʔ
မောင်နှမ	màʊɴn̥əma̰
မင်္ဂလ	mɪ̀ɴɡəla̰
စာတိုက်	sàdaɪʔ
ငရဲ	ŋəjɛ́
ခေါက်ဆွဲဆိုင်	kʰaʊʔsʰwɛ́zàɪɴ
ဒေသန္တရစကား	dèθàɴtəɹa̰zəɡá
သိန်း	θéɪɴ
သူများနည်းတူ	θùmjánítù
အာမခံ	ʔàma̰ɡàɴ
တေဇော	tèzɔ́
တံငါ	təŋà
စင်စင်	sɪ̀ɴzɪ̀ɴ
ပဲမှုန့်	pɛ́m̥o̰ʊɴ
ဆိုင်းဝိုင်း	sʰáɪɴwáɪɴ
အလုပ်ရုံ	ʔəloʊʔjòʊɴ
တရုတ်ဆီးသီး	təjoʊʔzíθí
သာဓု	θàdṵ
အင်္ဂါ	ʔɪ̀ɴɡà
သန်တူ	θàɴtù
နှုတ်ခမ်း	n̥oʊʔkʰáɴ
ဝိတ်	weɪʔ
ခပ်သိမ်း	kʰaʔθéɪɴ
ဗိုလ်ချုပ်	bòd͡ʑoʊʔ
လိပ်ပြာ	leɪʔpjà
ပရိသတ်	pəjeɪʔθaʔ
သဘာဝတ္ထဗေဒ	θəbàwʊʔtʰa̰bèda̰
ငါးသလောက်	ŋəθəlaʊʔ
ကြက်ဟင်းခါးသီး	t͡ɕɛʔhɪ́ɴɡáðí
အော့	ʔɔ̰
ဖူး	bú
ကောဏ္ဍည	kɔ̀ndəɲa̰
ပုလိပ်	pəleɪʔ
ပြစ်မှု	pjɪʔm̥ṵ
ဆပ်	sʰaʔ
ဖိတ်	pʰeɪʔ
လက်	lɛʔ
အကျည်းတန်	ʔət͡ɕítàɴ
ဥဏှဂူ	ʔòʊɴn̥əɡù
ပွေး	pwé
အလုပ်	ʔəloʊʔ
ဆု	sʰṵ
စက်ခေါင်း	sɛʔɡáʊɴ
အပိုင်း	ʔəpáɪɴ
မော်လီကျူး	mɔ̀lìt͡ɕú
ဝံ	wʊ̀ɴ
ကျောက်မီး	t͡ɕaʊʔmí
ဖင်	pʰɪ̀ɴ
ကလျာဏီ	kələjànì
လတ်	laʔ
မရန်း	məjáɴ
ရက်	jɛʔ
စမ်း	sáɴ
နေစကြဝဠာ	nèsɛʔt͡ɕàwəlà
ရင်ပတ်	jɪ̀ɴbaʔ
ဂျူး	d͡ʑú
ကံ့ကူတံ	ka̰ɴɡùdàɴ
မေးခွန်း	méɡʊ́ɴ
ဒေါ်လေး	dɔ̀lé
နားရွက်	nəjwɛʔ
ကင်းခြေများ	kɪ́ɴt͡ɕìmjá
နမ်း	náɴ
အာကာသယာဉ်	ʔàkàθa̰jɪ̀ɴ
ကိုလိုနီ	kòlònì
သဲကျောက်	θɛ́d͡ʑaʊʔ
ဆာယာ	sʰàjà
ကန်	kàɴ
အာဏာသား	ʔànàðá
ဖော့ဖျက်	pʰɔ̰bjɛʔ
ခံမြို့	kʰàɴmjo̰
မှန်မှန်	m̥àɴm̥àɴ
ကမာ	kəmà
မွှား	m̥wá
စွတ်ဖါး	sʊʔpʰá
ပုစဉ်း	bəzɪ́ɴ
သစ်သစ်	θɪʔθɪʔ
ပထွေး	pətʰwé
ကလောင်	kəlàʊɴ
ပြင်း	pjɪ́ɴ
သင်္ဂဟ	θɪ̰ɴɡəha̰
ဘကကျောင်း	ba̰ka̰t͡ɕáʊɴ
နှစ်	n̥ɪʔ
ရဲသား	jɛ́ðá
ရုံ	jòʊɴ
ဖြေ	pʰjè
သန်လျက်	θàɴjɛʔ
အမူအရာ	ʔəmùʔəjà
ဒြပ်ထု	dəɹaʔtʰù
လုံးလုံး	lóʊɴlóʊɴ
ယုတ္တိ	joʊʔtḭ
အင်းဆက်	ʔɪ́ɴsʰɛʔ
သမ္ဗန္ဓ	θàɴbàɴda̰
ဟ	ha̰
မြို့စား	mjo̰zá
ချေး	t͡ɕʰí
ဘထွေး	ba̰tʰwé
ချင်း	t͡ɕʰɪ́ɴ
သံကြိုးစာ	θàɴd͡ʑózà
ဘဏ္ဍာ	bàndà
ကျက်သရေ	t͡ɕɛʔθəjè
တံတိုင်း	dədáɪɴ
ကြောင်	t͡ɕàʊɴ
ကြွင်း	t͡ɕwɪ́ɴ
တေးသံရှင်	téθàɴʃɪ̀ɴ
သူပုန်ထ	ðəbòʊɴtʰa̰
ဆက္ကဂံ	sʰɛʔkəɡàɴ
အချုပ်အခြာအာဏာ	ʔət͡ɕʰoʊʔʔət͡ɕʰàʔànà
အထုပ်	ʔətʰoʊʔ
သေခြင်း	θèd͡ʑɪ́ɴ
ဘိုလီးဗီးယား	bòlíbíjá
အခွံ	ʔəkʰʊ̀ɴ
ဗြဟ္မစိုရ်တရား	bjəməzòjtəjá
နှင်းသီး	n̥ɪ́ɴðí
မိုးကုတ်	móɡoʊʔ
ကုတ်	koʊʔ
ပုံ	pòʊɴ
ခေး	kʰé
ပျူ	pjù
အလုပ်သမား	ʔəloʊʔθəmá
နို့လိမ်	no̰lèɪɴ
နွားမ	nəma̰
ကုလားအုတ်	kələʔoʊʔ
ရောမ	ɹɔ́ma̰
မြေပြန့်	mjèbja̰ɴ
နာဂရီ	nàɡəɹì
အိမ်ရှေ့မင်းသား	ʔèɪɴʃḛmɪ́ɴðá
ရိုးရာအမည်	jójàʔəmjì
လှ	l̥a̰
စားပြီးပြီလား	sápíbìlá
သူရိန်	θùjèɪɴ
ဗိုလ်ချုပ်မှူးကြီး	bòd͡ʑoʊʔm̥úd͡ʑí
ဆယ့်နှစ်လ	sʰɛ̰n̥əla̰
သဘောတူ	ðəbɔ́tù
သွားကြားထိုးတံ	θwád͡ʑátʰódàɴ
ခြေဖဝါး	t͡ɕʰèbəwá
မြက်ခုတ်ဓား	mjɛʔkʰoʊʔdá
လောင်	làʊɴ
ငို	ŋò
ပုဗ္ဗ	poʊʔba̰
ချဒ်	t͡ɕʰàd
ဖျား	pʰjá
ကုသိုလ်ကံ	kṵðòɡàɴ
အရွတ်	ʔəjʊʔ
တရား	təjá
သိုးထီး	θódí
ကျွဲကော	t͡ɕwɛ́ɡɔ́
အမြန်	ʔəmjàɴ
တူးရစ်	túɹɪʔ
ပို့	po̰
ကနေဒါ	ka̰nèdà
ဘုန်းဘုန်း	pʰóʊɴpʰóʊɴ
နှင့်တကွ	n̥ɪ̰ɴdəɡwa̰
တဏှာ	tən̥à
ဓမ္မပါလ	dàɴma̰pàla̰
မော	mɔ́
စပျစ်သီး	zəbjɪʔθí
အကို	ʔəkò
မီးပန်း	míbáɴ
ကမ္ဘာ	ɡəbà
အဖေ	ʔəpʰè
ပါဝါ	pàwà
အရမ်း	ʔəjáɴ
ပျော်	pjɔ̀
ယခု	jəkʰṵ
ဂေါ်ရခါးသီး	ɡɔ̀jəkʰáθí
ဥရောပ	ʔṵɹɔ́pa̰
ဘယ်လောက်	bɛ̀laʊʔ
မှန်လာ	m̥àɴlà
စက္ကန့်	sɛʔka̰ɴ
သူမ	θùma̰
ရောဂါ	jɔ́ɡà
ပရိယာယ်	pəɹḭjè
ပုန်းရည်ကြီး	póʊɴjèd͡ʑí
ကိုမိုရို	kòmòɹò
အတ္တဒဿီ	ʔaʔta̰daʔθì
သီရိ	θìɹḭ
ကြက်ခြေ	t͡ɕɛʔt͡ɕʰè
သာမဏေ	θàmənè
သုက်	θoʊʔ
လက်တင်အမေရိက	lɛʔtɪ̀ɴʔəmèɹḭka̰
တူရကီ	tùɹəkì
ပလတ်စတစ်	pəlaʔsətɪʔ
အပေါ်	ʔəpɔ̀
ဝန်ကြီးချုပ်	wʊ̀ɴd͡ʑíd͡ʑoʊʔ
နှောင်း	n̥áʊɴ
ဓာတ်ဆီဆိုင်	daʔsʰìzàɪɴ
ကောင်မငယ်	kàʊɴma̰ŋɛ̀
ယောက္ခမ	jaʊʔkʰəma̰
ရွှေချည်ထိုး	ʃwèd͡ʑìdó
လည်ပင်း	lɛ̀bɪ́ɴ
ဝါဒ	wàda̰
တိ	tḭ
အာလူး	ʔàlú
အင်းစိန်	ʔɪ́ɴsèɪɴ
သူမသာကိုယ်မသာ	θùməθàkòjməθà
လိုဏ်ခေါင်း	l̥àɪɴɡáʊɴ
ထိုင်	tʰàɪɴ
တိမ်	tèɪɴ
လောက	lɔ́ka̰
ဆိတ်ချေး	sʰeɪʔt͡ɕʰí
သု	θṵ
များ	mjá
ဘကုန်း	ba̰kóʊɴ
ပြီ	pjì
အမျိုးသား	ʔəmjóðá
ပိုလန်	pòlàɴ
ကဲ့	kɛ̰
ဆွမ်းအုပ်	sʰʊ́ɴʔoʊʔ
ဗဟုသုတ	bəhṵθṵta̰
ပသျှူးရာမ	pəʃújàma̰
ဝိညာဉ်	wèɪɴɲɪ̀ɴ
လပြည့်ဝန်း	la̰bjḛwʊ́ɴ
အတွင်းစကား	ʔətwɪ́ɴzəɡá
ခက်ရင်း	kʰəjɪ́ɴ
ညောင်	ɲàʊɴ
နား	ná
မယ်ဇလီ	mɛ̀zəlì
ဈေးနှုန်း	zén̥óʊɴ
အာဏာသိမ်း	ʔànàθéɪɴ
ဗင်နီဇွဲလား	bɪ̀ɴnìzwɛ́lá
နိုင်ငံသားအဖြစ်	nàɪɴŋàɴðáʔəpʰjɪʔ
ပျားရည်	pjájè
အတွင်းဝန်	ʔətwɪ́ɴwʊ̀ɴ
ဝမ်း	wʊ́ɴ
စင်္ကြံ	zɪ́ɴd͡ʑàɴ
တရားသူကြီး	təjáðùd͡ʑí
အုန်းဆီ	ʔóʊɴzì
ထွန်စက်	tʰʊ̀ɴzɛʔ
သက်သေ	θɛʔθè
ကင်းပုံ	kɪ́ɴbòʊɴ
ခေါပျဉ်	kʰɔ́bjɪ̀ɴ
ပရဟိတ	pəɹa̰hḭta̰
မော်လဒိုက်	mɔ̀lədaɪʔ
ရေတွက်	jètwɛʔ
ဒိုင်ယာရီ	dàɪɴjəɹì
ကျောက်ကပ်	t͡ɕaʊʔkaʔ
ထည်	tʰɛ̀
ညီမ	ɲìma̰
ရေဝတဘုရား	jèwəta̰pʰəjá
ဗာတီကန်မြို့ပြနိုင်ငံ	bàtìkàɴmjo̰pja̰nàɪɴŋàɴ
တိုက်ပုံ	taɪʔpòʊɴ
ရွှေဘို	ʃwèbò
ငွေသား	ŋwèðá
တုတ်	doʊʔ
ကုန်း	kóʊɴ
ကောင်းကင်တမန်	káʊɴɡɪ̀ɴtəmàɴ
ဘဝ	ba̰wa̰
ကျွန်	t͡ɕʊ̀ɴ
ဖီဂျီ	pʰìd͡ʑì
မာလီ	màlì
စနစ်	sənɪʔ
ချင်းမိုင်	t͡ɕʰɪ́ɴmàɪɴ
ခြောက်	t͡ɕʰaʊʔ
တော်လှန်	tɔ̀l̥àɴ
အခန်း	ʔəkʰáɴ
လယ်ထွန်	lɛ̀tʰʊ̀ɴ
လမု	ləmṵ
အစုံအစုံ	ʔəsòʊɴʔəsòʊɴ
ခေါင်းလျှော်ရည်	ɡáʊɴʃɔ̀jè
ယုံ	jòʊɴ
စာသား	sàðá
ဂန်ဂျာ	ɡàɴd͡ʑà
ပျဉ်းမ	pjɪ́ɴma̰
ကင်းမြီးကောက်	kɪ́ɴmjíɡaʊʔ
သပိတ်	ðəbeɪʔ
တဲ့	dɛ̰
စန္ဒရား	sàɴdəjá
အိမ်လည်	ʔèɪɴlè
ပျိုး	pjó
အဆောက်အဦ	ʔəsʰaʊʔʔəʔù
တောမန်ကျည်း	tɔ́məd͡ʑí
ဩရသ	ʔɔ́jəθa̰
လီး	lí
ရက်သတ္တပတ်	jɛʔθaʔdəbaʔ
ရာဇဝတ်ကောင်	jàzəwʊʔkàʊɴ
ဆေးပေါ့လိပ်	sʰébɔ̰leɪʔ
ဓား	dá
ဩစတြေးလျ	ʔɔ́sətəɹélja̰
တိရစ္ဆာန်ရုံ	təɹeɪʔsʰàɴjòʊɴ
သဘက်ခါ	θəbɛʔkʰà
တံခါး	dəɡá
မနေ့က	mənḛɡa̰
နမူနာ	nəmùnà
မီးပူ	míbù
ယက်	jɛʔ
အနုပညာ	ʔənṵpjɪ̀ɴɲà
ဗေဒ	bèda̰
ဗိန္ဒု	bèɪɴdṵ
အိုး	ʔó
မာကျောက်	màt͡ɕaʊʔ
မှတ်စု	m̥aʔsṵ
ပစ္စည်း	pɪʔsí
ငံပြာရည်	ŋàɴbjàjè
မိုးရာသီ	mójàðì
ဗုဒ္ဓဟူး	boʊʔda̰hú
ဘိုင်စကယ်	bàɪɴsəkɛ̀
စပွတ်နစ်	səpʊʔnɪʔ
ရှလကာရည်	ʃàləkàjè
အပြုအမူ	ʔəpjṵʔəmù
ကန့်လန့်ကာ	kələɡà
နေ့	nḛ
ကျွန်းကိုင်းမှီကိုင်းကျွန်းမှီ	t͡ɕʊ́ɴkáɪɴm̥ìkáɪɴt͡ɕʊ́ɴm̥ì
ယုဇန	jṵza̰na̰
နျူကလိယ	njùkəlḭja̰
ကိုယ်ဝန်ဆောင်	kòjwʊ̀ɴsʰàʊɴ
မြင်းကလေး	mjɪ́ɴɡəlé
ကြည်	t͡ɕɪ̀ɴ
ဒေသ	dèθa̰
ဖယ်ဒရေးရှင်း	pʰɛ̀dəɹéʃɪ́ɴ
ထိပ်ခေါင်တင်	tʰeɪʔkʰàʊɴtɪ̀ɴ
စေ့စပ်	sḛzaʔ
မျက်တောင်	mjɛʔtàʊɴ
စကြာဝဠာဗေဒ	sɛʔt͡ɕàwəlàbèda̰
အကြွေးဝယ်ကတ်ပြား	ʔət͡ɕwéwɛ̀kaʔpjá
အဘွား	ʔəpʰwá
အိုင်ဒီယာ	ʔàɪɴdìjà
စကားထာ	zəɡətʰà
အောက်ဆီဂျင်	ʔaʊʔsʰìd͡ʑɪ̀ɴ
ဣန္ဒာ	ʔḭndà
သံအမတ်	θàɴʔəmaʔ
ခွာ	kʰwà
အာလာပသလ္လာပ	ʔàlàpa̰θəlàpa̰
အိပ်	ʔeɪʔ
နိုင်ငံသား	nàɪɴŋàɴðá
ဂငယ်	ɡa̰ŋɛ̀
မျက်ပါး	mjɛʔpá
အမှား	ʔəm̥á
ဒေါ်ကြီး	dɔ̀d͡ʑí
ဇာတိ	zàtḭ
ဟယ်လီကော့ပတာ	hɛ̀lìkɔ̰pətà
၎င်း	ləɡáʊɴ
မင်္ဂလဘုရား	mɪ̀ɴɡəla̰pʰəjá
ကြက်ဆီထမင်း	t͡ɕɛʔsʰìtʰəmɪ́ɴ
ပြည်ကြီးမွန်	pjìd͡ʑímʊ̀ɴ
ဥမ္မာ	ʔṵmmà
အညို	ʔəɲò
ထူထဲ	tʰùdɛ́
တိဿဘုရား	teɪʔθa̰pʰəjá
စိတ်ရောဂါ	seɪʔjɔ́ɡà
ကရင်	kəjɪ̀ɴ
အချွဲ	ʔət͡ɕʰwɛ́
ငံ	ŋàɴ
ဘိက္ခုနီ	bìkkʰṵnì
စားပွဲ	sábwɛ́
ထိုင်ဝမ်	tʰàɪɴwàɴ
လာ	là
ဂိုင်ယာနာ	ɡàɪɴjànà
အနောမဒဿီဘုရား	ʔənɔ́mədaʔθìpʰəjá
ယွန်း	jʊ́ɴ
သင်္ကြန်ထမင်း	ðəd͡ʑàɴtʰəmɪ́ɴ
ဂရမ်	ɡəɹàɴ
သမိုင်း	θəmáɪɴ
ကြွက်နို့	t͡ɕwɛʔno̰
ရတနာပူရ	jɛ̀dənàpùɹa̰
လှေကား	l̥èɡá
ရွှေရင်အေး	ʃwèjɪ̀ɴʔé
ထုတ်ကုန်	tʰoʊʔkòʊɴ
တုတ်မီး	doʊʔmí
အင်္ဂလိပ်	ʔɪ̀ɴɡəleɪʔ
ရမ္မက်	jəmɛʔ
လီသီယမ်	lìθìjàɴ
ရာစု	jàzṵ
ကချင်	kət͡ɕʰɪ̀ɴ
ပြုတ်	pjoʊʔ
ဆေးလိပ်	sʰéleɪʔ
ကျွန်တော့်	t͡ɕʊ̀ɴdɔ̰
ပရုတ်	pəjoʊʔ
ဆန္ဒပြပွဲ	sʰàɴda̰pja̰bwɛ́
သူရဲပြေး	θəjɛ́pjé
ဓာတ်မီးခြစ်	daʔmíd͡ʑɪʔ
သူယောင်	θùjàʊɴ
ဝဏ္ဏ	wʊ̀ɴna̰
တောသား	tɔ́ðá
ရွှေတောင်ခေါက်ဆွဲ	ʃwèdàʊɴkʰaʊʔsʰwɛ́
ဗိုက်ကြီး	baɪʔt͡ɕí
မွတ်စလင်	mʊʔsəlɪ̀ɴ
ရှင်တို့	ʃɪ̀ɴdo̰
မြှောက်ရကိန်း	m̥jaʊʔja̰kéɪɴ
ငွေ့ငွေ့	ŋwḛŋwḛ
ညှပ်	ɲ̊aʔ
သုမေဓာ	θṵmèdà
ညှစ်	ɲ̊ɪʔ
စာပို့	sàbo̰
လွှတ်တော်	l̥ʊʔtɔ̀
ရတီ	jətì
သာဂူပြင်	θàɡùbjɪ̀ɴ
ဓမ္မ	dəma̰
စစ်တွေ	sɪʔtwè
အနုတ်လက္ခဏာ	ʔən̥oʊʔlɛʔkʰənà
ယာမာ	jàmà
သာဝက	θàwəka̰
ပုံနှိပ်စက်	pòʊɴn̥eɪʔsɛʔ
သမ္မာကျမ်း	θəmàt͡ɕáɴ
သင်	θɪ̀ɴ
အဲဒီ	ʔɛ́dì
လေး	lé
တွင်း	twɪ́ɴ
ခြားနား	t͡ɕʰáná
ချည်လုံး	t͡ɕʰìlóʊɴ
ဒွာရ	dwàja̰
မေတ္တေယျ	mjɪʔtèja̰
သာသနာ	θàðənà
အကော်ဒီယံ	ʔəkɔ̀dìjàɴ
သူဌေး	θətʰé
ရေး	jé
ဂျမေကာ	d͡ʑəmèkà
ဘား	bá
သဉ္ဇာ	θɪ̀ɴzà
အလ္လာဟ်	ʔàllàh
ဝန်ကြီးချုပ်ကတော်	wʊ̀ɴd͡ʑíd͡ʑoʊʔɡədɔ̀
ဝိတ်ချ	weɪʔt͡ɕʰa̰
ကော်ဖီ	kɔ̀pʰì
ဘုန်းတော်ကြီးဘုရား	pʰóʊɴdɔ̀d͡ʑípʰəjá
အတိုင်ပင်ခံ	ʔətàɪɴbɪ̀ɴɡàɴ
ဌဝမ်းဘဲ	tʰa̰wʊ́ɴbɛ́
အယူ	ʔəjù
ယာဉ်ရပ်	jɪ̀ɴjaʔ
နှစ်ဆန်းတစ်ရက်	n̥ɪʔsʰáɴtəjɛʔ
မြေရိုင်း	mjèjáɪɴ
ပခုံး	pəkʰóʊɴ
သုံးလ	θóʊɴla̰
ငုစပ်	ŋṵzaʔ
မြတ်လေး	mjaʔlé
လေဖြတ်ရောဂါ	lèpʰjaʔjɔ́ɡà
လက်ဖက်	lɛʔpʰɛʔ
ဏကြီး	na̰d͡ʑí
ထော်လာဂျီ	tʰɔ̀làd͡ʑì
ဖြောဖြော	pʰjɔ́bjɔ́
သရဖူ	θəɹəpʰù
တမန်	təmàɴ
ရွေး	jwé
မြောက်	mjaʊʔ
ဟန်ဂေရီ	hàɴɡèɹì
ရိုင်ဖယ်	ɹàɪɴpʰɛ̀
အမည်	ʔəmjì
ကြွ	t͡ɕwa̰
ကြော်ငြာစာ	t͡ɕɔ̀ɲàzà
ဖာလာစေ့	pʰàlàsḛ
ခဲ	kʰɛ́
ပဒေသာပင်	bədèðàbɪ̀ɴ
ရောက်	jaʊʔ
လေမုန်တိုင်း	lèmòʊɴdáɪɴ
သေး	θé
တိုင်	tàɪɴ
ပီကေ	pìkè
ဒန့်သလွန်	da̰ɴðəlʊ̀ɴ
ကျီးအ	t͡ɕíʔa̰
အဖွဲ့ဝင်	ʔəpʰwɛ̰wɪ̀ɴ
နည်း	nɛ́
မုနိ	mṵnḭ
သင်္ဘောသီး	θɪ́ɴbɔ́ðí
ဟထိုး	ha̰tʰó
ထဘီ	tʰəmì
ဒွယံဒွယံ	dwa̰jàɴdwa̰jàɴ
မျက်နှာကြက်	mjɛʔn̥àd͡ʑɛʔ
မိန်းမလျာ	méɪɴməʃà
ပိတ်	peɪʔ
ကလာပ်စည်း	kəlaʔsí
ကပ်ကြီးသုံးပါး	kaʔd͡ʑíθóʊɴbá
သက်တံ	θɛʔtàɴ
ရွာ	jwà
ကဗျာ	ɡəbjà
ကလပ်	kəlaʔ
သူဆင်းရဲ	θùsʰɪ́ɴjɛ́
အဲဒါ	ʔɛ́dà
အိမ်ထောင်	ʔèɪɴtʰàʊɴ
မြောက်ကိုရီးယား	mjaʊʔkòɹíjá
ကြေးစည်	t͡ɕézì
ပါပူအာနယူးဂီနီ	pàpùʔànəjúɡìnì
ဟောင်ကောင်	hàʊɴkàʊɴ
ကျောပိုးအိတ်	t͡ɕɔ́bóʔeɪʔ
ဝတီ	wədì
ဘလေး	ba̰lé
ငါးဖျင်းသလက်	ŋəpʰjɪ́ɴθəlɛʔ
ယပ်	jaʔ
ဟိုဟာ	hòhà
အရုဏ်	ʔəjùn
ဟိန္ဒူ	hèɪɴdù
လောင်း	láʊɴ
သုတ	θṵta̰
ချပါတီ	t͡ɕʰəpàtì
သတင်းပို့	ðədɪ́ɴpo̰
စာမေးပွဲ	sàmébwɛ́
ရာဇဝင်	jàzəwɪ̀ɴ
ရေတပ်	jèdaʔ
အောင်	ʔàʊɴ
ကပ်ပါး	kaʔpá
အလင်္ကာ	ʔəlɪ̀ɴɡà
ကျနော်	t͡ɕənɔ̀
အိန္ဒြာ	ʔèɪɴdɹà
စူးစူး	súzú
လွတ်လပ်ရေးနေ့	lʊʔlaʔjénḛ
ဟင်းခါး	hɪ́ɴɡá
မက္ကဆီကို	mɛʔkəsʰìkò
ညောင်ဖြူ	ɲàʊɴbjù
သားသတ်ရုံ	θáðaʔjòʊɴ
ခရစ္စမတ်	kʰəɹɪʔsəmaʔ
ပုထိုး	pətʰó
လုံချည်	lòʊɴd͡ʑì
စကတ်	səkaʔ
ဝါ	wà
ထိုမှာ	tʰòm̥à
ကြွပ်	t͡ɕʊʔ
အသင်း	ʔəθɪ́ɴ
ဟိမဝန္တာ	hḭma̰wʊ̀ɴtà
စက်ဆုပ်	sɛʔsʰoʊʔ
စာရင်း	səjɪ́ɴ
ဇလဗေဒ	zəla̰bèda̰
ဆင်	sʰɪ̀ɴ
ရေကြီး	jèt͡ɕí
ညောင်ဗောဓိ	ɲàʊɴbɔ́dḭ
လုပ်ခ	loʊʔkʰa̰
ဒေါက်တာ	daʊʔtà
နှစ်ဆယ်	n̥ɪʔsʰɛ̀
ထောပတ်ထမင်း	tʰɔ́baʔtʰəmɪ́ɴ
မှား	m̥á
မဟာဂီတ	məhàɡìta̰
သုဒ္ဓေါဒန	θùddɔ́dəna̰
ခန္ဓာငါးပါး	kʰàɴdàŋábá
ကြက်ဖ	t͡ɕɛʔpʰa̰
ထွန်	tʰʊ̀ɴ
ကြက်ဆင်	t͡ɕɛʔsʰɪ̀ɴ
ဖိုးသူတော်	pʰóθùdɔ̀
အဏ္ဏဝါ	ʔàɴnəwà
အသုံးပြု	ʔəθóʊɴpjṵ
အရင်းရှင်ဝါဒ	ʔəjɪ́ɴʃɪ̀ɴwàda̰
ကြိုဆိုပါ၏	t͡ɕòzòbàʔɛ̰
ချဲ့ချဲ့	t͡ɕʰɛ̰d͡ʑɛ̰
သံလွင်	θàɴlwɪ̀ɴ
ကွဲ	kwɛ́
စာဖတ်	sàpʰaʔ
ဗိုလ်	bò
ဧဏီ	ʔènì
ခမောက်	kʰəmaʊʔ
ရေမြင်း	jèmjɪ́ɴ
လူမျိုးရေးဝါဒ	lùmjójéwàda̰
တော	tɔ́
ခြံ	t͡ɕʰàɴ
သီတဂူ	θìdəɡù
ကျောင်း	t͡ɕáʊɴ
ဝန်	wʊ̀ɴ
သဝဏ်လွှာ	θəwʊ̀ɴl̥wà
လျောင်း	ljáʊɴ
မဟာမောဂ္ဂလာန်	məhàmaʊʔɡəlàɴ
ပန်းသီး	páɴðí
ဆိုဖာ	sʰòpʰà
သတ္တုစပ်	θaʔtṵzaʔ
နောက်ရုံး	naʊʔjóʊɴ
ပင်ပေါင်	pɪ̀ɴpàʊɴ
ဥက္ကဋ္ဌ	ʔoʊʔkəθa̰
ပီဇာ	pìzà
ရဲဘော်	jɛ́bɔ̀
ပြယုဂ်	pja̰joʊʔ
သမား	θəmá
ညီအစ်ကို	ɲìʔəkò
ဈေး	zé
သုပ်	θoʊʔ
ကိန်း	kéɪɴ
မာရ်	mà
ဗာလချောင်	bàla̰t͡ɕʰàʊɴ
နံနံ	nàɴnàɴ
သင်္ကန်း	θɪ̀ɴɡáɴ
မီးခေါင်း	míɡáʊɴ
ထပ်တစ်ရာ	tʰaʔtəjà
ကော်မတီ	kɔ̀mətì
ငါးခူ	ŋəkʰù
ကြောက်	t͡ɕaʊʔ
ခွက်	kʰwɛʔ
ရှလပတ်ရည်	ʃa̰ləpaʔjè
မီးသီး	míθí
ပန်းကန်	bəɡàɴ
ဓအောက်ခြိုက်	da̰ʔaʊʔt͡ɕʰaɪʔ
ကျိုက်မရော	t͡ɕaɪʔməɹɔ́
ကပ်ရောဂါ	kaʔjɔ́ɡà
ကျီး	t͡ɕí
ယမင်း	jəmɪ́ɴ
အသား	ʔəθá
သည်း	θí
တောင်ကြား	tàʊɴd͡ʑá
ခြေဖနောင့်	t͡ɕʰèbəna̰ʊɴ
တံဆိပ်ခေါင်း	dəzeɪʔɡáʊɴ
ဒေသန္တရ	dèθàɴtəja̰
စွမ်း	swáɴ
ကနခို	kənəkʰò
ဆနွင်းမကင်း	sʰənwɪ́ɴməkɪ́ɴ
စီဒီ	sìdì
ဗိုလ်မှူးချုပ်	bòm̥úd͡ʑoʊʔ
ပုဏ္ဏမာ	pòʊɴnəmà
ကျ	t͡ɕa̰
ကာကွယ်ရေး	kàɡwɛ̀jé
တိုဟူးနွေး	tòhúnwé
ဖြည့်	pʰjḛ
အမဲသား	ʔəmɛ́ðá
အညာသား	ʔəɲàðá
ထမင်းချဉ်	tʰəmɪ́ɴd͡ʑɪ̀ɴ
ပရိဘောဂ	pəɹḭbɔ́ɡa̰
ဖာသည်မ	pʰàθɛ̀ma̰
မျိုးချစ်စိတ်	mjót͡ɕʰɪʔseɪʔ
သီချင်း	θət͡ɕʰɪ́ɴ
ခဏ	kʰəna̰
ခန်း	kʰáɴ
သံရုံး	θàɴjóʊɴ
သောဘိတဘုရား	θɔ́bḭta̰pʰəjá
ဒါပော့	dàpɔ̰
ရှူးဖိနပ်	ʃúpʰənaʔ
ဉာဏ်	ɲàn
မနုပ်တာနီ	mənoʊʔtànì
ရိက္ခာ	jeɪʔkʰà
ဝက်မှင်ဘီး	wɛʔm̥ɪ̀ɴbí
သန္ဓေ	θàɴdè
သူရဲခို	θəjɛ́kʰò
ဆံပင်တု	zəbɪ̀ɴdṵ
လေဖိအား	lèpʰḭʔá
ကုလား	kəlá
တနင်္ဂနွေ	tənɪ̀ɴɡənwè
ယေရှု	jèʃṵ
မောက်ချ	maʊʔt͡ɕʰa̰
ကျောင်းသူ	t͡ɕáʊɴðù
ပေါ်	bɔ̀
ပရိုဂျက်	pəɹòd͡ʑɛʔ
ဥပါကြယ်	ʔṵpàt͡ɕɛ̀
အိုင်အိုင်	ʔàɪɴʔàɪɴ
ပါရမီ	pàɹəmì
ကသည်း	kəθí
ကပ်ပယ်	kaʔpɛ̀
အစိုးရ	ʔəsója̰
ကလေး	kʰəlé
ဟုတ်တာပေါ့	hoʊʔtàpɔ̰
အရေပြား	ʔəjèbjá
ဖြောင့်	pʰja̰ʊɴ
လျှောက်	ʃaʊʔ
ခရုပက်ကျိ	kʰəjṵpɛʔt͡ɕḭ
ကိုးကန့်	kóɡa̰ɴ
ဓနု	dənṵ
ဥတ္တရခဏ္ဍ	ʔoʊʔtəɹa̰kʰànda̰
ကောင်စစ်ဝန်	kàʊɴsɪʔwʊ̀ɴ
သင်္ချိုင်း	θɪ̀ɴd͡ʑáɪɴ
ဘဏ်	bàɴ
ပလပ်ကြွတ်	pa̰laʔt͡ɕʊʔ
ဆန္ဒ	sʰàɴda̰
ဂေါက်	ɡaʊʔ
သူတော်သူမြတ်	θùdɔ̀θùmjaʔ
ရှိ	ʃḭ
သူရဿတီ	θùɹa̰θətì
မုန်လာဥနီ	mòʊɴlàʔṵnì
ဆား	sʰá
တော်သလင်း	tɔ̀ðəlɪ́ɴ
ပတ္တမြား	bədəmjá
နိုင်	nàɪɴ
ဝါသနာရှင်	wàðənàʃɪ̀ɴ
နီလာ	nìlà
မယ်တော်	mɛ̀dɔ̀
ကျိုက်ထီးရိုး	t͡ɕaɪʔtʰíjó
တိုးတက်	tótɛʔ
အော်ဒါ	ʔɔ̀dà
ပလွေ	pa̰lwè
မဲဇလီ	mɛ́zəlì
တင့်ကား	tɪ̰ɴká
သောက်	θaʊʔ
တိုကျို	tòt͡ɕò
ရေကာတာ	jèɡàdà
မဟာရဋ္ဌ	məhàjətʰa̰
ပိုးဟပ်	póhaʔ
ပင်စင်စား	pɪ̀ɴsɪ̀ɴsá
ပဒုမ	pədṵma̰
အသော	ʔəθɔ́
ကြောင်အိမ်	t͡ɕàʊɴʔèɪɴ
အပြစ်	ʔəpjɪʔ
ဖြည်းဖြည်း	pʰjébjé
ဗြဟ္မာ	bjəmà
ပါရီ	pàɹì
လေသာခန်း	lèðàɡáɴ
ထွက်ပြေး	tʰwɛʔpjé
ခကွေး	kʰa̰ɡwé
ရေသူ	jèðù
ပူဒီနာ	pùsìnà
မွေးနေ့	mwénḛ
လည်ပင်းကြီးရောဂါ	lìbɪ́ɴd͡ʑíjɔ́ɡà
ပြဿနာ	pjaʔθənà
ရုရု	jṵjṵ
အလုပ်လုပ်	ʔəloʊʔloʊʔ
ရွှေမျက်ပါး	ʃwèmjɛʔpá
သိရှိ	θḭʃḭ
ခါ	kʰà
သီဟိုဠ်သရက်	θìhòθəjɛʔ
မြောင်း	mjáʊɴ
အီရန်	ʔìɹàɴ
ဆန်းဒဝစ်	sʰáɴdəwɪʔ
မျက်စိ	mjɛʔsḭ
ဒင်္ဂါးတိုက်	dɪ̀ɴɡádaɪʔ
အုန်းမှန်ကူ	ʔóʊɴm̥àɴɡù
ခန္တီ	kʰàɴtì
နွေဦး	nwèʔú
ဓမ္မသတ်	dəməθaʔ
ထိုင်း	tʰáɪɴ
ပြင်းဟုပ်	pjɪ́ɴhoʊʔ
ဝမ်းသာ	wʊ́ɴθà
ဆရာတော်	sʰəjàdɔ̀
အမွေ	ʔəmwè
ကြက်သွန်မြိတ်	t͡ɕɛʔθʊ̀ɴmjeɪʔ
ဥဏ္ဏလုံ	ʔòʊɴnəlòʊɴ
ကံ	kàɴ
လိင်	lèɪɴ
ခံ	kʰàɴ
မဲခေါင်မြစ်	mɛ́kʰàʊɴmjɪʔ
ဂျင်	d͡ʑɪ̀ɴ
ဘူမိဗေဒ	bùmḭbèda̰
ငချိတ်	ŋət͡ɕʰeɪʔ
ဖား	pʰá
ဘိုင်စကုတ်	bàɪɴsəkoʊʔ
သစ္စာ	θɪʔsà
သူတော်စင်	θùdɔ̀zɪ̀ɴ
လှည်းကူး	l̥íkú
ရိက္ခါ	jeɪʔkʰà
ကောင်စစ်ဝန်ရုံး	kàʊɴsɪʔwʊ̀ɴjóʊɴ
မင်္ဂလာ	mɪ̀ɴɡəlà
ပြုံး	pjóʊɴ
မျှို့	m̥jo̰
ဘရူနိုင်း	bəɹùnáɪɴ
မင်းသား	mɪ́ɴðá
အမာ	ʔa̰mà
ဇိမ်မယ်	zèɪɴmɛ̀
မြေနင်းခွာစိုက်	mjènɪ́ɴkʰwàzaɪʔ
ဘောဂဗေဒ	bɔ́ɡa̰ta̰bèda̰
အကောင့်	ʔəka̰ʊɴ
ဗြိစ္ဆာ	bjeɪʔsʰà
မိတ်	meɪʔ
အကြံပေးချက်	ʔət͡ɕàɴpéd͡ʑɛʔ
ပိ	pḭ
စလွယ်	səlwè
လ	la̰
မြေဩဇာ	mjèʔɔ́zà
မရမာ	məɹəmà
သဲကန္တာရ	θéɡàɴdàja̰
အားလုံး	ʔálóʊɴ
သို့မဟုတ်	ðo̰məhoʊʔ
ပိုင်း	páɪɴ
ကန်စွန်းဥ	ɡəzʊ́ɴʔṵ
ကလမောင်း	kələmáʊɴ
နဂါး	nəɡá
လက်ရန်း	lɛʔjáɴ
လက်တန်း	lɛʔtáɴ
တောင်အာဖရိက	tàʊɴʔàpʰəɹḭka̰
အခေါက်	ʔəkʰaʊʔ
ကောလိပ်	kɔ́leɪʔ
ကြယ်သီး	t͡ɕɛ̀θí
နာရဒ	nàɹəda̰
ရှေး	ʃé
အလုပ်ရှင်	ʔəloʊʔʃɪ̀ɴ
ဒထွေး	da̰dwé
ပါဠိ	pàlḭ
ခြေအိတ်	t͡ɕʰèʔeɪʔ
မီးဖို	míbò
လေစုန်	lèzòʊɴ
ဆာရီ	sʰàɹì
ဩဂုတ်	ʔɔ́ɡoʊʔ
အင်ဒိုနီးရှား	ʔɪ̀ɴdòníʃá
ဂျီဘူတီ	d͡ʑìbùtì
ချမ်း	t͡ɕʰáɴ
ဘ	ba̰
အနောမဒဿီ	ʔənɔ́mədətθì
နရက်	nəɹɛʔ
ဓာတ်မီးပူ	daʔmíbù
ဂျော်နီ	d͡ʑɔ̀nì
ကင်မရွန်း	kɪ̀ɴma̰ɹʊ́ɴ
ရောဂန္တရကပ်	jɔ́ɡàɴtəɹa̰kaʔ
အကောက်	ʔəkaʊʔ
ဥပါလိ	ʔṵpàlḭ
ဇာတ်ညွှန်း	zàtɲ̊ʊ́ɴ
ဘာသာပြန်	bàðàpjàɴ
ဟော	hɔ́
ဒဏ်	dàn
ချင်း	d͡ʑɪ́ɴ
အချင်းဝက်	ʔət͡ɕʰɪ́ɴwɛʔ
သံချပ်	θəd͡ʑaʔ
သန်လျင်	θəɲɪ̀ɴ
တပ်မတော်နေ့	taʔmədɔ̀nḛ
ရခိုင်	jəkʰàɪɴ
ကြာဆံသုပ်	t͡ɕàzàɴθoʊʔ
ဇယား	zəjá
မှန်တော့	m̥àɴdɔ̰
ခွေးအိမ်	kʰwéʔèɪɴ
ရှင့်	ʃɪ̰ɴ
ကုလားပဲ	kələpɛ́
လက်သည်	lɛʔθɛ̀
သိဒ္ဓတ္ထ	θeɪʔdaʔtʰa̰
မီးရထား	míjətʰá
အရီး	ʔəjí
ကျပ်သား	t͡ɕaʔθá
ခံစား	kʰàɴzá
ငါးမုန့်	ŋámo̰ʊɴ
တပေါင်းလပြည့်နေ့	dəbáʊɴla̰pjḭnḛ
စန်း	sáɴ
လက်ဖက်သုပ်	ləpʰɛʔθoʊʔ
ပင့်ကူအိမ်	pɪ̰ɴɡùʔèɪɴ
နှစ်ဆယ့်တစ်	n̥ɪʔsʰɛ̰tɪʔ
သူတော်ကောင်း	θùdɔ̀ɡáʊɴ
လွှတ်ရုံးငါးရပ်	l̥ʊʔjóʊɴŋájaʔ
ရေသူမ	jèðùma̰
ဖက်ဆစ်ဝါဒ	pʰɛʔsʰɪʔwàda̰
စလုံး	sa̰lóʊɴ
အုတ်ကြွပ်	ʔoʊʔt͡ɕʊʔ
အာခါ	ʔàkʰà
အူမကြီး	ʔùma̰d͡ʑí
ဒွေးဘော်	dwébɔ̀
ကနား	kəná
ဝယ်	wɛ̀
သမာသမတ်	θəmàθəmaʔ
မူကြိုကျောင်း	mùd͡ʑòd͡ʑáʊɴ
အုန်းထမင်း	ʔóʊɴtʰəmɪ́ɴ
ကျောင်းသား	t͡ɕáʊɴðá
ဩစတြီးယား	ʔɔ́sətəɹìja̰
မေး	mé
အဖုံး	ʔəpʰóʊɴ
ဂါနာ	ɡànà
မုန့်လုံးရေပေါ်	mo̰ʊɴlóʊɴjèbɔ̀
ပိဿာ	peɪʔθà
မောရစ်ရှ	mɔ́ɹɪʔʃa̰
သောသော	θɔ́ðɔ́
ယောက်ျား	jaʊʔt͡ɕá
ပန်းချီဆရာ	bəd͡ʑìsʰəjà
မုန်လာထုပ်	mòʊɴlàdoʊʔ
ဆီ	sʰì
စီးကရက်	síkəɹɛʔ
ဒုက္ခသည်	doʊʔkʰa̰ðè
ယမ်း	jáɴ
မျှော်	m̥jɔ̀
ကြက်သီးထ	t͡ɕɛʔθéɪɴtʰa̰
ဖုန်းနံပါတ်	pʰóʊɴnàɴbaʔ
ညီမျှခြင်း	ɲìm̥ja̰d͡ʑɪ́ɴ
သားကြီး	θád͡ʑí
အဝတ်အစား	ʔəwʊʔʔəsá
ဝိုင်	wàɪɴ
ငှက်ပျောပေါင်း	ŋ̊əbjɔ́báʊɴ
ဆေးခန်း	sʰékʰáɴ
ညံစာစာ	ɲàɴsàzà
သံတမန်	θàɴtəmàɴ
တာတား	tàtá
ကျွဲပြည့်စင်	t͡ɕwɛ́pjḭzɪ̀ɴ
ဘုရင်	bəjɪ̀ɴ
သုမေဓာဘုရား	θṵmèdàpʰəjá
အညီ	ʔəɲì
အစည်းအဝေး	ʔəsíʔəwé
အထပ်	ʔətʰaʔ
ပဲ့တင်သံ	pɛ̰tɪ̀ɴðàɴ
ကြက်သား	t͡ɕɛʔθá
ဒူးလေး	dúlé
စည်း	sí
ယောက်	jaʊʔ
ဂင်းနီဗစ်ဆော	ɡɪ́ɴnìbɪʔsʰɔ́
ဆန့်ကျင်ဘက်	sʰa̰ɴd͡ʑɪ̀ɴbɛʔ
လက်နက်	lɛʔnɛʔ
ဘယာ	bəjà
လပ်	laʔ
ဇာ	zà
သကြားလုံး	ðəd͡ʑálóʊɴ
တ	tə
မိုတယ်	mòtɛ̀
အလျင်	ʔəjɪ̀ɴ
မလေးရှား	məléʃá
အင်တာဗျူး	ʔɪ̀ɴtəbjú
ထင်း	tʰɪ́ɴ
မရဏ	məɹəna̰
ပြေး	pjé
အီဂျစ်	ʔìd͡ʑɪʔ
ကမ်စော်	kàɴzɔ̀
စိတ်မှတ်	seɪʔm̥aʔ
အိမ်ထောင်ပြု	ʔèɪɴdàʊɴpjṵ
ဗိုလ်မှူးကြီး	bòm̥úd͡ʑí
ဂီနီ	ɡìnì
ကြက်ဆူ	t͡ɕɛʔsʰù
အပိုဒ်	ʔəpaɪʔ
ကိုယ်စားလှယ်	kòjzəl̥ɛ̀
ဂျာမနီ	d͡ʑàmənì
ဗာဒံ	bàdàɴ
ညာ	ɲà
စိမ်းစားဥ	séɪɴzáʔṵ
သည်	θè
ခရိုင်	kʰəjàɪɴ
အမေရိက	ʔəmèɹḭka̰
သမက်	θəmɛʔ
ထွက်ပေါက်	tʰwɛʔpaʊʔ
လက်ချောင်း	lɛʔt͡ɕʰáʊɴ
ပြွန်	pjʊ̀ɴ
စီးပွား	síbwá
ဝေဿ	wɪʔθa̰
တောင်ငူ	tàʊɴŋù
မုန်တိုင်း	mòʊɴdáɪɴ
ညစာ	ɲa̰zà
ပါတီ	pàtì
ကိုး	kó
အင်ဒိုရာ	ʔɪ̀ɴdòɹà
ငူတူတူ	ŋùtùdù
ဥယျာဉ်	ʔṵjɪ̀ɴ
အရာ	ʔəjà
ရွရွ	jwa̰jwa̰
အတွင်းတာရာ	ʔətwɪ́ɴtàjà
သဒ္ဓါ	θàddà
အရွက်	ʔəjwɛʔ
ဒြပ်စင်	dəɹaʔsɪ̀ɴ
ဝိတိုရိယ	wḭtòɹḭja̰
သစ်ကုလားအုတ်	θɪʔkələʔoʊʔ
ဠ	la̰
ဘာသာဗေဒ	bàθàbèda̰
ဆွပ်	sʰʊʔ
ဂွမ်း	ɡʊ́ɴ
လွှ	l̥wa̰
မြေပဲ	mjèbɛ́
စီးပွားရေးသမား	síbwájéðəmá
အခါတစ်ပါး	ʔəkʰàdəbá
သာဝတ္ထိ	θàwʊʔtʰḭ
ဂေါ်ဖီထုပ်	ɡɔ̀bìdoʊʔ
ကျားမျက်လုံး	t͡ɕámjɛʔlóʊɴ
မုစလိန္ဒ	mṵsəlèɪɴda̰
ခဝဲ	kʰəwɛ́
အဆုံး	ʔəsʰóʊɴ
ဉာဏ်တော်	ɲàɴdɔ̀
သုံးဆယ်	θóʊɴsʰɛ̀
အသားမာ	ʔəθəmà
အကျည်း	ʔət͡ɕí
ခါးပတ်	ɡəbaʔ
မြင်းမိုရ်	mjɪ́ɴmò
သဇင်	ðəzɪ̀ɴ
ရှဉ့်	ʃɪ̰ɴ
စာအိတ်	sàʔeɪʔ
ဘုဉ်းပေး	bóʊɴpé
တစောင်း	dəzáʊɴ
ဒေါင်းလန်း	dáʊɴláɴ
ဒုယင်တော်	dəjɪ̀ɴdɔ̀
ခရစ်ယာန်	kʰəɹɪʔjàn
အင်တာနက်	ʔɪ̀ɴtànɛʔ
ရကောက်	ja̰kaʊʔ
မဟာမိတ်	məhàmeɪʔ
မြ	mja̰
ရဲစခန်း	jɛ́səkʰáɴ
ဗိုလ်မှူး	bòm̥ú
ကက်သလစ်	kɛʔθəlɪʔ
စည်	sì
စက်သေနတ်	sɛʔθənaʔ
မိုဘိုင်းလ်ဖုန်း	mòbáɪɴpʰóʊɴ
မဏိမေခလာ	mənḭmèkʰəlà
အက်စတိုးနီးယား	ʔɛʔsətóníjá
အိမ်သူ	ʔèɪɴðù
အနာကြီးရောဂါ	ʔənàd͡ʑíjɔ́ɡà
ဂရိ	ɡəɹḭ
ရေကတော့	jèɡədɔ̰
ခုံရှည်	kʰòʊɴʃè
ယှဉ်ဖက်	ʃɪ̀ɴpʰɛʔ
ပုဆိုး	pəsʰó
သံ	θàɴ
ချောင်း	t͡ɕʰáʊɴ
ထီးဖြူ	tʰíbjù
ခွဲ	kʰwɛ́
နက်ဖြန်	nɛʔpʰjàɴ
အဝတာရ	ʔa̰wa̰tàja̰
ချွန်ထက်	t͡ɕʰʊ̀ɴtʰɛʔ
ကြက်တူရွေး	t͡ɕɛʔtùjwé
ကျယ်ဝန်း	t͡ɕɛ̀wʊ́ɴ
သူ	θù
ရှမ်းခေါက်ဆွဲ	ʃáɴkʰaʊʔsʰwɛ́
ဥပဒေ	ʔṵba̰dè
ချေ	d͡ʑì
ဟနူမာန်	hənùmàn
အထက်လွှတ်တော်	ʔətʰɛʔl̥ʊʔtɔ̀
သိင်္ဂီ	θèɪɴɡì
ပုဒ်ကြီး	poʊʔd͡ʑí
အပြင်	ʔəpjɪ̀ɴ
သဘာပတိ	θəbàpətḭ
ပြန်လှန်	pjàɴl̥àɴ
ကြို့	t͡ɕo̰
မဏ္ဍိုင်	màɴdàɪɴ
ရေယုန်	jèjòʊɴ
နိုင်ငံခြား	nàɪɴŋàɴd͡ʑá
မွတ်	mʊʔ
အပ်ထောက်	ʔaʔtʰaʊʔ
လိင်တံ	lèɪɴdàɴ
ပြွတ်	pjʊʔ
ဘီ	bì
သိပ္ပံ	θeɪʔpàɴ
စန္ဒာ	sàɴdà
ဆီယူ	sʰìjù
ဟိန္ဒီ	hèɪɴdì
အစ်ကို	ʔəkò
ဖျံ	pʰjàɴ
နေဝင်	nèwɪ̀ɴ
မုတ္ထမ	moʊʔtəma̰
ကျားသစ်	t͡ɕəθɪʔ
အမေရိကန်ပြည်ထောင်စု	ʔəmèɹḭkàɴpjìdàʊɴzṵ
ရေပန်း	jèbáɴ
ဆွီဒင်	sʰwìdɪ̀ɴ
စို့	so̰
ဧကရာဇ်	ʔèɡəɹɪʔ
ဘယ်နှ	bɛ̀n̥a̰
ကော	kɔ́
ည	ɲa̰
ဇာတ်ဆောင်	zaʔsʰàʊɴ
ပီယဒဿီ	pìja̰daʔθì
ရွတ်ရွတ်	jʊʔjʊʔ
တီဟီရန်	tìhìɹàɴ
ခရေ	kʰəjè
ခရမ်း	kʰəjáɴ
လှုလှု	l̥ṵl̥ṵ
ရေချိုး	jèt͡ɕʰó
တံခါးဗိုလ်	dəɡábò
ပြင်ပြင်	pjɪ̀ɴbjɪ̀ɴ
ကြောင်ထီး	t͡ɕàʊɴdí
အင်္ဂတေ	ʔɪ̀ɴɡədè
ပြည်သူပိုင်သိမ်း	pjìðùbàɪɴðéɪɴ
ပစောက်	pa̰zaʊʔ
ဆလတ်	sʰəlaʔ
တား	tá
ကမ်း	káɴ
အီး	ʔí
ယွန်းယွန်း	jʊ́ɴjʊ́ɴ
ဗြဲတိုက်	bjɛ́daɪʔ
အသံ	ʔəθàɴ
သိုးအုပ်	θóʔoʊʔ
ခြင်္သေ့ကလေး	t͡ɕʰɪ̀ɴðḛɡəlé
အာရာမ	ʔàjàma̰
မုဆိုးမ	mṵsʰóma̰
တံတား	dədá
သပြု	ðəbjṵ
ရည်	jì
သိပ်	θeɪʔ
ကူ	kù
သတို့သား	ðədo̰θá
ရှည်မျော	ʃèmjɔ́
မေးစေ့	mézḭ
တွန်း	tʊ́ɴ
ဓာတ်	daʔ
မှုန်	m̥òʊɴ
အမျိုးသားလွှတ်တော်	ʔəmjóðál̥ʊʔtɔ̀
မုတ်ခွံ	moʊʔkʰʊ̀ɴ
အော်ပရာ	ʔɔ̀pəɹà
ငါးဥ	ŋáʔṵ
နီတိ	nìtḭ
ခယ်မ	kʰɛ̀ma̰
ကြာသပတေး	t͡ɕàθa̰pa̰dé
စိတ္တဗေဒ	seɪʔta̰bèda̰
ကြေးနန်း	t͡ɕénáɴ
သစ်တော	θɪʔtɔ́
မြက်ခြောက်	mjɛʔt͡ɕʰaʊʔ
မဏိဩဂ	mənḭʔɔ́ɡa̰
နာမ	nàma̰
သင်္ဘောမညှိုးပန်း	θɪ́ɴbɔ́məɲ̊óbáɴ
ပြည်တွင်း	pjìdwɪ́ɴ
ပါ	pà
သီရိလင်္ကာ	θìɹḭlɪ̀ɴkà
ယာယီ	jàjì
ပီစီ	pìsì
သွားဖုံး	θəpʰóʊɴ
ပျား	pjá
အာရိုက်	ʔàjaɪʔ
ပုံး	póʊɴ
ဟာသ	hàθa̰
ခင်ဗျာ	kʰəmjà
သားလှောင်	θál̥àʊɴ
သူကြီး	θùd͡ʑí
မောင်တော	màʊɴtɔ́
တိရစ္ဆာန်	təɹeɪʔsʰàɴ
ပဒေသာ	bədèðà
လေးလံ	lélàɴ
အနံ့	ʔəna̰ɴ
အသေ	ʔəθè
ခ	kʰa̰
တာဝတိံသာ	tàwa̰tèɪɴθà
အလင်းတန်း	ʔəlɪ́ɴdáɴ
ဥပဒေပညာ	ʔṵbədèpjɪ̀ɴɲà
စွယ်	swɛ̀
ဓာတ်လှေကား	daʔl̥èɡá
လှပ်လှပ်	l̥aʔl̥aʔ
ရဝေ	jəwè
ထ	tʰa̰
ရက်ကန်း	jɛʔkáɴ
မြန်နှုန်းပြကိရိယာ	mjàɴn̥óʊɴpja̰kḭjḭjà
အပြာကား	ʔəpjàká
ရုက္ခဗေဒ	joʊʔkʰa̰bèda̰
တိုဟူး	tòhú
နာနတ်ပွင့်	nənaʔpwɪ̰ɴ
မုန်လာဥဝါ	mòʊɴlàʔṵwà
အင်ဒိုချိုင်းနား	ʔɪ̀ɴdòt͡ɕʰáɪɴná
ပြည်ထောင်စုလွှတ်တော်	pjìdàʊɴzṵl̥ʊʔtɔ̀
အော်ကေ့ကြည်	ʔɔ̀kḛt͡ɕì
ဘင်နာ	bɪ̀ɴnà
အသျှင်	ʔəʃɪ̀ɴ
ဆိုဒီယမ်	sʰòdìjàɴ
ရယ်	jì
နင်	nɪ̀ɴ
ထပ်	tʰaʔ
ပူရ	pùɹa̰
ပုဏ္ဏားကျွန်း	pòʊɴnád͡ʑʊ́ɴ
ကြာ	t͡ɕà
ဘယ်	bɛ̀
အညစ်အထည်း	ʔəɲɪʔʔətʰí
ဥက္ကာပျံ	ʔoʊʔkàbjàɴ
ငန်	ŋàɴ
ချိတ်	d͡ʑeɪʔ
ဆေး	sʰé
ဒီပင်္ကရာ	dìpɪ̀ɴkəɹà
မှန်စီရွှေချ	m̥àɴzìʃwèt͡ɕʰa̰
ဝန်ကြီး	wʊ̀ɴd͡ʑí
ဆန်	sʰàɴ
ပုဒ်ကလေး	poʊʔkəlé
ချူးအင်းဂမ်း	t͡ɕʰúʔɪ́ɴɡáɴ
ဖလား	pʰəlá
ငှား	ŋ̊á
အိန္ဒြေ	ʔèɪɴdɹè
ပု	pṵ
မွေး	mwé
သူရဲဘောနည်း	θəjɛ́bɔ́ní
အီကွေတာဂီနီ	ʔìkwètàɡìnì
ပင်ဂွင်	pɪ̀ɴɡwɪ̀ɴ
ဘဲ	bɛ́
အသိတရား	ʔəθḭtəjá
ကုလားနို့	kələno̰
ကွမ်ရင်	kwàɴjɪ̀ɴ
ဗန်တို	bàɴdò
စက်ဘီး	sɛʔbéɪɴ
မဟာသာဝက	məhàθàwəka̰
ငရုတ်	ŋəjoʊʔ
ယူရေးရှား	jùɹéʃá
သုဒ္ဒ	θoʊʔda̰
သီးပင်	θíbɪ̀ɴ
လား	lá
နာနတ်	nənaʔ
ပေါင်မုန့်	pàʊɴmo̰ʊɴ
ဂုရု	ɡṵɹṵ
ပြသ	pja̰θa̰
သုံးဆောင်	θóʊɴsʰàʊɴ
တီကောင်	tìɡàʊɴ
အောက်သား	ʔaʊʔðá
ဝိပဿနာ	wḭpaʔθənà
စပါး	zəbá
ရေမှုတ်	jèm̥oʊʔ
အစ်မ	ʔəma̰
ဇီဝ	zìwa̰
ဝက်သားမျှစ်ချဉ်	wɛʔθám̥jɪʔt͡ɕʰɪ̀ɴ
ကိစ္စ	keɪʔsa̰
ဆယ့်တစ်	sʰɛ̰tɪʔ
လက်အိတ်	lɛʔʔeɪʔ
သကာ	ðəɡà
ကစားကွင်း	ɡəzáɡwɪ́ɴ
တင်ဒါ	tɪ̀ɴdà
နှင်း	n̥ɪ́ɴ
လူမှုကွန်ရက်	lùm̥ṵkʊ̀ɴjɛʔ
လက်ကွက်	lɛʔkwɛʔ
အင်ဂျင်	ʔɪ̀ɴd͡ʑɪ̀ɴ
စကားနည်းရန်စဲ	zəɡánɛ́jàɴzɛ́
အချိန်စာရင်း	ʔət͡ɕʰèɪɴsəjɪ́ɴ
ကျဲ	t͡ɕɛ́
သိုးမွေး	θómwé
ဝိပဿီဘုရား	wḭpaʔθìpʰəjá
ပစ္စည်းလေးပါး	pjɪʔsílébá
တစ္ဆေ	təsʰè
အာဏာရှင်	ʔànàʃɪ̀ɴ
တရုတ်မဆလာ	təjoʊʔməsʰəlà
တီဗီ	tìbì
ရထား	jətʰá
ငါ့	ŋa̰
ဒူးဝါး	dúwá
ပြောင်း	pjáʊɴ
ယာဉ်မောင်း	jɪ̀ɴmàʊɴ
အကျိတ်	ʔət͡ɕeɪʔ
ဠကြီး	la̰t͡ɕí
ဂုဏ်	ɡòʊɴ
ထေရဝါဒ	tʰèja̰wàda̰
ဆီချက်ခေါက်ဆွဲ	sʰìd͡ʑɛʔkʰaʊʔsʰwɛ́
အဲလစ်ဇဘက်	ʔɛ́lɪʔza̰bɛʔ
ဓာတ်ပုံ	daʔpòʊɴ
ဆပ်ကပ်	sʰaʔkaʔ
လူဝံ	lùwʊ̀ɴ
အမျိုးဇာတ်	ʔəmjózaʔ
ဘိုရွန်	bòɹʊ̀ɴ
ကုံကုမံ	ɡòʊɴɡəmàɴ
မေးခိုင်ရောဂါ	mékʰàɪɴjɔ́ɡà
တောက်တဲ့	taʊʔtɛ̰
ဘုရားရှိခိုးကျောင်း	pʰəjáʃḭkʰód͡ʑáʊɴ
လင်ပန်း	lɪ̀ɴbáɴ
ဂိုဏ်းချုပ်	ɡáɪɴd͡ʑoʊʔ
ကင်းမွန်	kɪ́ɴmʊ̀ɴ
အာဂျင်တီးနား	ʔàd͡ʑɪ̀ɴtíná
ဒုတိယဗိုလ်မှူးကြီး	dṵtḭja̰bòm̥úd͡ʑí
ဆိုးဆေး	sʰózé
ဖေါ်ပြချက်	pʰɔ̀pja̰t͡ɕʰɛʔ
အမှုန်	ʔəm̥òʊɴ
ကညာ	kəɲà
ပြီးတော့	pídɔ̰
မြင်	mjɪ̀ɴ
မကိုဋ်	məɡaɪʔ
သွေးပေါ်	θwépɔ̀
ကော်ပြန့်စိမ်း	kɔ̀pja̰ɴzéɪɴ
ကျုပ်တို့	t͡ɕoʊʔto̰
ဝက်သားချဉ်	wɛʔθát͡ɕʰɪ̀ɴ
သီဟ	θìha̰
အရောင်	ʔəjàʊɴ
နည်းနည်းချင်း	nínít͡ɕʰɪ́ɴ
နှံကောင်	n̥àɴɡàʊɴ
တစ်ပင်တိုင်မင်းသမီး	dəbɪ̀ɴdàɪɴmɪ́ɴðəmí
ဇီရာ	zìjà
လပို့	ləbo̰
သီတာဒေဝီ	θìdàdèwì
လောကဝတ်	lɔ́ɡəwʊʔ
ဇင်းမယ်	zɪ́ɴmɛ̀
ဇူလိုင်	zùlàɪɴ
ကြေးမုံ	t͡ɕémòʊɴ
ဆော့ဖ်ဝဲလ်	sʰaʊʔwɛ́
သုတေသီ	θṵtèθì
စောစော	sɔ́zɔ́
လမ်းလျှောက်	láɴʃaʊʔ
ကြက်ခြေနီ	t͡ɕɛʔt͡ɕʰènì
ရက်ကန်းစင်	jɛʔkáɴzɪ̀ɴ
သက္ကတ	θɛʔkəta̰
ကြငှန်း	t͡ɕəŋ̊áɴ
ချိုချဉ်	t͡ɕʰòt͡ɕʰɪ̀ɴ
ဓားပြား	dəbjá
လပြည့်နေ့	la̰pjḭnḛ
ပိုတက်ဆီယမ်	pòtɛʔsʰìjàɴ
ဗိုလ်ကြီး	bòd͡ʑí
တပေါင်း	dəbáʊɴ
ပြာ	pjà
မိန်းကလေး	méɪɴɡəlé
နီး	ní
သရဏင်္ကရာဘုရား	θəɹənɪ̀ɴkəɹàpʰəjá
အကြမ်းဖက်ဝါဒ	ʔət͡ɕáɴpʰɛʔwàda̰
တယ်	tɛ̀
ဒေါ်	dɔ̀
ဇိန	zḭna̰
အာလူးပူရီ	ʔàlúpùjì
ဘူဂေးရီးယား	bùɡéɹíjá
မလ္လိကာ	màɴlḭkà
ယတြာ	jədəjà
စီးနင်း	sínɪ́ɴ
ဆန့်ကျင်	sʰa̰ɴd͡ʑɪ̀ɴ
ချောင်	t͡ɕʰàʊɴ
ခင်ပွန်း	kʰɪ̀ɴbʊ́ɴ
အမွှေးတိုင်	ʔəm̥wédàɪɴ
လဆန်း	la̰záɴ
ပန်	pàɴ
ပြား	pjá
ဒီနေ့	dìnḛ
သံစုံတီးဝိုင်း	θàɴzòʊɴtíwáɪɴ
မုဆိုးဖို	mṵsʰóbò
နာနာဘာဝ	nànàbàwa̰
အီးမေးလ်	ʔímél
ဝါဏိဇ္ဇဗေဒ	wàneɪʔza̰bèda̰
ပဲခူး	bəɡó
ဘရိတ်	bəɹeɪʔ
စိတ္တဇ	seɪʔdəza̰
မာလကာသီး	màləkàθí
ဘတ်	pʰaʔ
စာသင်ခန်း	sàθɪ̀ɴɡáɴ
ကိလေသာ	kḭlèθà
နေထွက်	nètʰwɛʔ
ဆလိမ်	sʰa̰lèɪɴ
အိုမန်	ʔòmàɴ
စာပုံး	sàbóʊɴ
ကျေးဇူးတင်ပါတယ်	t͡ɕézútɪ̀ɴbàdɛ̀
ရာသီ	jàðì
ချော်	t͡ɕʰɔ̀
ဒီဇိုင်နာ	dìzàɪɴnà
ဥုံ	ʔòʊɴ
ညောင်းကျရောဂါ	ɲáʊɴt͡ɕa̰jɔ́ɡà
ဝက်သား	wɛʔθá
မဟာဝိဇ္ဇာဘွဲ့	məhàweɪʔzàbwɛ̰
ခြည်	t͡ɕʰì
အဖိုးကြီး	ʔəpʰót͡ɕí
ကြမ်း	t͡ɕáɴ
တန်ခိုးရှင်	tàɴkʰóʃɪ̀ɴ
အာဟာရဗေဒ	ʔàhàja̰bèda̰
ဒီပင်္ကရာဘုရား	dìpɪ̀ɴkəɹàpʰəjá
ဒိန်ခဲ	dèɪɴɡɛ́
ကြိယာဝိသေသန	kəɹḭjàwḭθèθəna̰
စံပယ်	zəbɛ̀
သေတ္တာ	θɪʔtà
သူရင်းငှား	θəjɪ́ɴŋ̊á
သုံး	θóʊɴ
ဇာတ်တော်	zàt
အဘိုး	ʔəpʰó
ပသီ	pəθì
ရ	ɹa̰
ဗားနစ်	bánɪʔ
ပြဒါး	bədá
အစား	ʔəsá
ရဟတ်	jəhaʔ
ခရိုမီယမ်	kʰəɹòmìjàɴ
မဟေ	məhè
မင်းမြောက်တန်ဆာ	mɪ́ɴmjaʊʔdəzà
ကင်မရာ	kɪ̀ɴməɹà
သန်ကောင်	θàɴɡàʊɴ
လေးညှင်းပွင့်	léɲ̊ɪ́ɴbwɪ̰ɴ
အာရာမ်	ʔàjàɴ
ကိုင်	kàɪɴ
မန်နေဂျာ	màɴnèd͡ʑà
ငါးလ	ŋála̰
အီသီယိုးပီးယား	ʔìθìjópíjá
ဖဲကြိုး	pʰɛ́d͡ʑó
မုရား	məjá
သင်္ကြန်မိုး	θɪ̀ɴd͡ʑàɴmó
ဓာတ်ခွက်	dàtkʰwɛʔ
ဗို့	bo̰
ကမ္ဘာလုံးခြမ်း	ɡəbàlóʊɴd͡ʑàɴ
အလင်း	ʔəlɪ́ɴ
မိုးခေါ်	mókʰɔ̀
ပြည့်	pjḛ
စဲ	sɛ́
မြေအောက်မီးရထား	mjèʔaʊʔmíjətʰá
ရုံး	jóʊɴ
နှာဘူး	n̥àbú
ဆူဒန်	sʰùdàɴ
မှတ်ဉာဏ်	m̥aʔɲàn
ဘော်လီဘော	bɔ̀lìbɔ́
စက္ကရီတေရီ	sɛʔkəɹìtèjì
အလက်	ʔəlɛʔ
အငြိမ့်တီးမျိုး	ʔa̰ɲḛɪɴtímjó
ဂူ	ɡù
ပဝရ	pəwəɹa̰
နဲ့	nɛ̰
ကြည့်	t͡ɕḭ
သဉ္ဇာလီ	θɪ̀ɴzàlì
မုဒိမ်း	mədéɪɴ
တောက်ပ	taʊʔpa̰
မီးအိမ်	míʔèɪɴ
ဒွိလိင်	dwḭlèɪɴ
လေအေးစက်	lèʔézɛʔ
နေ	nè
မြို့ပြနိုင်ငံ	mjo̰pja̰nàɪɴŋàɴ
ဆောင်းပါး	sʰáʊɴbá
ယပင့်	ja̰pɪ̰ɴ
ပြင်သစ်	pjɪ̀ɴθɪʔ
ပလူတိုနီယမ်	pəlùtònìjàɴ
မက်	mɛʔ
ရွှေဖြူ	ʃwèbjù
ဘုန်းကြီးကျောင်း	pʰóʊɴd͡ʑít͡ɕáʊɴ
အတိတ်	ʔəteɪʔ
အီကွေဒေါ	ʔìkwèdɔ́
ဘုန်းကြီးပျံ	pʰóʊɴd͡ʑíbjàɴ
သူစိမ်းတစ်ရံဆံ	ðəzéɪɴtəjàɴzàɴ
ကော်တွန်	kɔ̀tʊ̀ɴ
သတ္တုရိုင်း	θaʔtṵjáɪɴ
ထင်	tʰɪ̀ɴ
ချက်	t͡ɕʰɛʔ
အမျှင်	ʔəm̥jɪ̀ɴ
ကောဏ္ဍညဘုရား	kɔ̀ndəɲa̰pʰəjá
ငုသိမ်	ŋṵðèɪɴ
လူစုလူဝေး	lùzṵlùwé
အန်	ʔàɴ
တီး	tí
ဗုဒ္ဓသာသနာ	θàðənà
သားမြီးယပ်	θámjíjaʔ
ငလျင်	ŋəljɪ̀ɴ
ပဉ္စမ	pjɪ̀ɴsəma̰
ဒစ္စကို	dɪʔsa̰kò
အရေပြားရောဂါ	ʔəjèbjájɔ́ɡà
အမွေခွဲ	ʔəmwèkʰwɛ́
ဖော့လုံး	pʰɔ̰lóʊɴ
သူရဲကောင်း	θùjɛ́ɡáʊɴ
တင်	tɪ̀ɴ
ဗြိတိန်	bjḭtèɪɴ
မာလကာ	màləkà
ပုဂ္ဂိုလ်	poʊʔɡò
ဝန်ခံ	wʊ̀ɴkʰàɴ
ရူမေးနီးယား	ɹùméníjá
အထင်	ʔətʰɪ̀ɴ
သရဏဂုံသုံးပါး	θəjənəɡòʊɴθóʊɴbá
ညောင်လေးပင်	ɲàʊɴlépɪ̀ɴ
မြွက်	mjwɛʔ
ဝက်အူချောင်း	wɛʔʔùd͡ʑáʊɴ
စားဖိုဆောင်	səpʰòzàʊɴ
ငါးကျပ်တင်	ŋát͡ɕaʔtɪ̀ɴ
လည်စည်း	lèzí
သစ်ကတိုး	θɪʔɡədó
ဖိုင်	pʰàɪɴ
ပညတ်တော်	pjɪ̰ɴnaʔtɔ̀
ဂိတ်	ɡeɪʔ
လှေး	l̥é
ဆိုက်ဘေးရီးယား	sʰaɪʔbéɹíjá
ကြီး	t͡ɕí
ကြက်သီးမွေးညင်းထ	t͡ɕɛʔθéɪɴmwéɲɪ́ɴtʰa̰
သူတကာ	θùdəɡà
နင်တို့	nɪ̀ɴdo̰
ဘီစကွတ်	bìsəkʊʔ
ကော်ပြန့်ကြော်	kɔ̀pja̰ɴd͡ʑɔ̀
ဟွန်ဒူးရပ်စ်	hʊ̀ɴdúɹaʔs
ပန်းရန်	bəjàɴ
ဗိုင်းရပ်စ်	báɪɴɹaʔs
က	ka̰
ရဲရင့်	jɛ́jɪ̰ɴ
ဝစ်ရှင်နရီ	wɪʔʃɪ̀ɴnəɹì
ဆောက်	sʰaʊʔ
ကနစိုး	kənəzó
ပထမ	pa̰tʰa̰ma̰
သော့	θɔ̰
ရွှဲ	ʃwɛ́
ခန္ဓာဗေဒ	kʰàɴdàbèda̰
သူပုန်	ðəbòʊɴ
ခက်	kʰɛʔ
အတူ	ʔətù
ဂွါတီမာလာ	ɡwàtìmàlà
အစီရင်	ʔəsìjɪ̀ɴ
ခြင်	t͡ɕʰɪ̀ɴ
ယီမင်	jìmɪ̀ɴ
မြဝတီ	mja̰wədì
ပမာဏ	pəmàna̰
ရပါတယ်	ja̰bàdɛ̀
စုံစမ်း	sòʊɴzáɴ
ယပက်လက်	ja̰pɛʔlɛʔ
ဦးခွံ	ʔúɡʊ̀ɴ
လင်ကောင်ပိုး	lɪ̀ɴɡàʊɴbó
ကျေးဇူးပြု၍	t͡ɕézúpjṵjwḛ
ဖာလူဒါ	pʰàlùdà
ငါးပိရည်	ŋəpḭjè
ရဲရဲ	jɛ́jɛ́
ပေါ်	pɔ̀
မုန့်ဟင်းခါး	mo̰ʊɴhɪ́ɴɡá
လွန်	lʊ̀ɴ
ခွေးသူတောင်းစား	kʰwéðədáʊɴzá
ပန်းသေးခေါက်ဆွဲ	páɴθékʰaʊʔsʰwɛ́
မေဓင်္ကရာဘုရား	mèdɪ̀ɴkəɹàpʰəjá
မဂ္ဂင်ရှစ်ပါး	mɛʔɡɪ̀ɴʃɪʔbá
ဆင်ခြေထောက်ရောဂါ	sʰɪ̀ɴt͡ɕʰèdaʊʔjɔ́ɡà
ဘေးဆီးရန်ကာ	bézíjàɴɡà
အပေါင်းလက္ခဏာ	ʔəpáʊɴlɛʔkʰənà
အနန္တ	ʔənàɴda̰
မောင်	màʊɴ
မြေစာ	mjèzà
သွေးကြော	θwéd͡ʑɔ́
ဖင်လန်	pʰɪ̀ɴlàɴ
ကမ္ဘာဂြိုဟ်	ɡəbàd͡ʑò
လျက်	jɛʔ
ပျစ်	pjɪʔ
အထီး	ʔətʰí
သတ္တုတွင်း	θaʔtṵdwɪ́ɴ
ဖြူ	pʰjù
ကာဂစ်စတန်	kəɡɪʔsətàɴ
သံ့သံ့	θa̰ɴða̰ɴ
ခံတပ်	kʰàɴdaʔ
ပင်လယ်ဆား	pɪ̀ɴlɛ̀zá
တိုဖူး	tòpʰú
ကတိ	ɡədḭ
ကာလီဖိုးနီးယား	kàlìpʰóníjá
ကွမ်ရင်မယ်တော်	kwàɴjɪ̀ɴmɛ̀dɔ̀
သူငယ်ချင်း	θəŋɛ̀d͡ʑɪ́ɴ
သူကောင်းမြှောက်	θùɡáʊɴm̥jaʊʔ
လေးကြိုး	léd͡ʑó
ချိုး	t͡ɕʰó
ပဝါ	pa̰wà
ဒီလို	dìlò
ဝသန္တ	wa̰θàɴta̰
သူကောင်တင်	θùɡàʊɴdɪ̀ɴ
ဘရာဇီး	bəɹàzí
ရေခဲသေတ္တာ	jèɡɛ́θɪʔtà
ရွှေနန်းရွှေပြာသာဒ်သခင်	ʃwènáɴʃwèpjaʔθaʔθəkʰɪ̀ɴ
လက်ဝါးကပ်တိုင်	lɛʔwəɡaʔtàɪɴ
အကယ်၍	ʔəkɛ̀jwḛ
ဗထက်ခြိုက်	ba̰tʰɛʔt͡ɕʰaɪʔ
အိုရှန်းနီးယား	ʔòʃáɴníjá
ကွင်း	kwɪ́ɴ
ပုရွက်	pəjwɛʔ
ဘုံကျောင်း	bòʊɴd͡ʑáʊɴ
မည်စည်	mɛ̀zɛ̀
တင်းထိမ်	tɪ́ɴdèɪɴ
ဘူ	bù
မုန့်ညက်	mo̰ʊɴɲɛʔ
သီလရှင်	θìla̰ʃɪ̀ɴ
လကွယ်	la̰ɡwɛ̀
ဝန်စည်စလယ်	wʊ̀ɴzìzəlɛ̀
ဝင်း	wɪ́ɴ
ကင်ညာ	kɪ̀ɴɲà
ဝဆွဲ	wa̰sʰwɛ́
နဂါးမောက်သီး	na̰ɡámaʊʔθí
နိဒါန်း	nḭdáɴ
စာအုပ်	sàʔoʊʔ
ဟုတ်ကဲ့	hoʊʔkɛ̰
သစ္စာဖောက်	θɪʔsàpʰaʊʔ
သိပ္ပံဘွဲ့	θeɪʔpàɴbwɛ̰
သိခီဘုရား	θḭkʰìpʰəjá
အဖြေ	ʔəpʰjè
ပုဒ်မ	poʊʔma̰
ချစ်	t͡ɕʰɪʔ
ဝန်ရှင်တော်	wʊ̀ɴʃɪ̀ɴdɔ̀
လိမ်	lèɪɴ
ခရု	kʰəjṵ
ဩသဓ	ʔɔ́θəda̰
အလား	ʔəlá
ကော်	kɔ̀
ပန်တျာ	pàɴtəjà
ကုလားထိုင်	kələtʰàɪɴ
လက်ကိုင်ပဝါ	lɛʔkàɪɴpa̰wà
အစက်	ʔəsɛʔ
ပင်စင်	pɪ̀ɴsɪ̀ɴ
မရမာကြီး	məɹəmàd͡ʑí
မျက်ခွံ	mjɛʔkʰʊ̀ɴ
ခြေနင်း	t͡ɕʰènɪ́ɴ
ပြည်ထောင်စုနေ့	pjìdàʊɴzṵnḛ
ယင်ကောင်	jɪ̀ɴɡàʊɴ
မုန့်လက်ဆောင်း	mo̰ʊɴlɛʔsʰáʊɴ
တတ်	ɴ
ကြေးငွေ	t͡ɕéŋwè
အရေ	ʔəjè
မုန်ညင်းဖြူ	mòʊɴɲɪ́ɴpʰjù
အမြဲတမ်း	ʔəmjɛ́dáɴ
ဘက်	bɛʔ
မိတ်ကပ်	meɪʔkaʔ
အလုပ်ပိတ်ရက်	ʔəloʊʔpeɪʔjɛʔ
ဇီရာစေ့	zìjàsḛ
မျို	mjò
ကမ်းခြေ	káɴd͡ʑè
ဂါဘွန်	ɡàbʊ̀ɴ
ရှိုက်	ʃaɪʔ
အမေရိကန်	ʔəmèɹḭkàɴ
ခရင်း	kʰəjɪ́ɴ
ကျားကျားလျားလျား	t͡ɕád͡ʑájájá
တကာ	dəɡà
ရေးရေး	jéjé
ကျွန်းဆွယ်	t͡ɕʊ́ɴzwɛ̀
သူလျှို	ðəʃò
ကုန်းနှီး	kóʊɴn̥í
များများ	mjámjá
ဇီဝကမ္မဗေဒ	zìwa̰kàɴma̰bèda̰
အသည်း	ʔəθɛ́
ငု	ŋṵ
ဧကရာဇ်	ʔèɡəjɪʔ
မနက်	mənɛʔ
ကြွေ	t͡ɕwè
သတ္တုဗေဒ	θaʔtṵbèda̰
ဝိသေသလက္ခဏာ	wḭθèθa̰lɛʔkʰənà
အသတ်	ʔa̰θaʔ
သံလမ်းရထား	θàɴláɴjətʰá
စာဆို	sàzò
ဝေါဟာရဗေဒ	θaʔda̰bèda̰
စက်လှေကား	sɛʔl̥èɡá
ဘူးသီး	búθí
ပုပ်	poʊʔ
နွေရာသီ	nwèjàðì
ပသျှူး	pəʃú
ခရီးသည်	kʰəjíðè
ဒဿနဗေဒ	da̰θəna̰bèda̰
အုန်း	ʔóʊɴ
ပန်းခုနစ်မည်	páɴkʰənəmjì
ဆက်	sʰɛʔ
ရေနံ	jènàɴ
ထမင်းသုပ်	tʰa̰mɪ́ɴθoʊʔ
ဇာတ်	zaʔ
ရေ	jè
မဏိ	mənḭ
ကြက်သွန်ဖြူ	t͡ɕɛʔθʊ̀ɴbjù
တောင်း	táʊɴ
လစ်	lɪʔ
လင်းဇင်း	lɪ́ɴzɪ́ɴ
ကျွဲ	t͡ɕwɛ́
သူကောင်းပြု	θùɡáʊɴpjṵ
နေ့လယ်	nḛlɛ̀
လူဦးရေ	lùʔújè
လေလည်	lèlè
အနှီဟာ	ʔən̥ìhà
မော်ရီတေးနီးယား	mɔ̀ɹìténíjá
ရှား	ʃá
တိုင်းရင်းသား	táɪɴjɪ́ɴðá
ဆေးရှဲ	sʰéʃɛ́
ကြံ	t͡ɕàɴ
တချို့	tət͡ɕʰo̰
တော်လေးဝ	tɔ̀léwa̰
ဝှက်	ʍɛʔ
ဦးကြီး	ʔúd͡ʑí
အသည်းနှလုံး	ʔəθɛ́n̥əlóʊɴ
နွားနို့ခေါက်ဆွဲ	nwáno̰kʰaʊʔsʰwɛ́
ယို	jò
လက်ဆွဲသေတ္တာ	lɛʔsʰwɛ́θɪʔtà
ဒေသိယစကား	dèθḭja̰zəɡá
မီးယပ်ပညာ	míjaʔpjɪ̀ɴɲà
အရိုး	ʔəjó
လိပ်ခေါင်းရောဂါ	leɪʔɡáʊɴjɔ́ɡà
ဘေး	bé
စာ	sà
ဝါကျ	weɪʔt͡ɕa̰
ကမန်	ka̰màɴ
ပီရူး	pìɹú
ဂေါ်မိတ်	ɡɔ̀meɪʔ
ထိ	tʰḭ
ဖျာ	pʰjà
နယူးယောက်	nəjújaʊʔ
မြုံ	mjòʊɴ
အရီးလေး	ʔəjílé
ဘေးဆိုး	bézó
လုပ်ရတ်	loʊʔjaʔ
အစိမ်း	ʔəséɪɴ
တိပိဋက	tḭpḭtəka̰
အပ်ချုပ်စက်	ʔaʔt͡ɕʰoʊʔsɛʔ
အချိုး	ʔət͡ɕʰó
အဆောင်	ʔəsʰàʊɴ
ကျမ	t͡ɕəma̰
ကောင်	kàʊɴ
အခိုး	ʔəkʰó
အရှင်	ʔəʃɪ̀ɴ
ဦလန်ဘာတာ	ʔùlàɴbàtà
အကွ	ʔəkwa̰
အမြီး	ʔəm̥í
ပြည်နယ်	pjìnɛ̀
သား	θá
သွားတိုက်ဆေး	θwádaɪʔsʰé
ချောက်	t͡ɕʰaʊʔ
နေ့လယ်စာ	nḛlɛ̀zà
တက္ကဗေဒ	tɛʔka̰bèda̰
သုဒ္ဒကြိယာ	θoʊʔda̰kəɹḭjà
ပါလက်စတိုင်း	pàlɛʔsətáɪɴ
တရားရုံး	təjájóʊɴ
မှန်ပါ့ဘုရား	m̥àɴba̰pʰəjá
ကျောက်ကြီး	t͡ɕaʊʔt͡ɕí
ဘလောက်	ba̰laʊʔ
နှစ်ဆန်းတစ်ရက်နေ့	n̥ɪʔsʰáɴtəjɛʔnḛ
အမဲလိုက်	ʔəmɛ́laɪʔ
ငါးမန်း	ŋəmáɴ
ပါကစ္စတန်	pàkɪʔsətàɴ
မသိပါဘူး	ma̰θḭbàbú
ဖဝါး	pʰəwá
လစ်ဗျား	lɪʔbjá
ကုန်သည်	kòʊɴðè
ဒူး	dú
ခန်တမာ	kʰàɴtəmà
အခွန်	ʔəkʰʊ̀ɴ
မွဲ	mwɛ́
လျှပ်	l̥jaʔ
ဘူရွန်ဒီ	bùɹʊ̀ɴdì
မတ်	maʔ
ကိတ်မုန့်	keɪʔmo̰ʊɴ
ဒေါ်လာ	dɔ̀là
မန်ကျည်း	məd͡ʑí
သစ်သီးရည်	θɪʔθíjè
အကျဉ်း	ʔət͡ɕɪ́ɴ
တင်းနစ်	tɪ́ɴnɪʔ
ကြာဆံ	t͡ɕàzàɴ
ဘုရားအလောင်း	pʰəjáʔəláʊɴ
ဘာသာစကား	bàθàzəɡá
ပုဂံ	bəɡàɴ
လောဘ	lɔ́ba̰
ပခုက္ကူ	pəkʰùkkù
ဌေး	tʰé
ပစ္စယာ	pjɪʔsəjà
ဖောက်	pʰaʊʔ
နှစ်ရာ	n̥əjà
ကလီစာ	kəlìzà
ညီလာခံ	ɲìlàɡàɴ
ငရဲသား	ŋəjɛ́ðá
ပက်ကျိ	pɛʔt͡ɕḭ
မောင်း	máʊɴ
ကျွန်တော်တို့	t͡ɕʊ̀ɴdɔ̀do̰
နယုန်	nəjòʊɴ
ကို	ɡò
ကိန္နရီ	kèɪɴnəjì
မျက်နှာသုတ်ပဝါ	mjɛʔn̥àθoʊʔpa̰wà
အဇာဘိုင်ဂျန်	ʔa̰zəbàɪɴd͡ʑàɴ
ရှိုး	ʃó
ဖေဖော်ဝါရီ	pʰèpʰɔ̀wàɹì
ဗိမာန်	beɪʔmàɴ
စစ်ကဲ	sɪʔkɛ́
ဒိုင်နိုဆော	dàɪɴnòsʰɔ́
သိကြား	ðəd͡ʑá
အမျိုးသားသီချင်း	ʔəmjóðáθət͡ɕʰɪ́ɴ
သီဂိရိယ	θìɡḭɹḭja̰
ပဝေဏီ	pəwènì
ခြေ	t͡ɕʰè
ပိန်းဥ	péɪɴʔṵ
ယမ်းတောင့်	jáɴda̰ʊɴ
အဋ္ဌမ	ʔaʔtʰəma̰
ဝိဇယပူရ	wḭzəja̰pùɹa̰
ကျောက်သင်ပုန်း	t͡ɕaʊʔθɪ̀ɴbóʊɴ
တိဿ	teɪʔθa̰
ကံသုံးပါး	kàɴθóʊɴbá
ခွေးမသား	kʰwéma̰ðá
ဝါစင်္ဂ	wàzɪ̀ɴɡa̰
ပညာကျော်	pjɪ̀ɴɲàd͡ʑɔ̀
ကြောင့်	d͡ʑa̰ʊɴ
မဲဆန္ဒ	mɛ́sʰàɴda̰
ဗျိုင်း	bjáɪɴ
ဖော်ပြ	pʰɔ̀pja̰
ဆိုမာလီယာ	sʰòmàlìjà
လွိုင်ကော်	lwàɪɴkɔ̀
ပဋိသန္ဓေ	pədḭθàɴdè
မိုးကာအင်္ကျီ	móɡàʔɪ̀ɴd͡ʑì
ဟိုက်ဒရိုဂျင်	haɪʔdəɹòd͡ʑɪ̀ɴ
စာလုံးပေါင်းသတ်ပုံ	səlóʊɴbáʊɴθaʔpòʊɴ
သဒ္ဒဗေဒ	θaʔda̰bèda̰
စင်ကာပူ	sɪ̀ɴɡəpù
လက်တင်	lɛʔtɪ̀ɴ
နည်းနည်း	nɛ́nɛ́
ထွေး	tʰwé
ပတ်	paʔ
လက်နှိပ်စက်	lɛʔn̥eɪʔsɛʔ
တပ်ကြပ်ကြီး	taʔt͡ɕaʔt͡ɕí
အပ်ချည်	ʔaʔt͡ɕʰì
ဗျာဓိ	bjàdḭ
သရုပ်ဆောင်	θəjoʊʔsʰàʊɴ
ဓာတ်ဆီ	daʔsʰì
ကြည့်မြင်တိုင်	t͡ɕḭmjɪ̀ɴdàɪɴ
ကြော်ငြာ	t͡ɕɔ̀ɲà
ဟူ	hù
ရေနံဆီ	jènàɴzì
ကူးတို့	ɡədo̰
တစ်ထောင်	tətʰàʊɴ
သက်ဆိုင်	θɛʔsʰàɪɴ
ဝှေးစေ့	ʍézḭ
ဥက္ကာခဲ	ʔoʊʔkàɡɛ́
ဒုတိယအရာခံဗိုလ်	dṵtḭja̰ʔəjàɡàɴbò
လက္ခဏာ	lɛʔkʰənà
ကျဉ်းကျပ်	t͡ɕɪ́ɴt͡ɕaʔ
ပြော	pjɔ́
နတ်နန်း	naʔnáɴ
သီအိုရီ	θìʔòɹì
နာဂဒေဝ	nàɡa̰dèwa̰
ကိတ်ဗာဒီ	keɪʔbədì
ခြမ်း	t͡ɕʰáɴ
မီးပွိုင့်	mípwa̰ɪɴ
သီတင်းသီလ	ðədɪ́ɴθìla̰
ပါတာနီ	pàtànì
ကနုတ်	kənoʊʔ
ဝမ်းတဖိုး	wʊ́ɴda̰pʰó
ဘီလာရုဇ်	bìlàɹùz
ရွှေကြည်	ʃwèd͡ʑì
ဖုဿ	pʰoʊʔθa̰
ဗီယင်ကျန်း	bìjɪ̀ɴt͡ɕáɴ
သစ်ပင်	θɪʔpɪ̀ɴ
ခရမ်းသီး	kʰəjáɴθí
လမ်း	láɴ
ကောင်းကောင်း	káʊɴɡáʊɴ
မုန့်တီ	mo̰ʊɴtì
ဘယ်နှစ်	bɛ̀n̥ə
ဒုဗ္ဘိက္ခန္တရကပ်	doʊʔbeɪʔkʰàɴtəɹa̰kaʔ
ဆော်ဒီအာရေဗျ	sʰɔ̀dìʔàɹèbja̰
ဟင်္သာတ	hɪ̀ɴθəta̰
ပတ်တီး	paʔtí
ဆီးရီးယား	sʰíɹíjá
ကရဝိက်	kəɹa̰weɪʔ
သံပန်း	θàɴbáɴ
မုန်လာ	mòʊɴlà
ဂျေရုဆလင်	d͡ʑèɹṵsʰa̰lɪ̀ɴ
သူဖုန်းစား	θùpʰóʊɴsá
မွာချီး	mwàt͡ɕʰí
ဒီဃ	dìɡa̰
လဆုတ်	la̰zoʊʔ
မွန်တီနီဂရိုး	mʊ̀ɴtìnìɡəɹó
မြေအောက်	mjèʔaʊʔ
ပုံတူ	pòʊɴdù
ဆင်ဝင်	sʰɪ̀ɴwɪ̀ɴ
ဝိဇ္ဇာ	weɪʔzà
လေသာပေါက်	lèðàbaʊʔ
ထမင်းဆိုင်	tʰəmɪ́ɴzàɪɴ
ကျောင်းနေဖက်	t͡ɕáʊɴnèbɛʔ
ချည်	t͡ɕʰì
ပယောဂ	pəjɔ́ɡa̰
ပုရစ်	pəjɪʔ
ပန်းတော့	páɴdɔ̰
ဂိတ်ဆုံး	ɡeɪʔsʰóʊɴ
ဟရိဘုဉ္ဇ	həɹḭbòʊɴza̰
နည်းပညာ	nípjɪ̀ɴɲà
စို	sò
အိတ်	ʔeɪʔ
ရွှေထမင်း	ʃwètʰəmɪ́ɴ
နားလည်	nálɛ̀
နာရီ	nàjì
ဖက်ဝန်း	pʰɛʔwʊ́ɴ
အန်ကယ်	ʔàɴkɛ̀
ဇီဝဓာတုဗေဒ	zìwa̰dàtṵbèda̰
မုခ်	moʊʔ
ပါရှား	pàʃá
မှတ်ကျောက်	m̥aʔt͡ɕaʊʔ
ဗက်တီးရီးယား	bɛʔtíɹíjá
သူအို	θùʔò
နှုတ်သီး	n̥oʊʔθí
မိုင်	màɪɴ
အစားအစာ	ʔəsáʔəsà
နမီးဘီးယား	na̰míbíjá
တစ်	tɪʔ
သူတို့	θùdo̰
မယ်	mɛ̀
ရှေ့နေ	ʃḛnè
မြံမာ	mjàɴmà
တြိဂံ	tɹḭɡàɴ
ဓားစာခံ	dəzàɡàɴ
သစ်သီး	θɪʔθí
ဂယ်လက်ဆီ	ɡɛ̀lɛʔsʰì
စီး	sí
ညစ်	ɲɪʔ
မှန်ပြောင်း	m̥àɴbjáʊɴ
တိုးတက်ခြင်း	tótɛʔd͡ʑɪ̀ɴ
အကုန်	ʔəkòʊɴ
စားစရာ	sázəjà
ဂရပ်	ɡəɹaʔ
ရှေ့ရုံး	ʃḛjóʊɴ
သရုပ်	θəjoʊʔ
အင်းသား	ʔɪ́ɴðá
ယိုးဒယား	jódəjá
အတွင်းခံ	ʔətwɪ́ɴɡàɴ
အ	ʔa̰
ဎရေမှုတ်	da̰jèm̥oʊʔ
မြင်းစားဂျုံ	mjɪ́ɴzád͡ʑòʊɴ
ဥပုသ်	ʔṵboʊʔ
ဒါန	dàna̰
နိဒ္ဒေသ	neɪʔdèθa̰
ဘဏ်တိုက်	bàɴdaɪʔ
မိန်းမ	méɪɴma̰
ဖိနပ်	pʰənaʔ
ရုရှား	ɹṵʃá
နှင်းပွင့်	n̥ɪ́ɴbwɪ̰ɴ
တောင်	tàʊɴ
သပ်	θaʔ
ချစ်ခင်	t͡ɕʰɪʔkʰɪ̀ɴ
အလောင်း	ʔəláʊɴ
ပန်းအိ	páɴʔḭ
စ	sa̰
မည်သူ	mìðù
အဖော်	ʔəpʰɔ̀
ကွာစေ့	kwàsḭ
ရေကြီးခြင်း	jèt͡ɕíd͡ʑɪ́ɴ
ပေါက်တူး	paʊʔtú
ဖယောင်း	pʰəjáʊɴ
သိက္ခါ	θeɪʔkʰà
ကဿပ	kaʔθəpa̰
အသိုက်	ʔəθaɪʔ
နံနက်စာ	nàɴnɛʔsà
မရီး	məjí
အရောင်တင်မှုန့်	ʔəjàʊɴtɪ̀ɴm̥o̰ʊɴ
ခွေး	kʰwé
နာတာလူးပွဲ	nàtàlúbwɛ́
ဥစ္စာ	ʔoʊʔsà
ဝေလငါး	wèla̰ŋá
လိမ်း	léɪɴ
ကိုဘော့	kòbɔ̰
ကွမ်းတောင်	kʊ́ɴdàʊɴ
သွေ	θwè
ပုံတူကား	pòʊɴdùká
နောက်ကျ	naʊʔt͡ɕa̰
ငါးသလောက်ပေါင်း	ŋəθəlaʊʔbáʊɴ
လျှင်	l̥jɪ̀ɴ
စန္ဒြမာသ	sàɴdɹa̰màθa̰
လိုက်ဘေးရီးယား	laɪʔbéɹíjá
ကစား	ɡəzá
ထိမ်းမြား	tʰéɪɴmjá
သူငယ်မ	θəŋɛ̀ma̰
အရက်	ʔəjɛʔ
အမှုန့်	ʔəm̥o̰ʊɴ
ကော့စတာရီကာ	kɔ̰sətàɹìkà
သဒ္ဒါဆယ်ပါး	ðədàsʰɛ̀bá
သော်တာ	θɔ̀dà
သည်မှာ	ðìm̥à
ချော	t͡ɕʰɔ́
လွန်ဆွဲ	lʊ̀ɴsʰwɛ́
အကျဉ်းထောင်	ʔət͡ɕɪ́ɴdàʊɴ
ဂီတ	ɡìta̰
အဂ္ဂမဟာသေနာပတိ	ʔɛʔɡa̰məhàθènàpətḭ
အာနုဘော်	ʔànṵbɔ̀
ပြုံယမ်း	pjòʊɴjáɴ
စာမျက်နှာ	sàmjɛʔn̥à
ဦးခိုက်	ʔúkʰaɪʔ
မီးခြစ်	míd͡ʑɪʔ
နှာခေါင်း	n̥əkʰáʊɴ
ဗလာစာအုပ်	bəlàsàʔoʊʔ
အတွဲ	ʔətwɛ́
မင်	m̥ɪ̀ɴ
အသက်ဦးဆံပိုင်	ʔəθɛʔʔúsʰàɴbàɪɴ
ဣ	ʔḭ
မြွေ	mwè
တလွဲ	təlwɛ́
တွေး	twé
သင်ပန်း	θɪ̀ɴbáɴ
ပလတ်	pəlaʔ
ဒဿနိကဗေဒ	da̰θənḭka̰bèda̰
အာကာသစိုး	ʔàkàθa̰zó
သိဒ္ဓိ	θeɪʔdḭ
လမ်းသရဲ	láɴθəjɛ́
ဒိန်ချဉ်	dèɪɴd͡ʑɪ̀ɴ
နာရဒဘုရား	nàɹəda̰pʰəjá
အဓိက	ʔa̰dḭɡa̰
ဘုရားကျောင်း	pʰəjád͡ʑáʊɴ
ရေနဂါး	jènəɡá
အာဃာတ	ʔàɡàta̰
ကြာချည်	t͡ɕàt͡ɕʰì
သွေးအုပ်စု	θwéʔoʊʔsṵ
ပွား	pwá
လဲ	lɛ́
အင်း	ʔɪ́ɴ
ယင်းမာ	jɪ́ɴmà
အနိစ္စ	ʔənèssa̰
စရိတ်	zəjeɪʔ
အထိန်း	ʔətʰéɪɴ
ဗီဇ	bìza̰
ခေါင်းဆောင်	ɡáʊɴzàʊɴ
မြေနုကျွန်းပေါ်	mjènṵt͡ɕʊ́ɴbɔ̀
ကားရုံ	kájòʊɴ
လိပ်ကျောက်	leɪʔt͡ɕaʊʔ
အဆွေး	ʔəsʰwé
လက်ဖက်ရည်ဆိုင်	ləpʰɛʔjèzàɪɴ
ဆက်သွယ်ရေး	sʰɛʔθwɛ̀jé
မဒါဂတ်စကား	ma̰dàɡaʔsəká
ကာလသား	kàləðá
ဟင်း	hɪ́ɴ
ဘူး	bú
ဆွေခုနစ်ဆက်မျိုးခုနစ်ဆက်	sʰwèkʰənəzɛʔmjókʰənəzɛʔ
ဇနီး	zəní
မဲပေး	mɛ́pé
တရားခံ	təjəkʰàɴ
မိုင်လို	màɪɴlò
ပင်လယ်အော်	pɪ̀ɴlɛ̀ʔɔ̀
ဝင်	wɪ̀ɴ
တည်	tì
ရှက်	ʃɛʔ
အလုပ်သမားနေ့	ʔəloʊʔθəmánḛ
ကွမ်းယာ	kʊ́ɴjà
အာဝါဟဝိဝါဟ	ʔàwàha̰wḭwàha̰
ခြေထောက်	t͡ɕʰèdaʊʔ
မြင်းမ	mjɪ́ɴma̰
ကပွဲရုံ	ka̰bwɛ́jòʊɴ
ဆောင်းဦးရာသီ	sʰáʊɴʔújàðì
ပျော်ပျော်	pjɔ̀bjɔ̀
သင်္ဘော	θɪ́ɴbɔ́
ဖို့	pʰo̰
မဆလာ	ma̰sʰəlà
သံလိုက်	θàɴlaɪʔ
နိယာမ	nḭjàma̰
အမွေခံ	ʔəmwèkʰàɴ
ကောင်တာ	kàʊɴtà
ယသောဓရာ	ja̰θɔ́dəjà
အလီ	ʔəlì
မိုး	mó
ဘီယာ	bìjà
အခွင့်ထူးခံ	ʔəkʰwɪ̰ɴtʰúɡàɴ
ဒန်ပူ	dəbù
သူသူငါငါ	θùθùŋàŋà
ဇလုံ	zəlòʊɴ
ဈေးကြီး	zét͡ɕí
မင်္ဂလာပါ	mɪ̀ɴɡəlàbà
စင်း	sɪ́ɴ
ချွေး	t͡ɕʰwé
အရိုးစု	ʔəjózṵ
စခန်း	səkʰáɴ
မှတ်တိုင်	m̥aʔtàɪɴ
ဇေယျ	zèja̰
စက်ရုံ	sɛʔjòʊɴ
နေပြည်တော်	nèpjìdɔ̀
ပီတိ	pìtḭ
မီးသုံးပါး	míθóʊɴbá
ဖုဿဘုရား	pʰoʊʔθa̰pʰəjá
ဂြိုဟ်	d͡ʑò
ဓမ္မတာဝန်	dəmədàwʊ̀ɴ
ပဉ္စကလျာဏီ	pjɪ̀ɴsa̰kələjànì
ကျွန်မ	t͡ɕʊ̀ɴma̰
သူတစ်လူငါတစ်မင်း	θùtəlùŋàtəmɪ́ɴ
အရိမဒ္ဒနာပူရ	ʔa̰ɹḭmàddənàpùɹa̰
တတ်	taʔ
ဒုတိယဗိုလ်ချုပ်ကြီး	dṵtḭja̰bòd͡ʑoʊʔd͡ʑí
စိုက်ပျိုးရေး	saɪʔpjójé
ဗိုလ်ကျ	bòt͡ɕa̰
ထိုင်မသိမ်း	tʰàɪɴməθéɪɴ
သားရေ	θəjè
မူလီ	mùlì
ပိုက်ဆံ	paɪʔsʰàɴ
မြန်မာ့	mjàɴma̰
သိဒ္ဓတ်မင်း	θeɪʔdaʔmɪ́ɴ
အကျော်	ʔət͡ɕɔ̀
ထွက်	tʰwɛʔ
မီးပွား	míbwá
ကြောင်ကလေး	t͡ɕàʊɴɡəlé
သားပိုက်ကောင်	θábaɪʔkàʊɴ
အဖ	ʔəpʰa̰
ကာရန်	kəjàɴ
ကြီးကြီး	t͡ɕíd͡ʑí
ယဉ်	jɪ̀ɴ
အမျိုးအနွယ်	ʔəmjóʔənwɛ̀
ဘိန်းမုန့်	béɪɴmo̰ʊɴ
ခရီး	kʰəjí
ဗို့အား	bo̰ʔá
ကပ္ပလီ	kaʔpəlì
ပင်စည်	pɪ̀ɴzì
မာလာ	màlà
ကျန်း	t͡ɕáɴ
အဉ္ဇလီ	ʔɪ̀ɴzəlì
အဖွဲ့	ʔəpʰwɛ̰
နှစ်ချုပ်	n̥ɪʔd͡ʑoʊʔ
ဝီစကီ	wìsəkì
ယမနေ	jəmənè
မဟာလတာ	məhàlətà
မြေး	mjé
ကုန်ကုန်	kòʊɴɡòʊɴ
မျောက်လုတ်	mjaʊʔloʊʔ
မော်တော်ဆိုင်ကယ်	mɔ̀tɔ̀sʰàɪɴkɛ̀
ငရဲကြီးရှစ်ထပ်	ŋəjɛ́d͡ʑíʃɪʔtʰaʔ
ထာဝရ	tʰàwəja̰
ရေဝတ	ɹèwəta̰
တောကြက်မောက်	tɔ́t͡ɕɛʔmaʊʔ
ခြင်္သေ့မ	t͡ɕʰɪ̀ɴðḛma̰
မြန်မြန်	mjàɴmjàɴ
ကြိယာ	kəɹḭjà
စေတီ	zèdì
အချက်	ʔət͡ɕʰɛʔ
လက်ပတ်နာရီ	lɛʔpaʔnàjì
ကောင်မလေး	kàʊɴma̰lé
ကျောက်ပွင့်သုပ်	t͡ɕaʊʔpwɪ̰ɴθoʊʔ
ပေး	pé
လောက်	laʊʔ
မက်မွန်	mɛʔmʊ̀ɴ
ဘန်ကောက်	bàɴkaʊʔ
ဂေါတမ	ɡɔ́təma̰
ဒီဗီဒီ	dìbìdì
သူနာတင်ကား	θùnàtɪ̀ɴká
အမြဲ	ʔəmjɛ́
အညစ်အကြေး	ʔəɲɪʔʔət͡ɕé
ပါးစပ်	pəzaʔ
ဆရာဝန်	sʰa̰jàwʊ̀ɴ
ကောဏဂုံဘုရား	kɔ́nəɡòʊɴpʰəjá
သစ်ကြံပိုး	θɪʔd͡ʑəbó
ပြတင်းပေါက်	bədɪ́ɴbaʊʔ
လှုံ	l̥òʊɴ
ရွှေချီ	ʃwèd͡ʑì
ဝီရ	wìja̰
ကမ္ဗလာ	ɡəbəlà
နိခါတကဗေဒ	nḭkʰàtəka̰bèda̰
ဆရာလေး	sʰəjàlé
ငါတို့	ŋàto̰
ဖခင်	pʰa̰ɡɪ̀ɴ
ယဲ့ယဲ့	jɛ̰jɛ̰
အချို့	ʔət͡ɕʰo̰
ဝေါဟာရ	wɔ́hàɹa̰
ပဉ္စရူပ	pjɪ̀ɴsa̰ɹùpa̰
ဖုန်	pʰòʊɴ
ဒါ	dà
ပြ	pja̰
စစ်ဗိုလ်	sɪʔbò
ဗိုလ်လောင်း	bòláʊɴ
ကော်ရည်ခေါက်ဆွဲ	kɔ̀jìkʰaʊʔsʰwɛ́
အမေး	ʔəmé
ဝက်ဆီ	wɛʔsʰì
ကွန်ဂို	kʊ̀ɴɡò
အစီအလျဉ်	ʔəsìʔəljɪ̀ɴ
ပေါင်	pàʊɴ
ဆိပ်	sʰeɪʔ
ကျေးဇူးရှင်	t͡ɕézúʃɪ̀ɴ
သွန်းသွန်း	θʊ́ɴðʊ́ɴ
အဖြူ	ʔəpʰjù
သစ်ဆိမ့်	θɪʔsʰḛɪɴ
မတော်တဆ	mətɔ̀təsʰa̰
ပွတ်	pʊʔ
လေဖုတ်	lèpʰoʊʔ
ပြာသို	pjàðò
မြင်းလှည်း	mjɪ́ɴl̥ɛ́
ပအို့ဝ်	pəʔo̰
နားကွင်း	náɡwɪ́ɴ
ပုံသေနည်း	pòʊɴðèní
ခွန်း	kʰʊ́ɴ
ရှင်	ʃɪ̀ɴ
အင်္ကျီ	ʔɪ́ɴd͡ʑì
လှည့်	l̥ɛ̰
တာလုဇ	tàlṵza̰
တူ	tù
ထောင်မှူး	tʰàʊɴm̥ú
ပုဒ်ဖြတ်	poʊʔpʰjaʔ
နိဗ္ဗာန်	neɪʔbàɴ
ရာဇဂုရု	jàza̰ɡṵɹṵ
ပဒေသရာဇ်	bədèθəɹɪʔ
ဂမ်ဘီယာ	ɡàɴbìjà
ကျွန်းကလေး	t͡ɕʊ́ɴɡəlé
သက်ဦးဆံပိုင်	θɛʔʔúsʰàɴbàɪɴ
ချေ	t͡ɕʰè
အဖွဲ့ချုပ်	ʔəpʰwɛ̰d͡ʑoʊʔ
ရေကူးကန်	jèkúɡàɴ
အမတ်	ʔəmaʔ
ရာမ	jàma̰
ယမ်းမှုန့်	jáɴm̥o̰ʊɴ
အပြိုင်	ʔəpjàɪɴ
စောက်	saʊʔ
တလိုင်း	təláɪɴ
အသက်	ʔəθɛʔ
အရိပ်	ʔəjeɪʔ
သည်းခြေ	θíd͡ʑè
ကမ္ဘောဒီးယား	kàɴbɔ́díjá
ဒေဝ	dèwa̰
သံခွာ	θàɴkʰwà
ပိဋကတ်တိုက်	bḭdəɡaʔdaɪʔ
စုလျား	sṵjá
အသိပညာရှင်	ʔəθḭpjɪ̀ɴɲàʃɪ̀ɴ
ညကလေး	ɲa̰kəlé
ချေးထုပ်	t͡ɕʰétʰoʊʔ
ကြိုး	t͡ɕó
သူငယ်တန်း	θùŋɛ̀dáɴ
အိပ်ရာ	ʔeɪʔjà
ယုတ္တိဗေဒ	joʊʔtḭbèda̰
ဝိဟာရ	wḭhàja̰
ငါးမြစ်ချင်း	ŋəmjɪʔt͡ɕʰɪ́ɴ
ခေါင်းပေါင်း	ɡáʊɴbáʊɴ
ယောက်မ	jáʊɴma̰
သူယောင်မယ်	θùjàʊɴmɛ̀
မျှင်	m̥jɪ̀ɴ
ချီလီ	t͡ɕʰìlì
သူကောင်	θùɡàʊɴ
သုခ	θṵkʰa̰
တာရာ	tàjà
ဟေမန်	hèmàɴ
ဗျုပ္ပတ်	bjoʊʔpaʔ
မနော	mənɔ́
တတ်	ʔ
အန်တီ	ʔàɴtì
ကာတွန်း	kàtʊ́ɴ
သူရသတ္တိ	θùja̰θaʔtḭ
လံဗား	làɴbá
ဗေ့စဘော	bḛsəbɔ́
ကျိုက္ခမီ	t͡ɕaɪʔkʰəmì
မံသ	màɴθa̰
ကို	ʔ
နှစ်လ	n̥əla̰
ဆစ်ဒနီ	sʰɪʔdənì
မိကျောင်း	mḭd͡ʑáʊɴ
ဆုံး	sʰóʊɴ
မြူစွမ်	mjùswàɴ
ကြာကြာ	t͡ɕàd͡ʑà
ကြက်မောက်သီး	t͡ɕɛʔmaʊʔθí
မုန့်ကျွဲသည်း	mo̰ʊɴt͡ɕwɛ́ðɛ́
တီရှပ်	tìʃaʔ
ခေါက်မုန့်	kʰaʊʔmo̰ʊɴ
တဘက်	dəbɛʔ
ပိန္နဲ	péɪɴnɛ́
အလုံး	ʔəlóʊɴ
လူ့အဖွဲ့အစည်း	lṵʔəpʰwɛ̰ʔəsí
ပြည်ထောင်စုတော်လှန်ရေးကောင်စီအဖွဲ့	pjìdàʊɴzṵtɔ̀l̥àɴjékàʊɴsìʔəpʰwɛ̰
ညှင်း	ɲ̊ɪ́ɴ
ဖငယ်	pʰa̰ŋɛ̀
ပင်လယ်	pɪ̀ɴlɛ̀
ကြောင်လိမ်လှေကား	t͡ɕàʊɴlèɪɴl̥èɡá
တွင်	twɪ̀ɴ
တခြား	tət͡ɕʰá
လေချွန်	lèt͡ɕʰʊ̀ɴ
ဆီးဖြူ	zíbjù
ကြဉ်	t͡ɕɪ̀ɴ
ဆေးလိပ်မသောက်ရ	sʰéleɪʔməθaʊʔja̰
လက်သည်းကွင်း	lɛʔθéɡwɪ́ɴ
တောင်သူလယ်သမားနေ့	tàʊɴðùlɛ̀θəmánḛ
မာလဝီ	màla̰wì
ဂေါ်	ɡɔ̀
ပြည်ထောင်စု	pjìdàʊɴzṵ
ပန်းနာ	páɴnà
ဘော်ဒါ	bɔ̀dà
ထနောင်း	tʰənáʊɴ
တောင်ဖက်ဝန်း	tàʊɴpʰɛʔwʊ́ɴ
ခွံ	kʰʊ̀ɴ
ယူကရိန်း	jùkəɹéɪɴ
လူတော	lùdɔ́
အေး	ʔé
အဝတ်လျှောက်စက်	ʔəwʊʔʃaʊʔsɛʔ
သုခေါဒယ	θṵkʰɔ́dəja̰
မီးဖိုချောင်	míbòd͡ʑàʊɴ
တရားစွဲ	təjáswɛ́
အထုံးအဖွဲ့	ʔətʰóʊɴʔəpʰwɛ̰
ဓမ္မဒဿီဘုရား	dəma̰dətθìpʰəjá
သရက်	θəjɛʔ
ရေခဲ	jèɡɛ́
ဇာတ်ကြီးဆယ်ဘွဲ့	zàtd͡ʑísʰɛ̀bwɛ̰
တန်ဇေးနီးယား	tàɴzéníjá
လက်သည်း	lɛʔθɛ́
ကယ်လဆီယမ်	kɛ̀ləsʰìjàɴ
ဘဝဲ	bəwɛ́
ချင်	t͡ɕʰɪ̀ɴ
အာမေဍိတ်	ʔàmèdeɪʔ
အမှတ်	ʔəm̥aʔ
ကံကြမ္မာ	kàɴt͡ɕəmà
ပဲနံ့သာ	pɛ́na̰ɴθà
ပတ်စပို့	paʔsəpo̰
အလို	ʔəlò
စောင့်	sa̰ʊɴ
မင်းကြီး	mɪ́ɴd͡ʑí
သုည	θòʊɴɲa̰
ဒွိ	dwḭ
မုန်လာဥ	mòʊɴlàʔṵ
အနားယူ	ʔənájù
ခဲဖျက်	kʰɛ́bjɛʔ
ပုခက်	pəkʰɛʔ
ဒုတိယဗိုလ်	dṵtḭja̰bò
နဒီ	nədì
တံ့တံ့	ta̰ɴda̰ɴ
မုံရွာ	mòʊɴjwà
အောက်လွှတ်တော်	ʔaʊʔl̥ʊʔtɔ̀
ဆားရည်	sʰájè
ခု	kʰṵ
သုသာန်	θoʊʔθàɴ
လှော်ကား	l̥ɔ̀ɡá
သက်တင်	θɛʔtɪ̀ɴ
ပျဉ်းတော်သိမ်	pjɪ́ɴdɔ̀θèɪɴ
ရွာသူ	jwàðù
ချေ	d͡ʑè
အားနည်း	ʔánɛ́
အောက်	ʔaʊʔ
သံပြိုင်	θàɴbjàɪɴ
ငှက်ဖျား	ŋ̊ɛʔpʰjá
စပိန်	səpèɪɴ
သယ်	θɛ̀
အင်ပါယာ	ʔɪ̀ɴpàjà
စက်	sɛʔ
အမေ	ʔəmè
ယနေ့	ja̰nḛ
ကွမ်းမွှေး	kʊ́ɴm̥wé
မောင်းမမိဿံ	máʊɴma̰meɪʔθàɴ
ကိုယ်လုပ်တော်	kòloʊʔtɔ̀
ကျည်ကပ်	t͡ɕìɡaʔ
အိမ်တက်မင်္ဂလာ	ʔèɪɴtɛʔmɪ̀ɴɡəlà
ထမနဲ	tʰa̰ma̰nɛ́
လေးလ	léla̰
ရိတ်သိမ်း	jeɪʔθéɪɴ
ပြန်ကြားရေး	pjàɴt͡ɕájé
ထောင်သား	tʰàʊɴðá
အရုပ်စာ	ʔəjoʊʔsà
လူကြီး	lùd͡ʑí
ကား	ká
ကစားစရာ	ɡəzázəjà
ဝသုန္ဓရေ	wəθòʊɴdəɹè
ဇာတ်ရုံ	zaʔjòʊɴ
အဂ္ဂမဟေသီ	ʔɛʔɡa̰məhèθì
ဗြာဟ္မဏ	bjàhma̰na̰
ချေ	t͡ɕʰì
ဇာနည်	zànì
တရုတ်နှင်းသီး	ta̰joʊʔn̥ɪ́ɴθí
မဟာသိပ္ပံဘွဲ့	məhàθeɪʔpàɴbwɛ̰
တံခွန်	dəɡʊ̀ɴ
ဝေးကွာ	wékwà
တညင်းသီး	dəɲɪ́ɴðí
ထောက်ကြံ့	tʰaʊʔt͡ɕa̰ɴ
ငါးပိ	ŋəpḭ
ကာလသားရောဂါ	kàla̰θájɔ́ɡà
အဆိုတော်	ʔəsʰòdɔ̀
ကူဝိတ်	kùweɪʔ
ဒုံးပျံ	dóʊɴbjàɴ
မှန်ဘီလူး	m̥àɴbəlú
အာရပ်	ʔàɹaʔ
ခေါင်း	ɡáʊɴ
အဖေ့	ʔəpʰḛ
နံပြား	nàɴbjá
ပျပျ	pja̰bja̰
သူနာ	θùnà
ကိရိယာ	kəɹḭjà
ဂျော်ဂျီယာ	d͡ʑɔ̀d͡ʑìjà
ခင်ဗျားတို့	kʰɪ̀ɴbjádo̰
မဏိပူရ	mənḭpùja̰
ဗော့ဒ်ကာ	bɔ̰dkà
ကရစ်ကက်	kəɹɪʔkɛʔ
ဝန်ထောက်	wʊ̀ɴdaʊʔ
ဒုံး	dóʊɴ
ဂေါတမဘုရား	ɡɔ́təma̰pʰəjá
ဖွင့်	pʰwɪ̰ɴ
ပန်းရွဲ	páɴjwɛ́
လက်ဖက်ရည်	ləpʰɛʔjè
အငြိမ့်	ʔəɲḛɪɴ
ဧကရီ	ʔèkəjì
နိုး	nó
သလုံး	θəlóʊɴ
ဝဇီရာ	wəzìjà
သူစိမ်း	ðəzéɪɴ
ကားဂိတ်	káɡeɪʔ
အလျင်	ʔəljɪ̀ɴ
မီးလင်းဖို	mílɪ́ɴbò
တောင်ပံ	tàʊɴbàɴ
သွတ်သွတ်	θʊʔθʊʔ
ပင်စိမ်း	pɪ̀ɴzéɪɴ
ဟီ	hì
ဆိတ်ထီး	sʰeɪʔtʰí
ဂိုဏ်းအုပ်	ɡónʔoʊʔ
အတွင်း	ʔətwɪ́ɴ
တရုတ်နံနံ	ta̰joʊʔnàɴnàɴ
နှုတ်ဆက်	n̥oʊʔsʰɛʔ
လဲ့လဲ့	lɛ̰lɛ̰
နိကာယ	nḭkàja̰
အမိ	ʔəmḭ
ဟားခါး	hákʰá
ကြံ့	t͡ɕa̰ɴ
အိမ်ထောင်	ʔèɪɴdàʊɴ
သူပြောငါပြော	θùpjɔ́ŋàpjɔ́
ဝံပုလွေ	wʊ̀ɴbəlwè
ရတနာသုံးပါး	jɛ̀dənàθóʊɴbá
ထောက်	tʰaʊʔ
မဟာကဿပ	məhàkaʔθəpa̰
အထိမ်းအမှတ်	ʔətʰéɪɴʔəm̥aʔ
ပါရရာ	pàɹəjà
ဥဇဘက်ကစ္စတန်	ʔṵzəbɛʔkɪʔsətàɴ
နာမ်	nàɴ
ကစားသမား	ɡəsáðəmá
စပျစ်	zəbjɪʔ
ရဿ	ɹaʔθa̰
ကျင်ချောင်း	t͡ɕɪ̀ɴt͡ɕʰáʊɴ
ရပ်ကွက်	jaʔkwɛʔ
ဥမင်	ʔṵmɪ̀ɴ
လေဆိပ်	lèzeɪʔ
ကာယကံ	kàjəɡàɴ
ဒု	dṵ
ဍရင်ကောက်	da̰jɪ̀ɴɡaʊʔ
အကိတ်	ʔəkeɪʔ
ကျောက်ဖြူ	t͡ɕaʊʔpʰjù
အဖို့	ʔəpʰo̰
ဘယ်လို	bɛ̀lò
လေယာဉ်	lèjɪ̀ɴ
အစီရင်ခံ	ʔəsìjɪ̀ɴkʰàɴ
ငါးဖယ်	ŋəpʰɛ̀
စုန်း	sóʊɴ
ရေညှိ	jèɲ̊ḭ
မျက်ခုံး	mjɛʔkʰóʊɴ
ကရိန်း	kəɹéɪɴ
ရိုဟင်ဂျာ	ɹòhɪ̀ɴd͡ʑà
လေ့ကျင့်	lḛt͡ɕɪ̰ɴ
ချဉ်ပေါင်	t͡ɕʰɪ̀ɴbàʊɴ
လပြည့်	la̰pjḛ
ထုတ်ဝေသူ	tʰoʊʔwèðù
အမယ်	ʔəmɛ̀
တပို့တွဲ	dəbo̰dwɛ́
ရွှေတိုက်	ʃwèdaɪʔ
ကော်ပြန့်	kɔ̀pja̰ɴ
လေချဉ်တက်	lèd͡ʑɪ̀ɴtɛʔ
တယ်လီဗီးရှင်း	tɛ̀lìbíʃɪ́ɴ
ရရစ်	ja̰jɪʔ
ဆေးပြင်းလိပ်	sʰébjɪ́ɴleɪʔ
ငွေ	ŋwè
အမွှေး	ʔəm̥wé
တိုဂို	tòɡò
အထိ	ʔətʰḭ
ဘော	bɔ́
သူကောင်းသား	θùɡáʊɴðá
စေတနာ	sèdənà
ဒီဟာ	dìhà
ကတ်ကြေးကိုက်	kaʔt͡ɕíkaɪʔ
ဒူးရင်းယို	dújɪ́ɴjò
ဗိုက်ဆာတယ်	baɪʔsʰàtɛ̀
ပြည်သူ့ဆိုင်	pjìðṵsʰàɪɴ
ပုလင်း	pəlɪ́ɴ
အရုပ်	ʔəjoʊʔ
မြို့	mjo̰
ဖဲ	pʰɛ́
နို့ဆီ	no̰zì
မန်း	máɴ
ဦးချ	ʔút͡ɕʰa̰
အလျား	ʔəljá
ကလျာဏမိတ္တ	kələjàna̰meɪʔta̰
ကုသိုလ်	kṵθò
ကတ္တား	kaʔtá
ယူနိုက်တက်ကင်းဒမ်း	jùnaɪʔtɛʔkɪ́ɴdáɴ
ရန်ဖြစ်	jàɴpʰjɪʔ
ပဉ္စင်တူရိယာ	pjɪʔsɪ̀ɴtùɹḭjà
နာနာ	nànà
ဗိုင်း	báɪɴ
သံလမ်း	θàɴláɴ
မုသား	mṵðá
မတ်စေ့	maʔsḭ
ဇမ်ဘီယာ	zàɴbìjà
ထက်	tʰɛʔ
ကယ်တင်ရှင်	kɛ̀tɪ̀ɴʃɪ̀ɴ
သဏ္ဍာန်	θədàɴ
သုဇာတဘုရား	θṵzàta̰pʰəjá
ကြက်	t͡ɕɛʔ
ပစ္စုပ္ပန်	pjɪʔsoʊʔpàɴ
အမိုး	ʔəmó
အဂတိ	ʔa̰ɡədḭ
သဲ့သဲ့	θɛ̰ðɛ̰
လူဝင်မှုကြီးကြပ်ရေး	lùwɪ̀ɴm̥ṵt͡ɕít͡ɕaʔjé
ရွှေ့	ʃwḛ
ကိုဆိုဗို	kòsʰòbò
လူမျိုးစုလွှတ်တော်	lùmjózṵl̥ʊʔtɔ̀
ဆံပင်	zəbɪ̀ɴ
ပိုးလောင်း	póláʊɴ
အန္တာတိက	ʔàɴtàtḭka̰
သိမ်	θèɪɴ
ကြွယ်	t͡ɕwɛ̀
အကွာအဝေး	ʔəkwàʔəwé
မြင်းမိုရ်တောင်	mjɪ́ɴmòtàʊɴ
တာဂျစ်ကစ္စတန်	tàd͡ʑɪʔkɪʔsətàɴ
ကျောင်းသုံးစာအုပ်	t͡ɕáʊɴðóʊɴsàʔoʊʔ
ကလျာ	kələjà
ကျားမ	t͡ɕáma̰
လိင်ဆက်ဆံ	lèɪɴsʰɛʔsʰàɴ
ပဋိဇီဝဆေး	pa̰dḭzìwa̰sʰé
ဟောင်း	háʊɴ
ခေါင်း	kʰáʊɴ
အသုံး	ʔəθóʊɴ
သစ်ဖြူ	θɪʔpʰjù
တစ်လ	təla̰
နွေဦးရာသီ	nwèʔújàðì
ယမမင်း	jəma̰mɪ́ɴ
အပြုံး	ʔəpjóʊɴ
ပိုက်ဆံအိတ်	paɪʔsʰàɴʔeɪʔ
သိဝ	θḭwa̰
အားနာ	ʔánà
ခဲ့	kʰɛ̰
မူလတန်း	mùla̰táɴ
ယောက္ခထီး	jaʊʔkʰətʰí
ဆိုထုံး	sʰòdóʊɴ
ဟင့်အင်း	hɪ̰ɴʔɪ́ɴ
ဒါပါပဲ	dàbàbɛ́
မြည်း	mjí
ရဲတိုက်	jɛ́daɪʔ
တစပြင်	dəza̰bjɪ̀ɴ
အို	ʔò
ဇင်ဘာဘွေ	zɪ̀ɴbàbwè
ဘောပင်	bɔ́pɪ̀ɴ
နှမ်းဆီ	n̥áɴzì
ဆလဗ	sʰəla̰ba̰
ဝိဘတ်	wḭbaʔ
အဏုဇီဝဗေဒ	ʔənṵzìwa̰bèda̰
မျိုး	mjó
အပြော	ʔəpjɔ́
သင်တုန်းဓား	θɪ̀ɴdóʊɴdá
သလိပ်	θəleɪʔ
ရင်ခံ	jɪ̀ɴkʰàɴ
သူကျက်	θùd͡ʑɛʔ
လျှာနာခွာနာ	ʃànàkʰwànà
တာ့ခ်မင်နစ္စတန်	ta̰kʰmɪ̀ɴnɪʔsətàɴ
တုံး	tóʊɴ
ဗီဇာ	bìzà
ပဲဆီ	pɛ́zì
အခွင့်အရေး	ʔəkʰwɪ̰ɴʔəjé
ဆွဆွ	sʰwa̰zwa̰
လက်သမား	lɛʔθa̰má
ပညာဗလ	pjɪ̀ɴɲàbəla̰
ပြီးပြီ	píbì
နုပ်	noʊʔ
သူရဲ	θəjɛ́
ပြု	pjṵ
ပဒုမဘုရား	pədṵma̰pʰəjá
အာမခံသေတ္တာ	ʔàma̰ɡàɴθɪʔtà
ရှင်းရှင်း	ʃɪ́ɴʃɪ́ɴ
ကြိုးစင်	t͡ɕózɪ̀ɴ
ကိုယ်ဝန်ရှိ	kòjwʊ̀ɴʃḭ
စုံထောက်	sòʊɴdaʊʔ
နော်ဝေ	nɔ̀wè
အစ်	ʔɪʔ
ကပ္ပလီပင်လယ်	kaʔpəlìpɪ̀ɴlɛ̀
ကောလာဟလ	kɔ́làha̰la̰
အလူမီနီယမ်	ʔəlùmìnìjàɴ
အလှူရှင်	ʔəl̥ùʃɪ̀ɴ
ဥဂ္ဂါ	ʔṵɡɡà
ရတု	ja̰tṵ
သေ	θè
ပကတိ	bəɡədḭ
နယ်သာလန်	nɛ̀ðəlàɴ
အဝတ်	ʔəwʊʔ
မွေးနေ့မင်္ဂလာပါ	mwénḛmɪ̀ɴɡəlàbà
ရှာ	ʃà
ရှောက်နု	ʃaʊʔnṵ
သလား	θa̰lá
ကွာလာလမ်ပူ	kwàlàlàɴpù
ခဲတံ	kʰɛ́dàɴ
လက်ဝါး	lɛʔwá
ဘူတာရုံ	bùdàjòʊɴ
ခလာသီ	kʰəlàθì
ကက်စီနို	kɛʔsìnò
ကိုလံဘီယာ	kòlàɴbìjà
ငါးပုဏ္ဏား	ŋəpòʊɴná
သန်းခေါင်	ðəɡàʊɴ
ဗာလ	bàla̰
ခေါင်းအုံး	ɡáʊɴʔóʊɴ
သူ့	θṵ
အစ္စလမ်	ʔɪʔsəlàɴ
ဗုန်း	bóʊɴ
သတ်	θaʔ
အယ်လ်ဂျီးရီးယား	ʔɛ̀ld͡ʑíɹíjá
ဟော်	hɔ̀
ရိုင်ရိုင်	jàɪɴjàɪɴ
သတ္တိ	θaʔtḭ
ဂန္ထဝင်	ɡàɴdəwɪ̀ɴ
ကြမ္မာ	t͡ɕəmà
ဘု	bṵ
နံပါတ်	nàɴbaʔ
စကြဝဠာ	sɛʔt͡ɕàwəlà
ယုံကြည်	jòʊɴt͡ɕì
သမုဒ္ဒရာ	θəmoʊʔdəjà
အာဟာရ	ʔàhàja̰
ပဲပင်ပေါက်	pɛ́bɪ̀ɴbaʊʔ
အငတ်	ʔəŋaʔ
တူး	tú
အဆိပ်	ʔəsʰeɪʔ
ကွန်ပျူတာ	kʊ̀ɴpjùtà
အရက်ဆိုင်	ʔəjɛʔsʰàɪɴ
အာလူးဖုတ်	ʔàlúpʰoʊʔ
တိုက်ခန်း	taɪʔkʰáɴ
ခြေစွပ်	t͡ɕʰèzʊʔ
ကမ္ဗောဇ	kàɴbɔ́za̰
ဂျော်ဒန်	d͡ʑɔ̀dàɴ
စတိုး	sətó
မုန်း	móʊɴ
မိုဇမ်ဘစ်	mòzàɴbɪʔ
ကျောက်	t͡ɕaʊʔ
နဝကမ္မ	nəwa̰kàɴma̰
ဓားပြ	dəmja̰
ငြိမ်းချမ်းရေး	ɲéɪɴd͡ʑáɴjé
နှိပ်ကြယ်သီး	n̥eɪʔt͡ɕɛ̀ðí
အခွင့်	ʔəkʰwɪ̰ɴ
တတိယ	ta̰tḭja̰
ဝေလ	wèla̰
အနုရာဓပူရ	ʔənṵjàda̰pùɹa̰
ဦးထုပ်	ʔoʊʔtʰoʊʔ
အားကိုး	ʔákó
ထင်စား	tʰɪ̀ɴzá
ဒိုင်ခွက်	dàɪɴɡwɛʔ
သူတစ်ပြန်ငါတစ်ပြန်	θùdəbjàɴŋàdəbjàɴ
၎	ləɡáʊɴ
ဝေဒနာ	wèdənà
မြို့နယ်	mjo̰nɛ̀
မြား	m̥já
အနှီး	ʔən̥í
ဂိုဒေါင်	ɡòdàʊɴ
ပိုင်ရှင်	pàɪɴʃɪ̀ɴ
ကောင်ငယ်	kàʊɴŋɛ̀
ဘုမ္မစိုး	bòʊɴməzó
အတင်း	ʔətɪ́ɴ
ဝါဆို	wàsʰò
ဒီဇင်ဘာ	dìzɪ̀ɴbà
တိုင်ဖွန်း	tàɪɴpʰʊ́ɴ
မိုးလေဝသ	mólèwəθa̰
ယူရို	jùɹò
မဂ္ဂဇင်း	mɛʔɡa̰zɪ̀ɴ
သူတော်	θùdɔ̀
ရွေးကောက်ပွဲ	jwékaʊʔpwɛ́
ရာဘာ	jàbà
မေတ္တာ	mjɪʔtà
ပေါ့	pɔ̰
နယ်စပ်	nɛ̀zaʔ
ဖယောင်းတိုင်	pʰəjáʊɴdàɪɴ
ဓာတ်ကြီးလေးပါး	dàtt͡ɕílépá
လင်းနို့	lɪ́ɴno̰
ဓနိတ	dənḭta̰
မော်ဇာ	mɔ̀zà
ကြေးကြီး	t͡ɕét͡ɕí
ခွာနာလျှာနာ	kʰwànàʃànà
ဆံပင်ညှပ်	zəbɪ̀ɴɲ̊aʔ
အမွေခံ	ʔəmwèɡàɴ
ဟဲလို	hɛ́lò
စန္ဒြာ	sàɴdɹà
ထူပါ	tʰùpà
ကီလိုဂရမ်	kìlòɡəɹàɴ
စီလုံ	sìlòʊɴ
ကီးမား	kímá
ဆိုင်	sʰàɪɴ
ဝေါ	wɔ́
ခမာ	kʰəmà
နာမကျန်း	nàmət͡ɕáɴ
ရုပ်ပုံ	joʊʔpòʊɴ
ဆင့်	sʰɪ̰ɴ
ပြာသာဒ်	pjaʔθaʔ
ကြော်	t͡ɕɔ̀
ဆာလဖာ	sʰàləpʰà
ပျားတူ	ba̰dù
နန်းကြီးသုပ်	náɴt͡ɕíθoʊʔ
အတူတူ	ʔətùdù
မြန်	mjàɴ
ကူးတို့ဆိပ်	ɡədo̰zeɪʔ
မီးရထားတွဲ	míjətʰádwɛ́
သူရင်းတိုင်	θəjɪ́ɴdàɪɴ
ပြတိုက်	pja̰daɪʔ
စစ်	sɪʔ
အနောက်	ʔənaʊʔ
ဆို	sʰò
စာချုပ်	sət͡ɕʰoʊʔ
ဇီဝဗေဒ	zìwa̰bèda̰
သွင်သွင်	θwɪ̀ɴðwɪ̀ɴ
ကုန်စည်	kòʊɴzì
ကဆုန်လပြည့်နေ့	kəsʰòʊɴla̰pjḭnḛ
မံ	màɴ
နှင့်	n̥ɪ̰ɴ
သာမိုမီတာ	θàmòmìtà
သနပ်	θənaʔ
ပုဆိန်	pəsʰèɪɴ
သူရဲကြီးအလံ	θùjɛ́d͡ʑíʔəlàɴ
မီးခံသေတ္တာ	míɡàɴθɪʔtà
အတာအိုး	ʔətàʔó
ဖုတ်	pʰoʊʔ
ဒုတိယဗိုလ်ချုပ်မှူးကြီး	dṵtḭja̰bòd͡ʑoʊʔm̥úd͡ʑí
မည်	mjì
ဖုံး	pʰóʊɴ
ကျား	t͡ɕá
တီထွင်မှု	tìtʰwɪ̀ɴm̥ṵ
ငါ	ŋà
ဝရန်တာ	wəɹàɴdà
ကူးပြောင်း	kúpjáʊɴ
ဇာတ်ခုံ	zaʔkʰòʊɴ
လိမ္မော်	lèɪɴmɔ̀
ဆန်ပြုတ်	sʰàɴbjoʊʔ
တောင်သူ	tàʊɴðù
ဂရိတ်ဗြိတိန်	ɡəɹeɪʔbjḭtèɪɴ
မီးပြတိုက်	míbja̰daɪʔ
ရုက္ခစိုး	joʊʔɡəzó
မဟာယာန	məhàjàna̰
ဆိုမြည်	sʰòmjì
ဖတ်တီး	pʰaʔtí
အစု	ʔəsṵ
ဖင်လျက်	pʰɪ̀ɴjɛʔ
ဦးပဉ္စင်း	ʔúbəzɪ́ɴ
ကထိန်	kətʰèɪɴ
မြေကွက်	mjèɡwɛʔ
ကတ်ပြား	kaʔpjá
ခနုံအီ	kʰənòʊɴʔì
ယုန်	jòʊɴ
ခွဆုံ	ɡwa̰zòʊɴ
ဆိုဗီယက်	sʰòbìjɛʔ
သူကောင်း	θùɡáʊɴ
လက်သုပ်စုံ	lɛʔθoʊʔsòʊɴ
တို့	do̰
မုန်ညှင်းဖြူ	mòʊɴɲ̊ɪ́ɴbjù
ဝါခေါင်	wàɡàʊɴ
ဖွဲ့စည်းပုံအခြေခံဥပဒေ	pʰwɛ̰zíbòʊɴʔət͡ɕʰèɡàɴʔṵbədè
ရေခွက်	jèɡwɛʔ
မိုင်း	máɪɴ
လှဲ	l̥ɛ́
ပိဋကတ်	bḭtəɡaʔ
တာယာ	tàjà
စားသောက်ဆိုင်	sáθaʊʔsʰàɪɴ
မျှော်လင့်ချက်	m̥jɔ̀lɪ̰ɴd͡ʑɛʔ
မြီ	mjì
စိတ်	seɪʔ
ဆိတ်ကုလား	sʰeɪʔkəlá
ချယ်ရီ	t͡ɕʰɛ̀ɹì
သုက်ကောင်	θoʊʔkàʊɴ
သူသေ	θùθè
ပြွမ်း	pjʊ́ɴ
ခင်	kʰɪ̀ɴ
သွပ်	θʊʔ
ဂျင်းဘောင်းဘီ	d͡ʑɪ́ɴbáʊɴbì
ချွံချွံ	t͡ɕʰʊ̀ɴd͡ʑʊ̀ɴ
ရမ်းရမ်း	jáɴjáɴ
သနပ်ခါး	θənəkʰá
မစင်	ma̰sɪ̀ɴ
ကော်ပီစာအုပ်	kɔ̀pìsàʔoʊʔ
ဘောပွဲ	bɔ́pwɛ́
ယန္တရား	jàɴdəjá
သူပုန်သူကန်	ðəbəðùɡàɴ
မြင်းကျား	mjɪ́ɴd͡ʑá
အန်နီမဲ	ʔàɴnìmɛ́
ကျောက်မီးသွေး	t͡ɕaʊʔmíðwé
ငှက်	ŋ̊ɛʔ
အမှာ	ʔəm̥à
ပလောင်	pəlàʊɴ
အိမ်	ʔèɪɴ
ကောင်း	káʊɴ
ဆင်း	sʰɪ́ɴ
စိုင်း	sáɪɴ
ချက်ကြိုး	t͡ɕʰɛʔt͡ɕó
မုဆိုး	moʊʔsʰò
ဂြိုဟ်တု	d͡ʑòhdṵ
ကဆုန်	kəsʰòʊɴ
နေရာငါးသွယ်	nèjàŋáθwɛ̀
စက္ကူ	sɛʔkù
ပန်ကာ	pàɴkà
အခြား	ʔət͡ɕʰá
ကျွန်မတို့	t͡ɕʊ̀ɴma̰do̰
ရှစ်လ	ʃɪʔla̰
နန္ဒာ	nàɴdà
အမှတ်တံဆိပ်	ʔəm̥aʔdəzeɪʔ
စားမြုံ့ပြန်	səmjo̰ʊɴpjàɴ
ခေတ္တ	kʰɪʔta̰
မျက်မှန်	mjɛʔm̥àɴ
သတ်ဖြတ်	θaʔpʰjaʔ
စာကိုယ်	sàɡò
လက်ဘနွန်	lɛʔbənʊ̀ɴ
မဟာပညာဗလ	məhàpjɪ̀ɴɲàbəla̰
သင်္ဂဟတရားလေးပါး	θɪ̀ɴɡa̰ha̰ta̰jálépá
ခေါပုတ်	kʰɔ́boʊʔ
နေရာထိုင်ခင်း	nèjàtʰàɪɴɡɪ́ɴ
ရာဘ	jàba̰
ဆိုက်ကား	sʰaɪʔká
ဣန္ဒြေ	ʔèɪɴdɹè
တိုင်ကီ	tàɪɴkì
ခေါက်	kʰaʊʔ
ကျည်ဖူး	t͡ɕìbú
ထံ	tʰàɴ
သင်္ဘောသီးသုပ်	θɪ̀ɴbɔ́θíθoʊʔ
ဇန်နဝါရီ	zàɴnəwàɹì
ဝေဿဘူဘုရား	wètθa̰bùpʰəjá
ဆယ့်နှစ်	sʰɛ̰n̥ɪʔ
ဖြစ်	pʰjɪʔ
စာပေ	sàpè
အက်စစ်	ʔɛʔsɪʔ
ကွတ်	kʊʔ
လည်ချောင်း	lɛ̀d͡ʑáʊɴ
ပထဝီဝင်	pətʰəwìwɪ̀ɴ
အကြောင်း	ʔət͡ɕáʊɴ
ရှင်ပြု	ʃɪ̀ɴpjṵ
ဓမ္မတာ	dəmədà
ကုန်ကား	kòʊɴɡá
အရွယ်ဆယ်ပါး	ʔəjwɛ̀sʰɛ̀bá
ညှာ	ɲ̊à
ပြိတ္တာ	pjeɪʔtà
ကြွေး	t͡ɕwé
ကဒ်	kàd
တူနီးရှား	tùníʃá
တာချီလိတ်	tàt͡ɕʰìleɪʔ
ဆူ	sʰù
ဇစ်	zɪʔ
စားတော်ဆက်	sádɔ̀sʰɛʔ
ကျွန်း	t͡ɕʊ́ɴ
ဝမ်းဘဲ	wʊ́ɴbɛ́
မနက်ဖြန်	mənɛʔpʰjàɴ
သတ္တု	θaʔtṵ
တောခွေး	tɔ́ɡwé
နိုက်ထရိုဂျင်	naɪʔtʰəɹòd͡ʑɪ̀ɴ
မှ	m̥a̰
သို့သော်	ðo̰ðɔ̀
မော်စကို	mɔ̀səkò
လုပ်အား	loʊʔʔá
တဆယ်	təzɛ̀
အရေး	ʔa̰jé
ကုဗ	kṵba̰
ငါးဖန်ခွက်	ŋəpʰàɴɡwɛʔ
ပလ္လင်	pəlɪ̀ɴ
ခြင်း	t͡ɕʰɪ́ɴ
ဝံသ	wʊ̀ɴθa̰
ကတည်းက	ɡədɛ́ɡa̰
လူငယ်	lùŋɛ̀
လေယာဉ်ပျံ	lèjɪ̀ɴbjàɴ
စက်သုံးဆီဆိုင်	sɛʔθóʊɴsʰìsʰàɪɴ
ဒူးရင်းသီး	dújɪ́ɴθí
စတုဂံ	sətṵɡàɴ
အိမ်နီးချင်း	ʔèɪɴníd͡ʑɪ́ɴ
အစဉ်	ʔəsɪ̀ɴ
သတ္တမ	θaʔtəma̰
မြှောက်	m̥jaʊʔ
နှလုံးရောဂါ	n̥əlóʊɴjɔ́ɡà
မာရ်နတ်	mànaʔ
ရိပ်ရိပ်	jeɪʔjeɪʔ
အုတ်	ʔoʊʔ
တီးတိုးပြော	tídópjɔ́
ဟူးရား	hújá
သန္ဓေဗေဒ	θàɴdèbèda̰
လေ့ကျင့်ခန်း	lḛt͡ɕɪ̰ɴɡáɴ
ယူနီယန်	jùnìjàɴ
ပန်းတမော့	páɴdəmɔ̰
ရေဒီယို	ɹèdìjò
ဥဏှိဿ	ʔṵn̥eɪʔθa̰
နားကပ်	náɡaʔ
ပတ်ဝန်းကျင်	paʔwʊ́ɴt͡ɕɪ̀ɴ
ကိုယ်ဝန်	kòjwʊ̀ɴ
အမျိုးသားစိတ်	ʔəmjóðáseɪʔ
ချင်းသုပ်	d͡ʑɪ́ɴðoʊʔ
နွယ်တာ	nwɛ̀tà
နတ်ကွန်း	naʔkʊ́ɴ
တော်လှန်ရေး	tɔ̀l̥àɴjé
မွန်	mʊ̀ɴ
အခြေ	ʔət͡ɕʰè
ရာစုနှစ်	jàzṵn̥ɪʔ
သောကြာ	θaʊʔt͡ɕà
ပါဆယ်	pàsʰɛ̀
လမ်းကြား	láɴd͡ʑá
အဆင့်	ʔəsʰɪ̰ɴ
သူယုတ်မာ	θùjoʊʔmà
သံတွဲ	θàɴdwɛ́
နိစ္စ	nèsa̰
ကိုရီးယား	kòɹíjá
ရတနာပုံ	jɛ̀dənàbòʊɴ
ဒုတိယ	dṵtḭja̰
အာမေးနီးယား	ʔàméníjá
ခမည်းတော်	kʰəmídɔ̀
ပွိုင့်	pwa̰ɪɴ
ကတော်	ɡədɔ̀
ဟော်ကီ	hɔ̀kì
ထိကပေါက်	tʰḭɡəbaʊʔ
အင်းဝ	ʔɪ́ɴwa̰
ဥပမာ	ʔṵbəmà
အနွယ်	ʔənwɛ̀
အသင်	ʔəθɪ̀ɴ
တမန်တော်	təmàɴdɔ̀
ပင့်	pɪ̰ɴ
ဒူးခေါင်း	dúɡáʊɴ
အဘိဓာန်	ʔəbḭdàɴ
လင်းယုန်	lɪ́ɴjòʊɴ
နိဿယ	neɪʔθəja̰
ရင်ပြင်	jɪ̀ɴbjɪ̀ɴ
စကားဝှက်	zəɡəʍɛʔ
မဲ	mɛ́
တူးမြောင်း	túmjáʊɴ
မိငယ်	mḭŋɛ̀
အပေါ့	ʔəpɔ̰
ကျေးဇူး	t͡ɕézú
ဝက်	wɛʔ
ဆရာသမား	sʰa̰jàθəmá
ဂန်ဒူး	ɡàɴdú
ခြတောင်ပို့	t͡ɕʰa̰tàʊɴbo̰
ရွှေဖရုံသီး	ʃwèpʰəjòʊɴðí
ကြွက်သား	t͡ɕwɛʔθá
ထမင်း	tʰəmɪ́ɴ
နာမဝိသေသန	nàma̰wḭθèθəna̰
ရင်	jɪ̀ɴ
တယ်လီဖုန်း	tɛ̀lìpʰóʊɴ
ပြာခွက်	pjàɡwɛʔ
လိုင်း	láɪɴ
ကဝိ	kəwḭ
လမုန့်	la̰mo̰ʊɴ
မျှော်လင့်	m̥jɔ̀lɪ̰ɴ
မြွေဟောက်	mjwèhaʊʔ
မိတ္ထီလာ	meɪʔtʰìlà
ကျင်စွယ်	t͡ɕɪ̀ɴzwɛ̀
မြေဖြူခဲ	mjèbjùɡɛ́
အာဖဂန်နစ်စတန်	ʔàpʰəɡàɴnɪʔsətàɴ
ခရာမွှေး	kʰəjàm̥wé
ရိုး	jó
ရုပ်သေး	joʊʔθé
မျက်နှာဖုံး	mjɛʔn̥əpʰóʊɴ
နိဂ္ဂဟိတ	neɪʔɡəhḭta̰
ရေတွင်း	jèdwɪ́ɴ
ပဉ္စလက်	pɪ̀ɴsəlɛʔ
ပုဒ်ထီး	poʊʔkəlé
အဆုတ်ရောင်ရောဂါ	ʔa̰sʰoʊʔjàʊɴjɔ́ɡà
ဗုဒ္ဓဘာသာ	boʊʔda̰bàθà
ဗောဓိညောင်	bɔ́dḭɲàʊɴ
သူဟောင်းစကား	θùháʊɴzəɡá
ကာ	kà
မသိဘူး	ma̰θḭbú
သံမဏိ	θàɴmənḭ
ရွှေနန်းရှင်ဘုရား	ʃwènáɴʃɪ̀ɴpʰəjá
နဝရူပ	na̰wa̰jùpa̰
လက်မှတ်	lɛʔm̥aʔ
မနုဿ	ma̰noʊʔθà
လုံး	lóʊɴ
သူငယ်	θəŋɛ̀
တောင်သူလယ်သမား	tàʊɴðùlɛ̀ðəmá
ဖုန်စုပ်စက်	pʰòʊɴsoʊʔsɛʔ
ပဲငံပြာရည်	pɛ́ŋàɴbjàjè
ကကုသန်	ka̰kṵθàɴ
တူမ	tùma̰
လက်ထပ်	lɛʔtʰaʔ
ချောကလက်	t͡ɕʰɔ́kəlɛʔ
လက်ဆောင်	lɛʔsʰàʊɴ
ရေမွှေး	jèm̥wé
နကျယ်ကောင်	nəd͡ʑɛ̀ɡàʊɴ
သပြေ	ðəbjè
ဆာ	sʰà
ကြိုးကြာ	d͡ʑód͡ʑà
ခလုတ်	kʰəloʊʔ
ရဲ့	jɛ̰
ဇာတိပ္ဖိုလ်	zàdeɪʔpʰò
သွေး	θwé
ဘတ်ဂျက်	baʔd͡ʑɛʔ
ပါတိတ်	pàteɪʔ
အက်တမ်	ʔɛʔtàɴ
နှမ်း	n̥áɴ
ကားမှတ်တိုင်	kám̥aʔtàɪɴ
နယ်	nɛ̀
ဝက်ကြွပ်	wɛʔt͡ɕʊʔ
မ	ma̰
လုပ်ငန်း	loʊʔŋáɴ
ထဆင်ထူး	tʰa̰sʰɪ̀ɴdú
တွေ့	twḛ
အစည်းအရုံး	ʔəsíʔəjóʊɴ
ဝေသာလီ	wèθàlì
ဆီးပူညောင်းကျ	sʰípùɲáʊɴt͡ɕa̰
လောကနတ်	lɔ́ka̰naʔ
ကောလိသိန်	kɔ́lḭθèɪɴ
မိဖုရား	mḭbəjá
မြင်းသံခွာ	mjɪ́ɴθàɴkʰwà
မီးရှူးမီးပန်း	míʃúmíbáɴ
ကိုယ့်ဥမှဥထင်	ko̰jʔṵm̥a̰ʔṵtʰɪ̀ɴ
မှတ်စုစာအုပ်	m̥aʔsṵsàʔoʊʔ
ငါးရံ့	ŋəja̰ɴ
ဓမ္မဒဿီ	dəma̰ma̰daʔθì
မနုဿီဟ	mənoʊʔθìha̰
မြင်းမကလေး	mjɪ́ɴma̰ɡəlé
သျှောင်	jàʊɴ
ဂဏန်းတွက်စက်	ɡənáɴtwɛʔsɛʔ
မကုဋ	məkṵta̰
မဏ္ဍပ်	máɴdaʔ
သိုးဆောင်း	θósʰáʊɴ
ဆရာမ	sʰəjàma̰
နက်	nɛʔ
အစောင့်	ʔəsa̰ʊɴ
ကို	ɴ
ပုစွန်	bəzʊ̀ɴ
ပန်း	páɴ
ပဇာ	bəzà
အပေါင်	ʔəpàʊɴ
သံကြိုး	θàɴd͡ʑó
လက်သုတ်ပဝါ	lɛʔθoʊʔpa̰wà
လည်	lɛ̀
သားအိမ်ခေါင်း	θəʔèɪɴɡáʊɴ
ချွန်	t͡ɕʰʊ̀ɴ
လင်းတ	lɪ́ɴda̰
ရှို့	ʃo̰
ရေငတ်တယ်	jèŋaʔtɛ̀
မဟာ	ma̰hà
ဆိတ်	sʰeɪʔ
ဓာတ်ငွေ့	daʔŋwḛ
ထယ်	tʰɛ̀
ပြန်ကြား	pjàɴt͡ɕá
မီး	mí
ရန်	jàɴ
အနား	ʔəná
ဟို	hò
အထက်သား	ʔətʰɛʔðá
ကိန္နရာ	kèɪɴnəjà
အစ္စရေး	ʔɪʔzəɹé
ကပ်	kaʔ
အုန်းနို့	ʔóʊɴno̰
ဖိလစ်ပိုင်	pʰḭlɪʔpàɪɴ
ပြောင်းလဲ	pjáʊɴlɛ́
နားထောင်	nátʰàʊɴ
ခင်ဗျာ့	kʰɪ̀ɴbja̰
အနှစ်	ʔən̥ɪʔ
ကျုပ်	t͡ɕoʊʔ
သူခိုး	θəkʰó
ကုသိုလ်ရှင်	kṵθòʃɪ̀ɴ
သျှင်	ʃɪ̀ɴ
သို့ရာတွင်	ðo̰jàdwɪ̀ɴ
ဂီတသမား	ɡìta̰ðəmá
စွပ်	sʊʔ
နာမကရဏ	nàma̰kəɹəna̰
တစ်ချောင်းပုဒ်	tət͡ɕʰáʊɴpoʊʔ
သုမန	θṵməna̰
မနှစ်	mən̥ɪʔ
လူသတ်မှု	lùðaʔm̥ṵ
အုံး	ʔóʊɴ
ယမက	jəməka̰
ကြိုက်	t͡ɕaɪʔ
တေသံ	tèðàɴ
စားပွဲထိုး	zábwɛ́dó
အီရတ်	ʔìɹaʔ
သိုးမ	θóma̰
မဉ္ဇူ	mjɪ̀ɴzù
မြစ်	mjɪʔ
ကေတုမဒီ	kètṵmədì
ဆီးချို	sʰíd͡ʑò
တော်	tɔ̀
ဖြေဖျောက်	pʰjèbjaʊʔ
ဇီဇဝါ	zìzəwà
ဆီထမင်း	sʰìtʰəmɪ́ɴ
နွားထီး	nətʰí
ထောပတ်	tʰɔ́baʔ
ဓာတ်အိုး	daʔʔó
ကဿပဘုရား	kaʔθəpa̰pʰəjá
ကျိုက်ထို	t͡ɕaɪʔtʰò
ကာတာ	kàtà
စတုဒိသာ	sətṵdḭθà
ပရိုဂရမ်	pəɹòɡəɹàɴ
ဆောင်	sʰàʊɴ
ကြက်သွန်	t͡ɕɛʔθʊ̀ɴ
လှုပ်ရှား	l̥oʊʔʃá
မှုတ်	m̥oʊʔ
အမျိုးသမီးလစဉ်သုံးပစ္စည်း	ʔa̰mjóðəmíla̰zɪ̀ɴθóʊɴpjɪʔsí
ဂန္ထဗေဒ	ɡàɴtʰa̰bèda̰
ထမင်းကြော်	tʰəmɪ́ɴd͡ʑɔ̀
ရေလက်ဝါး	jèlɛʔwá
ဆူး	sʰú
ဆာဂျင်	sʰàd͡ʑɪ̀ɴ
ဖြီး	pʰí
တဏှင်္ကရာ	tən̥ɪ̀ɴkəɹà
သန္တာ	θàɴdà
ကံ့ကော်	ɡa̰ɴɡɔ̀
ဒူးထောက်	dútʰaʊʔ
ပါလီမန်	pàlìmàɴ
ညနေ	ɲa̰nè
ပန်းမုန်လာဖြူ	páɴmòʊɴlàbjù
ချာတိတ်	t͡ɕʰàteɪʔ
အမြှောက်လက္ခဏာ	ʔəm̥jaʊʔlɛʔkʰənà
အယ်လ်ဘေးနီးယား	ʔɛ̀lbéníjá
သံလိုက်စက်ကွင်း	θàɴlaɪʔsɛʔkwɪ́ɴ
သိုးထိန်း	θódéɪɴ
သကုဏဗေဒ	θa̰kṵna̰bèda̰
ယှဉ်း	ʃɪ́ɴ
မင့်စ်	mɪ̰ɴs
မှုန့်	m̥o̰ʊɴ
အမျိုးသမီး	ʔəmjóðəmí
ဆိုကရေးတီး	sʰòka̰jétí
မီးတောင်	mídàʊɴ
အချို	ʔət͡ɕʰò
နိုင်ငံတော်	nàɪɴŋàɴdɔ̀
ဆီပြန်	sʰìbjàɴ
ပိုးကြာချည်	pót͡ɕàt͡ɕʰì
မျက်ရည်	mjɛʔjè
ဝိပဿီ	wḭpətθì
အရှင်ဘုရား	ʔəʃɪ̀ɴpʰəjá
ဘုရားကိုးဆူ	pʰəjákósʰù
မယ်သီတာ	mɛ̀θìdà
ပညာရေး	pjɪ̀ɴɲàjé
ပူ	pù
ထီး	tʰí
ကျောက်စိမ်း	t͡ɕaʊʔséɪɴ
လှည်း	l̥ɛ́
ဆားဘဲဥ	sʰábɛ́ʔṵ
စက်ရုပ်	sɛʔjoʊʔ
လယ်သမား	lɛ̀ðəmá
အရင်း	ʔəjɪ́ɴ
ညကြီး	ɲa̰t͡ɕí
ကနုကမာ	kənṵkəmà
သုက်ပိုး	θoʊʔpó
လူ့ဘောင်	lṵbàʊɴ
သိဒ္ဓတ္ထဘုရား	θìddaʔtʰa̰pʰəjá
ဒီဇိုင်း	dìzáɪɴ
ခဲအို	kʰɛ́ʔò
၌	n̥aɪʔ
ကျပ်	t͡ɕaʔ
လက်ပံ	lɛʔpàɴ
သင်္ကြန်	θɪ́ɴd͡ʑàɴ
မုန့်လက်ကောက်	mo̰ʊɴlɛʔkaʊʔ
နို့	no̰
အလေး	ʔəlé
ဆယ့်နှစ်ရာသီ	sʰɛ̰n̥əjàθì
ဒဏ်ရာ	dàɴjà
ဝေဟင်	wèhɪ̀ɴ
ထုံးစံ	tʰóʊɴzàɴ
မာ	mà
မော်လ်ဒိုဗာ	mɔ̀ldòbà
နန်းမြင့်	náɴmjɪ̰ɴ
ဆက်ဆံ	sʰɛʔsʰàɴ
မာလာဟင်း	màlàhɪ́ɴ
အစီအစဉ်	ʔəsìʔəsɪ̀ɴ
သင်ကြား	θɪ̀ɴt͡ɕá
အမိန့်	ʔəmḛɪɴ
ဝမ်းဆွဲ	wʊ́ɴzwɛ́
ပယ်ရှား	pɛ̀ʃá
တက္ကစီ	tɛʔkəsì
မြိတ်	beɪʔ
ကျောက်ဂွမ်း	t͡ɕaʊʔɡʊ́ɴ
နက္ခတ္တဗေဒ	nɛʔkʰəta̰bèda̰
ပျော့	pjɔ̰
ဘိုင်	bàɪɴ
ဒဏ္ဍာရီ	dàndàjì
ဘယ်လ်ဂျီယမ်	bɛ̀ld͡ʑìjàɴ
ဥပဓိရုပ်	ʔṵpa̰dḭjoʊʔ
နှေး	n̥é
လာအို	làʔò
အီကြာကွေး	ʔìt͡ɕàkwé
ဘဟားမား	ba̰hámá
ပုရပိုက်	pəɹəbaɪʔ
လခြမ်း	la̰d͡ʑáɴ
လေးညှင်း	léɲ̊ɪ́ɴ
ထောင့်	da̰ʊɴ
တရုတ်စံကား	ta̰joʊʔsàɴká
ကျည်	t͡ɕì
မည်း	mɛ́
စွမ်းအင်	swáɴʔɪ̀ɴ
အမျိုးသားနေ့	ʔəmjóðánḛ
အတန်း	ʔətáɴ
မလေး	məlé
ဝီရိယ	wəɹḭja̰
သားလောင်း	θáláʊɴ
သက်သာ	θɛʔθà
အလွန်	ʔəlʊ̀ɴ
ရေတံခွန်	jèdàɡʊ̀ɴ
ယောက်ျားလျာ	jaʊʔkəʃà
အမွေး	ʔəmwé
မနောကံ	mənɔ́ɡàɴ
တိန်းညက်	téɪɴɲɛʔ
လေ့လာ	lḛlà
ကေသာ	kèθà
ကျွန်တော်	t͡ɕʊ̀ɴdɔ̀
နွေဦးပေါက်	nwèʔúbaʊʔ
မြီးရှေ	mjíʃè
ပရိဒေဝ	pəɹḭdèwa̰
မိတ်ဆွေ	meɪʔsʰwè
နောက်ပြီး	naʊʔpí
နတ်ပြည်ခြောက်ထပ်	naʔpjìt͡ɕʰaʊʔtʰaʔ
လူပျိုနာ	lùbjònà
ဝက်မ	wɛʔma̰
ငါး	ŋá
ဂေါ်ဖီပန်း	ɡɔ̀bìpáɴ
လက်ဖက်ထုပ်	ləpʰɛʔtʰoʊʔ
ပါမောက္ခ	pàmaʊʔkʰa̰
ဘိက္ခု	beɪʔkʰṵ
ရိုးရိုး	jójó
ဒေဝါလီခံ	dèwàlìkʰàɴ
လဆွဲ	la̰sʰwɛ́
ဘဒ္ဒန္တ	baʔdàɴta̰
အီရီထရီးယား	ʔìɹìtʰəɹíjá
စိတ္တဇရောဂါ	seɪʔdəza̰jɔ́ɡà
သန္ဓေသား	ðədèðá
အထဲ	ʔətʰɛ́
ဆယ့်တစ်လ	sʰɛ̰tɪʔla̰
သုဓာ	θoʊʔdà
ပနားမား	pa̰námá
အဆောက်အအုံ	ʔəsʰaʊʔʔəʔú
ရဟန်း	jəháɴ
ဝက်အူ	wɛʔʔù
ဂွေး	ɡwé
ယမုန်နာ	jəmòʊɴnà
သီးသီး	θíðí
ယောဂ	jɔ́ɡa̰
ပြန်	pjàɴ
အာကာသ	ʔàkàθa̰
ရေးချ	jét͡ɕʰa̰
ဒိုင်ယာနာ	dàɪɴjànà
ညနေခင်း	ɲa̰nèɡɪ́ɴ
ကြံ့လျော်	t͡ɕa̰ɴʃɔ̀
ရန်ပြု	jàɴpjṵ
ဆပ္ပတ်	sʰaʔpaʔ
ဆိုရိုးစကား	sʰòjózəɡá
ကောင်းကင်	káʊɴɡɪ̀ɴ
သီတာ	θìdà
တတ်	daʔ
သွင်း	θwɪ́ɴ
ကြေးဝါ	t͡ɕéwà
ပဋိပက္ခ	pətḭpɛʔkʰa̰
တိုးတက်ရေး	tótɛʔjé
ဌာန	tʰàna̰
အကြံ	ʔət͡ɕàɴ
တင်ပါ့ဘုရား	tɪ̀ɴba̰pʰəjá
မုန့်လင်မယား	mo̰ʊɴlɪ̀ɴməjá
ခြင်္သေ့	t͡ɕʰɪ̀ɴðḛ
အော့အန်	ʔɔ̰ʔàɴ
ကြခတ်ဝါး	t͡ɕəkʰaʔwá
ဘိုက်	baɪʔ
ကိမိလဗေဒ	kḭmḭla̰bèda̰
စာရင်းအင်း	sàjɪ́ɴʔɪ́ɴ
စိုက်	saɪʔ
နတ်ရွာစံ	naʔjwàsàɴ
ဆေးဆိုင်	sʰézàɪɴ
နေကောင်း	nèkáʊɴ
ပွဲ	pwɛ́
ဝိသေသ	wḭθèθa̰
အီကွေတာ	ʔìkwètà
ပိုက်	paɪʔ
ကုန်တင်ကား	kòʊɴdɪ̀ɴɡá
ရာဇာ	jàzà
ကွန်	kʊ̀ɴ
အစေ့	ʔəsḭ
ခဲ့	ɡɛ̰
မယ်သီလ	mɛ̀ðìla̰
ဂျာမန်	d͡ʑàmàɴ
ဂင်္ဂါ	ɡɪ̀ɴɡà
လူဇင်ဘတ်	lùzɪ̀ɴbaʔ
မိုက်ကယ်	maɪʔkɛ̀
အပင်	ʔəpɪ̀ɴ
ဋသန်လျင်းချိတ်	ta̰θəjɪ́ɴd͡ʑeɪʔ
ဗီရို	bìjò
ပစ္ဆိမ	pjɪʔsʰeɪʔma̰
ကြက်သွန်နီ	t͡ɕɛʔθʊ̀ɴnì
တံ	tàɴ
အစမ်း	ʔəsáɴ
ဘော့ဆွာနာ	bɔ̰sʰwànà
ရောင်	jàʊɴ
နာရီဝက်	nàjìwɛʔ
စတု	zətṵ
ဘောလုံး	bɔ́lóʊɴ
သွားရည်	θəjì
ဝန်ကြီးဌာန	wʊ̀ɴd͡ʑítʰàna̰
တောင်ဆူဒန်	tàʊɴsʰùdàɴ
ဝေး	wé
လွယ်	lwɛ̀
ခုနစ်	kʰʊ̀ɴn̥ɪʔ
ယမန်နှစ်	jəmàɴn̥ɪʔ
ပန်းတဉ်း	bədɪ́ɴ
ပျဉ်းကတိုး	pjɪ́ɴɡədó
ညလေး	ɲa̰lé
ကကုသန်ဘုရား	ka̰kṵθàɴpʰəjá
ဘုရားလောင်း	pʰəjáláʊɴ
မြေရှင်	mjèʃɪ̀ɴ
ကြက်မောက်	t͡ɕɛʔmaʊʔ
ဥက္ကာ	ʔoʊʔkà
ဘောက်ဆူး	baʊʔsʰú
ဆွဲ	sʰwɛ́
ပညာပေး	pjɪ̀ɴɲàpé
ပုဂ္ဂလိက	poʊʔɡəlḭɡa̰
နိုင်ငံရေး	nàɪɴŋàɴjé
နှစ်ချောင်းပုဒ်	n̥ət͡ɕʰáʊɴpoʊʔ
ပြည်သူ	pjìðù
ရေစစ္စရီ	jèsɪʔsəɹì
လယ်	lɛ̀
ပျံတော်မူ	pjàɴtɔ̀mù
စာရေးဆရာ	sàjésʰəjà
အခွံမာသီး	ʔəkʰʊ̀ɴmàðí
အဂ္ဂမဟာပဏ္ဍိတ	ʔɛʔɡa̰məhàpàɴdḭta̰
အရာခံဗိုလ်	ʔəjàɡàɴbò
နေရာ	nèjà
ဆန်ခါ	zəɡà
ဆွစ်ဇာလန်	sʰwɪʔzəlàɴ
ဘင်္ဂါလီ	bɪ̀ɴɡàlì
သာဂူ	θàɡù
အိုင်ယာလန်	ʔàɪɴjəlàɴ
ပန်းဂေါ်ဖီ	páɴɡɔ̀bì
ပေါ်ဆန်းမွှေး	pɔ̀sʰáɴm̥wé
သူများ	θùmjá
ကွန်ရက်	kʊ̀ɴjɛʔ
လှောက်	l̥aʊʔ
ခေါင်းလောင်း	kʰáʊɴláʊɴ
သောင်း	θáʊɴ
ဦးနှောက်	ʔóʊɴn̥aʊʔ
သားအိမ်လမ်းကြောင်း	θəʔèɪɴláɴd͡ʑáʊɴ
အကောက်ဆိပ်	ʔəkaʊʔsʰeɪʔ
အာဏာ	ʔànà
မီတာ	mìtà
သွေးတိုးရောဂါ	θwétójɔ́ɡà
မြေပုံ	mjèbòʊɴ
ဈမျဉ်းဆွဲ	za̰mjɪ́ɴzwɛ́
အနော်ရထာ	ʔənɔ̀jətʰà
ပိုစတာ	pòsətà
အယ်ဆာဗေဒို	ʔɛ̀sʰàbèdò
အသုပ်စုံ	ʔəθoʊʔsòʊɴ
ညွန့်	ɲʊ̰ɴ
အသားညှပ်မုန့်	ʔəθáɲ̊aʔmo̰ʊɴ
ဆိုး	sʰó
အော်တိုမေးရှင်း	ʔɔ̀tòméʃɪ́ɴ
နဂါးမောက်	na̰ɡámaʊʔ
ဇွန်	zʊ̀ɴ
ကောဏဂုံ	kɔ́nəɡòʊɴ
နွေ	nwè
ကဏ္ဍ	kànda̰
ခွင့်လွှတ်	kʰwɪ̰ɴl̥ʊʔ
ဂေဟဗေဒ	ɡèha̰ta̰bèda̰
မြို့ဝန်	mjo̰wʊ̀ɴ
လေထိုးတံ	lètʰódàɴ
စန္ဒီ	sàɴdì
ဟိုမှာ	hòm̥à
ဆုံးဖြတ်	sʰóʊɴpʰjaʔ
ယောနိ	jɔ́nḭ
ကီးယက်	kíjɛʔ
နံနက်	nàɴnɛʔ
ပန်းစည်း	páɴzí
အိပ်မက်	ʔeɪʔmɛʔ
အိပ်ခန်း	ʔeɪʔkʰáɴ
ဗိသုကာ	bḭðəɡà
ကြေးနီ	t͡ɕénì
ဒက္ခိဏ	dɛʔkʰḭna̰
အတီမျှ	ʔətìm̥ja̰
ထောပတ်သီး	tʰɔ́paʔθí
စင်္ကာပူ	sɪ̀ɴɡəpù
ဒီဂရီ	dìɡəɹì
ဖြူး	pʰjú
ကြေး	t͡ɕé
တင်ကူး	tɪ̀ɴɡú
မြစ်ကြီးနား	mjɪʔt͡ɕíná
အိုက်တင်	ʔaɪʔtɪ̀ɴ
ဒီည	dìɲa̰
စွေ့စွေ့	swḛzwḛ
မြေခွေး	mjèɡwé
ရွှံ့	ʃʊ̰ɴ
မတ်မတ်	maʔmaʔ
ဆောရီး	sʰɔ́ɹí
ကောင်းကင်ဘုံ	káʊɴɡɪ̀ɴbòʊɴ
သားဥ	θáʔṵ
နိုင်ဂျာ	nàɪɴd͡ʑà
မြင်းခွာရွက်သုပ်	mjɪ́ɴkʰwàjwɛʔθoʊʔ
အချုပ်ခန်း	ʔət͡ɕʰoʊʔkʰáɴ
ဇာတ်ကား	zaʔká
ကြောင်မ	t͡ɕàʊɴma̰
ကဏန်း	ɡənáɴ
ဘုန်း	pʰóʊɴ
သ	θa̰
ကာလဝမ်း	kàləwʊ́ɴ
နီကာရာဂွါ	nìkàɹàɡwà
ဂျလေဘီ	d͡ʑəlèbì
ကျန်းမာရေး	t͡ɕáɴmàjé
ရာ	jà
ဖောက်သည်	pʰaʊʔθè
ကျောက်နီ	t͡ɕaʊʔnì
တပ်ခွဲတပ်ကြပ်ကြီး	taʔkʰwɛ́taʔt͡ɕaʔt͡ɕí
အင်းဝ	ʔəwa̰
မဲဆောက်	mɛ́sʰaʊʔ
ဘွဲ့ချဉ်	bwɛ̰d͡ʑɪ̀ɴ
ရွပ်ရွပ်	jʊʔjʊʔ
ကိုယ်	kò
သောကြာဂြိုဟ်	θaʊʔt͡ɕàd͡ʑò
အာဇာနည်	ʔàzànì
သုဒ္ဒကိန်း	θoʊʔda̰kéɪɴ
ဝိတ်လျှော့	weɪʔʃɔ̰
လည်း	lɛ́
ရန်ကုန်	jàɴɡòʊɴ
မြင်းဆေး	mjɪ́ɴzé
ပါရာဂွေး	pàɹàɡwé
မုန့်	mo̰ʊɴ
ဗောဓိသတ်	bɔ́dḭθaʔ
စာကြည့်တိုက်	sàt͡ɕḭdaɪʔ
နံရိုး	nàɴjó
ကေ	kè
အရေးကြီး	ʔa̰jét͡ɕí
သာယာဝတီ	θàjàwədì
ကြိမ်	t͡ɕèɪɴ
ပညာ	pjɪ̀ɴɲà
ကြက်အူချောင်း	t͡ɕɛʔʔùd͡ʑáʊɴ
ဘရင်ဂျီ	bəjɪ̀ɴd͡ʑì
ပြင်	pjɪ̀ɴ
အဏ္ဏဝါဗေဒ	ʔànnəwàbèda̰
ဇာဂနာ	zàɡənà
ဟေမာ	hèmà
ဘူးသီးတောင်	búðídàʊɴ
တန်ခူး	dəɡú
ဖားလောင်း	pʰəláʊɴ
အစုရှင်	ʔəsṵʃɪ̀ɴ
သဘာဝ	ðəbàwa̰
တယော	təjɔ́
ဒီ	dì
စမူဆာသုပ်	səmùzàθoʊʔ
ဆီးချုပ်ရောဂါ	sʰíd͡ʑoʊʔjɔ́ɡà
ဝါဆော	wàsʰɔ́
၍	jwḛ
တီ	tì
ပြင်သည်	pjɪ̀ɴθì
အမြောက်	ʔəmjaʊʔ
ဒုံမင်း	dòʊɴmɪ́ɴ
မြက်	mjɛʔ
သင်ပေါင်း	θɪ̀ɴbáʊɴ
ဘယ်သူ	bəθù
ထို	tʰò
လိုက်ချီး	laɪʔt͡ɕʰí
စိတ်ပညာ	seɪʔpjɪ̀ɴɲà
ငရုတ်ကောင်း	ŋəjoʊʔɡáʊɴ
ဒေဝနာဂရီ	dèwa̰nàɡəɹì
ပြီး	pí
လိပ်	leɪʔ
မှဲ့	m̥ɛ̰
သတင်းစာ	ðədɪ́ɴzà
ပြည့်တန်ဆာ	pjḭdəzà
သမ္မတကတော်	θəma̰da̰ɡədɔ̀
ဖိအား	pʰḭʔá
နေအိမ်	nèʔèɪɴ
အာရုံကြော	ʔàjòʊɴd͡ʑɔ́
အလှဆီ	ʔəl̥a̰zì
အခမဲ့	ʔəkʰa̰mɛ̰
ပျဉ်	pjɪ̀ɴ
နေ့စွဲ	nḛzwɛ́
မဟာဘာရတ	məhàbàɹəta̰
မိုးကြိုး	mód͡ʑó
ခွေးမ	kʰwéma̰
စုပ်	soʊʔ
နို့သီးခေါင်း	no̰ðíɡáʊɴ
မန္တလေး	màɴdəlé
ဟလဝါ	ha̰ləwà
အကျယ်	ʔət͡ɕɛ̀
ဦး	ʔú
နာ	nà
ဘီလူး	bəlú
ရဝမ်ဒါ	ɹəwàɴdà
သရက်သီးသနပ်	θəjɛʔθíθa̰naʔ
သောက္ကတဲ	θaʊʔkətɛ́
ဆီးအောင့်ရောဂါ	sʰíʔa̰ʊɴjɔ́ɡà
မသာ	məθà
သူရ	θùja̰
သာရိပုတ္တရာ	θàjḭpoʊʔtəjà
တရုတ်	təjoʊʔ
ရှိန်းခို	ʃéɪɴɡò
အဓိဌာန်	ʔədeɪʔtʰàɴ
ဗျည်း	bjí
စကားပြန်	zəɡəbjàɴ
ဖန်တီး	pʰàɴdí
ဂျော့ခ်ျ	d͡ʑɔ̰t͡ɕʰə
သူကြွယ်	θùt͡ɕwɛ̀
စူပါမားကတ်	sùpəmákaʔ
ဟမ်ဘာဂါ	hàɴbàɡà
စိန်ဖြူ	sèɪɴpʰjù
ဝိုက်ချ	waɪʔt͡ɕʰa̰
ညည်း	ɲí
ရွှေပြည်စိုး	ʃwèpjìsó
ဩဇာ	ʔɔ́zà
သကြား	ðəd͡ʑá
စွန်	sʊ̀ɴ
အောင်ပွဲ	ʔàʊɴbwɛ́
ဆေးရုံ	sʰéjòʊɴ
ရှေ့	ʃḛ
ရုပ်မြင်သံကြား	joʊʔmjɪ̀ɴθàɴd͡ʑá
စွတ်စွတ်နာ	sʊʔsʊʔnà
ရန်သူမျိုးငါးပါး	jàɴðùmjóŋábá
အောက်မြစ်	ʔaʊʔmjɪʔ
ပူရီ	pùjì
ရွှံ့ပွက်	ʃʊ̰ɴbwɛʔ
ကော်ဇော	kɔ̀zɔ́
အလံ	ʔəlàɴ
မိဘမဲ့	mḭba̰mɛ̰
ဖော်	pʰɔ̀
ကာယ	kəja̰
တိုး	tó
မင်းဘူး	mɪ́ɴbú
လမ်းပြ	láɴpja̰
စောင်း	sáʊɴ
မီးယပ်	míjaʔ
ဝက်ခြံ	wɛʔt͡ɕʰàɴ
ဘဲလေး	bɛ́lé
မေဃာလယ	mèɡàləja̰
လန်ဒန်	làɴdàɴ
မျောက်	mjaʊʔ
လက္ခဏ	lɛʔkʰəna̰
တီထွင်	tìtʰwɪ̀ɴ
သားအိမ်	θəʔèɪɴ
အိုဗာတင်း	ʔòbàtɪ́ɴ
ပုတ်သင်ညို	poʊʔθɪ̀ɴɲò
သမဂ္ဂ	θa̰mɛʔɡa̰
သူရိယမာသ	θùɹḭja̰màθa̰
ပင်စိမ်းမွှေး	pɪ̀ɴzéɪɴm̥wé
ရောင်ခြည်	jàʊɴd͡ʑì
မုဒြာ	mṵdɹà
ပါး	pá
ပန်းမုန်လာ	páɴmòʊɴlà
ဝမ်းရောဂါ	wʊ́ɴjɔ́ɡà
အသုဘ	ʔa̰θṵba̰
သော	θɔ́
ဟီနယာန	hìna̰jàna̰
နီ	nì
ဂျုံ	d͡ʑòʊɴ
ပုန်ကန်	pòʊɴkàɴ
ဌာပနာ	tʰàpənà
ကော်လာ	kɔ̀là
စောင်းလျား	záʊɴjá
တပည့်တော်	dəbḭdɔ̀
ပဏ္ဍိတ	pàndḭta̰
နွားနို့	nwáno̰
စော	sɔ́
ဗျူရို	bjùɹò
ဘရဏီ	ba̰jənì
ကန့်	ka̰ɴ
အကြေး	ʔət͡ɕé
ရသ	ja̰ðà
အရေးတော်ပုံ	ʔəjédɔ̀bòʊɴ
အမည်း	ʔəmɛ́
ကူညီ	kùɲì
ဟိုင်းအီနာ	háɪɴʔìnà
မုန်ညင်း	mòʊɴɲɪ́ɴ
အယူဝါဒ	ʔəjùwàda̰
ချို	d͡ʑò
ဒေဝီ	dèwì
မေ့	mḛ
အာလယ	ʔàləja̰
ဘူတန်	bùtàɴ
အဆန်	ʔəsʰàɴ
ဩရိဿ	ʔɔ́ɹeɪʔθa̰
ရေငွေ့	jèŋwḛ
မာန်အောင်	mànʔàʊɴ
သူမသာငါမသာ	θùməθàŋàməθà
ရာဇဌာန်	ɹàzətʰàn
အက	ʔəka̰
မိခင်	mḭɡɪ̀ɴ
အပွင့်	ʔəpwɪ̰ɴ
သရီရ	θəɹìɹa̰
ထောင်	tʰàʊɴ
နယူးဒေလီ	nəjúdèlì
နှမ်းစေ့	n̥áɴzḛ
ကောက်	kaʊʔ
သျှမ်း	ʃáɴ
ဘယ်တော့	bɛ̀dɔ̰
မူလတန်းကြိုကျောင်း	mùla̰dáɴd͡ʑòd͡ʑáʊɴ
ထိုင်ပေ	tʰàɪɴpè
သုက်ရည်	θoʊʔjè
ကာလာမသုတ်	kàlàma̰θoʊʔ
လှေ	l̥è
တက္ကသိုလ်	tɛʔkəθò
ဒူလာ	dùlà
ကြက်ခြေနီအသင်း	t͡ɕɛʔt͡ɕʰènìʔəθɪ́ɴ
ရည်းစား	jízá
တူရိယာ	tùɹḭjà
စီလုံတီး	sìlòʊɴtí
အင်ဂျင်နီယာ	ʔɪ̀ɴd͡ʑɪ̀ɴnìjà
ပစ်	pjɪʔ
စားတော်ဆက်	sádɔ̀zɛʔ
အနုရုဒ္ဓါ	ʔənṵjoʊʔdà
ဥတု	ʔṵdṵ
အစ	ʔəsa̰
ခုခံအားကျရောဂါ	kʰṵɡàɴʔát͡ɕa̰jɔ́ɡà
ဘယ်ရီလီယမ်	bɛ̀ɹìlìjàɴ
တာဝန်	tàwʊ̀ɴ
ဝီကီပီးဒီးယား	wìkìpídíjá
အမ	ʔəma̰
အသံထွက်	ʔəθàɴdwɛʔ
ကယား	kəjá
ဟုတ်	hoʊʔ
ယူ	jù
ကြယ်စု	t͡ɕɛ̀zṵ
လီတာ	lìtà
မျောက်လောင်း	mjaʊʔláʊɴ
နိပေါ	nḭpɔ́
ခရိုအေးရှား	kʰəɹòʔéʃá
ဂိရိမေခလာ	ɡḭɹḭmèkʰəlà
ဖရုံ	pʰəjòʊɴ
ခေမာရဋ္ဌ	kʰèmàjətʰa̰
ရှယ်	ʃɛ̀
ဆော့	sʰɔ̰
တောင်ကိုရီးယား	tàʊɴkòɹíjá
ခြား	t͡ɕʰá
သံဖြူ	θàɴbjù
ပြည်ကြီးငါး	pjìd͡ʑíŋá
လက္ခဏာရေးသုံးပါး	lɛʔkʰənàjéθóʊɴbá
သိုး	θó
ဘာလိ	bàlḭ
မလုပ်တာနီ	məloʊʔtànì
ရှောက်	ʃaʊʔ
ပန်းမုန်လာစိမ်း	páɴmòʊɴlàzéɪɴ
အင်္ဂါဇာတ်	ʔɪ̀ɴɡàzaʔ
အချိုပွဲ	ʔət͡ɕʰòbwɛ́
အချိုမှုန့်	ʔət͡ɕʰòm̥o̰ʊɴ
ဝီကီပိဒိယ	wìkìpḭdḭja̰
ဘက်ထရီ	bɛʔtʰa̰ɹì
ရှမ်း	ʃáɴ
သစ်တို	θɪʔtò
ဈာန်	zàn
ဝါရှာ	wàʃà
သော်	ðɔ̀
ချက်သမ္မတ	t͡ɕʰɛʔθəməda̰
ငါးပေါင်းထုပ်	ŋəbáʊɴdoʊʔ
လိုး	ló
ဘုတ်	boʊʔ
မြမ္မာ	mjàɴmà
နဖူး	na̰pʰú
ဂျက်	d͡ʑɛʔ
ရေခဲမုန့်	jèɡɛ́mo̰ʊɴ
ဘိလပ်	bḭlaʔ
ဒေဝဒတ်	dèwədaʔ
ဆပ်ပြာ	sʰaʔpjà
မှု	m̥ṵ
လက်စွပ်	lɛʔsʊʔ
ဖရုံဆွဲ	pʰəjòʊɴzwɛ́
ငယ်	ŋɛ̀
မျိုးစိတ်	mjózeɪʔ
လုပ်သား	loʊʔθá
ရူပကအလင်္ကာ	jùpəka̰ʔəlìɡà
ပေါင်းတင်း	páʊɴdɪ́ɴ
ဗန်ရှည်	bàɴʃè
ကန္တာရ	kàɴtàja̰
စတုတ္ထ	zədoʊʔtʰa̰
တစ်ဆယ်	təzɛ̀
ကျယ်	t͡ɕɛ̀
ကူဖီ	kùpʰì
ကျန်	t͡ɕàɴ
ဒေတာဘေ့စ်	dètàbḛs
ဝါး	wá
အနို့	ʔəno̰
မျက်လွှာ	mjɛʔl̥wà
အလှမ်း	ʔəl̥áɴ
နှပ်	n̥aʔ
အဆီ	ʔəsʰì
အနှိပ်	ʔən̥eɪʔ
ဦးလေး	ʔúlé
ဘယ်သူ့	bəθṵ
စုတ်	soʊʔ
ကျင်ကြီး	t͡ɕɪ̀ɴd͡ʑí
အပ်	ʔaʔ
ဖက်	pʰɛʔ
အသိ	ʔəθḭ
သင်္ကေတ	θɪ̀ɴkèta̰
ဘီး	bí
ဂိုဏ်း	ɡón
လစဉ်	la̰zɪ̀ɴ
သေနတ်	θənaʔ
မျက်လုံး	mjɛʔlóʊɴ
လယ်ထွန်မင်္ဂလာ	lɛ̀tʰʊ̀ɴmɪ̀ɴɡəlà
ဆလိုဗေးနီးယား	sʰəlòbéníjá
သဲ	θɛ́
ဆားကြက်ဥ	sʰát͡ɕɛʔʔṵ
ဘီးကြယ်	bít͡ɕɛ̀
ဗျစ်	bjɪʔ
ဘုရင်မ	ba̰jɪ̀ɴma̰
မော်လတာ	mɔ̀lətà
သန်း	θáɴ
အီတလီ	ʔìta̰lì
ဓနရှင်	dəna̰ʃɪ̀ɴ
သုဝဏ္ဏ	θṵwʊ̀ɴna̰
ရာမည	ɹàməɲa̰
ဗီယက်နမ်	bìjɛʔnàɴ
ဝက်ထီး	wɛʔtʰí
ပြိုင်ပွဲ	pjàɪɴbwé
လှိုင်း	l̥áɪɴ
ကာယပညာ	kàja̰pa̰ɲà
တပ်	taʔ
သမင်မ	θəmɪ̀ɴma̰
သူတောင်းစား	ðədáʊɴzá
စားပွဲ	zəbwɛ́
သစ္စာလေးပါး	θɪʔsàlépá
ထန်းလျက်	tʰəɲɛʔ
ဒဿဂီရိ	dəθa̰ɡìjḭ
နို့သီး	no̰ðí
မဟာဝင်	məhàwɪ̀ɴ
ထားဝယ်	dəwɛ̀
ကတော့	ɡədɔ̰
ကာမ	kàma̰
သူတစ်ပါး	θùdəbá
ကိုရမ်ကျမ်း	kòɹàɴt͡ɕáɴ
စတုရန်း	sətṵjáɴ
ဖတ်	pʰaʔ
နောက်	naʊʔ
တံတောင်	dədàʊɴ
နော်ရထာ	nɔ̀jətʰà
ငါးကြင်း	ŋád͡ʑɪ́ɴ
အနန္တောအနန္တငါးပါး	ʔənàɴdɔ́ʔənda̰ŋápá
သစ်စေး	sɪʔsí
ဝါသနာ	wàða̰nà
မှာ	m̥à
လယ်ပြင်	lɛ̀bjɪ̀ɴ
တိုဟူးသုပ်	tòhúθoʊʔ
ခိုး	kʰó
ဂဠုန်	ɡəlòʊɴ
ဥသျှစ်	ʔoʊʔʃɪʔ
ဖြော်ဖြော်	pʰjɔ̀bjɔ̀
ထိုး	tʰó
သူရဲဘောကြောင်	θəjɛ́bɔ́d͡ʑàʊɴ
ပြည်	pjì
ခင်မင်မှု	kʰɪ̀ɴmɪ̀ɴm̥ṵ
လခြမ်းဆိုင်း	la̰d͡ʑáɴsʰáɪɴ
ကိုးလ	kóla̰
လေသိုက်	lèθaɪʔ
ယူဂန်းဒါး	jùɡáɴdá
သခွားမသီး	θəkʰəma̰ðí
စိန်	sèɪɴ
ဟီလီယမ်	hìlìjàɴ
ဒီပါ	dìpà
ပုစ္ဆာ	poʊʔsʰà
လေကတော့	lèɡədɔ̰
ဝတ်ကျောင်း	wʊʔt͡ɕáʊɴ
ရာဇာဓိရာဇဂုရု	jàza̰dḭjàza̰ɡṵɹṵ
စကား	zəɡá
အရသာ	ʔəja̰ðà
ဝပ်	wʊʔ
အထက်	ʔətʰɛʔ
ဇေယျာပူရ	zèjàpùɹa̰
နောက်ဆက်	naʊʔsʰɛʔ
လေရဟတ်	lèjəhaʔ
သုဓမ္မသိင်္ဂီ	θṵdàɴma̰θèɪɴɡì
အကျိုး	ʔət͡ɕó
စပ်	saʔ
ရူပဗေဒ	jùpa̰bèda̰
ကြက်မ	t͡ɕɛʔma̰
ဒဏ်ငွေ	dànŋwè
ဘယ်မှ	bɛ̀m̥a̰
အမွေအနှစ်	ʔəmwèʔən̥ɪʔ
နေကောင်းရဲ့လား	nèkáʊɴjɛ̰lá
ကာဗွန်	kàbʊ̀ɴ
မျည်းတံ	mjídàɴ
ရေကူး	jèkú
အိုင်ဗရီကို့စ်	ʔàɪɴbəɹìko̰s
မီးသွေး	míðwé
ဆူရှီ	sʰùʃì
သတင်း	ða̰dɪ́ɴ
ခါး	kʰá
ဘာသာ	bàðà
ငှက်ဆိုး	ŋ̊ɛʔsʰó
ဆီနီဂေါ	sʰìnìɡɔ́
ပီပီ	pìbì
ရုံးပတီ	jóʊɴbətì
ဆရာ	sʰəjà
ပတ္တလား	paʔta̰lá
ဆေးတံ	sʰédàɴ
ဇရပ်	zəjaʔ
နော်	nɔ̀
စရိုက်	zəjaɪʔ
လတ်ဗီယာ	laʔbìjà
နှလုံး	n̥əlóʊɴ
ဆံတော်ချ	sʰàɴtɔ̀t͡ɕʰa̰
ကောင်းကင်ကြိုး	káʊɴɡɪ̀ɴd͡ʑó
ရင်ထိုးတံဆိပ်	jɪ̀ɴdódəzeɪʔ
သင်္ကဒူး	θɪ́ɴɡədú
အမှိုက်	ʔəm̥aɪʔ
ကတ်သလိတ်	kaʔθəleɪʔ
သူဇာ	θùzà
ကကြီး	ka̰d͡ʑí
တိုရှေ	tòʃè
မြို့တော်ဝန်	mjo̰dɔ̀wʊ̀ɴ
စာရေး	səjé
ညေး	ɲé
ကျိန္တလီ	t͡ɕèɪɴta̰lì
အောင်လံ	ʔàʊɴlàɴ
လစ်သူယေးနီးယား	lɪʔθùjéníjá
သံသယ	θàɴθəja̰
ပူတင်း	pùtɪ́ɴ
ဣရိယာပုတ်	ʔḭɹḭjàboʊʔ
ဘီး	béɪɴ
အပတ်စဉ်	ʔa̰paʔzɪ̀ɴ
လိုချင်	lòd͡ʑɪ̀ɴ
ဆင်စွယ်	sʰɪ̀ɴzwɛ̀
ဂဏန်း	ɡənáɴ
ဝရဏဗေဒ	wəjəna̰da̰bèda̰
အိပ်ရာလိပ်	ʔeɪʔjàleɪʔ
သူတစ်ထူး	θùtətʰú
