tændt	tˢɛnˀd̥
eksamen	ɛɡ̊sæːmm̩
pat	pʰad̥
træl	tˢʁ̥ɑlˀ
trænet	tˢʁ̥æːnð̩
ligne	liːnə
utvivlsom	utˢviwˀlsʌmˀ
milliard	miliɑˀd̥
stødte	sd̥øːd̥ə
mægtig	mɛɡ̊d̥i
jade	jæːð̩
træffes	tˢʁ̥ɑfəs
kakkel	kʰɑɡ̊l̩
religiøs	ʁæliɡ̊jøːˀs
lejre	lɑjʁɐ
filigran	filiɡ̊ʁɑnˀ
køer	kʰøɐ̯ˀ
aftnen	ɑfd̥ənən
rest	ʁɑsd̥
svigerfar	sʋ̥iˀɐfɑː
lakonisk	lakʰoˀnisɡ̊
peber	pʰewɐ
ildflue	ilfluːə
jæger	jɛːjʌ
prædike	pʰʁ̥ɛðð̩ɡ̊ə
ås	ɔːˀs
tyfussen	tˢyfusn̩
dræbt	d̥ʁɑb̥d̥
evindelig	eʋenˀn̩li
vrøvlet	ʋʁɶwˀlð̩
skåne	sɡ̊ɔːnə
hug	huɡ̊
køretøjet	kʰøːɐtˢʌðˀð̩
fjord	fjoɐ̯ˀ
hinder	henɐ
ætten	ɛˀd̥ən
visken	ʋesɡ̊ən
petersen	pʰed̥ɐsn̩
der	d̥ɛˀɐ̯
ihukomme	ihukʰʌmˀə
længe	lɛŋə
stegt	sd̥ɛɡ̊d̥ə
målmand	mɔːlmanˀ
thor	tˢoɐ̯ˀ
vits	ʋid̥s
fordele	foɐ̯d̥eːˀlə
flagermus	flɑwɐmuːˀs
at	ad̥
kræmmer	kʁ̥ɑmɐ
irsk	iɐ̯ˀsɡ̊
producere	pʰʁ̥od̥useːˀɐ
like	lɑjɡ̊
meditation	med̥itˢaɕoːˀn
bager	b̥æːjɐ
bad	b̥að
støve	sd̥øːʊ
vorde	ʋɒːd̥ə
forrådt	fʌʁɔˀd̥
hæng	hɛŋˀ
røves	ʁɶwəs
sølvet	sølˀəð
slik	sleɡ̊
juvel	juveːˀl
hudfarve	hufɑːw̩
gø	ɡ̊øːˀ
ilt	ilˀd̥
kolerisk	kʰoleːˀɐ̯isɡ̊
viden	ʋiðð̩n
århus	ɒːhus
kløver	kʰløːvɐ
anæstesi	anɛsd̥əsiːˀ
måler	mɔːˀlɐ
trodse	tˢʁ̥ʌsə
mile	miːlə
fager	fæˀɐ
fagter	fɑɡ̊d̥ɐ
pokal	pʰokʰæːˀl
trå	tˢʁɔˀ
sjov	ɕɒwˀ
let	leˀd̥
mennesket	mɛnsɡ̊əð
pinlig	pʰiːnli
måne	mɔːnə
kvæler	kʰʋ̥ɛˀlɐ
søjle	sʌjlə
pege	pʰɑjə
a's	æːs
sloges	sl̥oːos
greje	ɡ̊ʁɑːɪ
forelske	fɒɛlsɡ̊ə
udeblev	uːðəb̥lewˀ
mødtes	mød̥əs
homofili	homofiliːˀ
zeus	sœwˀs
omgang	ʌmɡ̊ɑŋˀ
undr	ɔnˀd̥ɐ
landmand	lanmanˀ
muldvarpe	mulʋɑːb̥ə
faster	fasd̥ɐ
kroatisk	kʰʁoæːˀtˢisɡ̊
hylle	hylə
sigøjner	siɡ̊ʌjˀnɐ
frøken	fʁ̥œɡ̊ŋ̩
dumt	d̥ɔmˀd̥
svor	sʋ̥oɐ̯ˀ
mælkechokolade	mɛlɡ̊ɔɕoɡ̊olæːðə
punkt	pʰɔŋˀd̥
muskuløs	musɡ̊uløːˀs
såret	sɒːɒð
fryser	fʁ̥yˀsɐ
at	ʌ
folketinget	fʌlɡ̊ətˢeŋˀəð
østersøen	øsd̥ɐsøːˀən
spredte	sb̥ʁæːd̥ə
mundtlig	mɔnd̥li
fornemme	fɒːnɛmˀə
tunge	tˢɔŋə
rad	ʁɑˀð
nevada	nevɛːdæ
fransk	fʁɑnˀsɡ̊
vakuum	væːˀkʰuɔm
nulpunkt	nɔlpʰɔŋˀd̥
ledte	leːd̥ə
sig	siːˀ
koffein	kʰʌfəiːˀn
vandrestjerne	ʋɑnd̥ʁɐsd̥jaɐ̯nə
kork	kʰɒːɡ̊
ledte	leˀd̥ə
punktlig	pɔŋd̥li
hannen	hanˀn̩
ride	ʁiðð̩
ruiner	ʁuiːˀnɐ
vær	væˀɐ̯
gren	ɡ̊ʁæˀn
skilt	sɡ̊elˀd̥
seraf	seʁɑːˀf
overskuelig	ɒwɐsɡ̊uːˀəli
tight	tˢɑjd̥
gæst	ɡ̊ɛsd̥
frugt	fʁ̥ɔɡ̊d̥
morgenmand	mɒɒnmanˀ
ældre	ɛld̥ʁɐ
følger	følɐ
teint	tˢɛŋ
stedmor	sd̥emoɐ̯
neger	neːjɐ
næppe	nɛb̥ə
vordende	ʋɒːd̥n̩nə
kontor	kʰɔntˢoɐ̯ˀ
hamsteren	hɑmˀsd̥ɐɐn
rå	ʁɔˀ
ulden	ulən
skralde	sɡ̊ʁɑlə
vest	ʋɛsd̥
vædder	ʋɛðɐ
effen	ɛfən
sankthans	sɑŋd̥hans
atten	ad̥n̩
accenternes	ɑɡ̊sɛnˀd̥ɐnəs
tabte	tˢɑb̥d̥ə
udlændig	uðlɛnˀd̥i
konsensus	kʰʌnsɛnsus
kvækerfinke	kvɛˀɡʌfeŋɡə
forrådte	fʌʁɔˀd̥ə
skyllemiddel	sɡ̊øləmiðˀəl
adresse	ad̥ʁasə
passer	pʰaseɐ̯ˀ
bopæl	b̥opʰɛːˀl
embedsmand	ɛmb̥eðsmanˀ
serbisk	sæɐ̯ˀb̥isɡ̊
guddommelig	ɡ̊uðd̥ʌmˀəli
købstad	kʰøb̥sd̥að
candyfloss	kʰand̥iflʌs
bøvse	b̥œwsə
lærer	lɛːɐ
par	pʰɑˀ
kvæg	kʰʋ̥ɛˀ
risalamande	ʁisalamɑŋ
anse	anseˀ
albumin	alb̥umiːˀn
tryner	tˢʁyːnɐ
må	mɔˀ
vidst	ʋesd̥
tjekke	tçɛɡ̊ə
skræv	sɡ̊ʁaw
bil	b̥iːˀl
racer	ʁɛːsɐ
ridt	ʁid̥
gejstlig	ɡ̊ɑjsd̥li
lodde	lʌðə
ligestilling	liːɪsd̥elˀeŋ
adr	aðˀɐ
hyttet	hyd̥ð̩
hundred	hunɐð
bruxelles	b̥ʁysɛl
kryb	kʰʁ̥yːˀb̥
fotograf	fod̥oɡ̊ʁɒːˀf
gøgler	ɡ̊ʌjlɐ
sanger	saŋɐ
køretøjet	kʰøːɐtˢʌjˀəð
yver	ywˀɐ
oppebie	ʌb̥əb̥iːi
kakaosmør	kʰakʰæːosmɶɐ̯
rad	ʁɑð
pæn	pʰɛːˀn
borg	pɒˀw
forleden	fʌleðˀn̩
fundamentalisme	fɔnd̥aməntˢalismə
lægt	lɛˀjd̥
frist	fʁɛsd̥
føjning	fʌjneŋ
givne	ɡ̊iwnə
dukke	d̥ɔɡ̊ə
onani	ʌnaniːˀ
fastelavn	fasd̥əlɑwˀn
bumpes	b̥ɔmb̥əs
belortet	b̥eloɐ̯d̥əð
plask	pʰl̥asɡ̊
forsørge	fʌsɶɐ̯ˀwə
arbejder	ɑːb̥ɑjˀd̥ɐ
flaskepost	flasɡ̊əpʰʌsd̥
svag	svæˀj
lysning	lysneŋ
nuttet	nud̥əð
strategi	stˢʁad̥ɛɡ̊iː
anmode	anmoðˀð̩
afvise	ɑwʋiˀsə
slag	sl̥ɑw
spidde	sb̥iðð̩
flygtning	fløɡ̊neŋ
anders	ɑnɐs
kendt	kʰɛnˀd̥
noget	nɔðð̩
remonce	ʁæmʌŋsə
slem	slɛmˀ
hvilket	ʋelɡ̊əð
bedrøvede	b̥ed̥ʁœwˀð̩ð̩
slæt	slɛd̥
stuepige	sd̥uːupʰiːi
søvnig	sœwni
nederdrægtig	neðɐd̥ʁaɡ̊d̥i
stjæler	sd̥jɛˀlɐ
grise	ɡ̊ʁiːsə
dronning	d̥ʁʌneŋ
foragt	fʌɑɡ̊d̥
tyg	tˢyɡ̊
kreds	kʰʁ̥æːˀs
danerne	d̥æˀnɐnə
hamstrerne	hɑmsd̥ʁɐnə
vakt	ʋɑɡ̊d̥
grej	ɡ̊ʁɑjˀ
nyt	nyd̥
idyllisk	id̥ylˀisɡ̊
slås	sl̥ʌs
natklub	nad̥kʰlub̥
fundamental	fɔnd̥aməntˢæːˀl
gråd	ɡ̊ʁɔˀð
pokkers	pʰʌɡ̊ɐs
klokke	kʰl̥ʌɡ̊ə
længde	lɛŋˀd̥ə
køb	kʰøˀb̥
spøgelse	sb̥øːl̩sə
kolossal	kʰolosæːˀl
gang	ɡɑ̃
færge	faɐ̯ʊ
antage	antˢæːˀ
skueproces	sɡ̊uːəpʰʁ̥osɛs
rid	ʁiðˀ
hærger	haɐ̯wɐ
følte	føːld̥ə
spurgte	sb̥oɐ̯d̥ə
lod	lʌðˀ
enig	eːni
rensdyr	ʁanˀsd̥yɐ̯ˀ
vige	ʋiːi
søge	søːɪ
lasagne	lasanjə
jomfru	jʌmfʁ̥o
ødipal	ød̥ipʰæˀl
at	a
diminutiv	diminutˢiwˀ
kræve	kʰʁ̥æːʊ
mindre	mend̥ʁɐ
gigt	ɡiɡd
åbenbar	ɔːb̥m̩b̥ɑˀ
chips	tɕib̥s
liden	liðð̩n
grød	ɡ̊ʁœðˠˀ
ildsjæl	ilɕɛˀl
ar	ɑːˀ
flød	fløˀð
sødt	sød̥
irrationel	iʁɑɕonɛlˀ
hytter	hyd̥ɐ
led	leðˀ
bon	b̥ʌŋ
evne	ɛwnə
tilføje	tˢelfʌjˀə
tirsdag	tˢiɐ̯ˀsd̥a
starut	sd̥aʁud̥
papir	pʰapʰiɐ̯ˀ
stjal	sd̥jæˀl
køds	kʰøðs
gæld	ɡ̊ɛlˀ
kvæler	kʰʋ̥ɛːlɐ
gærdesmutte	ɡ̊ɛːɐsmud̥ə
ni	niːˀ
udrede	uðʁæðˀð̩
hale	hæːlə
legemlig	lɛːɪmli
spænders	sb̥ɛnɐs
gang	ɡ̊ɑŋˀ
blotte	b̥lʌd̥ə
bæve	b̥ɛːʊ
tjeneste	tɕɛːnəsd̥ə
ske	sɡ̊eˀ
gene	ɕeːnə
cremer	kʰʁ̥ɛˀmɐ
hårdt	hɒːd̥
lutter	lud̥ɐ
jødinde	jøðenə
sikker	seɡ̊ɐ
amerika	ameːˀʁikʰa
yngste	øŋˀsd̥ə
brom	bʁoˀm
nyde	nyːðə
sidste	sisd̥ə
føler	føːlɐ
primitiv	pʁimitˢʰiʊ̯ˀ
næsten	nɛsd̥ən
næste	nɛsd̥ə
tante	tˢand̥ə
bugte	b̥ɔɡ̊d̥ə
nået	nɔˀð̩
pinse	pʰensə
pulver	pʰɔlˀvɐ
bid	b̥iðˀ
puh	pʰuː
sisyfosarbejde	sisyfʌsɑːb̥ɑjˀd̥ə
korn	kʰoɐ̯ˀn
tanken	tˢɑŋˀɡ̊ŋ̩
stork	sd̥ɒːɡ̊
atter	ad̥ɐ
sammenhæng	sɑmənhɛŋˀ
søstrenes	søsd̥ʁɐnəs
kobber	kʰɒwˀɐ
ansatte	ansad̥ə
kerne	kʰaɐ̯nə
følge	følə
ultralyd	ultˢʁ̥ɑlyðˀ
røver	ʁœ̞ːwɐ
reje	ʁɑːɪ
tiendedel	tˢiːˀənəd̥eːˀl
akkusativ	akʰusatˢiwˀ
egern	eːˀjɐn
legemligt	lɛːmlid̥
selvlysende	sɛllyˀsn̩nə
halstørklæde	halstˢɶɐ̯kʰl̥ɛːðə
svoger	sʋ̥ɔwˀɐ
holdes	hʌləs
hu	huˀ
hitte	hid̥ə
ej	ɑjˀ
forlæg	fʌlɛɡ̊
system	sysd̥eːˀm
vederkvæge	ʋeðɐkʰʋ̥ɛˀjə
undre	ɔnd̥ʁɐ
elendig	elɛnˀd̥i
epos	eːpʰʌs
kræset	kʰʁ̥ɛːsəð
blodbad	b̥loðb̥að
ræson	ʁæsʌŋ
itu	itˢuːˀ
drømmeverdnerne	d̥ʁɶməʋaɐ̯d̥nɐnə
gøre	ɡ̊ɶːɐ
turde	tˢoɐ̯d̥ə
jomfruelig	jʌmfʁoˀoli
ildslukker	ilslɔɡ̊ɐ
hærgende	haɐ̯ʊnə
snes	sneːˀs
sygt	syɡ̊d̥
overflødig	ɒwɐfløˀði
si	siːˀ
syndflod	sønfloðˀ
kræfterne	kʰrɑfd̥ɐnə
dandere	dɑŋdeˀʌ
radioaktiv	ʁɑd̥joɑɡ̊tˢiwˀ
mær	mɛˀɐ̯
rave	ʁɑːwə
opsigtsvækkende	ʌb̥seɡ̊sʋɛɡ̊n̩nə
finér	fineːˀɐ̯
fotografer	fod̥oɡ̊ʁɑːˀfɐ
hvæsse	ʋɛsə
høste	høsd̥ə
legetøj	lɑːɪtˢʌj
bouquet	b̥ukʰɛ
kvær	kʰʋ̥ɛˀɐ̯
fjerdedel	fjeːɐd̥eˀl
forglemme	fɒɡ̊lɛmˀə
forskertse	fʌsɡ̊aɐ̯d̥sə
eufori	œwfoʁiːˀ
lune	luːnə
neutrum	nʌjtˢʁ̥ɔm
yngst	øŋˀsd̥
bruger	b̥ʁoːɐ
hyttens	hyd̥n̩s
filet	file
cremefraiche	kʰʁ̥ɛmfrɛːɕ
fritstående	fʁ̥id̥sd̥ɔːˀənə
klædernes	kʰl̥ɛːðɐnəs
samtykker	sɑmtˢyɡ̊ɐ
reel	ɹiːl
førte	føɐ̯ˀd̥ə
changere	ɕɑŋɕeˀɐ
undfange	ɔnfɑŋˀə
fersken	faɐ̯sɡ̊ən
svensk	sʋ̥ɛnˀsɡ̊
arkiv	ɑkʰiwˀ
barsle	b̥ɑːslə
tanke	tˢɑnɡ̊ə
afbildning	ɑwb̥elˀneŋ
bedårende	b̥ed̥ɒˀɒnə
overvægt	ɒwɐʋɛɡ̊d̥
fager	fæˀjɐ
gløgg	ɡ̊løɡ̊
algoritme	alɡ̊oʁid̥mə
rette	ʁɑd̥ə
herske	hæɐ̯sɡ̊ə
nøgleroman	nʌjləʁomæːˀn
gænger	ɡ̊ɛŋɐ
norden	noːɐn
vrang	vʁɑŋˀ
gebærde	ɡ̊eb̥ɛɐ̯ˀd̥ə
perker	pʰæɐ̯ˀɡ̊ɐ
formode	fʌmoðˀð̩
magre	mɑwʁʌ
frikadeller	fʁiɡ̊əd̥ɛlɐ
fængsler	fɛŋˀslɐ
handske	ha̝nsɡ̥ə
udebliver	uːðəb̥liwˀɐ
skændig	sɡ̊ɛnd̥i
indtægt	entˢɛɡ̊d̥
pendant	pʰɑŋd̥ɑŋ
faldskærm	falsɡ̊aɐ̯ˀm
pæderast	pʰɛd̥əʁɑsd̥
sørgede	sɶɐ̯wəðə
herberg	haɐ̯b̥aɐ̯ˀw
konservativ	kʰɔnsæɐ̯vatˢiwˀ
praksis	pʰʁ̥ɑɡ̊sis
naturvidenskab	natˢuɐ̯ˀviðn̩sɡ̊æˀb̥
træ	tˢʁ̥aˀ
oldefar	ʌləfɑː
skænk	sɡ̊ɛŋˀɡ̊
altid	alˀtˢiðˀ
græsk	ɡ̊ʁɑsɡ̊
hvorledes	vɒleːðɘs
sluge	sluːu
helvede	hɛ̝lvð̩ə
margrete	mɑɡ̊ʁæːˀd̥ə
bredders	b̥ʁæˀd̥ɐs
solgte	sʌld̥ə
piner	pʰiːnɐ
afsked	ɑʊ̯sɡ̊eð̠ˠˀ
tag	tˢæɡ̊
menuen	menyn̩
fri	fʁitʃː
punktum	pʰɔŋtˢɔm
finde	fenə
brunch	b̥ʁʌnˀɕ
flyder	flyˀðɐ
politik	pʰolitˢiɡ̊
skødet	sɡ̊øːðəd̥
studentereksamen	sd̥ud̥enˀd̥ɐɛɡ̊sæːmm̩
kolibri	kʰolib̥ʁiːˀ
masser	maseɐ̯ˀ
stemte	sd̥ɛmˀd̥ə
knar	kʰnɑːˀ
vælte	ʋɛld̥ə
eng	ɛŋˀ
nagle	nɑwlə
skørt	sɡ̊øɐ̯ˀd̥
adjø	ad̥jø
følelse	føːl̩sə
tjener	tɕɛˀnɐ
allesammen	aləsɑmn̩
bebyrde	b̥eb̥yɐ̯ˀd̥ə
trælle	tˢʁ̥ɑlə
slurk	sluɐ̯ɡ̊
lønforhøjelse	lœnfʌhʌjˀəlsə
karl	kʰɑl
balstyrisk	b̥alsd̥yːˀɐ̯isɡ̊
flimmerkasse	flemˀɐkʰasə
æde	ɛðð̩
pilgrim	pʰilɡ̊ʁɛmˀ
hul	hɔl
boet	b̥oðˀð̩
kilde	kʰilə
bunden	b̥ɔnˀən
skjule	sɡ̊juːlə
grus	ɡ̊ʁuːˀs
ført	føɐ̯ˀd̥
bipolær	b̥ipʰolɛːˀɐ̯
fryd	fʁ̥yˀð
standpunkt	sd̥anpʰɔŋˀd̥
pibe	pʰiːʊ
besudle	b̥esuðˠˀlə
genert	ɕeneɐ̯ˀd̥
tab	tˢæˀb̥
ilter	ild̥ɐ
harekilling	hɑːɑkʰileŋ
hjerte	jaɐ̯d̥ə
flæskesteg	fl̥ɛsɡ̊əsd̥ɑjˀ
mobil	mob̥iːˀl
pleje	pʰl̥ɑːɪ
lever	leːwɐ
oldgræske	ʌlɡ̊ʁasɡ̊ə
drift	d̥ʁæfd̥
bizar	b̥isɑːˀ
kompost	kʰɔmpʰʌsd̥
krans	kʰʁ̥ɑːˀns
bærer	b̥aɐ̯ˀ
forårsrulle	fɒːɒsʁulə
fisse	fisə
først	fɶsd̥
springe	sb̥ʁɛŋə
danegæld	d̥æːnəɡ̊ɛlˀ
vidste	ʋesd̥ə
anstand	ansd̥anˀ
hjælpes	jɛlb̥əs
klæd	kʰl̥ɛˀ
revne	ʁawnə
trøflen	tˢʁ̥œflən
nøgtern	nœɡ̊d̥ɐn
mad	maˀð
ynde	ønə
marsvin	mɑːsviːˀn
koge	kʰɔːʊ
springer	sb̥ʁeŋɐ
a	aˀ
metafor	metˢafoːˀɐ̯
spisestue	sb̥isəsd̥uːu
tiere	tˢiˀɐɐ
travl	tˢʁ̥ɑwˀl
hob	hoˀb̥
underlag	ɔnɐlæːˀɪ̯
slags	sl̥æˀjs
rejste	ʁɑjsd̥ə
amerika	ameɐ̯ˀikʰa
cowboy	kʰɒwb̥ʌj
iste	istˢeːˀ
fiks	feɡ̊s
rutebilstation	ʁud̥əb̥ilsd̥aɕoˀn
velfærdsstat	ʋɛlfɛɐ̯ssd̥æˀd̥
jeg	jɑj
rar	ʁɑːˀ
skulle	sɡ̊ulə
pagaj	pʰaɡ̊ɑjˀ
par	pʰɑː
violin	violiːˀn
skyldig	sɡ̊yld̥i
ret	ʁɑd̥
dårlig	d̥ɒːli
undret	ɔnd̥ʁɐð
slaver	slæːwɐ
ved	ʋeˀ
pligt	pʰl̥eɡ̊d̥
kørte	kʰøɐ̯ˀd̥ə
krus	kʰʁ̥oːˀs
leve	leːʋə
koparret	kʰʌb̥ɑːɑð
fuchsia	fɔɡ̊ɕa
stole	sd̥oːlə
ordbog	oɐ̯b̥ɔwˀ
jesus	je̝ːsus
flæsk	fl̥ɛsɡ̊
lærdom	læɐ̯d̥ʌmˀ
daler	d̥æːˀlɐ
blevet	b̥leːwð̩
lemmerne	lɛmɐnə
plat	pʰl̥ad̥
gift	ɡ̊ifd̥
uvejr	uʋɛɐ̯ˀ
gotisk	ɡ̊oˀtˢisɡ̊
kvarts	kʰʋ̥ɑːd̥s
pinligt	pʰiːnlid̥
søde	søːðə
begge	b̥ɛɡ̊ə
gør	ɡ̊ɶɐ̯
iscenesætte	iseːnəsɛd̥ə
blod	b̥loðˀ
attisk	atˢisɡ̊
traske	tˢʁ̥ɑsɡ̊ə
give	ɡ̊i
kælling	kʰɛleŋ
beretning	pe̝ʁɑtniŋ
rhinen	ʁiˀnn̩
saksisk	sɑɡ̊sisɡ̊
svoret	sʋoːɐð
holden	hʌlən
træskonæb	tʁasɡoˀnɛ̝b̥ˀ
kvaje	kʰʋ̥ɑjə
hel	heˀl
gudløs	ɡ̊uðløːˀs
vittighed	vid̥iheðˀ
dansker	d̥ansɡ̊ɐ
fart	fɑˀd̥
transparens	tˢʁ̥ɑnsb̥ɑʁans
sæl	sɛːˀl
skæv	sɡ̊ɛwˀ
vilde	ʋilə
livegen	liweˀjən
hotdog	hʌd̥d̥ʌɡ̊
reven	ʁæːwn̩
forbyd	fɒb̥yˀð
alting	alˀtˢeŋˀ
fersken	faɐ̯sɡ̊ŋ̩
stank	sd̥ɑŋˀɡ̊
kagers	kʰæːjɐs
hugge	hɔɡ̊ə
trufne	tˢʁ̥ɔfnə
vort	vɒd̥
undtagen	ɔntˢæjˀən
værtinde	væɐ̯d̥enə
optrædes	ʌb̥tˢʁ̥ɛˀðəs
drøne	d̥ʁœ̞ːnə
strøg	stʁʌjˀ
røven	ʁœːʋən
ambitiøs	ɑmb̥iɕøːˀs
egetræ	eːjətˢʁ̥ɛːˀ
kakkelovn	kʰɑɡ̊l̩lɒwˀn
slag	sl̥æˀ
rører	ʁœ̞ːɐ
vrik	vʁæɡ̊
forvente	fʌʋɛnˀd̥ə
kyse	kʰyːsə
træffedes	tˢʁ̥afəðəs
vågne	ʋɔwnə
frelse	fʁɑlsə
fugt	fɔɡ̊d̥
fortsatte	fɒːd̥sad̥ə
skørbug	sɡ̊øɐ̯b̥uˀ
møl	møl
sjælland	ɕɛlanˀ
undtag	ɔntˢæˀ
lykke	løɡ̊ə
grøntsag	ɡ̊ʁɶnsæˀ
blevet	b̥leːð̩
valgte	ʋald̥ə
gulvenes	ɡ̊ɔlnəs
giro	ɕiːo
blomsterbed	b̥lʌmˀsd̥ɐb̥eð
bøvler	b̥œwlɐ
enebarn	eːnəb̥ɑːˀn
cykelhjelm	syɡ̊l̩jɛlˀm
rygning	ʁœ̞ɡ̊neŋ
lemme	lɛmə
støvsuger	sd̥øwsuːɐ
båndoptager	b̥ʌnʌb̥tˢaˀjɐ
ko	kʰoˀ
rev	ʁæˀw
valke	valɡ̊ə
kristne	kʰʁ̥ɛsd̥nə
fra	fʁ̥ɑ
verdenskrig	væɐ̯d̥ənskʰʁiːˀ
pjat	pʰj̊ad̥
porre	pʰoːɐ
le	leˀ
purløg	pʰuɐ̯lʌɪ̯ˀ
hø	høtʃː
ræv	ʁæwˀ
subtil	sub̥tˢiːˀl
aftener	ɑfd̥ənɐ
spørge	sb̥ɶɐ̯wə
march	mɑːɕ
krebs	kʰʁ̥ab̥s
spyd	sb̥yð
herodot	heod̥oˀd̥
skørt	sɡ̊ɶɐ̯d̥
walisisk	valiːˀsisɡ̊
tyran	tˢyʁɑnˀ
spærre	sb̥æʁə
torsk	tˢɒːsɡ̊
prutten	pʰʁ̥ud̥ən
dejlig	d̥ɑjli
stræbte	sd̥ʁab̥d̥ə
blev	b̥lewˀ
irriterende	iɐ̯tˢeɐ̯ˀnə
overkrop	ɒwɐkʰʁ̥ʌb̥
borge	b̥ɒːʊ
guvernørpost	ɡ̊uʋɐnøːˀɐ̯pʰʌsd̥
christian	kʰʁɛsd̥jan
hårfin	hɒːfiˀn
fabelagtig	fæˀb̥əlɑɡ̊d̥i
ildsvåde	ilˀsʋɔðð̩
gav	ɡ̊æˀ
accentens	ɑɡ̊sɛnˀd̥n̩s
gad	ɡ̊æˀð
mager	mɑwˀɐ
boheme	b̥oɛːm
legal	leɡ̊æːˀl
krænke	kʰʁ̥aŋɡ̊ə
nytårsdag	nyd̥ʌsd̥æːˀ
rettelse	ʁɑd̥l̩sə
stande	sd̥anə
lagdes	læːəs
frelser	fʁɑlsɐ
støje	sd̥ʌjə
blåskimmelost	b̥lʌsɡ̊eməlɔsd̥
friste	fʁɛsd̥ə
ligeglad	liːəɡ̊lað̠ˠ
spredte	sb̥ʁæˀd̥ə
save	sæːʋə
vølve	vølvə
hygge	hyɡ̊ə
fiktiv	fiɡ̊tˢiwˀ
størrelse	sd̥ɶːɐlsə
efterspørgsel	ɛfdɐsbɶɐ̯səl
fred	fʁ̥æðˀ
numrene	nɔmʁɐnə
blæse	b̥lɛːsə
tvang	tˢʋ̥ɑŋˀ
fuldstændig	fulsd̥ɛnˀd̥i
fed	feð
onkel	ɔŋˀɡ̊l̩
syg	syˀ
pude	pʰuːðə
boner	b̥ʌŋˀɐ
helt	hɛlˀd̥
tænke	tˢɛŋɡ̊ə
godaften	ɡoɑfd̥ən
sælger	sɛlˀjɐ
sover	sɒwˀɐ
mål	mɔˀl
fugtig	fɔɡ̊d̥i
pigen	pʰiːn̩
fortæller	fʌtˢɛlˀɐ
forandre	fʌɑnˀd̥ʁɐ
ville	ʋelə
suppe	sɔb̥ə
ager	aɡ̊eˀɐ̯
asparges	asb̥ɑˀs
brugbar	b̥ʁoːb̥ɑˀ
overspringshandling	ɒʊ̯ɐsb̥ʁæŋˀshanleŋ
urtid	uɐ̯tˢiˀð
gennem	iɡ̊ɛmˀm̩
tog	tˢoˀ
træf	tˢʁ̥af
sanger	sɑŋɐ
ville	ʋilə
bag	b̥æˀj
kvæle	kʰʋ̥ɛːlə
gulvene	ɡ̊ɔlvənə
saft	sɑfd̥
usagt	usɑɡ̊d̥
spredt	sb̥ʁæˀd̥
forhud	fɒːhuðˀ
olivengren	oliwˀn̩ɡ̊ʁæˀn
butikken	b̥utˢiɡ̊ən
månefase	mɔːnəfæːsə
sådan	sʌnoːn
impulsiv	empʰulsiwˀ
ledt	leˀd̥
torve	tˢɒːʊ
rev	ʁæw
jaloux	ɕælu
støvsuger	sd̥øwsuːˀɐ
revy	ʁævy
løber	løwˀɐ
en	eːˀn
optræd	ʌb̥tˢʁ̥aðˀ
sværdfisk	svæɐ̯fesɡ̊
vægtning	ʋɛɡ̊d̥neŋ
holland	hʌlanˀ
ejendel	ɑːɪnd̥eˀl
skyld	sɡ̊ylˀ
klovne	kʰlɒwnə
skrift	sɡ̊ʁæfd̥
ufødt	uføˀd̥
trussel	tˢʁosl̩
kørvel	kʰɶɐ̯ʊ̯əl
avancere	ɑvɑŋseːˀɐ
olding	ʌld̥eŋ
salt	salˀd̥
grævling	ɡ̊ʁawleŋ
tilbagestående	tˢeb̥æːæsd̥ɔˀnə
kristian	kʰʁæsd̥jan
paté	pʰatˢe
skud	sɡ̊uð
pil	pʰelˀ
laven	læːwn̩
skejs	sɡɑjˀs
brugs	b̥ʁoˀs
første	fɶɐ̯sd̥ə
liberalisme	lib̥əʁɑlismə
aorist	ɑwʁisd̥
digt	d̥eɡ̊d̥
kræset	kʰʁ̥ɛˀsəð
korset	kʰɒsəd̥
stil	stˢiːˀl
otte	ʌd̥ə
fornuft	fʌnɔfd̥
dels	d̥eˀls
rive	ʁiːʋə
kanel	kʰaneːˀl
ihukomme	ihuˀkʰʌmˀə
valkyrie	valkʰyɐ̯ˀiə
lam	lɑmˀ
spas	sb̥æːˀs
banegård	b̥æːnəɡ̊ɒˀ
genlæse	ɡ̊ɛnlɛːˀsə
grund	ɡ̊ʁɔnˀ
helgen	hɛlˀjən
hvornår	vɒnɒːˀ
sulten	sulˀd̥ən
afholdtes	ɑwhʌlˀd̥əs
spredt	sb̥ʁɛˀd̥
andefedt	anəfed̥
vindbøjtel	ʋenb̥ʌjˀd̥əl
kruse	kʰʁ̥oːsɘ
artikel	ɑtˢiɡ̊əl
vande	vanə
rødlos	ʁœðˠlʌs
treti	tˢʁ̥ɛtˢi
tolv	tˢʌlˀ
vist	ʋiˀsd̥
basket	b̥ɑːsɡ̊əd̥
skred	sɡ̊ʁæðˀ
mørne	møɐ̯nə
stræben	sd̥ʁæːb̥m̩
kul	kʰuˀl
værdig	ʋaɐ̯d̥i
agern	æˀɐn
forrådende	fʌʁɔˀð̩nə
brystvorte	b̥ʁœsd̥vɒːd̥ə
bedrøvede	b̥ed̥ʁœˀʋð̩ð̩
herskerne	hæɐ̯sɡ̊ɐnə
enke	ɛŋɡ̊ə
glamour	ɡ̊lamɒ
band	b̥æːnd̥
starte	sd̥ɑːd̥ə
paris	pʰɑʁiˀs
total	tˢotˢal
hjulpne	jɔlb̥nə
flygel	flyːˀəl
flygtning	fløɡ̊d̥neŋ
udlejer	uðlɑjˀɐ
flåde	flɔðð̩
trick	tˢʁɛɡ̊
bersærk	b̥æɐ̯sæɐ̯ɡ̊
af	æːˀ
middelmådig	miðˀəlmɔːˀði
nevada	nevɛːtæ
magasin	mɑɡ̊asiːˀn
ilte	ild̥ə
ildebrand	iləb̥ʁɑnˀ
tåge	tˢɔːʊ
tager	tˢæːjɐ
talte	tˢald̥ə
tænkt	tˢɛŋˀd̥
tortere	tˢɒtˢeːˀɐ
polsk	pʰoːˀlsɡ̊
falsk	falˀsɡ̊
forsørger	fɒsɶɐ̯ˀwɐ
hinder	henˀd̥ɐ
tal	tˢæˀl
krævet	kʰʁ̥æwð̩
ligeledes	liːəleːðˠəs
nogle	noən
ode	oːðə
bueskytte	b̥uəsɡ̊ød̥ə
nominativ	nominatˢiwˀ
skarpskytte	sɡ̊ɑːb̥sɡ̊ød̥ə
chauffør	ɕoføˀɐ̯
læse	lɛːsə
egn	ɑjˀn
tugt	tˢɔɡ̊d̥
kronprins	kʰʁ̥oːˀnpʰʁ̥ɛnˀs
kok	kʰʌɡ̊
lig	liˀ
samfund	sɑmfɔnˀ
flad	flæˀð
eneste	eːnəsd̥ə
prøve	pʰʁ̥œːʋə
fiskehandler	fesɡ̊əhanˀlɐ
firsindstyve	fiɐ̯ˀsn̩stˢyːʋə
spelt	sb̥ɛlˀd̥
tigger	tˢeɡ̊ɐ
fordøje	fʌdʌjˀə
biddet	b̥iðˀð̩
oprindelse	ʌbʁænˀl̩sə
gulve	ɡ̊ɔlvə
fugl	fɑʊ̯ːl
savne	sɑwnə
sørget	sɶɐ̯wəð
nå	nɔˀ
kasserolle	kʰasəʁʌlə
væsen	vɛˀsən
sønner	sœnɐ
tyran	tˢyʁɑn
bombes	b̥ɔmb̥əs
putte	pʰud̥ə
grøn	ɡ̊ʁɶnˀ
uomgængelig	ʌmɡ̊ɛŋˀli
tvær	tˢʋ̥ɛˀɐ̯
revne	ʁæwnə
lider	liðˀɐ
pædagog	pʰɛd̥aɡ̊oˀ
sukker	sɔɡ̊ɐ
anciennitet	ɑŋɕənitˢeːˀd̥
bred	b̥ʁæð
nairobi	najʁoːb̥i
margrethe	mɑɡ̊ʁæːˀd̥ə
bytte	b̥yd̥ə
frys	fʁ̥yːˀs
hurtig	huɐ̯d̥i
arrest	aʁɑsd̥
selvisk	sɛlˀvisɡ̊
faktisk	fɑɾisɡ̊
slagen	sl̥æːjən
forbyd	fɒb̥yðˀ
behov	b̥ehʌw
eksamen	eɡ̊sæːmm̩
negl	nɑjˀl
kræsen	kʰʁ̥æːsn̩
italien	itˢæˀljən
umbra	ɔmb̥ʁɑ
bombardement	b̥ɔmb̥ɑd̥əmɑŋ
spændende	sb̥ɛnn̩nə
strøm	stχœmˀ
rense	ʁansə
tape	tˢɛjb̥ə
brædder	b̥ʁɑðɐ
hjul	juːˀl
torsdag	tˢɒˀsd̥a
koloenorm	kʰoloenɑːˀm
dyd	d̥yˀð
brod	b̥ʁʌð
kørsel	kʰøɐ̯ˀsl̩
røg	ʁʌjˀ
vind	ʋenˀ
spænde	sb̥ɛnə
cellofan	sɛlofæːˀn
brynje	b̥ʁønjə
synke	søŋɡ̊ə
uvægerlig	uʋɛɐ̯ˀli
kryddernellike	kʰʁ̥œðɐnelˀeɡ̊ə
klog	kʰlɔːˀw
ræk	ʁɑɡ̊
brite	b̥ʁid̥ə
stuve	sd̥uːu
ragelse	ʁɑːwl̩sə
kærte	kʰæɐ̯d̥ə
ejerløs	ɑjɐløːˀs
taltes	tˢæːld̥əs
bilde	b̥elə
nøddeskal	nøðəsɡ̊alˀ
græsk	ɡ̊ʁasɡ̊
palaver	pʰalæˀwɐ
lavede	læːwð̩ð̩
menneske	mɛnsɡ̊ə
menneske	mɛnn̩sɡ̊ə
legemlige	lɛːɪmlii
lakaj	lakʰɑjˀ
hyrde	hya̯d̥ə
fortrække	fʌtˢʁ̥aɡ̊ə
sendte	sɛnd̥ə
statelig	sd̥æːd̥əli
pig	pʰiɡ̊
hoved	hoːð̩
folk	fʌlˀɡ̊
pulvere	pʰɔlˀvɐɐ
irritabel	iɐ̯itˢæːˀb̥əl
besættelse	b̥esɛd̥əlsə
sørg	sɶɐ̯ˀwə
turkis	tˢyɐ̯kʰiːˀs
boykotte	b̥ʌjkʰʌd̥ə
gidet	ɡ̊iːðəd̥
tilværelse	tˢelʋaɐ̯ˀlsə
fortælle	fʌtˢɛlˀə
geværild	ɡ̊eʋɛˀɐ̯ilˀ
koldt	kʰʌlˀd̥
flakon	flakʰʌŋ
adverbium	að̠ˠʋæɐ̯ˀb̥jɔm
hjald	jalˀ
fremmede	fʁɑməðə
frikvarter	fʁɛɡ̊ʋɑtˢeɐ̯ˀ
dolk	d̥ʌlɡ̊
dagligvarer	d̥ɑwliʋɑːɑ
vækkelse	vɛɡ̊əlsə
betyde	betyˀðə
finger	feŋɡ̊eːˀɐ̯
ledestjerne	leːðəsd̥jæɐ̯nə
pincet	pʰensɛd̥
jasmin	ɕasmiːˀn
lægerne	lɛːɐnə
pjece	pʰj̊ɛːsə
pizza	pʰid̥sa
lektie	lɛɡ̊ɕə
ad	a
æ	ɛːˀ
stækket	sd̥ɛɡ̊əð
sommer	sʌmɐ
fare	fɑːɑ
kolos	kʰolʌs
palæstinensisk	pʰaləsd̥inɛnˀsisɡ̊
klient	kʰliɛnˀd̥
støber	sd̥øːb̥ɐ
talte	tˢalˀd̥ə
bådhus	b̥ɔðˠhuːˀs
muldvarpen	mulʋɑːb̥ən
altan	altˢæːˀn
sleb	slewˀ
altid	alˀtˢið
grævling	ɡ̊ʁɛwleŋ
vordede	ʋɒːd̥ð̩ð̩
gul	ɡ̊uːˀl
røræg	ʁœ̞ɐ̯ɛːˀɡ̊
tør	tˢøɐ̯ˀ
mønstre	mønsd̥ʁɐ
pålæg	pʰʌlɛˀɡ̊
burdet	b̥oɐ̯d̥əð
æts	ɛd̥s
fjor	fjoˀɐ̯
frygtsom	fʁœɡ̊d̥sʌmˀ
valgt	ʋalˀd̥
fornemme	fʌnɛmˀə
finger	feŋˀɐ
snog	snoːˀ
bunden	b̥ɔnən
kvaj	kʰʋ̥ɑj
kunnen	kʰunən
brændte	b̥ʁand̥ə
blottet	b̥lʌd̥əð
bær	b̥aɐ̯
sutte	sud̥ɘ
kim	kʰiːˀm
tage	tˢæːjə
bedrøvede	b̥ed̥ʁœðˀð̩ð̩
omkring	ʌmkʁɛ̝ŋ
ja	jæɐ̯
hjelm	jɛlˀm
smålig	smʌli
faste	fasd̥ə
rir	ʁiːˀɐ̯
bredders	b̥ʁæðɐs
omgås	ʌmɡ̊ɔˀs
kogger	kʌwˀɐ
svar	sʋ̥ɑˀ
aftener	ɑfnɐ
filippinsk	filipʰiːˀnsɡ̊
øjet	ʌðð̩
kys	kʰyːˀs
tempo	tˢɛmpʰo
fødsel	føsl̩
sygeplejerske	syːypʰl̥ɑjˀɐsɡ̊ə
kage	kʰæːæ
dysfori	dysfoʁiˀ
brise	b̥ʁiːsə
karikatur	kʰɑikʰatˢuɐ̯ˀ
givende	ɡ̊iːʊnə
bedrøvet	b̥ed̥ʁœðˀð̩
knusende	kʰnuːsənə
gris	ɡ̊ʁis
kværke	kʰvæɐ̯ɡ̊ə
afart	ɑʊ̯ɑːˀd̥
stod	sd̥oˀ
mærke	maɐ̯ɡ̊ə
bøflen	b̥øflən
brygge	b̥ʁœɡ̊ə
fluks	flɔɡ̊s
blad	b̥laːˀð
honning	hʌneŋ
troende	tˢʁ̥oːonə
svigerinde	sʋ̥iɐenə
lemmen	lɛmˀm̩
færing	fɛːɐ̯eŋ
uret	uˀɐð
band	b̥ænˀ
væd	vɛðˀ
blod	b̥loˀð
avokado	avokʰæːd̥o
kavaleri	kʰaʋləʁiˀ
ångstrøm	ʌŋsd̥ʁœmˀ
tør	tˢøˀɐ̯
dale	d̥æːlə
døm	d̥œmˀ
vente	ʋɛnd̥ə
skreven	sɡ̊ʁæwn̩
ophøre	ʌb̥høːˀɐ
ral	ʁɑlˀ
bie	b̥iːi
race	ʁɑːsə
nikke	neɡə
stedte	sd̥ɛːd̥ə
peb	pʰewˀ
søn	sœn
støje	sd̥ʌːɪ
protoindoeuropæisk	pʰʁ̥otˢoend̥oœwʁopʰɛˀisɡ̊
forulykke	fɒuløɡ̊ə
lovligt	lɒwlid̥
forliget	fʌliˀð̩
sprede	sb̥ʁæːðə
øje	ʌjə
sennep	senəb̥
aalborg	ʌlpɒːˀ
platon	pʰl̥æːtˢʌn
hittegods	hid̥əɡ̊ɔs
undtagen	ɔntˢæˀn
kysse	kʰøsə
testikel	tˢesd̥iɡ̊əl
rollespil	ʁʌləsb̥el
nørre	nɶɐ̯ɐ
frosne	fʁ̥ʌsnə
hans	hans
svær	sʋ̥ɛɐ̯ˀ
stuearrest	sd̥uːaʁɑsd̥
stryge	sd̥ʁyːə
socialdemokrati	soɕæˀld̥emokʰʁ̥ɑtˢiˀ
øreflip	øːɐfleb̥
bøffel	b̥øfəl
bredt	b̥ʁæd̥
basketballkurv	b̥ɑːsɡ̊əd̥b̥ɒːlkʰuɐ̯ˀv
fristelse	fʁɛsd̥ɭ̩sə
værge	ʋaɐ̯wə
ignorant	enjoʁɑnˀd̥
aftenerne	ɑfnɐnə
rendte	ʁɑnd̥ə
pornografi	pʰɒnoɡ̊ʁɑfiːˀ
dyse	d̥ysə
dulgte	d̥ulˀd̥ə
døv	d̥øˀʊ̯
betinge	beteŋˀə
nåede	nɔˀð̩ð̩
materiale	matˢəɐ̯iœːlə
løber	løːb̥ɐ
nyfødt	nyføˀd̥
hamborg	hɑmb̥ɒˀ
mødte	møːd̥ə
gallien	ɡ̊alˀjən
klædernes	kʰl̥ɛɐ̯nəs
sekstende	sɑɪ̯sd̥ənə
spist	sb̥iˀsd̥
badminton	b̥ad̥məntˢʌn
græd	ɡ̊ʁɑðˀ
atheniensisk	atˢeniɛnˀsisɡ̊
læg	lɛˀ
ansvar	ansʋ̥ɑˀ
al	al
båd	b̥ɔðˀ
surströmming	suɐ̯sd̥ʁɶmeŋ
ihjel	ijɛl
elleve	ɛlvə
spejlæg	sb̥ɑjlɛˀɡ̊
fjer	fjeˀɐ̯
slående	sl̥ɔːɔnə
fly	flyˀ
hittepåsom	hid̥əpʰɔˀsʌmˀ
kræs	kʰʁ̥ɛˀs
lager	læˀjɐ
hyttede	hyd̥ð̩ð̩
bedrøve	b̥ed̥ʁœwˀʊ
berette	b̥eʁad̥ə
skårne	sɡ̊ɒːnə
valsen	valˀsn̩
gemmested	ɡ̊ɛməsd̥ɛð
kødet	kʰøðˀəd̥
flyvestation	flyːʊsd̥aɕoˀn
hærgede	haɐ̯wəðə
værd	ʋɛˀɐ̯
kondom	kʰɔnd̥oːˀm
gamer	ɡ̊ɛjmʌ
brødflov	b̥ʁœðflɒwˀ
lej	lɑjˀ
geder	ɡ̊eːðɐ
udeblevne	uːðəb̥lewˀnə
reel	ʁiːl
tage	tˢæːæ
mistelten	misd̥əltˢeːˀn
svøbte	sʋøb̥d̥ə
æbletræ	ɛːb̥lətˢʁɛːˀ
stykke	sd̥øɡ̊ə
schweiz	sʋɑjˀd̥s
hin	hin
håndværker	hʌnʋaɐ̯ɡ̊ɐ
voven	ʋɔːʋn̩
fald	falˀ
manuskript	manusɡ̊ʁɛb̥d̥
sparsomt	sb̥ɑːsʌmˀd̥
breddens	b̥ʁæðˀn̩s
hittegodskontor	hid̥əɡ̊ɔskɔntˢoɐ̯ˀ
kraft	kʰʁ̥ɑfd̥
ytre	yd̥ʁɐ
anerkende	anɐkʰɛnˀə
hyle	hyːlə
ofte	ʌfd̥ə
arme	ɑmeːˀ
af	a
gilde	ɡ̊ilə
land	lanˀ
rædsel	ʁɑðˀsɭ̩
fælled	fɛlð̩
stønne	sd̥œnə
bede	b̥eðð̩
fuldkommen	fulkʰʌmˀən
kvælende	kʰʋ̥ɛːlənə
anordning	anɒˀd̥neŋ
cykle	syɡ̊lə
rumænsk	ʁumɛːˀnsɡ̊
ærkeengel	æɐ̯ɡ̊əɛŋəl
bordeaux	b̥ɒd̥o
malm	malˀm
jage	jæːɪ
styg	sd̥yɡ̊
münchen	mønˀɕən
tandpasta	tˢanpʰasd̥a
gulvet	ɡ̊ɔlˀəð
tråd	tˢʁ̥ɔðˀ
løb	løˀb̥
halvtredsindstyvende	haltˢʁ̥æsn̩stˢyːʋənə
pule	pʰuːlə
fængsel	fɛŋˀsl̩
pils	pʰiːˀls
hint	hiˀnd̥
sved	sʋeðˀ
biord	b̥ioɐ̯ˀ
accenter	ɑɡ̊sɛnˀd̥ɐ
fjendtlig	fjend̥li
eddikesur	æðɡ̊əsuɐ̯ˀ
krone	kʰʁ̥oːnə
emballage	ɛmb̥alæːɕə
krammer	kʁ̥ɑmɐ
glansbillede	ɡ̊lanˀsb̥eləðə
kul	kʰɔl
værktøj	vaɐ̯ɡ̊tˢʌj
vaskebjørn	vasɡəbjɶɐ̯ˀn
krydre	kʰʁ̥yðʁɐ
kurv	kʰuɐ̯ˀw
synlighed	syːnliheðˀ
ferie	feɐ̯ˀjə
lyserød	lysəʁœðˀ
fremmede	fʁaməðə
fremmed	fʁɑmð̩
uværdig	uʋaɐ̯d̥i
hunnen	hunˀn̩
grise	ɡ̊ʁisə
brødet	bʁœðˀð̩
alvorlig	alvɒːˀli
lykkelig	løɡ̊əli
bakke	b̥ɑɡ̊ə
belysning	b̥elyˀsneŋ
påklædning	pʰʌkʰl̥ɛðˀneŋ
dræbte	d̥ʁɑb̥d̥ə
hamstrer	hɑmsd̥ʁɐ
mælkebøtte	mɛlɡ̊əb̥ød̥ə
ur	uɐ̯ˀ
ejendom	ɑːɪnd̥ʌmˀ
værgede	ʋaɐ̯wəðə
ved	ʋeðˀ
sende	sɛnə
regne	ʁɑjnə
troet	tˢʁ̥oˀð̩
løn	lœnˀ
mangle	mɑŋlə
klapvogn	kʰlɑb̥vɔwˀn
for	foˀɐ̯
gylle	ɡ̊ylə
karnap	kanɑb̥
lut	lud̥
ekstraordinær	ɛɡ̊stˢʁ̥ɑɒd̥inɛɐ̯ˀ
amalie	amæːˀljə
retten	ʁad̥n̩
plombere	pʰl̥ɔmb̥eːˀɐ
forsoning	fʌsoˀneŋ
gavmild	ɡɑwmilˀ
drive	d̥ʁiːʊ
die	d̥iːə
rede	ʁæˀ
mord	moɐ̯ˀ
pølse	pʰølsə
skilling	sɡ̊elˀeŋ
rød	ʁœˀð
vågede	ʋɔwð̩ð̩
trævl	tˢʁ̥awˀl
have	hæˀ
levnedsmiddel	lɛwnð̩smiðˀl̩
fluorescens	fluɐɛsɛnˀs
ødipuskompleks	øˀd̥ipʰuskʰʌmpʰl̥ɛɡ̊s
indspist	ensb̥iːˀsd̥
løbet	løˀb̥əð
kun	kʰɔn
hård	hɒˀ
resurse	ʁɛsuɐ̯sə
skrækkelig	sɡ̊ʁaɡ̊əli
tænder	tˢɛnɐ
aftnen	ɑfnən
stor	sd̥oɐ̯ˀ
dræbte	d̥ʁab̥d̥ə
mage	mæːjə
hen	hɛn
talord	tˢaloɐ̯ˀ
ukrudt	ukʰʁ̥od̥
igennem	iɡ̊ɛmˀm̩
fortolkning	fʌtˢʌlˀɡ̊neŋ
laps	lɑb̥s
trompeter	tˢʁ̥ɔmpʰed̥ɐ
mave	mæːʊ
stirre	sd̥iːɐ
blive	b̥liːʊ
hundrede	hunɐðə
finger	feŋɡ̊eɐ̯ˀ
gulvenes	ɡ̊ɔlvənəs
knud	knuðˀ
byrde	b̥yɐ̯d̥ə
slagen	sl̥æːæn
øde	øðð̩
tyve	tˢyːʊ
gengælde	ɡ̊ɛnɡ̊ɛlˀə
boet	b̥oˀð̩
grisede	ɡ̊ʁisəðə
væren	ʋɛːɐn
halvfemte	halfɛmd̥ə
gymnasium	ɡ̊ymnæːˀɕɔm
mulig	muːli
kuriøs	kʰuɐ̯iøːˀs
galge	ɡ̊aljə
værterne	væɐ̯d̥ɐnə
perfektionist	pʰæɐ̯fəɡ̊ɕonismə
livegen	liweˀen
tvedragt	tˢʋ̥ed̥ʁɒɡ̊d̥
lemmer	lɛmɐ
tager	tˢɑˀ
hen	hɛnˀ
ribbenssteg	ʁib̥ensd̥ɑjˀ
olav	olɑwˀ
vover	ʋɔwɐ
kiks	kʰiɡs
ubrugelig	ub̥ʁoːˀli
søgte	søɡ̊d̥ə
europæisk	ɛwʁopʰɛˀisɡ̊
vogte	ʋʌɡ̊d̥ə
finder	fenɐ
høvl	hœwˀl
leven	lɛfn̩
nåde	nɔðð̩
tal	tˢal
kører	kʰøɐ̯ˀ
nå	nʌ
børnene	b̥ɶɐ̯ˀnnə
legeme	lɛːɪmə
farvel	fʌvɛl
karisma	kʰɑʁisma
findes	fenəs
vakte	ʋɑɡ̊d̥ə
toilet	tˢoalɛd̥
gemmer	ɡ̊ɛmɐ
trældom	tˢʁ̥ald̥ʌmˀ
mørbrad	møɐ̯ˀb̥ʁɑð
anholdelse	anhʌlˀəlsə
nabo	næːb̥o
relativ	ʁɛlatˢiʊ̯ˀ
sygehus	syːyhuˀs
primær	pʰʁ̥iːmɛɐ̯ˀ
skabning	sɡ̊æːb̥neŋ
optræder	ʌb̥tˢʁ̥ɛˀðɐ
stresset	sd̥ʁɑsəð
hvisken	ʋesɡ̊ən
en	en
skov	sɡ̊ɒwˀ
bulgarer	b̥ulɡ̊ɑːˀɑ
mut	mud̥
fængsle	fɛŋslə
træt	tˢʁ̥ad̥
fæ	fɛˀ
pind	pʰenˀ
ordsprog	oɐ̯sb̥ʁɔˀw
abbedi	ab̥ed̥iˀ
kyklop	kʰykʰl̥oˀb̥
laver	lɑwˀɐ
afholdes	ɑwhʌlˀəs
interessere	entˢʁ̥ɐseˀɐ
sød	søðˀ
alvorligt	alvɒːˀlid̥
magre	mæːʁʌ
unik	juniɡ̊
hængte	hɛŋˀd̥ə
sparsom	sb̥ɑːsʌmˀ
helgen	hɛljən
intelligent	entˢeliɡ̊ɛnˀd̥
bid	b̥ið
harmoni	hɑmoniˀ
forhøjelse	fʌhʌjˀəlsə
politiker	pʰolid̥iɡ̊ɒ
meget	mɑðð̩
navneord	nɑwnəoɐ̯ˀ
vovede	ʋɔwð̩ð̩
tumult	tˢumulˀd̥
athenæer	atˢenɛˀɐ
hjelme	jɛlˑm̩
pålagte	pʰʌlɑɡ̊d̥ə
memorere	memoʁeːˀɐ
rimelig	ʁiːməli
tut	tˢud̥
hår	hɒˀ
skak	sɡ̊ɑɡ̊
vejret	ʋɑjʁɐð
uskreven	usɡ̊ʁæwˀn̩
stige	sd̥iːə
hindbær	henb̥æɐ̯
lodden	lʌðən
sproget	sb̥ʁɔwˀəð
laurbær	lɑwˀɐb̥aɐ̯
sagte	sæːɡdə
enten	ɛnd̥n̩
gifte	ɡ̊ifd̥ə
krævede	kʰʁ̥æðð̩
mælken	mɛlɡ̊ən
værgens	ʋaɐ̯wəns
bestå	b̥esd̥ɔˀ
øgenavn	øːjənɑwˀn
sigte	seɡ̊d̥ə
fugl	fou̯ːˀl
rov	ʁɒw
fyraften	fyɐ̯ɑfd̥n̩
sølvbryllup	sølb̥ʁœ̞lʌb̥
livsforsikring	liʊ̯sfʌseɡ̊ʁɛŋ
børen	b̥øˀɐn
knus	kʰnuːˀs
unødvendige	unøðʋɛnˀd̥ii
vordet	ʋɒːd̥ð̩
pagaj	pʰɑɡ̊ɑjˀ
lyst	lyˀsd̥
halvfemsindstyve	halfɛmˀsn̩stˢyːʋə
løber	løˀb̥ɐ
søstrene	søsd̥ʁɐnə
slavisk	slæˀʋisɡ̊
gram	ɡ̊ʁɑmˀ
kryddersild	kʰʁ̥yðɐsilˀ
lide	liːðə
tykkes	tˢœwˀs
klokkeren	kʰlʌɡ̊əʁæːˀn
ulige	uliːə
periferi	pʰeɐ̯ifeʁiːˀ
madding	maðeŋ
adgangskode	aðɡ̥ɑŋskʰoːðə
vrag	vʁɑːˀw
ståsted	sd̥ɔːˀsd̥ɛð
bastard	b̥asd̥ɑːˀ
salig	sæːli
ernst	ænsd̥
værn	ʋaɐ̯ˀn
ordbog	oɐ̯b̥ɔˀw
ilde	ilə
skød	sɡ̊øðˀ
besjælet	b̥eɕɛˀləð
ånden	ʌnn̩
hundekold	hunəkʰʌlˀ
træf	tˢʁ̥ɑf
flyve	fl̥yːʋə
lægt	lɛɡ̊d̥
træffer	tˢʁ̥ɑfɐ
bedyre	b̥ed̥yˀɐ
trekke	tˢʁ̥aɡ̊ə
vid	ʋiðˀ
orden	ɒˀd̥n̩
frankisk	fʁɑŋˀɡ̊isɡ̊
krydderbolle	kʰʁ̥œðɐb̥ʌlə
synder	sønɐ
nitte	ned̥ə
muldvarp	mulʋɑːb̥
probat	pʰʁ̥ob̥æːˀd̥
hingst	heŋˀsd̥
misbruge	misbʁuˀə
skjald	sɡ̊jalˀ
mobilisering	mobiliseˀɐ̯eŋ
tidlige	tˢiðlii
brad	b̥ʁɑð
glædelig	ɡ̊lɛːðəli
rørig	ʁœ̞ːɐ̯i
kvartets	kʰʋ̥ɑtˢɛd̥s
bringe	b̥ʁæŋə
dom	d̥oˀm
mutter	mud̥ɐ
dulgte	d̥uld̥ə
børnesygdom	b̥œ̞ɐ̯nəsyːd̥ʌm
lysning	lyːsneŋ
hvisken	ʋesɡ̊ŋ̩
rytter	ʁyd̥ɐ
bekenden	b̥ekʰɛnˀn̩
hverandre	ʋɛɐ̯ɑnd̥ʁɐ
oplyse	ʌb̥lyˀsə
bønnen	b̥œnən
stryge	sd̥ʁyːy
lun	luːˀn
jegernes	jɑjˀɐnəs
slags	sl̥ɑɡs
cowboyder	kʰɒwb̥ʌjˀd̥ɐ
ægtefælle	ɛɡ̊d̥əfɛlə
jomfruelig	jʌmfʁuˀuli
fyrretyve	fɶɐ̯ɐtˢyːʋə
stedmor	sd̥ɛmoɐ̯
ragede	ʁɑwð̩ð̩
sø	søˀ
røves	ʁœːʊs
trætte	tˢʁ̥ad̥ə
udadvendt	uðˀaðvɛnˀd̥
haler	hæːˀlɐ
figen	fiːin
europæer	ɛwʁopʰɛˀɐ
faldgrube	falɡ̊ʁuːb̥ə
frossent	fʁ̥ʌsn̩d̥
spyt	sbød
bat	b̥ad̥
rædsom	ʁɑðsʌmˀ
pilgrim	pʰilɡ̊ʁɛm
småt	smʌd̥
tiende	tˢiːinə
ræd	ʁaðˀ
kæp	kʰɛb̥
værst	ʋaɐ̯sd̥
ådsel	ʌðˀsl̩
fornem	fʌnɛmˀ
synes	syːnəs
feje	fɑːjə
oldtidskundskab	ʌltˢiðskʰɔnsɡ̊æˀb̥
forbyder	fɒb̥yˀðɐ
hankat	haŋkʰad̥
rosé	ʁose
rig	ʁɛɡ̊
bidder	b̥iðɐ
svigersøn	sʋ̥iˀɐsœn
pittoresk	pʰitˢoʁæsɡ̊
jord	joɐ̯ˀ
skændes	sɡ̊ɛnˀəs
børnepornografi	b̥œɐ̯nəpʰɒnoɡ̊ʁɑfiːˀ
hoben	hoˀb̥m̩
gårsdag	ɡ̊ɑːsd̥æːˀ
nikolaj	neɡ̊olaɪ̯
styrbord	sd̥yɐ̯b̥oːˀɐ̯
børnenes	b̥ɶɐ̯ˀnnəs
definerlig	defineɐ̯ˀli
uddateret	uðd̥atˢeːˀɐð
spor	sb̥oːˀɐ̯
kom	kʰʌmˀ
amerikaner	ɑmʁikʰæːnɐ
blottelse	b̥lʌd̥əlsə
drømme	d̥ʁɶmə
læst	lɛsd̥
gammeldansk	ɡ̊ɑml̩d̥anˀsɡ̊
irer	iˀɐ
vågner	ʋɔwnɐ
imitere	imitˢeˀɐ
bratsch	b̥ʁɑːˀd̥ɕ
reol	ʁæjoˀl
spøg	sb̥øˀ
korrigere	kʰɒiɡ̊eːˀɐ
rygte	ʁœɡ̊d̥ə
charabanc	ɕɑɑb̥ɑŋ
forbydes	fɒb̥yðˀəs
timer	tˢɑjmɐ
lokale	lokʰæːlə
pebet	pʰeːb̥əð
omgåedes	ʌmɡ̊ɔˀð̩s
ypsilon	yb̥silʌn
pseudonym	sœwd̥onyːˀm
mødes	møːðəs
lygte	løɡ̊d̥ə
ændringsforslag	ɛnd̥ʁeŋsfɒːsl̥æˀj
odense	oðˀn̩sə
slige	sliːi
landsby	lanˀsb̥yːˀ
flueknepperi	fl̥uːəkʰneb̥ɐʁiːˀ
døbte	d̥øb̥d̥ə
skabe	sɡ̊æːʊ
træde	tˢʁ̥aðð̩
sværm	svæɐ̯ˀm
jernbanefløjl	jæɐ̯nb̥ænəflʌjˀl
iver	iːˀwɐ
nødtørftig	nøðtˢɶɐ̯fd̥i
trapez	tˢʁ̥ɑpɛd̥s
apostrof	ab̥osd̥ʁʌf
skære	sɡ̊ɛːɐ
styret	sd̥yːɐð
trænet	tˢʁ̥æˀnð̩
støbt	sd̥øb̥d̥
klædtes	kʰl̥ɛːd̥əs
peberkværn	pʰeʊ̯ɐkʰʋæɐ̯ˀn
fingerbøl	feŋɐb̥øl
trussel	tˢʁusəl
drømmeverdenen	d̥ʁɶməʋaɐ̯d̥nən
ordblind	oɐ̯b̥lenˀ
avlede	ɑwləð̩
tude	tˢuːðə
heliotrop	heliotˢʁ̥oːˀb̥
hendes	hinn̩s
saml	sɑml
høns	hœnˀs
horehus	hoːɐhuːˀs
bjælde	b̥jɛlə
nødt	nøðˀ
bøsse	b̥øsə
mjød	mjøð
vantro	vantˢʁ̥oːˀ
kriminel	kʰʁiminɛlˀ
tilfreds	tˢefʁɛs
støb	sd̥øˀb̥
klædte	kʰl̥ɛˀd̥ə
øv	œːw
sagtne	sɑɡ̊d̥nə
mangt	mɑŋˀd̥
eventyrlig	ɛwn̩tˢyɐ̯ˀli
forkert	fʌkʰeɐ̯ˀd̥
leg	lɑjˀ
lav	lɑw
bandage	b̥and̥æːɕə
chauffør	ɕoføɐ̯ˀ
hammer	hɑmɐ
pilgrim	pʰiːlɡ̊ʁɛmˀ
øst	øˀsd̥
regler	ʁæˀlɐ
freden	fʁ̥æˀðn̩
resumere	ʁæsymeːˀɐ
anfange	anfɑŋˀə
tillade	tˢelæːˀð̠ˠə
synlig	syːnli
pumpe	pʰɔmb̥ə
vægte	ʋɛɡ̊d̥ə
rigt	ʁiɡ̊d̥
camper	kʰɑmpʰeːˀɐ̯
smørelse	smɶːʌlsə
kvæld	kʰʋ̥ɛlˀ
hæve	hɛːwə
værgets	ʋaɐ̯ʊðs
patte	pʰad̥
landskab	lansɡ̊aːˀb̥
uheldig	uhɛlˀd̥i
grim	ɡ̊ʁɛmˀ
fodboldspiller	foðb̥ʌlsb̥elɐ
lært	lɛɐ̯ˀd̥
cykel	siɡ̊l̩
skrive	sɡ̊ʁiːʋə
hvem	ʋɛmˀ
charmere	ɕɑmeˀɐ
læg	lɛˀɡ̊
september	sɛb̥tˢɛmˀb̥ɐ
piller	pʰelɐ
klædende	kʰl̥ɛˀənə
parti	pʰatˢiːˀ
tysk	tˢysɡ̊
føn	føːˀn
kogt	kʰʌɡ̊d̥
fortov	fɒːtˢɔw
tegnefilm	tˢɑjnəfilˀm
båre	b̥ɒːɒ
kørt	kʰøɐ̯ˀd̥
forfatte	fɒfad̥ə
hævngerrig	hɛwnɡ̊æɐ̯ˀi
børe	b̥øːɐ
held	hɛlˀ
nytårsaften	nyd̥ʌsɑfd̥ən
kvartetten	kʰʋ̥ɑtˢɛd̥ən
diagonal	d̥iaɡ̊onæːˀl
van	væːˀn
martyr	mɑːtˢyɐ̯ˀ
færd	fɛˀɐ̯
vovedes	ʋɔwð̩ð̩s
peg	pʰɑjˀ
mund	mɔnˀ
hvidt	vid̥
rådyr	ʁʌd̥yɐ̯ˀ
spøgelse	sb̥øːjɭ̩sə
kærlighed	kaɐ̯liheðˀ
daglig	d̥ɑwli
hedning	heðneŋ
udebliven	uːðəb̥liwˀən
kærne	kʰaɐ̯nə
bryder	b̥ʁyːðɐ
badet	b̥aðˀəd̥
du	d̥uːˀ
korn	kʰokwɐ
galopere	ɡ̊alopʰeːɐ
sanddru	sand̥ʁoˀ
værdiløs	ʋaɐ̯d̥iløˀs
pålægget	pʰʌlɛˀɡ̊əð
ingen	eŋŋ̩
taget	tˢɑwˀð̩
gejstlig	ɡ̊ɑjsli
snæver	snɛwˀa̯
fædrene	fɛðɐnə
låg	lɔˀw
snakke	snɑːɡ̊ə
introducere	entʁ̥od̥useːˀɐ
jættestue	jɛd̥əsd̥uːu
sejl	sɑjˀl
klæder	kʰl̥ɛɐ̯
kjole	kʰj̊oːlə
mørkning	mœ̞ɐ̯ɡ̊neŋ
udelukke	uːðəlɔɡ̊ə
bager	b̥æːɐ
væsentlig	vɛˀsn̩li
farsot	fɑːsoˀd̥
skadestue	sɡ̊æðð̩sd̥uːu
træls	tˢʁ̥ɑls
halve	halvə
gjord	ɡ̊joˀɒ̯
irland	iɐ̯lanˀ
vise	ʋiːsə
symbol	symb̥oːˀl
aktiv	ɑɡ̊tˢiwˀ
briste	b̥ʁɛsd̥ə
vuf	ʋuf
randt	ʁɑnˀd̥
råbt	ʁʌb̥d̥
rose	ʁoːsə
stikke	sd̥eɡ̊ə
menneskene	mɛnsɡ̊nə
skjold	sɡ̊jʌlˀ
alen	æːln̩
åg	ɔːˀw
jernbaneoverskæring	jæɐ̯nb̥æːnəɒʊ̯ʌsɡ̊ɛɐ̯ˀeŋ
stækker	sd̥ɛɡ̊ɐ
lommetørklæde	lʌmətˢɶɐ̯kʰl̥ɛːðə
rase	ʁɑːsə
soludbrud	soːluð̠ˠb̥ʁuð̠ˠ
bur	b̥uɐ̯ˀ
stege	sd̥ɑjə
gyde	ɡ̊yːðə
fornem	fɒːnɛmˀ
tryk	tˢʁ̥œɡ̊
kejthåndet	kʰɑjd̥hʌnˀəð
miljø	miljø
tretten	tˢʁ̥ad̥n̩
tør	tˢɶɐ̯ˀ
kirtel	kiɐ̯dəl
uskreven	usɡ̊ʁæˀʋn̩
vølve	vœlvə
mange	mɑŋə
røven	ʁœːʊn
stikkelsbær	sd̥eɡ̊əlsb̥æɐ̯
kvarter	kʰʋ̥ɑːd̥ɐ
drog	d̥ʁowˀ
krukke	kʰʁɔɡ̊ə
opsigt	ʌb̥seɡ̊d̥
kastel	kʰasd̥ɛlˀ
retter	ʁɑd̥ɐ
vovede	ʋɔːʋð̩ð̩
oliven	oliwˀn̩
bæ	b̥ɛːˀ
efter	ɛfd̥ɐ
løkke	løɡ̊ə
stue	sd̥uːu
høne	hœːnə
beskrive	b̥esɡ̊ʁiˀʋə
forsømme	fʌsœmˀə
læge	lɛːɪ
forbyden	fɒb̥yˀðən
kredsen	kʰʁ̥ɛːˀsn̩
træl	tˢʁ̥alˀ
lille	lill̩
skrævet	sɡ̊ʁawˀəð
fluor	fluːɐ
varsom	vɑːsɒmˀ
kæreste	kʰaːɐsd̥ə
fremmed	fʁamð̩
svoren	sʋ̥oːɐn
pokker	pʰʌɡ̊ɐ
taget	tˢæðˀð̩
neutrum	nœwtˢʁ̥ɔm
kludre	kʰluðʁɐ
ørn	œ̞ɐ̯ˀn
dreven	d̥ʁæwn̩
shampoo	ɕæːmpʰuː
bær	b̥ɛˀɐ̯
gratis	ɡ̊ʁɑːd̥is
portugisisk	pʰɒtˢuɡ̊iːˀsisɡ̊
pinje	pʰinjə
tillid	tˢeliðˀ
håbe	hɔːb̥ə
mangen	mɑŋən
bræt	b̥ʁad̥
periodisk	pʰæɐ̯ioːˀðisɡ̊
messehagel	mɛsəhæˀjl̩
ottesang	ʌd̥əsɑŋˀ
trolig	tˢʁ̥oːli
sluge	sluːə
supert	suˀb̥ɐd̥
vallak	valɑk
rejst	ʁɑjˀsd̥
låne	lɔːnə
spændets	sb̥ɛnð̩s
fjeld	fjɛlˀ
kartoffel	katˢʌfəl
smitte	smid̥ə
værk	ʋaɐ̯ɡ̊
elitær	elitˢɛːˀɐ̯
zucchini	sukʰiːni
primær	pʰʁ̥imɛːˀɐ̯
vældig	velti
arme	ɑːmə
rygrad	ʁœɡ̊ʁɑð
vist	ʋesd̥
vals	valˀs
tyggede	tˢyɡ̊əðə
skelen	sɡ̊eːlən
grundlovsdag	ɡ̊ʁɔnlɒwsdæːˀ
sørøver	søʁœ̞ːwɐ
kvit	kʰvid̥
stedfar	sd̥efɑː
indianer	ind̥ijæˀnɐ
boner	b̥ʌŋɐ
strejf	sd̥ʁɑjˀf
pokeransigt	pʰoːˀɡ̊ɐanseɡ̊d̥
strande	sd̥ʁɑnə
stjæle	sd̥jɛːlə
analsex	anæːˀlsɛɡ̊s
kusk	kʰusɡ̊
dav	d̥ɑwˀ
kløve	kʰløːvə
smage	smæːæ
sigt	seɡ̊d̥
beløb	beløːˀb̥
højre	hʌjʁɐ
primær	pʰʁ̥iːmɛːˀɐ̯
stol	sd̥oːˀl
forræderi	fʌʁɛðɐʁiˀ
hænde	hɛnə
hud	huð
højtaler	hʌjtˢæːˀlɐ
gerningssted	ɡ̊æɐ̯neŋssd̥ɛð
jeget	jɑjˀəð
trods	tˢʁ̥ʌs
tresindstyve	tˢʁ̥ɛsn̩stˢyːʋə
fængslet	fɛŋsləð
berøringsangst	pe̝ʁɶɐ̯ˀiŋsɑŋˀst
blodlegeme	b̥loðlɛːɪmə
sulten	suld̥ən
gulerod	ɡ̊uləʁoˀð
strå	sd̥ʁɔːˀ
lagte	lɑɡ̊d̥ə
vindruekerneolie	ʋind̥ʁuːəkʰæɐ̯nəoljə
varetægt	ʋɑːɑtˢɛɡ̊d̥
troposfære	tˢʁ̥ob̥ʌsfɛːɐ
samsø	sɑmˀsøːˀ
syerske	syːˀɐsɡ̊ə
dufte	d̥ɔfd̥ə
bredderne	b̥ʁæˀd̥ɐnə
angreb	anɡ̊ʁɛˀb̥
bagt	b̥ɑɡ̊d̥
smagt	smɑɡ̊d̥
sene	seːnə
urt	uɐ̯d̥
vægt	ʋɛɡ̊d̥
nektar	nɛɡ̊tˢɑːˀ
agt	ɑɡ̊d̥
frøs	fʁ̥œˀs
revolutionere	ʁɛvoluɕoneːˀɐ
vært	ʋaɐ̯d̥
marker	mɑkʰeˀɐ̯
afledte	ɑwleˀd̥ə
bæven	b̥ɛːʋən
topologi	tˢob̥oloɡ̊iːˀ
fyn	fyːˀn
synge	søŋə
storbritannien	sd̥oɐ̯b̥ʁitˢanˀjən
nicolai	neɡ̊olaɪ̯
domkirke	d̥ʌmkʰiɐ̯ɡ̊ə
fagidiot	fɑwidioˀd̥
mødtes	møːd̥əs
numre	nɔmʁɐ
hundestjernen	hunəsd̥jæɐ̯nən
fuldtallig	fultˢalˀi
epistemologi	episdəmoloɡiˀ
lås	lɔːˀs
bugne	b̥uːnə
træt	tˢʁ̥ɑd̥
gryr	ɡ̊ʁyɐ̯ˀ
besk	b̥eːˀsɡ̊
fag	fæˀ
annektering	anɛɡ̊tˢeːˀɐ̯eŋ
bor	b̥oɐ̯ˀ
scene	seːnə
race	ɹɛjs
mær	mæɐ̯ˀ
rust	ʁɔsd̥
gemte	ɡ̊ɛmˀd̥ə
anordne	anɒˀd̥nə
brændte	b̥ʁɑnd̥ə
luder	luðˀɐ
sverige	sʋ̥aɐ̯ˀjə
lave	læːʋə
kompleks	kʰʌmpʰl̥ɛɡ̊s
kanapé	kʰanapʰe
lemfældig	lɛmfɛlˀd̥i
messe	mɛsə
grad	ɡ̊ʁɑðˀ
ile	iːlə
akkumulere	ɑkʰumuleːˀɐ
ålborg	ʌlb̥ɒːˀ
værgen	ʋaɐ̯wɐn
hamstrere	hɑmsd̥ʁɐɐ
alfons	alfʌŋs
dette	d̥ɛd̥ə
forfængelig	fʌfɛŋˀŋ̩li
æter	ɛˀd̥ɐ
øjebæ	ʌːɪpeˀ
maj	mɑj
kere	kʰeːɐ
linned	lenəð
klynge	kʰløŋə
ha	hɑ
larme	lɑːm̩
antropomorf	antˢʁ̥opʰomɒːf
puddel	pʰuðˀəl
stødte	sd̥ød̥ə
frelste	fʁɑlˀsd̥ə
mørkhudet	mɶɐ̯ɡ̊huðˀəd̥
forsøgt	fʌsøɡ̊d̥
datid	d̥atˢiðˀ
kæmpehagl	kʰɛmb̥ehɑwˀl
ophobe	ʌb̥hoːb̥ə
kredse	kʰʁ̥æːsə
fløjl	flʌjˀl
kløver	kʰløːˀvɐ
knap	kʰnɑb̥
imellem	imɛlˀəm
vagtelkonge	vɑɡ̊d̥əlɡ̊ʰʌŋə
stød	sd̥øˀð̞
tolkning	tˢʌlɡ̊neŋ
kludder	kʰluðˀɐ
måttet	mʌd̥əð
tilfredsstillende	tˢefʁɛssd̥elˀənə
abstrakt	ɑpstχakt
alting	alˀtˢeŋ
jernet	jaɐ̯ˀnəð
hørfrøolie	hɶɐ̯fʁœoljə
skyter	sɡ̊yd̥ɐ
væg	ʋɛːˀɡ̊
tape	tˢɛjb̥
gnide	ɡ̊niːð̩
vrøvle	ʋʁɶwlə
procent	pʁ̥osɛnˀd̥
leverpostej	lewˀʌposdɑjˀ
offentligt	ʌfənd̥lid̥
harve	hɑːwə
ankomst	ankʰʌmˀsd̥
pund	pʰunˀ
pragt	pʰʁ̥ɑɡ̊d̥
samvær	sɑmʋɛɐ̯ˀ
gang	ɡɑ̃ˀ
værger	ʋaɐ̯wɐ
faren	fɑːɑn
bomber	b̥ɔmb̥ɐ
vilje	ʋiljə
sideordning	siːðəɒːd̥neŋ
åd	ʌˀð̞
blomstre	b̥lʌmsd̥ʁɐ
olav	olɑw
krydderbolle	kʰʁ̥yðɐb̥ʌlə
svær	sʋ̥ɛˀɐ̯
lyserødt	lysəʁœd
udyr	udyɐ̯ˀ
prosadigt	pʰʁ̥oːsad̥eɡ̊d̥
søsters	søsd̥ɐs
ignoreret	inoʁɛˀɐð
skille	sɡ̊elə
tankegods	tˢɑŋɡ̊əɡ̊ɔs
abrikos	ɑb̥ʁikʰoːˀs
våd	ʋɔðˀ
sværd	sʋɛɐ̯ˀ
kanonisere	kanoniseˀʌ
lækker	lɛɡ̊ɐ
sol	soːˀl
ful	fuˀl
hjalp	jalˀb̥
fjern	fjæɐ̯ˀn
gives	ɡ̊iˀs
italesætte	itˢæːləsɛd̥ə
vinke	viŋɡ̊ə
regler	ʁɛjˀlɐ
forårsagtig	fɒːɒsɑɡ̊d̥i
forgæves	fʌɡ̊ɛːˀvəs
ketchup	kʰɛd̥ɕub̥
overveje	ɒwɐʋɑjˀə
tun	tˢuːˀn
drømmeverdner	d̥ʁɶməʋaɐ̯d̥nɐ
tit	tˢid̥
udenlandsk	uðð̩nlanˀsɡ̊
skildpadde	sɡ̊elpʰaðð̩
lært	læɐ̯ˀd̥
billig	b̥ili
rygning	ʁyːneŋ
slæber	slɛːb̥ɐ
kvartal	kʰʋ̥ɑtˢæˀl
grene	ɡ̊ʁæːnə
tud	tˢuðˀ
maniodepressiv	mæːˀnjod̥epʰʁ̥ɛsiwˀ
fede	feːðə
kvalte	kʰʋ̥æːld̥ə
frankisk	fʁɑŋˀkʰisɡ̊
prægnant	pʰʁ̥ɛjnanˀd̥
halvmåne	halmɔːnə
sniksnak	sneɡ̊snɑɡ̊
spurgt	sb̥oɐ̯ˀd̥
ulk	ulˀɡ̊
terræn	tˢaʁaŋ
østtysk	øsd̥tˢysɡ̊
furore	fuʁoːɐ
sværd	sʋɛˀɐ̯
falde	falə
stort	sd̥oˀɐ̯d̥
kolonorm	kʰolonɑːˀm
voves	ʋɔːʋəs
nigger	neɡ̊ʌ
erstatning	aɐ̯sd̥ad̥neŋ
boner	b̥oːnɐ
ugedag	uːd̥æːˀ
kong	kʰʌŋ
stræbe	sd̥ʁæːb̥ə
imidlertid	imið̠ˠˀlʌtið̠ˠˀ
sørger	sɶːɐ
bestjæle	b̥esd̥jɛˀlə
mørkeræd	mɶɐ̯ɡ̊əʁɑðˀ
kaudervælsk	kʰɑwd̥ɐvɛlˀsɡ̊
skønne	sɡ̊œnə
arrestere	ɑɑsd̥eˀɐ
billige	b̥ilii
universitet	uniʋaɐ̯sitˢeˀd̥
seddel	sɛðˀl̩
regel	ʁæˀl
ritual	ʁituæˀl
ledning	leðneŋ
konkurs	kʰʌŋkʰuɐ̯ˀs
skotskternet	sɡ̊ʌd̥sɡ̊tˢæɐ̯ˀnəð
skod	sɡ̊ʌð
stjålet	sd̥jʌlð̩
magert	mæˀjɐd̥
gør	ɡ̊ø̞ˀɐ̯
garn	ɡ̊ɑːˀn
syvende	sywˀənə
boring	b̥oːɐ̯eŋ
kræve	kʰʁ̥æːʋə
mager	mæˀɡ̊ɐ
ligge	leɡ̊ə
uhørt	uhøɐ̯ˀd̥
forrest	fɒːˀɒsd̥
platfodet	pʰlad̥foːˀðəd̥
snakke	snɑɡ̊ə
ræve	ʁæːwə
bon	b̥oˀn
skærm	sɡ̊aɐ̯ˀm
hunner	hunˀɐ
overnatte	ɒwɐnad̥ə
ungdom	ɔŋd̥ʌm
mareridt	mɑːɑʁid̥
fred	fʁ̥æˀð
hov	hɒw
flyve	fl̥yːʊ
periskop	pʰeɐ̯isɡ̊oːˀb̥
mere	meːɐ
hendes	henəs
acetone	asətˢoːnə
ring	ʁæŋˀ
lymfe	lømfə
micelle	miselə
for	fʌ
loven	lɔˀʋn̩
vanvittig	ʋanʋid̥i
nogen	noːn
agurk	akuɐ̯k
vækkes	ʋɛɡ̊əs
kykkeliky	kʰyɡ̊əlikʰyː
palaver	pʰalɒwˀɐ
dæmon	d̥ɛmoːˀn
uartig	uɑːˀd̥i
amagerkaner	ɑmɑkæːˀnɐ
morgenmad	mɒːɒnmað
kejsersnit	kʰɑjsɐsnid̥
ydre	yðʁɐ
deres	d̥aɐs
røve	ʁɶːʊ
forhåbentlig	fʌhɔˀb̥ənd̥li
udeblive	uːðəb̥liwˀə
kreta	kʰʁ̥ɛːtˢa
smitte	smed̥ə
døber	d̥øːb̥ɐ
stjålet	sd̥jɔːlð̩
tryg	tˢʁ̥œ̞ɡ̊
bade	b̥æːðə
græde	ɡ̊ʁɑðð̩
påklædt	pʰʌkʰl̥ɛˀd̥
straf	sd̥ʁɑf
løse	løːsə
ansætte	ansɛd̥ə
velsmagende	ʋelsmɛˀɪnə
aramæer	ɑɑmɛːˀɐ
skæbne	sɡ̊ɛːb̥nə
ha	ha
tyfus	tˢyfus
kontinuitet	kʰʌntˢinuitˢeːˀd̥
god	ɡ̊oðˀ
huslig	husli
accenten	ɑɡ̊sɑŋˀŋ̩
indbilde	enb̥ilˀə
klædt	kʰl̥ɛˀd̥
magert	mæˀɐd̥
filolog	filoloˀ
gravid	ɡ̊ʁɑviðˀ
lov	lɒw
olddansk	ʌld̥anˀsɡ̊
løbe	løːb̥ə
himmelstormer	heml̩sd̥ɒːmɐ
nicolaj	neɡ̊olaɪ̯
hovedsagelig	hoːð̩sæˀli
kæmpe	kʰɛmb̥ə
bøvlet	b̥œwˀlð̩
diger	d̥iːˀɐ
panser	pʰanˀsɐ
hundreder	hunɐðɐ
fork	fɒːɡ̊
svindle	svenlə
bliver	b̥liwˀɐ
latinsk	latˢiˀnsɡ̊
utøj	utˢʌj
længtes	lɛŋd̥əs
træn	tˢʁ̥æˀn
elg	ɛlˀj
holdt	hʌlˀd̥
drog	d̥ʁɒw
værge	ʋaɐ̯ʊ
afstemning	ɑwsd̥ɛmˀneŋ
kænguru	kʰɛŋɡ̊uːʁu
veer	ʋeːˀɐ
advent	aðvɛnˀd̥
tabe	tˢæːb̥ə
forgårs	fɒːɡ̊ɒːˀs
nødvendigvis	nøðʋɛnˀd̥iʋiˀs
led	leˀð
rasmussen	ʁɑsmusn̩
grev	ɡ̊ʁæʊ
skakbrik	sɡ̊ɑɡ̊b̥ʁeɡ̊
bæger	b̥ɛːjɐ
juveler	juvɘleːˀɐ̯
stræbte	sd̥ʁɑb̥d̥ə
grænse	ɡ̊ʁansə
vorder	ʋɒːd̥ɐ
afholder	ɑwhʌlˀd̥ɐ
sakse	sɑɡ̊sə
andemad	anəmað
standard	sd̥and̥ɑːˀd̥
bed	b̥eðˀ
forbuden	fɒb̥uˀðən
glimt	ɡ̊lemˀd̥
niti	nitˢi
forbud	fɒːb̥uð
frokost	fʁ̥ɔɡ̊ʌsd
beholdtes	b̥ehʌlˀd̥əs
fjært	fjæɐ̯ˀd̥
århus	ɒːhuˀs
ræsonnere	ʁæsoneˀɐ
udsagnsord	uðsɑwnsoɐ̯ˀ
jøde	jøːð̩
encyklopædi	ɑŋsykʰlopʰəd̥iːˀ
døgn	d̥ʌjˀn
napoleonshat	napʰoːˀljʌnshad̥
drager	d̥ʁɑːwɐ
vrede	ʋʁɛːðˠə
kræfter	kʰrafd̥ɐ
cigaret	siɡ̊aʁad̥
kogger	kʌɡ̊ɐ
bronze	b̥ʁʌŋsə
økse	øɡ̊sə
vogn	ʋɒwˀn
flyver	flyˀʋɐ
træder	tˢʁ̥ɑðˀə
har	hɑˀ
erantis	eʁɑntˢis
silikone	silikʰoːnə
sølvgrå	sølɡ̊ʁɔːˀ
ha'	ha
enfold	eːnfʌlˀ
slibe	sliːb̥ə
døber	d̥øˀb̥ɐ
karakter	kʰɑɑɡ̊tˢeːˀɐ̯
sne	sneˀ
delagtig	d̥elɑɡ̊d̥i
danskere	d̥ansɡ̊ɐɐ
krævet	kʰʁ̥æðð̩
skam	sɡ̊ɑmˀ
skønlitteratur	sɡ̊œnlid̥əʁɑtˢuɐ̯ˀ
job	d̥jʌb̥
luft	lɔfd
søle	søːlə
kysk	kʰysɡ̊
ad	að
accenters	ɑɡ̊sɑŋˀɐs
skærer	sɡ̊ɛɐ̯
hovedbanegård	hoːðb̥æːnɡ̊ɒˀ
mele	meːlə
quiz	kʰvis
juridisk	juʁiˀðisɡ̊
giver	ɡ̊iːwɐ
gennem	ɡ̊ɛmˀm̩
skræddermester	sɡ̊ʁaðɐmɛsd̥ɐ
forlig	fʌliˀ
kraftværk	kʰʁ̥ɑfd̥ʋaɐ̯ɡ̊
dig	d̥ɑ
svigte	sʋeɡ̊d̥ə
troposfære	tˢʁ̥ob̥osfɛːɐ
dogme	d̥ɒwmə
østkyst	øsd̥kʰøsd̥
angstskrig	ɑŋˀsd̥sɡ̊ʁiˀ
parker	pʰɑkʰeɐ̯ˀ
undrer	ɔnd̥ʁɐ
drikkepenge	d̥ʁeɡ̊əpʰɛŋŋ̩
fjor	fjoɐ̯ˀ
fyrstedømme	fyɐ̯sd̥əd̥œmə
hjemve	jɛmveːˀ
score	sɡ̊oːɐ
grube	ɡ̊ʁuːb̥ə
kendte	kɛnd̥ə
candyfloss	kʰæːnd̥iflʌs
stridbar	sd̥ʁiðb̥ɑːˀ
blå	b̥lɔːˀ
trænge	tˢʁ̥aŋə
våde	ʋɔðð̩
pinselilje	pʰensəliljə
nyse	nyːsə
presse	pʰʁ̥asə
danefæ	d̥æːnəfɛˀ
værne	ʋaɐ̯nə
tab	tˢæwˀ
så	sɔˀ
høretelefon	høːɐtˢeləfoˀn
sørget	sɶːɐð
ir	iɐ̯ˀ
androide	and̥ʁoiːðə
butikkerne	b̥utˢiɡ̊ɐnə
lærer	læːɐ
hun	hun
lyshåret	lyshɒˀɒð
gade	ɡ̊æːðə
døtre	d̥ød̥ʁɐ
formular	fɒmulɑːˀ
hudfarve	hufɑːvə
slæbte	slɛb̥d̥ə
slæbe	slɛːʊ
fabel	fæːˀb̥əl
vagt	væˀjd̥
hinduisme	hend̥uismə
tyvende	tˢywnə
havre	hɑwʁɐ
råb	ʁɔwˀ
lugt	lɔɡ̊d̥
afskrift	awsɡ̊ʁæfd̥
dagligvarerne	d̥ɑwliʋɑːɑnə
kongeblå	kʰʌŋəb̥lɔːˀ
sprog	sb̥ʁɔwˀ
bekendelse	b̥ekʰɛnˀl̩sə
reje	ʁɑjə
tøjet	tˢʌjˀəð
campingvogn	kambeŋvɔu̯ˀn
hudløs	huðløːˀs
munken	mɔŋˀɡ̊ən
haler	hæːlɐ
hinden	henn̩
hik	heɡ̊
historie	hisd̥oɐ̯ˀjə
ferie	feɐ̯ˀiə
karle	kʰæːlə
dyne	dyːnə
tjenlig	tɕɛːnli
udvikling	uðveɡ̊leŋ
svire	sviːɐ
værnemager	ʋaɐ̯nəmæˀjɐ
takke	tˢɑɡ̊ə
pornofilm	pʰɒːnofilm
elv	ɛlˀʋ
guddom	ɡ̊uðd̥ʌmˀ
traffes	tˢʁ̥ɑfəs
styret	sd̥yˀɐð
bibliotek	bibliotˢeˀɡ
øverst	øˀʋɐsd̥
slurk	sluɐ̯ˀɡ̊
svide	sʋiːðə
komme	kʰʌmə
saften	sɑfd̥n̩
flugt	flɔɡ̊d̥
eskimoisk	ɛsɡ̊imoːˀisɡ̊
jer	jaɐ̯
krav	kʰʁ̥ɑˀw
god	ɡ̊oˀð
doktor	d̥ʌɡ̊d̥ɐ
lærerne	lɛːɐnə
vrøvlende	ʋʁɶwl̩nə
brud	b̥ʁuˀð
fed	feːˀð
afledt	ɑwleˀd̥
juletræ	juːlətˢʁ̥ɛːˀ
bryllup	b̥ʁœlɔb̥
forligelig	fʌliˀili
skæl	sɡ̊ɛlˀ
demontere	d̥emɔntˢeːˀɐ
sejle	sɑjlə
træffende	tˢʁ̥ɑfənə
rør	ʁœ̞ɐ̯ˀ
høst	høsd̥
jøde	jøːðə
tjørn	tɕɶɐ̯ˀn
pædofil	pʰɛd̥ofiːˀl
pap	pʰɑb̥
spotte	sb̥ʌd̥ə
lignelse	liːnəlsə
skaffe	sɡ̥ɑfə
ende	ɛnn̩
spredte	sb̥ʁɛːd̥ə
brugte	b̥ʁɔɡ̊d̥ə
sørg	sɶwˀ
kendetegn	kʰɛnətˢɑjˀn
onsdag	ɔnˀsd̥a
idræt	iːdʁad̥
dem	b̥m̩
fyrre	fɶɐ̯ɐ
mose	moːsə
levn	lɛwˀn
bog	b̥ɔwˀ
gale	ɡ̊æːlə
unyttig	unød̥i
ludder	luðˀɐ
kor	kʰoɐ̯ˀ
hvil	viːˀl
videnskab	ʋiðˠn̩sɡ̊æːˀb̥
indimellem	enˀimɛlˀəm
overlagt	ɒwɐlɑɡ̊d̥
magt	mɑɡ̊d̥
tappe	tˢɑb̥ə
påske	pʰɔːsɡ̊ə
fond	fʌnˀd̥
årlig	ɒːli
fotografer	fod̥oɡ̊ʁɑfeɐ̯ˀ
halvtreds	haltˢʁ̥æs
unge	ɔŋə
lakonsk	lakʰoˀnsɡ̊
flyder	flyðˀɐ
oldgræske	ʌlɡ̊ʁɑsɡ̊ə
brunche	b̥ɹʌnɕə
tæt	tˢɛd̥
bageri	b̥æɪ̯ɐʁiːˀ
ælling	ɛleŋ
chok	ɕʌɡ̊
sliber	sliːb̥ɐ
akkumulator	ɑkʰumulæːtˢɐ
allegori	aləɡ̊oʁiˀ
tøs	tˢøːˀs
søsteren	søsd̥ɐɐn
slutspurt	slud̥sb̥uɐ̯ˀd̥
et	ed̥
avle	ɑwlə
viborg	vib̥ɒˀ
henriette	hɛnʁiɛd̥ə
neje	nɑjə
interesse	entˢɐˀʁɑsə
aktie	ɑɡ̊ɕə
etage	etˢæːɕə
håndklæde	hʌŋkʰl̥ɛːðə
cykler	syɡ̊lɐ
tyr	tˢyˀɐ̯
lilje	liljə
stinkdyr	sd̥eŋɡ̊d̥yɐ̯ˀ
sandwich	sanwid̥ɕ
berette	b̥eʁɑd̥ə
spejle	sb̥ɑjlə
fiktion	fiɡ̊ɕoˀn
prøve	pʰʁ̥œːʊ
vækket	ʋɛɡ̊əð
jernene	jaɐ̯ˀnənə
ædru	ɛːd̥ʁuˀ
farao	fɑːʁɑo
sukkervand	sɔɡ̊ɐvanˀ
mæslinger	mɛsleŋɐ
række	ʁaɡ̊ə
å	ɔˀ
glo	ɡ̊loːˀ
herkomst	haɐ̯kʰʌmˀsd̥
ror	ʁoɐ̯ˀ
armhule	ɑːmhuːlə
penning	pʰɛneŋ
old	ʌlˀ
drue	d̥ʁuːə
post	pʰʌsd̥
gjord	ɡ̊joɐ̯ˀ
tommel	tˢʌml̩
sagn	sɑwˀn
højtysk	hʌjtˢysɡ̊
kilder	kʰilɐ̯
vækker	ʋɛɡ̊ɐ
sylte	syld̥ə
telefon	tˢeləfoːˀn
råer	ʁɔˀɐ
termin	tˢæɐ̯miːˀn
bord	b̥oɐ̯ˀ
gave	ɡ̊æːʋə
fjols	fjʌlˀs
vundne	vɔnnə
ler	leɐ̯ˀ
ekstra	ɛɡ̊sd̥ʁɑ
klædes	kʰl̥ɛːðəs
lever	leʋeɐ̯ˀ
propel	pʰʁ̥opɛlˀ
vej	ʋɑjˀ
veje	ʋɑjə
klage	kʰl̥æːæ
størst	sd̥ɶɐ̯sd̥
bevægelse	b̥evɛˀl̩sə
hov	hɒwˀ
pikhoved	pʰeɡ̊hoːðð̩
overlægge	ɒwɐlɛɡ̊ə
brille	b̥ʁɛlə
diplomat	d̥ipʰl̥omæːˀd̥
tjære	tɕɛːɐ
krokodilletåre	kʁɔɡədilətɒːɒ
koreansk	kʰoɐ̯eæːˀnsɡ̊
brugs	b̥ʁuˀs
offentligt	ʌfn̩lid̥
spektakel	sb̥etˢɑɡ̊əl
prioritere	pʁiɒiteˀɐ
embede	ɛmb̥eːðð̩
viske	ʋesɡ̊ə
gebrokkent	ɡ̊eb̥ʁʌɡ̊ŋ̩d̥
latin	latˢin
gensidig	ɡ̊ɛnsiðˀi
safir	safiɐ̯ˀ
naust	nɑʊ̯ˀsd̥
ivrig	iwri
drevne	d̥ʁæwnə
regnskab	ʁɑjnsɡ̊æˀb̥
romersk	ʁoˀmɐsɡ̊
væv	ʋɛˀw
glæde	ɡ̊lɛːðə
mandag	manˀd̥a
ældst	ɛlˀsd̥
køleskab	kʰøːləsɡ̊æːˀb̥
højtaler	hʌjtˢæːlɐ
haitianer	haitˢiæːˀnɐ
vågen	ʋɔːʊn
grov	ɡ̊ʁɒwˀ
pose	pʰoːsə
fotografer	fotˢoɡ̊ʁɑfeɐ̯ˀ
kommen	kʰʌmm̩
nedsættende	neðsɛd̥ənə
værste	ʋaɐ̯sd̥ə
abbedisse	ɑb̥ed̥isə
færøsk	fɛɐ̯øːˀsɡ̊
forresten	fʌʁɑsd̥n̩
løgn	lʌjˀn
yt	yd̥
niks	neɡ̊s
hornhinde	hoɐ̯nhenə
spøge	sb̥øːɪ
frivillig	fʁ̥iʋilˀi
strakt	sd̥ʁɑɡ̊d̥
skær	sɡ̊ɛɐ̯ˀ
grine	ɡ̊ʁiːnə
nørrebro	nœ̞ɐ̯ɐb̥ʁoːˀ
metodisk	metˢoːˀðisɡ̊
bøvle	b̥œwlə
juleaften	juːləɑfd̥n̩
butikker	b̥utˢiɡ̊ɐ
kransekage	kʁ̥ɑnsəkʰæːjə
forlyde	fʌlyðˀð̩
bæve	b̥ɛːvə
bekendte	b̥ekʰɛnˀd̥ə
efterspørgsel	ɛfdɐsbɶɐ̯ˀsəl
athene	atˢeːnə
svigermor	sʋ̥iˀɐmoɐ̯
ståen	sd̥ɔːən
kommer	kʰʌmˀɐ̯
fryse	fʁ̥yːsə
bekendt	b̥ekʰɛnˀd̥
står	sd̥ɒˀ
ener	eːˀnɐ
nøs	nøːˀs
spartansk	sb̥ɑtˢæˀnsɡ̊
ignorere	inoʁɛˀɐ
kulturrevolution	kʰultˢuɐ̯ˀʁɛvoluɕoːˀn
avanceret	ɑvɑŋseːˀɐð
frelser	fʁɑlˀsɐ
skod	sɡ̊ʌðˀ
skabte	sɡ̊ɑb̥d̥ə
smoking	smoːkʰeŋ
revidere	ʁævid̥eːˀɐ
nymfe	nøɱfə
menage	menæːɕə
svage	svæːjə
forråder	fʌʁɔˀðɐ
gær	ɡ̊ɛːˀɐ̯
masturbere	masd̥uɐ̯b̥eːˀɐ
hytterne	hyd̥ɐnə
arv	ɑːˀw
tømme	tˢœmə
hængt	hɛŋˀd̥
rendte	ʁand̥ə
age	æːæ
tvætte	tˢvɛd̥ə
svensker	sʋɛnsɡ̊ɐ
elementær	eləmɛntˢɛˀɐ̯
sule	suːlə
accenterne	ɑɡ̊sɑŋˀɐnə
snige	sniːi
gris	ɡ̊ʁiˀs
wc	veːˀseːˀ
leven	lewˀn̩
sønnen	sœnˀən
vedrørende	ʋeðʁɶˀɐnə
kar	kʰɑ
yver	yːˀvɐ
bondegård	b̥ɔnəɡ̊ɒːˀ
sag	sæːˀj
dug	d̥uˀ
overlegen	ɒwɐlɑjˀən
lem	lɛmˀ
vulgær	vulɡ̊ɛːˀɐ̯
rødt	ʁœd̥
sved	sʋeˀð
spurte	sb̥uɐ̯d̥e
diskret	d̥isɡ̊ʁɛːˀd̥
mus	muːˀs
sælge	sɛlə
sol	sʌl
insekt	ensɛɡ̊d̥
kommode	kʰomoːðˠə
lette	lɛd̥ə
hostesaft	hoːsd̥əsɑfd̥
sneg	sneˀj
kendetegne	kʰɛnətˢɑjˀnə
fjendtlig	fjɛnd̥li
pave	pʰæːwə
børnebørn	b̥ɶɐ̯nəb̥ɶɐ̯ˀn
færd	fɛɐ̯ˀ
fotograf	fotˢoɡ̊ʁɒːˀf
femten	fɛmd̥n̩
lærte	lɛɐ̯d̥ə
pateen	pʰatˢeːˀn̩
etbenet	ed̥b̥eːˀnəð
færgen	faɐ̯wən
forsker	fɒːsɡ̊ɐ
tilbagestående	tˢeb̥æːjəsd̥ɔˀənə
tvært	tˢʋ̥ɛɐ̯ˀd̥
cd	sed̥eˀ
siv	siːˀw
norge	nɒːʊ
fattig	fad̥i
incidens	e̝nsid̥enˀs
fællig	fɛli
gulv	ɡ̊ɔl
atomerne	atˢoˀmɐnə
red	ʁæðˀ
europa	eʁoːpʰa
hånd	hʌnˀ
tilbringe	tˢelb̥ʁɛŋˀə
brud	b̥ʁuð
anden	anˀən
damask	d̥amasɡ̊
net	nɛd̥
rydde	ʁyðə
reklame	ʁɛklæːmə
reel	ʁiːˀl
afbryde	ɑwb̥ʁyˀðə
pils	pʰilˀs
sæt	sɛd̥
akkumulatorer	akʰumulatˢoːɐ
befolkningstæthed	befʌlˀɡneŋstɛdheð
vis	ʋes
afløb	ɑwløːˀb̥
siden	siːðən
substans	sub̥sd̥anˀs
fadervor	fæːðɐvɒ
arvelig	ɑːvəli
bestialsk	b̥esd̥jæːˀlsɡ̊
offentlige	ʌfənd̥liə
loyal	lʌjæːˀl
politistation	pʰolitˢisd̥aɕoˀn
ananas	ananas
forbydende	fɒb̥yˀðənə
træder	tˢʁ̥ɛðˀə
født	føˀd̥
købet	kʰøˀb̥əð
bøjning	b̥ʌjneŋ
søvn	sœwˀn
opvakt	ʌb̥ʋɑɡ̊d̥
skaber	sɡ̊æːwɐ
grædt	ɡ̊ʁad̥
styrerne	sd̥yːɐnə
julemand	julemæˀ
tavs	tˢɑwˀs
ændre	ɛnd̥ʁɐ
love	lɔːʋə
ombudsmand	ʌmb̥uðsmanˀ
ælde	ɛlə
dus	d̥us
værelse	ʋaːɐlsə
rørt	ʁɶɐ̯ˀd̥
færden	faɐ̯d̥n̩
hyttefad	hyd̥əfað
flyvemaskine	flyːʊ̯masɡ̊iːnə
bone	b̥oːnə
ladet	laðˀəd̥
psykose	sykʰoːsə
drivhus	d̥ʁiwhuˀs
udland	uðlanˀ
hoppe	hʌb̥ə
forstår	fʌsd̥ɔɐ̯ˀ
dem	d̥ɛm
gnist	ɡ̊nisd̥
øst	øsd̥
sås	sɔˀs
karle	kʰɑːlə
race	ʁɛːsə
ugle	uːlə
tanker	tˢɑnɡ̊ɐ̯
morgenfrisk	mɒɒnfʁæsɡ
lev	lewˀ
død	d̥øˀð
løve	løːʊ
eje	ɑjə
frikadelle	fʁiɡ̊ad̥ɛlə
gelé	ɕele
beståen	b̥esd̥ɔˀən
besked	b̥esɡ̊eˀð
ruinere	ʁuineːˀɐ
skåning	sɡ̊ɔːneŋ
rytteri	ʁyd̥ɐʁiˀ
højforræderi	hʌjfʌʁaðɐʁiˀ
psykiatri	syɡ̊iatˢʁ̥iˀ
krybdyr	kʰʁ̥yb̥d̥yɐ̯ˀ
opslagsværk	ʌb̥sl̥æjsʋaɐ̯ɡ̊
guirlande	ɡ̊iɐ̯land̥ə
døbe	d̥øːb̥ə
vove	ʋɔːʊ
anmode	anmoˀð̩
optræder	ʌb̥tˢʁ̥aðˀɐ
lidet	liðð̩d̥
forte	fɒːd̥ə
oprøre	ʌb̥ʁɶˀɐ
immigration	emiɡ̊ʁɑɕoːˀn
kuldkaste	kʰulkʰasd̥ə
føde	føːðə
krudt	kʰʁ̥od̥
brunche	b̥ʁʌnɕə
istanbul	isd̥amb̥ul
tankens	tˢɑŋˀɡ̊ŋ̩s
enhjørning	eːnjœ̞ɐ̯neŋ
vide	ʋiðð̩
kuller	kʰulˀɐ
færden	fɛˀɐn
tidslig	tˢiðsli
gnosticisme	ɡ̊nʌsd̥isismə
bark	b̥ɑːɡ̊
lang	lɑŋˀ
bjerg	b̥jaɐ̯ˀw
eklektisk	ɛɡ̊lɛɡ̊tˢisɡ̊
bi	b̥iˀ
værgende	ʋaɐ̯wənə
tagetage	tˢɑwetˢæːˀɕə
klar	kʰl̥ɑˀ
hamp	hɑmˀb̥
mormor	mɒˀmoɐ̯
tru	tˢʁ̥oˀ
hvad	vɑ
spænder	sb̥ɛnɐ
bolt	b̥ʌlˀd̥
battet	b̥ad̥əð
svøber	sʋøːb̥ɐ
borg	pɒwˀ
grafit	ɡ̊ʁɑfid̥
anglofil	ɑŋlofiːˀl
bevæge	b̥evɛˀə
a'ets	æːəd̥s
tav	tavˀ
undgælde	ɔnɡ̊ɛlˀə
lunken	lɔŋɡ̊ən
ravn	ʁɑʊ̯ˀn
gemme	ɡ̊ɛmə
givet	ɡ̊iːwð̩
vandrefalk	vɑnd̥ʁɐfalˀɡ̊
monstro	mɔnstˢʁ̥oˀ
foranderlig	fʌɑnˀɐli
føler	føˀlɐ
korset	kʰɒsɛd̥
sej	sɑjˀ
fod	foðˀ
stadig	sd̥æːði
elskov	ɛlsɡ̊ɒwˀ
sløjfe	slʌjfə
snefald	snefalˀ
arabisk	ɑʁɑːˀb̥isɡ̊
promiskuøs	pʰʁ̥omisɡ̊uøːˀs
imponerede	empʰoneːˀɐðˠə
låg	lɔwˀ
fladt	flad̥
penge	pʰɛŋə
grave	ɡ̊ʁɑːvə
kokosnød	kʰoːɡ̊osnøðˀ
slot	slʌd̥
frosset	fʁ̥ʌsð̩
herskeren	hæɐ̯sɡ̊ɐɐn
bedrift	b̥ed̥ʁæfd̥
flyvning	flywneŋ
mos	moːˀs
sige	siːə
hø	høɪ̯ː
fødselsdag	føsl̩sd̥æˀ
arkivar	ɑkivɑˀ
magre	mæjʁʌ
roer	ʁoːˀɐ
safterne	sɑfd̥ɐnə
nukleon	nukʰleoˀn
yoga	joːɡ̊a
republik	ʁɛpʰub̥liɡ̊
rørsukker	ʁɶɐ̯sɔɡ̊ɐ
råb	ʁɔˀb̥
skærf	sɡ̊æɐ̯f
pædagogik	pʰɛd̥aɡ̊oɡ̊iɡ̊
klor	kʰloːˀɐ̯
klassiker	kʰl̥asiɡ̊ɐ
abbedi	ɑb̥ed̥iˀ
englænder	ɛŋlɛnˀɐ
kort	kʰɒːd̥
par	pʰɑ
toiletpapir	tˢoalɛd̥pʰapʰiɐ̯ˀ
total	tˢotˢæːˀl
kristen	kʰʁ̥ɛsd̥ən
million	milioˀn
frue	fʁ̥oːo
sparto	sb̥ɑtˢoːˀ
afholdt	ɑwhʌlˀd̥
bredden	b̥ʁæˀd̥n̩
betale	b̥etˢæˀlə
venskabsby	vɛnsɡ̊ab̥sb̥yːˀ
erindre	eʁɛnˀd̥ʁɐ
gang	ɡɑ̃ʊ̃
gynækologi	ɡ̊ynɛkoloɡ̊iːˀ
andrik	and̥ʁæɡ̊
kalv	kʰalˀ
slet	slɛd̥
opslagstavle	ʌb̥sl̥æstˢɑwlə
tilhører	tˢelhøˀɐ
undrende	ɔnd̥ʁɐnə
tier	tˢiːɐ
fjende	fjenə
baggrund	b̥ɑwɡ̊ʁɔnˀ
underskrive	ɔnɐsɡ̊ʁiˀʋə
usikker	useɡ̊ɐ
forræder	fʌʁɛðˀɐ
nominere	nomineˀɐ
gode	ɡ̊oːo
herberg	haɐ̯b̥aɐ̯w
huske	husɡ̊ə
gregoriansk	ɡ̊ʁɛɡ̊oɐ̯iæːˀnsɡ̊
undtager	ɔntˢɑˀ
sammenbrud	sɑmm̩b̥ʁoð
skrævet	sɡ̊ʁaðˀð
stress	sd̥ʁɑs
drenge	d̥ʁa̝ŋə
nærhed	nɛɐ̯heðˀ
prægnant	pʰʁ̥ɛɡ̊nanˀd̥
katastrofe	kʰad̥asd̥ʁoːfə
kavalerist	kʰaʋləʁisd̥
tålmod	tˢʌlmoˀð
fødderne	føðˀɐnə
rækken	ʁaɡ̊ən
mutant	mutˢanˀd̥
boede	b̥oðð̩
slaver	slæˀʋɐ
mine	miːn̩
bør	b̥øɐ̯ˀ
nænne	nɛnə
kylling	kʰyleŋ
lyne	lyːnə
røgelse	ʁøːjl̩sə
stoppe	sd̥ʌb̥ə
arne	ɑːnə
spare	sb̥ɛɐ̯
bestemt	b̥esd̥ɛmˀd̥
kælder	kɕɔʎə
brændenælde	b̥ʁɑnnɛlə
rørte	ʁɶɐ̯d̥ə
tveægget	tˢveɛɡ̊əð
åbenbare	ɔːb̥ənb̥ɑˀɑ
daner	d̥æˀnɐ
risvin	ʁiːsʋiːˀn
kaste	kʰasd̥ə
italesættelse	itˢæːləsɛd̥l̩sə
gåsen	ɡ̊ɔˀsən
dreje	d̥ʁɑːɪ
måge	mɔːwə
kreds	kʰʁ̥ɛːˀs
bod	b̥oˀð
hør	høɐ̯ˀ
ved	ʋe
svedig	sveːði
velfærdsstat	ʋɛlfɛɐ̯sd̥æˀd̥
rager	ʁɑwɐ
svide	sʋiːə
slowmotion	slɔwmɔwɕən
altruistisk	altˢʁ̥uisd̥isɡ̊
brunch	b̥ɹʌnˀɕ
skyr	sɡ̊yɐ̯ˀ
ståltråd	sd̥ʌltˢʁ̥ɔðˀ
kaffebønne	kʰɑfəb̥œnə
sid	seðˀ
stor	sd̥oˀɐ̯
kat	kʰad̥
æggene	ɛːɡ̊n̩nə
røve	ʁœːʊ
lokke	lʌɡ̊ə
passere	pʰasɐːɐ
uld	ulˀ
ambra	ɑmb̥ʁɑ
hang	hɑŋˀ
opvække	ʌb̥ʋɛɡ̊ə
lyve	lyːʋə
stjålent	sd̥jɔːlənd̥
kompagnon	kʰɔmpʰanjʌŋ
murer	muːɐ
fedt	fed̥
skøge	sɡ̊øːɪ
athener	atˢeˀnɐ
fremragende	fʁamʁɑˀwn̩nə
slægt	slɛɡ̊d̥
hjælpen	jɛlˀb̥m̩
sørge	sɶɐ̯ɐ
natugle	nad̥uːlə
september	səb̥tˢɛmˀb̥ɐ
ved	ʋeð
mør	møɐ̯ˀ
hænge	hɛŋə
røre	ʁɶːɐ
eskimo	ɛsɡ̊imoːˀ
ude	uːðə
hovedpine	hoːəðpʰiːnə
fuldmagt	fulmɑɡ̊d̥
lange	lɑŋə
danmark	d̥anmɑɡ̊
traktor	tˢʁ̥ɑɡ̊tˢɐ
ekstra	ɛɡ̊sd̥ʁɐ
kvartalsvis	kʰʋ̥ɑtˢæˀlsʋiˀs
truffet	tˢʁ̥ɔfəð
giver	ɡ̊iːʋɐ
næbdyr	nɛːbdyɐ̯ˀ
gid	ɡ̊iðˀ
fiskerbåd	fesɡ̊ɐb̥ɔðˀ
skat	sɡ̊ad̥
ispind	ispʰenˀ
fædrene	fɛðʁɐnə
rosin	ʁosiˀn
højredrejning	hʌɪ̯ʁʌd̥ʁɑɪ̯niŋ
rektor	ʁaɡ̊tˢɒ
tank	tˢæːŋɡ̊
gummi	ɡ̊ɔmi
seks	sɛɡ̊s
kræft	kʁ̥afd̥
tjekket	tçɛɡ̊əð
tendens	tˢɛnd̥ɛnˀs
hovmod	hɒwmoðˀ
bonusser	b̥oːnusɐ
syntaks	syntˢɑɡ̊s
bygning	b̥yɡ̊neŋˀ
kile	kʰiːlə
rat	ʁɑd̥
parallellen	pʰɑɑlɛlˀən
autodidakt	ɑwtˢod̥id̥aɡ̊d̥
hvirveldyr	viɐ̯wəld̥yɐ̯ˀ
fælles	fɛlˀəs
krigshelt	kʰʁ̥ishɛlˀd̥
spørgsmål	sb̥ɶɐ̯smɔˀl
tid	tˢiˀð
trække	tˢʁ̥aɡ̊ə
bragte	b̥ʁɑɡ̊d̥ə
lund	lɔnˀ
vækkedes	ʋɛɡ̊əðəs
regel	ʁɛjˀəl
gudbarn	ɡ̊uðb̥ɑːˀn
strukket	sd̥ʁɔɡ̊əð
voldtægt	ʋʌltˢɛɡ̊d̥
vred	ʋʁæˀð
hors	hɒːs
medley	mɛd̥li
fjert	fjæɐ̯ˀd̥
lyste	lyːsd̥ə
pensel	pʰɛnˀsl̩
eventyr	ɛːʋn̩tˢyˀɐ̯
slæb	slɛwˀ
spiser	sb̥iːˀsɐ
pålæg	pʰʌlɛɡ̊
tår	tˢɒˀ
strømpe	sd̥ʁɶmb̥ə
træde	tˢʁ̥æðð̩
majonæse	mɑjonɛːsə
fem	fɛmˀ
den	d̥ɛn
flæskesvær	flɛsɡ̊əsʋɛɐ̯ˀ
slagte	slɑɡ̊d̥ə
rønnebær	ʁɶnəpɛɐ̯
harpe	hɑːb̥ə
vinde	venə
tissemand	tˢisəmanˀ
vride	ʋʁiðð̩
skumbad	sɡ̊ɔmbað
mandfolk	manfʌlˀɡ̊
frisisk	fʁiːˀsisɡ̊
lærte	læɐ̯d̥ə
taks	tˢɑɡ̊s
tveægget	tˢveɛːˀɡ̊əð
ækvator	ekʰvæːtˢɐ
blodmangel	ploðmɑŋˀl̩
erkende	aɐ̯kʰɛnˀə
klitoris	kʰlitˢoʁis
trøffel	tˢʁ̥œfəl
gulvet	ɡ̊ɔlˀvəð
færgen	faɐ̯ʊn
bøger	b̥øjˀɐ
omgikkes	ʌmɡ̊iɡ̊əs
rådhus	ʁʌðhuˀs
oprindelig	ʌb̥ʁænˀn̩li
røbe	ʁœ̞ːb̥ə
w	d̥ʌb̥əlveːˀ
mandig	mand̥i
skærgård	sɡ̊ɛɐ̯ɡ̊ɒˀ
løste	løːsd̥ə
amagerkaner	ɑmɑːkæːˀnɐ
børene	b̥øːɐnə
atomet	atˢoˀməð
bonede	b̥ʌŋəðə
ærgerlig	aɐ̯wɐli
thi	tˢi
vitaminpille	vitˢamiːˀnpʰelə
rest	ʁasd̥
usynlig	usyˀnli
øge	øːø
kvæg	kʰʋ̥ɛˀj
have	hæːʋə
have	ha
jura	juːɑ
lidt	led̥
val	ʋæˀl
mørkhåret	mɶɐ̯ɡ̊hɒˀɒð
syrer	syːɐ
hit	hid̥
beholder	b̥ehʌlˀɐ
tidszone	tˢiðssoːnə
trælle	tˢʁ̥alə
flydt	flyd̥
korskilde	kʰɒːskʰilə
broder	b̥ʁoːðɐ
vælger	vɛljɐ
dræbe	d̥ʁɛːb̥ə
fatal	fatˢæːˀl
faldgruppe	falɡ̊ʁub̥ə
landet	lanəð
carbondioxid	kʰɑːbʌnd̥iʌɡ̊ksiðˀ
kvik	kʰʋ̥iɡ̊
akt	ɑɡ̊d̥
marchere	mɑɕeˀɐ
gnu	ɡ̊nuːˀ
gebærde	ɡ̊eb̥æɐ̯d̥ə
frossen	fʁ̥ʌsn̩
bastard	b̥asd̥ɑːˀd̥
tygger	tˢyɡ̊ɐ
kakofoni	kʰɑɡ̊ofoniːˀ
fakultet	fɑɡ̊ultˢeˀd̥
apparat	ɑb̥ɑʁɑːˀd̥
efterår	ɛfd̥ɐɒˀ
stativ	sd̥atˢiwˀ
pålagde	pʰʌlæˀə
alfons	alfʌnˀs
daler	d̥æːlɐ
helg	hɛlˀj
nok	nʌɡ̊
forme	fɒːmə
havet	hæˀvəð
ulykke	uløɡ̊ə
sandhed	sanheðˠˀ
hest	hɛsd̥
skulder	sɡ̊ulɐ
skøn	sɡ̊œnˀ
tygget	tˢyɡ̊əð
frelse	fʁalsə
bevæget	b̥evɛˀð̩
brand	b̥ʁɑnˀ
breddernes	b̥ʁæðɐnəs
sophus	soːfus
læste	lɛːsd̥ə
kørte	kʰøɐ̯d̥ə
porno	pʰɒːno
hos	hɔs
sælge	sɛljə
flødeskum	fløðð̩sɡ̊ɔmˀ
retning	ʁad̥neŋ
redde	ʁæðð̩
pynt	pʰønˀd̥
irriterende	iɐ̯itˢeˀɐnə
randers	ʁɑnɐs
slig	sliˀ
peanutbutter	pʰiːnʌb̥b̥ʌd̥ɐ
koagulere	kʰoɑɡ̊uleːˀɐ
hierarki	hiɑkʰiːˀ
skåren	sɡ̊ɒːɐn
sætte	sɛd̥ə
eksaminand	ɛɡ̊saminanˀd̥
seksten	sɑjsd̥n̩
øre	øːɐ
tango	tˢɑŋɡ̊o
blomst	b̥lʌmˀsd̥
svøben	sʋøːb̥ən
larme	lɑːmə
ægget	ɛɡ̊əð
legemlige	lɛːmlii
testikel	tˢɛsd̥iɡ̊əl
recept	ʁɛsɛb̥d̥
øl	øl
krage	kʁ̥ɑːʊ
norden	noˀɐn
ens	eːˀns
stjålne	sd̥jɔːlnə
idræt	idʁad̥
allokering	alokʰeːˀɐ̯eŋ
told	tˢʌlˀ
anmeldelse	anmɛlˀəlsə
rang	ʁɑŋˀ
vrøvl	ʋʁɶwˀl
tiende	tˢiːənə
gulerod	ɡ̊uləʁoðˀ
hyppig	hyb̥i
fin	fiˀn
hjerne	jæɐ̯nə
hæleren	hɛːlɐɐn
hof	hʌf
malmø	ma̝lmø
vågn	ʋɔwˀn
undtaget	ɔntˢæˀəð
kavalerist	kʰaʋaləʁisd̥
hyklerisk	hyɡ̊lɐʁiˀ
turkis	tˢuɐ̯kʰiːˀs
athensk	atˢeˀnsɡ̊
slutte	slud̥ə
knud	knuˀð
blokere	b̥lokʰeːˀɐ
bedrøvet	b̥ed̥ʁœwˀð̩
syntes	sys
stress	sd̥ʁas
lod	loðˀ
davre	d̥ɑwʁɐ
bestående	b̥esd̥ɔˀənə
skred	sɡ̊ʁæˀð
værget	ʋaɐ̯ʊð
vurdere	ʋuɐ̯d̥eˀɐ
bred	b̥ʁæˀð
ordne	ɒːnə
helt	heˀld̥
fag	fæˀj
strube	sd̥ʁuːb̥ə
besøge	b̥esøˀø
pure	pʰuːɐ̯
hofteben	hʌfd̥əb̥eːˀn
sofavælger	soːfavɛljɐ
spøg	sb̥ʌjˀ
dag	d̥æˀj
bumpet	b̥ɔmˀb̥ð̩
finder	fenˀɐ
klæderne	kʰl̥ɛːðɐnə
komplet	kʰɔmpʰlɛd̥
forfatter	fɒfad̥ɐ
parallelt	pʰɑɑlɛlˀd̥
levnet	lɛwnð̩
tillykke	tˢeløɡ̊ə
ørering	øːɐʁeŋ
ve	ʋeːˀ
nede	neːðə
overraske	ɒwɐʁɑsɡ̊ə
uvægerlig	uʋɛjˀɐli
regn	ʁɑɪ̯ˀn
svie	sʋiˀ
sabel	sæːˀb̥əl
rædsel	ʁaðˀsɭ̩
ragout'er	ʁɑɡ̊uːˀɐ
spurt	sb̥uɐ̯ˀd̥
from	fʁ̥ʌmˀ
vrøvlet	ʋʁɶwlð̩
løjpe	lʌjb̥ə
uomgængelig	ʌmɡ̊ɛŋˀəli
skrækkelig	sɡ̊ʁaɡ̊li
hjælper	jɛlb̥ɐ
sikken	seɡ̊ə
antydning	antˢyðˀneŋ
fortsat	fɒːsad̥
arp	ɑːb̥
kvarten	kʰʋ̥ɑːd̥ən
gide	ɡ̊iːðə
galehus	ɡ̊æːləhuːˀs
legeme	lɛːmə
snegl	snɑjˀl
fodring	foðɹeŋ
forråde	fʌʁɔˀðə
formode	fʌmoˀð̩
guldsmed	ɡ̊ulsmeð
købe	kʰøːʊ
lykønskning	løɡ̊ønˀsɡ̊neŋ
mysli	mysli
argentiner	ɑɡ̊ɛntˢiːˀnɐ
spinde	sb̥enə
selv	sɛlˀ
vammel	vɑmˀl̩
engelsk	ɛŋˀl̩sɡ̊
germansk	ɡ̊aɐ̯mæˀnsɡ̊
ende	ɛnə
formå	fʌmɔˀ
ryg	ʁyˀ
begrebsforvirring	b̥eɡ̊ʁæˀb̥sfʌviɐ̯ˀeŋ
menneskene	mɛnn̩sɡ̊ənə
mennesker	mɛnsɡ̊ɐ
race	ʁɛˀs
jord	jeʊːɐ
københavn	kʰøb̥m̩hɑwˀn
under	ɔnˀɐ
fråse	fʁ̥ɔːsə
gammen	ɡ̊ɑmən
hug	hɔɡ̊
gudskelov	ɡ̊usɡ̊əlɒw
forsøde	fʌsøːˀðə
bogklub	b̥ɔwkʰlub̥
læge	lɛːjə
ydmyg	yðmyˀ
opholdstilladelse	ʌphʌlstsʰelæˀðl̩sə
skabe	sɡ̊æːb̥ə
camper	kʰæːmb̥ɐ
besatte	b̥esad̥ə
syndflod	sønfloˀð
maksime	mɑɡ̊siːmə
røver	ʁœ̞ːʋɐ
sulten	sulˀd̥n̩
vrikke	vʁæɡ̊ə
postbude	pʰʌsd̥b̥uːðə
hukommelse	hukʰʌmˀɭ̩sə
hybris	hyːb̥ʁis
producer	pʰʁ̥od̥useːɐ̯
imponere	empʰoneːˀɐ
jætte	jɛd̥ə
dagligliv	d̥ɑwliliˀw
ordspil	oɐ̯sb̥el
urinsekt	uɐ̯ensɛɡ̊d̥
optrådte	ʌb̥tˢʁ̥ʌd̥ə
stemme	sd̥ɛmə
politi	pʰolitˢiˀ
lovmæssig	lɒwmɛˀsi
jo	jo
thi	tˢiˀ
råbe	ʁɔːʊ
standse	sd̥ansə
fjerdedel	fjɛːɐd̥eˀl
overhovedet	ɔuəʀhoːðəd
fagreste	fɑwʁɐsd̥ə
hjortekød	jɒːd̥əkʰøðˠ
uhyrlig	uhyɐ̯ˀli
føl	føl
klud	kʰl̥uðˀ
bekendende	b̥ekʰɛnˀənə
spænderne	sb̥ɛnɐnə
svide	sʋiˀ
orkestergrav	ɒkʰɛsd̥ɐɡ̊ʁɑwˀ
leo	leːʊ
stabil	sd̥ab̥iːˀl
fuchsier	fɔɡ̊ɕʌ
æg	ɛˀj
mandel	manˀəl
stjæleren	sd̥jɛːlɐɐn
terrasse	tˢaʁɑsə
rygrad	ʁœɡ̊ʁɑðˀ
forlyd	fɒːlyðˀ
uglerne	uːlɐnə
sted	sd̥ɛðˀ
paraply	pʰɑɑpʰl̥yˀ
intervention	entˢɐvənɕoːˀn
oprinde	ʌb̥ʁænə
desuagtet	d̥ɛsuɑɡ̊d̥əð
koger	kʰɔːwɐ
forstørre	fʌsd̥ɶˀɐ
tredive	tˢʁ̥aðʋə
tag	tˢɑw
rem	ʁɑmˀ
attribut	atˢʁ̥ib̥ud̥
pest	pʰɛsd̥
gjord	ɡ̊joɐ̯ˀd̥
nominativ	nɔminatˢiwˀ
hal	hæːˀl
sondere	sʌnd̥eːˀɐ
medtrafikant	mɛðtˢʁ̥ɑfikʰanˀd̥
tressende	tˢʁ̥ɛsənə
rak	ʁɑɡ̊
tre	tˢʁ̥ɛˀ
lav	læwˀ
porcelæn	pʰɒsəlɛːˀn
lasers	læjsɐs
musvåge	musʋɔːʊ
klædes	kʰl̥ɛˀs
hjertens	jaɐ̯d̥n̩s
vid	ʋið
formiddag	fɒːmed̥æːˀ
ordre	ɒˀd̥ʁɐ
krans	kʰʁ̥ɑnˀs
lige	liːə
venskab	vɛnsɡ̊æˀb̥
ost	oˀsd̥
snedker	sneˀɡ̊ɐ
gåseøjne	ɡ̊ɔːsəʌjnə
galoper	ɡ̊alopʰeɐ̯ˀ
holdne	hʌlnə
herberg	haɐ̯b̥aɐ̯wˀ
indre	end̥ʁɐ
overmorgen	ɒwˀɐmɒɒn
dem	d̥m̩
leksikonet	lɛɡ̊sikʰʌnˀəð
vår	ʋɒˀ
skotskternet	sɡ̊ʌd̥sɡ̊tˢæɐ̯nəð
album	alb̥ɔm
gebærde	ɡ̊eb̥æɐ̯ˀd̥ə
spot	sb̥ʌd̥
goddag	ɡ̊od̥ɑwˀ
stigma	sd̥iːma
suspensorium	susb̥ænsoːˀɐ̯iɔm
holdte	hʌld̥ə
sprød	sb̥ʁœðˀ
tempo	tˢɛmb̥o
mod	moðˀ
ordspillet	oɐ̯sb̥elˀð̩
fjæs	fj̊ɛˀs
mødre	møðʁɐ
balkon	b̥alkʰʌŋ
krævede	kʰʁ̥æwð̩ð̩
øverst	øwˀɐsd̥
museer	musɛːɐ
festskrift	fɛsd̥sɡ̊ʁæfd̥
stås	sd̥ɔˀs
sagte	sɑwdə
flange	flɑŋɕɘ
visa	viːsa
lejr	lɑjˀɐ
fangenskab	fɑŋənsɡ̊æˀb̥
nitten	ned̥n̩
læder	lɛðˀɐ
fonetisk	foneːˀd̥isɡ̊
især	isɛːˀɐ̯
hovmodig	hɒwmoðˀi
eventyr	ɛwn̩tˢyɐ̯ˀ
øjeblik	ʌjəb̥leɡ̊
piber	pʰiwˀɐ
arabisk	aʁɑːˀb̥isɡ̊
holder	hʌlɐ
kikke	kʰiɡ̊ə
tøjet	tˢʌðˀð̩
rørende	ʁɶːɐnə
søvnløs	sœwnløˀs
hierarkisk	hiʁɑːˀkʰisɡ̊
tilbage	tˢeb̥æːæ
hieroglyfferne	hioɡ̊lyfɐnə
nytteløs	nød̥əløːˀs
kristenhed	kʰʁ̥ɛsd̥ənheðˀ
levnet	lɛwˀnð̩
superhelt	suˀb̥ɐhɛlˀd̥
skærer	sɡ̊ɛːɐ
nørd	nœ̞ɐ̯ˀd̥
blokere	b̥lʌkʰeːˀɐ
spøge	sb̥øːø
skummetmælk	sɡ̊ɔmð̩mɛlˀɡ̊
stør	sd̥øɐ̯ˀ
stedte	sd̥eːd̥ə
metodisk	metˢoːˀd̥isɡ̊
ægte	ɛɡ̊d̥ə
småbarn	smʌb̥ɑːˀn
gøgle	ɡ̊ʌjlə
succes	syɡ̊se
frem	fʁamˀ
kryddernellike	kʰʁ̥yðɐnelˀeɡ̊ə
råd	ʁɔˀð
græder	ɡ̊ʁaˀðɐ
italiensk	itˢaljɛˀnsɡ̊
bjerge	b̥jæɐ̯wə
aflede	awleðˀð̩
lørdag	lɶɐ̯d̥a
gejst	ɡ̊ɑjˀsd̥
forleden	fʌleˀðən
hash	haɕ
nevø	neʋø
væge	vɛːjə
kontrovers	kʰʌntˢʁovæɐ̯s
patetisk	pʰatˢeːˀtˢisɡ̊
moræne	moʁɛːnə
sejre	sɑjʁɐ
skumring	sɡ̊ɔmʁeŋ
pulverne	pʰɔlˀvɐnə
medium	meːˀd̥jɔm
kro	kʁoˀ
rype	ʁyːb̥ə
cowboyer	kʰɒwb̥ʌjˀɐ
vom	vʌmˀ
æt	ɛˀd̥
nedprioritere	neðpʁiɒiteˀɐ
ø	øˀ
marts	mɑːd̥s
lys	lyˀs
kobberrør	kʰɒʊ̯ˀɐʁɶːˀɐ̯
accenter	ɑɡ̊sɑŋˀɐ
mariehøne	maʁiːˀəhœːnə
psykiater	syɡ̊iæˀd̥ɐ
omkring	ʌmkʁɛ̝ŋˀ
blufærdig	b̥lufæɐ̯ˀd̥i
pomfrit	pʰʌmfʁid̥
cylinder	sylenˀd̥ɐ
metallet	metˢalˀð̩
galgenhumor	ɡ̊aljənhuːmɒ
peb	pʰeˀb̥
småkage	smʌkʰæːæ
ae	æːæ
live	liːʊ
tyktarm	tyɡtɑˀm
koncert	kʰʌnsæɐ̯d̥
sørgede	sɶːɐðð̩
samvær	sɑmʋɛˀɐ̯
skriv	sɡ̊ʁiwˀ
møbel	møːˀb̥əl
bullet	b̥uləd̥
vrøvlede	ʋʁɶwlð̩ð̩
bagefter	b̥æːˀjɛfd̥ɐ
videre	viðɐɐ
forloren	fʌloːˀɐn
hall	hɒːl
lærde	lɛɐ̯ˀd̥ə
samfundskritisk	sɑmfɔnskʁ̥itˢisɡ̊
slår	slɒˀ
godbid	ɡ̊oðb̥iðˀ
bedrager	b̥ed̥ʁɑˀwɐ
slige	sliːə
skægget	sɡ̊ɛˀɡ̊əð
treer	tˢʁ̥æːˀɐ
varsel	ʋɑːsl̩
høg	høˀj
mislykket	misløɡ̊əð
faktum	fɑɡ̊tˢɔm
amt	ɑmˀd̥
vrøvlen	ʋʁɶwln̩
fakta	fɑɡ̊tˢa
klædets	kʰl̥ɛːðəd̥s
tag	tˢæˀj
desuagtet	d̥esuɑɡ̊d̥əð
sverige	sʋ̥aɐ̯ˀi
dømte	d̥œmd̥ə
vedrøre	ʋeðʁɶˀɐ
nåede	nɔðˀð̩ð̩
elefant	eləfanˀd̥
valte	ʋald̥ə
tolken	tˢʌlˀɡ̊ŋ̩
røvs	ʁɶwˀs
går	ɡ̊ɒːˀ
stilig	stˢiːli
arrester	aʁasd̥ɐ
afslutte	ɑʊ̯slud̥ə
direkte	d̥iʁaɡ̊d̥ə
præst	pʰʁ̥ɑsd̥
vokse	ʋʌɡ̊sə
hus	huˀs
læsehest	lɛːsəhɛsd̥
fjendskab	fjensɡ̊æˀb̥
faste	fæːsd̥ə
lyst	lysd̥
tidligere	tˢiðliɐɐ
pisse	pʰesə
givet	ɡ̊iːʋəð
park	pʰɑːɡ̊
sagte	sæjdə
brede	b̥ʁæðð̩
tape	tˢɛjb̥ˀ
kaktus	kʰɑɡ̊tˢus
fikse	feɡ̊sə
slæber	slɛːwɐ
tå	tˢɔːˀ
øge	øːɪ
sværge	sʋ̥aɐ̯ʊ
nadver	naðvɐ
branche	b̥ʁɑŋɕə
højttaler	hʌjtˢæːˀlɐ
vækning	ʋɛɡ̊neŋ
indflydelse	enfl̥yðɭ̩sə
ulovlige	ulɒwˀlii
skyde	sɡ̊yːðə
rydde	ʁyd̥ə
vrå	ʋʁɔˀ
tilstand	tˢelsd̥anˀ
koncept	kʰʌnsɛb̥d̥
lægte	lɛɡ̊d̥ə
slæbe	slɛːb̥ə
ølmave	ølmæːvə
munke	mɔŋɡ̊ə
laurbærkrans	lɑʊ̯ɐb̥æɐ̯kʰʁɑˀns
høkre	høːɡ̊ʁɐ
begyndelse	b̥eɡ̊ønˀəlsə
onani	onaniːˀ
danbo	da̝nboˀ
bølgen	b̥øljən
karisma	kʰaʁisma
time	tˢɑjˀm
tomat	tˢomæːˀd̥
ratificere	ʁɑd̥ifiseːˀɐ
uheld	uhɛlˀ
klokkeren	kʰlʌɡ̊ɐən
skonnert	sɡ̊ʌnˀɐd̥
anden	anən
nonsens	nʌnˀsəns
kreta	kʰʁ̥æːtˢa
athen	atˢeˀn
hallo	halɔː
sot	soˀd̥
tilværelse	tˢelʋaɐ̯ˀɐlsə
hals	halˀs
seksti	sɛɡ̊stˢi
ryger	ʁyːɐ
vorden	ʋɒːd̥n̩
danskeren	d̥ansɡ̊ɐɐn
bede	b̥eˀ
urinale	uɐ̯inæːlə
an	æˀn
sendte	sɛnˀd̥ə
fabel	fæːˀb̥l̩
kaster	kʰasd̥ɐ
glad	ɡ̊læð
skøjte	sɡ̊ʌjd̥ə
hagel	hæˀjl̩
ånd	ʌnˀ
seksuel	sɛɡ̊suɛlˀ
cigaret	siɡ̊əʁad̥
bade	b̥æːð̩
okse	ʌɡ̊sə
fadøl	faðøl
afrodisiakum	afʁ̥od̥isiːˀakʰɔm
od	ʌðˀ
hvad	vað
komtesse	kʰʌmtˢɛsə
fugl	fɔu̯ːl
vennen	ʋɛnˀn̩
strakte	sd̥ʁɑɡ̊d̥ə
ansat	ansad̥
rav	ʁɑw
spiller	sb̥elɐ
apropos	ɑpʰʁ̥opʰo
fødders	føðˀɐs
traktorer	tˢʁ̥ɑɡ̊tˢoːɐ
laven	lɑwˀn̩
hovedtelefon	hoðð̩tˢeləfoˀn
skubbe	sɡ̊ɔb̥ɘ
fod	foˀð
størst	sd̥ɶsd̥
vig	ʋiˀ
oldgræsk	ʌlɡ̊ʁasɡ̊
hver	ʋɛɐ̯
åger	ɔwˀɐ
sorg	sɒwˀ
opsigtsvækkende	ʌb̥seɡ̊d̥sʋɛɡ̊n̩nə
tyver	tˢyːvɐ
tøven	tˢøːʊn
kvæl	kʰʋ̥ɛˀl
vedtægt	ʋeðtˢɛɡ̊d̥
besøg	b̥esøˀj
fagert	fæˀɐd̥
øjnene	ʌɪ̯n̩nə
brasilianer	b̥ʁɑsiljæːˀnɐ
blok	b̥lʌɡ̊
gemt	ɡ̊ɛmˀd̥
voves	ʋɔːʊs
forlæg	fɒːlɛˀɡ̊
splejse	sb̥lɑjsə
sørgede	sɶːɐðə
besat	b̥esad̥
arbejdsgiver	ɑːb̥ɑjd̥sɡ̊iːvɐ
splejset	sb̥lɑjsəð
japansk	japʰæːˀnsɡ̊
jævnfør	jɛwnføˀɐ̯
rås	ʁɔˀs
nøde	nøːðə
rapsolie	ʕɑb̥soljə
portræt	ɒtˢʁ̥ad̥
pille	pʰelə
time	tˢɑjmə
journalistik	ɕoɐ̯nalisd̥iɡ̊
løve	løːʋə
sprede	sb̥ʁɛːðə
gælle	ɡ̊ɛlə
urgermansk	uɐ̯ɡ̊æɐ̯mæːˀnsɡ̊
bønder	b̥œnˀɐ
bord	b̥oˀɐ̯
cellekerne	sɛləkʰaɐ̯nə
bonde	b̥ɔnə
tilbage	tˢeb̥æːjə
bad	b̥æðˀ
nord	noɐ̯ˀ
gardin	ɡ̊ɑd̥iːˀn
hinden	henˀn̩
alvor	alʋɒˀ
hilsen	hilsn̩
dømmer	d̥œmɐ
beholdes	b̥ehʌlˀəs
tyvende	tˢyːvənə
a'et	æːəd̥
midler	miðlɐ
soldug	soːld̥uɡ̊
genus	ɡ̊eːnus
parcelhus	pʰɑsɛlˀhuˀ
lige	liːi
milliard	miljɑˀd̥
maraton	mɑːˀɑtˢʌn
skuldertræk	sɡ̊ulɐtˢʁ̥aɡ̊
laver	læːʋɐ
bræt	b̥ʁɑd̥
vejr	ʋɑjˀɐ
finer	fineːˀɐ̯
kær	kɛˀɐ̯
skreven	sɡ̊ʁæːʋn̩
partnerskab	pɑːdnʌsɡæˀb
arrangement	ɑɑŋɕəmɑŋ
boykot	b̥ʌjkʰʌd̥
breds	b̥ʁæðs
forligs	fʌliˀs
hinanden	henann̩
studerende	sd̥ud̥eˀɐ
elfenbenstårn	ɛlˀfənbenstˢɒːˀn
true	tˢʁ̥uːu
sarkasme	sɑkʰasmə
rutebilstation	ʁod̥əb̥ilsd̥aɕoˀn
trussel	tˢʁosəl
viskestykke	vesɡ̊əsd̥øɡ̊ə
forlige	fʌliˀi
røntgen	ʁɶnˀd̥ɡ̊ən
ugentlig	uːnli
igle	iːlə
opstå	ʌb̥sd̥ɔˀ
bagdel	b̥ɑwd̥eˀl
vov	ʋɔˀw
citer	sitˢeɐ̯ˀ
kvarter	kʰʋ̥ɑtˢeɐ̯ˀ
tunika	tˢuːˀnikʰa
bilde	b̥ilə
kvan	kvæˀn
olivenolie	oliwˀn̩oljə
føllet	følˀð̩
udlede	uðleðˀð̩
generer	ɕeneˀɐ
stigma	sd̥iɡ̊ma
lære	lɛːɐ
jodle	jʌðlə
pauver	pʰoːˀvɐ
cyklen	syɡ̊lən
fabelagtig	fab̥əlɑɡ̊d̥i
juli	juːˀli
trygge	tˢʁ̥œɡ̊ə
forrådes	fʌʁɔˀðəs
vinder	venˀɐ
jo	jɔʊ̯ˀ
per	pʰeɐ̯
klør	kʰløːˀɐ̯
flynder	flønɐ
lov	lɔwˀ
klæder	kʰl̥ɛɐ̯ˀ
mutter	mɔd̥ɐ
flyver	flyːʋɐ
akillessene	akʰiləsseːnə
flue	fluːu
fæstebonde	fɛsd̥əb̥ɔnə
gæv	ɡ̊ɛˀw
læ	lɛˀ
mislykkes	misløɡ̊əs
ignorerede	injoʁɛˀɐðə
hjælpende	jɛlb̥ənə
facon	fasʌŋ
vold	ʋʌlˀ
sudanesisk	sud̥aneːˀsisɡ̊
social	ɕoɕæˀl
geleddet	ɡ̊eleðˀð̩
beskeden	b̥esɡ̊eðˀn̩
hul	huˀl
stift	sd̥efd̥
vuggestue	ʋɔɡ̊əsd̥uːu
tegne	tˢɑjnə
producer	pʰʁ̥od̥useɐ̯ˀ
horrorfilm	hɒɹɒfilm
rem	ʁamˀ
flødede	fløðð̩ð̩
babylem	b̥ɛɪ̯b̥ilɛmˀ
varetage	ʋɑːɑtˢæˀ
prut	pʰʁ̥ud̥
fodkold	foðkʰʌlˀ
oliven	oliˀʋn̩
restauranten	ʁɛsd̥oʁɑŋˀən
steg	sd̥ɑjˀ
stund	sdɔnˀ
midtpunkt	med̥pʰɔŋˀd̥
tvinge	tˢʋ̥eŋə
find	fenˀ
immigration	imiɡ̊ʁɑɕoːˀn
kommentar	kʰʌməntˢɑːˀ
ørering	øːɐʁɛŋ
orne	ɒːnə
menneskerne	mɛnsɡ̊ɐnə
kileskrift	kʰiːləsɡ̊ʁæfd̥
akkusativ	akʰusatˢiːˀw
bryder	b̥ʁyðˀɐ
van	van
tålmod	tˢʌlmoðˀ
byrd	b̥yɐ̯ˀd̥
middelalderlitteratur	miðˀəlalˀʌlidəʁɑtuɐ̯ˀ
dyre	d̥yːɐ
synden	sønˀən
talte	tˢæˀld̥ə
tjod	tɕʌð
hjemme	jɛmə
kopper	kʰʌb̥ɐ
ångstrøm	ɔŋsd̥ʁœmˀ
slås	sl̥ɔˀs
klage	kʰl̥æːjə
tålmodig	tˢʌlmoˀði
fejlagtig	fɑjlɑɡ̊d̥i
grejet	ɡ̊ʁɑjˀð̩
talt	tˢæˀld̥
måler	mɔːlɐ
stødte	sd̥øˀd̥ə
barn	b̥ɑˀn
minde	menə
petersen	pʰeˀd̥ɐsn̩
toksisk	tˢʌɡ̊sisɡ̊
hieroglyfs	hioɡ̊lyfs
zarina	zɑʁiːna
amager	ɑmɑːˀɑ
kamme	kʰɑmə
brøk	b̥ʁœ̞ˀɡ̊
tendens	tˢend̥ɛnˀs
frømand	fʁ̥œ̞manˀ
indvortes	enʋɒːd̥əs
bær	b̥ɛɐ̯ˀ
afhold	ɑwhʌlˀd̥
statelig	sd̥æːˀd̥əli
nærig	nɛːɐ̯i
mand	mæ̞nˀ
mode	moːðə
konsekvens	kʰʌnsəkʰvɛnˀs
stockholm	sd̥ʌkʰʌlˀm
hø	høɪ̯ˀ
tjeneste	tɕɛːnsd̥ə
appelsinjuice	ɑb̥l̩siːˀnd̥juːs
browser	bɹɑwsɐ
forbydes	fɒb̥yˀðəs
jomfrufødsel	jʌmfʁ̥uføsl̩
trossamfund	tˢʁ̥oˀsɑmfɔnˀ
kule	kʰuːlə
bov	b̥ɒwˀ
kvæge	kʰʋ̥ɛːjə
dør	d̥œ̞ːˀɐ̯
udeblevet	uːð̩b̥leðˀð̩
restauranter	ʁɛsd̥oʁɑŋˀɐ
kernekraftværk	kʰaɐ̯nəkʰʁ̥ɑfd̥ʋaɐ̯ɡ̊
haj	hajˀ
nødvendige	nøðʋɛnˀd̥ii
læser	lɛˀsɐ
frelser	fʁalsɐ
men	mɛn
stand	sd̥anˀ
gæs	ɡ̊ɛs
vægre	ʋɛːʁɐ
trænet	tˢʁ̥aŋˀð̩
værpe	ʋaɐ̯rb̥ə
øjet	ʌjð̩
skrivelse	sɡ̊ʁiːʋl̩sə
hittebarn	hid̥əb̥ɑˀn
tøj	tˢʌj
straks	sd̥ʁɑɡ̊s
forbudne	fɒb̥uðˀnə
afholde	ɑwhʌlˀə
mistænke	mistɛŋˀɡə
dødt	d̥ød̥
æbleskive	eːb̥ləsɡ̊iːw
gød	ɡ̊øðˀ
uvis	uve̝s
kræsen	kʰʁ̥ɛːsn̩
feber	feˀb̥ɐ
lide	liˀ
mødte	mød̥ə
bøje	b̥ʌɪ
mindes	menəs
træner	tˢʁ̥æːnɐ
taltes	tˢald̥əs
anselig	anseˀli
nakkeost	nɑɡ̊əɔsd̥
hamstere	hɑmˀsd̥ɐɐ
bøssepar	b̥øsəpʰɑ
uforlignelig	ufɒliːˀnəli
røves	ʁœːʋəs
gedder	ɡ̊eðɐ
grønlænder	ɡ̊ʁɶnlɛnˀɐ
ønsketænkning	ønsɡ̊ətˢɛŋɡ̊neŋ
husbond	husb̥ʌn
hedde	heðə
klejn	kʰl̥ɑjˀn
torden	tˢoɐ̯d̥n̩
skulle	sɡ̊u
kætter	kɛdʌ
allegorisk	aləɡ̊oɐ̯ˀisɡ̊
weekend	wiːɡ̊ɛnd̥
gøteborg	ɡøːd̥əbɒwˀ
distance	d̥isd̥ɑŋsə
velocipede	ʋelosipʰeðð̩
bredden	b̥ʁæðˀn̩
udtryk	uðtˢʁ̥œ̞ɡ̊
ryk	ʁœɡ̊
forelsket	fɒɛlsɡ̊əð
parentes	pʰɑɑntˢeˀs
bidt	b̥id̥
hvedebrød	ʋeːð̠ˠəb̥ʁœð̠ˠˀ
caffelatte	kʰafəlad̥ə
tilpas	tˢepʰas
lægerne	lɛːjɐnə
uligt	uliɡ̊d̥
regering	ʁæɡeɐ̯eŋ
hvid	ʋiðˀ
museum	musɛːɔm
støbte	sd̥øb̥d̥ə
celle	sɛlə
tusind	tˢuˀsənə
genstand	ɡ̊ɛnsd̥anˀ
udgift	uðɡ̊ifd̥
råde	ʁɔːðə
vinder	venɐ
blodig	b̥loːði
kvad	kʰvæːˀð
lær	læɐ̯ˀ
galoche	ɡ̊alʌɕə
bunde	b̥ɔnə
beskidt	b̥esɡ̊id̥
trækkerdreng	tˢʁ̥aɡ̊ɐd̥ʁaŋˀ
pragtfuld	pʰʁ̥ɑɡ̊d̥fulˀ
slæb	slɛˀb̥
themsen	tˢɛmˀsn̩
ulden	ulˀn̩
arresterede	ɑɑsd̥eˀɐðə
græde	ɡ̊ʁaðð̩
dysse	d̥ysə
drive	d̥ɹɑjʋ
våben	vɔːˀb̥m̩
råbte	ʁʌb̥d̥ə
bonus	b̥oːnus
rane	ʁɑːnə
mellem	mɛlˀm̩
forældelse	fʌɛlˀəlsə
drømmeverdener	d̥ʁɶməʋaɐ̯d̥nɐ
afbildning	ɑwb̥ilˀneŋ
håb	hɔːˀb̥
sal	sæˀl
træn	tˢʁ̥æŋ
hu	huː
spørger	sb̥ɶɐ̯wɐ
handle	hanlə
udenlands	uðn̩lanˀs
yver	yːˀwɐ
lev	leːˀw
pøj	pʰʌj
hera	heːɐ
billede	b̥elð̩ð̩
gnom	ɡ̊noːˀm
forlag	fɒːlæˀj
luftkastel	lɔfd̥kʰasd̥ɛlˀ
ignorerer	injoʁɛˀɐ
ambolt	ɑmb̥ʌlˀd̥
følt	føˀld̥
det	d̥e
krog	kʰʁɔwˀ
fjerde	fjeːɐ
tyngdekraft	tˢøŋd̥əkʰʁɑfd̥
leven	leˀʋn̩
febre	feˀb̥ʁɐ
tilhørende	tˢelhøˀɐnə
største	sd̥ɶɐ̯sd̥ə
han	han
digte	d̥eɡ̊d̥ə
skel	sɡ̊ɛlˀ
kræft	kʁ̥ɑfd̥
apanage	apʰanæːɕə
ukendt	ukʰɛnˀd̥
sydvest	syðvɛsd̥
kvan	kvan
konstantinopel	kʰʌnsd̥antˢinoˀb̥l̩
ilddåb	ild̥ɔˀb̥
athena	atˢeːna
akkumulator	akʰumulæːtˢɐ
hertz	hæɐ̯d̥s
palmeolie	pʰalməoljə
våger	ʋɔwɐ
østrig	øsd̥ʁi
sav	sæˀw
halstørklæde	halsd̥ɐkʰl̥ɛːðə
paddel	pʰaðˀəl
kateder	kʰatˢeːˀd̥ɐ
tommelfinger	tˢʌml̩feŋˀɐ
ragouten	ʁɑɡ̊uːˀn̩
blød	b̥løðˀ
udstykke	uðsd̥øɡ̊ə
røgte	ʁœɡ̊d̥ə
tolvte	tˢʌlˀd̥ə
knarr	kʰnɑːˀ
flyver	flyːwɐ
vådt	ʋʌd̥
ametyst	ɑmətˢysd̥
dialekt	d̥ialɛɡ̊d̥
kost	kʰʌsd̥
afvige	ɑwʋiˀi
engelsk	ɛŋˀəlsk
forbuden	fɒb̥uðˀən
sus	suːˀs
unik	uniɡ̊
ager	æˀjɐ
badet	b̥æːðəd̥
trænet	tˢʁ̥æŋˀð̩
kvad	kʰvæðˀ
æske	ɛsɡ̊ə
ruiner	ʁuineɐ̯ˀ
tænder	tˢɛnˀɐ
højst	hʌɪ̯ˀsd̥
forræderi	fʌʁaðɐʁiˀ
hende	hinn̩
lære	læːɐ
forlide	fʌliðˀə
organisme	ɒɡ̊anismə
a'erne	æːɐnə
spøg	sb̥øˀj
lokal	lokʰæːˀl
utallig	utˢalˀi
tønde	tˢønə
øjne	ʌjnə
forbydende	fɒb̥yðˀənə
slægtning	slɛɡ̊neŋ
griset	ɡ̊ʁisəð
kvad	kʰvað
de	d̥i
bagbord	b̥ɑwb̥oːˀɐ̯
bedt	b̥eˀd̥
låge	lɔːwə
hud	huðˀ
afføring	ɑwføːˀɐ̯eŋ
læger	lɛːjɐ
ækel	ɛːˀɡ̊əl
vunden	vɔnən
blåbær	b̥lʌb̥æɐ̯
laser	lɛɪ̯sɐ
træffes	tˢʁ̥afəs
juveler	juvɘleɐ̯ˀ
flygte	fløɡ̊d̥ə
intetkøn	end̥əðkʰœnˀ
køber	kʰøwˀɐ
børste	b̥œ̞ɐ̯sd̥ə
spændte	sb̥ɛnˀd̥ə
sorger	sɒːwɐ
slesk	sl̥eːˀsɡ̊
enlig	eːnli
korkeg	kʰɑːɡ̊eːˀj
berlin	b̥aɐ̯liˀn
nytår	nyd̥ɒːˀ
belyse	b̥elyˀsə
veteran	vetˢəʁɑːˀn
luder	luːðɐ
lægge	lɛːɡ̊ə
megen	mɑjn̩
euripides	œwʁib̥id̥ɛs
sølvet	sølˀvəð
frelst	fʁɑlsd̥
røve	ʁœːʋə
spredte	sb̥ʁɛˀd̥ə
overfor	ɒwˀɐfɒ
siv	siwˀ
hinsides	hinsiːðəs
hjem	jɛmˀ
ihukommelse	ihuˀkʰʌmˀɭ̩sə
åben	ɔːb̥m̩
udklædt	uðkʰl̥ɛˀd̥
rod	ʁoðˀ
bryd	b̥ʁyðˀ
dobbelt	d̥ʌb̥əld̥
øvrig	øwʁi
hytternes	hyd̥ɐnəs
kendeord	kʰɛnəoɐ̯ˀ
brun	b̥ʁuːˀn
ubønhørlig	ubœnhøɐ̯ˀli
salve	salvə
sløv	sløwˀ
tidspunkt	tˢiðspʰɔŋˀd̥
dræber	d̥ʁɛːb̥ə
beskrivelse	b̥esɡ̊ʁiːˀvəlsə
dyrskue	d̥yɐ̯sɡ̊uːə
fødte	føːd̥ə
skræl	sɡ̊ʁalˀ
farfar	fɑˀfɑː
magten	mɑɡ̊d̥n̩
afrikaner	ɑfʁikʰæːˀnɐ
kors	kʰɒːs
tres	tˢʁ̥æs
national	naɕonæˀl
sørg	sɶɐ̯ˀ
varulv	ʋɑːulˀʋ
manko	mɑŋkʰo
fiskehandler	fesɡ̊əhanlɐ
spilleliste	sbe̝ləle̝sdə
masser	masɐ
hjerter	jæɐ̯d̥ɐ
socialisme	soɕalismə
blottede	b̥lʌd̥əðə
potentat	pʰotˢəntˢæːˀd̥
nikolai	neɡ̊olaɪ̯
holdent	hʌlənd̥
kop	kʰʌb̥
syl	syːˀl
bedrøve	b̥ed̥ʁœˀʋə
sky	skyˀ
ham	hɑmˀ
caribisk	kʰaʁiːˀb̥isɡ̊
blodplade	b̥loðpʰlæːðə
sudanesiske	sud̥aneːˀsisɡ̊ə
hvalp	ʋalˀb̥
stængel	sd̥ɛŋˀl̩
stedfar	sd̥ɛfɑː
male	mæːlə
misunde	misɔnˀə
besked	b̥esɡ̊eðˀ
regent	ʁɛɡ̊ɛnˀd̥
fiksstjerne	feɡ̊ssd̥jaɐ̯nə
gemen	ɡ̊emeˀn
kom	kʰʌm
kloakdyr	kl̥oɑɡ̊d̥yɐ̯ˀ
fisk	fesɡ̊
afgørende	ɑwɡ̊ɶˀɐnə
toge	tˢɔːʊ
bæst	b̥ɛˀsd̥
forglemmigej	fɒɡ̊lɛmˀiɑjˀ
ruse	ʁoːsə
skride	sɡ̊ʁiðð̩
martre	mɑːtˢʁ̥ɐ
hvilken	ʋelɡ̊ən
vidne	ʋiðnə
færdsel	faɐ̯sl̩
forjætter	fʌjɛd̥ɐ
dendrokronologi	dɛndʁokʁonoloɡiˀ
tebrev	tˢeˀb̥ʁæwˀ
mørkhudet	mɶɐ̯ɡ̊huˀðəd̥
gæv	ɡ̊ɛwˀ
botanik	b̥otˢaniɡ̊
møde	møːðə
vækkede	ʋɛɡ̊əðə
gejstligt	ɡ̊ɑjsd̥lid̥
stedbarn	sd̥ɛðb̥ɑˀn
vedrørende	ʋeðʁɶɐ̯ˀnə
nøgtern	nøɡ̊d̥ɐn
aflevering	ɑwleveːˀɐ̯eŋ
selvfølgelig	sɛføli
tyst	tˢysd̥
kunst	kʰɔnˀsd̥
piber	pʰiˀb̥ɐ
prædike	pʰʁ̥æːɡ̊ə
elskværdig	ɛlsɡ̊væɐ̯ˀd̥i
forhåbentlig	fʌhɔˀb̥m̩li
retslig	ʁɑd̥sl̥i
saftig	sɑfd̥i
anså	ansɔˀ
lårt	lɒːd̥
æggestok	ɛɡ̊əsd̥ʌɡ̊
hund	hunˀ
tradition	tˢʁɑd̥iɕonˀ
frosne	fʁ̥ɔsnə
valg	ʋɑlˀʝ
hørelse	høːɐlsə
rum	ʁɔmˀ
bygd	b̥yɡ̊d̥
værgedes	ʋaɐ̯wəðəs
bølge	b̥øljə
retslig	ʁad̥sl̥i
egon	eːɡ̊ʌn
der	d̥ɑ
køre	kʰøːɐ
brunch	b̥ɹʌnɕ
lidt	lid̥
ler	leˀɐ̯
pointe	pʰʌjnd̥ə
seng	sɛ̝ŋˀ
fodbold	foðb̥ʌlˀd
undren	ɔnd̥ʁɐ
jordisk	joɐ̯d̥isɡ̊
ugift	uɡ̊ifd̥
lagkage	lɑwkʰæːɪ
regelen	ʁɛjˀlən
sørge	sɶɐ̯wə
bukser	b̥ɔɡ̊sɐ
samtale	sɑmtˢæːˀlə
skede	sɡ̊eːðə
stjernekaster	sd̥jæɐ̯nəkʰasd̥ɐ
kærnemælk	kʰaɐ̯nəmɛlˀɡ̊
kystlinje	kʰøsd̥lenjə
arm	ɑːˀm
myggenæs	myɡ̊ənɛs
monstro	mʌnstˢʁ̥oˀ
krigstid	kʰʁ̥istˢiðˀ
kogte	kʰʌɡ̊d̥ə
eg	eːˀj
citere	sid̥ɐɐ
rugemor	ʁuːəmoɐ̯
føddernes	føðˀɐnəs
flødet	fløðð̩d̥
psykologi	syɡ̊oloɡ̊iːˀ
ønskedrøm	ønsɡ̊əd̥ʁɶmˀ
forbød	fɒb̥øðˀ
omgængelig	ʌmɡ̊ɛŋˀəli
italiener	itˢaljeˀnɐ
slikket	sleɡ̊əð
palæstinenser	pʰaləsd̥inɛnˀsɐ
første	fɶsd̥ə
mennesket	mɛnn̩sɡ̊əð
russisk	ʁusisɡ̊
måske	mɔsɡ̊eːˀ
fed	feˀð
bredder	b̥ʁæˀd̥ɐ
aflive	ɑʊ̯ːliʋə
hvo	voːˀ
tømmermænd	tˢœmɐmɛnˀ
tupilak	tˢub̥ilɑɡ̊
holdende	hʌlənə
erklæring	æɐ̯klɛˀɐ̯eŋ
tredive	tˢʁ̥ɑðʋə
tårn	tˢɒːˀn
fange	fɑŋŋ̩
imponeres	empʰoneːˀɐs
halvt	halˀd̥
dobbeltgænger	d̥ʌb̥l̩d̥ɡ̊ɛŋɐ
sygt	syˀd̥
ultimatum	ultˢimæːtˢɔm
mane	mæːnə
krudt	kʰʁ̥ud̥
fosforescere	fʌsfʌəseːˀɐ
grynt	ɡ̊ʁœ̞nˀd̥
parcel	pʰɑsɛlˀ
stygt	sd̥yɡ̊d̥
dril	d̥ʁælˀ
antyder	antˢyðˠˀɐ
kurer	kʰuʁɛːˀɐ̯
trold	tˢʁ̥ʌlˀ
hydrere	hyd̥ʁ̥eːˀɐ
gnaver	ɡ̊næːvɐ
bøsserøv	b̥øsəʁɶwˀ
rødder	ʁɶðˀɐ
dyb	d̥yˀb̥
silikat	silikʰæd̥ˀ
skrive	sɡ̊ʁiːʊ
charm	ɕɑˀm
mit	mid̥
konstruktion	kʰɔnsd̥ʁuɡ̊ɕoːˀn
autofokus	ɑwtˢofoːɡ̊us
hovmod	hɒwmoˀð
hede	heːðə
overlegen	ɒwɐleˀjen
søster	søsd̥ɐ
toilet	tˢʌilɛd̥
snestorm	snesd̥ɒːˀm
lasers	læːsɐs
lolland	lʌlanˀ
løbet	løːb̥əð
muldvarperne	mulʋɑːb̥ɐnə
ubestemt	ub̥esd̥ɛmˀd̥
fedme	feðmə
sprogene	sb̥ʁɔwˀənə
sorgen	sɒwˀn̩
lyseblå	lysəb̥lɔːˀ
brændenælde	b̥ʁannɛlə
abonnement	ab̥onəmɑŋ
tråd	tˢʁ̥ɔːˀð
larm	lɑːˀm
tyk	tˢyɡ̊
stegte	sd̥ɛɡ̊d̥ə
drys	d̥ʁœ̞s
liberalisme	lib̥ɑːɑlismə
verfe	ʋaɐ̯rfə
ødelægge	øðð̩lɛɡ̊ə
kirke	kʰiɐ̯ɡ̊ə
dør	d̥œ̞ɐ̯ˀ
starut	sd̥ɑʁud̥
forudsige	fɒuðsiˀɘ
pige	pʰiːi
den	d̥n̩
pegefinger	pʰɑjəfeŋɐ
blive	b̥liːi
åndet	ʌnəð
krævet	kʰʁ̥æːʋð̩
stedt	sd̥eˀd̥
akkumulere	akʰumuleːˀɐ
aftægt	ɑwtˢɛɡ̊d̥
urtid	uɐ̯tˢiðˀ
glamour	ɡ̊lamuːɐ̯
nynne	nønə
spådom	sb̥ʌd̥ʌmˀ
kage	kʰæːjə
åbn	ɔˀb̥m̩
tankens	tˢɑŋɡ̊ŋ̩s
taget	tˢæːjð̩
hovedstad	hoːð̩sd̥að
fortaltes	fʌtˢalˀd̥əs
tragisk	tˢʁ̥ɑˀɡ̊isɡ̊
foranstaltning	fʌansdalˀdneŋ
grøft	ɡ̊ʁœfd̥
hindbær	hemb̥æɐ̯
øg	øˀj
sammenstykke	sɑmm̩sd̥øɡ̊ə
museet	musɛːəð
skærsild	sɡ̊ɛɐ̯silˀ
mis	mis
dansken	d̥anˀsɡ̊ŋ̩
ting	tˢeŋˀ
sødmælk	søðˀmɛlˀɡ̊
smal	smalˀ
emotikon	emoːˀtˢikʰʌn
spørgsel	sb̥ɶɐ̯səl
tjek	tçɛɡ̊
hvilke	ʋelɡ̊ə
lysegrøn	lysəɡ̊ʁɶnˀ
talt	tˢalˀd̥
brændstof	b̥ʁansd̥ʌf
også	ʌsə
ædru	ɛːd̥ʁoˀ
fangenskab	fɑŋŋ̩sɡ̊æˀb̥
ildhu	ilhuˀ
arrester	ɑɑsd̥eɐ̯ˀ
monument	monumɛ̝ˀnd̥
fange	fɑŋə
reol	ʁæoˀl
araber	ɑʁɑːˀb̥ɐ
lort	loɐ̯ˀd
pauver	pʰɔːˀvɐ
hor	hoɐ̯ˀ
johannes	johanəs
kold	kʰʌlˀ
hera	heːʁɑ
skulptur	sɡ̊ulb̥tˢuɐ̯ˀ
træn	tˢʁ̥aŋ
nu	nu
kvaj	kʰʋ̥ɑjˀ
bog	b̥ɔˀw
krop	kʰʁ̥ʌb̥
arresterer	ɑɑsd̥eˀɐ
bid	b̥iˀð
kriger	kʰʁ̥iːɐ
lager	læˀɐ
fåfængt	fɔˀfɛŋˀd̥
gemte	ɡ̊ɛmd̥ə
kontor	kʰontˢoɐ̯ˀ
overvågningslisten	ɒʊ̯ɐʋɔʊ̯ˀneŋslesd̥n̩
læste	lɛsd̥ə
syer	syˀɐ̯
euro	ewʁo
pirat	pʰiʁɑːˀd̥
periodisk	pʰeɐ̯ioːˀðisɡ̊
præsens	pʰʁ̥ɛˀsəns
lykønske	løɡ̊ønˀsɡ̊ə
ren	ʁæˀn
tænkte	tˢɛŋˀd̥ə
rhin	ʁiˀn
daniel	d̥æːˀnjəl
køl	kʰøˀl
styr	sd̥yɐ̯ˀ
grejernes	ɡ̊ʁɑjɐnəs
myrde	myɐ̯d̥ə
indianer	ind̥iæˀnɐ
vædder	ʋɛðˀɐ
dybhav	d̥yb̥hɑw
bedare	b̥ed̥ɒˀɒ
landet	lanˀəð
skøge	sɡ̊øːø
samtidig	sɑmtˢiðˀi
afskyelig	ɑwsɡ̊yːˀəli
giv	ɡ̊i
tiest	tˢiːəsd̥
fejde	fɑjd̥ə
sigter	seɡ̊d̥ɐ
knald	kʰnalˀ
japaner	japʰæːˀnɐ
dansken	d̥ansɡ̊ŋ̩
nogensinde	noːənsenə
klæder	kʰl̥ɛːðɐ
forlide	fʌliˀðə
jage	jæːjə
kød	kʰøð
fej	fɑjˀ
rigsdagen	ʁisd̥æˀən
mikael	mikʰæːˀl
tørklæde	tˢɶɐ̯kʰl̥ɛːðə
alskens	alˀsɡ̊n̩s
jomfru	jʌmfʁ̥u
lagde	læː
lærde	læɐ̯ˀd̥ə
uvis	uviˀːs
bryllup	b̥ʁœlʌb̥
hans	hanˀs
tiere	tˢiːɐɐ
rente	ʁand̥ə
kulørt	kʰuløɐ̯ˀd̥
røv	ʁœwˀ
kvartetterne	kʰʋ̥ɑtˢɛd̥ɐnə
drikker	d̥ʁeɡ̊ɐ
odder	ʌðˀɐ
indenlandsk	enn̩lanˀsɡ̊
hyt	hyd̥
smagte	smɑɡ̊d̥ə
ungarer	ɔŋɡ̊ɑːˀɑ
sur	suɐ̯ˀ
blues	b̥lʊəs
usynlighed	usyːnliheðˀ
tomme	tˢʌmə
retterne	ʁɑd̥ɐnə
mødte	møˀd̥ə
falleret	faleːˀɐð
ragouter	ʁɑɡ̊uːˀɐ
orm	oɐ̯ˀm
begynder	b̥eɡ̊ønˀɐ
syv	sywˀ
avl	ɑwˀl
cremen	kʰʁ̥ɛˀmm̩
kokosolie	kʰoːɡ̊osoljə
sav	sæwˀ
blæst	b̥lɛːˀsd̥
mælk	mɛlˀɡ̊
herre	haɐ̯ɐ
tarv	tˢɑwˀ
gråd	ɡ̊ʁɔðˀ
spare	sb̥ɑːɑ
rutebil	ʁud̥əb̥iˀl
løj	lʌjˀ
nødtørft	nøðtˢɶɐ̯fd̥
tørst	tˢɶsd̥
sniksnak	sniɡ̊snɑɡ̊
nyttig	nød̥i
pandekage	pʰanəkʰæːjə
legetøjet	lɑːɪtˢʌjˀəð
fajance	fajɑŋsə
stupid	sd̥upʰiðˀ
jiddisch	jid̥iɕ
røvhul	ʁɶwhɔl
blad	b̥lað
tyskland	tˢysɡ̊lanˀ
dige	d̥iːə
bude	b̥uːðə
dig	d̥ɑj
leven	leːʋn̩
nilen	niˀln̩
elben	ɛlˀb̥m̩
femti	fɛmtˢi
svoger	sʋ̥ɒwˀɐ
lag	læˀj
give	ɡ̊iˀ
børneporno	b̥œɐ̯nəpʰɒːno
brev	b̥ʁæwˀ
ost	ɔsd̥
sigtet	seɡ̊d̥ð̩
spændes	sb̥ɛnəs
hebraisk	heb̥ʁɑːˀisɡ̊
theben	tˢeˀb̥m̩
først	fɶɐ̯sd̥
legetøjet	lɑːɪtˢʌðˀð̩
skabe	sɡ̊æ̝ːbə
tjekkiet	tɕɛkʰiˀəð
spøgte	sb̥øɡ̊d̥ə
gå	ɡ̊ɔˀ
slag	sl̥æˀj
støv	sd̥øˀw
lavet	læːʋəð
erotika	eʁoˀtˢikʰa
brødre	b̥ʁœðʁɐ
kendte	kɛnˀd̥ə
djævelsk	d̥jɛːvəlsɡ̊
kurv	kʰoɐ̯ˀw
angriber	anɡ̊ʁiːˀb̥ɐ
balstyrig	b̥alsd̥yːˀɐ̯i
komposition	kʰʌmpʰosiɕoːˀn
kil	kʰiːˀl
børje	b̥ɶɐ̯jə
kræse	kʰʁ̥æːsə
kvartet	kʰʋ̥ɑtˢɛd̥
hvid	ʋiˀð
bonen	b̥ʌŋˀŋ̩
hamsterne	hɑmˀsd̥ɐnə
hærget	haɐ̯wəð
slippe	sl̥eb̥ə
advare	aðvɑˀɑ
lade	læːðə
åbne	ɔːb̥nə
visdom	viːsd̥ʌmˀ
riste	ʁɛsd̥ə
fortryde	fʌtˢʁ̥yðˀə
fyrre	fyɐ̯ɐ
møg	mʌɪ̯
omsonst	ʌmsʌnˀsd̥
fortalte	fʌtˢalˀd̥ə
zone	soːnɘ
præfiks	pʰʁ̥ɛfeɡ̊s
tolken	tˢʌlˀɡ̊ən
gavnet	ɡ̊ɑwnˀəð
solskoldning	soːlsɡ̊ʌlneŋ
råd	ʁɔðˀ
burdet	b̥uɐ̯d̥əð
lade	la
gebyr	ɡ̊eb̥yɐ̯ˀ
slog	sl̥oˀ
bred	b̥ʁæðˀ
indgang	enɡ̊ɑŋˀ
burde	b̥uɐ̯d̥ə
gave	ɡ̊æːʊ
bumpet	b̥ɔmb̥ð̩
dusin	d̥usiːˀn
korrigere	kʰoɐ̯iɡ̊eːˀɐ
evig	eːʋi
højttaler	hʌjtˢæːlɐ
blive	b̥liːʋə
fakultet	faɡ̊ultˢeˀd̥
magter	mɑɡ̊d̥ɐ
ulovlig	ulɒwˀli
selvlysende	sɛllyːsn̩nə
gives	ɡ̊iːʊs
ombære	ʌmb̥ɛːˀɐ
stræbt	sd̥ʁab̥d̥
takker	tˢɑɡ̊ɐ
abe	æːb̥ə
holdte	hʌlˀd̥ə
tank	tˢɑŋˀɡ̊
cognac	kʰʌnˀjɑɡ̊
værgernes	ʋaɐ̯wɐnəs
karl	kʰæˀl
rimeligt	ʁiːməlid̥
afholdenhed	ɑwhʌlˀənheðˀ
lemmet	lɛmˀð̩
bonussen	b̥oːnusən
bedrive	b̥ed̥ʁiwˀʊ
matrone	matˢʁ̥oːnə
peter	pʰeːˀd̥ɐ
konvoj	kʰʌnvʌjˀ
pate	pʰatˢe
gebrokken	ɡ̊eb̥ʁʌɡ̊ŋ̩
døde	d̥øːðə
maile	mɛjlə
myg	myɡ̊
kugleramme	kʰuːləʁɑmə
opportun	ob̥ɐtˢuːˀn
samtale	sɑmtˢæːlə
blæst	b̥lɛsd̥
lever	lewˀɐ
sværddrager	svæɐ̯d̥ʁɑːwɐ
muldvarper	mulʋɑːb̥ɐ
tanken	tˢɑŋɡ̊ŋ̩
tredivte	tˢʁ̥aðfd̥ə
mejeri	mɑjɐʁiˀ
klæders	kʰl̥ɛːðɐs
falk	falˀɡ̊
tekniker	tˢɛɡ̊niɡ̊ɐ
kuldegysning	kʰuləɡ̊ysneŋ
hule	huːlə
på	pʰɔˀ
presse	pʰʁ̥ɑsə
ny	nyːˀ
eksaminer	ɛɡ̊samiːˀnɐ
olie	oljə
orgasme	ɒːɡæs̬mə
realist	ʁɛalisd̥
selvtægt	sɛltˢɛɡ̊d̥
næb	nɛ̝b̥ˀ
tav	tˢɑwˀ
autoritet	ɑwtˢoɐ̯itˢeːˀd̥
spurgt	sb̥uɐ̯ˀd̥
pålæggene	pʰʌlɛˀɡ̊ənə
mellem	mɛlˀəm
købe	kʰøːb̥ə
mager	mæˀɐ
væde	ʋɛðð̩
stående	sd̥ɔːənə
bryst	b̥ʁœsd̥
syer	syˀɐ
hinder	henˀɐ
link	leŋɡ̊
thukydid	tˢuɡ̊əd̥iðˀ
hamster	hɑmˀsd̥ɐ
italiener	itˢaljɛˀnɐ
diskret	d̥iskʰʁ̥ɛːˀd̥
vejlede	ʋɑjleðˀð̩
narko	nɑːkʰo
søvngænger	sœwnɡ̊ɛŋɐ
kagers	kʰæːɐs
forrådtes	fʌʁɔˀd̥əs
fisker	fesɡ̊ɐ
ribbe	ʁib̥ə
undrede	ɔnd̥ʁɐðə
kælder	kʰɛlɐ
hemmelig	hɛmm̩li
trodsig	tˢʁ̥ʌsi
vejr	ʋɛɐ̯ˀ
oversættelse	ɒwɐsɛd̥l̩sə
gaves	ɡ̊æːʋəs
to	tˢoˀ
smile	smiːˀlə
syntes	syns
tolk	tˢʌlˀɡ̊
skræk	sɡ̊ʁaɡ̊
dulgt	d̥ulˀd̥
cadeau	kʰad̥o
hærgende	haɐ̯wənə
brugbar	b̥ʁuːb̥ɑˀ
såre	sɒːɒ
mafioso	mɑfioːso
mikrobølge	mikʰʁ̥ob̥øljə
spartaner	sb̥ɑtˢæˀnɐ
havet	hæˀwð̩
jubilæum	jub̥ilɛːɔm
frue	fʁ̥uːu
svække	sʋɛɡ̊ə
tvære	tˢʋ̥ɛːɐ
snyde	snyːðə
optrådtes	ʌb̥tˢʁ̥ʌd̥əs
bast	b̥asd̥
jylland	jylanˀ
padde	pʰaðə
tyre	tˢyːɐ
kan	kʰanˀ
husbåd	husb̥ɔːˀð
nøgtern	nøɡ̊tˢaɐ̯ˀn
guldfisk	ɡ̊ulfesɡ̊
koma	kʰoːma
rus	ʁuːˀs
følelse	føːləlsə
men	meːˀn
fandtes	fand̥əs
stakåndet	sd̥ɑɡ̊ʌnˀəð
motor	moːtˢɒ
sund	sɔnˀ
haitiansk	haitˢiæːˀnsɡ̊
est	ɛsd̥
fortsætte	fɒːd̥sɛd̥ə
flere	fleːɐ
forlyde	fɒːlyðð̩
latter	lad̥ɐ
fører	føːɐ
ulden	ulˀən
forbyden	fɒb̥yðˀən
brist	b̥ʁɛsd̥
klædte	kʰl̥ɛːd̥ə
dæmpe	d̥ɛmb̥ə
levere	leveˀɐ
heldig	hɛld̥i
vent	vɛnˀd̥
besøger	b̥esøˀɐ
holder	hʌlˀɐ
misse	misə
gåsepotentil	ɡ̊ɔːsəpʰotˢəntˢiːˀl
flød	fløðˀ
skrævet	sɡ̊ʁɛˀwəð
art	ɑˀd̥
dionysos	d̥ionysʌs
lyse	lyːsə
sjæl	ɕɛˀl
fejle	fɑɪ̯lə
frosset	fʁ̥ɔsð̩
attrå	atˢʁ̥ɔˀ
svare	sʋ̥ɑːɑ
fredelig	fʁ̥æːðəli
berede	b̥eʁæðˀð̩
sagte	sɑɡ̊d̥ə
kræft	kʁ̥æfd̥
joho	jɔhɔʊ̯ˀ
balsamisk	b̥alsæˀmisɡ̊
søgt	søɡ̊d̥
kryster	kʰʁ̥ysd̥ɐ
kristendom	kʰʁ̥ɛsd̥ənd̥ʌmˀ
omgåedes	ʌmɡ̊ɔˀəðəs
holdning	hʌlneŋ
ligt	liɡ̊d̥
amerikaner	ɑmɑikʰæˀnɐ
lobbye	lʌb̥iːˀə
sidde	seðə
fugl	fuu̯ːˀl
gevaldig	ɡ̊evalˀd̥iɡ
lærerne	læːɐnə
nævn	nɛʊ̯ˀn
kolonialisme	kʰolonialismə
gaves	ɡ̊æːʊs
kradse	kʰʁ̥ɑsɘ
aubergine	ob̥æɐ̯ɕiːn̩
reel	ʁɛɛlˀ
grejers	ɡ̊ʁɑjɐs
ordklasse	oɐ̯kʰlasə
tor	tˢoːˀɐ̯
tænkte	tˢɛŋd̥ə
lian	liæːˀn
svin	sʋiˀn
ørken	ɶɐ̯ɡ̊ŋ̩
åre	ɒːɒ
form	fɒːˀm
bragt	b̥ʁɑɡ̊d̥
undtage	ɔntˢæˀ
fordi	fʌd̥iˀ
tap	tˢɑb̥
klæde	kʰl̥ɛˀ
stud	sd̥uˀð
fro	fʁ̥oˀ
nådig	nɔːði
aktivist	ɑɡ̊tˢivisd̥
passiv	pʰasiwˀ
svie	sʋiːə
træls	tˢʁ̥als
stjæler	sd̥jɛːlɐ
vandbakkelse	ʋanb̥ɑɡ̊əlsə
undgå	ɔnɡ̊ɔˀ
tronarving	tˢʁ̥oːnɑːveŋ
hvis	ves
længsel	lɛŋˀsəl
enebær	eːnəb̥æɐ̯
transformer	tʁ̥ɑnsfɒmeɐ̯ˀ
sojaolie	sʌjaoljə
drøn	d̥ʁœ̞ːˀn
buket	b̥ukʰɛd̥
slagne	sl̥æːjnə
slæber	slɛˀb̥ɐ
astma	asd̥ma
bøn	bœnˀ
frikadelle	fʁæɡ̊əd̥ɛlə
tusind	tˢuˀsn̩
sandsten	sansd̥eːˀn
kongerige	kʰʌŋəʁiːə
julefrokost	juːləfʁɔɡ̊ʌsd
øldåse	øld̥ɔːsə
medie	meːˀd̥jə
hjemlig	jɛmli
mellemnavn	mɛləmnɑwˀn
tyrkisk	tˢyɐ̯kʰisɡ̊
super	suˀb̥ɐ
trekke	tˢɹɛɡ̊ə
jul	juˀl
bombe	b̥ɔmb̥ə
imod	imoðˀ
koldbrand	kʰʌlb̥ʁɑnˀ
troede	tˢʁ̥oːð̩ð̩
udlænding	uðlɛnˀeŋ
toksikolog	tˢʌɡ̊sikʰoloːˀ
kunde	kʰɔnə
vippe	veb̥ə
zink	seŋˀɡ̊
bus	b̥us
ugentlig	uːənd̥li
des	d̥is
mørbrad	møɐ̯ˀb̥ʁɑðˀ
hieroglyffer	hioɡ̊lyfɐ
spændt	sb̥ɛnˀd̥
bevæge	b̥evɛˀjə
patéen	pʰatˢeːˀn̩
taber	tˢæːb̥ɐ
nektarin	nɛɡ̊tˢɑʁiːˀn
sirene	siʁɛːnə
ressource	ʁɛsuɐ̯sə
grejets	ɡ̊ʁɑjˀð̩s
os	oːˀs
piv	pʰiwˀ
italiensk	itˢaljeˀnsɡ̊
pik	pʰeɡ̊
indavl	enɑwˀl
jordnøddesmør	joɐ̯nøðəsmœ̞ɐ̯
kubikmeter	kʰub̥iɡ̊meːˀd̥ɐ
klokken	kʰl̥ʌɡ̊ŋ̩
liggendefæ	leɡ̊ənəfɛˀ
loven	lɔwˀn̩
karpe	kʰɑːb̥ə
byg	b̥yɡ̊
udebliver	uːðəb̥liɐ̯ˀ
athenæisk	atˢenɛˀisɡ̊
skib	sɡ̊iwˀ
frimurer	fʁimuːɐ
føle	føːlə
brinten	b̥ʁænˀd̥n̩
dreng	d̥ʁa̝ŋˀ
apropos	apʰʁ̥opʰo
afbilde	awb̥elˀə
dampskib	d̥ɑmb̥sɡ̊iːˀb̥
accenternes	ɑɡ̊sɑŋˀɐnəs
nordisk	noɐ̯d̥isɡ̊
canadier	kʰanæːˀd̥jɐ
afmagt	ɑwmɑɡ̊d̥
jernbane	jaɐ̯nb̥æːnə
unde	ɔnə
indebrændt	enəbʁanˀd
klientel	kʰliəntˢɛlˀ
dør	d̥øːˀɐ̯
flink	fleŋˀɡ̊
feberen	feˀb̥ɐɐn
sjette	ɕɛːdə
te	tˢeːˀ
flaske	fl̥asɡ̊ə
aftale	ɑwtˢæːˀlə
avocado	aʋokʰæːd̥o
styr	sd̥yˀɐ̯
bisætning	b̥isɛd̥neŋ
arbejdsløs	ɑːb̥ɑjd̥sløˀs
krebs	kʰʁ̥ɑb̥s
snavset	snɑwsɘð
oftest	ʌfd̥əsd̥
manke	mɑŋɡ̊ə
tankevækkende	tˢɑŋɡ̊əʋɛɡ̊ənə
spæne	sb̥ɛːnə
tibetansk	tˢib̥ətˢæːˀnsɡ̊
holdende	hʌlnə
flytte	flød̥ə
velkendt	vɛlkʰɛnˀd̥
musket	musɡ̊ɛd̥
spille	sb̥elə
ærgerlig	aɐ̯wli
solgt	sʌlˀd̥
træ	tˢʁ̥æˀ
musikfolk	musiɡ̊fʌlˀɡ̊
bruge	b̥ʁoːo
rødderne	ʁɶðˀɐnə
meget	mɑjd̥
træffer	tˢʁ̥afɐ
svinde	svenə
guldet	ɡ̊ulˀəð
røves	ʁɶːʊs
torv	tˢɒːˀw
lak	lɑɡ̊
medarbejder	mɛðɑːb̥ɑjˀd̥ɐ
trættekær	tˢʁ̥ad̥əkʰɛːˀɐ̯
rugmel	ʁuːmeːˀl
drukne	d̥ʁɔɡ̊nə
kår	kʰɒˀ
værktøjet	vaɐ̯ɡ̊tˢʌðˀð̩
nymodens	nymoˀðɘns
afklæde	ɑwkʰl̥ɛðˀə
oprette	ʌbʁadə
stresse	sd̥ʁɑsə
bedrager	b̥ed̥ʁɑwˀɐ
blåøjet	b̥lʌʌjˀəð
bjørn	b̥jœ̞ɐ̯ˀn
satte	sad̥ə
pander	pʰanə
løvinde	løwenə
kanin	kʰaniˀn
kost	kʰɔsd̥
værdifuld	ʋaɐ̯d̥ifulˀ
pinligst	pʰiːnlisd̥
resonere	ʁæsoneˀɐ
organist	ɒːɡanisd̥
komposition	kʰɔmpʰosiɕoːˀn
ild	ilˀ
ragout'en	ʁɑɡ̊uːˀn̩
svagt	svæˀjd̥
len	leˀn
sine	siːnə
barndom	b̥ɑːnd̥ʌmˀ
spænding	sb̥ɛneŋ
bar	b̥ɑˀ
sprænge	sb̥ʁaŋə
gebrokne	ɡ̊eb̥ʁʌɡ̊nə
taget	tˢæˀjð̩
fulgte	fulˀd̥ə
frænde	fʁɑnə
ordføjning	oɐ̯fʌjneŋ
grine	ɡ̊ʁiːn̩
totale	tˢotˢæːˀlə
jævnstrøm	jɛʊ̯nsd̥ʁɶmˀ
kure	kʰuːɐ
galop	ɡ̊alʌb̥
stæder	sd̥ɛːðɐ
kone	kʰoːnə
kvarte	kʰʋ̥ɑːd̥ə
ellevte	ɛlfd̥ə
apparat	ɑb̥əʁɑːˀd̥
accenten	ɑɡ̊sɛnˀd̥n̩
græskar	ɡ̊ʁɑskʰɑ
træffedes	tˢʁ̥ɑfəðəs
løss	løs
helliget	hɛliið
påmindelse	pʰʌmenˀelsə
fattigdom	fad̥id̥ʌmˀ
musik	musiɡ̊
søge	søːø
syrer	syˀɐ
orientering	ɒiəntˢeːˀɐ̯eŋ
skumme	sɡ̊ɔmə
fagot	faɡ̊ʌd̥
gule	ɡ̊uːl̩
færdsel	faɐ̯ˀsl̩
skred	sɡ̊ʁæð
halm	halˀm
hjælpen	jɛlb̥m̩
nødvendig	nøðʋɛnˀd̥i
vaskemaskine	vasɡ̊əmasɡ̊iːnə
gavnlig	ɡ̊ɑwnli
forråd	fʌʁɔˀð
accent	ɑɡ̊sɑŋ
messehagel	mɛsəhæˀl̩
tabe	tˢæːʊ
forbudte	fɒb̥ud̥ə
absurd	ɑbsuɐ̯ˀd̥
fred	fʁ̥æð
rakte	ʁɑɡ̊d̥ə
metal	metˢal
sara	sɑːʁɑ
erotica	eʁoˀtˢikʰa
uvægerlig	uʋɛˀɐli
frugtbar	fʁ̥ʌɡ̊d̥b̥ɑːˀ
kærtegne	kɛɐ̯tˢɑɪ̯nə
piner	pʰiːˀnɐ
halvandet	halanð̩
yngre	øŋʁɐ
atonal	atˢonæːˀl
hyttes	hyd̥əs
stresse	sd̥ʁɛsə
frost	fʁ̥ʌsd̥
rætoromansk	ʁɛːtˢoʁomæːˀnsɡ̊
ønske	ønsɡə
gulerød	ɡ̊uləʁœðˀ
lampe	lɑmb̥ə
overvægtig	ɒwɐʋɛɡ̊d̥i
sy	syːˀ
dårligste	d̥ɒːlisd̥ə
udsigt	uðseɡ̊d̥
stendød	sd̥eːnd̥øðˀ
indbildning	enb̥ilˀniŋ
græskar	ɡ̊ʁaskʰɑ
færre	faɐ̯ɐ
aubergine	ob̥æɐ̯ɕinː
offentlige	ʌfn̩lii
telt	tˢɛlˀd̥
snebold	sneb̥ʌlˀd̥
hadet	haðˀəd̥
brintbombe	b̥ʁænd̥b̥ɔmb̥ə
værgende	ʋaɐ̯ʊnə
gråne	ɡ̊ʁɔːnə
bære	b̥ɛːɐ
lodden	lʌðn̩
flest	fleˀsd̥
sild	silˀ
blotter	b̥lʌd̥ə
bedrøvet	b̥ed̥ʁœˀʋð̩
krig	kʰʁ̥iˀ
grønsvær	ɡ̊ʁɶnsʋɛɐ̯ˀ
kynisk	kʰyːˀnisɡ̊
fløde	fløðð̩
placere	pʰl̥aseˀɐ
steg	sd̥eˀj
frygtelig	frœɡ̊d̥əli
pigtråd	pʰiɡ̊tˢʁ̥ɔːˀð
flimre	flemʁɐ
ådsel	ʌðˀsəl
værges	ʋaɐ̯wəs
tvært	tˢʋ̥aɐ̯d̥
ytringsfrihed	yd̥ʁeŋsfʁiheðˀ
spærre	sb̥æɐ
medaljon	med̥aljʌŋ
støde	sd̥øðð̩
slaver	slæːʋɐ
krævede	kʰʁ̥æːʋð̩ð̩
kostume	kʰosd̥yːmə
nonne	nʌnə
bregne	b̥ʁɑjnə
himmel	heml̩
tid	tˢiðˀ
røst	ʁœsd̥
tjene	tɕɛːnə
mette	mɛd̥ə
træffe	tˢʁ̥afə
psykisk	syɡ̊isɡ̊
traditionel	tˢʁ̥ɑd̥iɕonɛlˀ
skadefryd	sɡ̊æðð̩fʁ̥yðˀ
monne	mɔnə
hø	heːˀ
a	æːˀ
fashionabel	faɕonæˀb̥əl
brøkdel	b̥ʁœˀɡ̊d̥eˀl
syne	syːnə
skovl	sɡ̊ɒwˀl
ej	ɑj
mave	mæːʋə
bæger	b̥ɛːɐ
arkitekt	ɑɡ̊itˢɛɡ̊d̥
gjalde	ɡ̊jalə
aflevere	ɑʊ̯leʋeːˀɐ
blinke	b̥leŋɡ̊ə
borgmester	b̥ɒmɛsd̥ɐ
streg	sd̥ʁɑjˀ
skyg	sɡ̊yɡ̊
freden	fʁ̥æðˀn̩
vellevned	ʋɛllɛwnð̩
ord	oɐ̯ˀ
overlevende	ɒwɐleːˀvənə
stil	sd̥elˀ
lystig	løsd̥i
astronaut	asd̥ʁonɑwˀd̥
dyrisk	d̥yɐ̯ˀisɡ̊
spæk	sb̥ɛɡ̊
gravsten	ɡ̊ʁɑwsd̥eːˀn
hjælpen	jɛlˀb̥ən
tryne	tˢʁyːnə
lyster	lysd̥ɐ
cyklist	syɡ̊lisd̥
tyran	tˢyʁɑˀn
sørge	sɶɐ̯ʊ
forjætte	fʌjɛd̥ə
brasilien	b̥ʁɑsilˀjən
hente	hɛndə
høde	høðð̩
borde	b̥oːɐ
fremragende	fʁɑmʁɑwˀn̩nə
kandestøber	kʰanəsd̥øːb̥ɐ
brække	b̥ʁaɡ̊ə
værget	ʋaɐ̯wəð
hacke	haɡ̊ə
cicero	sisəʁo
råerne	ʁɔˀɐnə
flydende	flyːðənə
drev	d̥ʁæwˀ
lave	læːʊ
helhest	hɛlhɛsd̥
jævn	jɛwˀn
cowboybukser	kʰɒwb̥ʌjb̥ɔɡ̊sɐ
halvtredsindstyve	haltˢʁ̥æsn̩stˢyːʋə
odør	od̥œːɐ̯
billeder	b̥elðɐ
marker	mɑːɡ̊ɐ
ræddes	ʁaðð̩s
jegs	jɑjs
konservativ	kʰʌnsæɐ̯vatˢiwˀ
filigran	filiɡ̊ʁɑn
sådan	sʌnˀəd
får	fɒˀ
fond	fʌŋ
slugt	sluɡ̊d̥
stort	sd̥oɐ̯ˀd̥
skøder	sɡ̊øːðɐnə
uhyre	uhyˀɐ
drømmekage	d̥ʁɶməkʰaɪ̯ə
ab	ɑb̥
mørbrad	møɐ̯ˀb̥ʁɑ
tov	tˢɒw
rets	ʁɑd̥s
talk	tˢalˀɡ̊
solsikkeolie	soːlseɡ̊əoljə
abonnement	ɑb̥ɔnəmɑŋ
tøve	tˢøːʊ
søhelt	søhɛlˀd̥
nævne	nɛʊ̯nə
kvække	kʰvɛɡ̊ə
skete	sɡ̊eˀd̥ə
køber	kʰøːb̥ɐ
terminologi	tˢæɐ̯minoloɡ̊iːˀ
trosbekendelse	tˢʁ̥oˀsb̥ekʰɛnˀl̩sə
engel	ɛŋəl
brugelig	b̥ʁuːəli
digter	d̥eɡ̊d̥ɐ
leve	leːʊ
tranebær	tˢʁ̥ɑːnəb̥æɐ̯
ordforråd	oɐ̯fʌʁɔˀð
pattedyr	pʰad̥əd̥yɐ̯ˀ
griser	ɡ̊ʁisɐ
belægge	b̥elɛɡə
tyve	tˢyːʋə
omsorg	ʌmsɒːˀw
afpresning	ɑwpʰʁ̥asneŋ
arving	ɑːveŋ
ældste	ɛlˀsd̥ə
producer	pʰʁ̥od̥juːsɐ
rund	ʁɔnˀ
tynd	tˢønˀ
ekstravagant	ɛɡ̊stˢʁ̥ɑvaɡ̊anˀd̥
respektive	ʁæsb̥əɡ̊tˢiːˀvə
hinsides	hensiːðəs
sovs	sɒwˀs
bønne	b̥œnə
teknik	tˢɛɡ̊niɡ̊
avanceret	avɑŋseːˀɐð
retten	ʁɑd̥n̩
forråd	fɒːʁɔðˀ
ødegård	øðð̩ɡ̊ɒˀ
lignelser	liːnəlsɐ
stress	sd̥ʁɛs
lærred	læɐ̯ð̩
laser	læːsɐ
triumf	tʁiɔmˀf
enbenet	eːnb̥eːˀnəð
døbt	d̥øb̥d̥
bødker	b̥øðˀɡ̊ɐ
flødeis	fløːðəiːˀs
mennesker	mɛnn̩sɡ̊ɐ
hærget	haɐ̯ʊð
den	d̥ɛnˀ
kravle	kʰʁ̥ɑwlə
gavn	ɡ̊ɑwˀn
aksel	ɑɡ̊sl̩
doktorerne	d̥ʌɡ̊d̥ɐnə
når	nɒːˀ
cylindrisk	sylenˀd̥ʁisɡ̊
brydes	b̥ʁyðð̩s
gang	ɡɑ̃ɪ̃ˀ
musketer	musɡ̊ətˢeːˀɐ̯
maler	mæːlɐ
kondom	kʰʌnd̥oːˀm
fatamorgana	fatˢamɒɡ̊æːna
lader	læːðɒ
tørstig	tˢɶɐ̯sd̥i
spå	sb̥ɔˀ
odde	ʌðð̩
tråd	tˢʁʌð
unødvendigt	unøðʋɛnˀd̥id̥
hjørne	jœ̞ɐ̯nə
maske	masɡ̊ə
computer	kʰʌmpʰj̊uːd̥ɐ
fest	fɛsd̥
volde	ʋʌlə
fyre	fyːɐ
gad	ɡ̊æðˀ
seer	seːˀɐ
restauranten	ʁɛsd̥oʁɑŋˀŋ̩
koben	kʰoːˀb̥eːˀn
dug	d̥uɡ̊
søndre	sønʁɐ
måneformørkelse	mɔːnəfɒmœ̞ɐ̯ɡ̊əlsə
motivation	motˢivaɕoːˀn
standart	sd̥and̥ɑːˀd̥
bulgarsk	b̥ulɡ̊ɑːˀsɡ̊
hende	henə
skalle	sɡ̊alə
ør	øˀɐ̯
kæreste	kʰɛːɐsd̥ə
sål	sɔːˀl
bedemand	b̥eːðəmanˀ
optræd	ʌb̥tˢʁ̥ɛˀð
sænke	sɛŋɡ̊ə
pigtråd	pʰiɡ̊tˢʁ̥ɔðˀ
vrid	vʁiðˀ
tyfussen	tˢyːfusn̩
rædsom	ʁaðsʌmˀ
jernenes	jaɐ̯ˀnənəs
karnap	kɑnɑb̥
bud	b̥uð
ussel	usəl
halvanden	halanən
stratosfære	sd̥ʁɑd̥osfɛːɐ
kanapé	kʰanapʰeːˀ
a'ernes	æːɐnəs
etage	etˢæˀɕə
forliget	fʌliðˀð̩
kinesisk	kʰinɛsisɡ̊
grådig	ɡ̊ʁɔːði
for	foɐ̯ˀ
ond	ɔnˀ
sømme	sœmə
frygt	fʁ̥œɡ̊d̥
svøben	sʋøːb̥m̩
kakao	kʰakʰæːo
reglen	ʁæˀlən
telefonboks	tˢeləfoːˀnb̥ʌɡ̊s
modig	moːði
ordentlig	ɒːˀd̥ənli
tør	tˢɶɐ̯
plombe	pʰlɔmb̥ə
yde	yːð̠ˠə
snigskytte	sniːsɡ̊ød̥ə
skørost	sɡ̊øɐ̯ɔsd̥
hersker	hæɐ̯sɡ̊ɐ
monoteist	monoteisd̥
castiliansk	kasdiljæˀnsɡ
ikke	eɡ̊ə
gås	ɡ̊ɔˀs
fagre	fɑwʁɐ
dagligt	d̥ɑwlid̥
ræd	ʁɑðˀ
høj	hʌjˀ
solbær	soːlbæɐ̯
gammel	ɡ̊ɑml̩
kvan	kvanˀ
gulvene	ɡ̊ɔlnə
religion	ʁɛliɡjoˀn
check	ɕɛɡ̊
fakkel	fɑɡ̊l̩
sparta	sb̥ɑːtˢa
ægtemand	ɛɡ̊d̥əmanˀ
sender	sɛnɐ
levning	lɛwneŋ
el	ɛl
overflod	ɒwɐfloˀð
gestus	ɡ̊ɛsd̥us
lyve	lyːʊ
opstige	ʌb̥sd̥iˀə
britisk	b̥ʁid̥isɡ̊
harme	hɑːmə
hjælp	jɛlˀb̥
slaver	slæwˀɐ
teori	tˢeoʁiˀː
trætte	tˢʁ̥ɑd̥ə
køer	kʰøˀɐ
brøde	b̥ʁœðð̩
knurre	kʰnoːɐ
bue	b̥uːə
tværs	tˢʋ̥aɐ̯s
tovet	tˢɒwˀð̩
våge	ʋɔːʊ
sig	sɑj
stift	sd̥ifd̥
ånden	ʌnˀn̩
opslagstavle	ʌb̥sl̥æjstˢɑwlə
stuve	sd̥uːʋə
styrende	sd̥yːɐnə
jordskælv	joɐ̯sɡ̊ɛlˀv
præcis	pʰʁ̥æsiˀs
database	d̥æːtˢab̥æːsə
uligt	uliˀd̥
stuearrest	sd̥uːaʁasd̥
endestation	ɛnəsd̥aɕoˀn
halve	hall̩
stegepande	sd̥ɑːɪpʰanə
mogens	mɔːʊ̯ns
formåen	fʌmɔˀən
stresset	sd̥ʁasəð
bug	b̥uˀ
asien	æˀɕən
kind	kʰenˀ
danablu	dæːnabluː
smølf	smølf
hvidvin	viðviːˀn
catalansk	kʰatˢalæːˀnsɡ̊
lån	lɔˀn
gnide	ɡ̊niːðɘ
kryddersild	kʰʁ̥œðɐsilˀ
brændpunkt	b̥ʁɑnpʰɔŋˀd̥
båret	b̥ɒːɒð
skræv	sɡ̊ʁawˀ
rets	ʁad̥s
revolution	ʁɛvoluɕoːˀn
ben	b̥eˀn
stram	sd̥ʁɑmˀ
abbed	ab̥eð
postfaktuel	pʰɔˀsd̥fɑɡ̊tˢuɛlˀ
ret	ʁad̥
vejr	ʋɛˀɐ̯
pynte	pʰønd̥ə
loven	lɒwˀn̩
bødker	b̥øˀɡ̊ɐ
spække	sb̥ɛɡ̊ə
ræddes	ʁɑðð̩s
brunette	b̥ʁunɛd̥ə
færger	faɐ̯wɐ
age	æːjə
rigtig	ʁæɡ̊d̥i
deviere	devieˀʌ
pupil	pʰupʰilˀ
eksem	eɡ̊seːˀm
aftner	ɑfd̥ənɐ
råt	ʁʌd̥
tredivte	tˢʁ̥ɑðfd̥ə
hytte	hyd̥ə
ændringsforslag	ɛnd̥ʁeŋsfɒːsl̥æˀ
fulgte	fuld̥ə
parat	pʰɑʁɑˀd̥
spånplade	sb̥ʌnpʰlæːðə
tåre	tˢɔːɐ
tølt	tˢœlˀd̥
vred	ʋʁæðˀ
trone	tˢʁ̥oːnə
vidt	vid̥
gengive	ɡɛnɡiˀ
høvle	hœwlə
eksaminand	eɡ̊saminanˀd̥
police	pʰoliːsə
kakofoni	kʰɑɡ̊afoniːˀ
humor	huːmɐ
årstid	ɒːstˢiðˀ
tallerken	tˢalæɐ̯ɡ̊ŋ̩
line	liːnɘ
værnemagt	ʋaɐ̯nəmɑɡ̊d̥
ad	aðˀ
trompeter	tˢʁ̥ɔmpʰətˢeːˀɐ̯
kulde	kʰull̩
skjul	sɡ̊juˀl
gener	ɕeseɐ̯ˀ
bold	b̥ʌlˀd̥
røven	ʁɶwˀən
læser	lɛːsɐ
arsen	ɑːsen
franker	fʁɑŋˀkʰisɡ̊
sæd	sɛːˀð
skam	sɡ̊ɑm
last	lasd̥
hytteost	hyd̥əɔsd̥
bånd	b̥ʌnˀ
dværg	d̥væɐ̯ˀw
kavaleri	kʰaʋaləʁiˀ
større	sd̥ɶɐ̯ɐ
julekort	juːləkʰɑːd̥
folketing	fʌlɡ̊ətˢeŋˀ
artikler	ɑtˢiɡ̊lɐ
hobe	hoːb̥ə
carbon	kʰɑːb̥ʌn
sandstorm	sansd̥ɒˀm
sneg	sneˀ
sydkyst	syðˠkʰøsd̥
hæfte	hɛfd̥ə
melodigrandprix	melod̥iɡ̊ʁɑnpʰʁ̥i
svøbt	sʋøb̥d̥
hallo	halɔ
samler	sɑmlɐ
mene	meːnə
ordsprog	oɐ̯sb̥ʁɔwˀ
slut	sl̥ud̥
råd	ʁʌð
hjemmeside	jɛməsiːðə
kræfterne	kʰrafd̥ɐnə
kammer	kʰɑmɐ
uhyre	uhyːɐ
tykkes	tˢyɡ̊əs
biting	b̥itˢeŋˀ
kuldioxid	kʰɔld̥iʌɡ̊ksiðˀ
leksikon	lɛɡ̊sikʰʌn
revolutionær	ʁɛvoluɕonɛːˀɐ̯
høre	høːɐ
aflyse	ɑwlyˀsə
lettisk	lɛd̥isɡ̊
træls	tˢʁ̥ɑlˀs
homoseksuel	hoːmosɛɡ̊suɛlˀ
sølv	søl
ptolemæisk	tˢoləmɛˀisɡ̊
udeblevet	uːðəb̥lewˀəð
teater	tˢeaˀd̥ɐ
epoke	epʰoːɡ̊ə
nyfigen	nyfiːˀən
våges	ʋɔːʊs
mørkeræd	mɶɐ̯ɡ̊əʁaðˀ
kræset	kʰʁ̥æːsð̩
hø	hɔɪ̯ˀ
busser	b̥usɐ
følsom	føːlsʌmˀ
bussemand	b̥usəmanˀ
råen	ʁɔˀən
familie	familˀjə
samle	sɑmlə
filsben	fiˀlsb̥eˀn
tysker	tˢysɡ̊ɐ
fængslet	fɛŋˀsləð
faktisk	fɑɡ̊d̥isɡ̊
ti	tˢiˀ
halvtredje	haltˢʁ̥ɛðjə
stygge	sd̥yɡ̊ə
værgerne	ʋaɐ̯wɐnə
athenienser	atˢeniɛnˀsɐ
forråd	fɒːʁɔˀð
godt	ɡ̊ʌd̥
var	ʋɑˀ
optræde	ʌb̥tˢʁ̥aðˀə
viljestyrke	viljəsd̥yɐ̯ɡ̊ə
folklore	fʌlɡ̊loːɐ
kødets	kʰøðˀəd̥s
nav	nawˀ
studere	sd̥ud̥eˀɐ
juice	d̥juːs
uskyldig	usɡ̊ylˀd̥i
ignorerede	inoʁɛˀɐðə
løsen	løːsən
undertiden	ɔnɐtˢiðˀən
jegets	jɑðˀð̩s
pinligste	pʰiːnlisd̥ə
tag	tˢæˀ
kvalt	kʰʋ̥æˀld̥
grinen	ɡ̊ʁiːnə
fortsat	fɒːd̥sad̥
trussel	tˢʁusl̩
fløjte	fl̥ʌjd̥ə
traf	tˢʁ̥ɑf
omgående	ʌmɡ̊ɔˀnə
rive	ʁiːʊ
ulv	ulˀʋ
sørge	sɶːɐ
færrest	faɐ̯ɐsd̥
fagert	fæˀjɐd̥
begribe	b̥eɡ̊ʁiˀb̥ə
svor	sʋ̥oˀɐ̯
bagatel	b̥ɑɡ̊atˢɛlˀ
fyr	fyɐ̯
døende	d̥øˀənə
næse	nɛːsə
nydelig	nyːðəli
kræs	kʰʁ̥æˀs
pointe	pʰoɛŋd̥ə
dømme	d̥œmə
kristne	kʰʁ̥ɛsnə
beholdt	b̥ehʌlˀd̥
anglofil	ɑŋɡ̊lofiːˀl
komplet	kʰʌmpʰlɛd̥
bekvem	b̥ekʰvɛmˀ
mynde	mønə
udvortes	uðvɒːˀd̥əs
død	d̥øðˀ
bredderne	b̥ʁæðɐnə
dåb	d̥ɔˀb̥
breds	b̥ʁæðˀs
sørget	sɶɐ̯ʊð
accentens	ɑɡ̊sɑŋˀŋ̩s
vad	væːˀð
trådte	tˢʁ̥ʌd̥ə
værgede	ʋaɐ̯ʊðə
chateau	ɕatˢo
lagde	læːjə
brændte	b̥ʁanˀd̥ə
kroge	kʰʁ̥ɔːwə
fortolke	fʌtˢʌlˀɡ̊ə
krise	kʰʁ̥iːsə
besjælede	b̥eɕɛˀləðə
kunne	kʰunə
tarv	tˢɑˀw
tøven	tˢøːʋn̩
papir	pʰapʰiːˀɐ̯
blotlægge	b̥lʌd̥lɛɡ̊ə
gangræn	ɡ̊ɑŋɡ̊ʁæːˀn
stødt	sd̥ød̥
ulden	uln̩
oplagt	ʌb̥lɑɡ̊d̥
sagt	sɑɡ̊d̥
komisk	kʰoˀmisɡ̊
hovmodig	hɒwmoˀði
lokum	lɔkʰɔm
bekender	b̥ekʰɛnˀd̥ɐ
broderskab	bʁoːðʌsɡæˀb
væk	vɛɡ̊
tisse	tˢisə
hjælpe	jɛlb̥ə
violinist	violinisd̥
selvindlysende	sɛlenlyˀsn̩nə
ajour	aɕuɐ̯
nødte	nøːd̥ə
kanelsnegl	kʰaneːˀlsnɑɪ̯ˀl
mums	mɔmˀs
skrev	sɡ̊ʁæwˀ
mild	milˀ
retsløs	ʁɑd̥sløˀs
ignorant	inoʁɑnˀd̥
kager	kʰæːjɐ
dagligliv	d̥ɑwliliwˀ
æg	ɛˀɡ̊
gudskelov	ɡ̊uðsɡ̊əlɒw
el	ɛlˀ
bøf	b̥øf
syle	syːlə
sekstende	sɑɪ̯snə
tru	tˢʁ̥uˀ
æts	ɛˀd̥s
arrester	aʁɑsd̥ɐ
til	tˢe
lejlighed	lɑjliheðˀ
dybt	d̥yb̥d̥
dræbt	d̥ʁab̥d̥
saks	sɑɡ̊s
god	ɡ̊oˀ
köln	kʰølˀn̩
mæle	mɛːlə
mf	ɛmɛf
afbilde	awb̥ilˀə
rier	ʁiːˀɐ̯
øresund	øːɐsɔnˀ
figen	fiːən
fingere	feŋɡ̊eːˀɐ
lemmene	lɛmm̩nə
lærte	lɛɐ̯ˀd̥ə
whist	ʋesd̥
disciplin	disipʰliːˀn
slugte	sluɡ̊d̥ə
spædbarn	sb̥ɛðb̥ɑːˀn
fiskeolie	fesɡ̊əoljə
afholdende	ɑwhʌlˀənə
løjtnant	lʌjd̥nanˀd̥
trådt	tˢʁ̥ʌd̥
flov	flɒwˀ
tarm	tˢɑːˀm
underskrive	ɔnɐsɡ̊ʁiwˀʊ
tung	tˢɔŋˀ
marsk	mɑːsɡ̊
reparere	ʁæb̥əʁæːˀɐ
råber	ʁɔwˀɐ
bajer	b̥ɑjˀɐ
tilhøre	tˢelhøˀɐ
sexappeal	sɛɡ̊sapʰiːl
plads	pʰl̥as
livsforsikring	liʊ̯sfʌseɡ̊ʁiŋ
chauffør	ɕaføɐ̯ˀ
ordkløver	oɐ̯kʰløːwɐ
thukydid	tˢuɡ̊yd̥iðˀ
middelhavet	miðəlhæːˀvəð
mayonnaise	mɑjonɛːsə
bredder	b̥ʁæðɐ
spadsere	sb̥aseːˀɐ
grammatik	ɡ̊ʁɑmatˢiɡ̊
verden	ʋaɐ̯d̥n̩
modificere	mod̥ifiseːˀɐ
ignorere	injoʁɛˀɐ
øjendråber	ʌjənd̥ʁɔːb̥ɐ
vagt	vɑɡ̊d̥
adjektiv	aðjɛɡ̊tˢiwˀ
avenue	ævəny
sige	siːi
ærlig	æɐ̯li
gru	ɡ̊ʁuːˀ
skylde	sɡ̊ylə
blot	b̥lʌd̥
frygte	fʁ̥œɡ̊d̥ə
frossent	fʁ̥ɔsn̩d̥
due	d̥uːu
ø	øːˀ
fast	fasd̥
træls	tˢʁ̥alˀs
filetere	filətˢeːˀɐ
kriterium	kʰʁ̥itˢeːˀɐ̯iɔm
kopiere	kʰopj̊eːˀɐ
skyr	sɡ̊iːɐ̯
ked	kʰeˀð
arre	ɑːɑ
kedel	kʰeðəl
cylinder	sylenˀɐ
brillant	b̥ʁiljanˀd̥
rulle	ʁulə
lyst	løsd̥
holdtes	hʌld̥əs
tove	tˢoːwə
bøvlede	b̥œwlð̩ð̩
padde	pʰaðð̩
bange	b̥ɑŋŋ̩
genre	ɕɑŋʁɐ
rejser	ʁɑjˀsə
samfundskritisk	sɑmfɔnskʁ̥id̥isɡ̊
fars	fɑːˀs
givende	ɡ̊iːʋənə
skrædder	sɡ̊ʁaðɐ
go'	ɡ̊oːˀ
sær	sæɐ̯ˀ
optrådt	ʌb̥tˢʁ̥ʌd̥
joke	d̥jɔwˀɡ̊
kvark	kʰvɑːɡ̊
guldur	ɡ̊uluɐ̯ˀ
anke	ɑŋɡ̊ə
naturligvis	natˢuɐ̯liviːˀs
adgang	aðɡ̊ɑŋˀ
point	pʰoɛŋ
splitte	sb̥led̥ə
lev	lɛf
svækling	svɛɡ̊leŋ
halvtredser	haltˢʁɛsɐ
samleje	sɑmlajə
weekend	ʋiːɡ̊ɛnˀd̥
dagbog	d̥ɑwb̥ɔːˀw
hjælper	jɛlˀb̥ɐ
sang	sɑŋˀ
sakser	sɑɡ̊sɐ
træder	tˢʁ̥aðˀə
klaviatur	kl̥aʋiatˢuɐ̯ˀ
substantiv	sub̥sd̥antˢiʊ̯ˀ
tone	tˢoːnə
lakrids	lakʰʁ̥is
whiskysovs	wisɡ̊isɒʊ̯ˀs
jyde	jyːð̩
nation	naɕoˀn
stresse	sd̥ʁasə
odense	oˀðənə
bart	b̥ɑːˀd̥
ulig	uliˀ
parvis	pʰɑːviːˀs
besidde	b̥esiðˀə
bestemte	b̥esd̥ɛmˀd̥ə
mudder	muðˀɐ
galde	ɡ̊alə
fire	fiːɐ
cerebral	serəb̥ʁɑːˀl
ulykkesbil	uløɡ̊əsb̥iːˀl
stationsby	sd̥aɕoˀnsb̥yˀ
eksponentiel	ɛɡ̊sb̥onɛnɕɛlˀ
paratakse	pʰɑːɑtˢɑɡ̊sə
renlig	ʁæːnli
immigrere	emiɡ̊ʁæːˀɐ
vams	vɑmˀs
læger	lɛːɐ
skabelon	sɡ̊ɑb̥əloːˀn
vænne	vɛnə
repetere	ʁɛb̥ətˢeːˀɐ
numismatiker	numismæːˀtˢiɡ̊ɐ
hittegodskontor	hid̥əɡ̊ɔskontˢoɐ̯ˀ
tyngde	tˢøŋd̥ə
fartøj	fɑːtˢʌj
rede	ʁæðð̩
muldvarpene	mulʋɑːb̥ənə
euro	ʌjʁo
liv	liwˀ
fil	fiːˀl
millennium	milɛnˀiɔm
plyndre	pʰlønʁɐ
dum	d̥ɔmˀ
stikprøve	sd̥eɡ̊pʰʁ̥œ̞ːwə
folklore	fʌlkʰloːɐ
van	væːn
sikring	seɡ̊ʁeŋ
bredde	b̥ʁæˀd̥ə
rørte	ʁɶɐ̯ˀd̥ə
hamstreren	hɑmsd̥ʁɐɐn
skræv	sɡ̊ʁɛˀw
infinitesimalregning	enfinitˢesimæːˀlʕɑɪ̯neŋ
vindue	vend̥u
send	sɛnˀ
fjerde	fjɛːɐ
planche	pʰlɑŋɕɘ
hejse	hɑjsə
tårne	tˢɒːnə
økumenisk	økʰumeːˀnisɡ̊
alfons	alfʌŋˀs
hindbærsnitte	henb̥æɐ̯snid̥ə
urin	uʁiːˀn
adjunkt	aðjɔŋˀd̥
bump	b̥ɔmˀb̥
narkoman	nɑɡ̊omæːˀn
uagtet	uɑɡ̊d̥əð
sligt	sliɡ̊d̥
sprød	sb̥ʁœˀð
besøgte	b̥esøɡ̊d̥ə
hurtig	hoɐ̯d̥i
ødipus	øˀd̥ipʰus
ihukommelse	ihukʰʌmˀɭ̩sə
gang	ɡoŋˀ
sådan	sɔˀd̥an
oversætte	ɒwɐsɛd̥ə
læs	lɛˀs
hymne	hymnə
trappe	tˢʁɑb̥ə
kastanje	kʰasd̥anjə
onanere	onaneːˀɐ
verdensmester	væɐ̯d̥ənsmɛsd̥ɐ
mule	muːlə
pen	pʰɛnˀ
lavet	lɑwˀəð
bamse	b̥ɑmsə
bonen	b̥ʌŋˀən
iver	iːˀvɐ
sælger	sɛlˀɐ
fremmedfjendtlig	frɑməðfjɛnˀd̥li
sankthansaften	sɑŋd̥hansɑfd̥n̩
syndig	sønd̥i
bage	b̥æːæ
bøvs	b̥œwˀs
leven	lewn̩
frygtelig	frœɡ̊d̥li
ran	ʁɑːˀn
burde	b̥oɐ̯d̥ə
åbenbar	ɔːb̥ənb̥ɑˀ
givet	ɡ̊iːð̩
vinter	venˀd̥ɐ
jensen	jɛnsn̩
chance	ɕɑŋsə
strø	sd̥ʁœːˀ
optrædende	ʌb̥tˢʁ̥ɛˀðənə
tand	tˢanˀ
tyde	tˢyːðə
barre	b̥ɑːɑ
bror	b̥ʁoɐ̯
kyst	kʰøsd̥
gør	ɡ̊ø̞ɐ̯ˀ
champignon	ɕɑmpʰinjʌŋ
spørger	sb̥ɶɐ̯ˀ
skullet	sɡ̊u
uforanderlig	ufʌɑnˀɐli
ridder	ʁiðˀɐ
kan	kʰan
kvart	kʰʋ̥ɑːd̥
fæl	fɛːˀl
karl	kʰɑːˀl
fylde	fylə
fysisk	fyˀsisɡ̊
påfugl	pʰʌfuːˀl
ræer	ʁɛˀɐ
selvfølgelig	sɛlføljəli
slide	sliːðə
robot	ʁobʌd
indlysende	enlyˀsn̩nə
sammensværgelse	sɑmənsʋæɐ̯ˀʊ̯əlsə
hinde	henə
formiddag	fɒːmed̥a
tiende	tˢiˀinə
krydre	kʰʁ̥œðʁɐ
ukrudt	ukʰʁ̥ud̥
taber	tˢæˀb̥ɐ
høker	høˀɡ̊ɐ
abc	æb̥eseːˀ
tredje	tˢʁ̥ɛðjə
levere	lewˀɐɐ
charm	tɕɑːm
øresundsbroen	øɐsɔnsb̥ʁoˀːn̩
beskeden	b̥esɡ̊eˀðn̩
skotsk	sɡ̊ʌd̥sɡ̊
gods	ɡ̊ɔs
ursuppe	uɐ̯sɔb̥ə
flyver	flywˀɐ
rav	ʁɑːˀw
ketsjer	kʰɛd̥ɕɐ
strække	sd̥ʁaɡ̊ə
magert	mɑwˀɐd̥
afrodite	ɑfʁod̥iːd̥ə
prik	pʰʁ̥æɡ̊
fjende	fjɛnə
skynde	sɡ̊ønə
tøjle	tˢʌɪ̯lə
gav	ɡ̊æˀw
forlægge	fʌlɛɡ̊ə
dyd	d̥yðˀ
vrage	vʁɑːwə
spindelvæv	sb̥enˀəlvɛːˀw
oversættelseslån	ɒwɐsɛd̥l̩səslɔˀn
syreregn	syːɐʁɑjˀn
læne	lɛːnə
behold	b̥ehʌlˀ
klæders	kʰl̥ɛɐ̯s
overskrævs	ɒwɐsɡ̊ʁawˀs
mørke	mɶɐ̯ɡ̊ə
pil	pʰiːˀl
chef	ɕɛːˀf
hoste	hoːsd̥ə
bagklogskab	b̥ɑwkʰlɔwsɡ̊æːˀb̥
stedbarn	sd̥eb̥ɑˀn
rensdyr	ʁɑnˀsd̥yɐ̯ˀ
sted	sd̥ɛˀð
større	sd̥ɶːɐ
fanden	fanən
få	fɔˀ
subversiv	sub̥ʋæɐ̯siwˀ
nær	næːˀɐ̯
talent	talɛnˀd̥
vejrhane	vɛɐ̯hæːnə
tudse	tusə
halv	halˀ
duel	d̥uɛlˀ
fotografer	fotˢoɡ̊ʁɑːˀfɐ
bæskubber	b̥ɛːˀsɡ̊ɔb̥ɐ
oprør	ʌb̥ʁɶɐ̯ˀ
præsent	pʰʁ̥ɛsɛnˀd̥
kagle	kʰɑʊ̯lə
fugte	fɔɡ̊d̥ə
fødte	føˀd̥ə
modstand	moðsd̥anˀ
førte	føɐ̯d̥ə
supermarked	suˀb̥ɐmɑːɡ̊əð
lyster	løsd̥ɐ
bilist	b̥ilisd̥
flertals	fleɐ̯tˢals
vidunder	ʋiðɔnˀɐ
fandens	fanəns
rige	ʁiːə
neutron	nøʊ̯tˢʁoˀn
målløs	mɔːlløˀs
visk	ʋesɡ̊
droge	d̥ʁoːwə
arresteret	ɑɑsd̥eˀɐð
fugl	føʉ̯ːl
flammekaster	flɑməkasdʌ
skør	sɡ̊øˀɐ̯
pinlige	pʰiːnlii
klovn	kʰlɒwˀn
bedrive	b̥ed̥ʁiˀʋə
franker	fʁɑŋˀɡ̊ɐ
forræder	fʌʁaðˀɐ
vend	vɛnˀ
mejerierne	mɑjɐʁiˀɐnə
tørst	tˢɶɐ̯sd̥
vegne	ʋɑjnə
mængde	mɛŋˀd̥ə
køle	kʰøːlə
madro	maðʁoːˀ
berømt	b̥eʁɶmˀd̥
fjer	fjeɐ̯ˀ
drukne	d̥ʁɔːɡ̊nə
vanvittigt	ʋanʋid̥id̥
lægge	lɛɡ̊ə
indhøste	enhøsd̥ə
lårben	lɒːb̥eːˀn
araber	aʁɑːˀb̥ɐ
sekretariat	seɡ̊ʁətˢɑiæːˀd̥
spilde	sbilə
eventyrlysten	ewn̩tsʰyɐ̯løsdn̩
bringe	b̥ʁæŋŋ̩
stad	sd̥að
euro	œwʁo
kører	kʰøːɐ
udebleven	uːðəb̥lewˀən
konge	kʰʌŋə
tæppe	tˢɛb̥ə
tyrkiet	tˢyɐ̯kʰiˀəð
håndværk	hʌnʋaɐ̯ɡ̊
brasiliansk	b̥ʁɑsiljæːˀnsɡ̊
skabtes	sɡ̊ɑb̥d̥əs
stød	sd̥øð̞
cyklus	sykʰl̥us
våget	ʋɔwð̩
socialist	soɕalisd̥
salg	salˀ
freden	fʁ̥æðn̩
tarme	tˢɑːmə
cypres	sypʰʁ̥as
virak	viːʁɑɡ̊
roer	ʁoːɐ
tager	tˢæːɐ
frisk	fʁæsɡ̊
rose	ʁose
rir	ʁiɐ̯ˀ
basisk	b̥æːˀsisɡ̊
vækken	ʋɛɡ̊ən
kultveilte	kʰɔltˢʋ̥eild̥ə
knor	kʰnoːˀɐ̯
læst	lɛˀsd̥
laven	læːʋn̩
røn	ʁɶn
denne	d̥ɛnə
svælg	svɛlˀj
tigere	tˢiːɐɐ
pålagt	pʰʌlɑɡ̊d̥
jegets	jɑjˀəðs
ætse	ɛˀd̥sə
sprødt	sb̥ʁœˀd̥
almen	almeˀn
bærret	b̥aɐ̯ˀɐð
datter	tatɐ
britannien	b̥ʁitˢanˀjən
stride	sd̥ʁiːðəs
hadet	hæːðəd̥
bedrage	b̥ed̥ʁɑˀwə
erfare	aɐ̯fɑˀɑ
bros	b̥ʁoˀs
blevet	b̥leːʋəð
slør	sløɐ̯ˀ
løbet	løðð̩
nogle	noːn
lag	læˀ
tør	tˢɶˀɐ̯
skadelig	sɡ̊æːðəli
sejr	sɑjˀɐ
pistol	pʰisd̥oːˀl
lignelserne	liːnəlsɐnə
sulten	suld̥n̩
firs	fiɐ̯ˀs
spændet	sb̥ɛnð̩
changere	ɕɑŋseˀɐ
paryk	pʰɑʁœɡ̊
jern	jaɐ̯ˀn
tutte	tˢud̥ə
spekulativ	sb̥eɡ̊ulatˢiʊ̯ˀ
tjekkede	tçɛɡ̊əðə
støt	sd̥ød̥
facade	fasæːðə
racer	ʁɑːsɐ
skåret	sɡ̊ɒˀɐð
togstation	tˢɔwsd̥aɕoˀn
forsigtig	fɒseɡ̊d̥i
vejledning	ʋɑjleðˀneŋ
splitternøgen	sb̥led̥ɐnʌjən
piber	pʰiːb̥ɐ
skåret	sɡ̊ɒːɐð
træffe	tˢʁ̥ɑfə
koffein	kʰofəiːˀn
afgøre	ɑwɡ̊ɶˀɐ
kammer	kʰɑmˀɐ
pulveret	pʰɔlˀvɐð̩
bom	b̥ɔmˀ
elcykel	ɛlsyɡ̊l̩
sprogvidenskab	sb̥ʁɔwviðn̩sɡ̊æˀb̥
bo	b̥oːˀ
zucchini	sukʰini
væsentlig	vɛˀsənd̥li
cremen	kʰʁ̥ɛˀmən
kynologi	kʰynoloɡ̊iːˀ
smil	smiːˀl
høstak	høsd̥ɑɡ̊
sådan	sʌnˀ
munterhed	mɔnˀd̥ɐheðˀ
mageløs	mæːjəløːˀs
vægter	ʋɛɡ̊d̥ɐ
tolke	tˢʌlɡ̊ə
spise	sb̥iːsə
skudt	sɡ̊ud̥
skilte	sɡ̊eld̥ə
familie	fɑmilˀjə
fluesmækker	fluːsmɛɡ̊ɐ
amnesi	ɑmnəsiːˀ
arrig	ɑːˀi
bønnen	b̥œnˀən
hav	hɑw
jernbanespor	jæɐ̯nb̥æːnəsb̥oːˀɐ̯
bove	b̥ɒːʊ
duge	d̥uːu
breddes	b̥ʁæˀd̥əs
følte	føˀld̥ə
transformer	tʁ̥ɑnsfɒːmɐ
undvære	ɔnʋɛˀɐ
rom	ʁʌmˀ
grundlag	ɡ̊ʁɔnlæj
slotte	slɔd̥ə
musling	musleŋ
middag	med̥a
mælken	mɛlˀɡ̊ən
svøb	sʋøˀb̥ən
skænde	sɡ̊ɛnə
synes	synəs
amanuensis	amanuɛnsis
ært	æɐ̯ˀd̥
aristoteles	ɑisd̥oˀd̥əlɛs
brutal	b̥ʁutˢæːˀl
ballet	b̥alɛd̥
føre	føːɐ
lav	læˀʋ
mælke	mɛlˀɡ̊ə
salg	salˀʝ
albue	alb̥uˀə
bomben	b̥ɔmb̥m̩
røntgen	ʁɶŋˀd̥ən
filosof	filosʌf
kæk	kʰɛɡ̊
bed	b̥eð
truffen	tˢʁ̥ɔfən
hollandsk	hʌlanˀsɡ̊
skumme	sɡ̊ɔmm̩
gener	ɡ̊eˀnɐ
sort	sɒˀd̥
holde	hʌlə
sørgede	sɶɐ̯ʊðð̩
med	mɛð
forstand	fʌsd̥anˀ
penne	pʰɛnə
mellemstation	mɛlm̩sd̥aɕoˀn
atomer	atˢoˀmɐ
nylig	nyːli
duft	d̥ɔfd̥
længes	lɛŋəs
våd	ʋɔˀð
fødder	føðˀɐ
elskerinde	ɛlsɡ̊ɐenə
omgængelig	ʌmɡ̊ɛŋˀli
uglen	uːln̩
søstres	søsd̥ʁɐs
slægtning	slɛɡ̊d̥neŋ
nøgen	nʌjən
halte	haldə
foto	fod̥o
buddhisme	b̥ud̥ismə
boer	b̥oːˀɐ
agte	ɑɡ̊d̥ə
haft	hɑfd̥
globe	ɡ̊loːb̥ə
jordnød	joɐ̯nøðˠˀ
eksempel	ɛɡ̊sɛmˀb̥əl
kvæge	kʰʋ̥ɛːɛ
stået	sd̥ɔːəð
tatovere	tatoveˀʌ
bæk	b̥ɛɡ̊
argon	ɑːɡʌn
hold	hʌlˀ
lysten	løsd̥ən
gadekøkken	ɡ̊æːðəkʰøɡ̊ən
taber	tˢawˀɐ
værten	ʋaɐ̯d̥n̩
fortov	fɒːtˢɒw
dømte	d̥œmˀd̥ə
dagligvare	d̥ɑwliʋɑːɑ
caribisk	kʰɑʁiːˀb̥isɡ̊
svirre	sviːɐ
vane	væːnə
sko	sɡ̊oːˀ
alenlang	æːlənlɑŋ
spændte	sb̥ɛnd̥ə
rinde	ʁænə
krybe	kʰʁ̥yːb̥ə
springer	sb̥ʁeŋˀɐ
avance	avɑŋsə
brug	b̥ʁuˀ
reglen	ʁɛjˀlən
tartan	tˢɑːtˢan
gudenåen	ɡ̊uðˀn̩ɔˀn̩
hævd	hɛwˀd̥
grædt	ɡ̊ʁɑd̥
hæder	hɛːˀðɐ
stedfar	sd̥ɛðfɑː
røgalarm	ʁʌɪ̯alɑːˀm
skrivelse	sɡ̊ʁiwl̩sə
gyd	ɡ̊yðˀ
lærerinde	lɛːɐenə
råbe	ʁɔːb̥ə
estisk	ɛsd̥isɡ̊
uret	uʁad̥
stedmor	sd̥ɛðmoɐ̯
brint	b̥ʁænˀd̥
spytte	sb̥ød̥ɘ
naturvidenskabsmand	natˢuɐ̯ˀviðn̩sɡ̊ab̥smanˀ
råber	ʁɔˀb̥ɐ
himmellegeme	heml̩lɛːmə
karry	kʰɑːi
menneskerne	mɛnn̩sɡ̊ɐnə
mundhugges	mɔnhɔɡ̊ə
kundskab	kʰɔnsɡ̊æˀb̥
slæbt	slɛb̥d̥
atypisk	atˢyb̥isɡ̊
proper	pʰʁ̥oːˀb̥ɐ
øje	ʌːɪ
egentlig	eˀnli
taler	tˢæːlɐ
gavnet	ɡ̊ɑwnəð
lod	lʌð
brændpunkt	b̥ʁanpʰɔŋˀd̥
biskop	b̥isɡ̊ʌb̥
opfinde	ʌb̥fenˀə
malke	malɡ̊ə
forhøje	fʌhʌjˀə
aristophanes	ɑisd̥oˀfanɛs
plaske	pʰl̥asɡ̊ə
koparret	kʰʌb̥ɑˀɑð
blomkål	b̥lʌmkʰɔːˀl
vugge	ʋɔɡ̊ə
pastel	pʰasd̥ɛlˀ
velfærd	ʋɛlfɛɐ̯ˀ
tidligst	tˢiðlisd̥
måske	mosɡ̊eːˀ
guld	ɡ̊ul
vurdere	ʋoɐ̯d̥eˀɐ
til	tˢel
vejrudsigt	ʋɛɐ̯uðseɡ̊d̥
købt	kʰøb̥d̥
navnedag	nɑwnədæˀ
lim	liːˀm
musvåge	musʋɔːwə
hængte	hɛŋd̥ə
stræde	sd̥ʁɛːðə
grønlandsk	ɡ̊ʁɶnlanˀsɡ̊
henne	hɛnə
svamp	sʋɑmˀb̥
vampyr	ʋɑmpʰyɐ̯ˀ
safter	sɑfd̥ɐ
akkumulatorer	ɑkʰumulatˢoːɐ
segl	sɑjˀl
bagte	b̥ɑɡ̊d̥ə
tidsskrift	tˢiðsɡ̊ʁɛfd̥
rigsdaler	ʁisd̥æːlɐ
døb	d̥øˀb̥
tommelfinger	tˢʌməlfeŋˀɐ
kampsport	kʰɑmb̥sb̥ɒːd̥
charmant	ɕɑˀmɐnˀd̥
helst	hɛlˀsd̥
hemmelig	hɛmli
æble	ɛːb̥lə
stål	sd̥ɔːˀl
lektor	lɛɡ̊tˢɐ
val	ʋalˀ
rådden	ʁʌð̩n
smiley	smɑjli
grape	ɡ̊ʁɛjb̥
legemligt	lɛːɪmlid̥
støvle	sd̥œwlə
taler	tˢæːˀlɐ
hverandre	ʋæɐ̯ɑnd̥ʁɐ
drengen	d̥ʁa̝ŋˀŋ̩
ågerkarl	ɔwˀɐkʰæˀl
dåre	d̥ɒːɒ
maler	mæːˀlɐ
emballage	ɑmb̥alæːɕə
sind	senˀ
fugl	fɔu̯ːˀl
harmonika	hɑmoːˀnikʰa
skabt	sɡ̊ɑb̥d̥
racer	ʁɛˀsɐ
hine	hiːnə
sæde	sɛð̞ð̩
achilleus	akʰilœwˀs
femte	fɛmˀd̥ə
hva'	ʋɑ
episk	eːpʰisɡ̊
abonnement	ɑb̥onəmɑŋ
skridt	sɡ̊ʁid̥
ulyst	uløsd̥
landkrabbe	lankʁ̥ɑb̥ə
lignelsen	liːnəlsəs
sendt	sɛnˀd̥
jespersen	jɛsb̥ɐsn̩
studentereksamen	sd̥ud̥enˀd̥ɐeɡ̊sæːmm̩
højde	hʌjˀd̥ə
værre	ʋaɐ̯ɐ
truende	tˢʁ̥oːonə
købte	kʰøb̥d̥ə
hovedtørklæde	hoːð̩tˢɶɐ̯kʰl̥ɛːðə
strejke	sdʁɑjɡə
slags	sl̥æˀs
fryd	fʁ̥yðˀ
ris	ʁiːˀs
praktisk	pʰʁ̥ɑɡ̊d̥isɡ̊
tykmælk	tˢyɡ̊mɛlˀɡ̊
ildkugle	ilkʰuːlə
jeger	jɑjˀɐ
morder	moɐ̯d̥ɐ
vase	væːsə
tupilak	tˢupʰilɑɡ̊
ørkesløs	œ̞ɐ̯ɡ̊əsløːˀs
arbejde	ɑːb̥ɑjˀd̥ə
politibetjent	pʰolitˢib̥etˢjɛnˀd̥
pris	pʰʁiːˀs
stræbt	sd̥ʁɑb̥d̥
sandwich	sanʋid̥ɕ
forlyden	fɒːlyðˀn̩
laurbær	lɑwɐb̥aɐ̯
skal	sɡ̊a
rosévin	ʁoseviːˀn
halshugge	halshɔɡ̊ə
lærer	læɐ̯ˀ
rekvirere	ʁɛkʰviʁɛːˀɐ
mejerier	mɑjɐʁiˀɐ
lukke	lɔɡ̊ə
sgu	sɡ̊u
ytring	yd̥ʁɛŋ
træner	tˢʁ̥æˀnɐ
doktorerne	d̥ʌɡ̊tˢoːɐnə
øjnes	ʌjnəs
bage	b̥æːjə
bide	b̥iːðə
spare	sb̥æɐ̯
taxa	tˢɑɡ̊sa
håndklæde	hʌnkʰl̥ɛːðə
vrid	vʁið
vogter	ʋʌɡ̊d̥ɐ
hunden	hunˀn̩
støtte	sd̥ød̥ə
giver	ɡ̊iwˀɐ
bedst	b̥ɛsd̥
husmand	husmanˀ
betablokker	b̥eːtˢab̥lʌɡ̊ɐ
hø	hyø
homer	homeɐ̯ˀ
smilet	smiːˀlətˢ
eksaminer	ɛɡ̊samineːˀɐ̯
syvti	sywtˢi
støbe	sd̥øːb̥ə
rhesusabe	ʁɛsusæːb̥ə
hovedpine	hoːð̩pʰiːn̩
lærerinde	læːɐenə
overvejelse	ɒwɐʋɑjˀəlsə
sket	sɡ̊eˀd̥
loddekolbe	lʌðəkʰʌlb̥ə
ballon	b̥alʌŋ
herskere	hæɐ̯sɡ̊ɐɐ
ulige	uliːi
blåtand	b̥lʌtˢanˀ
overvættes	ɒwɐʋɛd̥ə
batte	b̥ad̥ə
have	hæːʊ
røddernes	ʁɶðˀɐnəs
referendum	ʁɛfəʁand̥ɔm
odense	oːonsə
løst	løˀsd̥
håndgemæng	hʌnɡ̊emɛŋ
pibe	pʰiːb̥ə
røget	ʁʌðð̩
bumpe	b̥ɔmb̥ə
stedt	sd̥ɛˀd̥
diger	d̥iːɐ
hjord	jɒːd̥
cellofan	selofæːˀn
sadist	sad̥isd̥
ara	ɑːʁɑ
idiomatisk	id̥iomæːˀtˢisɡ̊
sødygtig	sød̥øɡ̊d̥i
synonymordbog	synonyːˀmoɐ̯b̥ɔːˀw
samme	sɑmə
syge	syːy
tandbørste	tˢanb̥ɶɐ̯sd̥ə
symfoni	søɱfoniːˀ
hagl	hɑwˀl
mark	mɑːɡ̊
atom	atˢoˀm
svøbe	sʋøːb̥ə
grejs	ɡ̊ʁɑjˀs
røge	rʌjə
berøre	b̥eʁɶˀɐ
mobbe	mʌb̥ə
vågnet	ʋɔwnəð
faconen	fasʌŋˀən
tombak	tˢɔmb̥ɑɡ̊
brædder	b̥ʁaðɐ
rutebil	ʁod̥əb̥iˀl
slagne	sl̥æːnə
bort	b̥ɒːd̥
skriftlig	sɡ̊ʁæfd̥li
skattefar	skætəfɑː
jord	jokwɐ
mure	muːɐ
mens	mɛns
syltetøj	syld̥ətˢʌj
europæisk	œwʁopʰɛˀisɡ̊
forord	fɒːoˀɐ̯
under	ɔnɐ
cyklus	syɡ̊lus
tud	tˢuˀð
achilles	akʰiləs
flaskehals	fl̥asɡ̊əhalˀs
styrte	sd̥yɐ̯d̥ə
genbrug	ɡ̊ɛnb̥ʁuːˀ
kaffekande	kʰɑfəkʰanɘ
udtrykke	uðtˢʁ̥œ̞ɡ̊ə
vabel	vɑːb̥l̩
brød	b̥ʁœðˀ
ærme	æɐ̯mə
bonusserne	b̥oːnusɐnə
værnemager	ʋaɐ̯nəmæˀɐ
skade	sɡ̊æðð̩
man	man
hin	hiˀn
varsel	ʋɑːˀsl̩
dag	d̥æˀ
spørgsel	sb̥ɶɐ̯ˀsəl
reform	ʁɛfɒˀm
desværre	d̥esʋaɐ̯ɐ
hærg	haɐ̯ˀwəð
oprør	ʌb̥ʁɶˀɐ̯
værktøjet	vaɐ̯ɡ̊tˢʌjˀəð
hansen	hanˀsn̩
slå	sl̥ɔˀ
dom	d̥ʌmˀ
sliber	sliˀb̥ɐ
i	i
rævegrav	ʁɛːvəɡ̊ʁɑːˀw
ignoreret	enjoʁɛˀɐð
avlet	ɑwləð
dom	d̥oːm
bugt	b̥ɔɡ̊d̥
magen	mæːjən
brændte	b̥ʁɑnˀd̥ə
frøken	fʁ̥œˀɡ̊ŋ̩
rokade	ʁokʰæːðə
liechtensteiner	liɡd̥ənsd̥ɑɪ̯nʌ
film	film
frelste	fʁɑlsd̥ə
frankrig	fʁɑŋkʰʁ̥i
bøvlet	b̥œwlð̩
værdighed	væɐ̯d̥iheðˀ
aldrig	ɑld̥ʁi
forlis	fʌliˀs
barbar	b̥ɑb̥ɑːˀ
søstre	søsd̥ʁɐ
areal	ɑːeæːˀl
bruger	b̥ʁuːɐ
øvre	øwɐ
undulat	ʌnd̥ulæːˀd̥
opretholde	ʌbʁadhʌlˀə
rollemodel	ʁʌləmod̥ɛlˀ
bedrage	b̥ed̥ʁɑwˀə
størrelse	sd̥ɶɐ̯ɐlsə
feje	fɑːɪ
tyr	tˢyɐ̯ˀ
kolleger	kʰole̝ːjɐ
mafioso	mafioːso
bibel	b̥iˀb̥əl
gode	ɡ̊oːðə
føl	føˀl
allé	aleˀ
katten	kʰad̥n̩
bande	b̥and̥ə
ildsted	ilsd̥ɛð
chokoladekage	ɕoɡ̊olæːðəkʰæːjə
tie	tˢiːi
spjætte	sb̥jɛd̥ə
del	d̥eˀl
flanør	flanøːˀɐ̯
arabien	ɑʁɑːˀb̥iən
binde	b̥enə
hvepsetalje	vɛb̥sətˢaljə
fysik	fysiɡ̊
bliver	b̥liɐ̯ˀ
godnat	ɡonɑd̥
joke	d̥jɔwɡ̊
humør	humøˀɐ̯
traktoren	tˢʁ̥ɑɡ̊tˢɐɐn
bøjle	b̥ʌjlə
smoking	smɔwkʰeŋ
plattysk	pʰl̥ad̥tˢysɡ̊
strand	sd̥ʁɑnˀ
bevæget	b̥evɛˀjəð
kyst	kʰyːˀsd̥
kilde	kʰill̩
glemte	ɡ̊lɛmd̥ə
myg	myːˀ
breddens	b̥ʁæˀd̥n̩s
arte	ɑːd̥ə
skrin	sɡ̊ʁiːˀn
undertøj	ɔnɐtˢʌj
parallelle	pʰɑɑlɛlˀə
rev	ʁæwˀ
skygge	sɡ̊yɡ̊ə
kutyme	kʰutˢyːmə
discipel	d̥isib̥əl
tivoli	tˢiʋoli
jeget	jɑðˀð̩
ensilere	ɛnsileːˀɐ
sådan	sʌnˀən
betegnelse	betˢɑjˀnəlsə
rende	ʁɑnə
brusk	b̥ʁusɡ̊
bed	b̥eˀ
præposition	pʰʁ̥ɛpʰosiɕoːˀn
vant	ʋanˀd̥
orgie	ɒːˀɡ̊jə
stud	sd̥uðˀ
afholdte	ɑwhʌlˀd̥ə
moster	mʌsd̥ɐ
acceptabel	ɑɡ̊sɜb̥tˢaːˀb̥əl
prud	pʰʁ̥uˀð
træge	tˢʁ̥æːjə
marmelade	mɑməlæːðə
hæl	hɛˀl
simulere	simuleːˀɐ
vare	ʋɑːɑ
bedrag	b̥ed̥ʁɑˀw
proaktiv	pʰʁ̥oːˀɑɡ̊tˢiwˀ
ovn	ɒwˀn
malstrøm	malsd̥ʁɶmˀ
kredsen	kʰʁ̥æːˀsn̩
skummet	sɡ̊ɔmˀð̩
før	føɐ̯ˀ
rygtes	ʁœɡ̊d̥əs
steder	sd̥ɛːðɐ
ham	hɑm
parallel	pʰɑɑlɛlˀ
runde	ʁɔnd̥ə
mænd	mɛ̝nˀ
genere	ɕeneˀɐ
fjorten	fjoɐ̯d̥n̩
hjertestop	jæɐ̯d̥əsd̥ʌb̥
tjenstlig	tɕɛːnsd̥li
dagligvarebutik	d̥ɑwlib̥utˢiɡ̊
behændig	b̥ehɛnˀd̥i
vækst	ʋɛɡ̊sd̥
mase	mæːsə
vandfarve	vanfɑːvə
hvordan	ʋɔd̥ən
jag	jæjˀ
fars	fɑːs
undres	ɔnd̥ʁɐs
forstå	fʌsd̥ɔˀ
vaktes	ʋɑɡ̊d̥əs
drille	d̥ʁœlə
ahornsirup	ahoɐ̯nsiːˀʁɔb̥
folk	fɔwɡ̊
sagde	sæː
drikke	d̥ʁɛɡ̊ə
tidligt	tˢiðlid̥
ejendel	ɑːjənd̥eˀl
hvedemel	ʋeːð̩ˠmeːˀl
hint	hind̥
repræsentation	ʁapʰʁ̥asəntˢaɕoːˀn
ledt	leðˀd̥
foregangsmand	fɒːɒɡ̊ɑŋsmanˀ
ruiner	ʁuineːˀɐ̯
student	sd̥ud̥enˀd̥
læg	lɛˀj
bedårende	b̥ed̥ɒˀnə
er	æɐ̯
oversætter	ɒwɐsɛd̥ɐ
smide	smiːðə
havn	hɑʊ̯ˀn
kyl	kʰyːˀl
klapperslange	kʰlɑb̥ɐslɑŋə
før	fœ̞ɐ̯
røgelse	ʁøːjəlsə
pip	pʰib̥
passere	pʰaseːˀɐ
skændes	sɡ̊ɛnəs
fiskerbåd	fesɡ̊ɐb̥ɔːˀð
restaurant	ʁɛsd̥oʁɑŋ
overtro	ɒwɐtˢʁ̥oːˀ
skadefro	sɡ̊æːðəfʁ̥oːˀ
udskud	uðsɡ̊uð
amerika	ɑmeɐ̯ˀikʰa
bomb	b̥ɔmˀb̥
quiz'	kʰvis
international	entˢɐnaɕonæˀl
veje	ʋɑːɪ
kæreste	kʰaɐ̯sd̥ə
tissekone	tˢisəkʰoːnə
bøg	b̥øˀj
hærgede	haɐ̯ʊðə
færreste	faɐ̯ɐsd̥ə
resistor	ʁasisd̥ʌ
raget	ʁɑwð̩
givent	ɡ̊iːʊnd̥
plage	pʰlæːjə
styre	sd̥yːɐ
før	fœ̞ɐ̯ˀ
godmorgen	ɡ̊omɒːɒn
rationel	ʁɑɕonɛlˀ
rødhåret	ʁœ̞ðhɑːˀɑð
nej	nɑjˀ
otti	ɔtˢi
flyde	flyðð̩
opdukke	ʌb̥d̥ɔɡ̊ə
fru	fʁ̥o
sammenføje	sɑmm̩fʌjˀɪ
egentlig	eˀjn̩d̥li
guitarist	ɡ̊itˢɑʁisd̥
flueknepperi	fl̥uːəkʰnɛb̥ɐʁiːˀ
hedensk	heːˀðənsɡ̊
stemt	sd̥ɛmˀd̥
fængsler	fɛŋslɐ
synd	sønˀ
højforræderi	hʌjfʌʁɛðɐʁiˀ
værgers	ʋaɐ̯wɐs
fyrre	fyːɐ
brydning	b̥ʁyðneŋ
solgte	sʌlˀd̥ə
vis	ʋiˀs
skamme	sɡ̥ɑmə
vanedyr	væːnədyɐ̯ˀ
brøst	b̥ʁœsd̥
rådden	ʁʌðən
abonnement	ab̥ɔnəmɑŋ
sjofel	ɕoːˀfəl
bestemme	b̥esd̥ɛmˀə
passer	pʰasɐ
sexet	sɛɡ̊səð
skummet	sɡ̊ɔmð̩
sorg	sɒˀw
tyv	tˢywˀ
frænde	fʁanə
sjal	ɕæːˀl
apostrof	ɑb̥osd̥ʁʌf
million	miljoˀn
firti	fiɐ̯tˢi
du	d̥u
kvinde	kʰʋ̥enə
grejerne	ɡ̊ʁɑjɐnə
stege	sd̥ɑːɪ
værelse	ʋaɐ̯lsə
munter	mɔnˀd̥ɐ
autoritet	ɑwtˢɒitˢeːˀd̥
stræber	sd̥ʁæˀb̥ɐ
lærling	laɐ̯leŋ
hospital	hɔsb̥itˢæːˀl
trafikprop	tˢʁ̥ɑfiɡ̊pʰʁ̥ʌb̥
sangfugl	sɑŋfuːˀl
ded	d̥eðˀ
borgmester	b̥ɒwmɛsd̥ɐ
loft	lʌfd
globus	ɡ̊loːb̥us
bordel	b̥ɒd̥ɛlˀ
barken	b̥ɑːɡ̊n̩
utilfredsstillende	utˢefʁɛssd̥elˀənə
lig	leɡ̊
oldemor	ʌləmoɐ̯
spand	sb̥anˀ
skomager	sɡ̊omɑːˀ
flamboyant	flɑmb̥oɐ̯janˀd̥
lærd	læɐ̯ˀd̥
undredes	ɔnd̥ʁɐðəs
fyr	fyɐ̯ˀ
undtagne	ɔntˢæˀnə
leder	leːðɐ
følge	føljə
blasfemi	b̥lasfəmiːˀ
søndag	sœnˀd̥a
øh	əː
velfærdssamfund	ʋɛlfɛɐ̯ssɑmfɔnˀ
bumper	b̥ɔmb̥ər
djævel	d̥jɛːʊl
vand	ʋa̝nˀ
hal	halˀ
aubergine	ob̥æɐ̯ɕiːne
muddergrøft	muðˠˀɐɡ̊ʁœfd̥
være	ʋɛːɐ
falafel	falɑfl̩
dobbeltgænger	d̥ʌb̥l̩ɡ̊ɛŋɐ
spat	sb̥ad̥
visken	ʋesɡ̊ŋ̩
mur	muˀɐ̯
kaviar	kʰaviɑːˀ
søsterens	søsd̥ɐɐns
sætning	sɛd̥neŋ
tatovering	tatoveˀɐ̯eŋ
syd	syðˀ
himmellegeme	heml̩lɛːɪmə
julelys	juːləlyːˀs
samtykke	sɑmtˢyɡ̊ə
beholdte	b̥ehʌlˀd̥ə
fugl	fɛu̯ːˀl
natur	natˢuɐ̯ˀ
babyvræl	b̥ɛɪ̯b̥iʋʁɛːˀl
ged	ɡ̊eːˀð
bøger	b̥œˀɐ̯
sand	sanˀ
rejser	ʁɑjsə
spørge	sb̥ɶɐ̯ʊ
turdet	tˢoːɐð
telegraf	tˢeleɡ̊ʁɑːˀf
konspiration	kʰʌnsb̥iɑɕoˀːn
gadekøkken	ɡ̊æːð̩kʰøɡ̊n̩
bæger	b̥æːɐ
sligt	sliˀd̥
agern	æˀjɐn
grinen	ɡ̊ʁiːn̩
bøvl	b̥œwˀl
bundt	b̥ɔnˀd̥
mærkværdig	maɐ̯ɡ̊ʋaɐ̯ˀd̥i
creme	kʰʁ̥ɛˀm
fædre	fɛðʁɐ
bøvet	b̥œʊ̯əðˠ
perker	pʰæɐ̯ɡ̊ɐ
bag	b̥æˀ
vad	vað
forglemmigej	fɒɡ̊lɛmˀmɑɑjˀ
proton	pʰʁotˢoˀn
fyld	fylˀ
konservator	kʰʌnsæɐ̯væːtˢɐ
vestkyst	ʋɛsd̥kʰøsd̥
husk	husɡ̊
forlise	fʌliˀsə
lede	leðð̩
afhænge	ɑwhɛŋˀə
mig	mɑj
føje	fʌɪ
ydelse	yːð̠ˠəlsə
tillægsord	tˢelɛɡ̊soɐ̯ˀ
afstand	ɑwsd̥anˀ
malstrøm	mæːlsd̥ʁɶmˀ
princip	pʁɛ̝nsib̥
nordkyst	noɐ̯kʰøsd̥
juni	juːˀni
skød	sɡ̊øð
cd	seˀd̥eˀ
hvæse	vɛːsə
jungle	d̥jɔŋlə
præst	pʰʁ̥asd̥
danske	d̥ansɡ̊ə
udvortes	uðvɒːd̥əs
breve	b̥ʁeːw̩
esbjerg	ɛsb̥jæɐ̯ˀ
given	ɡ̊iːʊn
ladet	læːðəd̥
offentlig	ʌfənd̥li
breve	b̥ʁeːvə
dybde	d̥yb̥d̥ə
forstørrelse	fʌsd̥ɶɐ̯ˀɐleə
sygdom	syːd̥ʌmˀ
grape	ɡ̊ɹɛjb̥
vakuum	vɑkʰuɔm
tog	tˢɔw
æsel	ɛˀsəl
pels	pʰɛlˀs
efterligne	ɛfd̥ɐliːˀnə
grækenland	ɡ̊ʁɛˀɡ̊ŋ̩lanˀ
elfenben	ɛlˀfənb̥eˀn
vove	ʋɔːʋə
station	sd̥aɕoˀn
give	ɡ̊iːʋə
flertal	fleɐ̯tˢal
bøfler	b̥øflɐ
pålægge	pʰʌlɛɡ̊ə
rode	ʁoːðə
hykle	hyɡ̊lə
ryger	ʁyːˀɐ
høne	hœːn̩
kaos	kʰæːɐs
mulighed	muːliheðˀ
tur	tˢuɐ̯ˀ
søg	søjˀ
økonomi	økʰonomiːˀ
rær	ʁæɐ̯ˀ
græder	ɡ̊ʁɑðˀɐ
eskimologi	ɛsɡ̊imoloɡ̊iːˀ
bistro	b̥isd̥ʁo
hieroglyf	hioɡ̊lyf
sval	svæːˀl
sete	seˀd̥ə
mos	mɔs
munk	mɔŋˀɡ̊
krav	kʰʁ̥ɑwˀ
a'ers	æːɐs
socialist	ɕoɕalisd̥
huse	huːsə
håndjern	hʌnjæɐ̯ˀn
hare	hɑːɑ
gård	ɡ̊ɒˀ
udeblive	uːðəb̥liˀ
grav	ɡ̊ʁɑwˀ
pingpong	pʰeŋpʰʌŋ
ironi	iʁoniːˀ
tyd	tˢyðˀ
urinal	uɐ̯inæːˀl
aftner	ɑfnɐ
apoteker	ab̥otˢeːˀɡ̊ɐ
snigmorder	sniːmoɐ̯d̥ɐ
talkum	tˢalkʰɔm
duellere	d̥uəleːˀɐ
højdepunkt	hʌjˀd̥əpʰɔŋˀd̥
færøerne	fɛɐ̯øːˀɐnə
evangelium	evɑŋɡ̊eːljɔm
troede	tˢʁ̥oːð̩
togt	tˢʌɡ̊d̥
havde	hæːðə
heltinde	hɛld̥enə
opportun	ʌb̥ɐtˢuːˀn
mandelolie	manˀl̩oljə
tjald	tɕalˀ
talemåde	tˢæːləmɔːðə
sådan	sʌd̥ən
charme	ɕɑːmə
legemlig	lɛːmli
kirsten	kʰiɐ̯sdn̩
ven	ʋɛn
vejret	ʋɑjɐð
doktorer	d̥ʌɡ̊d̥ɐɐ
fuld	fulˀ
hjort	jɒːd̥
skrække	sɡ̊ʁaɡ̊ə
æggende	ɛɡ̊ənə
tøjhus	tˢʌjhuˀs
kattejammer	kʰad̥əjɑmˀɐ
leje	lɑːɪ
optræden	ʌb̥tˢʁ̥ɛˀðən
sømme	sœmm̩
fodgænger	foðɡ̊ɛŋɐ
knagende	kʰnæːjənə
radmager	ʁɑðmɑwˀɐ
turde	tˢoːɐ
hviderusser	ʋiːðˠəʁusɐ
præsens	pʰʁ̥ɛsɛnˀs
ægge	ɛɡ̊ə
forjættede	fʌjɛd̥ð̩ð̩
koagulere	kʰoaɡ̊uleːˀɐ
årsdag	ɒːˀsd̥æːˀ
mur	muɐ̯ˀ
poul	pɒʊ̯l
smuk	smɔɡ̊
danablu	dæːnabluˀ
småkage	smʌkʰæːjə
talje	tˢaljə
hovedsagelig	hoːð̩sæˀjəli
køer	kʰøˀɐ̯
fosfor	fʌsfɒ
alfahan	alfahan
grønland	ɡ̊ʁɶnlanˀ
kær	kæˀɐ̯
kynofobi	kʰynofob̥iːˀ
giraf	ɡ̊iʁɑf
væltepeter	ʋɛld̥əpʰeˀd̥ɐ
samt	sɑmd̥
bare	b̥ɑːɑ
benytte	b̥enød̥ə
kunstner	kʰɔnˀsd̥nɐ
producere	pʰʁ̥od̥juːsɐɐ
talsperson	tˢæːˀlspʰæɐ̯soːˀn
slukke	slɔɡ̊ə
helsinge	hɛlseŋə
ugler	uːlɐ
ansvarlig	ansvɑːˀli
surmule	suɐ̯muːˀlə
kryds	kʰʁ̥ys
lesbisk	lɛsb̥isɡ̊
bagage	b̥aɡ̊æːɕə
underlig	ɔnʌli
desavouere	d̥esavueːˀɐ
ener	eːnɐ
lyn	lyːˀn
undulat	ɔnd̥ulæːˀd̥
ager	aɡ̊eɐ̯ˀ
flyder	flyːðɐ
bowling	b̥ɒwleŋ
miste	mesd̥ə
sinecure	sinəkʰyːɐ
sover	sɒːwɐ
blomme	b̥lʌmə
tåle	tˢɔːlə
blot	b̥loˀd̥
ja	jɛ
forlystelse	fʌløsd̥l̩sə
kræfternes	kʰrafd̥ɐnəs
københavn	tɕœwnhɑwˀn
time	tˢiːmə
arrest	aʁasd̥
dybe	d̥yːb̥ə
jordnøddeolie	joɐ̯nøð̩ˠoljə
kryb	kʰʁ̥ywˀ
ordforråd	oɐ̯fʌʁɔðˀ
skørlevned	sɡ̊øɐ̯lɛwnð̩
danserinde	d̥ansɐenə
diftong	d̥iftˢʌŋ
timer	tˢiːmɐ
kunstgalleri	kʰɔnsd̥ɡ̊aləʁiˀ
dubiøs	d̥ub̥iøːˀs
helsen	hɛlsn̩
biologi	b̥ioloɡ̊iːˀ
siden	siðən
hør	hœ̞ɐ̯
dødvande	d̥øðvanə
skæv	sɡ̊ɛˀʋ
halvfjerds	halfjaɐ̯s
omgående	ʌmɡ̊ɔˀənə
vædde	ʋɛðð̩
nogen	noən
vorte	vɒːd̥ɘ
monarki	monɑkʰiˀ
lugte	lɔɡ̊d̥ə
bekostning	b̥ekʰʌsd̥neŋ
farao	fɑːʁɑw
gryn	ɡ̊ʁyːˀn
citere	sitˢeːˀɐ
fjendskab	fjɛnsɡ̊æˀb̥
bankkonto	b̥ɑŋɡ̊kʰʌntˢo
killing	kʰileŋ
gak	ɡ̊ɑɡ̊
brumme	b̥ʁɔmə
cremefraiche	kʰʁ̥ɛmfrɛːs
ifølge	iføljə
ignorerer	inoʁɛˀɐ
fjeder	fjeðˀɐ
kæledyr	kʰɛːləd̥yɐ̯ˀ
forsørger	fɒsɶwˀɐ
advarsel	aðvɑːsəl
led	leð
bly	b̥lyːˀ
stød	sd̥øð̞ˀ
sygeplejerske	syːypʰl̥ɑjˀɪsɡ̊ə
citer	sid̥ɐ
bilvask	b̥iːlʋasɡ̊
hån	hɔːˀn
mon	mɔn
middel	miðˀəl
menu	meny
ses	seˀs
alle	alə
facet	fasɛd̥
blote	b̥loːd̥ə
masse	masə
rundt	ʁɔnˀd̥
ard	ɑˀd̥
vis	ʋiːˀs
røge	ʁœ̞ːjə
latent	latˢɛnˀd̥
forskrække	fʌsɡ̊ʁaɡ̊ə
eddikesur	æðiɡ̊əsuɐ̯ˀ
billede	b̥elð̩
valg	ʋɑlˀ
støber	sd̥øˀb̥ɐ
vægre	ʋɛːjʁɐ
manga	mɑŋɡ̊a
definitorisk	definitoˀɐ̯isɡ
opslag	ʌb̥sl̥æˀj
hage	hæːjə
dårligst	d̥ɒːlisd̥
pib	pʰiwˀ
pålagde	pʰʌlæˀæ
postalveolar	pʰʌsd̥alveolɑːˀ
postbud	pʰʌsd̥b̥uð
vrøvler	ʋʁɶwlɐ
fyrste	fyɐ̯sd̥ə
aprilsnar	apʰʁ̥iːˀlsnɑːˀ
kigge	kʰiɡ̊ə
rage	ʁɑːʊ
øve	øːʋə
bedrag	b̥ed̥ʁɑwˀ
verdslig	ʋaɐ̯d̥sli
slette	slɛd̥ə
johannes	johanˀəs
indlemme	enlɛmˀə
små	smɔˀ
pokerfjæs	pʰoːˀɡ̊ɐfj̊ɜˀs
lov	lɔˀw
skid	sɡ̊ið̞ˀ
årti	ɒtˢiːˀ
køber	kʰøˀb̥ɐ
nitten	nid̥n̩
uoverlagt	uɒwɐlɑɡ̊d̥
hvordan	ʋʌd̥ən
geometri	ɡ̊eomətˢʁ̥iːˀ
univers	univæɐ̯s
rette	ʁad̥ə
syntes	synd̥əs
drev	d̥ʁæw
prise	pʰʁ̥iːsə
rygrad	ʁœɡ̊ʁɑˀð
syde	syːðə
knække	kʰn̥ɛɡ̊ə
løbet	løwəð
trykke	tˢʁ̥œɡ̊ə
fluepapir	fluːəpʰapʰiɐ̯ˀ
rus	ʁus
tyrker	tˢyɐ̯ɡ̊ɐ
mælkevej	mɛlɡəvɑjˀ
delikat	d̥elikʰæːˀd̥
eliksir	eləɡ̊siɐ̯ˀ
dyrke	d̥yɐ̯ɡ̊ə
ændring	ɛnd̥ʁeŋ
lår	lɒˀ
jegerne	jɑjˀɐnə
bære	b̥æːɐ
ri	ʁiːˀ
erklære	æɐ̯kʰlɛːˀɐ
småting	smʌtˢeŋ
hverken	ʋaɐ̯ɡ̊ŋ̩
vor	ʋɒ
bøde	b̥øðð̩
tygge	tˢyɡ̊ə
vovet	ʋɔːʋð̩
rejse	ʁɑjsə
væv	ʋɛwˀ
skriv	sɡ̊ʁiˀw
rigt	ʁiˀd̥
satanisme	satˢanismə
valgte	ʋalˀd̥ə
accents	ɑɡ̊sɛnˀd̥s
alting	altˢeŋˀ
opslagsværk	ʌb̥sl̥æsʋaɐ̯ɡ̊
fyrstendømme	fyɐ̯sd̥n̩d̥œmə
erhverv	æɐ̯væɐ̯ˀw
frihed	fʁiheðˀ
tilfredsstille	tˢefʁɛssd̥elˀə
retning	ʁɑd̥neŋ
armbrøst	ɑːmb̥ʁœ̞sd̥
flette	flɛd̥ə
odysseus	od̥ysœwˀs
peter	pʰed̥ɐ
ør	øɐ̯ˀ
aftnerne	ɑfnɐnə
raritet	ʁɑitˢeːˀd̥
tvivl	tˢviwˀl
åbenbare	ɔːb̥m̩b̥ɑˀɑ
chikane	ɕikʰæːnə
foranstalte	fʌansdalˀdə
ryge	ʁyːy
svorne	sʋ̥oɐ̯nə
disse	d̥isə
ser	seɐ̯ˀ
syndrom	synd̥ʁoːˀm
hedensk	heðˀənsɡ̊
optrædes	ʌb̥tˢʁ̥aðˀəs
hinanden	hinann̩
imposant	empʰosanˀd̥
hofmarskal	hʌfmɑːɕalˀ
seksualitet	sɛɡsualiteˀd
love	lɔːʊ
fiske	fesɡ̊ə
bomuld	b̥ʌmulˀ
ømfindtlig	œmfenˀd̥li
trojansk	tˢʁojæˀnsɡ̊
otte	ɔːd̥ə
sikkerhedsvagt	seɡ̊ɐheðˠsʋɑɡ̊d̥
drot	d̥ʁʌd̥
bryg	b̥ʁœɡ̊
individ	end̥iviðˀ
sandpapir	sanpʰapʰiɐ̯ˀ
pinligere	pʰiːnliɐɐ
ubestemmelig	ub̥esd̥ɛmˀəli
norsk	nɒːsɡ̊
hærge	haɐ̯ʊ
sød	søˀð
kunne	kʰu
pygmæ	pʰyɡ̊mɛˀ
volapyk	volapʰyɡ̊
goddag	ɡ̊od̥æˀ
mine	miːnə
opslag	ʌb̥sl̥æˀ
sålbænk	sʌlb̥ɛŋˀɡ̊
søger	søːjɐ
lokale	lokʰæːˀlə
optræde	ʌb̥tˢʁ̥ɛˀðə
gang	ɡɔɲ
århusiansk	ɒhuɕæːˀnsɡ̊
forbyder	fɒb̥yðˀɐ
besøg	b̥esøˀ
ansigt	anseɡd
vaskeklud	vasɡ̊əkʰluðˀ
stræber	sd̥ʁæːb̥ɐ
rude	ʁuːðə
eget	ɑjəð
bolle	b̥ʌlə
fiskestang	fesɡ̊əsd̥ɑŋˀ
bredt	b̥ʁæˀd̥
krydse	kʰʁysə
proaktiv	pʰʁ̥oɑɡ̊tˢiwˀ
repræsentation	ʁɛpʰʁ̥ɛsəntˢaɕoːˀn
asyl	asyːˀl
flå	flɔˀ
ulykkelig	uløɡ̊əli
villig	ʋili
hulens	huːln̩s
butik	b̥utˢiɡ̊
supre	suˀb̥ʁɐ
nogle	noːlə
bidsel	b̥isəl
så	sʌ
smage	smæːjə
ignorant	injoʁɑnˀd̥
udelukkende	uːðəlɔɡ̊ənə
dåse	d̥ɔːsə
råers	ʁɔˀɐs
hver	ʋɛɐ̯ˀ
andre	ɑnd̥ʁɐ
eksplicit	ɛɡ̊sb̥lisid̥
flamboyant	flɑmb̥oɑjanˀd̥
cykel	syɡ̊l̩
vesttysk	ʋɛsd̥tˢysɡ̊
nana	nana
undtagne	ɔntˢæˀjnə
vid	ʋiˀð
generer	ɡ̊enəʁæɐ̯ˀ
seddel	sɛðˀəl
sirene	siʁæːnə
fremmedfjendtlig	framəðfjenˀd̥li
shampoo	ɕɑmpʰo
alle	æleːˀ
indkomst	enkʰʌmˀsd̥
politisk	pʰolid̥isɡ̊
evindeligt	evenˀəlid̥
arve	ɑːvə
gåsepotentil	ɡ̊ɔːsəpʰotˢəntˢilˀ
bonede	b̥oːnəðə
nul	nɔl
tyfus	tˢyːfus
fold	fʌlˀ
synes	sys
skaber	sɡ̊æːb̥ɐ
pande	pʰanə
avler	ɑwlɐ
partikel	pʰɑtˢiɡ̊əl
bande	b̥anə
overbid	ɒwɐb̥ið
far	fɑː
drømmeverden	d̥ʁɶməʋaɐ̯d̥n̩
erstatte	aɐ̯sd̥ad̥ə
forjættet	fʌjɛd̥ð̩
mariehøne	mɑʁiːˀəhœːnə
klan	kʰlæːˀn
besøgt	b̥esøɡ̊d̥
sokratisk	sokʁɑˀdisɡ
dø	d̥øˀ
sandwich	sanʋid̥s
trompeter	tˢʁ̥ɔmpʰeːˀd̥ɐ
øllen	ølˀn̩
halvfjerde	halfjɛːɐ
bræk	b̥ʁaɡ̊
kæde	kʰɛðð̩
skandaløs	sɡ̊and̥aløːˀs
klædet	kʰl̥ɛːðəd̥
fadervor	fæːðɐvɒˀ
anser	anseɐ̯ˀ
streng	sd̥ʁaŋˀ
komedie	kʰomeðˀjə
frem	fʁɑmˀ
varmeovn	ʋɑːməɒwˀn
djævel	d̥jɛːʋl̩
gjorde	ɡ̊joɐ̯d̥ə
strid	sd̥ʁiðˀ
trældom	tˢʁ̥ɑld̥ʌmˀ
fejre	fɑjʁɐ
kørende	kʰøːɐnə
knalde	kʰnalə
jord	juoɹ
geled	ɡ̊eleð
nemme	nɛmə
kastanje	kʰasd̥anˀjə
olivenolie	oliˀʋn̩oljə
vaskemiddel	vasɡ̊əmiðˀəl
måde	mɔːðə
ignorere	enjoʁɛˀɐ
begreb	b̥eɡ̊ʁɛˀb̥
larsen	lɑːsn̩
hvile	viːlə
trænge	tˢʁ̥aŋŋ̩
hollænder	hʌlɛnˀɐ
fætter	fɛd̥ɐ
tier	tˢiˀɐ
hoste	hɔwsd̥e
aflyd	ɑʊløð
syd	syð
om	ʌm
iglo	iɡ̊lo
trin	tˢʁ̥in
utilgivelig	utˢelɡ̊iːˀvəli
almennyttig	almennød̥i
ilter	ilˀd̥ɐ
salut	salud̥
forbød	fɒb̥øˀð
ånde	ʌnə
valsen	valsn̩
færg	faɐ̯ˀw
stille	sd̥elə
stiv	sd̥iwˀ
loyale	lʌjæːˀle
naiv	naiːˀw
både	b̥ɔðð̩
smørrebrød	smɶɐb̥ʁœðˀ
pindsvin	pʰensviːˀn
lovlig	lɒwli
levne	lɛwnə
gal	ɡ̊æˀl
allike	alˀəɡ̊ə
værd	ʋɛɐ̯ˀ
sorgen	sɒˀwən
paddehat	pʰaðð̩had̥
makron	mɑkʰʁ̥oːˀn
svømme	svœmə
lud	luðˀ
cremer	kʰʁ̥ɛːmɐ
slibe	sliːʊ̯ə
tak	tˢɑɡ̊
eksempel	eɡ̊sɛmˀb̥əl
skørt	sɡ̊øˀɐ̯d̥
marcipan	mɑsipʰæːˀn
bekende	b̥ekʰɛnˀə
svans	svanˀs
turbine	tˢuɐ̯b̥iːnə
ansattes	ansad̥əs
syntes	synəs
spurgte	sb̥uɐ̯d̥ə
pebet	pʰeːwð̩
platfod	pʰlad̥foːˀð
hytten	hyd̥n̩
andersen	ɑnɐsn̩
røntgen	ʁɶŋˀɡ̊ən
frikvarter	fʁiɡ̊ʋɑtˢeɐ̯ˀ
gavne	ɡ̊ɑwnə
kørsel	kʰøɐ̯sl̩
vætte	ʋɛd̥ə
svær	sʋ̥æɐ̯ˀ
savsmuld	sɑwsmulˀ
århusianer	ɒhuɕæːˀnɐ
minimælk	minimɛlˀɡ̊
gaffel	ɡ̊ɑfəl
hævde	hɛwd̥ə
fedtet	fed̥əð
syer	syɐ̯ˀ
tvetydig	tˢvetyːˀði
lavet	læːwð̩
hellige	hɛlii
flue	fluːə
eder	eːðɐ
engsnarre	ɛŋsnɑːɑ
demokratiske	d̥emokʰʁ̥ɑˀd̥isɡ̊ə
blad	b̥laðˀ
brunch	b̥ʁʌnɕ
brudepige	b̥ʁuːðəpʰiːə
kiste	kʰiːsd̥ə
husgeråd	husɡ̊eʁɔˀð
spiser	sb̥iːsɐ
filologisk	filoloˀisɡ
vasal	vasalˀ
campere	kʰæːmb̥ɐɐ
vanvittige	ʋanʋid̥ii
høl	høl
furie	fuɐ̯ˀɪ̯ə
nil	niˀl
hint	henˀd̥
ungt	ɔŋˀd̥
elsdyr	ɛlˀsd̥yɐ̯ˀ
værgen	ʋaɐ̯ʊn
tommel	tˢʌməl
krybskytte	kʰʁ̥yb̥sɡ̊ød̥ə
hacker	haɡ̊ɐ
viril	viʁiːˀl
forligede	fʌliˀð̩ð̩
kvalte	kʰʋ̥æˀld̥ə
bone	b̥ʌŋə
spore	sb̥oːɐ
leksika	lɛɡ̊sikʰa
hikke	heɡ̊ə
greve	ɡ̊ʁæːʋə
mø	møˀ
sagde	sæːæ
græd	ɡ̊ʁaˀð
juveler	juveːˀlɐ̯
vakuum	vɑkʰɔm
hvas	ʋas
løg	lʌjˀ
udrensning	uðʁanˀsneŋ
sove	sɒːʊ
prædike	pʰʁ̥aðɡ̊ə
bærer	b̥ɛːɐ
købmand	kʰømanˀ
rækken	ʁaɡ̊ŋ̩
skænke	sɡ̊ɛŋɡ̊ə
tyndtarm	tøntɑˀm
vedtage	ʋeðtˢæˀ
lader	lɑ
dansk	d̥anˀsɡ̊
stjerne	sd̥jæɐ̯nə
tidsmaskine	tˢiðsmasɡ̊iːnə
radikal	ʁɑd̥ikʰæːˀl
manen	mæːˀnən
kulør	kʰuløɐ̯ˀ
sanddru	sand̥ʁuˀ
barfodet	b̥ɑːfoːˀðəd̥
røv	ʁɶwˀ
sigtes	seɡ̊d̥əs
tove	tˢɒːʊ
pedel	pʰed̥ɛlˀ
svigerdatter	sʋ̥iˀɐd̥ad̥ɐ
rig	ʁiˀ
labil	lab̥iːˀl
træg	tˢʁæjˀ
ark	ɑːɡ̊
boner	b̥ɔwnɐ
daglige	d̥ɑwlii
magnesium	maʊ̯neˀɕɔm
uret	uʁɑd̥
kel	kʰeːˀl
ab	æːˀb̥
abbed	ɑb̥eð
ærinde	æɐ̯ɐnə
hieroglyffen	hioɡ̊lyfn̩
pile	pʰiːlə
kneppe	kʰneb̥ə
euro	juɹɔw
hjulpen	jɔlb̥m̩
fik	feɡ̊
hvordan	ʋʌnˀn
forligede	fʌliðˀð̩ð̩
halvfjerdsindstyve	halfjaɐ̯sn̩stˢyːʋə
hovedpulsåre	hoːəð̩pʰulsɑːɑ
dun	d̥uːˀn
hjord	jɒˀd̥
borgen	b̥ɒːˀwən
ståltråd	sd̥ʌltˢʁ̥ɔːˀð
røgt	ʁœɡ̊d̥
vende	ʋɛnə
aluminium	alumiˀnjɔm
røv	ʁœˀw
runde	ʁɔnə
pure	pʰyʁæ
pæne	pʰɛːnə
værg	ʋaɐ̯ˀw
læste	lɛˀsd̥ə
bridge	b̥ʁid̥ɕ
vild	ʋilˀ
emne	ɛmnə
træffende	tˢʁ̥afənə
stratosfære	sd̥ʁɑd̥ʌsfɛːɐ
hjelme	jɛlmə
fortryde	fʌtˢʁ̥yˀðə
terapi	teɑpiˀ
tibetaner	tˢib̥ətˢæːˀnɐ
leksikoner	lɛɡ̊sikʰʌnˀɐ
indenlands	enn̩lanˀs
jodle	jʌd̥lə
besørge	b̥esɶwˀə
kapers	kʰæːˀb̥ɐs
kusine	kʰusiːnə
kaffe	kʰɑfə
prægtig	pʰʁ̥aɡ̊d̥i
hjemme	jɛmm̩
finmark	fenmɑːɡ̊
qua	kʰvæːˀ
accenters	ɑɡ̊sɛnˀd̥ɐs
gløgg	ɡ̊lœɡ̊
danisere	daniseˀʌ
prosaisk	pʰʁ̥osɑjˀisɡ̊
kongruens	kʰʌŋɡ̊ʁuɛnˀs
skum	sɡ̊ɔmˀ
forlange	fʌlɑŋˀə
faktisk	fɑɣd̥isɡ̊
tanken	tˢæːŋˀɡ̊ŋ̩
rigdom	ʁiːd̥ʌmˀ
let	lɛd̥
rende	ʁanə
stalinisme	sd̥alinismə
bund	b̥ɔnˀ
ignorerer	enjoʁɛˀɐ
ordspillene	oɐ̯sb̥elˀɭ̩nə
dal	dæːˀl
prud	pʰʁ̥uðˀ
spiste	sb̥iːsd̥ə
skomager	sɡ̊ɔmæːˀjɐ
lege	lɑːɪ
grammatiker	ɡ̊ʁɑmatˢiɡ̊ɐ
boulevard	b̥uləʋɑˀd̥
krydderurt	kʰʁ̥yðɐuɐ̯d̥
penneven	pʰɛnəvɛn
beholde	b̥ehʌlˀə
gregoriansk	ɡ̊ʁɛɡ̊ɒɐ̯iæːˀnsɡ̊
ligesom	lisʌm
mager	mæːɐ
bipolar	b̥ipʰolɑːˀ
onde	ɔnə
grel	ɡ̊ʁalˀ
frænke	fʁaŋɡ̊ə
vandet	ʋa̝nˀð̩
rød	ʁœðˀ
rygsæk	ʁœɡ̊sɛɡ̊
norge	nɒːwə
syge	syːə
rejsebureau	ʁɑjsəb̥yʁo
by	b̥yˀ
vække	ʋɛɡ̊ə
skole	sɡ̊oːlə
kollega	kʰole̝ːka
spørge	sb̥ɶːɐ
semester	semɛsd̥ɐ
vandr	ʋɑnˀd̥ɐ
bogorm	b̥ɔwoɐ̯ˀm
pilgrim	pʰiːlɡ̊ʁɛm
arabien	aʁɑːˀb̥iən
krydderurt	kʰʁ̥œðɐuɐ̯d̥
tatovør	tatovøˀɐ̯
føniks	føːniɡ̊s
dagligvaren	d̥ɑwliʋɑːɑn
bonet	b̥oːnəð
hofmarskal	hʌfmɑːɕal
å	ɔː
ejendom	ɑːjənd̥ʌmˀ
ligge	lɛɡ̊ə
trekant	tˢʁ̥ɛkʰanˀd̥
forbyde	fɒb̥yˀðə
tretten	tˢʁ̥ɑd̥n̩
harsk	hɑːsɡ̊
snyder	snyːðɐ
forelægge	fɒːɒlɛɡ̊ə
drage	d̥ʁɑːwə
forsørge	fʌsɶwˀə
kommentar	kʰɔməntˢɑːˀ
klokkeslæt	kʰl̥ʌɡ̊əslɛd̥
og	ɒw
pålægger	pʰʌlɛɡ̊ɐ
mad	mað
magen	mæːæn
bød	b̥øðˀ
sveder	sveːðɐ
kvæde	kʰʋ̥ɛːð̩
hvepsetalje	veb̥sətˢaljə
frelst	fʁalsd̥
varsle	ʋɑːslə
nav	naw
frelste	fʁalˀsd̥ə
lyste	løsd̥ə
rense	ʁɑnsə
skyts	sɡ̊ød̥s
glemte	ɡ̊lɛmˀd̥ə
skal	sɡ̊al
man	mæˀn
reel	ʁeɛlˀ
besætte	b̥esɛd̥ə
afrikansk	ɑfʁikʰæːˀnsɡ̊
basketball	b̥ɑːsɡ̊əd̥b̥ɒːl
skytte	sɡ̊ød̥ə
stækkede	sd̥ɛɡ̊əðə
jeres	jaːɐs
salathoved	salæːˀd̥hoːəð̠ˠ
offentlig	ʌfn̩li
fædreland	fɛðʁɐlanˀ
kaos	kʰæːʌs
hæler	hɛːlɐ
tang	tˢɑŋˀ
tegn	tɑjˀn
lavede	læːʋəðə
grundlov	ɡ̊ʁɔnlɒw
hvordan	ʋʌd̥an
spis	sb̥iːˀs
udseende	uðseːˀənə
paulun	pɑwluˀn
åger	ɔˀwɐ
medens	meðˀəns
forår	fɒːɒˀ
romer	ʁoˀmɐ
skal	sɡ̊alˀ
kvælstof	kʰʋɛːlsd̥ʌf
læsesal	lɛːsəsæˀl
voksen	ʋʌɡ̊sn̩
stakket	sd̥ɑɡ̊əð
sublim	sub̥liːˀm
and	anˀ
grusom	ɡ̊ʁuːsʌmˀ
isvin	iːsʋiːˀn
hvi	ʋiˀ
an	an
helligdag	hɛlidæˀ
sprog	sb̥ʁɔˀw
kulturchok	kʰultˢuɐ̯ˀɕʌɡ̊
dele	d̥eːlə
elske	ɛlsɡ̊ə
semiotik	semiotˢiɡ̊
kære	kɛːɐ
skurk	sɡ̊uɐ̯ɡ̊
opstanden	ʌb̥sd̥anˀən
brand	b̥ɹæːnd̥
kager	kʰæːɐ
patient	pʰaɕɛnˀd̥
radbrækket	ʁɑðb̥ʁaɡ̊əð
hav	ha
fulgt	fulˀd̥
hviske	ʋesɡ̊ə
latin	latˢiˀn
plag	pʰlæjˀ
frygtelig	frœɡ̊li
kunnet	kʰunəð
oldgræsk	ʌlɡ̊ʁɑsɡ̊
ungkarl	ɔŋkʰæːˀl
spinkel	sb̥eŋˀɡ̊əl
europæer	œwʁopʰɛˀɐ
ræv	ʁæˀw
hindre	henˀd̥ʁɐ
cypres	sypʰʁ̥ɑs
ribben	ʁib̥eˀn
tøve	tˢøːʋə
arbejdsdag	ɑːb̥ɑɪ̯d̥sd̥æːˀ
vovet	ʋɔwð̩
demokratisk	d̥emokʰʁ̥ɑˀd̥isɡ̊
råernes	ʁɔˀɐnəs
grejer	ɡ̊ʁɑjɐ
øv	œw
kviksølv	kʰʋiɡ̊søl
onanere	ʌnaneːˀɐ
værgens	ʋaɐ̯ʊns
bør	b̥øˀɐ̯
amerikaner	ɑmʁikʰæˀnɐ
dåseøl	d̥ɔːsəøl
bærer	b̥æːɐ
glansbillede	ɡ̊lanˀsb̥eləð̩
din	d̥iːˀn
overvejende	ɒwɐʋɑjˀənə
hade	hæːðə
collie	kʰʌli
lider	liˀðɐ
sliber	sliwˀɐ
ræd	ʁɑjˀ
læg	lɛɡ̊
forudse	fɒuðseˀ
drøv	d̥ʁɶw
pine	pʰiːnə
frede	fʁ̥æðð̩
sprødt	sb̥ʁœd̥
tresindstyvende	tˢʁ̥ɛsn̩stˢyːʊnə
dræber	d̥ʁɛˀb̥ə
korps	kʰɒːb̥s
jord	juːˀɐ
svøber	sʋøˀb̥ɐ
spændernes	sb̥ɛnɐnəs
frø	fʁ̥œːˀ
introduktion	entˢʁod̥ukʰɕoːn
grimassere	ɡ̊ʁimaseːˀɐ
retsløs	ʁad̥sløˀs
vin	ʋiˀn
spækhugger	sb̥ɛɡ̊hɔɡ̊ɐ
kustode	kʰusd̥oːðə
vov	ʋɒw
august	ɑwɡ̊ɔsd̥
radbrække	ʁɑðb̥ʁaɡ̊ə
jord	joːˀə
gøde	ɡ̊øːðə
nødvendigt	nøðʋɛnˀd̥id̥
vægre	ʋɛːɐ
frelser	fʁalˀsɐ
arrangere	ɑɑŋɕeˀɐ
hospital	hosb̥itˢæːˀl
esoterisk	esotˢeːˀɐ̯isɡ̊
enorm	enɒˀm
forråden	fʌʁɔˀðən
røg	ʁœjˀ
ætter	ɛˀd̥ɐ
kende	kʰɛnə
gælde	ɡ̊ɛlə
strejke	sdʁaɡə
vækkende	ʋɛɡ̊ənə
majsolie	mɑɪ̯ˀsoljə
stjålen	sd̥jɔːln̩
ribben	ʁib̥m̩
romerriget	ʁoˀmɐʁiːəð
endt	ɛnˀd̥
utryg	utˢʁ̥œ̞ɡ̊
dame	d̥æːmə
forstørre	fʌsd̥ɶɐ̯ˀɐ
knob	kʰnoːˀb̥
skræl	sɡ̊ʁɑlˀ
taget	tˢæðð̩
skinne	sɡ̊enə
undtog	ɔntˢoˀ
vægtning	ʋɛɡ̊neŋ
fordele	foɐ̯d̥eːlə
sigtede	seɡ̊d̥ð̩ð̩
troværdig	tˢʁ̥oʋaɐ̯ˀd̥i
græshoppe	ɡ̊ʁashʌb̥ə
bekendes	b̥ekʰɛnˀəs
schweizer	sʋɑjˀd̥sɐ
fast	fæːˀsd̥
tilpas	tˢelpʰas
knogle	kʰnɒwlə
se	seˀ
nyd	nyðˀ
træne	tˢʁ̥æːnə
jævnføre	jɛwnføˀɐ
oldnordisk	ʌlnoɐ̯ˀd̥isɡ̊
der	d̥eˀɐ̯
byde	b̥yːðə
eklektisk	ekʰlɛɡ̊tˢisɡ̊
rettelse	ʁad̥l̩sə
sneugle	sneuːlə
øgle	ʌjlə
uræmi	uʁɛmiːˀ
sjælden	ɕɛln̩
spækhøker	sb̥ɛɡ̊høˀɡ̊ɐ
retssal	ʁɑd̥sæˀl
hærge	haɐ̯wə
øm	œmˀ
klods	kl̥ʌs
grejet	ɡ̊ʁɑðˀð̩
vag	væːˀj
overvælde	ɑwɐʋɛlˀə
marked	mɑːɡ̊ð̩
kommet	kʰʌmð̩
kno	kʰnoːˀ
anholde	anhʌlˀə
mager	mæˀjɐ
folde	fʌlə
lagdes	lɑwd̥əs
nix	neɡ̊s
aorist	ɑoʁisd̥
tråde	tˢʁɔːðə
skjorte	sɡ̊joɐ̯d̥ə
værges	ʋaɐ̯ʊs
laver	læːwɐ
hejre	hɑjʁʌ
beskrive	b̥esɡ̊ʁiwˀʊ
virolog	viʁoloːˀ
hæle	hɛːlɐ
rod	ʁoˀð
hænder	hɛnˀɐ
husbåd	husb̥ɔðˀ
begynde	b̥eɡ̊ønˀə
sprit	sb̥ʁid̥
pakken	pʰɑɡ̊ŋ̩
vejre	ʋɑjʁɐ
slim	sliːˀm
sigende	siːənə
penge	pʰɛŋŋ̩
skab	sɡ̊æːˀb̥
gylden	ɡ̊ylˀən
fremmedlegeme	fʁɑmð̩lɛːmə
ubrugelig	ub̥ʁuːˀəli
tresindstyvende	tˢʁ̥ɛsənstˢyːʋənə
hovedbanegård	hoːəðb̥æːnəɡ̊ɒˀ
vitamin	vitˢamiːˀn
ryggesløs	ʁœɡ̊əsløˀs
stjålen	sd̥jʌln̩
kræset	kʰʁ̥æˀsð̩
nødt	nøˀd̥
radioaktiv	ʁɑːˀd̥joɑɡ̊tˢiwˀ
dagligstue	d̥ɑwlisd̥uːu
urindoeuropæisk	uɐ̯end̥oœwʁopʰɛˀisɡ̊
hævngerrig	hɛwnɡ̊æɐ̯i
louise	luiːsə
fotosyntese	fotˢosyntˢeːsə
vildsvin	ʋilsʋiˀn
berede	b̥eʁæˀðð̩
hovedsag	hoːð̩sæˀj
finne	fenɘ
trådløs	tˢʁ̥ɔðløːˀs
birkes	b̥iɐ̯ɡ̊əs
opstigende	ʌb̥sd̥iˀənə
fatwa	fæd̥ʋa
skær	sɡ̊ɛˀɐ̯
på	pʰɔ
fællesskab	fɛlˀəssɡ̊æˀb̥
smaragd	smɑʁɑwˀd̥
køretøj	kʰøːɐtˢʌj
fri	fʁiːˀ
vovedes	ʋɔːʋð̩ð̩s
arv	ɑwˀ
vover	ʋɔːʋɐ
morgen	mɒːɒn
belgisk	b̥ɛlˀɡ̊isɡ̊
kapring	kʰæːb̥ʁæŋ
nummer	nɔmˀɐ
udsagn	uðsɑwˀn
ked	kʰeðˀ
kappe	kʰɑb̥ə
indtil	enˀtˢe
henne	hɛnn̩
fund	fɔnˀ
sådan	sʌd̥an
forresten	fʌʁasd̥n̩
grupperabat	ɡ̊ʁub̥əʁɑb̥ɑd̥
paris	pʰɑːis
rente	ʁɑnd̥ə
sunde	sɔnə
funktionel	fɔŋɕonɛlˀ
vejret	ʋɛˀɐð
hjulpet	jɔlb̥əð
tænde	tˢɛnə
gårsdag	ɡ̊ɑːˀsd̥æːˀ
tankens	tˢæːŋˀɡ̊ŋ̩s
fordel	foɐ̯d̥eːˀl
maddike	maðˠˀiɡ̊ə
var	ʋɑ
gang	ɡɔŋˀ
kropslig	kʰʁ̥ʌb̥sli
måske	mɔsɡ̊e
hat	had̥
forbudt	fɒb̥ud̥
bolværk	b̥ʌlvæɐ̯ɡ̊
gamache	ɡ̊amaɕə
tæmme	tˢɛmə
kurer	kʰuːɐ
hamstre	hɑmsd̥ʁɐ
atombombe	atˢoˀmb̥ɔmb̥ə
ungarsk	ɔŋɡ̊ɑːˀsɡ̊
mørk	mɶɐ̯ɡ̊
tog	tˢɔˀw
megen	majən
pore	pʰoːɐ
sprogenes	sb̥ʁɔwˀənəs
ozon	osoˀn
farvestof	fɑːvəsd̥ʌf
eufori	ɛwfoʁiːˀ
fremmedlegeme	fʁamð̩lɛːɪmə
parre	pʰɑːɑ
bort	b̥oɐ̯ˀd̥
løste	løˀsd̥ə
zar	sɑːˀ
mager	mæːjɐ
trit	tˢʁ̥id̥
forbødes	fɒb̥øˀðəs
bruge	b̥ʁuːu
hver	ʋɛˀɐ̯
helle	hɛlə
gav	ɡ̊æwˀ
imod	imoˀð
stække	sd̥ɛɡ̊ə
skrev	sɡ̊ʁæˀw
campere	kʰɑmpʰeːˀɐ
kikkert	kʰiɡ̊ɐd̥
modvillig	moðʋilˀi
hydrat	hyd̥ʁɑːˀd̥
geek	ɡ̊iːɡ̊
sparsommelig	sb̥ɑsʌmˀl̩li
rabarber	ʁɑb̥ɑˀb̥ɐ
lunge	lɔŋə
sølvbryllup	sølb̥ʁœ̞lɔb̥
benklæder	b̥eːnkʰl̥ɛɐ̯
gut	ɡ̊ud̥
hårbørste	hɒːb̥œ̞ɐ̯sd̥ə
skete	sɡ̊eːd̥ə
tyd	tˢyːˀð
højredrejning	hʌɪ̯ʌd̥ʁɑɪ̯niŋ
uge	uːə
kredse	kʰʁ̥ɛːsə
årle	ɒːlə
palæ	pʰalɛːˀ
skilte	sɡ̊elˀd̥ə
forårsage	fɒɒsæːˀjə
sangsvane	sɑŋsvæːnə
billeder	b̥eðlɐ
som	sʌm
kneppe	kʰnɛb̥ə
bøv	b̥œʊ̯ˀ
brugelig	b̥ʁoːoli
bowle	b̥ɒwlə
bygge	b̥yɡ̊ə
bed	b̥eˀð
kan	kʰa
laks	lɑɡ̊s
spøgt	sb̥øɡ̊d̥
løgner	lʌjnɐ
tom	tˢʌmˀ
å	ɔ
bro	b̥ʁoːˀ
komme	kʰʌmm̩
ræsonen	ʁæsʌŋˀŋ̩
filologi	filoloɡiˀ
demokrati	d̥emokʰʁ̥ɑtˢiˀ
konjunktion	kʰʌnjɔŋɡ̊ɕoːˀn
hykler	hyɡ̊lɐ
bønner	b̥œnɐ
tobak	tˢob̥ɑɡ̊
klassisk	kʰl̥asisɡ̊
port	pʰoɐ̯ˀd̥
børs	b̥øɐ̯ˀs
ung	ɔŋˀ
sprøde	sb̥ʁœðð̩
hundestejle	hunəsd̥ɑjlə
besøger	b̥esøˀjɐ
drøbel	d̥ʁœʊ̯ˀəl
myre	myːɐ
ignorerede	enjoʁɛˀɐðə
hagel	hæˀl̩
primær	pʰʁ̥imɛɐ̯ˀ
vildt	ʋilˀd̥
kokosnød	kʰoːɡ̊usnøðˀ
opdrage	ʌb̥d̥ʁɑːˀwə
gjort	ɡ̊joɐ̯ˀd̥
skib	sɡ̊iˀb̥
whiskysovs	ʋisɡ̊isɒʊ̯ˀs
vederkvæge	ʋeðɐkʰʋ̥ɛˀɛ
gejstlige	ɡ̊ɑjsd̥lii
bon	b̥ʌŋˀ
spurv	sb̥uɐ̯ˀw
lader	laðˀɐ
ægge	ɛːɡ̊ə
lykkes	løɡ̊əs
fertilitet	fæɐ̯tˢilitˢeːˀd̥
vidunderlig	ʋiðɔnˀɐli
doktorer	d̥ʌɡ̊tˢoːɐ
ildløs	illøˀs
ir	iɐ̯
dølge	d̥øljə
skødet	sɡ̊øðˀəd̥
rigsdansk	ʁisd̥anˀsɡ̊
beslutte	b̥eslud̥ə
skalte	sɡ̊ald̥ə
flage	flæːjə
svorent	sʋoːɐnd̥
stå	sd̥ɔˀ
fed	feðˀ
ordne	ɒːd̥nə
stødt	sd̥øˀd̥
hop	hʌb̥
