vertuous	vɛrtiu̯us
yvel	ivələ
champioun	tʃampjuːn
imperial	impɛriaːl
game	ɡamən
bord	bɔːrd
byndyng	bindunɡ
aker	aːkər
whale	xʍaːl
couchen	kuːtʃən
baytynge	bɛi̯tinɡ
hood	hoːd
dewynge	dɛu̯inɡ
harneys	harnɛi̯s
delityng	deːliːtinɡ
warenne	warɛnə
towayle	twɛi̯lə
materialy	maːtɛriaːliː
jewery	dʒiu̯əriːə
awinnen	awinən
isykle	iːzikəl
merveilously	mɛrvələsliː
merily	miriliː
þei	θɛi̯
anteme	antɛvənə
alabastre	aləbastər
speche	spɛːk
defferent	dɛfɛrɛnt
matrone	maːtruːnə
rerynge	reːrinɡ
songly	sɔːnɡliːtʃ
lewidhed	lɛu̯idhɛːd
gome	ɡoːmə
nought	nau̯xt
frost	fɔrst
theater	tɛːaːtər
botnen	boːtənən
develiche	deːvəliːtʃ
selly	sɛleː
glasier	ɡlaːzjərə
folen	foːlən
rother	roːdər
cristien	kristjan
college	kɔlɛdʒə
potful	pɔtful
abenche	abɛntʃə
suren	siu̯rən
tape	taːpə
swathe	swaθ
wath	waθ
schanke	ʃankə
citeseyn	sitisɛi̯n
quaylen	kwɛːlən
deyen	dɛiən
wrotynge	wroːtinɡ
colt	kɔːlt
frounter	fruntɛːr
glew	ɡliu̯
snowisshe	snɔu̯iʃ
frost	frɔst
daunce	dau̯nsə
lawely	lau̯əliːtʃ
hameren	haːmərən
baptisen	baptiːzən
letheren	lɛðərən
brekefast	brɛkfast
hatel	hɛːtəl
hyen	hɛi̯ən
werreour	wɛriur
gauger	ɡau̯dʒuːr
alienyng	aːliɛninɡ
rewthfully	riu̯θfuliː
horlynge	hɔrəlinɡ
boryng	bɔːrinɡ
argh	arɔu̯
seli	seːliː
freen	freːn
vice	viːsə
gravey	ɡraːveː
towayle	tuːɛlə
collegiate	kɔlɛːdʒiaːtə
clepen	kleːpən
febly	feːbəliːtʃə
waynscot	wɛːnʃɔt
reuþe	ruːθ
yow	uː
nombre	nuːmər
ythe	uːθ
revelacioun	rɛvɛlaːsjun
douȝty	duxtiː
locuste	lɔːkusta
nyce	niːsə
heronsewe	hɛːrənsɛu̯
werren	wɛːrən
instrumental	instriu̯mɛntaːl
divisioun	divizjuːn
clovere	klɔːvər
brigge	briɡ
hatere	haːtərə
lawe	lau̯ə
angwissh	anɡwisə
capoun	kaːpən
elnen	ɛlnən
patynmaker	patinmaːkərə
cloudy	kluːdiː
cloystrer	klɔːstərər
frogge	frɔɡə
houselynge	huːzəlinɡ
gracious	ɡraːsiuːs
þeires	θɛi̯ris
redemptoure	rɛdɛmptuːr
sevenefold	sɛːvənfɔːld
camel	tʃamɛi̯l
langage	lanɡwaːd͡ʒə
segge	sɛːdʒ
brere	breːr
venyse	vɛnɛːsja
botew	butɛu̯
flawme	flambə
stingen	stindʒən
horenesse	hɑːrnɛs
amorette	amɔrɛtə
laurer	lau̯rər
wryngen	wrinɡən
termagaunt	tɛrmaɡau̯nt
breeth	brɛːθ
manered	maːnərid
sovereynte	sɔvərinəteː
jueler	dʒiu̯ələr
cromen	krumən
rofen	roːfən
sercher	sɛrtʃeːr
tablet	tabələtə
tusshe	tuʃ
sisours	sizuːrs
bridegome	briːdɡumə
cleyed	iklɛi̯id
swarmen	swarmən
juel	dʒuːəl
ote	ɑːtə
trone	trɔnə
rode	rɔd
bayte	bɛi̯tə
mercurie	markiu̯riːə
flien	fliːən
tosten	tɔːstən
tracen	traːsən
her	hɛːr
bitwixe	bitwiks
quest	kwɛstə
raysyn	rɛːzən
mysterie	mistɛːriːə
hondwerk	hɔndwərk
lynet	linətə
omissioun	ɔːmisjuːn
perilous	pɛriluːs
is	iːs
mysty	mistiː
ook	ɑːk
blowyng	blɔu̯inɡ
brewe	brɛu̯
germanie	dʒɛrmaniːə
gunne	ɡunə
seignurie	sɛi̯nuriːə
þes	ðeːs
mageste	madʒɛsteː
hight	hixt
perilously	parəluːsiː
baptizyng	bapteːzinɡ
heed	hɛːd
umbelappen	ymbelɑppen
odour	ɔːdər
grove	ɡrɔːvə
schaver	ʃaːvərə
trippen	tripən
morter	mɔrteːr
drem	drɛːm
ancle	ankleː
sotschipe	sɔtʃipə
tresounen	trɛːzunən
prisoner	prizoːnər
aken	ɛːkən
pome	pɔːmə
botemles	bɔtəmlɛːs
pere	peːr
ymne	imp
gravestone	ɡraːvstɔːn
inderly	inərəliː
odour	ɔduːr
tart	tart
temese	tamzə
rosee	rɔzeː
hethenli	hɛːðənliː
pattener	patənə
dragoun	draɡɔn
nyȝtly	nixtliː
ȝerde	jiːrd
shirreve	ʃireːvə
bern	bɛːrn
everwik	ɛvərwiːtʃ
unde	undə
mousepese	muːspɛzə
gnawynge	ɡnau̯inɡ
whelp	xʍɛlp
obligatorie	ɔbliɡaːtɔːriːə
crepel	krupəl
surete	sɛu̯rəteː
shire	ʃiːr
moder	moːðər
original	ɔriːɡinal
wrongful	wrɔnɡful
gesten	dʒɛstən
pirie	pɛriːə
grayned	ɡrɛi̯nɛd
prophecie	prɔfɛsiːə
morwe	mɔrɔu̯ən
seventene	sɛvənteːnə
worm	wurm
pathyng	paθinɡ
geaunt	dʒɛːau̯nt
moder	moːdər
vyner	viːnɛːr
swete	swɛːt
vertuous	vɛrtuːs
yit	jɛt
ketel	kɛtəl
assise	asiːzə
surnoun	surnun
junyper	dʒɛnipir
mastyf	mastif
yvelnes	ivəlnɛs
groynynge	ɡrui̯ninɡ
hatel	haːtəl
encens	ɛnsɛns
orpedliche	ɔrpədliːtʃə
suffren	sufrən
teren	tɛːrən
drerily	dreːriliː
serven	sɛrvən
royal	rɔi̯al
manered	maːnərd
legement	lidʒəmɛnt
parisshe	parisə
honysokel	huniːsuːkəl
ȝarowe	jarɔu̯ə
song	sɔːnɡ
everwik	œvərwiːk
manrede	manrɛːdən
cofre	kɔfrə
asker	askərə
almaunden	almau̯ndən
selden	seːldən
reren	reːrən
elleven	ɛlløːvən
mars	mars
rewme	rɛu̯mə
surete	siu̯rəteː
norischaunt	nuriʃau̯nt
pisse	pisə
grece	ɡrɛːsə
abstractly	abstraktliːtʃə
graciousnesse	ɡraːsjuːsnəs
tost	tɔːst
rowen	rɔu̯ən
prophete	prɔfɛːtə
wathely	wɑːðəliː
chaunten	tʃantən
dome	doːm
fiftene	fiːfteːnə
wayn	wɛːn
cirurgical	sirurdʒikal
vyntener	vintnər
pyke	pik
wasp	wasp
bireven	bɛrɛːvən
surgien	surdʒiɛn
lycorys	likurəs
tridel	tridəl
toþen	toːθən
tool	toːl
corner	kɔrnərə
cane	kaːnə
eternally	ɛːtɛrnaliː
bi	biː
glasen	ɡlasən
cheri	tʃiriː
schilder	ʃeːldər
materas	matəras
hires	hiris
gris	ɡriːs
animal	animaːl
fesaunt	fɛzau̯nt
yarne	jarn
germanie	dʒɛrmaːniːə
brewyng	briu̯inɡ
sheep	ʃɛːp
lyme	liːm
dyamaunt	diːamant
erle	ɛːrl
naken	nakən
imposicioun	impɔzisjun
crabbe	krabə
dogh	dɔx
asshy	askiː
pacquet	pakɛt
raymen	rɛi̯mən
bousen	buːzən
sachel	satʃɛl
udder	udər
junyper	dʒiu̯nipər
bargain	barɡənə
galyngale	ɡalənɡaːl
oure	uːr
universally	iu̯nivɛrsaliːtʃə
dale	dɛːl
aide	ɛi̯də
chibolle	tʃibɔlə
douȝtines	duxtinɛs
chalengen	kalɛndʒə
injurious	indʒiu̯riuːs
dale	daːl
blak	blaːk
thyckfolde	θikfɔːld
gerle	ɡirlə
mister	mistɛːr
nayler	nɛi̯lərə
flewme	flɛːmə
middelerthe	midəlɛrθə
mysterie	mistəriːə
mounten	muntən
hasel	hɛːzəl
sute	sui̯tə
coronal	kɔrunal
storien	stɔriːən
carvi	karviː
seging	seːdʒinɡ
stingen	stinɡən
welken	wɛlkən
blowen	blɑu̯ən
cataract	katəraktə
malencolie	mɛlənkɔːliːə
turmeryte	turməritə
chalk	tʃalk
gost	ɡɔːst
clappe	klapə
ladder	ladər
nyghtyngale	nixtinɡaːlə
horsen	hɔrsən
coroner	kuruːneːr
unfrendly	unfrɛndliː
auctour	au̯ktuːr
dane	daːnə
moneyles	munɛi̯lɛːs
lege	liːdʒə
caunterbury	kau̯ntərburiː
clethe	klɛːθ
squirel	skwirələ
venymen	vɛnimən
raunsonen	ransuːnən
yong	junɡ
foreyn	furrɛi̯n
cassen	kasən
fanon	fanuːn
panter	panteːrə
reuþe	riu̯θ
erldom	ɛrldɔm
nicholas	nikɔlau̯s
spilen	speːlən
bark	bark
smythier	smiðiərə
felaweshipe	fɛləʃipə
forsweren	fɔrswɛːriən
hore	hɔːrwə
knoppen	knɔpən
merines	miriːnɛs
columpne	kɔlumnə
fenkel	fɛnkəl
aprill	aːpril
modilich	moːdiːliːtʃə
surgerie	surdʒɛriːə
spicerie	spiːsəriːə
mery	miriːə
rind	riːnd
organic	ɔrɡaniːs
gonner	ɡunər
grace	ɡraːsə
prune	priu̯nə
surveyen	survɛi̯ən
ampte	antə
hertles	hɛrtlɛs
cheveteyn	tʃeːvəntɛi̯nə
youres	juːris
sixtene	sɛksteːnə
whale	ʍal
flodegate	floːdjɛt
seventene	sɛːvənteːnə
anfald	aːnfaːld
tilier	tiljərə
po	pɛː
botere	bɔːtərə
schamel	ʃambəl
waith	waːθ
yrchoun	hurtʃun
lorþeine	lɔːrðɛi̯n
stynken	stinkən
wæstm	wastəm
balfulli	baːlfuliː
ynche	untʃə
wheler	ʍɛːlər
bapteme	baptɛzəm
blasfemyng	blasfɛːminɡ
venyse	vɛniːsə
grippe	ɡripə
hosyer	hɔːzərə
garde	ɡaːrdə
blasfeme	blasfɛːmə
aungel	au̯ndʒəl
swetnesse	sweːtnɛs
historie	ɛstɔriːə
nynthe	niːndə
mon	man
ynke	ɛnkə
narwe	narɔu̯
tofore	toːfɔːrən
quene	kwɛːnə
waynen	wɛi̯nən
muet	miu̯ɛt
chevese	tʃivəsə
rebellyng	ribɛlinɡ
egged	ɛdʒid
hordom	hoːrədoːm
glewen	ɡliu̯jən
overriden	ɔːvərriːdən
venemosite	vɛnəmusteː
kembestere	keːmbəstər
forcoveren	fɔrkɔvərən
hit	it
money	munɛi̯ə
sleighly	slɛi̯liː
game	ɡɛːmən
narwen	narwən
aserchen	asɛːrtʃən
cristenyng	kriːstəninɡ
borden	bɔrdən
boryn	bɔːrən
probleme	prɔblɛmə
þe	teː
venemously	vɛnəmusliːtʃə
aline	aliːnə
asshen	aksən
hostiler	hɔstɛːlər
bildyng	bildinɡ
caunterbury	kantərburiː
werrely	warliː
yelpinge	jɛlpinɡ
tryppingly	tripinɡliː
serchen	sɛːrtʃən
forswerer	fɔrswɛːrərə
dirige	diridʒə
foman	fɔːman
gre	ɡreː
shelden	ʃeːldən
scheryng	ʃɛːrinɡ
thresshyng	θrɛʃinɡ
governaile	ɡuvərnɛl
song	sɔnɡ
webben	wɛbən
cruelly	kriu̯ɛliːtʃə
savegard	saːvəɡardə
crepel	kripəl
sixtene	siksteːnə
mewe	miu̯ə
roialme	rɔi̯au̯m
arȝen	arxjən
sodeyn	sɔdɛi̯n
foreyn	fɔrin
strawen	strau̯ən
webbe	wɛbə
germanie	dʒɛrmɛi̯nə
halter	hɛltər
trewe	trøːwə
inker	inkər
songly	sɔnɡliː
straunge	strau̯ndʒə
smethyng	smeːðinɡ
axel	ɛksəl
sere	seːrə
gardein	ɡardɛn
thred	θrɛːd
cope	kɔːpə
norischen	nurʃən
verveyne	vɛrvɛi̯nə
poisoun	puizɔn
fraudulent	frau̯diu̯lɛnt
straunge	straːndʒə
pleye	plɛi̯ə
ender	ɛːndərə
wel	wɛl
duracioun	diu̯raːsjun
jargoun	dʒarɡun
merily	mɛriliː
spreden	sprɛːdən
halyday	hɔlidɛi̯
gaugen	ɡau̯dʒən
burnet	burnɛːt
tre	trøː
canner	kanərə
thurven	θurvən
garlek	ɡarlɛk
feblischen	feːbliʃən
greceles	ɡrɛslɛːs
viniterie	vintɛːriːə
glorious	ɡlɔːrjuːs
harneysen	harnəʃən
mountant	muːntant
arghnes	arwənɛs
enchaunteresse	ɛntʃantərɛsə
tode	tɔːdə
knotted	knɔtəd
douth	duːθ
mewynge	miu̯inɡ
trone	trɔːnə
originali	ɔriɡinaːli
ele	ɛːl
sho	ʃoː
steire	stɛi̯ər
naperon	naːpəroːn
chaf	kaf
hading	hɑːdinɡ
vesselment	vɛsɛləmɛnt
submissioun	submisjuːn
surname	sirnaːmə
trouthe	triu̯θ
lah	lɑːx
fiftene	fifteːnə
gounde	ɡuːnd
viciously	visiuːsliː
folisch	foːliʃ
quiver	kwivər
defte	daftə
megre	mɛːɡrə
laughter	laxtər
his	his
vertual	vɛrtiu̯al
desert	dɛzɛrt
þestren	θeːstrən
manerly	manɛːrliːtʃə
recoveryng	rɛkuvərinɡ
dialog	diːalɔːɡə
shirrevehod	ʃəreːvəhɔːd
original	ɔriɡinaːl
jafeth	dʒaːfɛt
synamome	sinəmun
fremde	frɛmədə
perche	pərtʃə
wys	wiːs
feldefare	feːldəfaːrə
threschen	θraʃən
wrid	wriːd
staken	staːkən
materialy	matɛːrialiːtʃə
roget	rudʒɛt
sire	sirə
lorfadyr	lɔːrfadər
caraway	karwiː
endely	ɛːndəliː
werreour	wɛriuːr
translatyng	translaːtinɡ
wekely	weːkəliː
whete	xwɛːtə
cite	siteː
knight	knixt
puls	puls
store	stɔːr
grome	ɡrɔːmə
bole	buːlə
kerne	kɛrn
venymoushede	vɛniməshɛːd
narowly	narwəliː
thorp	θrɔp
viciousnesse	visjusnɛs
geson	ɡɛːzun
theft	θɛft
termagaunt	tɛrvaɡau̯nt
nyne	neːən
baleful	balful
bastard	bastaːrd
oule	uːlə
gronen	ɡrɔːnən
ymaginacioun	imaːdʒinaːsjuːn
aghlich	aɣəliːtʃ
narwen	narɔu̯ən
swopen	swoːpən
wroten	wroːtən
slynesse	slɛi̯nɛs
pauncher	pau̯ntʃeːrə
pown	pau̯n
felten	fɛltən
lond	laːnd
ministracion	ministraːtjuːn
crowe	krɑu̯ə
canel	kanɛːlə
regioun	rɛːdʒjun
brekefast	brɛːkfast
rotyngnesse	rɔtinɡnɛs
clubber	klubər
oyler	ui̯lərə
haven	havən
schuldre	ʃuldər
vertuously	vɛrtiu̯əsliː
newte	nɛu̯tə
jalousie	dʒɛluːsiːə
crane	kran
envenymous	ənvɛniməs
parys	paris
orpedliche	ɔrpədliː
cheri	tʃɛriː
wraw	wrɔu̯x
haven	habən
cappe	kapə
lewed	lɛu̯idə
motoun	mutuːn
sporen	spurən
kith	kuðə
hattere	hatərə
smerten	smɛrtən
sly	sliː
herne	hərnə
enhaunsyng	ɛnhansinɡ
shirevewyk	ʃəreːvəwiːkə
soupe	suːpə
grayned	ɡrɛi̯nid
blowen	blɔu̯ən
camel	tʃamɛːl
london	lundən
blasten	blastən
amorette	amurɛtə
radiche	raːditʃə
slider	sliðər
abrest	abrɛːst
fiole	fiːələ
cuppeborde	kupbɔːrd
belde	beːldə
coronement	kurunəmɛnt
bonwort	bɑːnwurt
apocalips	apɔkalipsis
chauntour	tʃantur
monymaker	munɛi̯maːkərə
translacioun	translaːsiuːn
fewell	fɔu̯ɛl
alabastre	aləbastrə
glasyng	ɡlasinɡ
chalengen	tʃalɛndʒən
firse	furz
captivite	kaptiviteː
patronesse	paːtruːnɛsə
vapour	vapuːr
symplenesse	simpəlnɛs
tomben	tuːmbən
felawe	fɛlə
ymagynen	imadʒinən
scheren	ʃɛːrən
egged	iɛdʒid
roste	rɔːst
gate	jaːt
horned	hɔrnɛd
cristenhode	kristɛnhɔːd
develissh	dɛvəliʃ
antecrist	antikriːst
purpel	purpul
vertually	vɛrtiu̯aːliːtʃə
clothing	klɔːðinɡ
acustumaunce	akustumau̯nsə
swayn	swɛi̯n
gage	ɡaːdʒə
þi	ðiː
cosyn	kuziːn
chyn	tʃin
sodeynly	sudɛi̯nliː
revewe	rɛviu̯ə
moisture	mɔi̯sturə
word	wɔːrd
duely	diu̯əliː
recoverer	rɛkuvəriːr
whetten	ʍɛtən
myren	miːrən
clewe	kliu̯ən
cofrer	kɔfreːr
sliden	sliːdən
diversite	diːvərsitɛː
flote	flɔːtə
helm	hɛlm
drerily	dreːrəliːtʃə
tresounen	trɛːzuːnən
coucher	kuːtʃər
green	ɡreːən
college	kɔlɛːdʒə
sotilly	sutəliː
fewell	fiu̯ɛl
ryal	riːal
crist	krist
gripe	ɡripə
veel	vɛl
outward	uːtward
charmyng	tʃarminɡ
comb	kamb
torche	tɔrtʃə
mytre	miːtər
drenchen	drintʃən
gesten	ɡɛstən
tenour	tɛnur
sotil	sɔtil
preposicioun	prɛːpɔzisjun
cleyen	klɛi̯ən
quene	kwɛnə
governen	ɡuvɛrnən
frendly	frɛndliː
medle	mɛdəl
endower	ɛnduːərə
narwe	narwə
horscomb	hɔrskaːmb
furmente	frumɛnteː
hunter	huntər
bace	bas
walwort	walwurt
neygh	niːx
knop	knɔpə
childen	tʃiːldən
alym	aləm
prest	prɛːst
northerne	nɔrðərnə
modilich	moːdiːliː
messen	mɛsən
universalite	iu̯nivɛrsaliteː
perle	pɛːrlə
baroun	baruːn
od	ɔdə
disparagen	disparaːdʒə
halyday	hɔːliːdɛi̯
thamarynde	tamarində
angwischous	anɡwisuːs
castel	kastəl
mone	mɔːn
eifulle	ɛi̯əful
general	dʒɛnəral
auntelere	antələr
firse	firz
batayle	batələ
aren	aːrən
corn	kɔːrn
whale	ʍaːl
officen	ɔfiːsən
awe	aɣ̞ə
hostelrye	hɔstələriːə
sauf	saːf
voys	voːs
mowynge	mɔu̯inɡ
este	ɛːstə
sly	slɛi̯x
posicioun	pɔzisjuːn
myschef	mistʃeːf
enchauntement	ɛntʃantəmɛnt
cheynen	tʃiːnən
crepynge	kreːpinɡ
coynour	kui̯nuːr
opposicioun	ɔpɔːzisjuːn
axiltre	ɛksəltreː
bewrien	biwriːən
beringe	bɛːrinɡ
womman	wiman
filme	filmə
hungren	hinɡrən
wekely	wikəliː
myschevous	mistʃeːvus
fraudulently	frau̯dilɛntliː
savely	sau̯fliːtʃə
nayled	nɛi̯lɛd
colerik	kɔlɛrik
olyve	ɔlif
fre	freː
pilwe	piliu̯
carlele	karliːl
figee	fiɡɛi̯
lawely	lau̯əliː
pask	paskis
west	wɛːstə
frighten	frixtən
pith	peːθə
perled	pɛːrlɛd
ampte	amptə
mode	moːdə
dremen	dreːmən
þe	θeː
dee	deː
sympilte	simpləteː
frightly	frixtliː
kokerel	kɔkrəl
cokke	kɔk
horned	hɔrnd
quiste	kwist
venemosite	vɛnəmusiteː
hostiler	hɔstilər
doucet	dulsit
norture	nurtərə
olfent	ɔlvənd
sored	sɔːrɛd
iwinnen	jəwinən
depely	deːpliːkə
band	band
chambre	tʃaːmbər
ostrich	ɔstriːtʃə
folily	foːliliː
schinen	ʃiːnən
worm	wɛrm
overflowen	ɔvərflɔu̯ən
dokke	dɔkə
heggen	hɛdʒən
kokerel	kɔkərəl
grave	ɡraːvɛi̯
aliegiaunce	aleːdʒəau̯nsə
ilome	iloːmə
sword	swœrd
get	dʒɛt
thrusche	θrɛʃə
alym	alim
inwardnesse	inwaːrdnɛs
baroun	barɔn
grassen	ɡrɛsən
reuful	riu̯ful
speckyd	spɛkid
lamb	lamb
malencolik	malɛnkɔlik
biheve	biheːvə
grave	ɡrav
umbeloken	ymbelɔːken
endelesnes	ɛːndəlɛːsnɛs
erve	ɛrfə
rebel	rɛːbəl
god	ɡɔd
mysteren	mistɛːrən
pulter	pulətər
selden	seːldəm
hos	hɑːrs
egged	ɛdʒɛd
cunnen	kunən
cleve	klɛːvə
bataylen	batələn
wolf	wulf
foreyner	fɔrɛi̯nərə
wesele	wɛːzələ
couche	kuːtʃə
griffoun	ɡrifuːn
les	lɛːs
pese	pɛːzə
grassen	ɡrasən
bragot	brakət
hatrede	haːtərɛːdən
madli	madliː
potell	pɔtəl
brewen	briu̯ən
slyngyng	slinɡinɡ
botnen	bɔtənən
hamme	ham
wawen	wau̯ən
pautener	pau̯tənərə
merveile	mɛrvɛlə
tribune	tribiu̯n
tayl	tɛi̯l
lesarde	lizard
haten	haːtən
pikyng	piːkinɡ
vynolent	viːnɔlɛnt
in	in
fen	fɛn
clevere	kleːvərə
playing	plɛi̯nɡ
cruel	kriu̯ɛːl
disparage	disparadʒə
sweren	swɛːriən
divisioun	dəvizjun
blo	blɔː
oystre	ui̯stər
stile	stilə
peril	parəl
eri	ɛːriː
meteles	mɛtlɛːs
caitif	kɛi̯tif
venym	vɛnim
patyner	patinər
wyndronken	wiːndrunkə
wyspe	wisp
geson	ɡɛsən
tygre	tiɡər
sherte	ʃɛrtə
flour	fluːr
moderly	moːdərliː
staf	staːf
simplicite	simplisiteː
tredel	trɛːdəl
code	kwidə
emeraude	ɛmərau̯də
vertulees	vɛrtiu̯lɛs
clawe	klau̯ə
exaumple	ɛɡzampəl
tumour	tiu̯mur
twelve	twɛlvə
chewyng	tʃiu̯inɡ
unserchable	unsɛrtʃaːbəl
sotilte	sutələteː
ei	ɛi
yoman	jɛːman
chambre	tʃambər
wheten	wɛːtən
swan	swan
kernellen	kirnələn
lyoun	liːun
raunsoner	rau̯nsunərə
patene	patɛːnə
chosling	t͡ʃoːzlinɡ
lawe	laɣə
werrour	wɛrər
glorifiynge	ɡlɔːrifiːinɡ
senyour	sɛːnjuːr
cunde	kynde
versicle	vɛrsikəl
penne	pɛnə
rode	roːd
crouden	kruːdən
raunsonen	rau̯nsunən
quaschen	kwaʃən
bride	briːd
smal	smal
abreggen	abrɛdʒən
hondwerk	hɔːndwərk
pattener	patnə
glyffen	ɡlifən
gaynly	ɡɛi̯nliː
juno	dʒiu̯nɔː
smyth	smiθ
sterven	stɛrvən
rone	rɔːn
nacioun	naːsjuːn
universal	iu̯nivɛrsal
monstruous	mɔnstriu̯uːs
dyamaunt	diːamau̯nt
sotilnes	sutəlnɛs
laughen	lɛxən
colerik	kɔlɛːrik
sovereynly	sɔvərinliːtʃə
jupe	dʒiu̯pə
vertuously	vɛrtiu̯usliːtʃə
official	ɔfisiaːl
winter	wintər
code	koːdə
ministracion	minəstraːtjuːn
barke	barkə
welken	wɔlkənə
queynte	kwɛi̯ntə
fifte	fiftə
bowe	bɔu̯ə
teere	tɛːr
arable	ɛːraːbəl
swiven	swiːvən
folily	foːliːliːtʃə
whettynge	ʍɛtinɡ
writhen	wriːðən
mountuous	muntiu̯uːs
dokeling	duklinɡ
enserching	ənsɛrtʃinɡ
aspe	aspə
otemele	ɑːtəmɛːlə
messyas	mɛsiːas
maundement	mau̯ndimɛnt
fnesy	fneːziː
herien	hɛriən
merveilously	mɛrvɛi̯luːsliːtʃə
er	ɛːr
fumous	fiu̯mus
mone	moːnə
sacre	saːkər
skyr	skiːr
questioun	kwɛstiuːn
ooneyed	ɔniːid
cerymonye	sɛrəmɔːniːə
napkyn	naːpkin
rote	roːtə
sermonynge	sɛrmuninɡ
fiþelere	fiðələrə
homager	ɔmaːdʒeːrə
arow	aːrwə
exaccion	ɛksaksjuːn
bargenyng	barɡəninɡ
faucoun	fau̯kun
outwardly	uːtwardliː
gresynge	ɡreːsinɡ
gest	ɡɛːst
temen	tɛːmən
jurour	dʒiu̯rər
merveilously	mɛrvɛlusliːtʃə
placebo	plaːsɛːbɔː
savement	saːvimɛnt
fesaunt	fɛːzau̯n
nave	naːvə
hatten	hatən
manful	manful
sacre	saːkreː
armee	armeː
anientishen	aneːntiʃən
herne	hiːrnə
endelesly	ɛːndəlɛːsliː
mynystryng	ministərinɡ
thridde	θirdə
spynx	spinks
dewyn	dɛu̯ən
mylnston	miləstɔːn
gilden	ɡildən
ciser	siːsər
officer	ɔfiːsər
hassasis	hasasis
lyoun	lɛːun
blasfemour	blasfɛːmur
cruelheed	kriu̯ɛːlhɛːd
cofrer	kɔfərər
horsman	hɔrsman
falwen	faliu̯ən
wocnesse	wɑːknɛs
raysyn	raːzən
rade	raːd
songly	sɔːnɡliː
þeires	ðɛi̯rz
tenoun	tɛnuːn
ergo	ərɡɔː
berien	burjən
clewe	kliu̯ə
luxurie	luksjuːrə
smelt	smɛlt
madnes	madnɛs
tretys	trɛːtiːs
cerymonye	sɛrimɔːniːə
sutour	siu̯tur
threschwolde	θrɛʃfɔːld
clevynge	klɛːvinɡ
thursday	θuːrizdɛi
frendschip	freːndʃipə
ten	tɛn
tartelet	tartəlɛt
slider	sliːdər
frountel	fruːntɛːl
bataillyng	batəlinɡ
fnast	fnast
chymeney	tʃiminɛi̯
swathel	swaðəl
sider	siːdrə
hegge	hɛdʒ
mynute	miniu̯tə
citeseyn	sitisin
crome	krumə
thede	θeːd
tabler	taːbələrə
laughen	lau̯xən
spyne	spiːna
bastard	bastərd
gele	dʒɛleː
fomynge	fɔːminɡ
ligeaunce	leːdʒəansə
servish	sɛrviʃ
temese	tɛməzə
teme	tɛːmə
bedelven	bidɛlvən
foreyn	fɔrɛi̯n
cheste	tʃɛst
panter	panəteːr
cornered	kɔrnərɛd
cheveteyn	tʃeːvətɛi̯nə
medle	mɛːlə
magik	madʒikə
violently	viːɔlɛntliː
goselyng	ɡeːslinɡ
wytword	witwɔːrd
clevynge	kleːvinɡ
world	wurld
and	an
kith	kuθ
nynetene	niːnteːnə
captif	kaptivə
saillen	sɛi̯lən
theen	θeːən
grave	ɡraːv
dote	dɔːtə
geffrey	dʒɛfrɛi̯
sour	suːr
ketel	tʃitəl
frenden	freːndən
kirnelly	kirnəliː
sowe	suːə
akennednesse	akɛnɛdnɛsə
sotil	suptil
waden	wadən
rotnesse	rɔːtnɛs
weif	wɛi̯f
impregnacioun	imprɛɡnaːsjuːn
slynge	slinɡə
chalk	kalk
canne	kanə
governaunce	ɡuvɛrnansə
laumpe	lau̯mpə
lege	lɛːkə
alym	aliu̯m
schavynge	ʃaːvinɡ
beken	bɛːkən
pautener	pau̯təneːrə
modinesse	moːdiːnɛs
slepeles	sleːplɛːs
sisours	sizuːrz
tradicioun	traːdisjuːn
kerne	kɛːrn
herber	ɛrbeːr
submissioun	submisjun
orped	ɔrpəd
douȝtily	duxtiːliː
yelow	jɛlɔu̯
sovereyn	sɔvərin
parde	pɛrdeː
biqueste	bikwɛst
swei	swɛi̯
gaugen	ɡaːdʒən
wothe	wɑːðə
noumpere	nuːmpeːr
instrumental	instrumɛntal
mader	madrə
sarse	saːrs
raunsonynge	rau̯nsuːninɡ
awles	au̯əlɛs
occean	ɔksjan
bet	bɛt
tylle	tilə
cleven	kleːvən
burde	buːrdə
noumbringe	nuːmbərinɡ
ich	itʃ
toun	tuːn
perer	pɛrər
tygre	teːɡər
eyed	ɛi̯id
parchemyn	partʃimiːn
vynour	viːnuːr
swarm	swarm
meinful	mɛi̯nful
leg	lɛɡ
node	nɔːdə
contre	kuntreːə
imperial	impɛːrial
chalengen	tʃalandʒən
fonnen	funən
recovere	rɛkuvər
gardein	ɡardian
legende	lɛdʒənd
poleyn	pulɛi̯n
sandal	sandəl
maner	manərə
glasier	ɡlaːziərə
seneschal	sɛniʃal
maner	manuːr
fole	foːl
axen	aksən
malencolien	malənkɔːliːɛn
pot	pɔt
ne	nɛ
stikke	stikə
cruelly	kriu̯ɛliː
burely	burliːtʃ
serchen	sɛrtʃən
stakyng	staːkinɡ
sorenes	sɔːrnɛs
diversite	divərsiteː
woke	wɔːk
buryinge	bɛrinɡ
hatyng	haːtjunɡ
chauntement	tʃantəmɛnt
hemp	hɛmp
feble	feːblə
elbowe	ɛlbɔu̯ə
rome	rɔːmə
horynesse	hɔːriːnɛs
bilder	byːldərə
ple	plɛi̯
hondwerk	handwərk
barker	barkərə
thymbyll	θimbəl
ferthe	fɛrθə
different	difɛrɛnt
treden	trɛːdən
king	kinɡ
yvory	iːvui̯riːə
whelwryght	ʍɛːlwrixt
byndyng	bindinɡ
glas	ɡlaːs
store	stuːr
houre	uːrə
tridel	turdəl
luxurious	luksjuːrius
sodeyn	sɔːdɛi̯n
salthous	salthuːs
wynner	winərə
gracious	ɡraːsjus
recoveraunce	rɛkɛvəransə
herne	huːrnə
beaute	bɛu̯teː
beswiken	biswiːkən
serk	sark
gestenen	ɡɛstənən
pome	poːmə
blasfemour	blasfɛːmuːr
licour	likuːr
sorcery	sɔrsəreːə
partrich	partritʃ
hakle	haklə
cornered	kɔrneːrid
frossh	frɔsk
weving	wɛːvinɡ
wicchecraft	witʃəkraft
asshe	ɛʃə
tracyng	traːsinɡ
þou	θuː
pork	poːrk
sathan	satən
horenesse	hɔːrnɛs
bordure	bɔrdiu̯rə
liven	liːvən
sympilte	simpəlteː
ham	hɑːm
day	dɛi̯
pulpit	pulpit
hog	hɔːɡ
thede	θøːd
assayen	sɛi̯ən
sodeynte	sudɛnteː
wrot	wroːt
almond	almɔnd
reremous	reːrəmuːs
vicious	visjus
gold	ɡɔːld
tilier	tilərə
cruelte	kriu̯ɛlteː
whæm	hwam
pepyrquerne	pɛpərkwɛːrn
torche	tordʒə
galyngale	ɡaninɡaːl
bathen	baːðən
creature	krɛaːtiu̯r
bridel	briːdəl
swete	soːtə
motoun	mutun
rubrich	riu̯briʃə
wharfage	ʍarfaːdʒə
ro	rɔu̯
matrone	maːtrɔnə
dyaper	diːaprə
moisten	mɔi̯stən
perchyn	pɛrtʃən
agre	əɡreː
patronage	patruːnadʒə
faderles	faːdərlɛːs
macula	makiu̯la
hosnesse	hɔːsnɛs
path	paθ
botme	bɔtəm
fot	foːt
deposicion	dɛpɔzisjun
verdit	vɛi̯rdit
fader	faːdər
bilewit	biləwit
soukyng	suːkinɡ
sparwe	sparəwə
dauncen	dau̯ntsən
crepen	kreːpən
here	hɛːrə
mysteren	mistərən
deliten	deːliːtən
adamantine	adəmau̯ntiːnə
beriel	buriəls
abstractif	abstraktiv
spayen	spɛi̯ən
compassyng	kumpasinɡ
morther	murðər
winge	wɛːnɡə
lune	liu̯nə
champioun	tʃampjun
blame	blaːmə
griffoun	ɡrifin
gnawen	knau̯ən
creacion	krɛːaːsjuːn
browe	bruː
barntem	baːrntɛːm
capacite	kapasiteː
wyny	wiːniː
sele	seːl
veir	vɛi̯r
chaundeler	tʃandələr
atbreken	ætbrɛːken
sleighly	sliːliː
swalwe	swalɔu̯ə
samoun	samun
jure	dʒiu̯reːə
dint	dunt
glasier	ɡlazjərə
supernatural	siu̯pərnaːtiu̯ral
byschopryke	biʃəpriːtʃə
bale	baːlə
baptist	baptistə
gyserne	ɡəzɛrn
recoveren	rɛkuvərən
humour	iu̯mur
sleighty	slɛi̯xtiː
gate	ɡaːt
horesone	hoːrəsunə
sherten	ʃirtən
yelpere	jɛlpərə
scheltroun	ʃɛltrunə
armurie	arməriːə
frendschip	freːntʃipə
eie	iːə
kerven	kɛrvən
pipen	piːpən
figer	fiɡərə
hervest	hɛrvɛst
coyn	kui̯nə
perle	pɛrlə
senyour	sɛːnjur
thrusche	θruʃə
berme	bɛrmə
flynt	flint
apposicioun	apɔːzisjuːn
slideren	slidərən
canevas	kanəvaːs
inwardnesse	inwardnɛs
raunsonynge	rau̯nsuminɡ
landlorde	landlɔːrd
cyvee	siveː
gronyng	ɡrɔːninɡ
flawmy	flamiː
crabbe	skrabə
feend	feːnd
wawy	waɣiː
inker	junkər
feblenesse	feːblənɛs
flo	flɔː
erd	ard
beautevous	bɛu̯teːuːs
hordom	hoːrdɔm
verray	vərɛi̯
kempe	kɛmp
graciously	ɡraːsjuːsliːtʃə
fan	fan
intronizen	ɛntrɔːniːzən
dart	dart
twig	twiɡ
liquide	likwidə
mynystryng	ministrinɡ
ermyne	ərmineː
rebellen	ribɛlən
hit	hit
maladie	malədiːə
bace	baːs
narowly	narwəliːtʃə
sweren	swɛːrən
inwardly	inwardliː
sterre	stœrə
eyed	ɛi̯ɛd
þester	θɛstər
regioun	rɛdʒjuːn
brasyng	braːsinɡ
deluden	dəliu̯dən
fremde	frɛmptə
prisoun	prizuːn
materas	matərəs
kemben	kɛmən
pound	pund
rebellious	rɛbɛliuːs
elf	ɛlf
steppe	stɛːpə
gruntyng	ɡruntinɡ
rebellioun	rɛbɛliun
sure	siu̯r
werrour	warur
mire	myːr
panter	pantərə
souker	sukərə
swathlen	swaðələn
champioun	kampiuːn
figer	fiɡeːrə
i	i
blameful	blaːməful
tethen	teːθən
ambre	ambər
gressehopper	ɡrashɔpər
hors	hɔrs
walsch	wɛliʃ
moneyour	munɛi̯uːr
toln	tɔlnə
drye	driːə
merily	mɛriːliː
her	heːr
bataillous	batɛi̯luːs
arveðliche	arvəðliːtʃə
fumyter	fumtɛːrə
lyne	lin
peretre	pɛːrətreː
syment	simɛnt
swaren	swaːrən
bettre	bɛtərə
judew	juːdɛu̯
hasel	haːzəl
outwardes	uːtwardəs
story	stɔriːə
scheef	ʃɛːf
depthe	dɛpθ
sodeynly	sɔdɛi̯nliː
kernel	kɛrnəl
spruten	spruːtən
brewester	briu̯əstər
bladdren	blɛdərən
est	ɛːst
arow	arɔu̯
thefly	θeːfliːtʃə
rebellioun	rɛbɛljun
ikil	itʃəl
deluge	dɛːliu̯dʒə
madhede	madhɛːd
get	dʒɛːt
thistel	θistəl
sleight	slɛi̯ð
ashore	aʃɔːrə
wicchen	witʃən
forkerven	fɔrkɛrvən
humour	iu̯muːr
stroken	strɑːkjən
fawnyng	fau̯ninɡ
weykenesse	wɛi̯kənɛs
horned	hɔrnid
inde	iːndə
mountuous	muːntiu̯uːs
gelen	dʒɛlən
smiten	smiːtən
devely	dɛfliːtʃə
thilke	θɪlk
schiten	ʃiːtən
sotilen	sɔtilən
fanon	fanun
tronen	trɔːnən
fome	fɔːm
bordis	buːrdɛi̯s
barnles	baːrnlɛːs
woken	wɔːkən
fox	fɔks
ten	teːn
violently	viəlɛntliː
revelacioun	rɛvɛlaːsjuːn
flawme	flamə
strengthen	strɛi̯nθən
bliken	bliːkən
adle	adəl
reme	rɛːm
hornyng	hɔrninɡ
pakker	pakərə
blome	bloːm
risshe	riʃ
agayn	ajeːn
vespertyne	vɛspərtiːnə
skyn	skin
sorow	sɔrɔu
armurie	armiu̯riːə
endowynge	ɛnduːinɡ
anger	anɡər
moderles	moːdərlɛs
wale	waːl
mawe	mau̯ə
thornen	θɔrnən
good	ɡoːd
trompour	trumpərə
feblen	feːblən
sadeler	sadələrə
broun	bruːn
bethleem	bɛdleːɛm
bref	breːvə
wombe	woːm
magnete	maɡnɛːtə
harneys	harnəs
bleten	blɛːtən
axiltre	aksəltreː
inwit	ənwit
bisynes	biziːnɛs
sithen	sin
spekke	spɛkə
kne	kniu̯
sorcery	sɔsəriːə
ruynous	riu̯inus
bakynge	baːkinɡ
ymaginacioun	imaːdʒinaːsjun
officen	ɔfisən
blase	blaːzə
syftynge	siftinɡ
scorpioun	skɔrpiuːn
perilously	pɛriluːsliːtʃə
depely	deːpliː
burde	burdə
compas	kumpaːs
mane	maːnə
cruelheed	kriu̯əlhɛːd
wayn	wɛi̯nə
houselen	huːzələn
hacche	hɛtʃ
wynly	winliːtʃə
falwen	falwən
lopster	lɔpəstər
tyrauntly	tiːrau̯ntliː
warm	warm
laumpe	lampə
angwischous	anɡui̯ʃus
sly	slɛi̯
schade	ʃadə
glasen	ɡlaːzən
dalke	dalk
smythier	smiðərə
suster	zistər
vine	viːnə
dauncen	dansən
fiele	fiːɛlə
sathan	satan
frangible	frand͡ʒiblə
piker	pikərə
pissen	piʃən
merveilen	mɛrvɛlə
forest	fɔrɛst
gome	ɡɔmə
sotilte	sɔtiləteː
wawynge	waɣinɡ
spile	spiːl
hirdel	hɛrdəl
redempcioun	rɛdɛmpsjun
bireven	bərɛːvən
nose	nɔːzə
oystre	ui̯strə
comaundable	kumandaːbəl
aliegiaunce	aleːdʒəansə
whynne	win
beterynge	bɛtərinɡ
cerymonye	sɛrimɔniːə
conjurer	kundʒərɛːrə
dowarye	duːəriːə
gore	ɡɔːr
sauge	saːdʒə
streight	strɛi̯xt
aliegiaunce	aliːdʒəau̯nsə
hevysum	hɛːvisum
gardener	ɡardinərə
tilthe	tilθ
wynsom	winsum
flasket	flaskɛt
vertuousnesse	vɛrtiu̯usnɛs
þurs	θrus
felawrede	fɛlau̯rɛːdə
schat	ʃat
comaunden	kumandən
thikly	θikliː
emperie	ɛmpəriːə
vapouren	vaːpurən
horden	hɔrdən
ligeaunce	liːdʒəau̯nsə
adamantine	adəmantiːnə
larke	lavərkə
horyen	hɔːrən
hosely	hɔːsliː
westward	wɛstward
malencolious	mɛlɛnkɔːliuːs
meteles	mɛːtəlɛs
laven	laːvən
papirus	papiːrus
merveilously	mɛrvɛlusliː
whelpen	xʍɛlpən
thymbyll	θiːməl
cromen	krimən
auctorite	au̯tɔriteː
mountayne	muːntinə
waknen	wakənən
ȝellynge	jɔlinɡ
geste	dʒɛstə
isykle	iːsitʃəl
tothe	toːθ
lege	leːdʒə
ȝok	jɔːk
inc	junk
alym	aliːm
sauf	saf
tyraunt	tiːrau̯nt
compassen	kumpasən
dreryhed	dreːriːhɛːd
blome	bloːmə
fume	fiu̯m
tuken	tukən
assailen	asɛi̯lən
ro	roː
haylen	hɛi̯lən
athem	ɑːθəm
were	wɛːrə
toppyng	tɔpinɡ
jubbe	dʒubə
sanguine	sanɡwin
knave	knaːvə
rof	roːf
supposicioun	supɔzisjun
roum	ruːm
miȝen	miːɣən
aungel	au̯ndʒɛl
hatere	haːtɛːrə
fader	fɛːdər
botyng	boːtinɡ
aken	aːkən
graciousnesse	ɡraːsjuːsnɛs
foteball	foːtbal
swathlen	swɛdələn
herien	hɛrən
horn	hɔrn
temese	tɛmzə
flayre	flɛi̯r
masedliche	maːzədliː
blasfemye	blasfɛmə
berien	bɛrjən
vitailler	vitɛi̯lər
letuse	lɛtisə
diverse	diːvərs
thickenen	θiknən
wommanles	wumanlɛːs
ple	plɛːt
ampte	ɛmptə
lynx	links
jupe	dʒuːpə
berien	bɛrən
maynouren	mɛi̯nurən
companye	kumpɛi̯niːə
vesselment	vɛsələmɛnt
feþer	fɛðər
intronizen	intrɔːniːzən
erchebischop	ɛrtʃəbiʃəp
heres	hɛris
amad	amɛd
erldom	ɛːrldoːm
age	aːdʒə
wif	wiːf
weyk	wɛi̯k
spile	spil
paper	papɛːr
pak	pakə
masen	maːzən
merveile	mɛrvələ
appel	ɛpəl
gest	ɡist
syngeresse	sinɡərɛsə
tilyen	tilən
creature	krɛːtur
comaundour	kumau̯ndur
blameles	blaːməlɛs
bodeword	boːdwɔːrd
souke	suːkə
velvet	vɛlwɛt
scheld	ʃeːld
outwardes	uːtwardz
rebellioun	rɛbɛljuːn
knotted	iknɔtəd
myscheven	mistʃeːvən
gnat	ɡnɛt
vitaile	vitɛi̯lə
hore	hoːrə
armurer	armurər
pultrie	pultəriːə
merily	miriːliːtʃə
surenes	siu̯rnɛs
usual	iu̯zual
yow	iu̯
extre	ɛkstreː
situacioun	sitiu̯aːsjuːn
ches	tʃɛs
gounde	ɡund
bever	bøːvər
wyspe	wips
batayle	batɛlə
messyas	mɛsiːa
maken	makən
demon	dɛːmɔːn
swelle	swɛl
pautener	pau̯təneːr
agen	aːdʒən
surely	siu̯rliː
wowe	wɔu̯ə
chalenge	tʃalandʒə
animal	animal
stafflike	stafliːkə
knobbe	knɔbə
parde	pardeː
delf	dɛlv
swart	swart
conjuren	kundʒiu̯rən
rewe	riu̯
harneysen	harnəsən
stony	stɔːniː
potable	pɔːtaːbəl
brinke	brinkə
bordure	bɔrdərə
dyamaunt	diːamand
dasshyng	daʃinɡ
as	aːs
skynnen	skinən
þe	ðeː
eiȝtthe	ɛi̯xθə
kex	kɛks
ewrous	iu̯ruːs
murrey	murɛi̯
nynthe	neːənθə
usual	iu̯zuəl
samoun	samuːn
þes	ðeːzə
schamel	ʃaːməl
rue	riu̯ə
brotherles	broːðərlɛs
ruyne	riu̯iːnə
tredynge	trɛːdinɡ
clawynge	klau̯inɡ
see	seː
we	wɛː
clot	klɔt
kne	kneː
gerle	ɡiːrlə
shirreve	ʃirifə
sparwe	sparuːə
sotilnes	sɔtəlnɛs
pleyer	plɛi̯ər
toiling	tɔi̯linɡ
hospiteler	hɔspitəleːr
inwardes	inwardəs
name	naːmə
selden	sɛldəm
feynen	fɛi̯nən
chesteyne	tʃɛstən
child	tʃiːld
rother	rɛðər
ridership	riːdərʃipə
schade	ʃaːdə
wicche	witʃə
honyed	ihuniːid
violent	viːəlɛnt
skew	skiu̯
hasard	hazərd
lycorys	likuriːs
skyren	skiːrən
gon	ɡɔːn
wombe	waːmb
fonned	funid
wawynge	wau̯inɡ
winberie	wiːnbɛriːə
faucoun	fau̯kuːn
neve	nɛːvə
bisyde	bisiːdə
exposicioun	ɛkspɔːzisjuːn
climben	kliːmbən
accounten	akuːntən
monday	moːndɛi
berne	beːrn
raunsoun	ransum
merveilously	mɛrvɛi̯luːsliː
see	sɛː
northfolk	nɔrθfɔlk
erldom	ɛrldam
maynouren	maniu̯rən
coker	kɔkər
hater	hatərə
reiser	rɛi̯zər
narwenesse	narwənɛs
jhesus	dʒeːzuːs
seren	sɛːrən
humanyte	iu̯maniteː
bridegome	briːdɡoːmə
clowe	klɔːv
gele	dʒɛːleː
wawe	waɣ
adam	adaːm
gestyng	ɡɛstinɡ
germanie	dʒɛrməniːə
trip	tripə
thedisch	θøːdiʃ
estward	ɛːstward
robous	rubus
nought	nɔu̯xt
cook	koːk
agheful	au̯əful
crabbed	krabid
universe	iu̯nivɛrs
berne	bøːrn
eyed	iːɛd
ladder	lɛːdər
hevysum	hɛːviːsum
previsioun	prɛːvizjun
smythen	smiðən
ani	aniː
storie	stɔːriːə
eunuk	ɛːniu̯k
sorcerere	sɔrsərər
perilous	pariluːs
encens	ənsɛns
accidently	aksidɛntliː
groyn	ɡriːn
facioun	fasjuːn
shave	ʃaːvə
governour	ɡuvɛrnuːr
hos	hɔːs
vapour	vaːpuːr
normand	nɔrmau̯nt
queynte	kwɔi̯ntə
veel	vɛːl
schiren	ʃiːrən
baroun	baroːn
cloven	əklɔːvə
ram	ram
kneder	knɛːdərə
tape	tapə
bedfelawe	bɛdfɛlau̯ə
collegian	kɔlɛːdʒian
bowen	buːwən
chyrnen	tʃirnən
jalousie	dʒɛlusiːə
fader	faðər
stif	stif
flicche	flitʃə
hauke	havək
morwe	mɔrɔu̯ə
cronk	krɔnk
quyksande	kwikəsaːnd
cloth	klɑːθ
ende	ɛndə
sege	seːdʒə
flon	flɔːn
stone	stɑːn
kex	kiks
delare	dɛːlərə
tenour	tɛnuːr
ro	rɔː
glasy	ɡlaːsiː
bas	bas
aserchen	asɛrtʃən
merily	miriːliː
axiltre	aksəltrøː
coronacion	kɔrunaːsiuːn
science	siɛnsə
venu	vɛniu̯ə
soryly	sɔːriliː
burynes	birinɛs
ars	ɛrs
hor	hɔːr
morter	mɔːrtɛr
clymbyng	klimbinɡ
timen	tiːmən
sovereyn	suvərin
anteme	antɛmə
hostelrye	hɔstɛːləriːə
lude	luːdə
awen	au̯ən
oten	ɔːtən
future	fiu̯tir
freen	frøːwən
wheten	ʍɛːtən
grasen	ɡraːzən
ewe	jiu̯ə
aumbre	au̯mbər
umbefolden	ymbefɔːlden
synamome	sinəmum
biyete	bijɛːtə
abay	əbɛi̯
absolucioun	absɔliu̯siuːn
cloystrer	klɔi̯stərər
morwenyng	mɔːrwəninɡ
se	sɛː
answeryng	andswɛːrinɡ
cleyere	klɛi̯ərə
grot	ɡrɔːt
rys	riːs
hakker	hakərə
eccho	ɛkɔː
viciously	visjusliː
strengthen	strɛnkθən
knappe	knapə
couchant	kuːtʃant
stenen	stɛːnən
thenoun	tɛnun
garsavese	ɡɛrsavɛzə
floury	fluːriː
capitain	kapətɛi̯nə
cosynage	kuzinaːdʒə
sliding	sliːdinɡ
hyen	hiːən
foun	fau̯n
avoy	əvui̯
þin	tiːn
syse	siːzə
salade	saladə
felt	fɛlt
aliegiaunce	aliːdʒəansə
chaundeler	tʃandəleːr
marchal	marʃal
straunge	strɔndʒə
threschwolde	θrɛʃwɔːld
muse	miu̯zə
ȝok	jɔk
laurer	lɔrər
almerie	au̯məriːə
toilous	tui̯luːs
drerynesse	dreːriːnɛs
pibel	pɛbəl
charlewayn	tʃarləwɛːn
naperon	aːpərɔn
waden	waːdən
stile	stiːlə
þou	ðuː
ewrous	iu̯rus
shriden	ʃrudən
swathen	swaðən
cruel	kriu̯əl
pikyng	pikinɡ
brace	braːsə
line	liːnə
darten	dartən
moneyour	munɛi̯ur
ryder	riːdərə
savenes	sau̯fnɛs
sercher	sɛrtʃər
frosty	frɔstiː
fleumatik	flɛːmatiːk
þin	θiːn
whynen	ʍiːnən
tempten	tɛmptən
ymne	imən
gramery	ɡraməriːə
sax	saks
hakken	haːkən
wlak	lak
swevenyng	swɛvəninɡ
laughen	lixən
coynen	kui̯nən
angwischous	anɡwiʃus
jupartie	dʒupərtiːə
egre	ɛːɡər
glasy	ɡlasiː
weyven	waːvən
ymagynynge	imadʒininɡ
spynnyng	spininɡ
huru	huːru
flawme	flaːmə
gummen	ɡumən
lesarde	lɛːzard
mynter	mintərə
asseth	seːθ
visioun	vizjun
frend	freːnd
knytten	knutən
swevenen	swɛːvənən
fnesen	fnøːzən
flowndre	fluːndrə
gloriously	ɡlɔːriuːsliːtʃə
pakkyng	pakinɡ
felawely	fɛlau̯liː
larspel	laːrspɛl
brigge	brudʒ
ache	atʃə
glowen	ɡlɔu̯ən
duracioun	diu̯raːsiuːn
daunten	dantən
abhomynable	abɔminaːbəl
elleven	ɛlɛvən
murrey	mureː
four	føːwər
word	wurd
godfader	ɡɔdfaːdər
goodlich	ɡoːdlitʃ
oten	ɑːtən
egerly	ɛːɡərliː
crymynatour	kriːminaːtuːr
erd	ɛrd
enchaunten	ɛntʃantən
proposicioun	prɔːpɔzisjun
doucet	duːsit
chewen	tʃiu̯ən
gandre	ɡɔːndər
chafur	tʃaːvər
sand	sand
hery	heːriː
heronsewe	hɛːrunsɛu̯
digit	didʒit
wicche	weːtʃə
schide	ʃiːd
sathan	satɔn
pipe	piːpə
childberyng	tʃiːldbɛːrinɡ
crane	kraːn
cristen	kristɛn
sorel	surəl
eie	ɛi̯ə
path	paːθ
berme	barmə
clift	klift
merveilous	mɛrvələs
panter	pantɛːrə
instrument	instrumɛnt
ympen	impən
cokkou	kukuː
governour	ɡuvɛrnər
sermoun	sɛrmun
foted	ifoːtid
dovehouse	duːfuːs
pullayle	pulil
cheynen	tʃɛi̯nən
shryven	ʃriːvən
skynnery	skinəriː
popedome	pɔːpdoːm
berien	bɛriən
cleyed	klɛi̯ɛd
booke	boːk
coaccion	kɔːaksjun
patroun	paːtrunə
yoman	jɔːman
schyrly	ʃiːrliː
ferthe	fɔu̯rθə
box	bɔks
bataillyng	batɛi̯linɡ
horesone	hoːrəsənə
þurs	θurs
daschen	dɛi̯ʃən
appeltre	apəltriu̯
abstraccyone	abstraksjuːn
auctorite	au̯ktɔriteː
gutte	ɡut
fey	vɛi̯ə
payen	pɛi̯ən
secunde	sɛːkundə
muske	musk
bethleem	bɛdlɛm
haterynge	haːtərinɡ
fodder	foːdər
whey	wɛi̯
wel	wɛːl
sporen	spoːrən
dette	dɛtə
climben	klimbən
yrchoun	hirtʃun
mydge	midʒ
wraw	wrau̯x
dosk	dɛsk
onfrend	unfrɛnd
gunstone	ɡunstɔːn
tyraunt	tiːrant
byword	biːwurd
strecchen	strɛtʃən
breiden	breːdən
poudre	puːðər
mouth	muːθ
flewme	flɛu̯mə
whelebarow	ʍɛːlbarɔu̯ə
oonly	ɔːnliː
commenden	kumɛndən
thorny	θɔrniː
vendage	vɛndaːdʒə
chauntynge	tʃantinɡ
orfray	ɔrfriː
nakedhed	naːkidhɛːd
flesh	flɛːʃ
bakke	bakə
vapouren	vaːpuːrən
rother	riðər
aschewednysday	aʃwɛdnəzdɛi
massy	masiː
gerle	ɡɛːrlə
norisshement	nuriʃmɛnt
rewme	rɛːalmə
steppen	stapən
shirreve	ʃɛrifə
quaylen	kwɛi̯lən
fiole	fiːɔlə
slegge	slɛdʒ
cristened	kriːstənəd
delitable	deːliːtaːbəl
waknen	waːkənən
violent	viəlɛnt
synamome	sinəmɔːm
snoren	snɔːrən
fomy	fɔːmiː
douceoure	duːzər
glewy	ɡliu̯iː
lavendrye	lavəndriːə
sanguisuge	sanɡwisiu̯dʒə
bref	breːf
cleyye	klɛi̯iː
dyaper	diːapər
pyke	piːk
alienen	aːliənən
fumyter	fumitɛːrə
winge	winɡə
houselen	huzələn
clyf	kliv
onfrend	unfreːnd
alienyng	aːliəninɡ
tuo	twoː
middelerd	midəlard
fiole	viːɔlə
slykstone	sliːkstɔːn
kirnelly	kɛrnəliː
yow	jiu̯
chaunterie	tʃantəriːə
pennen	pɛnən
fou	fɔu̯
ymageour	imaːdʒuːr
werreyen	wɛriən
toyle	tui̯lə
tharm	θarm
lavatorie	lavatɔːriːə
ynkhorn	inkhɔrn
morwe	mɔriu̯ə
assailen	sɛi̯lən
pawe	pau̯ə
thorn	θrɔn
rosten	rɔːstən
þestri	θɛstriː
steppe	stapə
mynte	mɛntə
coler	kɔləra
myrthen	mɛrθən
galder	ɡaːldər
capitainerie	kaːpətɛi̯nəriːə
pigge	piɡə
buryinge	bɛriinɡ
barm	bɛrm
venemously	vɛniməsliːtʃə
lamb	lɔmb
red	rɛːd
crymynous	kriːminuːs
mastik	mastik
mersh	mɛrʃ
nayl	nɛi̯l
bale	baːl
enchauntynge	ɛntʃantinɡ
odour	ɔːdur
vapour	vaːpur
bast	baːst
fo	fɔː
samoun	sau̯muːn
knotty	knɔtiː
chirche	kirkə
fonned	fɔnid
recoveraunce	rɛkuvəransə
shriden	ʃriːdən
venisoun	vɛnizuːn
umbedelven	umbedelven
cley	klɛi̯
vambrace	vau̯mbraːsə
moderhede	moːdərhoːd
southerne	suːðərnə
trompour	trumpur
pibel	pibəl
kingdom	kiŋɡdɔm
brest	breːst
sugre	siu̯ɡrə
cosyn	koːzin
bladdren	bladərən
cleve	kleːvə
brayny	brɛi̯niː
tusk	tusk
ferthe	fɛːrθə
disparagen	disparadʒə
commendable	kumɛndaːbəl
woclic	wɔːkliːk
raunsonen	ransumən
bourden	buːrdən
setten	sɛtən
letheryd	lɛdərid
muske	muskɔ
orfray	ɔrfrɛi̯
sonne	sunə
clingen	klinɡən
voys	vui̯s
chef	tʃeːf
worden	wurdən
reif	rɛːf
fredom	freːdoːm
fenel	fɛnəl
nauger	nau̯ɡər
norischen	nurisən
mages	maːdʒis
umbegon	ymbeɡɔːn
graciously	ɡraːsjuːsliː
maner	manər
appeltre	apəltreː
larke	lavərtʃə
sevenyght	sɛvənixt
lawier	lau̯ər
fourtene	fɔu̯rteːnə
gloriously	ɡlɔːriuːsliː
sanguine	sanɡiːn
ram	raːm
potage	pɔtaːdʒə
pathyng	paːθinɡ
patent	patɛnt
hasardour	hazardərə
atberen	ɑtbɛren
umbeclosen	imbəklɔːzən
gingivere	dʒindʒivərə
unserchable	unsɛːrtʃaːbəl
roster	rɔːstərə
hostiler	hɔstələr
office	ɔfiːsə
norserye	nurəsəriːə
norturen	nurəturən
beeste	bɛːstə
sotilnes	sɔtilnɛs
rebellen	rɛbɛlən
tablement	taːbəlmɛnt
sevenþe	sɛːvənθə
wolle	wul
tombe	tuːmbə
moistinge	mɔi̯stinɡ
storier	stɔriːər
crownynge	kuruninɡ
sodeynte	sudɛi̯nteː
swathel	swɛðəl
sorow	sɔrwə
wyndronken	wiːndrunkən
swete	swɔːt
baleful	baːlful
deis	dɛs
mile	mil
beken	beːkən
gyserne	ɡizɛrn
garfysche	ɡarfiʃ
brest	brøːst
taphose	tapəhɔːzə
forsweren	fɔrswɛːrən
sermonen	sɛrmunən
sweten	swɛːtən
boterflye	butərflɛi̯ə
norischer	nuriʃərə
yow	juː
wight	ʍixt
blede	bleːd
baston	bastun
myrthe	mɛrθ
cle	klɛː
vertulees	vɛrtiu̯lɛːs
gracious	ɡraːsjuːs
lawday	lau̯ədɛi̯
surgerie	surdʒiːə
creature	kraːtiu̯r
gain	ɡeːn
peper	pipər
sorre	sɔreː
rotyngnesse	rɔːtinɡnɛs
hene	hɛːn
finden	fiːndən
mounture	muːntiu̯rə
houndestonge	huːndəstunɡ
sored	sɔːrd
laweliche	lau̯əliːtʃə
reme	rɛːmə
cristiente	kristianiteː
venemously	vɛnəmusliː
governement	ɡuvɛrnəmɛnt
beverage	bɛvərɛdʒə
endelesly	ɛndəlɛsliː
vesselling	vɛsəlinɡ
styngyng	stinɡinɡ
bathyng	baːðinɡ
table	taːbəl
thenoun	tɛnuːn
whelwryght	ʍeːlwrixt
fumerelle	fiu̯mərələ
aungel	ɛːndʒəl
luxurious	luksjuːriuːs
stere	støːr
beche	beːtʃə
delvyng	dɛlvinɡ
tyrauntrie	tiːrau̯ntəriːə
don	doːn
sauge	sau̯dʒə
partrich	paːrtritʃ
lax	lɛks
kembynge	kɛmbinɡ
translaten	tranlaːtən
heed	hɛvəd
chalengyng	tʃalandʒinɡ
cod	kɔdə
panterere	pantəlɛːrə
myschevous	mɛstʃeːvuːs
manered	manərid
gracious	ɡraːsius
swon	swɔːn
eterne	ɛtɛrnə
hethenli	hɛːðənliːtʃə
bayten	bɛi̯tən
nyghten	nixtən
radiche	radikə
larke	larkə
burde	byːrdə
maner	manɛːr
writhyng	wriːðinɡ
hawthorn	hau̯əθrɔn
comaunde	kumandə
cop	kɔp
disposicioun	dispɔːzisjuːn
pestel	pɛstɛl
schyftynge	ʃiftinɡ
fecche	fɛtʃə
antelope	antəlɔːp
conjurer	kundʒərərə
latoun	latun
recommenden	rɛkumɛndən
erle	ɛrəl
felawrede	fɛlɔu̯rɛːdə
deef	dɛːf
towayle	təwɛi̯lə
cappynge	kapinɡ
moten	moːtən
drerily	dreːriːliː
ferthing	fœrðinɡ
angrily	anɡriːliː
clyngyng	klinɡinɡ
laweles	lau̯əlɛːs
four	fɔur
frute	friu̯t
concubine	kɔnkiu̯biːnə
charmen	tʃarmən
mund	mund
wop	woːp
viciousnesse	visjuːsnɛs
duely	diu̯əliːtʃə
diademe	diːadɛmə
dragoun	draɡuːn
clompe	klumpə
goke	ɡoːk
sithen	siθən
wednesday	wɛdnizdɛi̯
horlynge	hoːrəlinɡ
mace	maːsə
gamen	ɡɔːmənən
wermode	wɛrmoːd
mirien	miriːən
glorious	ɡlɔːriuːs
bord	bɔrd
bukke	bukə
sausfleme	sau̯səflɛːmə
blader	blaːdər
damasyn	daməzinə
burde	biːrdə
lond	lɔnd
growte	ɡruːt
barowe	barɛu̯ə
osel	oːzəl
almond	almand
pykeharneys	pikəharnɛi̯s
frangible	frand͡ʒiːblə
couple	kuːpəl
fagot	fakət
brewe	breː
vynet	viːnɛt
rostyng	rɔːstinɡ
folliche	foːlitʃə
werrour	warər
honysokel	huniːsukəl
matrone	maːtroːnə
mirre	mirə
thornbak	θɔrnbak
conjuren	kundʒurən
sider	siːdər
pane	panə
hires	hirz
cherne	tʃirn
goundi	ɡundiː
tayled	tɛi̯lɛd
robber	rɔbər
sethen	seːðən
alienen	aːliɛːnən
creature	krɛːatuːr
thevysch	θeːfiʃ
weyk	wɛːk
rebellen	rɛːbɛlən
phebus	fɛːbus
lyard	liːart
poudren	puːdərən
brere	brɛːr
rode	rɔːd
sot	sɔt
tronchoun	tʃrunsun
delitabilite	deːliːtabəliteː
groyn	ɡriu̯n
lous	luːs
glouworm	ɡlɔu̯wurm
hempen	hɛmpən
champioun	tʃau̯mpiuːn
pocioun	pɔːsjuːn
turmeryte	tɛrməritə
moneyen	munɛi̯ən
elat	ɛːlaːt
parisshen	parisiən
cosynage	koːzinaːdʒə
sor	sɔr
real	rɛːal
ne	nə
gredyly	ɡreːdiliːkə
supplien	supliːən
bordis	burdiːs
bapteme	baptiːmə
vertual	virtiu̯al
tartelet	tartələt
wort	wirt
weke	woːkə
stie	stiːə
gredyly	ɡreːdiːliː
gronyng	ɡrɑːninɡ
lewedly	lɛu̯idliː
differently	difɛrɛntliː
hevy	hɛːviː
licour	likur
trouthe	trɔu̯θ
hostel	hɔstəl
doke	duːkə
kne	knøː
outwardly	uːtwaːrdliː
spinach	spinartʃə
asshe	ɛʃ
gain	jeːn
abreggen	abridʒən
bak	bak
citrine	sitəriːnə
gesten	dʒɛːstən
cheveteyn	tʃeːftɛi̯nə
allien	aliːən
comaunden	kumau̯ndən
versifiour	vɛrsifiːər
gorst	ɡɔrst
ache	ɛːtʃə
swathel	swɛdəl
vertu	virtiu̯
merines	mɛriːnɛs
abominacioun	abɔminaːsjuːn
staffull	stafful
sorel	sɔrəl
creat	krɛːaːt
horen	hɔːriən
kilne	kulnə
brotherhede	broːðərrɛːdə
flowndre	flundər
eiliche	ejəliːtʃ
faderles	fɛːdərlɛːs
his	iz
composicioun	kɔmpɔzisjun
jussel	dʒuʃɛl
hound	hund
blasfemye	blasfɛːmiːə
rind	rind
vitaile	vitələ
flod	floːd
paunche	pau̯ntʃə
yest	jɛst
muske	muskə
boteles	boːtlɛːs
rother	roːðər
brother	broːðər
letheryd	lɛːðərid
resistyng	rɛsistinɡ
childing	tʃiːldinɡ
mansioun	mansjun
selde	sɛld
cirurgie	sirurdʒiːə
burynes	bɛrinɛs
seven	sœvən
gore	ɡɔːrə
brigge	bridʒ
sotilen	sutilən
endyng	ɛːndinɡ
doke	doːkə
pilwe	pilwə
caboche	kabidʒə
enquest	inkwɛstə
fumen	fiu̯mən
mynystren	ministrən
reredos	rɛːrədɔs
warm	wɛrm
foreyner	fɔrinərə
hevyliche	hɛːviːliː
yvory	iːvər
monstre	mɔnstrə
spynner	spinər
poudre	puːdrə
drerily	dreːriːliːtʃə
mynte	mintə
creper	kreːpərə
cat	kat
trouthe	trøːwθ
manrede	manrɛːdə
cloistre	klɔːstər
damasyn	daməzɛːnə
goselyng	ɡoːslinɡ
whele	ʍɛːlə
water	waːtər
lettre	lɛtər
adle	ɔːdəl
eye	ejə
tenour	tɛniu̯r
malencolien	mɛlənkɔːliːɛn
ynke	inkə
bireven	birɛːvən
knyf	kniːf
wit	wit
pestel	pɛstəl
ȝellen	jɔlən
game	ɡɛːmə
louten	luːtjən
se	seː
garne	ɡarn
raggy	raɡiː
hatel	hɛtəl
botonen	butənən
gome	ɡumə
cherne	tʃɛrn
whestone	ʍɛtstɔːn
berien	buriən
columpne	kɔliu̯mnə
overriden	ɔvərriːdən
sorhed	sɔːrhɛd
tappen	tapən
that	ðat
fonned	fɔnd
brayle	brɛi̯l
horshelne	hɔrshɛlnə
conjuren	kundʒərən
snowy	snɑu̯iː
overfeble	ɔːvərfeːbəl
saffron	safruːn
sturgiun	sturdʒuːn
swaþelynge	swɛðəlinɡ
englisch	anɡliʃ
mirour	mirur
avisioun	advizjun
redemen	rɛdeːmən
game	ɡamə
storier	stɔriər
chambre	tʃambrə
schepherde	ʃɛpərdə
asshe	askə
erly	ɛrliː
garlek	ɡaːrlɛk
cloke	kluːtʃə
axen	askən
clothen	klɔːðiən
loresman	lɔːrəzman
barowe	barɔu̯ə
lyf	liːf
morther	mɔrðər
yvory	ɛvɔriːə
hauke	hafk
sleightly	slixtliː
graceles	ɡraːsəlɛs
homly	hɔːmliː
sorely	sɛːrliː
hevynesse	hɛːvinɛs
bour	buːr
werre	war
deciden	dɛːsiːdən
avys	aviːs
evildoer	ivəlduːɚ
prophetesse	prɔfɛtisə
loppe	lɔbə
mire	miːr
song	saːnɡ
sermonynge	sarmuninɡ
hert	hɛːrt
grippen	ɡripən
governaile	ɡuvərnɛi̯l
loude	luːd
pocioun	pɔːsjun
norisshement	nurəʃmɛnt
frightihed	frixtiːhɛːd
muske	muska
distaf	distaf
medle	mɛdlə
contre	kuntrɛi̯
roten	rɔːtə
barntem	barntɛːm
perled	pɛːrlid
vitaillyng	vitəlinɡ
wharf	ʍarf
oures	uːrz
bor	bɑːr
peril	pɛriːl
obligacioun	ɔbliɡaːsjuːn
weyven	wɛi̯vən
toller	tɔlərə
helve	hɛlf
winge	wɛnɡə
daschen	dasən
kernel	kurnəl
werrour	wɛriu̯r
horscomb	hɔrskɔːmb
hachet	hatʃitə
chalenger	tʃalɛndʒərə
endely	ɛndəliːtʃə
deis	dɛi̯əs
mased	maːzəd
jurour	dʒiu̯ruːr
citeseyn	sitɛsɛi̯n
childhode	tʃiːldhoːd
middenerd	midənɛrd
gyser	ɡizɛr
bore	bɔːrə
ymaginable	imaːdʒinaːbəl
ew	iu̯
clodden	klɔdən
cristenen	kriːstənən
obligacioun	ɔbliɡaːsjun
spinach	spinatʃə
squirel	skwɛrələ
newgate	niu̯əɡaːt
hasardour	hazarduːr
stroken	strɑːkə
ȝek	jɛːk
remen	reːmən
ple	plɛː
lawghynge	lɛi̯xinɡ
pome	pɔmə
mowen	mɑu̯ən
knappen	knapən
bere	bɛːrə
capston	kapstɔːn
ostrich	ɔstridʒ
myschevously	mistʃeːvusliː
diademe	diːadɛːmə
afrainen	afrɛi̯nən
tablen	taːbələn
aren	arən
thost	θɔst
heron	hɛi̯ruːn
develrye	deːvələriːə
sodeynly	sudɛnliː
awen	aɣən
ote	ɔːtə
knaven	knaːvən
furmente	frumɛntiː
bynde	bində
firse	fɛrz
historie	istɔi̯rə
wawe	wau̯
ȝelpen	jɛlpən
frenderede	freːndrɛːdə
viniter	vintər
manerly	manərliː
roten	roːtən
fecche	fitʃə
sporier	spoːriərə
nicholas	nikɔlas
verdit	vɛrdikt
oystre	ɔstər
kitoun	kituːn
baundon	bau̯nduːn
savage	savau̯dʒə
spore	spurə
delen	dɛːlən
alienen	aːliɛnən
sevenefold	sɛvənfɑːld
clyf	kleːf
sotil	sutil
nacioun	natsjun
gras	ɡrɛs
parable	paraːbəl
moneyour	munɛi̯ər
lopster	lɔbəstər
glewer	ɡliu̯ər
auntelere	au̯ntəlɛːr
panel	panɛːl
londen	landən
ymageour	imaːdʒər
fumygacioun	fiu̯miɡaːsjuːn
comaundour	kumau̯ndər
cheste	kist
bath	baθ
hungrylych	hunɡriːliː
envenymous	ɛnvɛnəmus
samoun	samən
mode	mɔːdə
goundi	ɡuːndiː
herien	hɛrjən
homwardes	hɔːmwardəs
bagpipe	baɡəpiːpə
stifly	stifliː
gameful	ɡaːmful
cley	klɛi̯ə
buccaneer	bʌkənɪəɹ
vert	vɛrt
saucerie	sau̯səriːə
wefte	wɛft
malencolik	mɛlɛnkɔlik
coronement	kuruːnəmɛnt
nynthe	niːnəθə
angry	anɡriː
journe	dʒurneː
kilne	kilə
lewedly	lɛu̯idliːtʃə
noumpere	uːmpeːr
groynen	ɡruːnən
storien	stɔriən
cloistre	klɔi̯stər
pulet	pulət
neighebor	nɛixəbur
yorkshire	jɔrkʃiːr
wrenne	wranə
storie	stɔriːə
secundarili	sɛkundaːriliːtʃə
wayn	wɛi̯n
clod	klɔd
smythy	smiðiːə
gardener	ɡardənərə
enserchen	ɛnsɛːrtʃən
abbey	abɛi̯ə
seneschal	sɛnitʃal
gamely	ɡaːmənliː
sutour	sui̯tuːr
webster	wɛbəstər
sleighty	slixtiː
bataillous	batəluːs
strawbery	strau̯bɛriːə
wordy	wɔrdiː
achab	aːkab
arghly	arxliː
groyn	ɡruːɳə
mode	moːd
rose	rɔzə
halm	halm
biflowen	biflɔu̯ən
recoveryng	rɛkɔvərinɡ
viniter	vintɛːr
neptunus	nɛptiu̯nus
jupon	dʒiu̯poːn
myscheven	mɛstʃeːvən
crowde	kruːð
jorneyen	dʒurnɛi̯ən
matrone	maːtrunə
saumple	sampəl
hacche	hak
royalte	rɔi̯alteː
mynute	minitə
garsavese	ɡrasavɛzə
ymne	imnə
schoven	ʃeːvən
traunce	trau̯nsə
paunce	pau̯nsə
jorneman	dʒurnɛi̯man
spinnen	spinən
gras	ɡraːs
he	heː
popy	papiː
laughter	lau̯xtər
sovereyn	suvərɛi̯n
glasyng	ɡlaːzinɡ
unk	unk
provisioun	prɔːvizjun
lavender	lavəndər
claret	klarɛt
reredos	rɛːrədɔːs
absolucioun	absɔliu̯sjun
raunsoner	rau̯nsumərə
sone	soːnə
malencolious	malɛnkɔːliuːs
cok	kɔk
hemp	hɛnəp
chalengeable	tʃalandʒaːbəl
desirous	dɛziːrus
folehardy	foːlhardiː
emeraude	ɛmərau̯nt
arghly	arɛu̯liːtʃə
mid	mid
pegge	pɛɡə
fantom	fantəm
agreable	aɡreːaːbəl
cubite	kiu̯bitə
barge	baːrdʒə
norture	nurturə
jalousie	dʒɛləsiːə
schadowe	ʃadəwə
mages	maːdʒiː
pykeharneys	pikəharnəs
deluden	dɛːliu̯dən
eiȝtetene	au̯xteːnə
herne	heːrnə
seven	sɛːvən
forneys	furnis
peper	pɛpər
swathlen	swaːðələn
mounde	muːndə
grene	ɡreːnə
sadelen	saːdəliən
ynche	ɛntʃə
pichfork	pitʃə̩fɔrkə
material	matɛriɛːl
hord	hɔːrd
dovehouse	duːvəhuːs
arow	arwə
hen	hɛn
translaten	tranzlaːtən
bor	bɔːr
couchen	tʃuːtʃən
hostellen	hɔstɛːlən
mete	mɛt
balfulli	balfuliː
fantom	fantɛːm
panter	panətər
schit	ʃiːtə
wrist	wirst
vergeous	vɛrdʒiu̯s
answeren	andswɛːrən
heeth	hɛːθ
stacioun	staːsiuːn
spurnen	spurnən
tyrauntly	tirau̯ntliː
weke	wukə
fous	fuːs
mewen	miu̯ən
werrour	wɛruːr
alien	aːliɛːn
anfald	ɔːnfɔːld
slepen	slɛːpən
godfader	ɡɔdfadər
sovereyn	sɔvərɛi̯n
erchebischop	artʃəbiʃəp
haterel	hatərəl
geaunt	dʒɛːant
horsbak	hɔrsbak
cuppeborde	kupəbɔːrd
zele	zɛːlə
empire	ɛmpiːrə
poisoun	puizən
bouk	buːk
oblacioun	ɔblaːsjuːn
hostel	hɔstɛːl
storial	stɔrial
cristendom	kristɛndoːm
sercher	sɛrtʃuːr
pask	paskə
accidie	aksiːdiː
cristemasse	kristəmɛsə
webbe	wɛb
febly	feːbəliː
erchebyschopryke	ɛrtʃəbiʃəpriːkə
cokkou	kɔkuː
secte	sɛktə
camper	kampər
bace	bars
sarsen	sarsən
suren	sɛu̯rən
feble	feːbəl
homward	hɔːmwaːrd
blasen	blaːzən
patronage	patroːnadʒə
goky	ɡoːkiː
dremer	drɛːmərə
gurnard	ɡurnard
remen	riːmən
hatrede	haːtərɛdə
adamant	adəmant
capoun	kaːpun
flien	fleːn
vyny	viːniː
tred	trɛːdə
wynchester	wintʃɛstər
capitainship	kapətɛi̯nəʃipə
dotacion	dɔːtaːsjuːn
breydynge	breːdinɡ
mody	moːdiː
jussel	dʒusɛl
vertually	virtiu̯aliː
burde	beːrdə
glorifien	ɡlɔːrifiːən
captif	kaptif
nape	naːpə
larew	lɑːrøːw
fomen	fɔːmən
aproven	apruːvən
croken	kroːkən
tresoun	trɛːzun
abord	abɔːrd
lawghynge	laxinɡ
chafur	tʃafər
reveling	rɛvɛːlinɡ
regioun	rɛːdʒən
wynne	wɛnə
skyrte	skirtə
seen	seːn
yvory	iːvɔriːə
ȝiven	jivən
absolucioun	absɔliu̯siun
sorcery	sɔrsəriːə
wode	woːdə
naperon	naːpəruːn
columpne	kɔliu̯m
broth	brɔθ
flowndre	fluːndər
nayled	nɛi̯lid
braynen	brɛi̯nən
alonnesse	alɔːnɛs
savement	sau̯vimɛnt
mynystren	ministərən
magnes	maɡnɛːs
supernatural	siu̯pərnaːtiu̯rɛl
maner	manɛːrə
herber	ɛrbər
chauntour	tʃantuːr
fumyter	fimtɛːrə
vergeous	vɛrdʒus
floten	flɔtən
ladde	ladə
lessoun	lɛsoːn
bildyng	biːldinɡ
anys	anɛːs
chayer	tʃɛi̯ərə
musket	muskit
poteller	pɔtələrə
swarten	swartən
brevely	breːfliː
sorinesse	sɔːrinɛs
sire	siːrə
nakidly	naːkidliːtʃə
crude	kriu̯də
brid	brid
ymne	im
beriel	bɛriəl
woclic	wɑːkliːk
pounen	puːnən
lilie	leːliːə
we	weː
dust	dust
scherd	ʃɛrd
byword	biːwɔrd
roialme	rɔi̯am
raysyn	rɛːziːn
worm	wirm
til	til
patronage	patroːnaːdʒə
crownynge	kuruːninɡ
wel	weːl
frenged	frɛndʒid
piker	piːkərə
horden	hɔːrdən
sleightly	slɛi̯xtliː
þestren	θɛstrən
clepen	klɛːpən
thinne	θinə
holt	hɔlt
hasardrie	hazərdəriːə
ram	rɔm
bladyn	blaːdən
secunde	sɛkundə
foun	fuːn
knedynge	knɛːdinɡ
mayn	mɛi̯n
viniter	vinitɛːr
tilyen	tiljən
serge	sirdʒə
fawn	fau̯n
fleten	fleːtən
translatour	translaːtur
bridlen	briːdələn
fewell	fiu̯ɛːl
snowte	snuːtə
ȝerde	jɛːrd
raunsoner	ransunərə
proposicioun	prɔːpɔzisjuːn
mousepese	muːspɛːzə
gris	ɡris
brewere	briu̯ərə
dyamaunt	diːamɔnd
stroke	strɔːk
hoggeshed	hɔɡishɛːd
slykstone	slikstɔːn
answeren	andswaːrən
redempcioun	rɛdɛmpsjuːn
norischen	nuriʃən
savegard	saːfəɡardə
flowyng	flɔu̯inɡ
nyghtgale	nixtəɡaːlə
crabbidly	krabədliː
randoun	randuːn
hungrylych	hunɡriːliːtʃə
garlek	ɡarlək
wawy	wau̯iː
sweten	sweːtən
mynisterie	minəstəriːə
capitainerie	kapətinəriːə
lude	liu̯də
asshe	aksə
violet	viːɔlɛt
frount	frunt
alliaunce	aliːansə
palate	palət
prest	prɛst
square	skwaːrə
narwe	nariu̯
blast	blɛːst
stomak	stɔmək
merveilous	mɛrvɛlus
delitably	dɛliːtaːbliː
hatel	hatəl
hore	hɔːrɔu̯ə
honyly	huniːliː
patronesse	paːtrɔnɛsə
hordere	hɔːrdərə
brymston	brinstɔːn
officer	ɔfisɛːr
decre	dɛːkreː
revel	rɛvəl
gracelessly	ɡraːsəlɛsliː
fumous	fiu̯muːs
rote	rɔːt
raunsoner	ransumərə
þurs	θirs
sotilly	sɔtəliː
cunte	kuntə
houselynge	huzəlinɡ
ymagerie	imaːdʒəriːə
hospiteler	hɔspitaleːr
rancour	rankər
housyng	huːzinɡ
mincen	mintʃən
almond	almau̯nd
all	al
terebentyne	tɛrəbintiːnə
gain	ɡɛi̯n
jus	dʒiu̯s
cruelte	kriu̯əlteː
reve	reːvə
future	fiu̯tiu̯r
disch	diʃ
cifre	sifər
venymynge	vɛniminɡ
batailloure	batələr
maundement	mandimɛnt
tradicioun	tradisjun
bragot	braɡət
stench	stɛntʃ
ani	ɛːniː
ymagen	imaːdʒən
armurie	armɔrɛː
song	sanɡ
asure	aziu̯r
translacioun	translaːsjun
whestone	ʍɛstɔːn
parisshe	pariʃə
pereles	peːrlɛs
item	iːtɛm
revelen	rɛvələn
secundarili	sɛkundaːriliː
myghty	mixtiː
alien	aːliau̯nt
thre	θriː
abominacioun	abɔminaːsjoːn
rome	roːmə
egment	ɛɡmɛnt
undedlynesse	undɛːdliːnɛs
magicien	madʒisjɛn
asure	aːziu̯r
almond	almɔu̯nd
crevis	krɛvisə
flawme	flau̯mə
oken	ɛːkən
schelfe	ʃɛlfə
legge	lɛdʒə
away	awɛi̯
cornet	kɔrnit
berwen	bœrɣən
clappynge	klapinɡ
trone	troːnə
allone	alɔːn
fraudulent	frau̯dilɛnt
derknesse	dɛrknɛs
pan	pan
rose	rɔːzə
atbreken	ɑtbrɛːken
jelouste	dʒɛluːsteː
rebelte	rɛbɛlteː
segen	seːdʒən
boterflye	butərfliːə
companye	kumpaniːə
hevyliche	hɛːviːliːtʃʃə
galyngale	ɡalinɡaːl
trome	troːmə
warenne	warɛi̯nə
þester	θeːstər
byword	biːwɔːrd
latyn	latin
dokeling	doːklinɡ
cryminal	kriːminaːl
tyraunt	tirau̯nt
sithen	siːn
original	ɔriɡinal
cyve	siːvə
ensercher	ənsɛːrtʃər
myst	mist
popehode	pɔːpəhɛːd
questen	kwɛstən
ameven	ameːvən
horsmynte	hɔrsmintə
sky	skiː
sanguine	sanɡin
ani	ɑːniː
tenche	tɛntʃə
morwe	mɔrən
recommendacion	rɛkumɛndaːsjun
norserye	nurisəriːə
versifien	vɛrsifiːən
swathel	swaːdəl
gredyly	ɡreːdəliːtʃə
hauke	hau̯k
collegial	kɔlɛːdʒiaːl
nombre	numbər
diverse	divərs
aspe	ɛspə
bothe	boːθ
angwissh	anɡui̯ʃə
violence	viːəlɛnsə
clething	klɛːðinɡ
flouren	fluːrən
lessoun	lɛsuːn
swathen	swɛːðən
delynge	dɛːlinɡ
material	matɛːriɛl
strengthen	strɛnθən
hevy	hɛviː
greyn	ɡrɛi̯n
toilen	tui̯lən
knappe	knap
faderhode	fadərhɛːd
magnete	maɡnɛtə
bee	beː
po	pɑː
crabbednes	krabɛdnɛs
proposicioun	prɔpɔzisjuːn
apocalips	apɔkalipsə
susterhede	sistərhɛːd
noumbringe	nuːmərinɡ
tord	tɔrd
glorie	ɡlɔːriːə
myrthe	mirθ
gauge	ɡaːdʒə
horen	hɔːrən
parchemyn	partʃimɛnt
raunsonynge	ransuminɡ
brotherly	broːðərliː
lygger	lidʒərə
inc	unk
pleyen	plɛi̯ən
robous	rubis
livid	lividə
clymbyng	kliːmbinɡ
meteles	mɛːtəlɛːs
matere	matɛːrə
vertual	vɛrtiu̯aːl
hacche	hɛk
translacioun	translaːsjuːn
feeldi	feːldiː
blosme	blɔsəm
skynner	skinərə
trewe	triu̯ə
berkere	bɛrkərə
mountant	muntau̯nt
gressehopper	ɡrɛshɔpər
sauf	sau̯f
ounce	unsə
womman	wuman
supernatural	siu̯pərnatiu̯rɛl
tyrauntrie	tirau̯nəriːə
frenge	frɛndʒə
and	and
stak	stak
spannen	spanən
dowarye	duːariːə
assay	asɛi̯
scheltroun	ʃiltrunə
forneys	furnai̯s
bible	biːbəl
chauntement	tʃau̯ntəmɛnt
rebellious	rɛbɛlius
eternyte	ɛːtɛrniteː
clokken	klɔkən
sure	suːr
baundon	bau̯ndun
spillen	spilən
childles	tʃiːldlɛːs
moiste	mɔi̯stə
whelen	ʍeːlən
indisposicioun	indispɔːzisjuːn
delvere	dɛlvɛːrə
stench	stuntʃ
slepe	slɛːp
basket	baskət
norice	nɔrisə
glasier	ɡlaːzərə
tyme	tim
morwe	mɔrun
envenimen	invɛnumən
sermonen	sɛrmuniən
compleet	kɔmplɛːt
corn	kɔrn
chyrnyng	tʃirninɡ
sandal	sandal
elven	alvən
homage	ɔmaːdʒə
amen	aːmɛːn
mytre	mitər
fiole	viːɔːlə
commendacioun	kɔmɛndaːsiuːn
tresoun	trɛːzuːn
vendage	vindaːdʒə
ache	ɛtʃə
bekenen	bɛkənən
douve	duːfə
comb	kɔmb
weblome	wɛbloːmə
collegiate	kɔlɛdʒiaːtə
viniterie	vintriː
schyre	ʃiːrə
stif	stiːf
sward	sward
kemben	keːmbən
baston	bastuːn
scherling	ʃɛːrlinɡ
nevew	nɛvɛu̯
clappen	klapən
lore	lɔːrə
herne	hurnə
delvere	dɛlvərə
basket	baskɛt
bilden	byːldən
steppyng	stapinɡ
endowement	ɛnduːəmɛnt
duete	diu̯əteː
brayn	brɛi̯ən
reren	rɛːrən
ax	aks
teme	tɛːm
adversitee	advɛrsiteː
gurnard	ɡurnərd
ketel	tʃɛtəl
corounen	kruːnən
swevenen	swɛvənən
lof	loːf
ovet	ɔːvɛt
wlak	wəlɛtʃ
cleven	klɛːvən
translatour	translaːtər
sausfleme	sau̯səflɛu̯mə
alienacioun	aːliənaːsjuːn
not	nat
aswagen	aswaːdʒən
raunsoun	rau̯nsuːn
sixte	sɛstə
sliken	slikən
tyraunt	tirant
jew	dʒiu̯
buryinge	biriinɡ
papirus	pəpiːrus
balaunce	balantsə
inwit	inwit
selde	seːld
bapteme	baptizmə
gayn	ɡɛi̯n
tollynge	tɔlinɡ
coynour	kui̯nər
tarte	tartə
saumple	sau̯mpəl
vertuous	vɛrtiu̯uːs
pure	piu̯r
dinten	dintən
sone	sunə
nought	naxt
cedre	sɛːdrə
walkirie	walkiriːə
mithen	miːðən
feblenesse	feːbəlnɛs
feture	fɛːturə
symply	simpəliː
biqueste	bikwɛːst
injurious	indʒiu̯rius
clete	klɛːtə
halter	haltər
sevenefold	sɛvənfɔːld
wale	waːlə
kernel	kirnəl
charme	tʃarmə
hosnesse	hɑːsnɛs
tygre	tiːɡər
wynche	wintʃə
lege	lɛu̯ɡə
herted	hɛːrtid
surely	suːrliː
resyn	rɛːziːnə
hom	hɔːm
prophecien	prɔfɛːsiːən
riden	riːdən
cheveteyn	tʃeːftinə
conjuracioun	kundʒiu̯raːsiuːn
garsavese	ɡarsavɛzə
delitably	deːliːtaːbliː
collusioun	kɔliu̯zjuːn
fle	flɛː
dirige	diːridʒə
therebynte	tɛribintə
cod	kɔd
cloven	klɔːvən
arow	aːrɔu̯
haylen	hau̯lən
moneyour	muniur
preposicioun	prɛːpɔzisjuːn
herte	hɛrtə
ruyne	riu̯inə
ferthe	fɔu̯rtə
ȝelp	jɛlp
ȝhere	jɛːrə
blak	blak
chalis	tʃalisə
cristiente	kristianteː
merveilen	mɛrvɛi̯lə
salade	salədə
voys	vɛi̯s
belden	beːldən
jhesu	dʒeːziu̯
stenchen	stɛntʃən
hayle	hɛi̯l
lettre	lɛtrə
hakeney	hakənɛi̯
panterere	pantərɛːrə
saunz	san
swerven	swarvən
goshauk	ɡɔshau̯k
fewe	fɛuə
þester	θiːstər
savagyne	savadʒiːnə
recovere	rɛkɛvər
werre	wɛːrə
clothing	klɑːðinɡ
savenes	saːvənɛs
mynten	mintən
atberen	ætbɛren
gluynge	ɡliu̯inɡ
umbedelven	ymbedelven
crowe	krɔu̯ə
amyable	aːmiaːbəl
fauconer	fau̯kuːnɛːr
soot	soːt
in	ən
faderles	fadərlɛːs
fenygreke	feːniɡreːk
patroun	paːtroːnə
undisposicioun	undispɔːzisjun
bisy	biziː
orf	ɔrf
bilewit	biləʍiːt
graceles	ɡraːsəlɛːs
samoun	sau̯mun
baken	baːkən
thefly	θeːvliː
pancake	pankaːkə
wrenne	wrɛnə
assailing	asɛi̯linɡ
art	art
savegard	sau̯fɡardə
ancle	ankəl
vapouren	vapuːrən
thevysch	θeːviʃ
endelesly	ɛːndəlɛːsliːtʃə
barneschen	barniʃən
bischop	biʃəp
materialy	matɛːrialiː
wevel	weːvəl
dotynge	dɔːtinɡ
hospitalite	hɔspitaːliteː
jelous	dʒaluːs
norice	nurisə
columpne	kɔlum
fiole	fiːɔːlə
flouryng	fluːrinɡ
queynte	kwui̯ntə
welken	wɔlkən
schyrnesse	ʃiːrnɛs
rebelloure	rɛbɛluːr
wheten	xwɛːtən
sevenefold	sɛːvəfɔːld
rewly	riu̯litʃ
nakenen	naːkənən
theft	θɛfθ
leden	lɛːdən
wolward	wulwərd
officer	ɔfiːsɛːr
chaunterie	tʃau̯ntəriːə
clawen	klɔu̯ən
sored	sɔːrid
flask	flaskə
thedisch	θeːdiʃ
top	tɔp
trippyng	tripinɡ
conjuracioun	kundʒiu̯raːsjun
douȝty	dɔu̯xtiː
undisposicioun	undispɔːzisjuːn
barkyn	barkən
ligeaunce	leːdʒəau̯nsə
chymeney	tʃimineː
cristiente	kristiɛnteː
baptistery	baptiːstəriːə
umbefolden	umbefɔːlden
swere	swɛːr
acquerne	aːkwɛrnə
saffron	safrɔn
congelen	kɔndʒɛlən
flawmen	flaːmən
gramery	ɡramariːə
rotynge	roːtinɡ
middel	mɛdəl
enchaunten	ɛntʃau̯ntən
endower	ɛnduːɛːrə
everwik	ɛvərwitʃ
gamen	ɡɔːmən
hoden	hɔːdən
palate	palat
standen	standən
bladdre	bladər
fenny	fɛniː
tawne	tau̯niː
wermode	wɛrmɔd
heron	hɛːrun
randoun	rau̯nduːn
northumberlond	nɔrθhumbərlɔːnd
lyoun	lɛːuːn
burynes	burinɛs
capitain	kaːpətɛi̯nə
selden	sɛldən
exaccion	ɛksaksjun
sleight	slɛi̯xt
steȝere	stɛi̯ər
ympe	impə
facioun	fasjun
elleven	ɛnløːvən
word	wɔrd
erldom	ɛrldoːm
materas	matəraːs
frendman	frɛndman
wombed	wɔːmbid
swathing	swaðinɡ
chestre	tʃɛstər
sanguinolent	sanɡwinɔlɛnt
hevyte	hɛːviteː
pattener	pætənɚ
berkyng	bɛrkinɡ
angwischous	anɡwiʃuːs
james	dʒaːmz
cruelte	kriu̯alteː
schovel	ʃuvəl
spyndel	spindəl
perilously	pɛrəluːsiː
peril	pɛrəl
comb	kɔːmb
hund	hund
batailloure	batɛi̯luːr
morther	murdər
gamely	ɡaːməliː
rede	rɛːd
garlek	ɡarleːk
elven	ɛlvən
nihterne	nixtərnə
pesecod	pɛːzəkɔdə
staf	staf
leke	leːk
brymston	brimstɔːn
yondfaren	jɔndfɑːren
suster	sistər
abbey	abiːə
vambrace	vambraːsə
mery	muriːə
gate	ɡatə
englisch	ɛnɡliʃ
bast	bast
mowen	maɣən
roobukke	rɑːbuk
dewe	diu̯ə
paleys	paləs
tolboth	tɔlboːθ
trome	trumə
depely	deːpliːtʃə
hosnesse	hɑːrsnɛs
square	skwɛːrə
botoun	butuːn
herne	hirnə
cruddynge	krudinɡ
lentile	lɛntilə
pye	piːə
allie	aliːə
wikked	wikəð
rychemund	ritʃəmund
warderobe	wardərɔːbə
duchish	dutʃiʃ
endyng	ɛndinɡ
not	nɔt
goky	ɡuːkiː
roget	rɔdʒɛt
pykeharneys	piːkəharnəs
blede	blɛːd
posicioun	pɔzisjun
venus	vɛːnus
gnawen	ɡnau̯ən
yvory	iːvəriːə
hosyer	hɔːzjərə
sware	swaːrə
doten	dɔːtən
egren	ɛːɡərən
scheld	ʃiːld
grunten	ɡruntən
weke	wikə
felawe	fɛlɔu̯ə
emperour	ɛmpərər
bedfelawe	bɛdfɛlɔu̯ə
toll	tɔːl
sotilly	sɔtiliːtʃə
coroner	kurunər
faie	fɛi̯ə
tayl	tɛi̯əl
emperie	ɛmpɛriːə
morteys	mɔrtis
hamelen	hamələn
thikken	θikən
graciously	ɡraːsjoːsliːtʃə
interposicion	intərpɔːzisjuːn
wolward	wulward
ilkon	ilkɔːn
cristien	kristjɛn
visioun	viːzjuːn
devel	deːvəl
nothyng	noːθinɡ
harneysen	harnɛi̯sən
win	win
endowen	ɛnduːən
forken	fɔrkən
viciousnesse	visiuːsnɛs
stynge	stindʒ
bitwixe	bitwikst
revyng	rɛːvinɡ
dorry	dɔrɛː
birche	birtʃə
schyre	ʃiːr
lether	lɛːðər
goselyng	ɡɔslinɡ
cloke	kloːkə
hamer	hɔmər
taylende	tɛi̯lɛːndə
hondywerk	hɔːndiwərk
samoun	saːmuːn
geste	dʒɛːstə
ymne	impnə
queynte	kɔi̯ntə
caleys	kalis
rydyng	riːdinɡ
sevenþe	sɛftə
staunce	stau̯nsə
saunz	sau̯n
velvet	vɛlvɛt
cloud	kluːd
wordy	wurdiː
daunten	dau̯ntən
slynesse	sliːnɛs
hereword	hɛrəwɔrd
gandre	ɡandər
ache	aːtʃə
febilte	feːbəlteː
ymagynatif	imaːdʒinaːtiːf
college	kɔlaːdʒə
houndesberye	huːndbɛriːə
dauncen	dantsən
eunuk	ɛu̯nuk
wrynge	wrinɡə
flye	flɛi̯ə
sherten	ʃɔrtən
dower	duːɛːrə
librarie	libraːriː
chymeney	tʃiməneː
sadel	saːdəl
nepe	neːp
derth	dɛrθə
fyke	fiːkə
bargaynen	barɡɛnən
aghlich	au̯əliːtʃ
norture	nuritiu̯rə
dovehouse	duːfhuːs
legende	lɛdʒɛnd
cheyne	tʃɛi̯ɳə
securite	sɛkiu̯rəteː
schovynge	ʃuvinɡ
sermoun	sarmun
siker	sikər
assaile	asɛi̯lə
fomentacioun	fɔːmentaːsjuːn
swopen	swɔːpən
anteme	antɛfənə
tinder	tɛndər
sanguinolent	sanɡwinɔːlɛnt
vewer	viu̯ərə
couplyng	kuːpəlinɡ
faderhode	faːdərhoːd
myrthe	mɛrxθ
robberie	rɔbriːə
delf	dɛlf
roben	rɔːbən
manerly	manɛːrliː
brotherwort	broːðərwurt
morwenyng	mɔrəninɡ
sacre	saːkrə
douen	duːən
berien	burən
hacchynge	hatʃinɡ
been	bøːn
moderly	moːdərliːtʃ
fenygreke	feːnəɡreːk
flien	flɛi̯ən
aker	akər
kyte	kiːtə
soryly	sɔːriːliːtʃə
gaynen	ɡɛi̯nən
smythe	smiθə
climben	klimən
tillen	tilən
red	reːd
hore	hɔːriu̯ə
plurelle	pliu̯rɛl
rere	reːrə
charmer	tʃarmɛr
thurgh	θurx
blast	blast
gron	ɡrɔːn
yerd	jard
robberie	rɔbəriːə
gredynesse	ɡreːdiːnɛs
garde	ɡardə
slyke	sliːk
chevese	tʃeːvəsə
corounen	kurunən
brigge	brɛdʒ
bargaynen	barɡɛi̯nən
revelyng	rɛvəlinɡ
smythen	smeːðən
sleighly	slixliː
chymeney	tʃimənɛi̯
schaft	ʃaft
vertuous	vɛrtiu̯əs
opposicioun	ɔpɔːzisjun
salade	salatə
chambre	tʃaːmbrə
parisshoner	pariʃənər
stonen	stɔːnən
breken	brɛːkən
agrement	əɡreːmɛnt
drane	drɔːnə
as	as
juelrye	dʒiu̯əlriː
berier	biriər
lavender	lau̯ndeːr
brochen	brɔːtʃən
square	skwiːrə
lymon	limən
rebellyng	rɛbɛlinɡ
schilling	ʃilinɡ
forcouth	fɔrkuːθ
yest	jɛːst
prest	preːst
morwe	mɔrn
yis	jis
schovynge	ʃuːvinɡ
roste	roːst
wet	wɛːt
tred	trɛd
deposicion	dɛpɔzisjuːn
gamen	ɡamən
playing	plɛi̯inɡ
inc	jink
patronage	patruːnaːdʒə
vertu	vɛrtiu̯
chaf	tʃaf
suster	zustər
stacioun	staːsjun
pauncher	pau̯ntʃərə
stacioun	staːsiun
rewe	rɛu̯
governour	ɡuvɛrnur
fenygreke	feːniu̯ɡreːk
vynour	viːnur
termagaunt	tɛrvaɡant
scheltroun	ʃɛltrumə
lordlyng	lɔːrlinɡ
nyne	nijən
historie	istɔriːə
groynen	ɡrunən
felaweshipe	fɛlɔu̯ʃipə
cloven	klɔːvə
greynen	ɡrɛi̯nən
jurour	dʒiu̯rur
chewen	tʃɔu̯ən
reth	reːðə
dale	dal
slepen	sleːpən
wischen	wiʃən
coucher	kuːtʃuːr
couplen	kuplən
rade	rad
vinous	viːnus
historial	istɔrial
tombe	toːmbə
chymeney	kimənɛi̯
napkyn	napkin
griffoun	ɡrifun
tare	taːrə
sorely	sɔːrliːtʃə
fisch	fiʃ
dorry	dɔriː
bridale	briːdalə
enfeblisshen	ɛnfeːbliʃən
inker	jinkər
degre	dɛːɡreːs
speckyd	spɛkɛd
braynles	brɛi̯nlɛs
foreyn	fɔrɛːn
fantom	fantum
sore	sɑːr
gloriynge	ɡlɔːriːinɡ
langage	lanɡaːd͡ʒə
questor	kwɛstuːr
sovereynte	sɔvərɛi̯nəteː
yvel	uvələ
water	watər
wynly	winliː
venquysshen	vɛnkwiːsən
livid	liːvidə
jay	dʒɛi̯
bordis	buːrdiːs
recomaunden	rɛkumandən
frendly	freːndliː
remen	rɛːmən
crowdere	kruːdərə
berier	bɛriər
cristemasse	kristismɛsə
reulily	riu̯ləliː
rethnes	reːðənɛs
bacoun	baːkuːn
rare	raːrə
gain	jɛi̯n
wet	wɛt
stage	staːdʒə
borden	bɔːrdən
umbelappen	umbelɑppen
waynscot	wɛi̯nʃɔt
agreablely	əɡreːaːbəliː
surnoun	surnuːn
wommanly	wumanliː
compas	kumpas
apocalips	əpɔkalipsə
answere	andswɛːrə
gon	ɡɑːn
magik	madʒiːkə
caitif	kɛi̯tiːf
alienat	aːliɛːnaːt
steppen	stɛpən
lavour	laːvər
saunz	sanz
ythe	iːθ
wikke	wikə
jewly	dʒiu̯liː
rot	rɔt
kembynge	kɛminɡ
norice	nuriːsə
artificer	artifəsɛːr
real	riːal
tre	treː
kith	kiðə
lyme	leːm
terebentyne	turbintiːnə
recoveryng	rɛkɛvərinɡ
south	suːθ
delitable	dɛliːtaːbəl
base	baːsə
purpel	purpəl
eternal	ɛːtɛrnɛːl
dotard	dɔːtard
cleyye	klɛi̯jiː
pound	puːnd
letheren	lɛðrən
grome	ɡroːmə
disparage	disparaːdʒə
latoun	latən
trace	traːsə
inker	unkər
warenner	warəneːrə
resyn	rɛzinə
reif	rɛːv
matere	maːtər
thonder	θunər
delite	deːliːtə
letheryd	lɛðərid
tyllyng	tilinɡ
vitaillyng	vitɛi̯linɡ
cant	kant
spere	speːrə
werrely	wɛrəliː
spone	spoːn
werren	wɛrən
venemosite	vɛniməsteː
feeste	fɛːste
dusken	duskən
myschef	mistʃif
lawier	lau̯eːr
lid	lid
presthode	preːsthɔːd
shirevewyk	ʃəreːvəwikə
ampte	amətə
hat	hat
tode	tɑːdə
james	dʒaːmə
yondbreden	jɔndbrɛːden
tolsey	tɔlzɛi̯
gestenen	ɡɛstnən
westerne	westərnə
emeroides	ɛmərui̯dis
supposicioun	supɔzisjuːn
acordaunt	akɔːrdau̯nt
cloven	iklɔːvə
cok	koːk
oblacioun	ɔːblaːsjuːn
blader	bladər
spigot	spiɡɔt
sherte	ʃirtə
bord	boːrd
surname	surnaːmə
inwardes	inwaːrdəs
cusshon	kuʃən
jupartie	dʒuːpartiːə
coroner	kruːneːr
mysword	miswɔːrd
garlek	ɡarlɛːk
corne	kɔːrn
gelen	dʒɛːlən
cofre	koːfər
ook	ɔːk
clemen	klɛːmən
biche	bit͡ʃə
gerle	ɡurlə
dingen	dinɡən
develiche	deːvəliː
weren	wɛːrən
jewesse	dʒiu̯ɛsə
john	dʒɔːhanɛs
tow	tɔu̯
tayled	tɛi̯lid
womman	wivman
hernes	harnəs
viniterie	vinitɛriː
mi	miː
ilke	ilkə
speche	spɛːtʃ
bukskyn	bukskin
pronouncen	prɔːnuːnsən
dusty	dustiː
blameles	blaːməlɛːs
nakednesse	naːkidnɛs
fass	faːs
securite	sɛːkiu̯rəteː
hospiteler	hɔspitɛleːr
future	fiu̯tur
spoke	spɑːkə
footeles	foːtlɛːs
serche	sɛrtʃə
tin	tin
tuo	twɑː
ooneyed	ɔːniːid
collegial	kɔlɛdʒiaːl
survewe	surviu̯ə
miȝen	miːən
rind	rində
eukarist	iu̯karistə
syften	siftən
patronesse	paːtrunɛsə
swete	swoːtə
avoy	avui̯
sly	slix
sauf	saːvə
lewednesse	lɛu̯idnɛs
omissioun	ɔmisjən
lege	lɛːɡə
vertuous	vɛrtus
amad	amad
undressen	undrɛsən
jupartie	dʒiu̯partiːə
daunce	dansə
toiling	tui̯linɡ
spyne	spiːnə
chafur	tʃaːfər
obumbren	ɔbumbrən
gloriously	ɡlɔːriusliː
lycorys	likuris
drery	dreːriː
ȝoken	jɔkən
oter	ɔːtər
coronal	kruːnal
steppyng	stɛpinɡ
sithen	siðən
popy	pɔpiː
prisner	priznər
mæche	meːtʃə
absence	absɛnsə
fode	foːdə
honysoke	huniːsukə
ciser	sisər
west	wɛst
wolled	wulɛd
monstre	mɔnstər
captif	kaptiːf
gumme	ɡumə
fannen	vanən
adamant	adəmau̯nt
straw	strau̯
crowde	kruːd
heedles	hɛːdlɛːs
maken	maːkən
kampe	kɔːmp
hodles	hoːdlɛːs
freen	frøːn
schadowe	ʃadɔu
poynaunt	pui̯nau̯nt
pullayle	pulɛi̯l
lavatorie	lavaːtɔːriːə
lawier	lau̯jər
bastardie	bastardriːə
nyfte	nift
wombed	wɔːmid
lorþeine	laːrðɛjn
develrye	dɛvələriːə
universally	iu̯nivɛrsɛliː
clother	klɔːðjər
chalis	tʃaləsə
commendynge	kumɛndinɡ
reuþeles	riu̯θlɛs
clodred	klɔðərɛd
bourdour	buːrduːr
theft	θift
schaft	ʃɛft
morteys	mɔrtɛi̯s
ewage	ɛu̯adʒə
cloke	kloːtʃə
blamyng	blaːminɡ
tyrauntrie	tirau̯ntəriːə
armurer	armərər
sute	syːtə
gron	ɡrɑːn
penner	pɛnərə
worden	wɔːrdən
cruelnesse	kriu̯ɛlnɛs
stiborne	stubuːrn
bacheler	batʃəlɛːr
behove	bihoːvə
percher	pərtʃərə
shirreve	ʃɛreːvə
egre	ɛːɡrə
ik	ik
parisshe	parɔtʃə
cristendom	kristəndɔm
mongere	mɔnɡərə
wytword	witwɔrd
felawen	fɛlɔu̯ən
slight	slixt
mynisterie	ministəriːə
dumben	dumbən
roialme	rɔi̯alm
otemele	ɔːtəmɛːlə
lof	lɔf
lauriol	lau̯riɔl
whelpen	ʍɛlpən
commendably	kɔmɛndaːbliː
reuþeles	riu̯θlɛːs
rotennesse	rɔtənnɛs
nynthe	niəðə
thresshere	θraʃərə
yelow	jɛlwə
beste	bɛst
pepyrquerne	pɛpərkwɛrn
woken	wɑːkən
couplyng	kupəlinɡ
panetrie	panətəriːə
sodeynte	sɔdɛi̯nteː
macer	maːsər
broche	brɔːtʃə
cryme	kriːmə
nake	naːkə
voysen	vui̯sən
wyndrawer	wiːndrau̯ərə
story	stɔːriːə
badde	badə
bochous	boːkhuːs
ærfeðnesse	arvəðnɛs
raunsonen	ransunən
sevenyght	sɛnixt
situacioun	sitiu̯aːsjun
atazir	ataziːr
freen	freːən
chest	tʃɛːst
cataract	katərakta
dombenesse	duːmbnɛs
chalenger	tʃalandʒuːr
coronement	kruːnəmɛnt
bladdre	blɛdər
enden	ɛndən
beriel	buriəl
hordom	hoːrdum
halter	haltrə
naken	naːkən
cross	krɔs
lawfully	lau̯əfuliːtʃə
fauconer	fau̯kənər
digit	didʒitus
dogge	dɔɡə
toilen	tɔi̯lən
flye	fliːə
flowen	flɔu̯ən
tyraundise	tirau̯ndisə
creature	krɛːətiu̯r
steȝere	stiːər
bolde	bɔːld
shyn	ʃinə
hodynge	hoːdinɡ
horyen	hɔːriən
kene	keːnə
yesterday	jɛstərdɛi
translatour	translaːtuːr
jueler	dʒuːələr
whelpen	wɛlpən
corde	kɔːrdə
whale	waːl
sweven	swɛːvən
recoveree	rɛkuvəreː
bisne	biːzən
reuþful	ruːθful
bapteme	baptizəm
pety	pɛteː
dusken	dɛskən
grece	ɡreːs
eiliche	ɛi̯əliːtʃ
maner	maːnərə
yvelen	eːvələn
recoveren	rɛkɔvərən
coronacion	kɔrunaːsjun
perre	pɛriːə
growte	ɡrut
coteler	kutəlɛr
abay	abɛi̯
ende	ɛːnəd
pulet	pulɛt
berd	bɛːrd
weder	wɛdər
werrour	waruːr
oracle	ɔːraːkəl
envie	ɛnviːə
empire	ɛmpɛːrə
germanie	ɡɛrmaniːə
crepel	kreːpəl
paire	pɛi̯rə
clepen	klipən
mysword	miswɔrd
kemben	kɛmbən
mad	mɛd
nakenyng	naːkəninɡ
sherman	ʃɛːrman
corner	kɔrneːrə
inward	inwaːrd
malencolik	malənkɔːlik
ligeaunce	liːdʒəansə
wynsom	wunsum
caraway	karəwiː
mirien	muriːən
breid	brɛi̯də
frountel	fruntɛl
fifte	fiːfθə
venemous	vɛnəmuːs
spynnester	spinəstər
warþe	warθ
sevenþe	sɛvənθə
cristiente	kristjaniteː
coroune	kuruːnə
tribe	triːbə
bakhows	bakhuːs
gamen	ɡamənən
envenemyng	ɛnvɛnəminɡ
slidery	sliːdəriː
feture	fɛi̯tiu̯rə
birche	birkə
lymon	limun
undedlynesse	undɛdliːnɛs
sorely	sɔːrliː
sot	sɔːt
gate	ɡat
hory	hɔːriː
pan	paːn
thikkenes	θikənɛs
flawmen	flambən
pown	puːn
bren	braːn
cirurgien	sirurdʒin
kilne	kilnə
sotilte	sɔtələteː
yorkshire	jɔrkʃər
assaynge	asɛi̯inɡ
taylende	tɛi̯lɛndə
sarsen	saːrsən
þombe	θuːmə
seldomly	seːldəmliː
pety	pɛtiː
clause	klau̯zə
vertuously	vɛrtiu̯uːsliː
stere	steːrə
latyn	laːtin
leodlich	leːdliːtʃ
clubbe	klubə
berken	bɛrkən
seignurie	sɛːnjuriːə
alym	alum
hog	hɔɡ
forȝiven	fɔrjeːvən
cleyed	klɛi̯id
elne	ɛlən
hacchen	hatʃən
abstractif	abstraktiːf
sporier	spɔːriərə
knyttynge	knitinɡ
batayle	batɛi̯lə
herne	hyrnə
orpyment	ɔrpimɛnt
northhumbre	nɔrθhumbrə
feture	fɛːtərə
chaf	tʃɛf
hosely	hɔːrsliː
synamome	sinamɔːm
emeroides	ɛmərɔu̯dis
spore	spɔːrə
lucifer	liu̯sifər
eterne	ɛtɛːrnə
gredy	ɡreːdiː
siȝe	siːə
laufulnes	lau̯əfulnɛs
lady	laːdiːə
luxurie	luksjuriə
shirten	ʃurtən
heronsewe	hɛi̯ruːnsɛu̯
provisioun	prɔːvizjuːn
kernellen	kɛrnələn
megre	mɛːɡər
i	iː
egurdouce	ɛːɡərduːsə
sovereynly	sɔvərɛi̯nliː
nece	neːsə
doughter	dɔu̯xtər
hawe	hau̯ə
gingivere	dʒindʒərə
writer	wriːtərə
larew	lɔːriu̯
clyf	klif
clethen	klɛːðən
wort	wurt
aleden	alɛːdən
þesternesse	θuːstərnɛs
tuskyd	tuskid
pulle	pul
raunsoun	rau̯nsun
parable	paraːblə
fonne	fɔnə
walnot	walnutə
brewe	brɛi̯
alabastre	aləblastər
bane	baːnə
myschevously	mistʃivəsliː
del	dɛːl
trewely	triu̯əliː
thylle	θilə
autumpne	au̯tum
pilwe	pilɔu̯
abstractly	abstraktliː
chevese	tʃɛvəsə
ooneyed	ɔnɛi̯id
latyn	latiːn
amounten	amuːntən
gauger	ɡau̯dʒər
alliaunce	aliːau̯nsə
barowe	barwə
tewesday	tiu̯əzdɛi̯
baptizyng	baptiːzinɡ
fredom	freːdɔm
blinnen	blinən
storiyng	stɔriːinɡ
lord	lɔːwərd
ye	iːə
childhode	tʃiːldhɔːd
fenkel	finkəl
nyne	niːn
boon	boːn
schovynge	ʃuːinɡ
anteme	antɛmpnə
dedly	dɛːdliː
materialy	matɛriaːliː
band	bɔːnd
beteren	bɛtərən
bilder	biːldərə
chalenge	tʃalɛndʒə
sword	swɔrd
olyve	ɔliva
hod	hɔːd
myrthen	mirθən
speche	speːtʃ
nycely	niːsəliːtʃə
serchyng	sɛrtʃinɡ
seldere	seːldər
werre	wɛrə
neygh	nɛix
shon	ʃoːn
grasgrene	ɡrasɡreːnə
salt	salt
laughen	lɛi̯xən
strawbery	strɑːbɛriːə
singen	sinɡən
cleyere	klɛi̯ɛːrə
lilie	liliːə
nyne	niwən
derth	darθə
north	nɔrθ
wrist	wrist
snayle	snɛːl
jhesus	dʒeːzus
heron	hɛːrən
eiȝtetene	ɛi̯xteːnə
myle	miːl
axel	aksəl
hospitalarye	hɔspitəlariːə
shon	ʃoːən
retenue	rɛtiniu̯ə
þombe	θumbə
beautevous	bɛu̯teːvuːs
barn	barn
knowen	knɔu̯ən
scherd	ʃard
plumtre	plumtreː
musike	miu̯ziːk
emperice	ɛmpəris
garlek	ɡarleː
stroke	strɑːk
venemosite	vɛniməsiteː
min	miːn
injurie	indʒiu̯riːə
unfrendly	unfreːndliː
james	dʒaːməs
cruel	kriu̯ɛl
wicchecraft	witʃəkrɛft
graciously	ɡraːsjoːsliː
aboven	abuvən
middenerd	midənard
drerimod	dreːriːmoːd
prestly	prɛstliː
versicle	vɛrsiklə
sanguinarie	sanɡwinaːriː
rerd	rœrd
lessoun	lɛtsuːn
kembestere	kɛmpstər
schonde	ʃɔnd
venemous	vɛniməs
þester	θuːstər
rubarbe	riu̯bardə
figee	fiɡeːə
hache	hatʃ
stiffenes	stifnɛs
wiþ	wið
dyamaunt	diːamau̯nd
swathing	swaːðinɡ
hagis	haɡis
official	ɔfisial
wermode	wurmɔd
roten	rɔːtən
orfray	ɔrfrɛi̯s
croudewayn	kruːdwɛi̯n
myschef	mɛstʃeːf
ballok	balək
beriel	biriəls
ew	jiu̯
couche	tʃuːtʃə
lyoun	lɛuːn
fecche	vɛtʃə
auripigment	au̯ripiɡmɛnt
lof	lɔːf
ȝerde	jɛrd
desert	dɛːzɛrt
sory	sɔːriː
felefold	fɛːləfɔːld
daunce	dantsə
bicaren	bikaːrən
storial	stɔriaːl
englisch	inɡliʃ
bal	bal
chesteyne	tʃastɛi̯nə
scharn	ʃɛrn
macer	maːsɛːr
flete	fleːt
bataylen	batɛi̯lən
shirten	ʃirtən
agreen	aɡreːən
lome	loːmə
buryinge	buriinɡ
narowly	narɔu̯liː
fresen	freːzən
bas	baːs
isykle	iːsikəl
theft	θeːfθ
bleden	bleːdən
ymagynynge	imaːdʒininɡ
fother	foːðər
wyn	wiːn
pronunciacioun	prɔːnunsiaːsjɔn
nacioun	naːsjun
fleumatik	flɛu̯matiːk
mustard	mustərdə
pyssynge	pisinɡ
clubbyd	klubid
amen	aːmɛn
feeld	feːld
sor	sɔːr
extre	akstreː
yvel	ɛːvəl
paynym	pɛi̯nimə
navel	naːvələ
þes	θeːzə
hous	huːs
fright	frixtə
abashen	əbaʃən
conjurer	kundʒiu̯rɛːrə
vertuously	vɛrtiu̯usliː
cristened	kriːstənd
ac	ak
þombe	θuːmbə
peple	peːplə
crownynge	kruːninɡ
serche	sɛːrtʃə
hure	huːrə
crudelite	kriu̯dɛliteː
moderhede	moːdərhɔːd
angwischen	anɡwiʃən
divisioun	diːvizjuːn
hateful	haːtəful
composicioun	kɔmpɔzisjuːn
patene	patɛn
vessel	vɛsəl
hound	huːnd
messyas	mɛsiːə
eldefader	eldəfaːder
sevenefold	sɛvəfɑːld
fus	fuːs
londyng	lɔːndinɡ
saucer	sau̯sərə
shon	ʃoːjən
kembynge	keːminɡ
leyt	lɛi̯t
honyed	huniːid
hacchen	hɛtʃən
berien	birjən
resistyng	rɛzistinɡ
schalk	ʃalk
cage	kaːdʒə
greynyng	ɡrɛi̯ninɡ
scorpioun	skɔrpiən
cruel	kruəl
matere	matərə
violent	viːɔlɛnt
spicen	spiːsən
naked	naːkid
journe	dʒurnɛi̯
kalender	kaləndər
carpe	karpə
clowe	klɔu̯
dee	diː
schaft	ʃɛpθ
unicorne	iu̯nikɔrnə
violet	viːəlɛt
slynger	slinɡərə
leuk	li̯uk
bef	beːf
adam	adam
sether	seːðərə
suster	swustər
ymaginacioun	imaːdʒinaːsiuːn
hackynge	hakinɡ
capoun	kaːpuːn
walsch	waliʃ
kembestere	kɛmbəstər
bisegen	biseːd͡ʒən
flathon	flaðun
armure	armuːrə
paper	paːpɛːr
sleighly	slɛi̯xliː
mad	mad
malencolien	malɛnkɔliːɛn
roben	rɔbən
paper	paːpiːr
creature	krɛːaːtiu̯r
heed	hɛːvd
cokswain	kɔkswɛi̯n
herber	ɛrbɛːr
halyday	halidɛi̯
bargenyng	barɡɛi̯ninɡ
sisours	sizurs
dusty	duːstiː
sweven	swɛvən
rereward	rɛːrəwardə
helve	hilv
cedre	sɛːdər
yvelen	ɛvələn
foted	foːtɛd
stynge	stinɡ
crudden	krudən
venquysshen	vɛnkwiʃən
asker	aksərə
teren	tɛːrn
wer	wɛr
bren	bran
persely	pɛrsɛl
worden	wɔrdən
opposicioun	ɔpɔzisjuːn
reremous	reːmuːs
historier	istɔriər
coler	kɔlərə
kith	kiθ
waynscot	wɛi̯nskɔt
hameren	hamərən
onerous	ɔnɛruːs
pope	pɔːpə
gome	ɡoːm
barm	barm
sirup	sirip
stremen	strɛːmən
amiral	amiraːl
bourdour	buːrdər
rotynge	rɔːtinɡ
schoven	ʃuvən
recoveren	rɛkɛvərən
wipen	wiːpən
povre	poːrə
capcioun	kapsjun
thild	θild
spyndel	spinəl
hostellen	hɔstələn
hacche	hatʃ
enhauncen	ɛnhau̯nsən
umbeloken	umbelɔːken
myrthe	murθ
tymely	tiːmliː
comaundable	kumau̯ndaːbəl
amplifiyen	amplifiːən
swete	swɑːt
spiþre	spiːðər
beriel	biriəl
swarmen	swɛrmən
sugren	siu̯ɡəːrən
emeraude	ɛmərant
coteler	kutələr
elleven	ɛnlɛvən
woo	wɔː
interposicion	intərpɔːzisjun
reysen	rɛːzən
burde	byrdə
symple	sɛmpəl
ikil	ikəl
thicke	θikə
cryminal	kriːminəl
assay	sɛi̯
regioun	rɛːdʒjuːn
yit	jit
cloddre	kludər
flor	floːr
derth	dirθə
mele	mɛːlə
trant	trant
wrongfully	rɔnɡfuliː
pereles	peːrlɛːs
facioun	faksjuːn
lavendre	lavəndər
prophetesse	prɔfɛːtɛsə
homwardes	hɔːmwaːrdəs
toþeles	toːθlɛs
steppe	stɛpə
acordingli	akɔːrdinɡliː
cerymonial	sɛrimɔniaːl
rowen	rɛu̯ən
garfysche	ɡaːrfiʃ
tolling	tɔlinɡ
venymynge	vɛnəminɡ
prophecien	prɔfəsiːən
vertually	vɛrtiu̯aːliː
hordere	hɔrdərə
maladie	maladiːə
swerer	swɛːrərə
candel	kandəl
clouting	kluːtinɡ
norisshyng	nurisinɡ
hosyer	hɔːziərə
thymbyll	θuməl
anys	aniːs
frendschip	freːnʃipə
fowel	fuːəl
hateliche	haːtəliːtʃ
dile	dilə
tusk	tuks
swaþelynge	swɛdlinɡ
swathel	swadəl
forke	fɔrtʃə
soren	sɔːrən
hondywerk	hɔndiwərk
day	dɛj
chaunten	tʃau̯ntən
verdit	vɛrdit
douȝt	duxt
code	kɔːdə
foteman	foːtman
agayn	ajɛi̯n
housel	huːzəl
askynge	askinɡ
socour	sukuːr
toppen	tɔpən
saffron	safrən
shere	ʃɛːr
extre	ɛkstrøː
groynen	ɡrui̯nən
gauger	ɡaːdʒər
warenner	warənər
swevenyng	swɛːvəninɡ
silence	siːlɛnsə
yesternyght	jɛstərnixt
souker	suːkərə
accordaunce	akɔːrdau̯nsə
couple	kuplə
ender	ɛndərə
tradicioun	tradisjuːn
dewy	dɛu̯iː
ȝerde	jard
stormy	stɔrmiː
esy	ɛːziː
gauge	ɡau̯dʒə
pith	piθə
bisy	byziː
suffolk	suθfɔlk
quynce	kwɛns
kingdom	kiŋɡdoːm
norischer	nuriʃɛːrə
dinten	duntən
saucen	sau̯sən
chervell	tʃɛrvɛlə
assailing	sɛi̯linɡ
spiller	spilər
spicerie	spiːsɛːriːə
sampson	sampsun
terebentyne	turpintiːnə
store	stoːr
agame	aɡaːmə
comaunde	kumau̯ndə
bef	bøːf
dasch	daʃ
brotherhede	broːðərhoːd
tripe	triːpə
stile	stiːl
deeth	dɛːθ
hare	haːrə
resisten	rɛzistən
wolled	wulid
gripe	ɡriːpə
sadelen	saːdələn
kneden	knɛːdən
recoverer	rɛkuvərɛːr
animate	animaːt
merveile	mɛrvɛi̯lə
groynynge	ɡruːninɡ
differren	difɛrən
po	pɔː
sesoun	sɛːzun
fonne	funə
hoden	hoːdən
vitailen	vitɛi̯lən
weder	wɛːdər
scherer	ʃɛːrərə
light	lixt
hevyte	hɛːviːteː
mous	muːs
sauf	savə
coffyn	kɔfin
thyng	θinɡ
angelik	au̯ndʒɛliːk
relenten	rɛlɛntən
rebellious	rɛbɛlus
dialog	diːalɔɡə
gredyly	ɡreːdəliː
hakle	hakələ
massif	masif
enden	ɛːndən
yesterday	jistərdɛi
clother	klɔːðər
cornet	kɔrnɛt
daunce	dau̯ntsə
letheryd	lɛðərɛd
swathen	swaːðən
brotherles	broːðərlɛːs
monymaker	munimaːkərə
cheynen	tʃɛi̯ɳən
werrour	wɛrur
worthy	wɔrðiː
ruynous	riu̯inuːs
lore	laːrə
fonnen	fɔnən
fiele	fiːələ
endeles	ɛːndəlɛːs
agheful	aɣəful
wegge	wɛdʒ
esterne	ɛːstərnə
revelen	rɛvɛːlən
pibel	peːbəl
homage	umaːdʒə
bakbon	bakbɔːn
mincen	minsən
morwe	mɔriu̯ən
poperiche	pɔːpəriːtʃə
honysoke	huniːsuːkə
whelyn	ʍɛːlən
clout	kluːt
larðewe	lɔːrðiu̯ə
prophete	prɔfətə
mustard	mustardə
bristel	bristəl
potacion	pɔtaːsjuːn
thele	θɛːlə
suster	sustər
rare	rɛːrə
sive	seːvə
blasfemye	blasfɛmiːə
fnesen	fneːzən
tyme	tiːmə
dafftelike	daftəliːkə
fanon	fanən
marchal	maristʃal
werreour	wɛriər
ynkhorn	ɛnkhɔrn
swere	swaːr
encensen	ənsɛnsən
constitucioun	kɔnstitiu̯siuːn
snesen	sneːzən
botme	bɔðəm
extre	akstrøː
straw	streː
yvelen	ivələn
nyne	niɣən
juelrye	dʒuːəlriː
þin	ðiːn
swathlen	swɛðələn
cornered	kɔrnərid
agrement	aɡreːmɛnt
poynaunt	pui̯nant
sixte	sɛksθə
popedome	pɔːpdɔm
yarne	jɛrn
nakenen	naknən
blasfemour	blasfɛːmərə
rede	røːd
recoveraunce	rɛkɔvəransə
snow	snɔu̯
duche	dutʃeː
mazidnesse	maːzədnɛs
quik	kwik
eiȝtthe	ɛi̯xtə
perer	pɛːrər
clubbyd	klubɛd
universal	iu̯nivɛrsaːl
sauce	sau̯sə
kampe	kamp
susterhede	sustərhoːd
odour	ɔːduːr
rebel	rɛbɛl
waverynge	waːvərinɡ
snot	snɔtə
writen	wriːtən
vewe	viu̯ə
ensercher	ənsɛrtʃuːr
tridel	tirdəl
patroun	paːtrɔnə
camel	kamɛːl
slight	slɛxt
coronal	kɔrunaːl
vynegre	vinɛɡrə
ministre	ministər
landbok	landboːk
legement	lɛdʒəmɛnt
feþer	fɛːðər
sethyng	seːðinɡ
slider	slidər
venisoun	vɛnizun
sevenyght	sɛːvənixt
bothe	buːθ
hospital	hɔspitaːl
heed	hɛːvəd
feblesse	feːblɛsə
cerymonial	sɛrəmɔːniaːl
stynk	stink
fotyng	foːtinɡ
spicer	spiːsər
stagge	staɡə
eere	ɛːr
swaþelynge	swaːðəlinɡ
payen	pɛi̯n
gleowinge	ɡliu̯inɡ
rotidnes	rɔːtidnɛs
duch	diu̯tʃ
pask	paːskə
bacoun	baːkən
orenge	ɔrɛndʒə
wympel	wimpəl
sovereynly	sɔvərinliː
sisours	sizuris
barly	barliː
raysyn	rɛi̯zən
burde	birdə
pakken	pakən
cothe	kɔːðə
noumbren	nuːmbərən
armure	armiu̯rə
mel	mɛːl
dauncen	dau̯nsən
capitainerie	kapətɛi̯nəriːə
horehoune	hɔːrəhuːnd
piken	piːkən
hereword	hɛrəwurd
emperour	ɛmpərur
laweful	lau̯əful
nought	nɔxt
arisen	ariːzən
whey	xʍɛi̯
glorien	ɡlɔːriːən
bel	bɛːl
mase	maːzə
baundon	banduːn
yesternyght	justərnixt
couchynge	kuːtʃinɡ
chauntour	tʃantər
malencolious	malənkɔːliuːs
fantom	fantɔm
owen	ɔu̯ən
jelous	dʒɛluːs
sarse	sars
blamen	blaːmən
doucen	duːsən
comaundement	kumandimɛnt
cloddre	klɔdər
violence	viːɔlɛnsə
grecen	ɡrɛːsən
hethenesse	hɛːðənɛs
vyntener	vintnɛːr
curlew	kurliu̯
coler	kɔlɛːr
blosme	blɔsmə
heggyng	hɛdʒinɡ
usen	iu̯zən
hachet	hatʃɛtə
elleven	ɛlɛːvən
compassement	kumpasəmɛnt
symplesse	simplɛsə
rotynge	rɔtinɡ
bounte	buːnteː
cloth	klɔːθ
botnyng	bɔtəninɡ
heron	hɛi̯run
leke	lɛːk
phebe	feːbeː
wickednes	wikədnɛs
dettour	dɛtur
horner	hɔrnərə
sadeler	saːdəlɛːrə
table	taːblə
moderles	moːdərlɛːs
horshelne	hɔrshɛːlə
diall	diːal
nacioun	natsjuːn
graciousnesse	ɡraːsjoːsnɛs
gliden	ɡliːdən
slay	slɛi̯ə
mayn	majən
surete	suːrəteː
schovel	ʃɔvəl
trasch	traʃ
aske	askə
schoven	ʃuːvən
doer	doːərə
godmoder	ɡɔdmoːdər
herne	hyːrnə
slyke	slik
risshe	ruʃ
hord	hɔrd
clyf	kliːv
iseland	iːslɔːnd
tuschy	tuʃiː
fischer	fiʃərə
instrument	instriu̯mɛnt
spring	sprinɡ
parage	paraːdʒə
abrogen	abrɔːdʒən
sterre	stɛrə
everwik	œvərwiːtʃ
laughter	lixtər
coronal	kɔrənal
frenderede	frɛndrɛːdə
stien	stɛi̯ən
tharm	θɛrm
sore	sɔːr
questioun	kwɛstjun
code	kweːdə
flesh	flɛʃ
ymagynatif	imadʒinaːtiːf
mysword	miswurd
sporen	spɔːrən
citrine	tsitəriːnə
enquest	ɛnkwɛstə
barnles	barnlɛːs
madschipe	madʃipə
hernes	hɛrnəs
governement	ɡuvɛrnmɛnt
scharn	ʃarn
symple	simpəl
serchyng	sɛːrtʃinɡ
salt	sɛlt
bisne	biznə
blower	blɔu̯ərə
sword	sɔrd
frendschip	frɛndʃipə
towayle	tuːələ
charlewayn	tʃarləwɛi̯n
nynthe	niːðə
baundon	bandun
felaweshipe	fɛlau̯ʃipə
trewely	triu̯əliːtʃə
love	luvə
colour	kulur
paleys	palɛi̯s
shirreve	ʃɛrivə
corny	kɔːrniː
durren	durən
wommanles	wumanlɛs
werryng	wɛrinɡ
wytword	witwurd
coronacion	kɔrunasjuːn
mygge	midʒə
dedly	dɛdliː
ro	rɑː
loresman	laːrəzman
kernel	kɔrnəl
depen	deːpən
rerd	rɛːrd
hamelen	hamelen
ter	tɛr
obligen	ɔbliːʃən
theen	θeːn
bon	bɔːn
woclic	wɑːkliːtʃ
talewise	taːlwiːzə
normand	nɔrmand
stone	stɔːn
hoden	hɑːdən
knoble	knɔbəl
radiche	raditʃə
wommanyssh	wumaniʃ
chalengen	kalandʒə
tuo	twɔː
seldscene	seːldseːn
yvel	ɛːvələ
quethen	kwɛːðən
swaþelynge	swaðəlinɡ
lessoun	lɛstsuːn
piper	piːpərə
tawne	tau̯neː
plomme	plumə
john	dʒɔːhan
yvel	ɛvəl
norisshyng	nurəʃinɡ
gamen	ɡaːmən
blasfemen	blasfɛːmən
sparwe	sparɔu̯ə
vitailler	vitələr
armure	armɛu̯rə
rother	ruðər
frightilike	frixtiːliːkə
balaunce	balaːnsə
governen	ɡuvərnən
pikerel	pikəɹɛl
sirup	sirup
ministre	minəstər
vyneȝerd	viːnjard
mastyf	mastiːf
housen	huːzən
houndesberye	huːndəsbɛriːə
yeven	jeːvən
charlewayn	tʃarləswɛi̯n
schuldre	ʃɔldər
ey	ɛi
gunnepoudre	ɡunpuːðər
fairye	fɛi̯əriə
sand	saːnd
cirurgien	sirurdʒiɛn
morwenyng	mɔrwəninɡ
halyday	haːliːdɛi̯
seisen	sɛːzən
clokke	klɔkə
bothe	bɔːθə
heretowa	hɛrətɔu̯ə
ache	aːkə
abstract	abstraktə
sute	siu̯tə
ample	ɛmpəl
gracen	ɡraːsən
haven	haːn
bel	bɛl
gilden	ɡiːldən
swellynge	swɛlinɡ
schuldre	ʃuldrə
hospitalarye	hɔspitaːlaːriːə
serge	sɛrdʒə
naperon	naːpərɔn
aiden	ɛi̯dən
vynegre	vinɛːɡər
schyft	ʃiftə
twelve	twɛlfə
angerly	anɡərliː
violence	viəlɛnsə
þesternesse	θeːstərnɛs
lyoun	liuːn
tomben	toːmbən
homager	ɔmaːdʒərə
mount	muːnt
versifiour	vɛrsifiːur
forage	fɔːraːdʒə
raunsoun	rau̯nsum
yvel	eːvələ
hake	haːkə
panten	pantən
monday	mundɛi
blade	blad
peple	peːpəl
glewen	ɡliu̯ən
somer	sumər
envenimen	ɛnvɛnimən
mousere	muːsɛːrə
auctour	au̯tər
sere	sɛːr
fane	vaːnə
iniquite	inikwiteː
mewen	mɛu̯ən
sorcerere	sɔrsərɛːr
engreynen	ɛnɡrɛi̯nən
botonen	butunən
sorceresse	sɔrsərɛsə
hassasis	asasis
angerly	anɡərliːtʃə
schildyng	ʃiːldinɡ
piete	piːəteː
weke	wɛkə
norischer	nurəʃərə
poudre	puːdər
fannen	fanən
rosee	rɔːzeː
spore	spoːrə
graceful	ɡraːsful
kalender	kaləndɛːr
londen	lɔːndən
revelour	rɛvəluːr
houshold	huːshɔːld
swerven	swɛrvən
manered	maːnɛːrid
ythe	iːð
whete	ʍɛːtə
hosen	hɔːzən
pome	puːmə
lawghynge	lau̯xinɡ
gramer	ɡramɛːrə
lyme	lim
organic	ɔrɡaniːk
fecche	fatʃə
niȝt	nixt
colour	kuluːr
answeryng	andswaːrinɡ
chalenge	kalandʒə
rebellioun	rɛbɛliuːn
strem	strɛːm
bourden	boːrdən
cloke	kluːkə
hatrede	haːtərɛːdə
pere	pɛːrə
goselyng	ɡɛslinɡ
askynge	aksinɡ
hamer	hamər
schonden	ʃandən
bettre	bɛtrə
huge	hiu̯dʒə
dosk	dɔsk
malencolie	malənkɔːliːə
grave	ɡraːveː
welken	wɛlkənə
gorst	ɡɔrs
yerd	jɛrd
schort	ʃɔrt
muet	miu̯t
natural	natiu̯ral
waven	waːvən
folily	foːləliː
spoke	spɔːkə
paynye	pɛi̯əniːə
soukyng	sukinɡ
yë	iːə
tryppe	tripə
snayle	snɛi̯l
evete	ɛu̯tə
threschen	θrɛʃən
moisture	mɔi̯stiu̯rə
endowable	ɛnduːaːbəl
auctour	au̯tuːr
patronesse	paːtroːnɛsə
createn	krɛːaːtən
kne	knøw
stench	stintʃ
bullok	bulɔk
hungry	hunɡriː
angelik	andʒɛliːk
clothles	klɔːðlɛːs
wollemongere	wulmɔnɡərə
cirurgien	sirurdʒiən
venymoushede	vɛnəmushɛːd
governaunce	ɡuvɛrnau̯nsə
frount	fruːnt
prophete	prɔfitə
recoveree	rɛkɔvəreː
seven	sɛvən
wikked	wikəd
is	is
naperye	naːpəriːə
chaunteresse	tʃantərɛsə
binden	biːndən
plomme	pluːmə
occean	ɔːsjan
fan	van
duke	diu̯k
sward	swɛrd
vambrace	vau̯ntbraːsə
provisioun	prɔvizjun
inward	inward
ermyne	ɛrmineː
argh	arx
ermyn	armiːn
sheep	ʃeːp
tronke	trunk
sporier	spuriərə
swalwe	swaləwə
bee	bøː
bon	baːn
bileven	bileːvən
stakken	stakən
rebellious	rɛbɛljus
hakken	hakən
journeyinge	dʒurnɛi̯inɡ
mercurie	mɛrkiu̯riːə
lond	lɔːnd
spilen	spilən
stomak	stɔmak
sovereynly	sɔvərɛi̯nliːtʃə
arȝen	arəwən
hose	hɔːzə
wordy	wɔːrdiː
chefly	tʃeːfliː
asshe	aʃə
knight	kniçt
rede	reːd
schanke	ʃɔnkə
dokeling	duːklinɡ
verset	vɛrsɛt
mon	mɔn
chauntynge	tʃau̯ntinɡ
douceoure	duːzuːr
creature	krɛːtiu̯r
prophecie	prɔfɛːsiːə
crowyng	krɔu̯inɡ
aydaunt	ɛi̯dant
revere	rɛːvərə
helmen	hɛlmən
lawier	lau̯ɛːr
donge	dunɡ
aley	alɛi̯
tumour	tiu̯muːr
forȝiven	fɔrjivən
geson	ɡɛːzən
hate	haːtə
crymynatour	kriːminnaːtər
potacion	pɔːtaːsjuːn
antecrist	antɛkriːst
aprill	aːpriːl
bracer	braːsɛːrə
iudeisc	juːdiʃ
dotage	dɔːtaːdʒə
savage	savaːdʒə
normand	nɔrmant
world	wɛrld
sage	saːdʒə
mæche	mɛːtʃə
borden	boːrdən
mynute	minutə
extorcion	əkstɔrsjun
twig	twiː
traunce	transə
redemptoure	rɛdɛmptur
fo	əfɔː
right	rixt
duchish	diu̯tʃiʃ
thresshyng	θraʃinɡ
game	ɡaːmə
ilome	əloːmə
swart	swɛrt
cold	tʃɛːld
weyken	wɛi̯kən
childhode	tʃiːldhɛːd
conjurer	kundʒiu̯rərə
congelen	kɔndʒɛːlən
gardyn	ɡardin
saterday	satərdɛi
shirrevehod	ʃəreːvəhɛːd
wothe	wɔːðə
pautener	pau̯tənər
barn	baːrn
vicious	visjuːs
gras	ɡɛrs
susterhede	sustərhɛːd
frightful	frixtful
seisen	sɛi̯zən
footen	foːtən
ȝarowe	jarwə
burnet	burnɛt
spigot	spiɡət
camel	kamɛl
raunsonynge	rau̯nsuninɡ
plunket	plunkɛt
queller	kwɛlərə
game	ɡɔːmən
bole	bulə
cruelnesse	kriu̯ɛːlnɛs
degre	dɛːɡreː
goshauk	ɡoːshau̯k
temen	teːmən
erthe	œrθə
brayle	brɛi̯əl
iseland	iːsland
larðewe	laːrðøːwə
extorcion	ɛkstɔrsjuːn
aknowen	aknɔu̯ən
agayn	aɡɛi̯n
ferthing	fɛrðinɡ
usual	iu̯ziu̯al
oures	uːris
dresen	dreːzən
ruynous	riu̯iːnuːs
browe	briu̯
nycely	niːsəliː
perled	pɛrlid
flathe	flaːðə
mount	munt
ter	tɛːrə
inderly	indərəliː
sanguine	sanɡwiːn
sathan	saːtan
moneth	mɔnəθ
bagge	baɡə
sere	seːr
sotil	sɔtəl
schyrly	ʃiːrliːtʃə
piken	pikən
wiþ	wiθ
thryven	θriːvən
haching	hatʃinɡ
monfulnesse	mɔnfulnɛs
coffyn	kɔfiːn
speckyd	ispɛkəd
kalende	kalɛnd
helmet	hɛlmɛt
ȝit	jit
kychyn	kitʃən
onerous	ɔnɛrus
swellen	swɛlən
swathe	swaːðə
ani	ɛniː
cristien	kristjən
jupartie	dʒɛpərtiːə
tery	tɛːriː
encensen	ɛnsɛnsən
gracelessly	ɡraːsəlɛːsliː
umbegon	umbeɡɔːn
þesternesse	θɛstərnɛs
venemosite	vɛnəmɔsiteː
frenderede	freːndrɛːdən
malencolien	mɛlɛnkɔliːɛn
toppyn	tɔpən
dokkyn	dɔkən
sherman	ʃɛrman
grayn	ɡrɛi̯n
spanne	span
bourde	buːrdə
bocstaff	boːkstaːv
goke	ɡuːk
toyle	tɔi̯lə
threschwolde	θrɛʃɔːld
sermoun	sɛrmuːn
clete	klɛːt
rewthfully	riu̯θfuliːtʃə
dyapren	diːapərən
nynthe	niːnətə
viciate	viːsiaːt
historial	istɔriaːl
in	i
hachet	hatʃətə
raunsonynge	ransuninɡ
evete	ɛːvətə
mowsyn	muːsən
jhesu	dʒeːzu
previsioun	prɛːvizjuːn
myght	mauxt
accion	aksjun
enserche	ənsɛrtʃə
originali	ɔriɡinaliːtʃə
deis	dɛːs
nappen	napən
sevenþe	sɛːvəndə
ynche	intʃə
folk	fɔlk
enhaunsyng	ɛnhau̯nsinɡ
grace	ɡraːtsə
material	matɛːrial
nyȝtschade	nixtʃɔdə
orpyment	ɔrpmɛnt
flees	fleːs
lanterne	lantərnə
dok	dɔkə
myghty	mauxtiː
udder	uðər
reysen	rɛi̯zən
stiborne	stiburn
james	dʒɛːməs
secunde	sɛkund
iwinnen	iwinən
wagen	waːdʒən
sadelen	sadələn
waterlees	watərlɛs
enchauntement	ɛntʃau̯ntəmɛnt
rother	rɔðər
felter	fɛltərə
wine	winə
biwinnen	biwinən
rotidnes	rɔtidnɛs
myschevous	mistʃeːvuːs
rancour	rankur
bracen	braːsən
ospray	ɔsprɛi̯
universal	iu̯nivɛrsɛl
gronen	ɡrɑːnən
feþer	fɛdər
gamen	ɡaːmənən
gunnepoudre	ɡunpuːdər
bodeword	boːdwurd
fane	faːnə
corne	kɔrn
songly	sɔnɡliːk
snore	snɔːrə
serk	sɛrk
pultes	pultis
thorp	θrɔːp
plurelle	pliu̯raːl
childly	tʃiːldliːtʃə
wepen	weːpən
shryver	ʃriːvər
hosnesse	hɔːrsnɛs
foted	foːtid
asshen	aʃən
sotillynge	sutəlinɡ
ermyn	ərmiːn
folye	foːliːə
enfeblen	ɛnfeːblən
falwen	falɔu̯ən
gracious	ɡraːsjəs
gossomer	ɡɔsumər
hasardrie	hazardəriːə
myrthe	murxθ
waveren	waːfərən
gerle	ɡɛrlə
galyngale	ɡalinɡal
antelope	antəlɔp
disposicioun	dispɔːsjun
code	køːdə
weren	wɛrən
stifly	stifliːtʃə
floteren	flutərən
bern	bɛrn
whele	ʍɛːl
cosyn	kuzin
husbonde	husband
overflowen	ɔːvərflɔu̯ən
hawthorn	hau̯əθɔrn
hayle	hau̯l
conventicle	kɔnvɛntiklə
coaccion	kɔːaksjuːn
temese	taməzə
hirdel	hurdəl
endeles	ɛndəlɛːs
jus	dʒui̯s
cranage	kraːnaːdʒə
lordlyng	lɔːrdlinɡ
spewyng	spiu̯inɡ
hasardour	hazardur
biten	biːtən
knytter	knitərə
eternal	ɛːtɛrnal
paunce	pansə
bodeword	boːdwɔrd
randoun	rau̯ndun
vicious	visiuːs
veine	vɛi̯nə
poudren	puːðərən
rache	ratʃ
wombed	wɔːmbɛd
hony	huniː
fre	friː
byschopryke	biʃəpriːkə
anteme	antimə
dirige	dirdʒə
assaier	asɛi̯uːr
quellen	kwɛlən
hevynesse	hɛːviːnɛs
theft	θiːft
yesternyght	jistərnixt
amased	amaːzəd
questor	kwɛstur
remyn	rɛːmən
fauconer	fau̯kunɛːr
dint	dint
adle	aːdəl
bathe	baːðə
chalenge	tʃalau̯ndʒə
olyve	ɔlivə
cheyne	tʃɛi̯nə
dew	dɛu̯
inwardly	inwaːrdliː
sisours	sizurz
cenyth	sɛːnit
secundarili	sɛkundaːriːliː
myschevously	mistʃeːvuːsliː
oddenesse	ɔdnɛs
lopster	lɔpəstrə
bilden	biːldən
angwischen	anɡwisən
mowen	mɔu̯ən
fnesy	fnøːziː
norischaunt	nuriʃant
vyner	viːnər
sercher	sɛːrtʃər
endely	ɛndəliː
request	rɛkwɛstə
wombe	wɔːmb
þesternesse	θiːstərnɛs
felawen	fɛlau̯ən
accion	aksjuːn
oyle	ui̯lə
spurn	spurn
berd	bɛrd
material	maːtɛriaːl
crowdere	kruːðərə
creature	krɛːatiu̯r
bever	bɛːvər
flathon	flaðən
tronchoun	tʃruntʃuːn
wynne	winə
arable	araːbəl
frighti	frixtiː
spice	spiːsə
sward	swarθ
outward	uːtwaːrd
panel	panəl
latoun	latuːn
humayne	iu̯mɛi̯nə
frendles	freːndlɛːs
storiyng	stɔriinɡ
hondywerk	handiwərk
been	beːn
dogh	dɔu̯x
eifulle	ejəful
resistence	rɛsistɛnsə
yekesters	jɛːkistɛrs
cenyth	sɛnit
kempe	kɛːmp
erle	jɛrl
hore	hɔːrə
binden	bindən
provynce	prɔːvinsə
bourdeful	buːrdful
gate	jat
captif	kaptiːvə
brinke	brɛnkə
persely	pɛrsəliː
duch	dutʃ
heed	hɛvd
norice	nurəsə
eternal	ɛːtɛrnaːl
almerie	alməriːə
merveilyng	mɛrvɛlinɡ
chevese	tʃɛːvəsə
journeier	dʒurnɛi̯ərə
quiste	kwɛst
hunger	hunɡər
aboute	abuːtə
barn	bɛrn
exposicioun	ɛkspɔːzisjun
sorcery	sɔsəreːə
schonde	ʃand
cote	koːtə
quern	kweːrn
stile	stɛi̯l
maner	maːnɛːrə
sotten	sɔtən
wocnesse	wɔːknɛs
kiteling	kitəlinɡ
newe	niu̯ə
speche	speːk
stiborne	stibuːrn
fer	fɛr
viniterie	vintɛriː
endeles	ɛndəlɛs
enchauntour	ɛntʃantur
pesecod	pɛskɔdə
angren	anɡərən
gauger	ɡau̯dʒɛu̯r
cruelnesse	kriu̯əlnɛs
whele	ʍeːl
blamer	blaːmərə
partrich	paːrtrik
caboche	kabətʃə
sotilly	sɔtiliː
raunsonen	rau̯nsuːnən
peril	pɛril
peni	pɛniː
ende	ɛːndə
silver	silvər
game	ɡɔːmə
controllen	kɔntrɔlən
awles	aɣəlɛs
blosmy	blɔsmiː
fraude	frau̯də
flawme	flau̯mbə
vers	vɛrs
bordure	bɔːrdiu̯rə
douȝtines	duxtiːnɛs
edre	ɛːdɾə
alienyng	aːliɛːninɡ
napping	napinɡ
schaven	ʃaːvən
wales	waːlɛs
cifre	sifrə
cremesyn	krɛmisin
wryngyng	wrinɡinɡ
coper	kɔːpər
folliche	foːliːtʃə
antiquyte	antikwiteː
loppe	lɔpə
wrongfully	wrɔnɡfuliː
beverage	bɛvəradʒə
naylen	nɛi̯lən
gras	ɡrɛːs
answere	andswaːrə
stenchen	stintʃən
goren	ɡɔːrən
garlek	ɡaːrleːk
merveilyng	mɛrvɛi̯linɡ
lady	lavdiːə
middel	midəl
gyserne	dʒizɛrn
hosely	hɔːsliːtʃə
honyed	huniːd
that	θat
sorhed	sɔːrhɛːd
rubrich	riu̯britʃə
senevey	sɛnəvɛi̯
anteme	antɛːmə
latoun	latin
frounter	fruːntɛːr
weven	wɛːvən
fiftene	fiːvteːnə
ymage	imaːdʒə
snake	snaːkə
deluden	dɛliu̯dən
prophete	prɔfɛtə
flicche	flikə
souke	sukə
mi	mi
fle	flɛi̯x
crabbed	krabɛd
venyse	vɛnisə
lyne	liːn
chirche	tʃirətʃə
sodeyn	sudɛn
rubrich	riu̯brikə
atbresten	ætbresten
gnat	ɡnat
foreyner	fɔrnərə
drawen	drau̯ən
frosty	fɔrstiː
colt	kɔlt
synger	sinɡərə
clawen	kleːn
douve	duːə
coler	kɔləriːə
material	matɛriaːl
moneyour	muniu̯r
potable	pɔtaːbəl
sleight	slixt
merveilous	mɛrvɛi̯luːs
ryal	rɛːal
knytten	knɛtən
chaucer	tʃau̯sər
commendably	kumɛndaːbliː
delven	dɛlvən
cristemasse	krismɛs
lesarde	lɛzard
frountel	fruntɛːl
ye	jeː
alienat	aːliənaːt
chalenge	kalɛndʒə
corde	kɔrdə
angwischen	anɡui̯ʃən
surgien	surdʒiən
gernet	ɡɛrnɛt
hewe	hiu̯
wile	wiːlə
conquest	kɔnkwɛstə
grashope	ɡɛrshɔpə
coker	kɔːkər
bonwort	bɔːnwurt
bole	bɔːlə
obligen	ɔblɛːdʒən
sugre	siu̯ɡər
sweryng	swɛːrinɡ
braynles	brɛi̯nlɛːs
caboche	kabɔtʃə
baptistery	baptiːstɛːriːə
trippere	tripər
tablet	taːbələtə
venquysshen	vɛnkusən
douȝty	dɔxtiː
delitabilite	dɛliːtabəliteː
waken	waːkən
wrongful	rɔnɡful
paper	paːpɛr
flawmy	flau̯miː
werreour	wɛriɛːr
bildyng	byldinɡ
jelous	dʒɛːluːs
rot	rɔːt
hosynge	hɔːzinɡ
fumerelle	fiu̯mɛrələ
fou	fɔu̯x
sooty	soːtiː
avisioun	avizjun
swarm	swɛrm
nombre	numbrə
thresshere	θrɛʃərə
povre	pɔvrə
schyne	ʃiːnə
slidery	slidriː
jude	dʒiu̯deː
bynde	biːndə
norturen	nurtiu̯rən
hery	hɛːriː
horstaile	hɔrstɛi̯l
oon	ɔːn
coynyng	kui̯ninɡ
thridde	θridə
drerily	dreːrəliː
quaken	kwaːkən
ymageour	imaːdʒur
floteren	flɔtərən
facioun	fasun
elne	ɛln
crane	kraːnə
frossh	frɔʃ
sotie	sɔtiːə
raunsoner	ransuːnərə
horscomb	hɔrskɔmb
nap	nap
asshen	ɛʃən
ȝoken	jɔːkən
thyckfolde	θikfald
yvory	iːvɛːrə
violently	viːəlɛntliː
felawshipen	fɛlɔu̯ʃipən
nature	naːtiu̯r
belden	bɛːldən
roobukke	rɔːbuk
crowen	krɔu̯ən
comaundour	kumau̯nduːr
general	dʒɛnəraːl
colerik	kɔlərik
commendacioun	kɔmɛndaːsjuːn
lollen	lollen
envenemyng	ənvɛniminɡ
kitoun	kitun
helmet	hɛlmit
outwardes	uːtwaːrdəs
fumygacioun	fiu̯miɡaːsjun
fifte	fifθə
hornepipe	hɔrnpiːpə
hostel	hɔstɛi̯l
capitainship	kapətinʃipə
mased	maːzd
noumbringe	numbərinɡ
schulderyng	ʃuldərinɡ
creacion	krɛːaːsjun
vambrace	vantbraːsə
roialme	rɔi̯m
capitainship	kaːpətɛi̯nəʃipə
acqueren	akwɛːrən
fredom	frøːdoːm
thre	θreː
fynche	fintʃ
toller	tɔlɛrə
lond	land
rotennesse	rɔːtənnɛs
pen	pɛn
theft	θeːft
suture	siu̯tiu̯rə
pathen	paːθən
myght	mixt
code	kudə
gretnesse	ɡrɛːtnɛs
prestly	preːstliː
poul	puːl
drane	draːnə
hostiler	hɔːstilər
noumbren	nuːmərən
souken	suːkən
rebelnes	rɛbɛlnɛs
fesaunt	fɛːzau̯nt
neve	nɛːfə
science	siːɛnsə
withdelen	wiθdɛːlen
evildoer	iːvəlduːə
belde	bɛːldə
robe	rɔbə
hasard	hazard
þurs	θris
deyen	diːən
dumb	dumb
shirreve	ʃiːreːvə
bisne	bizən
straw	strɑː
barnhede	barnhɛːd
narwenesse	narɔu̯nɛs
and	ɛn
dayly	dɛiliː
strete	streːt
lavender	lavəndeːr
rodde	rɔd
bonde	bɔːndə
panterere	pantərərə
raton	ratuːn
whynne	xʍin
madli	madliːtʃə
ratte	rat
clyf	kleːv
snewen	sniu̯ən
sorinesse	sɔːriːnɛs
visioun	vizjuːn
feture	fɛːtiu̯rə
parisshen	pariʃiən
breid	breːdə
usual	iu̯zuaːl
pisse	piʃə
grippe	ɡriːpə
tuskyd	tuskɛd
greable	ɡreːaːbəl
frendman	freːndman
swathel	swaːðəl
foreyn	furin
chalis	kalisə
wollen	wulən
seen	søːn
tymeful	tiːmful
peple	piu̯pəl
tusky	tuskiː
slidery	slidəriː
bladdre	blɛːdər
tenoun	tɛnun
rerer	reːrərə
norisshyng	nuriʃinɡ
dee	dɛi̯
tofore	toːfɔːrə
mery	mɛriːə
bisne	biːznə
savely	saːvəliː
masse	masə
lavour	laːvuːr
panterere	pantələrə
oystre	ɔstreːə
dombenesse	dumbnɛs
blameable	blaːməaːbəl
sevenyght	sɛvənnixt
sermonen	sarmunən
selly	sɛliː
benedicite	bɛnədisiteː
surgien	surdʒin
sowryng	sɔːrinɡ
helme	hɛlmə
schaft	ʃapθ
bathe	baːðən
game	ɡaːmən
barge	bardʒə
trumpet	trumpɛt
obligen	ɔbliːdʒən
thorn	θɔrn
palmer	palmərə
enserching	ənsɛːrtʃinɡ
garth	ɡarθ
fusen	fuːzən
quern	kwɛrn
pocioun	pɔsjuːn
mund	muːnd
botoun	butun
warnen	warnən
fige	fiɡə
patyn	patiːn
swete	sweːtə
odly	ɔdliː
frere	friːrə
ryver	rivər
whanne	ʍɛnə
tyme	tiːm
sevenþe	sɛːvəðə
path	pɛθ
swalwe	swaluːə
letuse	lɛtusə
patene	patɛi̯nə
moistnes	mɔi̯stənɛs
breydynge	brɛi̯dinɡ
erchebyschopryke	ɛrtʃəbiʃəpriːtʃə
narwen	nariu̯ən
band	baːnd
nimphe	nimfə
knotted	əknɔtəd
glorious	ɡlɔːrius
lavour	laːvur
slideren	sliðərən
ratoner	ratunərə
lyoun	liːuːn
gest	ɡɛst
brevely	breːvəliːtʃə
gandre	ɡandrə
norturely	nurətiu̯rliː
quaschen	kwasən
ymagynen	imaːdʒinən
usual	iu̯ziu̯aːl
magnes	maɡnɛs
recomaunden	rɛkumau̯ndən
amiral	amiral
snowen	snɔu̯ən
resisten	rɛsistən
crowen	krɑu̯ən
vers	fɛrs
nighte	nixt
sotliche	sɔtliːtʃə
shryvyng	ʃriːvinɡ
tinder	tindər
swernes	swɛːrnɛs
yis	jɛs
yvel	ɛvələ
tung	tunɡ
flet	flɛt
bordcloth	bɔːrdklɔːθ
mewe	mɛu̯
flodegate	floːdɡaːt
endelesnes	ɛndəlɛsnɛs
parisshen	parɔtʃiən
berne	bɛrn
childissh	tʃiːldiʃ
dowarye	duːriːə
clete	kloːt
cloke	klɔːkə
golden	ɡɔːldən
berye	bɛriːə
osel	oːzlə
calf	kalfə
toilous	tɔi̯ləs
difference	difɛrɛnsə
chalengeable	tʃalɛndʒaːbəl
spewen	spiu̯ən
eighte	ɛixtə
ani	ɔniː
saunz	sau̯nz
sevenþe	sɛfθə
stynkynge	stinkinɡ
obumbren	abumbrən
camel	tʃamɛl
ere	ɛːrə
grey	ɡrɛi̯
self	sɛlf
stroken	strɔːkən
bisili	biziliː
axen	aʃən
governynge	ɡuvɛrninɡ
warderobe	waːrdərɔːpə
hungren	hɛnɡrən
band	bɔnd
eunuk	ɛu̯niu̯k
cuppeborde	kupəbɔrd
recoverer	rɛkuvərər
sliken	sliːkən
bocstaff	boːkstaf
douce	duːs
frere	freːrə
kide	kid
tyraundise	tirau̯ndiːsə
grashope	ɡrashɔpə
eiȝtthe	ɛi̯xtəðə
sutour	siu̯tər
gestour	ɡɛstuːr
laughter	lɛi̯xtər
cote	kɔːtə
quantite	kwantiteː
botnyng	boːtəninɡ
shelden	ʃiːldən
tinder	tundər
thrusche	θriʃə
secundarie	sɛkundaːriːə
musket	muskɛt
lenten	lɛntən
risshe	rɛʃ
walmore	walmɔːrə
prisoner	prizɔnər
iudeisc	juːdeːiʃ
knytten	knitən
weke	weːkə
hatrede	haːtərɛdən
brotherhede	broːðərhɔːd
calf	kalf
pleiful	plɛi̯ful
tyrauntly	tirandliːtʃə
corounen	kuruːnən
hospital	hɔspital
robbyng	rɔbinɡ
manfully	manfulliː
reys	rɛi̯sə
bischophod	biʃɔphɔːd
hakke	hakə
emperice	ɛmpərɛs
venym	vɛnəm
elvyssh	alviʃ
yerd	jɛːrd
clodred	klɔdərɛd
bordcloth	bɔrdklɔːθ
paunche	pantʃə
cleven	kliːvən
arveð	arvəðə
wight	wikt
ȝiven	jeːvən
theater	tɛːatər
ethymologie	ɛtimɔlɔdʒiː
capcioun	kapsiuːn
awe	au̯ə
spillyng	spilinɡ
lusty	lustiː
norischaunt	nurəʃant
hateliche	hatəliːtʃ
seven	søːvən
hæthendom	hɛːðəndɔm
fole	fɔːlə
omissioun	ɔmisjuːn
aray	arɛi̯
weykly	wɛi̯kliː
towayle	tuːwɛi̯lə
atbresten	ɑtbresten
cheste	tʃist
junyper	dʒiu̯nipərus
schildyng	ʃeːldinɡ
coroner	kuruneːr
savely	saːfəliː
vesper	vɛspər
grys	ɡriːs
werreyen	wɛrɛi̯ən
chaucer	tʃau̯sɛːr
speckyd	spɛkəd
rebellyng	rɛːbɛlinɡ
sive	sif
waveren	waːvərən
rerynge	rɛːrinɡ
sutour	siu̯tuːr
ape	aːpə
kiteling	kɛtəlinɡ
day	daj
ragged	raɡid
myrthe	mirxθ
lordlyng	lɔːvərdlinɡ
parde	pardɛu̯s
gate	jɛt
savely	sau̯fliː
bekenyng	bɛkəninɡ
kinestol	kinəstoːl
pirie	piriːə
alien	aːliən
lether	lɛdər
axil	aksəl
gate	ɡaːtə
partrich	pɛrtritʃ
eten	ɛːtən
tere	tɛːr
sisours	sizuːris
morter	mɔrtɛr
lordlyng	lɔːrdinɡ
viniterie	vinitɛːriːə
caleys	kalɛi̯s
governeresse	ɡuvɛrnərɛsə
patyn	patin
coroune	kruːnə
morwe	mɔrwən
strete	strɛːt
pauncher	pantʃərə
chambre	tʃau̯mbər
ought	ɔuxtə
agreable	əɡreːaːbəl
sodeynly	sudɛi̯nliːtʃə
strengthen	strɛnɡðən
cataract	katərak
folliche	foːliː
mile	miːl
þe	θɛ
bordure	buːrdərə
derk	dɛrk
buxum	buksum
sele	sɛːl
foreyner	furinərə
cristemasse	kristismasə
lyard	liːard
noumbren	numbərən
wight	wixt
almerie	aməriːə
blood	bloːd
whelebarow	ʍɛːlbarwə
hostiler	hɔːstɛːlər
tronchoun	tʃrunsuːn
erly	ɛːrliː
avisioun	avizjuːn
blomen	bloːmən
tolboth	tɔːlboːθ
knaves	knaːvis
forswerynge	fɔrswɛːrinɡ
snow	snɑu̯
vynet	vinɛt
wekely	woːkəliː
assayen	asɛi̯ən
werryng	warinɡ
develissh	deːvəliʃ
depnesse	deːpnɛs
quyksande	kwikəsɔnd
þou	tuː
either	ɛiðər
hod	hɛːd
toll	tɔl
raunsoner	rau̯nsuːnərə
murmur	murmur
supernatural	siu̯pərnatiu̯ral
herted	hɛrtid
groyn	ɡruːn
clothen	klɔːðən
tremour	trɛːmuːr
sho	ʃɔu̯x
robe	rɔːbə
grove	ɡrɑːvə
sunnenday	sunəndɛi
emperour	ɛmpəruːr
retenue	rɛtɛniu̯ə
ferthe	fiu̯rθə
shour	ʃuːr
alienat	aːliɛnaːt
questioun	kwɛstjuːn
dremyng	dreːminɡ
crudde	kurdə
alienacioun	aːliənaːsiuːn
yvel	uvəl
bakhows	baːkəhuːs
rotnesse	rɔtnɛs
whete	wɛːtə
universalite	iu̯nivɛrsaːliteː
geson	ɡɛːsən
marchal	martʃal
maker	maːkərə
evete	ɛvətə
sty	stiː
pith	piðə
berwen	bɛrwən
liven	livən
bifore	bifɔːrə
grasy	ɡrasiː
peple	piu̯plə
quenchen	kwɛntʃən
prophecien	prɔfɛsiːən
horden	hoːrdən
hospitalite	hɔspitaliteː
benygne	bɛniːnə
rote	rɔːtə
spiþre	spiːdər
argh	arɛu̯
chaundeler	tʃau̯ndələr
armurie	armuriːə
hache	hatʃeː
breiden	brɛi̯dən
six	siks
cruelheed	kriu̯ɛlhɛːd
balaunce	balansə
beverage	bɛvəraːdʒə
pissen	pisən
hod	hɑːd
syngyng	sinɡinɡ
forstage	fɔːrstaːdʒə
sodeyn	sudɛi̯n
jelousnesse	dʒɛluːsnɛs
paper	papɛr
schaft	ʃɛfθ
payen	paːən
logge	lɔɡə
eye	ɛi̯ə
gripen	ɡriːpən
douȝtily	duxtiliː
vesta	vɛsta
perre	pɛreː
aungel	aːndʒəl
trumpe	trumpə
schilder	ʃiːldər
þi	tiː
panne	panə
figer	fieːrə
lowting	luːtinɡ
wiþerwine	wiðərwinə
dint	dɛnt
schonden	ʃɔndən
knape	knaːpə
sevenyght	sɛːnixt
knotte	knɔtə
brotherhede	broːðərhɛːd
forage	fɔraːdʒə
haven	haːvən
quyksande	kwikəsand
poleyn	pulin
popehode	pɔːpəhɔːd
bisili	biziːliː
þe	θ
perilously	pɛriluːsliː
natural	naːtiu̯ral
cherne	kirn
selly	sɛliːtʃə
fiole	viːələ
provisioun	prɔviːzjuːn
childly	tʃiːldliː
vinous	viːnɔːs
erldom	ɛrldum
schaft	ʃapt
balaunce	balau̯nsə
recommendacion	rɛkumɛndaːsiun
glorious	ɡlɔːriəs
gote	ɡɔːt
flourdelis	fluːrdɛliːs
felawe	fɛlau̯ə
probleme	prɔbleːmə
ple	plɛi̯t
yvory	ɛvuːrə
rathe	raːðə
faderhode	fadərhɔːd
pro	prɔː
folye	fɔliːə
whelp	wɛlp
napyn	napən
couple	kupəl
cristemasse	krismas
forke	fɔrkə
sotil	sɔːtəl
moderwort	moːdərwurt
fass	fas
chayer	tʃaːərə
bastardie	bastardiːə
tribe	triːbu
chefly	tʃeːvəliː
locuste	lɔːkustə
whelpynge	ʍɛlpinɡ
stake	staːkə
thamarynde	tamərində
tart	tɛːrt
parable	parabəl
detty	dɛtiː
hatyng	haːtinɡ
completen	kɔmplɛːtən
prisoun	prizɔn
bolster	bɔlstər
wynnyng	wininɡ
horshelne	hɔrshɛlə
lax	laks
greet	ɡrɛːt
egerly	ɛːɡərliːtʃə
hamer	haːmər
vitailen	vitələn
kempen	kɛmpən
bonchef	bɔntʃeːf
barnhede	baːrnhɛːd
ewe	iu̯ə
hatyng	haːtunɡ
childwyte	tʃiːldwiːtə
tremour	trɛːmur
comb	kaːmb
capitain	kapətinə
exaumple	ɛɡzau̯mpəl
fo	ifɔː
þi	θiː
arghnes	arxnɛs
commendable	kɔmɛndaːbəl
staf	staːvə
massy	maseː
begreten	biɡreːtən
assethen	aseːθən
naperye	naːpɛriːə
raunsoun	ransun
webbyng	wɛbinɡ
botew	boːtɛu̯
whey	ʍɛi̯
york	jɔrk
foreyner	furɛi̯nərə
goos	ɡoːs
venemous	vɛnəmus
bat	bɔt
dele	dɛːlə
blewe	blɛuə
ale	aːlə
paleys	palɛs
cusshon	kuʃin
moisture	mɔi̯stərə
vyntener	vintinər
obligatorie	ɔbliɡatɔːriːə
origyne	ɔriɡinə
pers	pərs
latyn	laːtiːn
auntelere	au̯ntələr
grassen	ɡrisən
prophetesse	prɔfɛtɛsə
finden	findən
coignage	kui̯naːdʒə
alienacioun	aːliənaːsjun
folen	fɔːlən
thickenen	θikənən
stremer	strɛːmərə
whanne	ʍanə
madden	madən
bacoun	baːkun
bred	brɛːd
fifte	fiːftə
rebellious	rɛbɛljuːs
thefly	θeːfliː
glas	ɡlas
collusioun	kɔliu̯zjun
viniter	vinitər
pultes	pultɛs
patroun	paːtruːnə
chaundeler	tʃau̯ndəleːr
gestning	ɡɛstəninɡ
felawely	fɛlɔu̯liː
trewely	trøːwəliːtʃə
thornetre	θɔrntreː
lessoun	lɛsun
pissemyre	pisəmuːrə
smyth	smɛθ
fain	fɛi̯n
cofre	kɔfər
nave	naf
cold	kɔːld
chesteyne	tʃɛstɛi̯nə
mire	miːrə
withclosen	wiθklɔːzen
emty	ɛmptiː
fawnen	fau̯nən
pichfork	pikə̩fɔrkə
tartelet	tartəlit
mountayne	muːntɛi̯nə
syngster	sinɡəstər
doke	dukə
asshy	aʃiː
devel	deːl
dosk	dusk
eiȝtetene	ɛi̯xtəteːnə
schit	ʃitə
bot	bɔːt
emty	amptiː
aghlich	au̯əliː
champioun	tʃampiuːn
haching	hɛtʃinɡ
quayle	kwɛi̯lə
glas	ɡlɛs
abashen	abaʃən
iwin	jəwin
chalengen	tʃalau̯ndʒən
ample	ampəl
taylarde	tɛi̯lardə
lavendre	lavəndrə
thonder	θundər
horyen	hɔriən
fumous	fiu̯mɔːs
oure	uːrə
fumosite	fiu̯mɔːsiteː
chayer	tʃaːrə
lyne	liːnə
ooneyed	ɔːnɛi̯id
malencolious	mɛlənkɔːliuːs
daschen	daʃən
tronchoun	tʃruntʃən
balaunce	balau̯ntsə
hatfully	haːtfuliː
laweles	lau̯əlɛs
warwyk	warwiːk
coper	kɔpər
overfeble	ɔːvərfeːblə
rere	rɛːrə
gare	ɡɔːr
egge	ɛdʒ
astonen	astunən
eternally	ɛːtɛrnaːliː
evete	ɛftə
agreablely	aɡreːaːbəliː
hungren	hunɡrən
friday	friːdɛi
comaundement	kumau̯ndimɛnt
office	ɔfisə
egge	ɛɡ
felawe	fɛla
accidently	aksidɛntliːtʃə
wage	waːdʒə
radiche	radiʃə
frossh	frɔs
sotil	sutəl
depe	deːp
randoun	randun
maser	maːzɛːr
erthe	ɛrθə
frounter	fruntuːr
slyngen	slinɡən
stere	stɛːrə
schulderen	ʃuldərən
whelp	ʍɛlp
erle	ɛrl
þes	θeːs
wrot	wrɔt
stere	steːr
gare	ɡaːr
fumyter	fimitɛːrə
drenchen	drɛntʃən
ymaginable	imadʒinaːbəl
hornen	hɔrnən
cou	kuː
wlak	wəlak
fraudulently	frau̯diu̯lɛntliː
swartish	swartiʃ
angrynes	anɡriːnɛs
strawbery	streːbɛriːə
schiften	ʃiftən
autumpne	au̯tumnə
tylman	tilman
aken	ɔːkən
universally	iu̯nivɛrsaliː
gramer	ɡramɛi̯rə
whynne	ʍin
walet	walit
felawshipen	fɛləʃipən
schovel	ʃuːl
nowel	nɔu̯ɛl
crist	kriːst
abaten	abaːtən
secunde	sɛːkund
caboche	kabədʒə
cristen	kristən
prisoun	prizən
rebellious	rɛbɛluːs
