زرتشتی	zæɾtoʃtiː
اتصال مجازی	ettesɒːlemæd͡ʒɒːziː
هندوایرانی	hendoiːɾɒːniː
غلبه	ɢælæbe
نگران	neɡæɾɒːn
رکسانه	ɾoksɒːne
آناپا	ɒːnɒːpɒː
بزک	bæzæk
کالیفرنیم	kɒːliːfoɾniːom
ابرو	æbɾuː
استاتین	æstɒːtiːn
اشک ریختن	æʃkɾiːxtæn
كم‌گوش	kæmɡuːʃ
جوش آوردن	d͡ʒuːʃɒːvæɾdæn
چال کردن	t͡ʃɒːlkæɾdæn
سد کشیدن	sædkeʃiːdæn
صید	sæiːd
اخم	æxm
سر درآوردن	sæɾdæɾɒːvæɾdæn
مظلومیت	mæzluːmiːæt
سینه	siːne
رویه	ɾuːjæ
رحمت آوردن	ɾæhmætɒːvæɾdæn
سفارت	sefɒːɾæt
بهره‌برداری	bæhɾebæɾdɒːɾiː
بیراهه	biːɾɒːhe
مائوئیسم	mɒːʔuːʔiːsm
فر زدن	feɾzædæn
تونس	tuːnes
کراتین	keɾɒːtiːn
تکاوری	tækɒːvæɾiː
یادآوری کردن	jɒːdɒːvæɾiːkæɾdæn,jɒːdɒːvæɾiːkæɾdæn
فاز	fɒːz
شهر	ʃæhɾ
شتر	ʃotoɾ
اسحاق	eʃɒːɢ
مسیح	mæsiːh
میر	miːɾ
خوش اومدی	xoʃuːmædiː
گیر	ɡiːɾ
تو را	tuːɾɒː
ایست	est
برنجاسف	beɾend͡ʒɒːsef
متأسف‌ام	motæʔsefæm
كیف دادن	kejfdɒːdæn
آب حیات	ɒːbehejɒːt
موضوع	moʊzuː
ریمل	ɾiːmel
بوته	buːte
دلشوره	delʃuːɾe
ژورنال	ʒoɾnɒːl
کیم	kiːm
زبان آبخازی	zæbɒːnɒːbxɒːziː
الجزیره	æld͡ʒæzîɾe,æld͡ʒæziːɾe
شکمبه	ʃekæmbe
بوییدن	büjiːdæn
ماژیک	mɒːʒiːk
نگه داشتن	neɡæhdɒːʃtæn
دیرین	diːɾiːn
خشک	xoʃk
انبار مهمات	ænbɒːɾemohemmɒːt
کاما سوترا	kɒːmɒːsuːtɾɒː
گاهی	ɡɒːhiː
می‌خواست	míxɒːst
طرح کشیدن	tæɾhkeʃiːdæn
الگو زدن	olɡuːzædæn
چشم‌پزشکی	t͡ʃeʃmpezeʃkiː
مرو	mæɾv
ناسازگار	nɒːsɒːzɡɒːɾ
چاشنی	t͡ʃɒːʃniː
مدرسه	mædɾese
فناوری	fænnɒːvæɾiː
ویشنو	viːʃnuː
خویشان	xviːʃɒːn
کفتر	kæftæɾ
تهران	tehɾɒːn
فیکساتور زدن	fiːksɒːtoɾzædæn
عقد درآمدن	æɢddæɾɒːmædæn
زبان ماشین	zæbɒːnemæʃiːn
نفر	næfæɾ
چشمک	t͡ʃeʃmæk
کینه گرفتن	kiːneɡeɾeftæn
پنجر	pænd͡ʒeɾ,pænd͡ʒæɾ
شیراز	ʃiːɾɒːz
عصرانه	æsɾɒːne
احساس	ehsɒːs
گاراژ	ɡɒːɾɒːʒ
خنده زدن	xændezædæn
اولین عشق	ævvæliːneʔeʃɢ
نقطه‌ویرگول	noɢteviːɾɡuːl
پناه	pænɒːh
اسنوکر	esnuːkeɾ
تکرار کردن	tekɾɒːɾkæɾdæn
بخش	bæxʃ
برهمن	bɾæhmæn
کرایه دادن	keɾɒːjædɒːdæn
یدک کشیدن	jædækkeʃiːdæn
مرمر	mæɾmæɾ
شناختن	ʃenɒːxtæn
دل	del
آرسنیک	ɒːɾseniːk
آغوش گرفتن	ɒːɢuːʃɡeɾeftæn
اقریطس	eɢɾiːts
فاخته	fɒːxtæ
انتگرال گرفتن	ænteɡɾɒːlɡeɾeftæn
شانه کشیدن	ʃɒːnekeʃiːdæn
سه	se
سيمگون	siːmɡuːn
مهربان	mehæɾbɒːn,mehɾæbɒːn
آب سیب	ɒːbesiːb
مربع	moɾæbæ
زبر	zæbæɾ,zebæɾ
بوش	buːʃ
خواسته باشیم	xɒːstebɒːʃiːm
فریبا	fæɾiːbɒː
چهچهه	t͡ʃæht͡ʃæhe
قالیچه	ɢɒːliːt͡ʃe
جای‌گزین	d͡ʒɒːjɡoziːn
آچمز	ɒːt͡ʃmæz
جوجه	d͡ʒuːd͡ʒe
سه‌تار	setɒːɾ
چپ‌گرا	t͡ʃæpɡæɾɒː
باتنگان	bɒːtenɡɒːn
امان آمدن	æmɒːnɒːmædæn
گوز	ɡuːz
رغبت کردن	ɾeɢbætkæɾdæn
درنگ کردن	deɾænɡkæɾdæn
سرفیدن	soɾfiːdæn
امگا	omeɡɒː
بست زدن	bæstzædæn
تیزآب سلطانی	tiːzɒːbesoltæniː
قانقاریا	ɢɒːnɢɒːɾjɒː
کوریم	kuːɾiːom
خواسته بودم	xɒːstebúdæm
هماورد	hæmɒːvæɾd
تشبیه	tæʃbiːh
سرشاخه	sæɾʃɒːxe
بدهی	bedehiː
ارمغان	æɾmæɢɒːn
نقاب	neɢɒːb
کارل	kɒːɾl
بوم‌شناسی	buːmʃenɒːsiː
صدام	sæddɒːm
مکعب	mokæʔæb
ترانسیلوانیا	teɾɒːnsiːlvɒːniːjɒː
خاکزاد	xɒːkzɒːd
سرعت گری	soɾʔɒːtɡɒːɾiː
مجاور	mod͡ʒɒːveɾ
فغان	fæɢɒːn
فنلاندی	fænlɒːndiː
ترس	tæɾs
داشت می‌خواست	dɒːʃtmíxɒːst
واکس زدن	vɒːkszædæn
اقیانوسیه	oɢjɒːnuːsiːje
فرانسه	fɾɒːnse
ناله کشیدن	nɒːlekeʃiːdæn
مخاچ‌قلعه	mæxɒːt͡ʃɢælʔe
سرخ	soɾx
آشنایی دادن	ɒːʃnɒːjiːdɒːdæn
دیسال	diːsɒːl
بزودی	bezuːdiː
غیب زدن	ɢejbzædæn
قوطى	ɢuːtiː
گنجینه	ɡænd͡ʒiːne
طناب	tænɒːb
زق	zeɢ
داروساز	dɒːɾuːsɒːz
بادنجان	bɒːdend͡ʒɒːn
بریتانیای کبیر	beɾiːtɒːniːjɒːjekæbiːɾ
شمال غربی	ʃomɒːleɢæɾbiː,ʃæmɒːleɢæɾbiː
چرخ زدن	t��ʃæɾxzædæn
گرین کارت	ɡɾiːnkɒːɾt
رهبر	ɾæhbæɾ
انبار کردن	ænbɒːɾkæɾdæn
پزشک زنان	pezeʃkezænɒːn
عصا زدن	æsɒːzædæn
فعل	feʔl
سوزن زدن	suːzænzædæn
اتریش	otɾiːʃ
بیست و پنج سنتی	biːstopænd͡ʒsentiː
قاچ زدن	ɢɒːt͡ʃzædæn
برس	boɾos
یورش	juːɾeʃ,joɾeʃ
گشتن	ɡæʃtæn
اگرچه	æɡæɾt͡ʃe
لثه	lese,læse
تلاش کردن	tælɒːʃkæɾdæn
استونیائی	estuːniːjɒːʔiː
دایره کشیدن	dɒːjeɾekeʃiːdæn
نیل	niːl
پین‌یین	piːnjiːn
توله سگ	tuːlesæɡ
اشاره کردن	eʃɒːɾekæɾdæn
مارگارین	mɒːɾɡɒːɾiːn
زوزه زدن	zuːzezædæn
چرخ خوردن	t͡ʃæɾxxoɾdæn
نبض	næbz
طرفدار	tæɾæfdɒːɾ
یتیم	jætiːm
شوت	ʃuːt
شش	ʃoʃ,ʃeʃ
سیریلیک	siːɾiːliːk
تماشا	tæmɒːʃɒː
زمستان	zemestɒːn
ارقام رومی	æɾɢɒːmeɾuːmiː
شوروی	ʃuːɾæviː
مردمک	mæɾdomæk
سازه	sɒːze,sɒːzæ
نارو	nɒːɾo
سر سخت	sæɾsæxt
داستان کوتاه	dɒːstɒːnekuːtɒːh
کمی	kæmiː
هم‌جنس‌گرایی	hæmd͡ʒensɡæɾɒːjiː
پرسش	poɾseʃ
ایده	iːde
مشابه	moʃɒːbe
گریز زدن	ɡoɾiːzzædæn
جاده کشیدن	d͡ʒɒːddekeʃiːdæn
جبر	d͡ʒæbɾ
رو پوشانی	ɾuːpuːʃɒːniː
چربی	t͡ʃæɾbiː
اکتبر	oktobɾ
صرع	sæɾ
استراتفورد	estɾɒːtfoɾd
سنگسار	sænɡsɒːɾ
شبیخون	ʃæbiːxuːn
مد	mod
بقالی	bæɢɒːliː
شیردل	ʃiːɾdel
اعدام کردن	eʔdɒːmkæɾdæn
مترادف	motæɾɒːdef
خشمگین	xæʃmɡiːn
صبور	sæbuːɾ
زیاد	ziːjɒːd
گل	ɡel,ɡol,ɡol
بازیهای رایانه	bɒːziːhɒːjeɾɒːjɒːne
مهمان	mehmɒːn
خیزش	xiːzeŝ
کوکب	kouːkæb
طب سوزنی	tebbesuːzæniː
جاوی	d͡ʒɒːviː
علامت جمع	ʔælɒːmæted͡ʒæmʔ
اوکراینی	uːkɾɒːiːniː
ارائه دادن	eɾɒːʔedɒːdæn
باغ	bɒːğ,bɒːɢ
امر	æmɾ
آذری	ɒːzæɾiː
چمبر زدن	t͡ʃæmbæɾzædæn
نشین	neʃiːn
خودنمایی کردن	xodnæmɒːiːkæɾdæn
ميانه	miːjɒːne,miːjɒːnæ
کنونی	konuːniː
عذاب آمدن	æzɒːbɒːmædæn
اشتباه کردن	eʃtebɒːhkæɾdæn
هلال احمر	helɒːleæhmæɾ
اتود زدن	etuːdzædæn
بال بال زدن	bɒːlbɒːlzædæn
گردن گرفتن	ɡæɾdænɡeɾeftæn
جراحی	d͡ʒæɾɾɒːhiː
نای	nɒːj
بانگ کشیدن	bɒːnɡkeʃiːdæn
موش شبگرد	muːʃeʃæbɡæɾd
فرزند	fæɾzænd
کونی	kuːniː
تولید	touːliːd
برهنگی	beɾæhneɡiː
دیر	dejɾ,diːɾ
جدا	d͡ʒeddæn
رضایت دادن	ɾezɒːjætdɒːdæn
رامن	ɾɒːmen
ایگوانا	iːɡvɒːnɒː
بت	bot
با یک تیر دو نشان زدن	bɒːjektiːɾdoneʃɒːnzædæn
شهادت	ʃæhɒːdæt
خفتان	xæftɒːn
زبان میانجی	zæbɒːnemiːjɒːnd͡ʒiː
نیاهندواروپایی	niːjɒːhendooɾuːpɒːjiː
یخچال	jæxt͡ʃɒːl
میوآن	mjuːɒːn
آشوب	ɒːʃuːb
عاريه	ɒːɾiːje
انگلیسی آمریکایی	enɡeliːsiːjeɒːmɾiːkɒːjiː
زبان اودی	zæbɒːnuːdiː
ریاضی	ɾiːjɒːziː
چدن	t͡ʃodæn
پرگار	pæɾɡɒːɾ
بی‌معنی	biːmæʔniː
قید زدن	ɢejdzædæn
شستشو	ʃosteʃuː
پیرزن	piːɾezæn
کیف پول	kiːfepuːl
انترناسیونال	enteɾnɒːsjuːnɒːl
عنان زدن	ænɒːnzædæn
فقر	fæɢɾ
نئره	næɾe
آبستنی	ɒːbestæniː
خوره	xoɾe
شست	ʃæst
تشکیل شدن	tæʃkiːlʃodæn
تخمه	toxmæ
چهچهه کردن	t͡ʃæht͡ʃæhekæɾdæn
زیر	ziːɾ
توگوشی	tuːɡuːʃiː
رنج دادن	ɾænd͡ʒdɒːdæn
هنر	honæɾ
اقتصاد	eɢtesɒːd
حدس زدن	hædszædæn,hædszædæn
نظر خوردن	næzæɾxoɾdæn
پسند	pæsænd
ژنو	ʒenev
پدرخوانده	pedæɾxwɒːnde
مردمسالاری	mæɾdomsɒːlɒːɾiː
سوسیالیستی	sosiːjɒːliːstiː
سورینام	suːɾiːnɒːm
ببخشید	bebæxʃiːd
اطاق خواب	otɒːɢexɒːb
شیون	ʃiːvæn
بجز	bed͡ʒoz
تعلق	tæʔælloɢ
پیشین	piːʃiːn
آدامس	ɒːdɒːms
نیایش	niːjɒːjeʃ
مهاچین	mæhɒːt͡ʃiːn
وول خوردن	vuːlxoɾdæn
بهانه کردن	bæhɒːnekæɾdæn
طغیان کردن	toɢjɒːnkæɾdæn
آهوبره	ɒːhuːbæɾɾe
فلسفه اخلاق	fælsæfejeæxlɒːɢ
نابه هنگام	nɒːbehænɡɒːm
ذهن	zehn
ماهی مرکب	mɒːhiːjemæɾkæb
عقرب	ʔæɢɾæb,æɢɾæb
پادزهر	pɒːdzæhɾ
موشک	muːʃæk
باکره	bɒːkeɾe
چندک	t͡ʃondæk
پادرد	pɒːdæɾd
سده	sæde
بالا کشیدن	bɒːlɒːkeʃiːdæn
یاس شیروانی	jɒːseʃiːɾvɒːniː
هفتم	hæftom
پستاندار	pestɒːndæɾ,pestɒːndɒːɾ
قندوز	ɢonduːz
چرت زدن	t͡ʃoɾtzædæn,t͡ʃoɾtzædæn
تبخال زدن	tæbxɒːlzædæn
پس فردا	pæsfæɾdɒː
لاجورد	lɒːd͡ʒvæɾd
تصنيف هجائی	tæsniːfehed͡ʒɒːʔiː
بیل	biːl
سنگین	sænɡiːn
پخ	pæx
هفده	hefdæh,hefdæʔ
کار گروهی	kɒːɾeɡoɾuːhiː
بنانج	bænɒːnd͡ʒ
هستی	hæstiː,hæsiː
رأی	ɾɒːʔiː
دنبال	donbɒːl
کانال	kɒːnɒːl
هرچند	hæɾt͡ʃænd
حمل کردن	hæmlkæɾdæn
یقین کردن	jæɢiːnkæɾdæn
ادامه یافتن	edɒːmejɒːftæn
گلوله بستن	ɡoluːlebæstæn
فهرست پی‌گیری‌ها	fehɾestepejɡiːɾiːhɒː
آگهی دادن	ɒːɡæhiːdɒːdæn
کونگ فو	kuːnɡfuː
پوتین	puːtiːn
ساروج	sɒːɾuːd͡ʒ
بشارت دادن	beʃɒːɾætdɒːdæn
دارم می‌خواهم	dɒːɾæmmíxɒːhæm
سر کشیدن	sæɾkeʃiːdæn
آبجو	ɒːbd͡ʒoʊ,ɒːbd͡ʒo
ناگهان	nɒːɡæhɒːn
انسان	ensɒːn
بخواه	bexɒːh
گورکن	ɡuːɾkæn
شوت زدن	ʃuːtzædæn
انباشتن	ænbɒːʃtæn
برنامه	bæɾnɒːme
برجستگی	bæɾd͡ʒæsteɡiː
کشور	keʃvæɾ
راگبی	ɾɒːɡbiː
روزه	ɾozæ,ɾuːze
همدستی	hæmdæstiː
بروکسل	bɾuːksel
قطره	ɢætɾe
فراموشکاری زدن	fæɾɒːmuːʃkɒːɾiːzædæn
کتابخانه	ketɒːbxɒːne
انتقام	enteɢɒːm
پیامک زدن	pæjɒːmækzædæn
دکتر زایمان	doktoɾezɒːjemɒːn
ژئودزی	ʒeodeziː
عذرخواهی کردن	ozɾxɒːhiːkæɾdæn
فوران	fævæɾɒːn
خطاب کردن	xætɒːbkæɾdæn
ستاره داوود	setɒːɾejedævuːd
زندگی	zendeɡiː,zendæɡiː
پنجشنبه	pænd͡ʒʃænbe
جاسوسی	d͡ʒɒːsuːsiː
خیابان	xiːɒːbɒːn,xiːjɒːbɒːn
عرفانی	eɾfɒːniː
ضربه	zæɾbe
توفا	tuːfɒː
کوکاکولا	kokɒːkolɒː
دو زن داری	dôzændɒːɾiː
پسته	peste
پدر و مادر	pedæɾomɒːdæɾ,pedæɾvæmɒːdæɾ
بغداد	bæɢdɒːd
تمساح	temsɒːh
گوراسب	ɡuːɾɒːsb
ابر اورت	æbɾeuːɾt
تلاش	tælɒːʃ
جوانی	d͡ʒævɒːniː
عائله	ʔɒːʔiːle
چوب	t͡ʃuːb
بغل گرفتن	bæɢælɡeɾeftæn
جلو	d͡ʒeloʊ,d͡ʒolo,d͡ʒelo,d͡ʒeloʊ
جزجز کردن	d͡ʒezd͡ʒezkæɾdæn
داس	dɒːs
آشپز	ɒːʃpæz
بوق	buːɢ
فهرست کردن	fehɾestkæɾdæn
پس غذا	pæsɢæzɒː
رودست زدن	ɾuːdæstzædæn
عراقی	ʔeɾɒːɢiː
طلوع کردن	toluːʔkæɾdæn
سپاسگزار	sepɒːsɡozɒːɾ
گلو	ɡæluː
شمعدان	ʃæmʔædɒːn
می‌خواهم	míxɒːhæm
سپوتنیک	spuːtniːk
توگوشی زدن	tuːɡuːʃiːzædæn
بیگانه	biːɡɒːnæ,biːɡɒːne
پارکور	pɒːɾkuːɾ
دهن  دهان	dæhæn
ورق  خوردن	væɾæɢxoɾdæn
شاخ زدن	ʃɒːxzædæn
ساتور	sɒːtuːɾ
تگرگ	tæɡæɾɡ
پیانو فورته	piːɒːnofoɾte
امضا	emzɒː
پیشرفت کردن	piːʃɾæftkæɾdæn
گویان	ɡuːjɒːn
گل خوردن	ɡolxoɾdæn
پیچ‌گوشتی	piːt͡ʃɡuːʃtiː
بدرود	bedɾuːd
چوپون	t͡ʃuːpuːn
نعره	næ’ɾe
میخ زدن	miːxzædæn
قاچ	ɢɒːt͡ʃ
دهه	dæhe
نیشخند	niːʃxænd
خمپاره	xompɒːɾe
بیرون	biːɾuːn
مجارستانی	mæd͡ʒɒːɾestɒːniː
گوش	ɡuːʃ
چک زدن	t͡ʃækzædæn
پماد زدن	pomɒːdzædæn
نراد	næɾɒːd
دور انداختن	duːɾændɒːxtæn
نگاه انداختن	neɡɒːhændɒːxtæn
شبنم زدن	ʃæbnæmzædæn
آدیس آبابا	ɒːdiːsɒːbɒːbɒː
گذر کردن	ɡozæɾkæɾdæn
روشنک	ɾoʊʃænæk
برمه‌ای	beɾmeʔɒːjiː
آبجو زدن	ɒːbd͡ʒozædæn
تمام کردن	tæmɒːmkæɾdæn
آبخازیه	ɒːbxɒːziːje
پرواز دادن	pæɾvɒːzdɒːdæn
سرمایه‌گذاری کردن	sæɾmɒːjeɡozɒːɾiːkæɾdæn
تلمبه	tolombe
کمردرد	kæmæɾdæɾd
نیمسال تحصیلی	niːmsɒːltæhsiːliː
بالکن	bɒːlkon
آب‌سنگ	ɒːbsænɡ
م‍ﮩ‍ر	mohoɾ
سیم	siːm
رستاخیز شدن	ɾæstɒːxiːzŝodæn
چاک زدن	t͡ʃɒːkzædæn
تشکیل دادن	tæʃkiːldɒːdæn
گوجه فرنگی	ɡod͡ʒefæɾænɡiː
میکال	miːkɒːl
دلو	dæluː
من	mæn
المپیک	olæmpiːk
ژامبون	ʒɒːmbon
پیوند زدن	pejvændzædæn
ناخوشی زدن	nɒːxoʃiːzædæn
تاسیس کردن	tæʔsiːskæɾdæn
مس	mes
چهار گوش	t͡ʃæhɒːɾɡuːʃ
هاوائ	hævɒːiː
مجازات کردن	mod͡ʒɒːzɒːtkæɾdæn
گرفت	ɡeɾeft
پشه	pæʃe
روبل	ɾuːbl
آذرخش	ɒːzæɾæxʃ
نیشگون	niːʃɡuːn
جادوی سیاه	d͡ʒɒːduːjesiːjɒːh
ارابه	æɾɾɒːbe,æɾɒːbe
زلزله‌شناسی	zelzeleʃenɒːsiː
زجر کشیدن	zæd͡ʒɾkeʃiːdæn
رایانه	ɾɒːjɒːne
مانند	mɒːnænd
روسیه	ɾuːsiːje
فردا	fæɾdɒː
آموختن	ɒːmuːxtæn
ارشاد کردن	eɾʃɒːdkæɾdæn
فروزان	fɾuːzɒːn
عصا	æsɒː
تن دادن	tændɒːdæn
کیمیا	kiːmiːjɒː
روح	ɾuːh
شهمات	ʃɒːhmɒːt
فلوت	fluːt
زبان آمدن	zæbɒːnɒːmædæn
متشکرم	moteʃækeɾæm
سرباز نیزه‌دار	sæɾbɒːzenejzedɒːɾ
پوست بیضه	puːstebejze
شرکت کردن	ʃeɾkætkæɾdæn
پیشکش	piːʃkæʃ,piːʃkeʃ
ختم شدن	xætmʃodæn
یادآوری	jɒːdɒːvæɾiː
توکان	tuːkɒːn
رقّاص	ɾæɢɢɒːs
جرمن شپرد	d͡ʒæɾmænʃepæɾd
تاکید	tæʔkiːd
تلگراف	teleɡɾɒːf
پخش شدن	pæxʃʃodæn
یائسگی	jɒːeseɡiː
ترکی عثمانی	toɾkiːjeʔosmɒːniː
کناره گیری	kenɒːɾeɡiːɾiː
واکسن کردن	vɒːksænkæɾdæn
خارگیل	xɒːɾɡiːl
اقرار کردن	eɢɾɒːɾkæɾdæn
اسرائیلی	esɾɒːʔiːliː
زرّافه	zæɾɾɒːfe
سی‌دی	siːdiː
دشنام	doʃnɒːm
لاک زدن	lɒːkzædæn
بخاری	boxɒːɾiː
مرسی	meɾsiː
سر زدن	sæɾzædæn
دمبل زدن	dæmbelzædæn
چمپداک	t͡ʃæmpædɒːk
سراغ	soɾɒːɢ
چرک	t͡ʃoɾæk,t͡ʃeɾk
خواستند	xɒːstænd
انگيختار	ænɡiːxtɒːɾ
الان	ælɒːn
بلوز	boluːz,bluːz
موتورسیکلت	motoɾsiːklet
ساعت یک و نیم	sɒːʔætjekoniːm
دیگ به دیگ می‌گه روت سیاه	diːɡbediːɡmiːɡeɾuːtsiːjɒːh
نوزده	nuːzdæh
جاوه	d͡ʒɒːve
عقل	æɢæl
پی	piː,pej
اصابت کردن	esɒːbætkæɾdæn
حل کردن	hælkæɾdæn,hællkæɾdæn
گاز گرفتن	ɡɒːzɡeɾeftæn
باور دادن	bɒːvæɾdɒːdæn
که	ke,kæh,koh
نصب	næsb
دخالت	dexɒːlæt
داغ خوردن	dɒːɢxoɾdæn
مجاری	mæd͡ʒɒːɾiː
روغن زدن	ɾoʊɢænzædæn
تجویز	tæd͡ʒviːz
پسر برادر	pesæɾebæɾɒːdæɾ
ناف	nɒːf
قهقهه زدن	ɢæhɢæhezædæn
چپق	t͡ʃopoɢ
رنگارنگ	ɾænɡɒːɾænɡ
خط کشیدن	xætkeʃiːdæn
رقص عربی	ɾæɢsʔæɾæbiː
دست اره	dæstæɾɾe
اسکوپیه	iːskopiːjæh
دخپسر	doxpesæɾ
هواپيما	hævɒːpejmɒː
تعیین	tæʔiːn
رقم	ɾæɢæm
خواسته	xɒːste
همدستی در جرم	hæmdæstiːdæɾd͡ʒoɾm
رودست	ɾuːdæst
دونقطه	donoɢte
تحریم‌	tæhɾiːm
آخور	ɒːxoɾ
نامزدن	nɒːmzædæn
امروز صبح	emɾuːzsobh
سپاس	sepɒːs
قیماغ	ɢejmɒːɢ
طاعون	tɒːʔuːn
ادراری	edɾɒːɾiː
شهریور	ʃæhɾiːvæɾ
برچسب	bæɾt͡ʃæsb
ماجورو	mɒːd͡ʒoɾo
پر دادن	pæɾdɒːdæn
سرمه‌ای	soɾmejiː
خیانت کردن	xiːɒːnætkæɾdæn
بلروسى	belæɾuːsiː
دورواژ	duːɾvɒːʒ
وجد	væd͡ʒd
چانه	t͡ʃɒːne
نتیجه	nætiːd͡ʒe
پرسپولیس	peɾspoliːs
انرژی هسته‌ای	eneɾʒiːjehæsteʔiː
ابلاغ	eblɒːɢ
پس گردنی	pæsɡæɾdæniː
مؤدب	moʔæddæb
ناله	nɒːle,nɒːlæ
آسیب رسیدن	ɒːsiːbɾesiːdæn
بی‌خیالی زدن	biːxiːjɒːliːzædæn
بژ	beʒ
ادویه زدن	ædviːjezædæn
کسل کننده	keselkonænde
فرودگاه	foɾuːdɡɒːh
مکیدن	mækiːdæn
شاه‌بلوط	ʃɒːhbæluːt
قوزک پا	ɢuːzækepɒː
چچنی	t͡ʃet͡ʃeniː
نی زدن	nejzædæn
عیسی مسیح	ʔiːsɒːmæsiːh
مچ	mot͡ʃ
بمب زدن	bombzædæn
سپهر	sepehɾ
خواب زدن	xɒːbzædæn
موژیک	muːʒiːk
بازی گرفتن	bɒːziːɡeɾeftæn
مالت	mɒːlt
لاندا	lɒːndɒː
پروتون	pɾuːtuːn
مات	mɒːt
جزجز زدن	d͡ʒezd͡ʒezzædæn
شنا کردن	ʃenɒːkæɾdæn
پیاله	piːɒːle
چنبر زدن	t͡ʃænbæɾzædæn
تمرین کردن	tæmɾiːnkæɾdæn
خودنویس	xodneviːs
بازی	bɒːziː
اسقف	osɢof
آذربایجانی	ɒːzæɾbɒːjd͡ʒɒːniː
نقاشی	næɢɢɒːʃiː
فقیر	fæɢiːɾ
آوریل	ɒːvɾîl
کاروان‌سرا	kɒːɾvɒːnsæɾɒː
دلداده	deldɒːde
آمیزش	ɒːmiːzeʃ
محاصره شدن	mohɒːseɾeʃodæn
پشتو	pæʃto
جواب	d͡ʒævɒːb
ساعت یک و ربع	sɒːʔætjekoɾobʔ
اسرائیل	esɾɒːʔiːl
پيش شرط	piːʃʃæɾt
قلمه خوردن	ɢælæmexoɾdæn
لبی	læbiː
اوردن	ovoɾdæn
قاپ	ɢɒːp
بلوف	bolof
قیمق	ɢejmæɢ
اتازونی	etɒːzuːniː
ژاکت	ʒɒːket
مایع	mɒːjeʔ
تبلیغ	tæbliːɢ
مهر خوردن	mohɾxoɾdæn
شیرجه	ʃiːɾd͡ʒe
هرازدان	heɾɒːzdɒːn
اقلیم‌شناسی	eɢliːmʃenɒːsiː
مسیحی	mæsiːhiː
حسابدار	hesɒːbdɒːɾ
آلاسکا	ɒːlæskæ
امتحان دادن	emtehɒːndɒːdæn
حس	hes
ترکی	toɾkiː
ساموآ	sɒːmoɒː
عوض شدن	ævæzʃodæn
ترسو	tæɾsuː
باریدن	bɒːɾiːdæn
تخم‌دان	toxmdɒːn
بلن کردن	bolænkæɾdæn
کاست	kɒːst
وضو	vozuː
یا	jɒː
حمام	hæmmɒːm
حزب	hezb
وزن کردن	væznkæɾdæn
کمان زنبورکی	kæmɒːnezænbuːɾækiː
خرج شدن	xæɾd͡ʒʃodæn
برگزیده	bæɾɡoziːde
فراموشی زدن	fæɾɒːmuːʃiːzædæn
تسکین	tæskiːn
ورزشگاه	væɾzeʃɡɒːh
بادبان	bɒːdbɒːn
صفت برترین	sefætebæɾtæɾiːn
آشپزی	ɒːʃpæziː
یاکوتسک	jækuːtsk
کارناوال	kɒːɾnɒːvɒːl
عرش	ʔæɾʃ
جهان	d͡ʒæhɒːn
لب گرفتن	læbɡeɾeftæn
قایق اژدها	ɢɒːjeɢeʒdehæ
زنبور زدن	zænbuːɾzædæn
کیسه بیضه	kiːsejebejze
بیدار کردن	biːdɒːɾkæɾdæn
اسلامی	eslɒːmiː
ترسناک	tæɾsnɒːk
بی‌شمار	biːʃomɒːɾ
معجزه	moʔd͡ʒeze
نژادپرستی	neʒɒːdpæɾæstiː
سازدهنی زدن	sɒːzdæhæniːzædæn
دریاچهٔ مازندران	dæɾjɒːt͡ʃejiːmɒːzændæɾɒːn
مقعد	mæɢʔæd
الکترونی	elekteɾoniː
فاصله مجازی	fɒːselejemæd͡ʒɒːziː
رستاخیز	ɾæstɒːxiːz
شما را	ʃomɒːɾɒː
چنگك	t͡ʃænɡæk
تلافی	tælɒːfiː
گواوا	ɡvɒːvɒː
قوس	ɢoʊs
نیمه‌عمر	niːmeʔomɾ
گول خوردن	ɡuːlxoɾdæn
تغییرمسیر	tæɢjiːɾemæsiːɾ
رده بندی	ɾædebændiː
آتش‌فشان	ɒːteʃfeʃɒːn
ادامه دادن	edɒːmedɒːdæn
ارتداد	eɾtedɒːd
گرگینه	ɡoɾɡiːne
ژاپنی	ʒɒːponiː
تخته نرد زدن	tæxtenæɾdzædæn
فندک	fændæk
شاهکار	ʃɒːhkɒːɾ
درونی	dæɾuːniː
جر	d͡ʒeɾ
رنگ زدن	ɾænɡzædæn
مارکس	mɒːɾks
هیجده	hiːd͡ʒdæh
ویتنام	viːjætnɒːm
جلق زدن	d͡ʒælɢzædæn
بر داشتن	bæɾdɒːʃtæn
پشه زدن	pæʃezædæn
جناس	d͡ʒenɒːs
بربخ	bæɾbæx
خیابان زدن	xiːɒːbɒːnzædæn
شوهرعمه	ʃoʊhæɾæmme
تغییر کردن	tæɢʔiːɾkæɾdæn
زلاند جدید	zelɒːnded͡ʒædiːd
بارود	bɒːɾuːd
استاندارد	estɒːndɒːɾd
بسنده	bæssænde
تحمل	tæhæmmol
پاک کردن	pɒːkkæɾdæn
کیر	kiːɾ
تصاحب	tæsɒːhob
عزیز	æziːz,ʔæziːz
آشتی دادن	æʃtiːdɒːdæn
غش و ضعف	ɢæʃozæʔf
سقف	sæɢf
اینجا	iːnd͡ʒɒː
خلیفه	xæliːfe
درخشان	dɾæxʃɒːn,deɾæxʃɒːn
دریای مازندران	dæɾjɒːjemæzændæɾɒːn,dæɾjɒːjemɒːzændæɾɒːn
پساانسان	pæsɒːensɒːn
حیدرآباد	hejdæɾɒːbɒːd
مادرجد	mɒːdæɾd͡ʒædd
جوهر نمک	d͡ʒouːhæɾenæmæk
دیده‌بان	diːdebɒːn
به یاد آوردن	bejɒːdɒːvæɾdæn
یاد افتادن	jɒːdoftɒːdæn
روستا	ɾuːstɒː
بغل کردن	bæɢælkæɾdæn
سامانه خورشیدی	sɒːmɒːnexuːɾʃiːdiː
کاشته	kɒːʃte
سپتامبر	septɒːmbɾ
مادربزرگ	mɒːdæɾbozoɾɡ
دامن	dɒːmæn
موس	moʊs,muːs
قلب	ɢælb
نرمهٔ گوش	næɾmejeɡuːʃ
انباره	ænbæɾe
امان	æmɒːn
سقیط	sæɢiːt
آژانس ازدواج	ɒːʒɒːnsezdevɒːd͡ʒ
زنگبار	zænɡebɒːɾ
خود آوردن	xodɒːvæɾdæn
ازدواج	ezdevɒːd͡ʒ
آدرس	ɒːdɾes
دق آمدن	deɢɒːmædæn
شناریدن	ʃenɒːɾiːdæn
سفتر	seftæːɾ
خواهند خواست	xɒːhændxɒːst
هادسون	hɒːdsuːn
نه	noh,næh,næ
مرکز	mæɾkæz
دستور گرفتن	dæstuːɾɡeɾeftæn
گسترده	ɡostæɾde
آخ	ɒːx
انبار شدن	ænbɒːɾʃodæn
اختلاط کردن	extelɒːtkæɾdæn
لرزیدن	læɾziːdæn
لیموترش	liːmuːtoɾʃ
گمانه	ɡomɒːne
خاله‌زاده	xɒːlezɒːde
صبحانه	sobhɒːne
ماشین حساب	mɒːʃiːnehesɒːb
چوپان	t͡ʃuːpɒːn
تبریز	tæbɾiːz
محاصره گرفتن	mohɒːseɾeɡeɾeftæn
بازگو کردن	bɒːzɡuːkæɾdæn
نقش کشیدن	næɢʃkeʃiːdæn
بله	bæle
سپر	sepæɾ
دوک	duːk
حق زدن	hæɢɢzædæn
پوما	puːmɒː
چکرز	t͡ʃekeɾz
هخامنشیان	hæxɒːmæneʃiːɒːn
تخته زدن	tæxtezædæn
ژاله	ʒɒːle
سقلمه	soɢolme
بی‌مغز	biːmæɢz
اسلحه گرم	æslæheɡæɾm
لنز	lenz
برس کشیدن	boɾoskeʃiːdæn
کم صدا	kæmsedɒː
الف	ælef
آمو دریا	ɒːmuːdæɾjɒː
مگس انگبین	mæɡæsænɡæbiːn
کارفرما	kɒːɾfæɾmɒː
بانگ	bɒːnɡ
آغوش کشیدن	ɒːɢuːʃkeʃiːdæn
گران	ɡeɾɒːn
بدبختی کشیدن	bædbæxtiːkeʃiːdæn
ترخانه	tæɾxɒːnæ
لعنتی	læʔnætiː
انجیل	end͡ʒiːl
هفته	hæfte
آقا	ɒːɢɒː,ɒːĝɒː
بیوشیمی	biːoʃiːmiː
گشتاپو	ɡestɒːpuː
بوتان	buːtɒːn
تعارف کردن	tæʔɒːɾofkæɾdæn
دیسک سخت	diːskesæxt
رختخواب	ɾæxtexɒːb
ادعا	eddeʔɒː
آذربایجان	ɒːzæɾbɒːjed͡ʒɒːn,ɒːzæɾbɒːjd͡ʒɒːn
کاهو	kɒːhuː
نافرمان	nɒːfæɾmɒːn
ماشین‌حساب	mɒːʃiːnhesɒːb
استراحت کردن	esteɾɒːhætkæɾdæn
پیرانا	piːɾɒːnɒː
ساعد	sɒːed
کیف زدن	kiːfzædæn
نیروگاه	niːɾuːɡɒːh
چرکس	t͡ʃæɾkæs
آجر	ɒːd͡ʒoɾ
زشت	zeʃt
بافتن	bɒːftæn
دست آوردن	dæstɒːvæɾdæn
قوم	ɢoʊm
ایمیل	iːmejl
خاموشی	xɒːmuːʃiː
دایرةالمعارف	dɒːjeɾætolmæʔɒːɾef
کرایه	keɾɒːjæ
سوراخ کون	suːɾɒːxekuːn
برگشت خوردن	bæɾɡæʃtxoɾdæn
سوهان کردن	sohɒːnkæɾdæn
مرجان	mæɾd͡ʒɒːn
دلارام	delɒːɾɒːm
هیدرولیکی	hiːdɾoliːkiː
علم اخلاق	ʔelmeæxlɒːɢ
توندرا	tuːndɾɒː
اسپانیایی	espɒːniːjɒːiː
اجاق	od͡ʒɒːɢ
پارک	pɒːɾk
گچ	ɡæt͡ʃ
کفتار	kæftɒːɾ
عبادت کردن	ʔebɒːdætkæɾdæn
مستاجر	mostɒːʔd͡ʒeɾ
سرنا	soɾnɒː
کفش‌دوزک	kæfʃduːzæk
کارگر	kɒːɾɡæɾ
مؤلف	moʔællef
تسلیم شدن	tæsliːmʃodæn
شرکت	ʃeɾkæt
دسر	deseɾ
الاغ	olɒːɢ
سقط	seɢt
بیان	bæjɒːn,bejɒːn
هاشور زدن	hɒːʃuːɾzædæn
چون	t͡ʃon,t͡ʃuːn
یانگتسه	jænɡtse
شوارزنگر	ʃvɒːɾzeneɡeɾ
اسب	æsb
سراب	sæɾɒːb
کردستان	koɾdestɒːn
یوز	juːz
دال سیاه	dɒːlesiːjɒːh
جمهوری اسلامی ایران	d͡ʒomhuːɾiːjeeslɒːmiːjeiːɾɒːn
هشتسد	hæʃtsæd
آشور	ɒːʃuːɾ
بیتلز	biːtlz
دلربا	delɾobɒː
خبر	xæbæɾ
آستریکس	ɒːsteɾjks
بازگو	bɒːzɡuː
به دنیا آوردن	bedonjɒːɒːvæɾdæn
عجله کار شیطان است	æd͡ʒælekɒːɾeʃejtɒːnæst
تمشک	tæmeʃk
قدم	ɢædæm
چاه زدن	t͡ʃɒːhzædæn
هزارپا	hezɒːɾpɒː
شوان	ʃævɒːn,ʃovɒːn
حفظ شدن	hefzʃodæn
پست هوائی	posthævɒːjiː
بورس	buːɾs
سرور	soɾuːɾ,sæɾvæɾ
حماقت زدن	hemɒːɢætzædæn
فاکس	fɒːks
گمان 	ɡomɒːn
عطسه گرفتن	ætseɡeɾeftæn
خداحافظی کردن	xodɒːhɒːfeziːkæɾdæn
شاه‌دانه	ʃɒːhdɒːne
آواشناسی	ɒːvæʃenɒːsiː
اره كردن	æɾɾekæɾdæn
کورسو	kuːɾsuː
توافق	tævɒːfoɢ
هزاره	hezɒːɾe
سرانجام	sæɾænd͡ʒɒːm
بیمناک	biːmnɒːk
روايت	ɾævɒːjæt
عشق‌بازی	eʃɢbɒːziː
نشیمن	neʃiːmæn
تاب	tɒːb
نام‌واژه	nɒːmvɒːʒe
مشنگ	mæʃænɡ
هدایت	hedɒːjæt
اذان	æzɒːn
بست	bæst
ریتم	ɾiːtm
برلوسکونی	beɾluːskuːniː
منگنه	mænɡæne
اس ام اس	esemes,esemes
خوشحال	xoʃhɒːl
تاریک	tɒːɾiːk
تماس گرفتن	tæmɒːsɡeɾeftæn,tæmɒːsɡeɾeftæn
هوار زدن	hævɒːɾzædæn
پل	pol
پرث	peɾs
حرص زدن	heɾszædæn
مهندس	mohændes
شورش کردن	ʃuːɾeʃkæɾdæn
مرخصی	moɾæxxæsiː
چیز	t͡ʃiːz
موشک خوردن	muːʃækxoɾdæn
گپيدن	ɡæpiːdæn
دولت اسرائیل	douːlæteesɾɒːʔiːl
چشیدن	t͡ʃeʃiːdæn
لالمونی	lɒːlmuːniː
جار	d͡ʒɒːɾ
دندان زدن	dændɒːnzædæn
تخته‌پاک‌کن	tæxtepɒːkkon
جمله‌شناسی	d͡ʒomleʃenɒːsiː
نورنبرگ	nuːɾænbeɾɡ
مرض	mæɾæz
هماهنگ	hæmɒːhænɡ
چمبر	t͡ʃæmbæɾ
پنیر	pæniːɾ
زرشک	zeɾeʃk
کانی	kɒːniː
روش علمی	ɾæveʃeelmiː
لاک‌پشت	lɒːkpoʃt
نیتریک اسید	niːtɾiːkæsiːd
واژگان	vɒːʒeɡɒːn
چراغ زدن	t͡ʃeɾɒːɢzædæn
روایت شدن	ɾævɒːjætʃodæn
سود سهام	suːdesæhɒːm
خرید کردن	xæɾiːdkæɾdæn
شاهد	ʃɒːhed
جانورشناسی	d͡ʒɒːnvæɾʃenɒːsiː
دق	deɢ
بهانه گرفتن	bæhɒːneɡeɾeftæn
کرنر زدن	koɾneɾzædæn
جستجو کردن	d͡ʒostod͡ʒuːkæɾdæn,d͡ʒosted͡ʒuːkæɾdæn
نفوس بد	nofuːsebæd
زمینی‌سازی	zæmiːniːsɒːziː
نخستین	noxostiːn
کمردرد زدن	kæmæɾdæɾdzædæn
مو	mo,muː
شمالگان	ʃomæleɡɒːn
برفک	bæɾfæk
زردچوبه	zæɾdt͡ʃuːbe
گرفتن	ɡeɾæftæn,ɡeɾeftæn
درصد	dæɾsæd
بوفالو	buːfɒːlo
انیمی	æniːme
ماگاس	mɒːɡɒːs
عذاب	æzɒːb
تعظیم کردن	tæʔziːmkæɾdæn
دردسر	dæɾdesæɾ
ملخ زدن	mælæxzædæn
پنج‌شنبه	pænd͡ʒʃænbe
چگونه	t͡ʃeɡuːne
برن	beɾn
استونی	estuːniː
بیدار شدن	biːdɒːɾʃodæn
زنبور عسل	zænbuːɾeʔæsæl,zænbuːɾeæsæl
ابا	æbɒː
پسرعمو	pesæɾæmuː,pesæɾʔæmuː
باز	bɒːz
اجماع	ed͡ʒmɒːʔ
دیرتر	diːɾtæɾ
راننده	ɾɒːnænde
آب کردن	ɒːbkæɾdæn
میمون	mejmuːn
تضاد	tæzzɒːd
بغل	bæɢæl
عنبر	ʔænbæɾ
بانو	bɒːnuː
شامپو زدن	ʃæmpuːzædæn
وضعیت	vædiːjet
مخفی	mæxfiː
الله	ællɒːh
امپریالیسم	æmpeɾiːjɒːliːsm
بال بال	bɒːlbɒːl
سرکرده	sæɾkæɾde
غریبه	ɢæɾiːbe
حركت دادن	hæɾekætdɒːdæn
هش	hæʃ
آفتاب‌پرست	ɒːftɒːbpæɾæst
گفته شدن	ɡofteʃodæn
مبهم	mobhæm
جشن	d͡ʒɒːʃn
هوشمند	huːʃmænd,huːŝmænd
کوبا	kuːbɒː
شتک	ʃætæk
این ماه	iːnmɒːh
خط زدن	xætzædæn
یاد دادن	jɒːddɒːdæn,jɒːddɒːdæn
مالدیو	mɒːldiːv
آتش‌بس	ɒːtæʃbæs
بشارت	beʃɒːɾæt
طرز فکر	tæɾzefekɾ
زانو زدن	zɒːnuːzædæn
حواجه‌زاده	xɒːd͡ʒezɒːde
تحول	tæhævvol
شخم	ʃoxm
قمار	ɢomɒːɾ
محو کردن	mæhvkæɾdæn
تعریف	tæʔɾiːf
دارکوب	dɒːɾkuːb
نیک	niːk
افیون	æfjuːn
صفحه اصلی	sæfhejeæsliː
نارنگ	nɒːɾenɡ,nɒːɾænɡ
نوین	noviːn
دستور دادن	dæstuːɾdɒːdæn
تصدیق	tæsdiːɢ
فیلم ترسناک	fiːlmetæɾsnɒːk
بندباز	bændbɒːz
پیچ زدن	piːt͡ʃzædæn
پرونده	pæɾvænde
تونل کشیدن	tuːnelkeʃiːdæn
فضانورد	fæzɒːnævæɾd
حزب‌الله	hezbollɒːh
جعبه	d͡ʒæʔbe
فوریه	fevɾiːje
عقب زدن	æɢæbzædæn
بخارا	boxɒːɾɒː
درستی	doɾostiː
بنگاه تجاری	bonɡɒːheted͡ʒɒːɾiː
کعبه	kæʔbe
تبسم	tæbæssom
آلومینیم	ɒːluːmiːniːjom
بخواهند	bexɒːhænd
روز پیروزی	ɾuːzepiːɾuːziː
مشام زدن	mæʃɒːmzædæn
استارباکس	estɒːɾbɒːks
گره زدن	ɡeɾehzædæn
چکش	t͡ʃækoʃ
لاس	lɒːs
شاد	ŝɒːd
سنباده	sombɒːde
اتاق گاز	otɒːɢeɡɒːz
مشکل	moʃkel
هیمه	hiːmæ
پرده	pæɾde
گفت و گو	ɡoftoɡuː
نوه	næve
نمایشگاه	næmɒːjeʃɡɒːh
حساب بردن	hesɒːbboɾdæn
ژوراسیک	ʒuːɾɒːsiːk
زیر سیگاری	ziːɾsiːɡɒːɾiː
دستور	dæstuːɾ
چشم زهر	t͡ʃeʃmzæhɾ
تمیز کردن	tæmiːzkæɾdæn
مرگ	mæɾɡ
ژانویه	ʒɒːnviːje
مسیحیت	mæsiːhiːjæt
تهرون	tehɾuːn
چرند	t͡ʃæɾænd
هرزه‌نگاری	hæɾzeneɡɒːɾiː
زنجیر زدن	zænd͡ʒiːɾzædæn
هشتصد	hæʃtsæd
اتو کردن	otuːkæɾdæn
سرسرا	sæɾsæɾɒː
خدمت کردن	xedmætkæɾdæn,xedmætkæɾdæn
پارو	pɒːɾuː
اعضا	æzɒː
قرقیزی	ɢiːɾɢiːziː
فربود	fæɾbuːd
صحرا	sæhɾɒː
شعاع	ʃoʔɒːʔ
کادمیوم	kɒːdmiːjom
حرف گرفتن	hæɾfɡeɾeftæn
حالت نهادی	hɒːlætenæhɒːdiː
شربت	ʃæɾbæt
آرزو	ɒːɾezuː
به این زودی	beiːnzuːdiː
تماس	tæmɒːs
ان‌شاءالله	enʃɒːʔællɒːh
آجری	ɒːd͡ʒoɾiː
آرایه	ɒːɾɒːje
نقد	næɢd
پور	puːɾ
تحقق	tæhæɢɢoɢ
قطر	ɢætæɾ
خمیازه	xæmjɒːze
نقاش	næɢɢɒːʃ
سل	sell
سیب	siːb
نارنگی	nɒːɾenɡiː
میگو	mejɡuː
می‌خواهد	míxɒːhæd
خارج شدن	xɒːɾed͡ʒʃodæn
تایید کردن	tæʔiːdkæɾdæn
می بینمت	miːbiːnæmet
نعوظ	noʻuːz
پرستو	pæɾæstuː
بلبل	bolbol
نعل	næʔl
بستر	bestæɾ
فدراسیون روسیه	fedeɾɒːsjuːneɾuːsiːje
داری می‌خواهی	dɒːɾiːmíxɒːhiː
دانشنامه	dɒːneʃnɒːme
ضعیف	zæʔiːf
توزلا	tuːzlɒː
هدیه کردن	hedjekæɾdæn
طلاق	tælɒːɢ
تابلوی اعلانات	tɒːblojeeʔlɒːnɒːt
مولکول	molekuːl
کار کردن	kɒːɾkæɾdæn,kɒːɾkæɾdæn
اپاختر	æpɒːxtæɾ
مجازی	mæd͡ʒɒːziː
زیگ	ziːɡ
پست الکترونیکی	posteelekteɾoniːkiː
عصبانی	æsæbɒːniː
ضروری	zæɾuːɾiː
آلمانی	ɒːlmæniː
تنور	tænuːɾ
باجناق	bɒːd͡ʒenɒːɢ
شوهر کردن	ʃohæɾkæɾdæn
شترگاوپلنگ	ʃotoɾɡɒːvpælænɡ
طولانی	tuːlɒːniː
چندش	t͡ʃendeʃ
غصه	ɢosse
گاوبندی کردن	ɡɒːvbændiːkæɾdæn
دلشوره گرفتن	delʃuːɾeɡeɾeftæn
بازماندن	bɒːzmɒːndæn
کار بستن	kɒːɾbæstæn
مردانه	mæɾdɒːnæ,mæɾdɒːne
تیتر زدن	tiːtɾzædæn
منگنه کردن	mænɡænekæɾdæn
دهلی	dehliː
بهمن	bæhmæn
می‌خواهیم	míxɒːhiːm
صفر	sefɾ
رها	ɾæhɒː
شریک	ʃæɾiːk
خم کردن	xæmkæɾdæn
اکتینیم	æktiːniːjom
ساک زدن	sɒːkzædæn
سوزن	suːzæn
رضایت	ɾezɒːjæt
امتحان	emtehɒːn
بد	bæd
کراوات زدن	keɾɒːvɒːtzædæn
پنالتی زدن	penɒːltiːzædæn
خشم آوردن	xæʃmɒːvæɾdæn
تمام‌خط	tæmɒːmxæt
خاویار	xɒːvjɒːɾ
بخیه	bæxiːje
عذاب دادن	æzɒːbdɒːdæn
کاهش گرفتن	kɒːheʃɡeɾeftæn
یاری	jɒːɾiː
آمیزش جنسی مقعدی	ɒːmiːzeʃed͡ʒensiːjemæɢʔædiː
پیک	pejk
خشک زدن	xoʃkzædæn
انتظار داشتن	entezɒːɾdɒːʃtæn,entezæɾdæʃtæn
لقمه	loɢme
قهر کردن	ɢæhɾkæɾdæn
نیاز	niːjɒːz
پالایش	pɒːlɒːjeʃ
هنگ‌کنگ	honɡkonɡ
ارزان	æɾzɒːn
کک	kek
عادت	ɒːdæt,ʔɒːdæt
گریه گرفتن	ɡeɾjeɡeɾeftæn
گرسنه	ɡoɾosne
زبان انگلیسی	zæbɒːneenɡeliːsiː
کانال مانش	kɒːnɒːlmɒːnʃ
آلو بخارا	ɒːluːboxɒːɾɒː
جاکش	d͡ʒɒːkeʃ
شناوری کردن	ʃenɒːvæɾiːkæɾdæn
چندین	t͡ʃændiːn
وداع کردن	vedɒːʔkæɾdæn
برهنه	beɾæhne
پسوند	pæsvænd
سمرقند	sæmæɾɢænd
دخترخاله	doxtæɾxɒːle
خواسته‌اید	xɒːsteiːd
غلط	ɢælæt
ماده‌گاو	mɒːdeɡɒːv
آیت‌الله	ɒːjætollɒːh
واکسن	vɒːksæn
گرجی	ɡoɾd͡ʒiː
جاچسبی	d͡ʒɒːt͡ʃæsbiː
مکان‌ها	mækɒːnhɒː
گناه کردن	ɡonɒːhkæɾdæn
ذرت	dhoɾæt,zoɾɾæt
نگار	neɡɒːɾ
دسته پزندگان	dæstejepæɾændeɡɒːn
تحویل دادن	tæhviːldɒːdæn
رد شدن	ɾædʃodæn
گرمک	ɡæɾmæk
جست زدن	d͡ʒæstzædæn
سگ آبی	sæɡeɒːbiː
فتادن	fetɒːdæn
اقیانوس آرام	oɢjɒːnuːseɒːɾɒːm
فواره زدن	fævvɒːɾezædæn
دست‌خط	dæstxæt
فحش دادن	fohʃdɒːdæn
برگشت زدن	bæɾɡæʃtzædæn
خیاره	xiːjɒːɾe
جنده‌خانه	d͡ʒendexɒːne
التماس	eltemɒːs
هیدرولیک	hiːdɾoliːk
ایتالیا	iːtɒːliːjɒː
جا	d͡ʒɒː
شوکولات	ʃuːkuːlɒːt
مهندسی	mohændesiː
کارنوال	kɒːɾnevɒːl
عنبیه	ʔenæbiːje
کان	kɒːn
ضجه	zæd͡ʒd͡ʒe
کسره	kæsɾe
نبرد	næbæɾd
مارماهی	mɒːɾmɒːhiː
تنی	tæniː
شناسایی	ʃenɒːsɒːjiː
اخیرا	æxiːɾæn
خودنمایی	xodnæmɒːiː
ناخوشایند	nɒːxuːʃɒːjænd
عجان	ʔed͡ʒɒːn
حرف اضافه	hæɾfeezɒːfe
دلدار	deldɒːɾ
مشتق	moʃtæɢ
لوزون	luːzon
خماندن	xæmɒːndæn
لیتوانی	liːtvɒːniː
ورق 	væɾæɢ
قفل	ɢofl
ماندن	mɒːndæn
نواختر	nouːæxtæɾ
شکری	ʃekæɾiː
انتگرال	ænteɡɾɒːl
سامانی	sɒːmɒːniː
خواهم خواست	xɒːhæmxɒːst
گویه	ɡuːje
موی زهار	muːjezæhɒːɾ
متوجه شدید	motevæd͡ʒd͡ʒeʃodiːd
قفقاز	ɢæfɢɒːz
ترساندن	tæɾsɒːndæn
دریای خزر	dæɾjɒːjexæzæɾ
ید	jod
بادبادک	bɒːdbɒːdæk
میان گذاشتن	miːɒːnɡozɒːʃtæn
اعتقاد داشتن	eʔteɢɒːddɒːʃtæn
کم	kæm,kom
استنطاق	estentɒːɢ
ماتیک	mɒːtiːk
محک خوردن	mæhækxoɾdæn
صدپا	sædpɒː
یاد انداختن	jɒːdændɒːxtæn
پنالتی	penɒːltiː
خاتمه یافتن	xɒːtemejɒːftæn
تخم	toxm
زانو	zɒːnuː
ایرلندی	iːɾlændiː
نیمروز	niːmɾuːz
ویرایشگر	viːɾɒːjeʃɡæɾ
دوش گرفتن	duːʃɡeɾeftæn
پرشکوه	poɾʃokuːh
پشتک	pæʃtæk,poʃtæk
عدل	ædl
حلوا	hɒːlvɒː
نیزه	nejze
دگربار	deɡæɾbɒːɾ
پیش میاد دیگه	píʃmiːɒːddiːɡe
آووکادو	ɒːvokɒːdo
آزمون‌پذیری	ɒːzmuːnpæziːɾiː
شامپو کردن	ʃæmpuːkæɾdæn
نشانه‌شناسی	neʃɒːneʃenɒːsiː
ماساژ	mɒːsɒːʒ
اردو زدن	oɾduːzædæn
لذت بردن	lezzætboɾdæn
توازن قدرت	tævɒːzoneɢodɾæt
هستی‌گرایی	hæstiːɡeɾɒːjiː
جنبش	d͡ʒonbeʃ
چسب نواری	t͡ʃæsbenævɒːɾiː
میهن	miːhæn
تلنگر	tælænɡoɾ
رنج	ɾænd͡ʒ
خواسته باشی	xɒːstebɒːʃiː
بار	bɒːɾ
بخار	boxɒːɾ
قزاقی	ɢæzɒːɢiː
ارگاسم	oɾɡɒːsm
ماشين برقي	mɒːʃiːnebæɾɢiː
خو گرفتن	xuːɡeɾeftæn
هنوز	hænuːz
خلع سلاح	xælʔeselɒːh
وال	vɒːl
شک	ʃæk
سیاره	sejɒːɾe
استوار بودن	ostovɒːɾbuːdæn
سائیگون	sɒːiːɡon
له له	læhlæh
خرج کردن	xæɾd͡ʒkæɾdæn
کتک	kotæk
حاضر	hɒːzeɾ
جوش آمدن	d͡ʒuːʃɒːmædæn
ضرر کردن	zæɾæɾkæɾdæn
كه	ke
فیل	fiːl
آمریکای شمالی	ɒːmɾiːkɒːjeʃomɒːliː
پله	pelle
هشت	hæʃt
افغانی	æfɢɒːniː
شلیل	ʃæliːl
پنجول زدن	pænd͡ʒuːlzædæn
پرتاب	pæɾtɒːb
طرف	tæɾæf
اوت	uːt
قیافه	ɢiːɒːfe
رقیب	ɾæɢiːb
بزباش	bozbɒːʃ
تكرار کردن	tekɾɒːɾkæɾdæn
گیاهخوار	ɡiːjɒːhxɒːɾ
منشار	menʃɒːɾ
ششم	ʃeʃom
مصر	mesɾ
قلیان	ɢæljɒːn
ارغنون	æɾɢænuːn
احمق	æhmæɢ
نارگیل	nɒːɾɡiːl
خرس پاندا	xeɾsepɒːndɒː
تشخیص	tæʃxiːs
خاک کردن	xɒːkkæɾdæn,xɒːkkæɾdæn
در زدن	dæɾzædæn,dæɾzædæn
جاسوس	d͡ʒɒːsuːs
از کی تا حالا	æzkejtɒːhɒːlɒː
کاکائو	kɒːkɒːoje
اخراج کردن	exɾɒːd͡ʒkæɾdæn
استمنا کردن	estemnɒːkæɾdæn
زبان مادری	zæbɒːnemɒːdæɾiː
قانون زدن	ɢɒːnuːnzædæn
با هم	bɒːhæm
محبوب	mæhbuːb
صحبت کردن	sohbætkæɾdæn,sohbætkæɾdæn
عروسی	æɾuːsiː,ʔæɾuːsiː
میو	miːjuː
دق آوردن	deɢɒːvæɾdæn
ارتباط	eɾtebɒːt
سود	suːd
مهار کردن	mæhɒːɾkæɾdæn
تحقق یافتن	tæhæɢɢoɢjɒːftæn
دو زدن	dozædæn
پیاده	pjɒːde,piːjɒːde
مفهوم	mæfhuːm
استنباط	estembɒːt
آره	ɒːɾe
تانزانیا	tɒːnzɒːniːjɒː
نوشابه	nuːʃɒːbæ,nuːʃɒːbe
کاسه	kɒːse
برمه	beɾme
زن‌بابا	zænbɒːbɒː
کفش	kæfʃ
چراغ	t͡ʃeɾɒːɢ,t͡ʃeɾɒːĝ
شیعه	ʃiːʔe
هیجان	hæjæd͡ʒɒːn,hiːd͡ʒɒːn
دعوت	dæʔvæt
کاشف	kɒːʃef
تمبر زدن	tæmɾzædæn
نوشیدن	nuːʃiːdæn
بلوچی	bæluːt͡ʃiː
بلاگ	blɒːɡ
پیشی	piːʃiː
پوست کندن	puːstkændæn
عوض	ævæz
سازواره	sɒːzvɒːɾe
ماگنیتوگورسک	mɒːɡniːtuːɡuːɾsk
هما	homɒː
زنی	zæniː
قارچ	ɢɒːɾt͡ʃ
نقاشی شدن	næɢɢɒːʃiːʃodæn
تجاوز جنسی	tæd͡ʒɒːvozd͡ʒensiː
تفلیس	tiːfliːs
مخده	mæxæddæh
کلان	kælɒːn
حركت کردن	hæɾekætkæɾdæn
ارکاک	eɾkɒːk
رنده	ɾænde
عاج	ʔɒːd͡ʒ
خواندن	xɒːndæn,xwɒːndæn
صابون زدن	sɒːbuːnzædæn
بلدرچین	beldeɾt͡ʃiːn
زیرآبی	ziːɾɒːbiː
بار زدن	bɒːɾzædæn
ماضی	mɒːziː
تازه	tɒːze
وکیل	vækiːl
ایجاد	iːd͡ʒɒːd
مدد گرفتن	mædædɡeɾeftæn
آیین	ɒːjiːn
نظر کردن	næzæɾkæɾdæn
مطاله	motɒːle
فيليپ	fiːliːp
باهاما	bɒːhɒːmɒː
شل زدن	ʃælzædæn
اشتیاق	eʃtiːjɒːɢ
اپی فیلوم	epiːfiːluːm
نزدیکان	næzdiːkɒːn
جیگر	d͡ʒiːɡæɾ
فرزین	fæɾziːn
کله معلق	kællemoællæɢ
آزمودن	ɒːzmuːdæn
شتک زدن	ʃætækzædæn
خاورمیانه	xɒːvæɾemiːjɒːne
کشکک زانو	kæʃkækzɒːnuː
خط فرمان	xættefæɾmɒːn
پذیرائی	pæziːɾɒːʔiː
سرب	soɾb
تهيه کردن	tæhiːjekæɾdæn
تشخیص دادن	tæʃxiːsdɒːdæn
اقرار	eɢɾɒːɾ
آلپ	ɒːlp
خطرناک	xætæɾnɒːk
ساختمان	sɒːxtemɒːn
پادرد زدن	pɒːdæɾdzædæn
ناهمگون	nɒːhæmɡuːn
خرد کردن	xoɾdkæɾdæn,xoɾdkæɾdæn
حمله کردن	hæmlekæɾdæn
حشره‌شناسی	hæʃæɾeʃenɒːsiː
بی خوابی کشیدن	biːxɒːbiːkeʃiːdæn
جورج تائون	d͡ʒoɾd͡ʒtɒːʔuːn
قاچ کردن	ɢɒːt͡ʃkæɾdæn
کف پا	kæfepɒː
هیدروژن پراکسید	hiːdɾoʒenpeɾɒːksiːd
نمایش	næmɒːjeʃ
طرح	tæɾh
شماره‌گذاری کردن	ʃomɒːɾeɡozɒːɾiːkæɾdæn
ناشنوا	nɒːʃenævɒː
ادبی	ædæbiː
عق زدن	oɢzædæn
اشتباه شدن	eʃtebɒːhʃodæn
یاوری کردن	jɒːvæɾiːkæɾdæn
مونته‌نگرو	monteneɡɾuː
برش زدن	boɾeʃzædæn
نردبان	næɾdebɒːn,næɾdobɒːn,næɾdæbɒːn
خرمارطب	xoɾmɒːɾotæb
راست	ɾɒːst
ناشایست	nɒːʃɒːjest
معاهده	moʔɒːhæde
نطق کردن	notɢkæɾdæn
مدد	mædæd
غده	ɢodde
قومیت	ɢoʊmiːjjæt
سرو	sæɾv
پاک‌کن	pɒːkken,pɒːkkon
گماردن	ɡomɒːɾdæn
ادکلن	odkolon
تیرانداز	tiːɾændɒːz
اجرا کردن	ed͡ʒɾɒːkæɾdæn
راه انداختن	ɾɒːhændɒːxtæn
پادشاهی متحد	pɒːdeʃɒːhiːjemottæhed
سالار	sɒːlɒːɾ
خر	xæɾ
اسپریس	æspɾiːs
عربستان سعودی	ʔæɾebiːstɒːnesæʔuːdiː
آغوش	ɒːɢuːʃ
همزاد	hæmzɒːd
زمزمه کردن	zemzemekæɾdæn
نینجوتسو	niːnd͡ʒuːtsuː
بریدن	boɾiːdæn
آدم‌خواری	ɒːdæmxɒːɾiː
خط	xæt
کثافت کشیدن	kesɒːfætkeʃiːdæn
معتبر	moʔtæbæɾ
دقیق	dæɢiːɢ
قرارداد زدن	ɢæɾɒːɾdɒːdzædæn
یافتن	jɒːftæn
پیش‌بینی‌ کردن	piːʃbiːniːkæɾdæn
یقه	jæɢe
نیجریه	niːd͡ʒeɾiːje
لگام زدن	led͡ʒɒːmzædæn
خط تیره	xættetiːɾe
مخفي	mæxfiː
یوتیوب	juːtjuːb
پادرميانی کردن	pɒːdæɾmiːɒːniːkæɾdæn
عربی	æɾæbiː,ʔæɾæbiː
کارد زدن	kɒːɾdzædæn
آزادماهی	ɒːzɒːdmɒːhiː
کاغذی	kɒːɢæziː
کودکستان	kuːdækestɒːn
جوش دادن	d͡ʒuːʃdɒːdæn
روسپی‌خانه	ɾuːspiːxɒːne
شادکام	ʃɒːdkɒːm
خبط	xæbt
سلاح هسته‌ای	selɒːhehæsteʔiː
گیتی	ɡiːtiː
فرهنگستان	fæɾhænɡestɒːn
شرکت هواپیمایی	ʃeɾkætehævɒːpejmɒːjiː
شانه کردن	ʃɒːnekæɾdæn,ʃɒːnekæɾdæn
طرح زدن	tæɾhzædæn
تعلق داشتن	tæʔælloɢdɒːʃtæn
شل	ʃæl
آواز	ɒːvɒːz
پس دادن	pæsdɒːdæn
نشانه‌های سجاوندی	neʃɒːnehɒːjesæd͡ʒɒːvændiː
نستعلیق	næstæʔliːɢ
نعل کردن	næʔlkæɾdæn
فرآیند	fæɾɒːjænd
آتش‌نشان	ɒːtæʃneʃɒːn
بلگراد	belɡeɾɒːd
ارائه شدن	eɾɒːʔeʃodæn
چپاول کردن	t͡ʃæpɒːvolkæɾdæn
ناكار	nɒːkɒːɾ
یخ کردن	jæxkæɾdæn
فرعون	fæɾʔæwn
این هفته	iːnhæfte
حج	hæd͡ʒd͡ʒ
آشامیدن	ɒːʃɒːmiːdæn
حمل شدن	hæmlʃodæn
برادرزاده	bæɾɒːdæɾzɒːde
اکوسیستم	ekuːsiːstem
پیانو	piːjɒːno
زخمی	zæxmiː
عادت کردن	ɒːdætkæɾdæn
معرفی شدن	moʔæɾɾefiːʃodæn
جدال کردن	d͡ʒedɒːlkæɾdæn
جیغ زدن	d͡ʒiːɢzædæn,d͡ʒiːɢzædæn,d͡ʒǐɢzædæn
ناخواهری	nɒːxwɒːhæɾiː
گلف	ɡolf
قرقیزستان	ɢeɾɢiːzestɒːn
اعتبار	eʔtebɒːɾ
آرزو کشیدن	ɒːɾezuːkeʃiːdæn
فارس	fɒːɾs
حرف هان	hæɾfehɒːn
اختصاص	extesɒːs
لاک	lɒːk
اندونزیایی	enduːneziːjɒːjiː,ændonesiːjejiː
هفتاد	hæftɒːd
صابون	sɒːbuːn
درود	doɾuːd
آفریقا	ɒːfɾiːɢɒː
اثر	æsæɾ
روزه گرفتن	ɾuːzeɡeɾeftæn
یاد	jɒːd
عید قربان	eiːdeɢoɾbɒːn
نگاه‌کردن	neɡɒːhkæɾdæn
منطق	mænteɢ
مبالغه	mobɒːleɢe
نسخه خطی	nosxejexættiː
خوشبختانه	xuːʃbæxtɒːne
لذیذ	læziːz
استخوان	ostoxɒːn,ostexwɒːn
عيد فطر	ejdefetɾ
پسردایی	pesæɾdɒːjiː
بلندگو	bolændɡouː
فرهنگ	fæɾhænɡ
برق گرفتن	bæɾɢɡeɾeftæn
سراسر	sæɾɒːsæɾ
عیسی	ʔiːsɒː
لو دادن	loʊdɒːdæn
گریبان	ɡæɾiːbɒːn
باستان‌شناسی	bɒːstɒːnʃenɒːsiː
اهمیت دادن	æhæmmiːjætdɒːdæn
غش	ɢæʃ
تکان	tekɒːn
لقمه گرفتن	loɢmeɡeɾeftæn
امانت گرفتن	æmɒːnætɡeɾeftæn
یزدان	jæzdɒːn
مسافر	mosɒːfeɾ
سوراخ کس	suːɾɒːxekos
با این حال	bæiːnhɒː
جامدادی	d͡ʒɒːmedɒːdiː
زیره‌ی سیاه	ziːɾejesiːjɒːh
نگاه دزدانه	neɡɒːhedozdɒːnæ
پلنگ برفی	pælænɡebæɾfiː
بزرگتر	bozoɾɡtæɾ
زرد چوبه زدن	zæɾdt͡ʃuːbezædæn
انگاشت	enɡɒːŝt
خواسته است	xɒːsteæst
مورمانسک	muːɾmɒːnsk
آکندن	ɒːkændæn
قهرمان	ɢæhɾemɒːn
لش	læʃ
می‌خواهید	míxɒːhiːd
شکار	ʃekɒːɾ
لواش	lævɒːʃ
چنگ آوردن	t͡ʃænɡɒːvæɾdæn
کاغذ روزنامه	kɒːɢæzeɾuːznɒːme
عصبانیت زدن	æsæbɒːniːjjætzædæn
نخجوان	næxd͡ʒevɒːn
اورشلیم	oɾʃæliːm
چشمه	t͡ʃæʃmæ
کله زدن	kællezædæn
خاص	xɒːs
خرگوش كوهی	xæɾɡuːʃekuːhiː
خیس کردن	xiːskæɾdæn
خایه	xɒːje
حاجی	hɒːd͡ʒiː
فوران کردن	fævæɾɒːnkæɾdæn
عبرانی	ebɾɒːniː
کوچ کردن	kuːt͡ʃkæɾdæn
نشانه‌گذاری	neʃɒːneɡozɒːɾiː
حشیش	hæŝiːŝ,hæʃiːʃ
نبیره	næbiːɾe
پرنده	pæɾænde
ریچارد	ɾiːt͡ʃɒːɾd
حلقوی	hælɢæviː
باور	bɒːvæɾ
موفق باشید	movæffæɢbɒːʃiːd
پتو	pætuː
کوچک	kuːt͡ʃek
تماشا‌کردن	tæmɒːʃækæɾdæn
لیس زدن	liːszædæn
دریای ژاپن	dæɾjɒːjeʒɒːpon
داد	dɒːd
زدن	zædæn
باد کردن	bɒːdkæɾdæn
پشت پا	poʃtepɒː
زردآلو	zæɾdɒːluː
ترجیح	tæɾd͡ʒiːh
علاقه داشتن	ælɒːɢedɒːʃtæn
کلّه خر	kællexæɾ
‏توانا بود هر که دانا بود	tævɒːnɒːbovædhæɾkedɒːnɒːbovæd
لال	lɒːl
حشفه	hæʃæfe
شیهه	ʃejhe
التزام دادن	eltezɒːmdɒːdæn
شخم زدن	ʃoxmzædæn
بر آن بودن	bæɾɒːnbuːdæn
برم	boɾom
فاکس زدن	fækszædæn
انداختن	ændɒːxtæn
ایرلند	ʔiːɾlænd
صاریغ	sɒːɾiːɢ
جالب	d͡ʒɒːleb
هاله	hɒːle
غم خوردن	ɢæmxoɾdæn
اندام	hændɒːm,ændɒːm
ایالات متحده	ejɒːlɒːtemottæhede
شکوفه کردن	ʃokuːfekæɾdæn
بوف	buːf
کندهار	kændæhɒːɾ
تنگنا	tænɡnɒː
تجدیدنظر	tæd͡ʒdiːdenæzæɾ
توبه	toʊbe
دود	duːd
معذرت می‌خواهم	mæʔzeɾætmiːxɒːhæm
مادر	mɒːdæɾ
ترویج کردن	tæɾviːd͡ʒkæɾdæn
منداغان	mændɒːɢɒːn
محتوا	mohtævɒː
پارک ملی	pɒːɾkemelliː
چادر	t͡ʃɒːdoɾ
شبیه	ʃæbiːh
عدد	ʔædæd
خریت	xæɾiːjjæt
طبل	tæbl
مامان	mɒːmɒːn
راش	ɾɒːʃ
جمهوری عربی مصر	d͡ʒomhuːɾiːjeʔæɾæbiːjemesɾ
گياه	ɡiːjɒːh
افتخار	eftexɒːɾ
درنهایت	dæɾnæhɒːjæt
دایره	dɒːjeɾe,dɒːjiːɾe
تاکید کردن	tæʔkiːdkæɾdæn
ارث	eɾs
شگرد زدن	ʃeɡeɾdzædæn
اسباب بازی	æsbɒːbbɒːziː
سوسمار	suːsmɒːɾ
گیاه‌شناسی	ɡiːjɒːhʃenɒːsiː
پیش‌بینی کردن	piːʃbiːniːkæɾdæn
لگد کردن	læɡædkæɾdæn
کازاخستان	kɒːzɒːxestɒːn
نسبت	nesbæt
زبان کانارا	zæbɒːnkænæɾæ
رده‌بندی	ɾædebændiː
توسری زدن	tuːsæɾiːzædæn
قالی	ɢɒːliː
کاشتن	kɒːʃtæn
ماشین	mɒːʃiːn
تخمین کردن	tæxmiːnkæɾdæn
مثانه	mæssɒːne
کلیه	kolje
کوپید	kuːpiːd
آتن	ɒːten
موزیک	muːziːk
کفاره	kæffɒːɾe
بالعکس	bɒːlʔæks
هندسه اقليدسی	hendeseoɢliːdsiː
کمتر	kæmtæɾ
حکمران	hokmɾɒːn
فراموشی	fæɾɒːmuːʃiː
مقایسه کردن	moɢɒːjesekæɾdæn
پس زدن	pæszædæn
چاپ کردن	t͡ʃɒːpkæɾdæn,t͡ʃɒːpkæɾdæn
آرخانگلسک	ɒːɾxɒːnɡelsk
حصار کشیدن	hesɒːɾkeʃiːdæn
ولزی	velziː
خواب دیدن	xɒːbdiːdæn,xwɒːbdiːdæn
شکمبند	ʃekæmbænd
براز	boɾɒːz
نانوایی	nɒːnvɒːjiː
بو داشتن	büdɒːʃtæn
اکتیو	æktiːv
قدس شریف	ɢodseʃæɾiːf
ضرر زدن	zæɾæɾzædæn
نقطه لاگرانژی	noɢtejelɒːɡɾɒːnʒiː
تجاری	ted͡ʒɒːɾiː
غایی	ɢɒːjiː
انگلیسی	enɡeliːsiː
شبح	ʃæbæh
قیف	ɢiːf
لگام	leɡɒːm
لنگ	lænɡ
چهارصد	t͡ʃæhɒːɾsæd
فایده	fɒːjede
معالجه کردن	moʔɒːled͡ʒekæɾdæn
چرا	t͡ʃeɾɒː
ناقص	nɒːɢes
لیمو	liːmuː
حیله زدن	hiːlezædæn
سنباده زدن	sombɒːdezædæn
تقدیر	tæɢdiːɾ
یعنی	jæʔniː
کوسه	kuːse
شکلاتی	ʃokolɒːtiː
زرد	zæɾd
جان	d͡ʒɒːn
خواه	xɒːh
كانا	kɒːnɒː
صربستانی	seɾbiːstɒːniː,sæɾbiːstɒːniː
می‌خواهند	míxɒːhænd
شاهنشاهی ایران	ʃɒːhænʃɒːhiːjeiːɾɒːn
جا لباسي	d͡ʒɒːlebɒːsiː
دوناگری	devænɒːɡæɾiː
شما	ʃomɒː
یکتا	jektɒː
تماشا کردن	tæmɒːʃɒːkæɾdæn,tæmɒːʃɒːkæɾdæn
شمپانزه	ʃæmpɒːnze
کورسو زدن	kuːɾsuːzædæn
یاسمون	jɒːsæmuːn
برگه نخست	bæɾɡejenoxost
دق کردن	deɢkæɾdæn
شماره	ʃomɒːɾe
فردا غروب	fæɾdɒːɢoɾuːb
تنبل	tænbæl
گه	ɡoh
کیلوگرم	kiːloɡɾæm
اسلوونیایی	esluːveniːjɒːjiː
کرگوشی زدن	kæɾɡuːʃiːzædæn
بوئین	bhouːʔiːn
تنگ	tænɡ
خراش افتادن	xæɾɒːʃoftɒːdæn
قل قل زدن	ɢolɢolzædæn
شک کردن	ʃækkæɾdæn
ماریجوانا	mɒːɾiːxuːɒːnɒː
نزدیک شدن	næzdiːkŝodæn
زبان چینی	zæbɒːnet͡ʃiːniː
زهرشناسی	zæhɾʃenɒːsiː
حفظ	hefz
برق زدن	bæɾɢzædæn
شکستن	ʃekæstæn
لیتوانیایی	liːtvɒːniːjɒːjiː
فاحشه‌خانه	fɒːheʃexɒːne
گوهر	ɡohæɾ
مرد	mæɾd
بو گرفتن	buːɡeɾeftæn
گرم	ɡæɾm,ɡeɾæm
بارگذاری	bɒːɾɡozɒːɾiː
اسلاو	eslɒːv
سفیدار	sæfiːdɒːɾ,sefiːdɒːɾ
چماق	t͡ʃomɒːɢ
سزیم	seziːom
شیرجه زدن	ʃiːɾd͡ʒezædæn
کیشینف	kiːʃiːnef
جهل	d͡ʒæhl
روزنامه‌نگار	ɾuːznɒːmeneɡɒːɾ
هورمون	huːɾmuːn
شانگهای	ʃɒːnɡhɒːiː
مرکب	moɾækkæb
کلن	koln
شق کردن	ʃæɢkæɾdæn
پوپک	puːpæk
لندن	lændæn
ارسال کردن	eɾsɒːlkæɾdæn
مردن	moɾdæn
تهدید	tæhdiːd
نیم	niːm
پر کشیدن	pæɾkeʃiːdæn
ابربازار	æbɾæbɒːzɒːɾ
اورانیوم	uːɾɒːnjuːm
کور	kuːɾ
دیباچه	diːbɒːt͡ʃe
ساكت	sɒːket
وادی	vɒːdiː
ضرب گرفتن	zæɾbɡeɾeftæn
خجالت	xed͡ʒɒːlæt
هسته	hæste,hæstæ
آرامگاه	ɒːɾɒːmɡɒːh
دوست مکاتبه‌ای	dostemokɒːtebeɒːjiː
گلاب	ɡolɒːb
مذهب	mæzhæb
ضربه خوردن	zæɾbexoɾdæn
باهوش	bɒːhuːʃ
لمباندن	lombɒːndæn
دستره	dæstæɾe
گند کشیدن	ɡændkeʃiːdæn
سیرک	siːɾk
نجم	næd͡ʒm
کلید	keliːd
بادام زمینی	bɒːdɒːmezæmiːniː,bɒːdɒːmzæmiːniː
گرایش جنسی	ɡæɾɒːjeʃed͡ʒensiː
سرگرمی	sæɾɡæɾmiː
مشکی	meʃkiː
سوئیس	suːʔiːs
زمین زدن	zæmiːnzædæn
زبان قزاقی	zæbɒːneɢæzɒːɢiː
ناگازاکی	næɡæzɒːkiː
برگ	bæɾɡ
توهین	toʊhiːn
منگنز	mænɡènèz
بافت	bɒːft
جانماز	d͡ʒɒːnæmɒːz
دو زار و ده شاهی	dozɒːɾodæhʃɒːhiː
دائی	dɒːʔiː
جار کشیدن	d͡ʒɒːɾkeʃiːdæn
غار	ɢɒːɾ
خیار	xiːjɒːɾ
کارتاژ	kæɾtɒːʒ
دسامبر	desɒːmbɾ
شجر	ʃæd͡ʒæɾ
پوشیده	puːʃiːdæ
معاینه	moʔɒːjene
مرورگر	moɾuːɾɡæɾ
صفت	sefæt
سرما زدن	sæɾmɒːzædæn
توان بویایی	tævɒːnebuːjɒːjiː
چپاول	t͡ʃæpɒːvol
آموزشگاه	ɒːmuːzeʃɡæh
پزشکی	pezeʃkiː
حقه	hoɢɢe
استثمار	estesmɒːɾ
گندمی	ɡændomiː
به قلاب وصل كردن	beɢollɒːbvæslkæɾdæn
برگشت	bæɾɡæʃt
كبریت کشیدن	kebɾiːtkeʃiːdæn
کالیفرنیا	kɒːliːfoɾniːɒː
آریایی	ɒːɾiːjɒːjiː
خدا نگهدار	xodɒːneɡæhdɒːɾ
دستبرد زدن	dæstboɾdzædæn
هوار کشیدن	hævɒːɾkeʃiːdæn,hævɒːɾkeʃiːdæn
آب شدن	ɒːbʃodæn
ازبکستان	ozbækestɒːn
بی‌خوابی	biːxɒːbiː
چندخدایی	t͡ʃændxodɒːjiː
تهمت	tohmæt
هالتر	hɒːlteɾ
قهوه‌خانه	ɢæhvexɒːne
نابینایی	nɒːbiːnɒːjiː
گراز	ɡeɾɒːz
مقعدی	mæɢʔædiː
بشیر	bæʃiːɾ
چتر زدن	t͡ʃætɾzædæn
دفاع	defɒːʔ
هالو	hɒːluː
لهجه	læhd͡ʒe
بچ	bæt͡ʃ
اشغال	eʃɢɒːl
نقشه	næɢʃe
سنجاق زدن	sænd͡ʒɒːɢzædæn
نیشکر	nejʃækæɾ
قره‌باغ کوهستانی	ɢæɾebɒːɢekuːhestɒːniː
پیدا کردن	pejdɒːkæɾdæn
افزاره	æfzɒːɾe
ضمه	zæmme
سوم	som
آموزش	ɒːmuːzeʃ
بها	bæhɒː
التماس کردن	eltemɒːskæɾdæn
بومی	buːmiː
تجاوز	tæd͡ʒɒːvoz
دانا	dɒːnɒː
بتن	beton
شانه	ʃɒːne
پلک زدن	pelkzædæn
توپ	tuːp
بیزانس	biːzɒːns
كپور	kæpuːɾ
خواسته‌ای	xɒːsteiː
ميليارد	miːljɒːɾd
ترمز کردن	toɾmozkæɾdæn
آقاپسر	ɒːɢɒːpesæɾ
کار افتادن	kɒːɾoftɒːdæn
سیاه‌کاج	siːɒːhkɒːd͡ʒ
استوخودوس	ostoxuːddos
آسان	ɒːsɒːn
بیهوشی زدن	biːhuːʃiːzædæn
خانم‌ها و آقایان	xɒːnomhɒːvæɒːɢɒːjɒːn
بلغراد	belɢeɾɒːd
آگهی	ɒːɡæhiː
پاسخ دادن	pɒːsoxdɒːdæn,pɒːsoxdɒːdæn
ویژه	viːʒæ
گوشت	ɡuːʃt,ɡoʃt
اینترلینگو	iːnteɾliːnɡuːæ
کتاب مقدس	ketɒːbemoɢæddæs
مشاهده کردن	moʃɒːhedekæɾdæn
قفقاز شمالی	ɢæfɢɒːzeʃæmɒːliː
تلخ	tælx
عروس	æɾuːs
سوت زدن	suːtzædæn
رفیق	ɾæfiːɢ
شغال	ʃoɢɒːl
بدل شدن	bædælʃodæn
بولیوی	boliːviː
قرنیه	ɢæɾniːje
چنگال	t͡ʃænɡɒːl
بو کشیدن	buːkeʃiːdæn
شمع	ʃæmʔ
بیرون زدن	biːɾuːnzædæn
تزیین کردن	tæzʔiːnkæɾdæn
کامیون	kɒːmiːon
جا به جا شدن	d͡ʒɒːbed͡ʒɒːʃodæn
کیش	kiːʃ
جرگه‌سالاران	d͡ʒæɾɡesɒːlɒːɾɒːn
گمانه زدن	ɡomɒːnezædæn
هلندی	holændiː
مشق	mæʃɢ
کتابدار	ketɒːbdɒːɾ
فیلم	fiːlm
مهبانگ	mæhbɒːnɡ
دیروز صبح	diːɾuːzsobh
عر	æɾ
پانچ	pɒːnt͡ʃ
روزنامه‌نگاری	ɾuːznɒːmeneɡɒːɾiː
جدید	d͡ʒædiːd
حسودی	hæsuːdiː
تودهنی زدن	tuːdæhæniːzædæn
نهصد	nohsæd
برف دانه	bæɾfedɒːne
زمان	zæmɒːn
بینی	biːniː
چپ	t͡ʃæp
سفارش	sefɒːɾeʃ
بنگلادش	bænɡlɒːdeʃ
چندن	t͡ʃændæn
دادن	pænɒːhdɒːdæn,tekɒːndɒːdæn,pænddɒːdæn,d͡ʒɒːdɒːdæn
هیجان آمدن	hæjæd͡ʒɒːnɒːmædæn
بالون	bɒːluːn
مطاله کردن	motɒːlekæɾdæn
انجام گرفتن	ænd͡ʒɒːmɡeɾeftæn
تعلیم	tæʔliːm
قلبی	ɢælbiː
لوتوس	lotuːs
کوپرنیسیم	kopeɾniːsiːom
عشق	ʔeʃɢ
استاد	ostɒːd
بروت	boɾuːt
مذهب بودا	mæzhæbebuːdɒː
تلف	tælæf
سیاه‌سرفه	siːjɒːhsoɾfe
چشم زهر گرفتن	t͡ʃeʃmzæhɾɡeɾeftæn
همبستر	hæmbæstæɾ
پلاتین	pelɒːtiːn
جغرافیا	d͡ʒoɢɾɒːfiːjɒː
پوست گرفتن	puːstɡeɾeftæn
روان	ɾævɒːn
مارچوبه	mɒːɾt͡ʃuːbe
عصر	æsɾ
تقویت کردن	tæɢviːætkæɾdæn
سوت کشیدن	suːtkeʃiːdæn
سانتریفوژ	sɒːntɾiːfuːʒ
صندوق پست	sonduːɢepost
تنها	tænhɒː
دوشیدن	duːʃiːdæn
تشریف بردن	tæʃɾiːfboɾdæn
تسبیح	tæsbiːh
تکیه	tækjetekje,tækje
زالتسبورگ	zɒːlsbuːɾɡ
پنگان	penɡɒːn
شاخه	ʃɒːxe
تسار	tsɒːɾ
پوزه	puːze
پودینگ	puːdiːnɡ
خاتمه	xɒːteme
فرات	foɾɒːt
اصول اخلاق	osuːleæxlɒːɢ
درایه	dæɾɒːje
مانگا	mɒːnɡɒː
ستادن	setɒːdæn
دوسره	dosæɾe
ساوانا	sɒːvɒːnɒː
چرخ	t͡ʃæɾx
خرگوش	xæɾɡuːʃ
دوستدار	duːstdɒːɾ
آخر	ɒːxæɾ
مهتر	mæhtæɾ,mehtæɾ
كیف	kejf
پست سفارشی	postesefɒːɾʃiː
اتحادیه آفریقا	ettehɒːdiːjeɒːfɾiːɢɒː
ضربه زدن	zæɾbezædæn
خواهر	xɒːhæɾ,xwɒːhæɾ
محلی	mæhælliː
رنج کشیدن	ɾænd͡ʒkeʃiːdæn
دامن زدن	dɒːmænzædæn
تایوان	tɒːiːvɒːn
خانتیمانسییسک	xɒːntiːmɒːnsiːjsk
وصول کردن	vosuːlkæɾdæn
پروستات	pɾostɒːt
روان پزشک	ɾævɒːnʔpezeʃkʔ
روايت کردن	ɾævɒːjætkæɾdæn
چسب زدن	t͡ʃæsbzædæn
حواجه‌سرا	xɒːd͡ʒesæɾɒː
مغاره	mæɢɒːɾe
عصر هسته‌ای	æsɾehæsteʔiː
پذیرفتن	pæziːɾoftæn
کشتی گذاره	kæʃtiːjeɡozɒːɾæh
کوری	kuːɾiː
خواسته بودند	xɒːstebúdænd
لادا	lɒːdɒː
واکنشگاه هسته‌ای	vɒːkoneʃɡɒːhehæsteʔiː
سودان	suːdɒːn
سرفه	soɾfe
زاگرس	zɒːɡɾos
دندان	dændɒːn
درخت آزاد	deɾæxteɒːzɒːd
وجد آوردن	væd͡ʒdɒːvæɾdæn
هزاره‌ی سوم	hezɒːɾejesevvom
دگرگونی	deɡæɾɡuːniː
ضجه کشیدن	zæd͡ʒd͡ʒekeʃiːdæn
هشتم	hæʃtom
لنگ زدن	lænɡzædæn
زندانی کردن	zendɒːniːkæɾdæn
نیوزیلند	niːjuːziːlend
پالتو	pɒːlto
دهدهی	dæhdæhiː
برف	bæɾf
ارزانی داشتن	æɾzɒːniːdɒːʃtæn
کندی	kenediː
یاقوتی	jɒːɢuːtiː
زخم زدن	zæxmzædæn
عمه‌زاده	æmmezɒːde
داربست زدن	dɒːɾbæstzædæn
دمشق	demeʃɢ
خاطر نشان کردن	xɒːteɾneʃɒːnkæɾdæn
تابوت	tɒːbuːt
خواب	xɒːb
لباس	lebɒːs
کنار	kenɒːɾ,kenɒːɾe
کشت	keʃt
گمان کردن	ɡomɒːnkæɾdæn
سرجوخه	sæɾd͡ʒuːxe
بام	bɒːm
آهنگساز	ɒːhænɡsɒːz
هلنی	heleniː
کوه	kuːh
اقیانوس اطلس	oɢjɒːnuːseætlæs
باله	bɒːle
باران آمدن	bɒːɾɒːnɒːmædæn
ریدن	ɾiːdæn
ثبت کردن	sæbtkæɾdæn
آب معدنی	ɒːbmæʔdæniː
هوار	hævɒːɾ
غروب	ɢoɾuːb
فلاطون	flɒːtuːn
عمان	ommɒːn
پچ‌پچ کردن	pet͡ʃpet͡ʃkæɾdæn
شاه‌توت	ʃɒːhtuːt
شکارچی	ʃekɒːɾt͡ʃiː
امپراطوری	empɾɒːtuːɾiː
جنبش غیرمتعهد	d͡ʒonbeʃeædæmetæʔæhhod,d͡ʒonbeʃeɢejɾemoteʔæhhed
حدس	hæds
پراگ	pɾɒːɡ
مالزی	mɒːleziː
ته تغاری	tætoɢɒːɾiː
مغرب عربی	mæɢɾebʔæɾæbiː
چلیپا	t͡ʃæliːpɒː
زیستن	ziːstæn
کرواسی	koɾoɒːsiː
سفت	seft
تایید	tæʔiːd
نقب زدن	næɢbzædæn
طراح	tæɾɒːh
سوسیالیست	sosiːjɒːliːst
وسعت	vosʔæt
پیروی	pejɾoviː
قفسه کتاب	ɢæfæsejeketɒːb
تلف کردن	tælæfkæɾdæn
اندازه	ændɒːze
نقشه کشیدن	næɢʃekeʃiːdæn
عاشق بودن	ʔɒːʃeɢbuːdæn
کده	kæde
هکر	hækeɾ
قربانی کردن	ɢoɾbɒːniːkæɾdæn
مرور کردن	moɾuːɾkæɾdæn
غمگین	ɢæmɡiːn
حرف	hæɾf
مبلمان	moblemɒːn
یالتا	jɒːltæ
دکتر	doktoɾ
بلاروس	belɒːɾuːs
عذرخواهی	ozɾxɒːhiː
گرینلند	ɡɾiːnlænd
زخم زبان	zæxmezæbɒːn
حتی‌الامکان	hættælemkɒːn
مفت	moft
کشنده	keʃænde
غش و ضعف زدن	ɢæʃozæʔfzædæn
برخورد	bæɾxoɾd
برای همیشه	bæɾɒːjehæmiːʃe
هندوکش	henduːkuːʃ
الکترون	elektɾon
خان	xɒːn
دماغ گرفتن	dæmɒːɢɡeɾeftæn
تندپز	tondpæz
دار زدن	dɒːɾzædæn,dɒːɾzædæn
ظهر بخیر	zohɾbexejɾ
دست	dæst
راه شیری	ɾɒːheʃiːɾiː
ناخن کشیدن	nɒːxonzædæn
مونیخ	muːniːx
ریگ	ɾiːɡ
خون	xuːn
خیانت‌کار	xiːjɒːnætkɒːɾ
طول موج	tuːlemoʊd͡ʒ
دریای سیاه	dæɾjɒːjesiːjɒːh
لجام زدن	leɡɒːmzædæn
هشیاری	hoʃjɒːɾiː
ملاقات کردن	molɒːɢɒːtkæɾdæn
بسته	bæste
اردیبهشت	oɾdiːbeheʃt
مالی	mɒːliː
یاریگر	jɒːɾiːɡæɾ
دوات	dævɒːt
بی‌رنگ	biːɾænɡ
چهره	t͡ʃehɾæ,t͡ʃehɾe
شگفت	ʃeɡæft
در سمت چپ	dæɾsemett͡ʃæp
سوئز	suːez
فرار کردن	fæɾɒːɾkæɾdæn
مسواک	mesvɒːk
گسترش	ɡostæɾeʃ
میتوکندری	miːtokondɾiː
فوتبالیست	fuːtbɒːliːst
خاله	xɒːle
قاره	ɢɒːɾe
استخدام کردن	estexdɒːmkæɾdæn
زیرزمین	ziːɾzæmiːn
زق زدن	zeɢzædæn
نقره فام	noɢɾefæm
نان تست	nɒːnetost
کورش	kuːɾoʃ
شانزده	ʃɒːnzdæh
بزه	beze
تاتار	tɒːtɒːɾ
خوراکی	xoɾɒːkiː
دریاچه ارومیه	dæɾjɒːt͡ʃeeoɾuːmiːje
ستاره دریایی	siːtɒːɾejedæɾjɒːjiː
چشم خوردن	t͡ʃeʃmxoɾdæn
ارث بردن	eɾsboɾdæn
قیچی کردن	ɢejt͡ʃiːkæɾdæn
قلمه کردن	ɢælæmekæɾdæn
پررنگ	poɾɾænɡ
آبتنی کردن	ɒːbtæniːkæɾdæn
فرجام	fæɾd͡ʒɒːm
پیشنام	piːʃnɒːm
پل کشیدن	polkeʃiːdæn
بدتر	bædtæɾ
دروغ گفتن	doɾuːɢɡoftæn,doɾuːɢɡoftæn
دارو کوب	dɒːɾuːkob
رعد زدن	ɾæʔdzædæn
بیتولا	biːtolɒː
دختر باز	doxtæɾebɒːz
خلیج	xæliːd͡ʒ
اندازه‌گیری	ændɒːzeɡiːɾiː
منتظر شدن	montæzeɾʃodæn
توجه شدن	tævæd͡ʒd͡ʒohʃodæn
مردم‌شناسی	mæɾdomʃenɒːsiː
تردستی	tæɾdæstiː
طول	tuːl
تاراج کردن	tɒːɾɒːd͡ʒkæɾdæn
حیوانی	hejvɒːniː
مور	muːɾ
ادعا کردن	eddeʔɒːkæɾdæn
کره جنوبی	koɾejed͡ʒænuːbiː
تفنگ	tofænɡ
هدایت کردن	hedɒːjætkæɾdæn
تولدت مبارک	tævɒːllodætmobɒːɾæk
کره زدن	kæɾezædæn
ادویه	ædviːje
دیگر	diːɡæɾ
دوباره	dobɒːɾe
کر	kæɾ
لالمونی گرفتن	lɒːlmuːniːɡeɾeftæn
فصح	feʃ
سیزده	siːzdæh
خطا کردن	xætɒːkæɾdæn
سبزی	sæbziː
نطق	notɢ
خسارت زدن	xesɒːɾætzædæn
شیر دادن	ʃiːɾdɒːdæn
کباب	kebɒːb
پیر	piːɾ
مکزیک	mekziːk
مگس	mæɡæs
شوالیه كردن	ʃovɒːljekæɾdæn
دین	diːn
واو	vɒːv
زنگ زدن	zænɡzædæn,zænɡzædæn
قبر	ɢæbɾ
بانگ زدن	bɒːnɡzædæn
جایگاه	d͡ʒɒːjɡɒːh
نوشتن	neveʃtæn,næveʃtæn
مکادونیه	mækɒːduːniːje
کسشعر	kosʃeʔɾ,koseʃeʔɾ
یک	jek
سیبریه	siːbeɾiːje
سنگ جادو	sænɡed͡ʒɒːduː
ور زدن	veɾzædæn
راک اند رول	ɾɒːkɒːndɾol
بره	bæɾɾe,bæɾe
بودا	buːdɒː
نصف	nesf
بغ	bæɢ
آمپول	ɒːmpuːl
جان دادن	d͡ʒɒːndɒːdæn
مشت خوردن	moʃtxoɾdæn
عبری	ebɾiː
بیماری قند	biːmɒːɾiːjeɢænd
خشم	xæʃm
دستبرد	dæstboɾd
آوا	ɒːvɒː
یادش آمدن	jɒːdæʃɒːmædæn
بازگیری	bɒːzɡiːɾiː
گذرنامه	ɡozæɾnɒːme
حیله خوردن	hiːlexoɾdæn
سؤال	soʔɒːl
پیشرفته	piːʃɾæfte
حرف چینی	hæɾfet͡ʃiːniː
امپراتوری روم	empeɾɒːtuːɾiːjeɾuːm
تئاتر	teʔɒːtɾ
جام	d͡ʒɒːm
مستندات	mostænædɒːt
براتیسلاوا	bɾɒːtiːslɒːvɒː
جایزه	d͡ʒɒːjeze
لاتین	lɒːtiːn
اره و اوره و شمسی کوره	ɒːɾeuːɾeʃæmsiːkuːɾe
اداره	edɒːɾe
تف	tof
پر	poɾ,pæɾ
یاد بردن	jɒːdboɾdæn
خشک‌سالی	xoʃksɒːliː
زیبا	ziːbɒː
ضرر	zæɾæɾ
حقوق بشر	hoɢuːɢebæʃæɾ
زیست‌شیمی	ziːstʃiːmiː
لیختن‌اشتاین	liːxteneʃtɒːjn
شیشه	ʃiːʃe
گیهان	ɡeiːhɒːn
رژ لب	ɾoʒelæb
مطب زدن	mætæbzædæn
خود	xuːd,xod
نرم‌تن	næɾmtæn
دعوت كردن	dævætkæɾdæn
دارایی	dɒːɾɒːjiː
همخوابگی	hæmxɒːbeɡj
افغان	æfɢɒːn
قاضی	ɢɒːziː
آبمیوه	ɒːbmiːve
آناتولی	ɒːnætoliː
قرار زدن	ɢæɾɒːɾzædæn
ابر	æbæɾ
پایبندی	pɒːbændiː
بندپایان	bændpɒːjɒːn
قول زدن	ɢoʊlzædæn,ɢolzædæn
کمان‌دار	kæmɒːndɒːɾ
صدا زدن	sedɒːzædæn,sedɒːzædæn
گروه واژه	ɡoɾuːhvɒːʒe
دربی	deɾbiː
اعتماد	eʔtemɒːd
بیگ بن	biːɡben
بی‌خانمان	biːxɒːnemɒːn
کردی	koɾdiː
بستن	bæstæn
خالی کردن	xɒːliːkæɾdæn
بهینه	bæhiːnæ,behiːne
خلیج فارس	xæliːd͡ʒefɒːɾs
سیاتل	sejɒːtæl
جسد	d͡ʒæsæd
زبان دیوهی	zæbɒːndiːvehiː
مباهات کردن	mobɒːhɒːtkæɾdæn
پزشک	pezeʃk
پایین	pɒːjiːn
صوفیه	sofiːje
تلنگر زدن	tælænɡoɾzædæn
آفت	ɒːfæt
دست کشیدن	dæstkæʃiːdæn,dæstkeʃiːdæn
مادرخوانده	mɒːdæɾxwɒːnde
سپاسگزاری	sepɒːsɡozɒːɾiː
آب گرفتن	ɒːbɡeɾeftæn
قزاق	ɢæzzɒːɢ
رایگان	ɾɒːjɡɒːn
گدایی	ɡedɒːjiː
مهربانی	mehɾæbɒːniː
نقل کردن	næɢlkæɾdæn
نفهمی	næfæhmiː
نیاهندوایرانی	niːjɒːhendoiːɾɒːniː
تدوینگر	tædviːnɡæɾ
حس کردن	heskæɾdæn
اصلی	æsliː
فهرست محتویات	fehɾestemohtæviːjɒːt
بازار	bɒːzɒːɾ
پردازش داده‌ها	pæɾdɒːzeʃedɒːdehhɒː
چلچله	t͡ʃelt͡ʃele
رادون	ɾɒːdon
اسب آبی	æsbeɒːbiː
مريض	mæɾiːz
دعا	doʔɒː
پلو	polo
رزیدن	ɾæziːdæn
ناب	nɒːb
تاراج	tɒːɾɒːd͡ʒ
کوتاهی	kuːtɒːhiː
علامت	ælɒːmæt
ناخنک کردن	nɒːxonækkæɾdæn
فردریش	feɾedɾiːʃ
گام زدن	ɡɒːmzædæn,ɡɒːmzædæn
خائن	xɒːʔen
عجیب و غریب	ʔæd͡ʒiːboɢæɾiːb,ʔæd͡ʒiːboɢæɾiːb
پسرخاله	pesæɾxɒːle
نامه	nɒːme
الکترومغناطیس	elektɾomæɢnɒːtiːs
دوربین دیجیتال	duːɾbiːnediːd͡ʒiːtɒːl
بود	buːd
دينار	diːnɒːɾ
اشاره	eʃɒːɾe
صدمه زدن	sædæmezædæn
یادبود	jɒːdbuːd
کهن	kohæn
ورودی	voɾuːdiː
نوروز	nouːɾuːz
گریونا	ɡɾiːvnɒː
ماده تاریک	mɒːddejetɒːɾiːk
چوب زدن	t͡ʃuːbzædæn
دارو	dɒːɾuː
بهتان زدن	bohtɒːnzædæn
دزد	dozd
کار بردن	kɒːɾboɾdæn
نهانی	nehɒːniː
چسباندن	t͡ʃæsbɒːndæn
شهرزاد	ʃæhɾzɒːd
آرامش	ɒːɾɒːmeʃ
گاز	ɡɒːz
خواسته باشید	xɒːstebɒːʃiːd
رادیو	ɾɒːdiːo
اندریاس	ændɾiːjɒːs
رم دادن	ɾæmdɒːdæn
ارث گذاشتن	eɾsɡozɒːʃtæn
اسم	esm
شالوده	ʃɒːluːdæ
خواهد	xɒːhæd
کاری است که شده	kɒːɾiːæstkeʃode
خیلی ممنون	xejliːmæmnuːn
تروریسم	teɾuːɾiːsm
قلقلک	ɢelɢelæk
قیصر	ɢejsæɾ
خواسته باشند	xɒːstebɒːʃænd
کول	kuːl
سفیر	sefiːɾ
نظر زدن	næzæɾzædæn
لرزش	læɾzeʃ
پشه بند زدن	pæʃebændzædæn
کار انداختن	kɒːɾændɒːxtæn
کوسوو	kosovo
پیش‌بینی	piːʃbiːniː
پزشکی قانونی	pezeʃkiːjeɢɒːnuːniː
تندر	tondæɾ
بو کردن	buːkæɾdæn,buːkæɾdæn
صید کردن	sæiːdkæɾdæn
لوور	luːvɾ
الفبا	ælefbɒː
محکمه	mæhkæme
آسیب زدن	ɒːsiːbzædæn
سوسک	suːsk
باغچه	bɒːɢt͡ʃe
دفن کردن	dæfnkæɾdæn,dæfnkæɾdæn
بارگیری	bɒːɾɡiːɾiː
وصلت کردن	væslætkæɾdæn
شنبلیله	ʃænbeliːle
مار	mɒːɾ
آستانه	ɒːstɒːne
وزنه زدن	væznezædæn
رایانامه	ɾɒːjɒːnɒːme
شاهنشاهی	ʃɒːhænʃɒːhiː
آسفالت کردن	ɒːsfɒːltkæɾdæn
کفاره دادن	kæffɒːɾedɒːdæn
استخون	ostoxuːn
طیاره	tejjɒːɾe
فاشیسم	fɒːʃiːsæm
باگ	bɒːɡ
متر	metɾ
جرقه زدن	d͡ʒæɾæɢɢezædæn
زندانی	zendɒːní
کنه	kæne
شلاق	ʃællɒːɢ
پایتخت	pɒːjtæxt,pɒːjetæxt
پیمان	pejmɒːn
آمریکیوم	ɒːmeɾiːkiːjom
پیشوند	piːʃvænd
پایتون	pɒːjton
ناهار	nɒːhɒːɾ
مزار شریف	mæzɒːɾeʃæɾiːf
به سمت	hesemet
خوردن	xoɾdæn,zædæn
فولاد	fuːlɒːd
تیزآب	tiːzɒːb
دایره زدن	dɒːjeɾezædæn
زار زدن	zɒːɾzædæn
مشام	mæʃɒːm
شکفتن	ʃekoftæn
تگزاس	teɡzɒːs
تعلم	tæʔællom
اخطار کردن	extɒːɾkæɾdæn
پناه دادن	pænɒːhdɒːdæn
نابودی	nɒːbuːdiː
فهمیدن	fæhmiːdæn
فر	feɾ
آمدن	ɒːmædæn
متا	metɒː
افروختن	æfɾuːxtæn
یشمی	jæʃmiː
عافیت باشه	ɒːfiːjætbɒːʃe
یادداشت کردن	jɒːddɒːʃtkæɾdæn
خواهیم	xɒːhiːm
انگلستان	enɡelestæn
نوزاد	nouːzɒːd
همکلاس	hæmkelɒːs
دارمشتادیم	dɒːɾmeʃtɒːdiːom
سیاه‌چاله	siːjɒːht͡ʃɒːle
اسلو	oslo
بهره‌برداری کردن	bæhɾebæɾdɒːɾiːkæɾdæn
قل خوردن	ɢolxoɾdæn
رخسار	ɾoxsɒːɾ
اصابت	esɒːbæt
اصلاح	eslɒːh
خاطر داشتن	xɒːteɾdɒːʃtæn
هم	hæm
فارسی	fɒːɾsiː
رحمت کردن	ɾæhmætkæɾdæn
اتهام خوردن	ettehɒːmxoɾdæn
نفرین کردن	nefɾiːnkæɾdæn
تومسک	tomsk
پایان رساندن	pɒːjɒːnɾesɒːndæn
تاسیس	tæʔsiːs
شی	ʃiː
پادشاهی	pɒːdeʃɒːhiː,pɒːdʃɒːhiː
قرن	ɢæɾn
داده‌ها	dɒːdehɒː
روان‌شناس	ɾævɒːnʃenɒːs
انتقام گرفتن	enteɢɒːmɡeɾeftæn
مرده	moɾde
بدل کردن	bædælkæɾdæn
داشتید می‌خواستید	dɒːʃtiːdmíxɒːstiːd
چلاقی	t͡ʃolɒːɢiː
ناز	nɒːz
ماتروشکا	mɒːtɾuːʃkɒː
دال	dɒːl
کهکشان	kæhkeʃɒːn
دزد زدن	dozdzædæn
خرما	xoɾmɒː
کلمبیا	kolombiːjɒː
خرده	xoɾde
پرداختن	pæɾdɒːxtæn
دیوار	diːvɒːɾ
گفته	ɡofte
غنچه دادن	ɢont͡ʃedɒːdæn,ɢont͡ʃedɒːdæn,ɢont͡ʃædɒːdæn
پیشانی	piːʃɒːniː
سه نفری	senæfæɾiː
گل کردن	ɡolkæɾdæn
پست	pæst,post
توسری	tuːsæɾiː
پنجم	pænd͡ʒom
تاشکند	tɒːʃkænd
پاسبان	pɒːsbɒːn
ماسا�� دادن	mɒːsɒːʒdɒːdæn
دیروز غروب	diːɾuːzɢoɾuːb
دوم	dovvom
ناپسری	nɒːpesæɾiː
آشپزخانه	ɒːʃpæzxɒːne
بردن	boɾdæn
نشانه‌گذاری کردن	neʃɒːneɡozɒːɾiːkæɾdæn
چسب مایع	t͡ʃæsbemɒːjeʔ
بخیه خوردن	bæxiːjexoɾdæn
کلوچه	koluːt͡ʃæ
شوهر	شوهر,ʃoʊhæɾ
خراش خوردن	xæɾɒːʃxoɾdæn
زادگاه	zɒːdɡɒːh
ارعابگری	eɾʔɒːbɡæɾiː
اچ‌تی‌ام‌ال	et͡ʃtiːemel
دلار	dolɒːɾ
شیر کوهی	ʃiːɾekuːhiː
زیردریایی	ziːɾdæɾjɒːjiː
زیر پوشی زن	ziːɾpuːʃiːzæn
خواسته‌اند	xɒːsteænd
انباز شدن	ænbɒːzʃodæn
تمیز	tæmiːz
سلما	sælmɒː
شلغم	ʃælɢæm
رقصیدن	ɾæɢsiːdæn
آسفالت شدن	ɒːsfɒːltʃodæn
اصرار	esɾɒːɾ
باران	bɒːɾɒːn
از بر	æzbæɾ
آناناس	ɒːnɒːnɒːs
پنجاه	pænd͡ʒɒːh
خودمختاری	xodmoxtɒːɾiː
شرم	ʃæɾm
خمیازه کشیدن	xæmjɒːzekeʃiːdæn
هراس	hæɾɒːs
ثمر	sæmæɾ
آپارتمان	ɒːpɒːɾtemɒːn
شکم دریدن	ʃekæmdæɾiːdæn
سیاه‌زخم	siːjɒːhzæxm
سنجاقک	sænd͡ʒɒːɢæk
واروژان	vɒːɾuːʒɒːn
بسط یافتن	bæstjɒːftæn
اسپست	æspest,espest
صحنه	sæhne
ارت کردن	eɾtkæɾdæn
کوالالامپور	kvɒːlɒːlɒːmpuːɾ
نمکین	næmækiːn
خراشیدن	xæɾɒːʃiːdæn
جاری	d͡ʒɒːɾiː
ببر	bæbɾ
خدمت	xedmæt
نخیر	næxejɾ
نوازش	nævɒːzeʃ
سر رفتن	sæɾɾæftæn
جزء	d͡ʒoz
اعلام کردن	eʔlɒːmkæɾdæn
مدفوع	mædfuːʔ
ابراهیم	iːbɾɒːhiːm,ebɾɒːhiːm
بیماری	biːmɒːɾiː
فروختن	foɾuːxtæn
اردنگی  زدن	oɾdænɡiːzædæn
استنطاق کشیدن	estentɒːɢkeʃiːdæn
ختنه	xætne
ماسه	mɒːse
جزیره	d͡ʒæziːɾe
سوهان	soʊhɒːn
حسد	hæsæd
پیرارسال	piːɾɒːɾsɒːl
شاتل فضایی	ʃɒːtelefæzɒːjiː
بیرون کردن	biːɾuːnkæɾdæn
لتونی	letuːniː
ندا	nedɒː
باج	bɒːd͡ʒ
پیل	piːl
مغرب	mæɢɾeb
ممنوع	memnuː
کوری زدن	kuːɾiːzædæn
منزل داشتن	mænzeldɒːʃtæn
هردو	hæɾdo
ملاقات	molɒːɢɒːt
جزجز	d͡ʒezd͡ʒez
یاخته	jæxte
است	æst
خوروران	xuːɾvæɾɒːn
گناه	ɡonɒːh
قار	ɢɒːɾ
موسیقی	muːsiːɢiː
تبلیغات	tæbliːɢɒːt
بریلیوم	beɾiːliːjom
مغ	moɢ
بسکتبالیست	bæsketbɒːliːst
توت‌فرنگی	tuːtfæɾænɡiː
حاشیه	hɒːʃiːje
تخته	tæxte
اوکراین	uːkɾɒːjn
ضمیر	zæmiːɾ
کنجد	kond͡ʒed,kond͡ʒod
فرمانروایی	fæɾmɒːnɾævɒːjiː
پيش بايست	piːʃbɒːjæst
برازندگی	bæɾɒːzændæɡiː
ارسال	eɾsɒːl
سامانه	sɒːmɒːne
مسکو	moskuː
بلشویک	bolʃeviːk
بری	bɾiː
سقط کردن	seɢtkæɾdæn
شکرک	ʃekæɾæk
چینی ساده‌شده	t͡ʃiːniːjesɒːdeʃode
مهاجرت	mohɒːd͡ʒeɾæt
قول	ɢol,ɢoʊl
شهمات کردن	ʃæhmɒːtkæɾdæn
چای سبز	t͡ʃɒːjesæbz
فساد	fæsɒːd,fesɒːd
حماقت	hemɒːɢæt
دستبند زدن	dæstbændzædæn
بال زدن	bɒːlzædæn
مهر ورزیدن	mehɾvæɾziːdæn
زبان لاتین	zæbɒːnelɒːtiːn
آباژور	ɒːbɒːʒuːɾ
اکسیژن	oksiːʒen
قهوه‌ای	ɢæhveiː,ɢæhveʔiː,ɢæhvejiː
آرانی	ɒːɾɒːniː
گاینده	ɡɒːjænde
زبان فارسی	zæbɒːnefɒːɾsiː
توافق رسیدن	tævɒːfoɢɾesiːdæn
آزمایش	ɒːzmɒːjeʃ
خنجر خوردن	xænd͡ʒæɾxoɾdæn
زن‌دایی	zændɒːjiː
ناامید	næomiːd
نویسنده	neviːsænde
اوستیای جنوبی	osetiːjɒːjed͡ʒænuːbiː
افشردن	æfʃoɾdæn
بازنده	bɒːzænde
پارسی	pɒːɾsiː
پلک	pælk,pelk
سرفه افتادن	soɾfeoftɒːdæn
امیب	æmiːb
سرویس	seɾviːs
گیلاس	ɡiːlɒːs
اعدام	eʔdɒːm
کوتاه	kuːtɒːh
ذات	zɒːt
ارگ	oɾɡ
کنسرت	konseɾt
حساب	hesɒːb
کبک	kebek
تلفظ	tælæffoz
روز	ɾuːz
یونی‌کد	juːniːkod
گنگ	ɡænɡ,ɡonɡ
کپنهاگ	kopenhɒːɡ
زینت	ziːnæt
حاد	hɒːd
حوزه	houːze
آب	ɒːb
قورت	ɢuːɾt
وین	viːn
مجار	mæd͡ʒɒːɾ
سفر	sæfæɾ
وق زدن	væɢzædæn
اجاره	ed͡ʒɒːɾe
یونان	juːnɒːn
باد زدن	bɒːdzædæn
کمربند	kæmæɾbænd,kæmæɾbænd
شیمیل	ʃiːmejl
نیز	niːz
گفتار	ɡoftɒːɾ
دانش	dɒːneʃ
توزیع	toziːæ
موم عسل	muːmæsæl
شاهزاده	ʃɒːhzɒːde
پارس کردن	pɒːɾskæɾdæn
مست	mæst
گوشمالی دادن	ɡuːŝmɒːliːdɒːdæn
اروپای مرکزی	oɾuːpɒːjemeɾkæziː
هلندی‌ها	holændiːhɒː
خاکی	xɒːkiː
زمین‌شناسی	zæmiːnʃiːnɒːsiː,zæmiːnʃenɒːsiː
ایوان	ejvɒːn,iːvɒːn
تخمین زدن	tæxmiːnzædæn
کومیس	kuːmiːs
گراز دریایی	ɡoɾɒːzedæɾjɒːjiː
چارمیخ کشیدن	t͡ʃæhæɒːɾmiːxkeʃiːdæn
بدبختی	bædbæxtiː
تقریب	tæɢɾiːb
ققنس	ɢæɢnos
شلیک	ʃeliːk
دستگاه تناسلی	dæstɡɒːhetænɒːsoliː
اسلام‌گرا	eslɒːmɡæɾɒː
درد کردن	dæɾdkæɾdæn
فوتوکپی	fotokopiː
پرسه زدن	pæɾsezædæn
چانه زدن	t͡ʃɒːnezædæn
آکوردئون	ɒːkoɾdeʔon
پمپ	pomp
ماچ	mɒːt͡ʃ
مدخل	mædxæl
سیب‌زمینی	siːbzæmiːniː
نجات	ned͡ʒɒːt
تشنه	teʃne
گستردن	ɡostæɾdæn
بخواهید	bexɒːhiːd
هیجان آوردن	hæjæd͡ʒɒːnɒːvæɾdæn
کندن	kændæn
کرد	koɾd
بوزینه	buːziːne
برای من	bɾɒːjemæn
تلفن هوشمند	telefonehuːʃmænd
تیغ اوکام	tiːɢokɒːm
نهیب زدن	næhiːbzædæn
رواج دادن	ɾævɒːd͡ʒdɒːdæn
درویدن	dɾæviːdæn
پیشباز  پیشواز	piːʃbɒːzpiːʃvɒːz
انجیر	ænd͡ʒiːɾ
اطو	otuː
نیس	niːs
باد ستاره‌ای	bɒːdesetɒːɾeʔiː
تشدید کردن	tæʃdiːdkæɾdæn
کشتی فضایی	kæʃtiːefæzɒːje
تیپا زدن	tiːpɒːzædæn
تازه‌ها	tɒːzehɒː
دوست‌دختر	duːstdoxtæɾ
اباختر	æbɒːxtæɾ
لج کردن	læd͡ʒkæɾdæn
گیر آوردن	ɡiːɾɒːvæɾdæn
رواج	ɾævɒːd͡ʒ
رآکتور هسته‌ای	ɾeɒːktoɾehæsteʔiː
فروغ	fɾuːĝ
رنگ	ɾænɡ
بو دادن	buːdɒːdæn
بدن	bædæn
شالیزار	ʃɒːliːzɒːɾ
نازنین	nɒːzæniːn
درخت نارنج	deɾæxtenɒːɾend͡ʒ
ممنونم	mæmnúnæm
ویکتوریا	viːktuːɾiːjɒː
چرک گرفتن	t͡ʃeɾkɡeɾeftæn
قزاقستان	ɢæzzɒːɢestɒːn
ارس	æɾæs
آغاز شدن	ɒːɢɒːzʃodæn
پاییز	pɒːjiːz
افسوس	æfsuːs
معاشرت کردن	moʔɒːʃeɾætkæɾdæn
قاچ خوردن	ɢɒːt͡ʃxoɾdæn
دوست	duːst
هرگز	hæɾɡez
فیروزه‌ای	fiːɾuːzejiː
دیدبانی دادن	diːdebɒːniːdɒːdæn
کناره	kenɒːɾe
رحم آوردن	ɾæhmɒːvæɾdæn
ونکوور	vænkuːveɾ
تمبر پستی	tæmbɾepostiː
آمیزه	ɒːmiːze,ɒːmiːzæ
خواهی	xɒːhiː
اسپرماتوزئید	espeɾmɒːtozoʔiːd
سیخ	siːx
پوزه زدن	puːzezædæn
ولاپوک	volɒːpuːk
اقیانوس هند	oɢjɒːnuːsehend
تاج‌محل	tɒːd͡ʒmæhæl
محاصره کردن	mohɒːseɾekæɾdæn
فضازمان	fæzɒːzæmɒːn
سفر خوش	sæfæɾxoʃ
تصادفی	tæsɒːdofiː
هم زدن	hæmzædæn
رستگاری	ɾæstɡɒːɾiː
قید	ɢejd
امروزه	emɾuːze
کمند	kæmænd
مفصل	mæfsæl
فک	fæk
وصله کردن	væslekæɾdæn
تراموای	tɾɒːmvɒːj
سلام علیکم	sælɒːmoælejkom
نابکار	nɒːbekɒːɾ
پندار	pendɒːɾ
معرفی کردن	moʔæɾɾefiːkæɾdæn
نفرت داشتن	nefɾætdɒːʃtæn
لک‌لک	læklæk
مادّه	mɒːdde
گزاره	ɡozɒːɾe
بر خوردن	boɾxoɾdæn
اسم جمع	esmed͡ʒæmʔ
سه‌چهارم‌خط	set͡ʃæhɒːɾomxæt
چنبر	t͡ʃænbæɾ
غصه خوردن	ɢossexoɾdæn
ضخیم	zæxiːm
دنگ	donɡ
ضجه کردن	zæd͡ʒd͡ʒekæɾdæn
آسیا	ɒːsiːjɒː
یخ‌زده	jæxzæde
همسنجی	hæmsænd͡ʒiː
دوش	duːʃ
دوران طلایی	doɾɒːntælæʔeiː
سوزن منگنه	suːzænemænɡæne
غيرانتفاعي	ɢeiːɾeentefæʔiː
سال	sɒːl
صفحه کلید	sæfhekeliːd
غیبت	ɢejbæt
واشنگتن	vɒːʃenɡton
تحمیل کردن	tæhmiːlkæɾdæn
کل	kol
خجالت کشیدن	xed͡ʒɒːlætkeʃiːdæn
تلفن موبایل	telefonemobɒːjl
کشیده زدن	keʃiːdezædæn
دیوانگی	diːvɒːneɡiː
شهادت دادن	ʃæhɒːdætdɒːdæn
ننگ	nænɡ
داد زدن	dɒːdzædæn,dɒːdzædæn
جذام	d͡ʒozɒːm
جبریل	d͡ʒebɾiːl
ولی	vɒːliː
حرف زدن	hæɾfzædæn,hæɾfzædæn
بهانه	bæhɒːne
گیومه	ɡiːjuːme
ماگادان	mɒːɡɒːdɒːn
ویولن	viːjolon
کسی	kæsiː,ksiː
ایژوسک	iːʒevsk
تخم مرغ	toxmemoɾɢ,toxmemoɾɢ
کافر	kɒːfæɾ,kɒːfeɾ
تارنما	tɒːɾnæmɒː
کیمیاگری	kiːmiːjɒːɡæɾiː
زجر	zæd͡ʒɾ
آزاد	ɒːzɒːd
محک کردن	mæhækkæɾdæn
دانش‌آموز	dɒːneʃɒːmuːz
تره	tæɾe
مک	mek
دانشجو	dɒːneʃd͡ʒuː
پاریس	pɒːɾiːs
تانک	tɒːnk
تبدیل کردن	tæbdiːlkæɾdæn
شمشیرزن	ʃæmʃiːɾzæn
معشوق	mæʔʃuːɢ
لب	læb
اسکوپیا	iːskopiːjɒː
اداره پست	edɒːɾejepost
سرآشپز	sæɾɒːʃpæz
ارنبورگ	oɾenbuːɾɡ
خمیدن	xæmiːdæn
موتورولا	motoɾolɒː
پرستیژ	peɾestiːd͡ʒ
پلاسما	plɒːsmɒː
مغولستان	moɢolestɒːn
تسکین دادن	tæskiːndɒːdæn
جنگ جهانی دوّم	d͡ʒænɡed͡ʒæhɒːniːedovvom
لاجوردی	lɒːd͡ʒevæɾdiː
نه هزار	nohhæzɒːɾ
چتر دریایی	t͡ʃætɾdæɾjɒːjiː
شامه	ʃɒːmme
جغد	d͡ʒoɢd
تصویب کردن	tæsviːbkæɾdæn
دید زدن	diːdzædæn
گرمی	ɡæɾmiː
پس از این	pæsæziːn
آه کشیدن	ɒːhkeʃiːdæn
زیرصفحه	ziːɾsæfhe
تقریبا	tæɢɾiːbæn
ابلاغ کردن	eblɒːɢkæɾdæn
کف زمین	kæfezæmiːn
جمع کردن	d͡ʒæmʔkæɾdæn
چشم افتادن	t͡ʃeʃmoftɒːdæn
دفترچه	dæftæɾt͡ʃe
دایی	dɒːjiː
نیجر	niːd͡ʒeɾ
باختن	bɒːxtæn
مینو	miːnuː
مچ پا	mot͡ʃepɒː
چمباتمه	t͡ʃombɒːtme
نون	nuːn
ایروان	eɾævɒːn
راهرو	ɾɒːhɾo
ماده‌خوک	mɒːdexuːk
مهار زدن	mæhɒːɾzædæn
ولوو	volvo
تحویل	tæhviːl
بنفش روشن	bænæfʃeɾoʃæn
فهرست	fehɾest
دوجنسه	dod͡ʒense
آزادی مطبوعات	ɒːzɒːdiːjemætbuːʔɒːt
تن‌فروشی	tænfoɾuːʃiː
قلم زدن	ɢælæmzædæn
توجیه	tod͡ʒiːh
رد	ɾæd
فراخواندن	fæɾɒːxvɒːndæn
مسابقه دادن	mosɒːbeɢedɒːdæn
کابل	kɒːbol
شیون کشیدن	ʃiːvænkeʃiːdæn
خاتمه دادن	xɒːtemedɒːdæn
سیب‌زمینی سرخ‌کرده	siːbzæmiːniːjesoɾxkæɾde
ریشه زدن	ɾiːʃezædæn
آندورا	ɒːndoɾɒː
گا	ɡɒː
قبرستان	ɢæbɾestɒːn
اختلاف	extelɒːf
آمریکایی‌سازی	ɒːmɾiːkɒːjiːsɒːziː
گامبی	ɡɒːmbiː
يشم	jæʃm
گلوله زدن	ɡoluːlezædæn
ایمان آوردن	iːmɒːnɒːvæɾdæn
جارو	d͡ʒɒːɾuː
عزم	ʔæsm,æzm
ایتالیایی	iːtæliːjɒːjiː
ثانیه	sɒːniːje
لیز	liːz
بیزار بودن	biːzɒːɾbuːdæn
تلویزیون	televiːziːon
دهن  دهان خوردن	dæhænxoɾdæn
پارس	pɒːɾs
آلفا	ɒːlfɒː
هرات	heɾɒːt
ژوکوف	ʒuːkov
ایرکوتسک	iːɾkuːtsk
دوستی کردن	duːstiːkæɾdæn
بهتان	bohtɒːn
تنگی نفس	tænɡiːenæfæs
طالبی	tɒːlebiː
روندن	ɾuːndæn
رد و بدل کردن	ɾædobædælkæɾdæn
سرما	sæɾmɒː
شالوم	ʃɒːlom,ʃɒːluːm
تلویزیون کابلی	televiːziːonkɒːbliː
چرخاندن	t͡ʃæɾxɒːndæn
پدیدآورنده	pædiːdɒːvæɾænde
علم	ʔælæm,ʔelm
درستکار	doɾostkɒːɾ
تنندگان	tænændeɡɒːn
داد رسیدن	dɒːdɾesiːdæn
قلم	ɢælæm
منزل	mænzel
اختصاص داشتن	extesɒːsdɒːʃtæn
کول کردن	kuːlkæɾdæn
اسهال زدن	eshɒːlzædæn
خنده کردن	xændekæɾdæn
شکوفه زدن	ʃokuːfezædæn
بند آمدن	bændɒːmædæn
استانبول	estɒːmbuːl
مصادره	mosɒːdeɾe
قصد داشتن	ɢæsddɒːʃtæn
خار	xɒːɾ
مبارزه	mobɒːɾeze
پینه	piːne
تغییرعقیده دادن	tæɢʔiːɾeæɢiːdedɒːdæn
خمپاره خوردن	xompɒːɾexoɾdæn
سرکوفت	sæɾkuːft
ایالات متحدۀ آمریکا	ejɒːlɒːtemottæhedejeɒːmɾiːkɒː
فحش	fohʃ
تایپه	tɒːjpe
دختر خانم	doxtæɾxɒːnom
پتاسيم	potɒːsiːm
بیسموت	biːsmuːt
نامبردن	nɒːmboɾdæn
لندن بزرگ	lændænebozoɾɡ
پدربزرگ	pedæɾbozoɾɡ
آراستن	ɒːɾɒːstæn
بلوف خوردن	bolofxoɾdæn
شوم	ʃuːm
دلدرد	deldæɾd
آبشار	ɒːbʃɒːɾʔ,ɒːbʃɒːɾ
دعوا کردن	dæʔvɒːkæɾdæn
پایان یافتن	pɒːjɒːnjɒːftæn
شال	ʃɒːl
کار	kɒːɾ
هر چیز	hæmet͡ʃiːz
شروع	ʃoɾuːʔ
میخی	miːxiː
معده	meʔde
عقد شدن	æɢdʃodæn
دختردایی	doxtæɾdɒːjiː
گنبد	ɡonbæd
تحسین	tæhsiːn
شمال	ʃomɒːl,ʃæmɒːl,ʃemɒːl
رمان	ɾomɒːn
زعفرانی	zæʔfeɾɒːniː
مسلمون	mosælmuːn
مقدونیه	mæɢduːniːje
کارت پستال	kɒːɾtpostɒːl
بیابان	biːjɒːbɒːn
ژاپن	ʒɒːpon
به هنگام	behænɡɒːme
قدم زدن	ɢædæmzædæn,ɢædæmzædæn
معرفت	mæʔɾefæt
بیل زدن	biːlzædæn
دیدن	diːdæn
خرابکار	xæɾɒːbkɒːɾ
عفو	æf
سفر به خير	sæfæɾbexeiːɾ
کتاب الکترونیکی	ketɒːbeelektɾoniːkiː
باز کردن	bɒːzkæɾdæn
چرت	t͡ʃoɾt
عروسی کردن	æɾuːsiːkæɾdæn
تازیانه‌ها	tɒːziːjɒːnehɒː
نوش جان	nuːʃed͡ʒɒːn
گونه	ɡuːnæ,ɡuːne
لبخند زدن	læbxændzædæn
تبسم کردن	tæbæssomkæɾdæn
اتو زدن	otuːzædæn
شبانه	ʃæbɒːne
خشاب	xeʃɒːb
خریدن	xæɾiːdæn
آرگون	ɒːɾɡon
ترفند	tæɾfænd
نینوا	nejnævɒː
خرج دادن	xæɾd͡ʒdɒːdæn
کامپیوتر	kɒːmpjuːteɾ
مجازات شدن	mod͡ʒɒːzɒːtʃodæn
هوا دادن	hævɒːdɒːdæn
حشیش کشیدن	hæʃiːʃkeʃiːdæn
چورک	t͡ʃuːɾæk
مقدس	moɢæddæs
استثمار شدن	estesmɒːɾʃodæn
یاد آوردن	jɒːdɒːvæɾdæn
معادله	moʔɒːdele
مایا	mɒːjɒː
مردانگی	mæɾdɒːneɡiː
خاتم کاری	xɒːtæmkɒːɾiː
پناه بردن	pænɒːhboɾdæn
تبیلیسی	tiːbiːliːsiː
پامچال	pɒːmt͡ʃɒːl
فاحشه	fɒːheʃe
یاروسلاول	jæɾuːslɒːvl
شاخ	ʃɒːx
پل زدن	polzædæn
ترسیدن	tæɾsiːdæn
ریختن	ɾiːxtæn
برش خوردن	boɾeʃxoɾdæn
سرمایه‌گذاری	sæɾmɒːjeɡozɒːɾiː
گفتگو	ɡoftoɡuː,ɡofteɡuːɡoftoɡuː,ɡoftɡuː,ɡofteɡuː
شیون زدن	ʃiːvænzædæn
بهی	behiː
بیشتر	biːʃtæɾ
عینک	eiːnæk,ejnæk
الهیات	elæhiːjɒːt
پیشنهاد	peʃnæhɒːd,piːʃnæhɒːd
گلزار	ɡolzɒːɾ
سوت	suːt
اعتراف	eʔteɾɒːf
کار گرفتن	kɒːɾɡeɾeftæn
سلطان	soltɒːn
درنگ	deɾænɡ,dɾænɡ
گر گرفتن	ɡoɾɡeɾeftæn
شلاق زدن	ʃællɒːɢzædæn
رحم	ɾæhem,ɾæhm
فرمیون	feɾmiːjon
البروس	elbɾuːs
گیره	ɡiːɾe
دره	dæɾe,dæɾɾe
چهل و پنج	t͡ʃehelopænd͡ʒ
رحمت	ɾæhmæt
نعره زدن	næ’ɾezædæn
گاز اعصاب	ɡɒːzeæʔsɒːb
تولد	tævællod,tævælod
مزمور	mæzmuːɾ
نفس کشیدن	næfæskeʃiːdæn
قبل	ɢæbl
بلژیک	belʒiːk
آبکش کردن	ɒːbkeʃkæɾdæn
استارت	estɒːɾt
مطمئن	motmæʔenn,motmæʔen
عفو خوردن	æfxoɾdæn
بی خوابی	biːxɒːbiː
چیزبرگر	t͡ʃiːzbeɾɡeɾ
سنگر	sænɡæɾ
هله‌هوله	hælehuːle
گنجه	ɡænd͡ʒe
چهارم	t͡ʃæhɒːɾom
مظلومیت زدن	mæzluːmiːætzædæn
شهباز	ʃæhbɒːz
رومانیکا	ɾuːmɒːniːkɒː
بد انجامیدن	bædænd͡ʒɒːmiːdæn
غش غش کردن	ɢæʃɢæʃkæɾdæn
اتهام زدن	ettehɒːmzædæn
پارکینگ	pɒːɾkiːnɡ
اعلام	eʔlɒːm
فرشته	feɾeʃte
محله	mæhælle
استنباط شدن	estembɒːtʃodæn
زوال عقل	zævɒːleʔæɢl
بامبول زدن	bɒːmbuːlzædæn
برابر	bæɾɒːbæɾ
شهید	ʃæhiːd
خردل	xæɾdæl
گردش کار	ɡæɾdeʃekɒːɾ
زینت دادن	ziːnætdɒːdæn
غلیان	ɢæljɒːn
هات داگ	hɒːtdɒːɡ
حالا	hɒːlɒː
نقره‌ای	noɢɾeʔiː,noɢɾejiː
لق	læɢ
فرا	fæɾɒː
نمونه	nemuːne,nomuːne
اقیانوس منجمد جنوبی	oɢjɒːnuːsemond͡ʒæmeded͡ʒænuːbiː
چلاقی زدن	t͡ʃolɒːɢiːzædæn
حیرت کردن	hejɾætkæɾdæn
استراحت	esteɾɒːhæt
درک	dæɾk
برخیزیدن	bæɾxiːziːdæn
سرچشمه	sæɾt͡ʃæʃmæ
بت‌کده	botkæde
ترجمه کردن	tæɾd͡ʒomekæɾdæn,tæɾd͡ʒomekæɾdæn
مرداد	moɾdɒːd
جمع زدن	d͡ʒæmʔzædæn
حمله آوردن	hæmleɒːvæɾdæn
آفریقای جنوبی	ɒːfɾiːɢɒːjed͡ʒonuːbiː
بیا بریم	biːjɒːbeɾiːm
ایران	iːɾɒːn
جرأت کردن	d͡ʒoɾʔætkæɾdæn
عمو	æmuː,ʔæmuː
فن الکتریکی	fænelektɾiːkiː
روسری	ɾuːsæɾiː
تندرست	tændoɾost,tændæɾæst
کبد	kæbed
دی	dej
روسیه سفید	ɾuːsiːjejesefiːd
قورت دادن	ɢuːɾtdɒːdæn
زنبور	zænbuːɾ
اروس	eɾuːs
شخم خوردن	ʃoxmxoɾdæn
اتحاد	ettehɒːd
در راه	dæɾɾɒːh
بوستان	buːstɒːn
نشانه	neʃɒːneneʃɒːn
فرنشین	fæɾneʃiːn
داروخانه	dɒːɾuːxɒːne
پف فیل	pofefiːl
شوفان	ʃuːfɒːn
فیزیک	fiːziːk
همکاری کردن	hæmkɒːɾiːkæɾdæn
گناهکار	ɡonɒːhkɒːɾ
وجود داشتن	vod͡ʒuːddɒːʃtæn
خودکار	xodkɒːɾ
سیر کوب	sîɾkob
تاميل	tɒːmiːl
سرفه انداختن	soɾfeændɒːxtæn
حظ	hæz
استفاده شدن	estefɒːdeʃodæn
گزارشی	ɡozɒːɾeʃiː
میانمار	mjɒːnmɒːɾ
بخار شدن	boxɒːɾʃodæn
درآمدن	dæɾɒːmædæn
آفتابگیر زدن	ɒːftɒːbɡiːɾzædæn
باکرگی	bɒːkeɾeɡiː
خوش‌شانس	xoʃʃɒːns
زن کردن	zænkæɾdæn
گرسنگی	ɡɾosnæɡiː,ɡoɾosneɡiː,ɡɾosneɡiː
اخم کردن	æxmkæɾdæn
کیر مکیدن	kiːɾmekiːdæn
کباب کردن	kæbɒːbkæɾdæn
استرونسیم	æstɾuːnsiːm
نگهداری کردن	neɡæhdɒːɾiːkæɾdæn
گمان  کردن	ɡomɒːnkæɾdæn
اسباب کشیدن	æsbɒːbkeʃiːdæn
راجا	ɾɒːd͡ʒɒː
کبوتر چاهی	kæbuːtæɾt͡ʃɒːhiː
تصرف کردن	tæsæɾɾofkæɾdæn
پاییدن	pɒːeiːdæn,pɒːjiːdæn
زیرک	ziːɾæk
خر و پف کردن	xoɾopofkæɾdæn
شاش	ʃɒːʃ
شهرآورد	ʃæhɾɒːvæɾd
حافظه	hɒːfeze
قدیمی	ɢædiːmiː
گر	ɡoɾ
ترک زدن	tæɾækzædæn
بیزاری	biːzɒːɾiː
پیرامون	piːɾɒːmuːn
سردرد	sæɾdæɾd
جا به جا کردن	d͡ʒɒːbed͡ʒɒːkæɾdæn
هیدروکلریک اسید	hiːdɾokoloɾiːkæsiːd
ساق	sɒːɢ
نادختری	nɒːdoxtæɾiː
ضجه زدن	zæd͡ʒd͡ʒezædæn
ناله زدن	nɒːlezædæn
استنطاق کردن	estentɒːɢkæɾdæn
معنی کردن	mæʔniːkæɾdæn
کهنه	kohne
کاغذدیواری	kɒːɢæzdiːvɒːɾiː
ادا آمدن	ædɒːɒːmædæn
پونه	puːne
ترسا	tæɾsɒː
پس	pæs,pos
درودگر	doɾuːdɡæɾ
اصرار کردن	esɾɒːɾkæɾdæn
نالیدن	nɒːliːdæn
آبخازستان	ɒːbxɒːzestɒːn
بزدل	bozdel
منزلت	mænzelæt
کتک زدن	kotækzædæn
آینده	ɒːjænde
کی	kej,kiː
یک کم	jekkæm
ممکن	momken
آرنج	ɒːɾænd͡ʒ,ɒːɾend͡ʒ
عجله کردن	æd͡ʒælekæɾdæn
شغل	ʃoɢl
پاگودا	pɒːɡodɒː
بشقاب	boʃɢɒːb
کمک گرفتن	komækɡeɾeftæn
چوبین	t͡ʃuːbiːn
شاهدخت	ʃɒːhdoxt
آزار	ɒːzɒːɾ
عقیق سلیمانی	æɢiːɢesolejmɒːniː
دقیقه	dæɢiːɢe
مذی	mæziː
شکست دادن	ʃekæstdɒːdæn
هنرمند	honæɾmænd
علاقه	ælɒːɢe
جانور	d͡ʒɒːnvæɾ
لبنان	lobnɒːn
سنگ آهک	sænɡɒːhæk
بیت‌المقدس	bejtolmoɢæddæs
احترام	ehteɾɒːm
ترکیه‏ای	toɾkiːjeʔiː
تذکر	tæzækkoɾ
هاکی	hɒːkiː
رجم	ɾæd͡ʒm
درجا	dæɾd͡ʒɒː
بسته بندی	bestebændiː
معمولا	mæʔmuːlæn
بعد از ظهر	bæʔdæzzohɾ
رئیس جمهور	ɾæʔiːsed͡ʒomhuːɾ
دوست داشتن	duːstdɒːʃtæn,duːstdɒːʃtæn
اخترمار	æxtæɾmɒːɾ
دندان‌پزشک	dændɒːnpezeʃk
موشک زدن	muːʃækzædæn
فاصله نشکن	fɒːselejenæʃkæn
صحیح	sæhiːh
آلبانی	ɒːlbɒːniː
غریزه	ɢæɾiːze
مشت	moʃt
حیوان	hejvɒːn
نقاد	næɢɒːd
خرداد	xoɾdɒːd
پاسخ	pɒːsox
جاز	d͡ʒɒːz
عزا گرفتن	æzɒːɡeɾeftæn
یکمین	jekomiːn
علم معانی	ʔelmmæʔɒːniː
برگه	bæɾɡæ
فکر رفتن	fekɾɾæftæn
هر	hæɾ
درازا	deɾɒːzɒː
یاهو	jɒːhuː
یکسان	jeksɒːn
مهبل	mæhbæl
گشت	ɡæʃt
زل	zol
تجدید نظر کردن	tæd͡ʒdiːdenæzæɾkæɾdæn
بهبود	behbuːd
آبغوره گرفتن	ɒːbɢuːɾeɡeɾeftæn
کره شمالی	koɾejeʃemɒːliː
ناخن	nɒːxon
همیشه	hæmiːʃe
ماموت	mɒːmuːt
چوچوله	t͡ʃuːt͡ʃuːle,t͡ʃuːt͡ʃuːlæ
کلمه	kælæme
مناره	menɒːɾe
شناویدن	ʃenɒːviːdæn
چشم‌پزشک	t͡ʃeʃmpezeʃk
تایتانیک	tejtɒːniːk
‌قطع شدن	ɢætʔʃodæn
سیمان	siːmɒːn
حک شدن	hækʃodæn
فاکس کردن	fækskæɾdæn
لیورپول	liːvæɾpuːl
تجویز کردن	tæd͡ʒviːzkæɾdæn
ذره‌بین	zæɾɾebiːn
عربده زدن	æɾbædezædæn
گلایه کردن	ɡelɒːjekæɾdæn
سایگون	sɒːjɡon
خوک نر	xuːkenæɾ
سياه	siːɒːh,siːjɒːh
آب‌پنیر	ɒːbpæniːɾ
موشکافی کردن	muːŝekɒːfiːkæɾdæn
برقي	bæɾɢiː
بیم	biːm
جز	d͡ʒoz
مشاهده	moʃɒːhede
دربارۀ	dæɾbɒːɾeje
بازتاب	bɒːztɒːb
خانواده	xɒːnevɒːde,xɒːnevɒːdæh
خنده	xænde
ست	set
اتو	otuː
نقاله	næɢɢɒːle
گردن	ɡæɾdæn
رمضان	ɾæmæzɒːn
بنزن	bænzæn
نمک زدن	næmækzædæn
اره	æɾɾe
افغانستان	æfɢɒːnestɒːn
ادامه	edɒːme
لطمه خوردن	lætmexoɾdæn
گمان زدن	ɡomɒːnzædæn
بازاریابی	bɒːzɒːɾjɒːbiː
ثریا	ʃoɾæiːjɒː
خواسته بودید	xɒːstebúdiːd
اشتراوس	eʃtɾɒːuːs
كبریت	kebɾiːt
رومانیایی	ɾuːmɒːniːjɒːjiː
فتحه	fæthe
صندل	sændæl
مثال	mesɒːl
الگوریتم	ælɡoɾiːtm
دریای عرب	dæɾjɒːjeʔæɾæb
افزایش دادن	æfzɒːjeʃdɒːdæn
دراز	deɾɒːz
لاف	lɒːf
مکه	mække
میکاییل	miːkɒːjiːl
بازگشتن	bɒːzɡæʃtæn
سپس	sepæs
تجارتخانه	ted͡ʒɒːɾætxɒːnæ,ted͡ʒɒːɾætxɒːne
کیوسک	kiːjuːsk
هاسی	hɒːsej
پتروسیان	petɾosjɒːn
عیلام	iːlɒːm
خوب	xuːb
بی قرار	biːɢæɾɒːɾ
آفتاب گرفتن	ɒːftɒːbɡeɾeftæn
نظاره کردن	nezɒːɾekæɾdæn
جوجه‌تیغی	d͡ʒuːd͡ʒetiːɢiː
آگرا	ɒːɡɾɒː
شوالیه	ʃovɒːliːje
موش‌مردگی	muːʃmoɾdeɡiː
اثر گرفتن	æsæɾɡeɾeftæn
عابر بانک	ʔɒːbeɾbɒːnk
کوتاهی کردن	kuːtɒːhiːkæɾdæn
کوک خوردن	kuːkxoɾdæn
اعتماد کردن	eʔtemɒːdkæɾdæn
غنودن	ɢonuːdæn
گرما	ɡæɾmɒː
آمریکایی	ɒːmɾiːkɒːjiː
شامپو	ʃɒːmpuː,ʃæmpuː
بوریم	boɾiːom
جلق	d͡ʒælɢ
پا زدن	pɒːzædæn
بدو بدو	bodobodo
دستمال کشیدن	dæstmɒːlkeʃiːdæn
فراز	fæɾɒːz
کیسه خایه	kiːsejexɒːje
لیف کشیدن	liːfkeʃiːdæn
کجا	kod͡ʒɒː
کالبدشناسی	kɒːlbodʃenɒːsiː
سرودن	soɾuːdæn
واحه	vɒːhe
دوپیکر	dopejkæɾ
صفت برتر	sefætebæɾtæɾ
آبراه	ɒːbɾɒːh
جستجو	d͡ʒosted͡ʒuːd͡ʒostod͡ʒuː
اطمینان دادن	etmiːnɒːndɒːdæn
اغلب	æɢlæb
معامله زدن	moʔɒːmelezædæn
دنبال گشتن	donbɒːlɡæʃtæn,donbɒːlɡæʃtæn
ماتم گرفتن	mɒːtæmɡeɾeftæn
جیرجیرک	d͡ʒiːɾd͡ʒiːɾæk
پا افتادن	pɒːoftɒːdæn
مسواک کردن	mesvɒːkkæɾdæn
مرور	moɾuːɾ
ماهیچه	mɒːhiːt͡ʃe
معشوقه	mæʔʃuːɢe
مکانیک کوانتوم	mekɒːniːkekvɒːntuːm
سقوط	soɢuːt
بنیاد	bonjɒːd
فرصت	foɾsæt
دستبند خوردن	dæstbændxoɾdæn
تف کردن	tofkæɾdæn
میکرب	miːkɾob
ماسک زدن	mɒːskzædæn
اردنگی 	oɾdænɡiː
لجام	led͡ʒɒːm
دلفریب	delfæɾiːb
اندر	ændæɾ
استخدام	estexdɒːm
محصول	mæhsuːl
نشریه زدن	næʃɾiːjezædæn
منی	mæniː,moniː
ازوپ	ezuːp
مدت	moddæt
واژه‌نامه	vɒːʒenɒːme
فردا بعد از ظهر	fæɾdɒːbæʔdæzzohɾ
خروشیدن	xɾuːʃiːdæn
شصت و نه	ʃæstonoh
پوشیدن	puːʃiːdæn
هرزه	hæɾzæ
قد کشیدن	ɢædkeʃiːdæn
كبریت زدن	kebɾiːtzædæn
بحر	bæhɾ
قهوه	ɢæhve
چشم زدن	t͡ʃeʃmzædæn
آنتن زدن	ɒːntenzædæn
صفحه خانگی	sæfhejexɒːneɡiː
آناتومی	ɒːnætomiː
تلفن همراه	telefonehæmɾɒːh
کاسنی	kɒːsniː
استکان	estekɒːn
ساز زدن	sɒːzzædæn
همنوا	hæmnævɒː
گلوله	ɡoluːle
دوبالان	dobɒːlɒːn
طهران	tehɾɒːn
قصد کردن	ɢæsdkæɾdæn
پرماسیدن	pæɾmɒːsiːdæn
پشه بند	pæʃebænd
جمع	d͡ʒæmʔ
قشلاق	ɢeʃlɒːɢ
فرزان	fæɾzɒːn
افتخار کردن	eftexɒːɾkæɾdæn
ابریشم	æbɾiːʃæm
دیکتاتوری	diːktɒːtuːɾiː
خواننده	xɒːnænde,xwɒːnænde
مکعب روبیک	mokæʔæbeɾuːbiːk
برق انداختن	bæɾɢændɒːxtæn
پور سینا	puːɾesiːnɒː
جیک زدن	d͡ʒiːkzædæn
وات	vɒːt
شعله کشیدن	ʃo’lekeʃiːdæn
دلدرد زدن	deldæɾdzædæn
کون	kuːn
نهنگ	næhænɡ
کلاس	kelɒːs
خیارشور	xiːjɒːɾʃuːɾ
پخت و پز	poxtopæz
عمرة	ʻæmɾæt
اجنبی	æd͡ʒnæbiː
پاشنه کفش	pɒːʃnejekæfʃ
عینک آفتابی	eiːnækɒːftɒːbiː
خرمائی روشن	xoɾmɒːjiːjeɾoʃæn
برف آمدن	bæɾfɒːmædæn
طبیعتاّ	tæbiːætæn
نقره‌فام	noɢɾefɒːm
طبق معمول	tebɢemæʔmuːl
تونل زدن	tuːnelzædæn
همانی	hæmɒːniː
مجله	mæd͡ʒælle
نسبی	nesbiː
ماموریت گرفتن	mæʔmuːɾiːætɡeɾeftæn
خرمشهر	xoɾæmʃæhɾ
سیا	siːjɒː
سبقت گرفتن	sebɢætɡeɾeftæn
داماد	dɒːmɒːd
اوکرائین	uːkɾɒːʔiːn
پلیمر	poliːmeɾ
بچه	bæt͡ʃt͡ʃe
جاروب	d͡ʒɒːɾuːb
ناخدا	nɒːxodæ
انگیختن	ænɡiːxtæn
دست‌نویسی	dæstneviːsiː
فسفر	fosfoɾ
قفقازی	ɢæfɢɒːziː
انسان جایزالخطاست	ensænd͡ʒɒːjezolxætæst
عادی	ʔɒːdiː
تیتر	tiːtɾ
دربند کردن	dæɾbændkæɾdæn
آمریکای جنوبی	ɒːmɾiːkɒːjed͡ʒænuːbiː
علف	ælæf
اردک	oɾdæk
خرد	xeɾæd,xoɾd
سرکوفت زدن	sæɾkuːftzædæn
سگدو	sæɡdo
تیر زدن	tiːɾzædæn
اسپین	espiːn
ونزوئلا	venezuːelɒː
دیکتاتور	diːktɒːtoɾ
غارت کردن	ɢɒːɾætkæɾdæn
اتحاد شوروی	ettehɒːdeʃuːɾæviː,ettehɒːdeʃouːɾæviː
موم	muːm
سقرلات	sæɢeɾlɒːt
رنسانس	ɾonesɒːns
نقش زدن	næɢʃzædæn
جولان دادن	d͡ʒoʊlɒːndɒːdæn
رد و بدل	ɾædobædæl
مجروح	mæd͡ʒɾuːh
خاس	xɒːs
نشست	neʃæst
ساختمون	sɒːxtemuːn
تلفن	telefon
ماچ کردن	mɒːt͡ʃkæɾdæn,mɒːt͡ʃkæɾdæn
مسی	mesiː
دور زدن	doʊɾzædæn,doʊɾzædæn
نیش زدن	niːʃzædæn
هفته‌ی گذشته	hæftejeɡozæʃte
یهودیت	jæhuːdiːjæt
دستبند	dæstbænd
نیروی هوائی	niːɾuːjehævɒːjiː
هاید پارک	hɒːjdpɒːɾk
وسترن	vesteɾn
سپیدار	sæpiːdɒːɾ,sepiːdɒːɾ
دباغی	dæbbɒːɢiː
جعلی	d͡ʒæʔliː
خودکشی کردن	xodkoʃiːkæɾdæn
رگ	ɾæɡ
نحو	næhv
کتاب‌فروش	ketɒːbfoɾuːʃ
پاسارگاد	pɒːsɒːɾɡɒːd
ضمیمه	zæmiːme
وقت گل نی	væɢteɡolenej
بازداشتن	bɒːzdɒːʃtæn
بدعت	bedʔæt
آمیخته	ɒːmiːxte,ɒːmiːxtæ
آروغ	ɒːɾoɢ
دانوب	dɒːnuːb
ساحره	sɒːhæɾe
حباب	hebɒːb
اجازه	ed͡ʒɒːze
سایه	sɒːje
تورم	tævæɾɾom
کس لیسیدن	kosliːsiːdæn
فیزیک اتمی	fiːziːkeætomiː
امانت دادن	æmɒːnætdɒːdæn
کاتالانی	kætælɒːniː
عدسی	ædæsiː,æddæsiː
چهچهه زدن	t͡ʃæht͡ʃæhezædæn
جای	d͡ʒɒːj
گاما	ɡɒːmɒː
امشب	emʃæb
خاور دور	xɒːvæɾeduːɾ
زبان ژاپنی	zæbɒːneʒɒːponiː
زبان بلوچی	zæmɒːnebæluːt͡ʃiː
غیبت کردن	ɢejbætkæɾdæn
امکان	emkɒːn
تلگراف شدن	teleɡɾɒːfʃodæn
پاک	pɒːk
سیخ‌زن	siːxzæn
هله‌لویا	hæleluːjɒː
کتاب عبارت	ketɒːbeʔebɒːɾæt
رکاب	ɾekɒːb
بنفش	bænæfʃ
توانستن	tævɒːnestæn
طفره	tæfɾe
قلیون	ɢæljuːn
جهت اطلاع	d͡ʒæhæteettelɒːʔ
حسب حال	hæsbehɒːl
کرنر	koɾneɾ
نوازش دادن	nævɒːzeʃdɒːdæn
خورشید	xuːɾʃiːd,xoɾʃiːd
صورتی	soɾætiː,suːɾætiː
از کی	æzkej
ناجور	nɒːd͡ʒuːɾ
معلّم	moællem
معاینه کردن	moʔɒːjenekæɾdæn
گشت زدن	ɡæʃtzædæn
سایت زدن	sɒːjtzædæn
تنه زدن	tænezædæn
زخم زبان زدن	zæxmezæbɒːnzædæn
سوزن ته‌گرد	suːzænetæhɡeɾd
بزن به تخته	bezænbetæxtæ
راد	ɾɒːd
اکسید	oksiːd
آهنگ جمله	ɒːhænɡed͡ʒomle
خسارت	xesɒːɾæt
چکه	t͡ʃekke
اتاق	otɒːɢ
لگو	leɡuː,leɡo
خط خوردن	xætxoɾdæn
بدی	bædiː
پالایشگاه	pɒːlɒːjeʃɡɒːh
توله	tuːle
متد	metod
زنگ خوردن	zænɡxoɾdæn
عالم	ʔɒːlæm,ʔɒːlem
فریاد	fæɾjɒːd
دوره	douːɾe,doɾæ,doɾe
گربۀ پشمالو	ɡoɾbejepæʃmɒːluː
سیام	sjɒːm
پوزخند زدن	puːzxændzædæn
مسافرخانهچی	mosæfeɾxɒːneht͡ʃiː
روان‌شناسی	ɾævɒːnʃenɒːsiː
پرسه	pæɾse
دیدار کردن	diːdɒːɾkæɾdæn
تصاحب کردن	tæsɒːhobkæɾdæn
عکاس	ʔækkɒːs
کلاغ	kælɒːɢ
میخ	miːx
لیوان	liːvɒːn
مسلسل گاتلینگ	mosælsælɡɒːtliːnɡ
اشتباه	eʃtebɒːh
عزا	æzɒː
برعکس	bæɾʔæks
قورباغه	ɢuːɾbɒːɢe
فرهنگ‌نویسی	fæɾhænɡnæviːsiː
كالبد	kɒːlbod
اندازه شدن	ændɒːzeʃodæn
پا	pɒː
هالیوود	hɒːliːvuːd
از	æz
وان	vɒːn
جهل زدن	d͡ʒæhlzædæn
پیشباز  پیشواز آمدن	piːʃbɒːzɒːmædæn
پژو	puːʒo
پناه آوردن	pænɒːhɒːvæɾdæn
بحث	bæhs,bæhæs
بازی کردن	bɒːziːkæɾdæn,bɒːziːkæɾdæn
امارات عربی متحده	emɒːɾɒːtæɾæbiːmotæhiːde
شیخ	ʃejx
بکار بردن	bekɒːɾboɾdæn
زوزه کشیدن	zuːzekeʃiːdæn
ترویج	tæɾviːd͡ʒ
بزک کردن	bæzækkæɾdæn
ارغوانی	æɾɢævɒːniː
نصب شدن	næsbʃodæn
انیمیشن ژاپنی	æniːmeʒɒːponiː
جده	d͡ʒedde
افسس	æfss
بیزار کردن	biːzɒːɾkæɾdæn
پروژه	pɾoʒe
آگاهی دادن	ɒːɡɒːhiːdɒːdæn
هوموفوبیا	huːmuːfuːbiːjɒː
تکرار شدن	tekɾɒːɾʃodæn,tækɾɒːɾʃodæn
آرایش	ɒːɾɒːjeʃ
قواخ	ɢævɒːx
تحویل گرفتن	tæhviːlɡeɾeftæn
عظیم	æziːm
رقص کردن	ɾæɢskæɾdæn
عقرب زدن	æɢɾæbzædæn
اکنون	æknuːn
ماهی‌فروش	mɒːhiːfoɾuːʃ
دوختن	duːxtæn
سوسو زدن	suːsuːzædæn
ناخوشی	nɒːxuːʃiː,nɒːxoʃiː
اوراسیا	oɾɒːsiːjɒː
روشنا	ɾoʊʃænɒː
گرگ	ɡoɾɡ
باعث شدن	bɒːʔesʃodæn
جیوه	d͡ʒiːve
طاووس هندی	tɒːvuːsehendiː
خوشمزه	xoʃmæze,xuːʃmæze,xoʃmæzæ
چندتایی	t͡ʃændtɒːjiː
ملافه	mælɒːfe
هلال حاصلخیز	helɒːlehɒːselxiːz
وب‌گاه	vebɡɒːh
الکترونیک	elekteɾoniːk
داغ کردن	dɒːɢkæɾdæn
مسئله	mæsæle
کفاش	kæffɒːʃ
فراموشکاری	fæɾɒːmuːʃkɒːɾiː
صعب	sæʔb
تاندون	tɒːndon
لگد خوردن	læɡædxoɾdæn
خواهش کردن	xɒːheʃkæɾdæn,xɒːheʃkæɾdæn
زیرا	ziːɾɒː
سرخابی سیر	soɾxɒːbiːsiːɾ
قبا	ɢæbɒː
حسودی کردن	hæsuːdiːkæɾdæn
خواستگاری کردن	xɒːsteɡɒːɾiːkæɾdæn
برنامک	bæɾnɒːmæk
باقلوا	bɒːɢlævɒː
مایونز	mɒːjonez
شوخی کردن	ʃuːxiːkæɾdæn
عدس	ʔædæs,ædæs
تیم	tiːm
پاپایه	pɒːpɒːje
بوسنیائی	bosniːjɒːʔiː
ماسه بادی	mɒːssebɒːdiː
خبر شدن	xæbæɾʃodæn
قاشق	ɢɒːʃeɢ,ɢɒːʃoɢ
چغندر	t͡ʃoɢondæɾ
دست و پا کردن	dæstopɒːkæɾdæn
رنگ کردن	ɾænɡkæɾdæn,ɾænɡkæɾdæn
نم کشیدن	næmkeʃiːdæn
راه	ɾɒːh
شفا دادن	ʃæfɒːdɒːdæn
تباری	tæbɒːɾiː
فیس بوک	fesbuːk
ون	væn
قرارملاقات	ɢæɾɒːɾemolɒːɢɒːt
کاشغر	kɒːʃɢæɾ
جرم گرفتن	d͡ʒeɾmɡeɾeftæn
فوتون	foton
تجربه	tæd͡ʒɾobe
بخواهیم	bexɒːhiːm
به امید دیدار	beomiːdediːdɒːɾ
مغولی	moɢuːliː
نیکل	niːkel
آشخال	ɒːʃxɒːl
عطر	ætɾ
خرخر	xoɾxoɾ
پسرخوانده	pesæɾxwɒːnde
دارواش	dɒːɾvɒːʃ
آماج گرفتن	ɒːmɒːd͡ʒɡeɾeftæn
بالا زدن	bɒːlɒːzædæn
یخ زدن	jæxzædæn
منظره	mænzæɾe
کاهش دادن	kɒːheʃdɒːdæn
می زدن	mejzædæn
ستایش	setɒːjeʃ
جناب	d͡ʒenɒːb
کپک زدن	kæpækzædæn
توهین کردن	toʊhiːnkæɾdæn
خارج	xɒːɾed͡ʒ
کوچه	kuːt͡ʃe
یک کمی	jekkæmiː
خوكچه	xuːkt͡ʃe
برتونی	beɾetuːniː,beɾetoniː
بازیگر	bɒːziːɡæɾ
نئونازی	neʔuːnɒːziː
توضیح	toʊziːh
محاکمه کردن	mohɒːkemekæɾdæn
مارى	mɒːɾiː
ریش زدن	ɾiːʃzædæn
موشواره	muːʃvɒːɾæ
بشکن	beʃkæn
حکومت	hokuːmæt
زل زدن	zolzædæn
سیگارت	siːɡɒːɾet
خارکوف	xɒːɾkov,xɒːɾkuːv
دندان پزشکی	dændɒːnpezeʃkiː
باغلاما	bɒːɢlɒːmɒː
لیسیدن	liːsiːdæn
نگاه داشتن	neɡɒːhdɒːʃtæn
بن	bon
جواب کردن	d͡ʒævɒːbkæɾdæn
اپل	epl
چشم انداز	t͡ʃæʃmændɒːz
برخاستن	bæɾxɒːstæn
مردم	mæɾdom
یه کمی	jekæmiː
پسردائی	pesæɾdɒːʔiː
بازوبند	bɒːzuːbænd
بیمارستان	biːmɒːɾestɒːn
گونیا	ɡuːniːjɒː
عروسی گرفتن	æɾuːsiːɡeɾeftæn
انگبین	ænɡæbiːn,ænɡobiːn
انجام دادن	ænd͡ʒɒːmdɒːdæn
تثبیت	tæsbiːt
سر	sæɾ,seɾ,soɾ
لب زدن	læbzædæn
مسافرت کردن	mosɒːfeɾætkæɾdæn
هیدروژن	hiːdɾod͡ʒen
اسفند	esfænd
هلو	holuː
درد آوردن	dæɾdɒːvæɾdæn
صحنه رقص	sæhnejeɾæɢs
ترجیح دادن	tæɾd͡ʒiːhdɒːdæn,tæɾd͡ʒiːhdɒːdæn
بمبئی	bombæʔiː
سفارتخانه	sefɒːɾætxɒːne
قرمزی	ɢeɾmeziː
موسم	mæuːsæm
فراداده	fæɾɒːdɒːde
هوش	huːʃ
استودیو	estuːdiːjuː
بالگرد	bɒːlɡæɾd
فاصله	fɒːsele
گل آفتاب‌گردان	ɡolæftɒːbɡæɾdɒːn
طبقه	tæbæɢe
قلقلک دادن	ɢelɢelækdɒːdæn
پایگاه داده‌ها	pɒːjɡɒːhedɒːdehɒː
وجود	vod͡ʒuːd
کشیده خوردن	keʃiːdexoɾdæn
نازی	nɒːziː
دایی‌زاده	dɒːjiːzɒːde
نیویورک	njuːjuːɾk
مشهد	mæʃhæd
خواسته‌ایم	xɒːsteiːm
فدراسیون	fedeɾɒːsjuːn
لیف	liːf
دکتر کودکان	doktoɾekuːdækɒːn
چندش شدن	t͡ʃendeʃʃodæn
بلودى مارى	bluːdiːmɒːɾiː
کله	kællæ,kælle
جعفری	d͡ʒæʔfæɾiː
تلگراف کردن	teleɡɾɒːfkæɾdæn
گول	ɡuːl
سرهنگ	sæɾhænɡ
کلم	kælæm
تنگه بسفر	tænɡæbosfoɾ
خور	xuːɾ
رودست خوردن	ɾuːdæstxoɾdæn
متغیر عضو	moteɢejjeɾeozv
سرم	seɾom
ژیرش	ʒiːɾeʃ
بیماری زدن	bebiːmɒːɾiːzædæn
مبارزه کردن	mobɒːɾezekæɾdæn
صدا	sedɒː
سینما	siːnemɒː
تنگدستی	tænɡdæstiː
کارمند	kɒːɾmænd
زیست	ziːst
روانکاو	ɾævɒːnʔkɒːv
رف	ɾæf
شپش	ʃepeʃ
اس ام اس زدن	esemeszædæn
دیوانه	diːvɒːne
بکن	bokon
جورجیا	d͡ʒuːɾd͡ʒiːjɒː
اطلاع	ettelɒːʔ
برچسب زدن	bæɾt͡ʃæsbzædæn,bæɾt͡ʃæsbzædæn
عرق ریختن	æɾæɢɾiːxtæn
بندرگاه	bændæɾɡɒːh
شکوفه	ʃokuːfe
ولت	volt
تشکر کردن	tæʃækkoɾkæɾdæn
چین افتادن	t͡ʃiːnoftɒːdæn
افزودن	æfzuːdæn
شگرد	ʃeɡeɾd
تثبیت کردن	tæsbiːtkæɾdæn
شاتوت	ʃɒːtuːt
کشاورزی	keʃɒːvæɾziː
شکلک	ʃeklæk
متن ادبی	mætneædæbiː
دفتر	dæftæɾ
وقتی که	væɢtiːke
خشت	xeʃt
درز	dæɾz
آلوچه جنگلی	ɒːluːt͡ʃed͡ʒænɡæliː
لکنت	loknæt
تخته سنگ	tæxtesænɡ,tæxtæsænɡ
کروکودیل	kɾokodiːl
بازیافت	bɒːzjɒːft
بازو	bɒːzuː
پدرجد	pedæɾd͡ʒædd
نگهداری	neɡæhdɒːɾiː
دم زدن	dæmzædæn
خسته	xæstæ,xæste
اسفناج	esfenɒːd͡ʒ
وافن اس‌اس	vɒːfeneses
آفتاب	ɒːftɒːb
معاصر	moʔɒːseɾ
کاخ سفید	kɒːxesæfiːd
چی	t͡ʃiː
پینه زدن	piːnezædæn
کلیدی	keliːdiː
شکم	ʃekæm
سنگال	seneɡɒːl
کام کشیدن	kɒːmkeʃiːdæn
پارسه	pɒːɾse
گردو	ɡeɾduː
فکس کردن	fækskæɾdæn
ایمان	iːmɒːn
خردمندی	xeɾædmændiː
افترا زدن	efteɾɒːzædæn
شادی	ʃɒːdiː
وزن	væzn
مورچه	muːɾt͡ʃe
بيگـاری گرفتن	biːɡɒːɾiːɡeɾeftæn
التزامی	eltezɒːmiː
واژن	vɒːʒæn
نخست وزیر	noxostvæziːɾ
راديوم	ɾɒːdiːjuːm
زعفران	zæʔfeɾɒːn
قایق	ɢɒːjeɢ
واتیکان	vɒːtiːkɒːn
سلام دنیا	sælɒːmdonjɒː
گاه به گاه	ɡɒːhbeɡɒːh
پوزیترون	posiːtɾon
توجیه کردن	tod͡ʒiːhkæɾdæn
داشتی می‌خواستی	dɒːʃtiːmíxɒːstiː
بدبو	bædbuː
دستشویی	dæstʃuːtiː
گریه انداختن	ɡeɾjeændɒːxtæn
خانم	xɒːnom
سرمه	soɾme
پیشاب	peʃɒːb
بخیه کردن	bæxiːjekæɾdæn
گجراتی	ɡod͡ʒæɾɒːtiː
پروانه	pæɾvɒːne
زلزله	zelzele
ذوق زدن	zoʊɢzædæn
ستوان	sotvɒːn
گرمساز	ɡæɾmsɒːz
سوپرمارکت	suːpeɾmɒːɾket
زخم	zæxm
سیسیل	siːsiːl
عنان	ænɒːn
گو	ɡoʊ,ɡuː
رغبت	ɾeɢbæt
صورت	suːɾæt
درگوشی	dæɾeɡuːʃiː
گذاشتن	ɡozɒːʃtæn,topuːt
مشت زدن	moʃtzædæn
اسلیمی	esliːmiː
استفراغ افتادن	estefɾɒːɢoftɒːdæn
فهمیدید	fæhmiːdiːd
سی	siː
سوراخ	suːɾɒːx
دموکراسی	demuːkɾɒːsiː
اگر و فقط اگر	æɡæɾvæfæɢætæɡæɾ
تاکتیک	tɒːktiːk
نود	nævæd
سورانی	soɾɒːniː
گربه	ɡoɾbe
اول	ævvæl
ظرف	zæɾf
چروک	t͡ʃoɾuːk
مهمانی	mehmɒːniː
چنگ زدن	t͡ʃænɡzædæn
روزنامه	ɾuːznɒːme
چشم	t͡ʃeʃm,t͡ʃæʃm,t͡ʃæŝm,t͡ʃeʃmt͡ʃæʃm
عراق	ʔeɾɒːɢ
میانبر زدن	miːɒːnboɾzædæn
اماکن	æmɒːken
راندن	ɾɒːndæn
با	bɒː
آبکش	ɒːbkeʃ
باد دادن	bɒːddɒːdæn
کیسه کشیدن	kiːsekeʃiːdæn
کد پستی	kodepostiː
ان	æn
گردن زدن	ɡæɾdænzædæn,ɡæɾdænzædæn
لائوس	lɒːʔos
فسرده	fesoɾde
مزرعه	mæzɾæʔe
مرغ	moɾɢ
نیرنگ	nejɾænɡ
خروس	xoɾuːs
قیماق	ɢejmɒːɢ
یازده	jɒːzdæh
مياني	miːjɒːniː
کریکت	kɾiːket
بیکاری کشیدن	biːkɒːɾiːkeʃiːdæn
خیز	xiːz
یه	je
دستکش	dæstkeʃ
پنجه	pænd͡ʒe
پنسیلین زدن	penesiːliːnzædæn
رمزنگاری	ɾæmzneɡɒːɾiː
زمین	zæmiːn
به صحنه آوردن	besæhneævæɾdæn
ویرایش	viːɾɒːjeʃ
روشنگری	ɾoʃænɡæɾiː
حریف	hæɾiːf
شلیل.شبرنگ	ʃæliːl.ʃæbɾænɡ
ناکارامد	nɒːkɒːɾɒːmæd
دژخیم	doʒxiːm
گلاسنوست	ɡlɒːsnost
نامزد	nɒːmzæd
سهل	sæhl
کاخ	kɒːx
بینایی	biːnɒːjiː
جگر	d͡ʒeɡæɾ
رسانه	ɾesɒːne,ɾæsɒːne
کبالت	kobɒːlt
یورو	juːɾo
گوشه و کنایه زدن	ɡuːʃeokenɒːjezædæn
استخدام شدن	estexdɒːmʃodæn
سردبیر	sæɾdæbiːɾ
اقلا	æɢælæn
خوشه	xuːʃe,xuːʃæ
برزیل	beɾziːl,beɾeziːl
نشان زرین	neʃɒːnezæɾiːn
بيست	biːst
تمام شدن	tæmɒːmʃodæn
پول	puːl
خطا	xætɒː
درمان	dæɾmɒːn
چک خوردن	t͡ʃækxoɾdæn
حیفا	hæiːfɒː
لغت‌نامه	loɢætnɒːme
تابع	tɒːbeʔ
غوطه زدن	ɢuːtezædæn
فرش کردن	fæɾʃkæɾdæn,fæɾʃkæɾdæn
مارک	mɒːɾk
جامع	d͡ʒɒːmeʔ
فشار دادن	feʃɒːɾdɒːdæn,feʃæɾdɒːdæn
دست نخورده	dɒːstnæxoɾde
برنجی	beɾend͡ʒiː
آب اکسیژنه	ɒːboksiːʒene
ساختگی	sɒːxteɡiː
له له زدن	læhlæhzædæn
هدایت شدن	hedɒːjætʃodæn
چنگ	t͡ʃænɡ
عهده	ohde
کاف	kɒːf
سیمرغ	siːmoɾɢ
آرزو کردن	ɒːɾezuːkæɾdæn
احتياط کردن	entiːɒːtkæɾdæn
سخت‌پوست	sæxtpuːst
چند	t͡ʃænd
دلنواز	delnævɒːz
ضربدر زدن	zæɾbdæɾzædæn
مولداوی	muːldɒːviː
برش	boɾʃ,boɾeʃ
دائرةالمعارف	dɒːʔeɾætolmæʔɒːɾef
باسکی	bɒːskiː
دختر	doxtæɾ
خوکچه هندی	xuːkt͡ʃejehendiː
صقلیه	seɢliːje
کاهش	kɒːheʃ
سیکتیوکار	siːktiːvkɒːɾ
گوندولا	ɡondolɒː
جانان	d͡ʒɒːnɒːn
پنسیلین	penesiːliːn
ناو	nɒːv
هویج	hæviːd͡ʒ
همدستی کردن	hæmdæstiːkæɾdæn
ناخنک 	nɒːxonæk
هالووین	hɒːlouːviːn
بلند	bolænd
چین	t͡ʃiːn
شکر کردن	ʃokɾkæɾdæn
گیتاشناسی	ɡiːtɒːʃenɒːsiː
بژم	bæʒm
فورا	fævɾæn
یاسمین	jɒːsæmiːn
تخت	tæxt
استعداد	esteʔdɒːd
پریشب	pæɾiːʃæb
نهر	næhɾ
راه شاهی	ɾɒːheʃɒːhiː
باباآدم	bɒːbɒːdæm
دشوار	doʃvɒːɾ
کامامبر	kɒːmɒːmbeɾ
قرآن	ɢoɾʔɒːn
تب	tæb
پاپ	pɒːp
تهيه دیدن	tæhiːjediːdæn
هاردکور	hɒːɾdkoɾ
وجود آمدن	vod͡ʒuːdɒːmædæn
چشم‌غره	t͡ʃeʃmɢoɾɾe
پدربزرگ و مادربزرگ	pedæɾbozoɾɡomɒːdæɾbozoɾɡ
دانستن	dɒːnestæn
فارماکولوژی	fɒːɾmɒːkoloʒiː
نعل اسب	næʔleæsb
لانه	lɒːne
افتادن	oftɒːdæn
پیغام	pejɢɒːm
استرالیا	ostɾɒːliːjæ
پایان	pɒːjɒːn
خواننده زن	xɒːnændejezæn
پانجه​آ	pænd͡ʒēɒː
اکوادور	ekvɒːdoɾ
ادوکلن	odokolon
اسفنج	esfænd͡ʒ
بستنی	bæstæniː
دور گرفتن	doʊɾɡeɾeftæn
برق	bæɾɢ
زبان خارجی	zæbɒːnexɒːɾed͡ʒiː
نمودن	nemuːdæn
لجاجت	led͡ʒɒːd͡ʒæt
چارک	t͡ʃɒːɾæk
بتا	betɒː
مالایی	mɒːlɒːjiː
کلنگ	kolænɡ
اطاعت کردن	etɒːʔætkæɾdæn
آدمی	ɒːdæmiː
خسارت خوردن	xesɒːɾætxoɾdæn
جورج تاون	d͡ʒoɾd͡ʒtɒːuːn
صحرای غربی	sæhɒːɾæɢæɾbiː
آشنایی	ɒːʃnɒːjiː
الله اکبر	ællɒːhoækbæɾ
وصله زدن	væslezædæn
همگام‌سازی	hæmɡɒːmsɒːziː
آرزومندی	ɒːɾezuːmændiː
پهن	pæhn,pehen
دولت	douːlæt,doʊlæt
لمس	læms
پورسلین	poɾseliːn
قیچی	ɢejt͡ʃiː
تشويق کردن	tæʃviːɢkæɾdæn
مثال زدن	mesɒːlzædæn
تجربه کردن	tæd͡ʒɾobekæɾdæn
اجاره کردن	ed͡ʒɒːɾekæɾdæn,ed͡ʒɒːɾekæɾdæn
نامک	nɒːmæk
متحد	mottæhed
یادداشت	jɒːddɒːʃt
افترا	efteɾɒː
مالش دادن	mɒːleʃdɒːdæn
مراعات کردن	moɾɒːʔɒːtkæɾdæn
اخترشناس	æxtæɾʃenɒːs
ژنرال	ʒeneɾɒːl
آشغال	ɒːʃɢɒːl
اعتراف کردن	eʔteɾɒːfkæɾdæn
مالیات	mɒːliːjɒːt
اجاره دادن	ed͡ʒɒːɾedɒːdæn,ed͡ʒɒːɾedɒːdæn
سوهان زدن	sohɒːnzædæn
ارث رسیدن	eɾsɾesiːdæn
موافق بودن	movɒːfeɢbuːdæn
استفراغ	estefɾɒːɢ
افزایش	æfzɒːjeŝ,æfzɒːjeʃ
بي ابهام	biːebhɒːm
خداحافظی	xodɒːhɒːfeziː
بهره گرفتن	bæhɾeɡeɾeftæn
لقب گرفتن	læɢæbɡeɾeftæn
حیرت افتادن	hejɾætoftɒːdæn
قیمت	ɢejmæt
نگهبان	neɡæhbɒːn
ترگمان	tæɾɡomɒːn
شدن	ʃodæn
تشریف آوردن	tæʃɾiːfɒːvæɾdæn
گت	ɡæt,ɡot
هنر رزمی	honæɾeɾæzmiː
مارخوار	mɒːɾxɒːɾ
بازی‌های المپیک	bɒːziːhɒːjeolæmpiːk
جعبه نامه	d͡ʒæʔbejenɒːme
ژرف	ʒæɾf
سرعت نور	soɾʔætenuːɾ
خراميدن	xæɾɒːmiːdæn
تبدیل	tæbdiːl
پرده کرکره	pæɾdekeɾkeɾe
عقد	æɢd
خالی	xɒːliː
جراحی کردن	d͡ʒæɾɾɒːhiːkæɾdæn
چاقو زدن	t͡ʃɒːɢuːzædæn
خواستید	xɒːstiːd
پس انداز	pæsændɒːz
ترنج	toɾænd͡ʒ
ساکت شدن	sɒːketʃodæn
تامبوف	tɒːmbuːf
برادرخوانده	bæɾɒːdæɾxwɒːnde
گند زدن	ɡændzædæn
امان آوردن	æmɒːnɒːvæɾdæn
دنیا	donjɒː
استفاده	estefɒːde
خلاصه کردن	xolɒːsekæɾdæn
بغض گرفتن	boɢzɡeɾeftæn
جنگ سرد	d͡ʒænɡesæɾd
تخم کردن	toxmkæɾdæn
جوراب	d͡ʒuːɾɒːb
خاطرخواه	xɒːteɾxɒːh
زنگی	zænɡiː
مغازه	mæɢɒːze
گلوله خوردن	ɡoluːlexoɾdæn
خواهیم خواست	xɒːhímxɒːst
قاب	ɢɒːb
نقاشی کردن	næɢɢɒːʃiːkæɾdæn
در غیر این صورت	dæɾɢejɾeiːnsuːɾæt
بدل	bædæl
آبْلرْزه	ɒːblæɾze
مهمانسرا	mehmɒːnsæɾɒː
هندی	hendiː
دست آمدن	dæstɒːmædæn
ترمذ	teɾmez
مش	meʃ
تابع گاما	tɒːbeeɡæmmæ
ثروتمند	seɾvætmænd
رخ	ɾox
الیستا	eliːstɒː
نعلبند	nælbænd
ترازو	tæɾɒːzuː
حلقه زدن	hælɢezædæn
دانمارک	dɒːnmɒːɾk
ضربدر	zæɾbdæɾ
باید	bɒːjæd
فی	fiː
منظومه شمسی	mænzuːmeʃæmsiː
حاملگی	hɒːmeleɡiː
دون ژوان	donʒovɒːn
حظ کردن	hæzkæɾdæn
جبری	d͡ʒæbɾiː
استکان زدن	estekɒːnzædæn
درون	dæɾuːn
پلاک	pelɒːk
نوشیدنی الکلی	nuːʃiːdæniːjeælkoliː
رقاص	ɾæɢɢɒːs
برو	boɾuː,bæɾuː
نارنجی سیر	nɒːɾend͡ʒiːsiːɾ
جزیره ایستر	d͡ʒæziːɾeiːsteɾ
ساتراپ	sɒːtɾɒːp
شوید	ʃeviːd
کم گوی	kæmɡuːj
نوگل	noʊɡol
غلت زدن	ɢæltzædæn
آب‌نما	ɒːbnæmɒː
باد	bɒːd
غنچه	ɢont͡ʃæ,ɢont͡ʃe
غوغا	ɢævɢɒː,ɢouːɢɒː
ارائه	eɾɒːʔe
تقلید کردن	tæɢliːdkæɾdæn,tæɢliːdkæɾdæn
پرده گوش	pæɾdejeɡuːʃ
گوش دادن	ɡuːʃdɒːdæn,ɡuːʃdɒːdæn
انس گرفتن	onsɡeɾeftæn
آفتابی	ɒːftɒːbiː
از حالا	æzhɒːlæn
داربست	dɒːɾbæst
گنوستیسیزم	ɡnostiːsiːzm
جوش	d͡ʒuːʃ
باختر	bɒːxtæɾ
اسهال	eshɒːl
وینتیان	ventiːɒːn
خواهی خواست	xɒːhíxɒːst
ام	em,æm
هیچ وقت	hiːt͡ʃvæɢt
توقع	tævæɢɢoʔ
سلاح	selɒːh
ترجمه	tæɾd͡ʒome
نابود کردن	nɒːbuːdkæɾdæn
بانک اطلاعات	bɒːnkettelɒːʔɒːt
پارامسی	pɒːɾɒːmesiː
سمارت‌ فون	smɒːɾtfon
مات زدن	mɒːtzædæn
اخلاق	æxlɒːɢ
گنیس	ɡnejs
پایداشتن	pɒːjdɒːʃtæn
کلاه	kolɒːh
عاریت	ɒːɾjæt
مگر	mæɡæɾ
بروز دادن	boɾuːzdɒːdæn
ارمغان دادن	æɾmæɢɒːndɒːdæn
آشیانه گرفتن	ɒːʃjɒːneɡeɾeftæn
توصیف کردن	toʊsiːfkæɾdæn
سیخ زدن	siːxzædæn
کولون	kolon
عفو کردن	æfkæɾdæn
ووتیک	votiːk
بنزین زدن	benziːnzædæn
درآمد	dæɾɒːmæd
نویسه‌گردانی	neviːseɡæɾdɒːniː
بی‌مهره	biːmohɾe
تابه	tɒːbe
رامی	ɾɒːmiː
آغا	ɒːɢɒː
کاپوچینو	kɒːpuːt͡ʃiːnuː
همجنس‌گرا	hæmd͡ʒensɡæɾɒː
می‌خواستی	míxɒːstiː
هندوستانی	henduːstɒːniː
رسیدگی کردن	ɾesiːdeɡiːkæɾdæn
ژانر	ʒɒːnɾ
جمجمه	d͡ʒomd͡ʒome
خشایارشا	xʃɒːjɒːɾʃɒː,xæʃɒːjɒːɾʃɒː
تاول زدن	tɒːvælzædæn
پانزده	pɒːnzdæh
اوج	oʊd͡ʒ
خنده گرفتن	xændeɡeɾeftæn
برگزیده شده	bæɾɡoziːdeʃode
خوشنویسی	xoʃneviːsiː
هندوانه	hendevɒːne
خطر	xætæɾ
مسلخ	mæslæx
انتقاد	enteɢɒːd
نافرمانی	nɒːfæɾmɒːniː
لیسبون	liːsbon
هتل	hotel
صیقل زدن	sejɢælzædæn
پس گردنی زدن	pæsɡæɾdæniːzædæn
کشتی هوایی	kæʃtiːjehævɒːjiː
دید	diːd
قناس	ɢenɒːs
حوله	hole
نامادری	nɒːmɒːdæɾiː
تا شدن	tɒːʃodæn
مذبح	mæzbæh
پشت	poʃt
فانوس	fɒːnuːs
تمام	tæmɒːm
ژیوه	ʒiːve
تلفظ کردن	tælæffozkæɾdæn
تشويق	tæʃviːɢ
آبچین	ɒːbt͡ʃiːn
تاسمانی	tɒːsmɒːniː
کلّه سخت	kællesæxt
شهرک	ʃæhɾæk
کمر	kæmæɾ
سرنیزه	sæɾnejze
مصرف کننده	mæsɾæfekonænde
ماکائو	mɒːkɒːo
جولیا	d͡ʒuːliːɒː
برادرزن	bæɾɒːdæɾzæn
حکایت کردن	hekɒːjætkæɾdæn
خم	xæm
یخکوه	jæxkuːh
هالتر زدن	hɒːlteɾzædæn
پشت سر هم	poʃtesæɾehæm
اجاس	ed͡ʒɒːs
نگاه	neɡɒːh
دوزخ	duːzæx
همرقص	hæmɾæɢs
همساخته	hæmsɒːxtæ
رهبر ارکستر	ɾæhbæɾeoɾkestɾ
مریض	mæɾiːz
چاک دادن	t͡ʃɒːkdɒːdæn
الهام	elhɒːm
کشتی گرفتن	koʃtiːɡeɾeftæn
جیش	d͡ʒiːʃ
زهرخنده	zæhɾxænde
جفتک	d͡ʒoftæk
آماده	ɒːmɒːde,ɒːmɒːdæ
پهنیان	pehenjɒːn
چشش	t͡ʃeʃeʃ
سوچی	sot͡ʃiː
مک زدن	mekzædæn
آروغ زدن	ɒːɾoɢzædæn
ختم	xætm
بالاتر	bɒːlɒːtæɾ
پستخانه	postxɒːne
کیپا	kiːpɒː
درویش	dæɾviːʃ
تمرین	tæmɾiːn
باردار	bɒːɾdæɾ
امیدوار بودن	omiːdvɒːɾbuːdæn
اعتنا کردن	eʔtenɒːkæɾdæn
کی ۲	kejdoh
جار زدن	d͡ʒɒːɾzædæn
تخت جمشید	tæxted͡ʒæmʃiːd
زهر	zæhɾ
مهرابه	mehɾɒːbe
شاهوار	ʃɒːhvɒːɾ
جبران کردن	d͡ʒobɾɒːnkæɾdæn
زجر دادن	zæd͡ʒɾdɒːdæn
یکتاپرستی	jektɒːpæɾæstiː
میز	miːz
دوجین	dod͡ʒiːn
کنفرانس	konfeɾɒːns
پروسه	pɾose
کامبوج	kɒːmbuːd͡ʒ
دات‌نت	dɒːtnet
تونل	tuːnel
دیپلماسی	diːplomɒːsiː
خاج	xɒːd͡ʒ
لحظه	læhze
بربط	bæɾbæt
پوست	puːst
مراعات	moɾɒːʔɒːt
شبیخون زدن	ʃæbiːxuːnzædæn
خط‌کش	xættkeʃ,xætkeʃ
سخن	soxæn
بوق زدن	buːɢzædæn
ادا کردن	ædɒːkæɾdæn
زاری	zɒːɾiː
تیر و کمان	tiːɾokæmɒːn
شمارشگر	ʃomɒːɾeʃɡæɾ
بغض	boɢz
نیشخند زدن	niːʃxændzædæn
پس کشیدن	pæskeʃiːdæn
تشدید	tæʃdiːd
کشاورز	keʃɒːvæɾz
محو	mæhv
سرما خوردن	sæɾmɒːxoɾdæn
ونگ	vænɡ
روزانه	ɾuːzɒːne
کبوتر	kæbuːtæɾ
بهرام	bæhɾɒːm
مردم‌سالاری	mæɾdomsɒːlɒːɾiː
کیبورد	kiːboɾd
شجاع	ʃod͡ʒɒːʔ
آنها	ɒːnhɒː
مفقود	mæfɢuːd
نوامبر	novɒːmbɾ
اسپانیا	espɒːniːjæ
سفر کردن	sæfæɾkæɾdæn,sæfæɾkæɾdæn
پدر	pedæɾ
اتوبوس	otobuːs
كو كلوكس كلان	kuːkluːksklɒːn
کریسمس	keɾiːsmæs
بخواهد	bexɒːhæd
گرچه	ɡæɾt͡ʃe
در منزل	dæɾmænzel
آواز دادن	ɒːvɒːzdɒːdæn
سرخس	sæɾæxs
قاپ زدن	ɢɒːpzædæn
کلاسور	kelɒːsoɾ
ابن سینا	ebnesiːnɒː
فریاد آمدن	fæɾjɒːdɒːmædæn
سنگ زدن	sænɡzædæn
رسانه گروهی	ɾesɒːneʔjeɡoɾuːhiːʔ,ɾæsɒːneʔjeɡoɾuːhiːʔ
ترک برداشتن	tæɾækbæɾdɒːʃtæn
نوشابه زدن	nuːʃæbezædæn
سبز	sæbz
اگزیستانسیالیسم	eɡziːstɒːnsiːɒːliːsm
چکاوک	t͡ʃækɒːvæk
بغل زدن	bæɢælzædæn
قوی سیاه	ɢuːjesiːjɒːh
زبان مالایی	zæbɒːnemɒːlɒːjiː
کوچ‌ها	kuːt͡ʃhɒː
خشم آمدن	xæʃmɒːmædæn
کام	kɒːm
پاراگوئه	pɒːɾɒːɡuːʔe
نقصان گرفتن	noɢsɒːnɡeɾeftæn
برده	bæɾdæ
ارزیابی کردن	æɾzjɒːbiːkæɾdæn
کردنی	kæɾdæniː
ویسکی	viːskiː
شبنم	ʃæbnæm
مژه	moʒe
برادر	bæɾɒːdæɾ
خیلی زیاد	xejliːziːjɒːd
مزد	mozd
جلد	d͡ʒeld
لهستانی	lehestɒːniː
بی	biː
مركزي	mæɾkæziː
هندوستان	henduːstɒːn
مکاتبه	mokɒːtebe
خالق	xɒːleɢ
هنرپیشه	honæɾpiːʃe
سنجاق	sænd͡ʒɒːɢ
افزایه	æfzɒːje
پوستر	posteɾ
معجزه‌آسا	moʔd͡ʒezeɒːsɒː
شیطان بزرگ	ʃejtɒːnebozoɾɡ
زائر	zɒːʔeɾ
ژله	ʒele
سد زدن	sædzædæn
شاه‌اثر	ʃɒːhæsæɾ
بودن	buːdæn
اسپرانتو	espeɾɒːnto
زیان	ziːjɒːn
چس فیل	t͡ʃosefiːl
لیبیدو	liːbiːdo,liːbiːduː
مسواک زدن	mesvɒːkzædæn
رولت روسی	ɾuːletɾuːsiː
خبط کردن	xæbtkæɾdæn
دریغ کردن	dæɾiːɢkæɾdæn
بوگوتا	boɡotɒː
کشمش	keʃmeʃ
استخوانی	ostexɒniː
نفس نفس زدن	næfæsnæfæszædæn
چادر زدن	t͡ʃɒːdoɾzædæn
برقع	boɾɢæʔ
میش	miːʃ
پریروز	pæɾiːɾuːz
پس از	pæsæz
خودداری	xoddɒːɾiː
محک	mæhæk
پرینه	peɾiːne
امروز	emɾuːz
‌قطع	ɢætʔ
چک	t͡ʃæk,t͡ʃek
داشتم می‌خواستم	dɒːʃtæmmíxɒːstæm
تیغ زدن	tiːɢzædæn
ترا	toɾɒː
پیوند	pejvænd
بلک‌بری	blækbeɾiː
سنگینی	sænɡiːniː
واج	vɒːd͡ʒ
آسمان	ɒːsmɒːn,ɒːsemɒːn
شوخی	ʃuːxiː
اهریمن	æhɾiːmæn
میدان	mejdɒːn
اختیار افتادن	extiːɒːɾoftɒːdæn
هموندان	hæmvændɒːn
سویا	sojɒː
ضربت زدن	zæɾbætzædæn
نزدیک	næzdiːk
جیپ	d͡ʒiːp
شرق تیمور	ʃæɾɢetiːmoɾ
چرمی	t͡ʃæɾmiː
برگشتن	bæɾɡæʃtæn
گل دادن	ɡoldɒːdæn
سلام	sælɒːm
محل	mæhæll,‎mæhæll
سرماخوردگی	sæɾmɒːxoɾdeɡiː
وولوگدا	vuːluːɡdɒː
جنگ‌های صلیبی	d͡ʒænɡhɒːjesæliːbiː
باکتریا	bɒːktæɾiːjɒː
سرایوو	sæɾɒːjevo
پک زدن	pokzædæn
و	o,væ
نیاهندواروپایی‌زبان	niːjɒːhendooɾuːpɒːjiːzæbɒːn
عمدی	ʔæmdiː
ثبت	sæbt
کوشش	kuːŝeŝ
اسکناس	eskenɒːs
شکار کردن	ʃekɒːɾkæɾdæn
فیت	fiːt
تصرف	tæsæɾɾof
گودال	ɡouːdɒːl
اولین	ævvæliːn
منت	mennæt
خواستی	xɒːstiː
استثنایی	estesnæeiː
نیش و کنایه زدن	niːʃokenɒːjezædæn
فانوس دریایی	fɒːnuːsedæɾjɒːjiː
ایستگاه اتوبوس	iːstɡɒːheotobuːs
نارو زدن	nɒːɾozædæn
دلکش	delkæʃ
کنست	kneset
فراری	feɾɒːɾiː
آن	ɒːn
معدنی	mæʔdæniː
کارتن	kɒːɾton
ملاحظه فرمودن	molɒːhezekæɾdæn
ییدیش	jiːdiːʃ
قوس و قزح	ɢoʊsoɢæzæh
خودکشی	xodkoʃiː
فضای بیرونی	fæzɒːjebiːɾuːniː
امت	ommæt
اوزبکستان	uːzbækestɒːn
دسته	dæste,dæstæ
صلح کردن	solhkæɾdæn
هرم بزرگ جیزه	hæɾæmbozoɾɡd͡ʒîze
شمس	ʃæms
غربی	ɢæɾbiː
فریاد کردن	fæɾjɒːdkæɾdæn
زیادروی کردن	ziːɒːdeɾæviːkæɾdæn
شورش	ʃuːɾeʃ
پوزه کشیدن	puːzekeʃiːdæn
داروسازی	dɒːɾuːsɒːziː
گوسفند	ɡuːsfænd,ɡosfænd
اتحاد جماهیر شوروی سوسیالیستی	ettehɒːded͡ʒæmɒːhiːɾeʃuːɾæviːjesosiːjɒːliːstiː
پرچم	pæɾt͡ʃæm
کوچ	kuːt͡ʃ
ویتنامی	viːjætnɒːmiː
یکی بود یکی نبود	jekiːbuːdjekiːnæbuːd
سیل	sæiːl
مبالغه کردن	mobɒːleɢekæɾdæn
کمد	komod
گیلارد	ɡiːlɒːɾd
تطبیق دادن	tætbiːɢdɒːdæn
زحمت کشیدن	zæhmætkeʃiːdæn
غزال آفریقائی	ɢæzɒːleɒːfɾiːɢɒːʔiː
بعدا	bæʔdæn
سرده	sæɾde
بنفشه	bænæfʃe
پخش	pæxʃ
برشتن	beɾeʃtæn
ماچین	mɒːt͡ʃiːn
همايش	hæmɒːjeʃ
دایناسور	dɒːjnɒːsoɾ
مریخ	meɾɾiːx
تبار	tæbɒːɾ
قفل کردن	ɢoflkæɾdæn,ɢoflkæɾdæn
نوازش کردن	nævɒːzeʃkæɾdæn
کام گرفتن	kɒːmɡeɾeftæn
سیاهه	siːɒːhe
والیبال	vɒːliːbɒːl
بخشنده	bæxʃænde,bæxŝænde,bæxŝændæ
انتها	entehæ
خدا	xodɒː
خواستن	xwɒːstæn,xvɒːstæn,xɒːstæn
دود کردن	duːdkæɾdæn
شاخ آفریقا	ʃɒːxeæfɾiːɢɒː
قرارداد	ɢæɾɒːɾdɒːd
به سلامت	besælɒːmæt
کارت اعتباری	kɒːɾteeʔtebɒːɾ
اکسیر	eksiːɾ
اندازه‌گیر	ændɒːzeɡiːɾ
ابوالهول	æbuːælhuːl
تسلیم کردن	tæsliːmkæɾdæn
‌قطع کردن	ɢætʔkæɾdæn
شعله زدن	ʃo’lezædæn
خیانت	xiːɒːnæt
لاستیک	lɒːstiːk
بخشیش	bæxʃiːʃ
فرضیه	fæɾziːje
جوان	d͡ʒævɒːn
زندگی کردن	zendeɡiːkæɾdæn,zendeɡiːkæɾdæn
ساحل	sɒːhel
یوان	juːɒːn
پایگاه داده	pɒːjɡɒːhedɒːde
فرماندار	fæɾmɒːndɒːɾ
فصل	fæsl
راه ابریشم	ɾɒːheæbɾiːʃæm
تغییر	tæɢʔiːɾtæɢjiːɾ,tæɢjiːɾ
کمان	kæmɒːn
قل قل	ɢolɢol
تکه	tekke
انقلاب	enɢelɒːb
مهاجر	mohɒːd͡ʒeɾ
ناتو	nɒːto
پاکستان	pɒːkestɒːn
افزایش گرفتن	æfzɒːjeʃɡeɾeftæn
هلند	holænd
بهره	bæhɾe,bæhɾæ
قشنگ	ɢæʃænɡ
معلوم	mæʔluːm
تذکر دادن	tæzækkoɾdɒːdæn
شاخاب پارس	ʃɒːxɒːbepɒːɾs
آبان	ɒːbɒːn
اوروپول	oɾuːpuːl
بلغاری	bolɢɒːɾiː
طغیان	toɢjɒːn
غسل کردن	ɢoslkæɾdæn
رابین‌هود	ɾɒːbjnhuːd
شکرک زدن	ʃekæɾækzædæn
تجارت	ted͡ʒɒːɾæt
دوازده	dævɒːzdæh
افشک	æfʃæk
شاشیدن	ʃɒːʃiːdæn
بی‌سیم زدن	biːsiːmzædæn
دست و پا زدن	dæstopɒːzædæn
اندونزی	iːndoneziː
استفراغ کردن	estefɾɒːɢkæɾdæn
پرتغال	poɾtoɢɒːl
فریاد کشیدن	fæɾjɒːdkeʃiːdæn
ترغیب	tæɾɢiːb
الگو کشیدن	olɡuːkeʃiːdæn
بینوایی	biːnævɒːjiː
خوش	xoŝ,xoʃ
سه‌گوش	seɡuːʃ
سقوط کردن	soɢuːtkæɾdæn
ماتم	mɒːtæm
کولی	koʊliː
مسکه	mæske
بنده	bændæ
خفاش	xefɒːʃ,xoffɒːʃ
بند زدن	bændzædæn
ورق  زدن	væɾæɢzædæn
حکمت	hekmæt
کامل	kɒːmel
پخش کردن	pæxʃkæɾdæn
پکن	pekæn
فیکساتور	fiːksɒːtoɾ
هل	hel
ارزشگذاری	æɾzeʃɡodhæɾiː
رشته	ɾeʃte
خواهرشوهر	xwɒːhæɾʃoʊhæɾ
اندرون	ændæɾuːn
زغن	zæɢæn
ترول	tɾuːl
سبزه	sæbze
دستور زبان	dæstuːɾezæbɒːn
سئول	seʔuːl
میان	miːjɒːn,miːɒːn
تاول	tɒːvæl
دارید می‌خواهید	dɒːɾiːdmíxɒːhiːd
اسمبلی	æsembeliː
خصم	xæsm
پستان بند	pestɒːnbænd
ناکافی	nɒːkɒːfiː
آرام گرفتن	ɒːɾɒːmɡeɾeftæn
علمی	elmiː
رنگ صورتی	ɾænɡsuːɾætiː
دارد می‌خواهد	dɒːɾædmíxɒːhæd
کانگورو	kɒːnɡoɾo
جنسیت‌گرایی	d͡ʒensiːtɡæɾɒːjiː
باغ وحش	bɒːɢevæhʃ
قطب جنوب	ɢotbed͡ʒonuːb
فرسودن	fæɾsuːdæn
باد خورشیدی	bɒːdexoɾʃiːdiː
استعمارگری	esteʔmɒːɾɡæɾiː
سورپرایز	suːɾpeɾɒːjz
کروم	koɾom
توان	tævɒːn
ژوئیه	ʒuːʔiːje
زبان سانسکریت	zæbɒːnesɒːnskɾiːt
پیشرفت	piːʃɾæft
درخواست دادن	dæɾxɒːstdɒːdæn
نیش	niːʃ
بعدتر	bæʔdtæɾ
سبیل	sebiːl
رنگین	ɾænɡiːn
قحبه‌خانه	ɢæhbexɒːne
چکی	t͡ʃekiː
خلافت	xelɒːfet
اسپارت	espɒːɾt
یدک	jædæk
تاجیکستان	tɒːd͡ʒiːkestɒːn
پیشاور	peʃɒːvæɾ
خبر دادن	xæbæɾdɒːdæn
کوآلا	koɒːlæ
نژاد پرستی	neʒɒːdpæɾæstiː
ماشین پارک	mɒːʃiːnepɒːɾk
سرفه کردن	soɾfekæɾdæn,soɾfekæɾdæn
تنیس	teniːs
الماس	ælmɒːs
سرم زدن	seɾomzædæn
منشی	monʃiː
هم‌معنی	hæmmæʔniː
آزمون‌پذیر	ɒːzmuːnpæziːɾ
مکان	mækɒːn
آخوندک	ɒːxuːndæk
آشنا	ɒːʃenɒː,ɒːʃnɒː
حمایت	hemɒːjæt
پنج	pænd͡ʒ
قطب شمال	ɢotbeʃomɒːl
پلاتو زدن	pelætozædæn
سیگما	siːɡmɒː
تحریك	tæhɾiːk
آرارات	ɒːɾæɾæt
کوه زدن	kuːhzædæn
رستوران	ɾestoɾɒːn
پای سیب	pɒːjesiːb
مرخصی گرفتن	moɾæxxæsiːɡeɾeftæn
اژدهابلم	eʒdehæbælæm
آتنا	ɒːtenɒː
هیل	hiːl
ترشی	toɾʃiː
جارو برقی	d͡ʒɒːɾuːbæɾɢiː
طب	tebb
زنجیر	zænd͡ʒiːɾ
استخوان‌بندی	ostoxɒːnbændiː
زبان آوردن	zæbɒːnɒːvæɾdæn
کراوات	keɾɒːvɒːt
سبقت	sebɢæt
لرز	læɾz
بلغار	bolɢɒːɾ
جلو گرفتن	d͡ʒeloʊɡeɾeftæn
خدایگان	xodɒːjɡɒːn
چاقو خوردن	t͡ʃɒːɢuːxoɾdæn
نارو خوردن	nɒːɾoxoɾdæn
پیش‌افکند	piːʃæfkænd
چونکه	t͡ʃuːnke
اهمیت	æhæmmiːjæt
خوش آمدی	xoʃɒːmædiː
زاییدن	zɒːjiːdæn
زن گرفتن	zænɡeɾeftæn
نطفه	notfæ
ربع	ɾobʔ
احمقانه	æhmæɢɒːne
به دنیا آمدن	bedonjɒːɒːmædæn
شیر	ʃiːɾ
سنبل	sombol
صوری	suːɾiː
اصفهان	esfæhɒːn
تن داشتن	tændɒːʃtæn
رودخانه	ɾuːdxɒːne
علی بابا	ʔæliːbɒːbɒː
فرانسیم	feɾɒːnsiːjom
مبل	mobl
آبی آسمانی	ɒːbiːjeɒːsemɒːniː
نکاح	nekɒːh
رایج	ɾɒːjed͡ʒ
حرف ربط	hæɾfeɾæbt
آشنا شدن	ɒːʃnɒːʃodæn
افندی	efendiː
آرژانتین	ɒːɾʒɒːntiːn
رد کردن	ɾædkæɾdæn
وقتی	væɢtiː
روزی روزگاری	ɾuːziːɾuːzeɡɒːɾiː
خواهید خواست	xɒːhídxɒːst
کودنی زدن	koʊdæniːzædæn
وبلاگ زدن	veblɒːɡzædæn
اختری	æxtæɾiː
الو	ælo
جداچاپ	d͡ʒodɒːt͡ʃɒːp
طریقه	tæɾiːɢe
سپری شدن	sepæɾiːʃodæn
مشتری	moʃtæɾiː
ایراد گرفتن	iːɾɒːdɡeɾeftæn
اضافه	ezɒːfe
اض پوشت ب ژلو گوضشتن	æzpoʃtbed͡ʒeloɡozæʃtæn
لاتویایی	lɒːtviːjɒːjiː
وام‌واژه	vɒːmvɒːʒe
بال گرفتن	bɒːlɡeɾeftæn
گره خوردن	ɡeɾehxoɾdæn
مشتاق بودن	moʃtɒːɢbuːdæn
تشکر	tæʃækoɾ,tæʃækkoɾ
ارت	eɾt
ریش	ɾiːʃ
اینترنت	iːnteɾnet
راه یافتن	ɾɒːhjɒːftæn
امید	omiːd
درز کردن	dæɾzkæɾdæn
کره	kæɾe,koɾɾe,koɾe
نسک	næsk
مغرور	mæɢɾuːɾ
بند	bănd,bænd
شهرت	ʃæhɾæt
مخالف	moxɒːlef
شکر	ʃækæɾ,ʃækkæɾ,ʃekæɾ,ʃokɾ
هانوی	hɒːnuːj
اندازه کردن	ændɒːzekæɾdæn
قاصدک	ɢɒːsedæk
آدم	ɒːdæm
صلح	solh
اسلوونی	esloveniː
هابیل	hɒːbiːl
مدال	medɒːl
تودار	tuːdɒːɾ
اسمیم	osmiːjom
ارشاد	eɾʃɒːd
عجیب	ʔæd͡ʒiːb
گریه	ɡeɾje
پوشه	puːʃe
معلق	mællæɢ,moʔællæɢ
سویس	suːviːs
آبادان	ɒːbædæn
دعوت داشتن	dæʔvætdɒːʃtæn
بی‌جنس‌گرایی	biːd͡ʒensɡæɾɒːjiː
می‌خواستند	míxɒːstænd
گزینه	ɡoziːne
پیام	pejɒːm
سرعت	soɾʔæt
چکى	t͡ʃekiː
حسد بردن	hæsædboɾdæn
امام	emɒːm
درخت	deɾæxt,dæɾæxt
دعا کردن	doʔɒːkæɾdæn,doʔɒːkæɾdæn
قهر	ɢæhɾ
تپه	tæpe
غزال افریقا	ɢæzɒːleɒːfɾiːɢɒː
دوچرخه‌سوار	dot͡ʃæɾxesævɒːɾ
بابل	bɒːbel
بسنده کردن	bæsændekæɾdæn
لازم	lɒːzem
خال‌کوبی	xɒːlkuːbiː
زبان	zæbɒːn
اوستا	ævestɒː
قار زدن	ɢɒːɾzædæn
بیروت	bejɾuːt
نهم	nohom
تروریست	teɾoɾiːst
جمهوری چک	d͡ʒomhuːɾiːjet͡ʃek
زود	zuːd
طاس	tɒːs
گرمکن	ɡæɾmkon
زحمت افتادن	zæhmætoftɒːdæn
دودویی	dodojiː
چاپ	t͡ʃɒːp
زن کثیف	zænkæsîf
جنت	d͡ʒænnæt
پایانه اتوبوس	pɒːjɒːnejeotobuːs
زنبق	zæmbæɢ
فارسی تاجیکی	fɒːɾsiːjetɒːd͡ʒiːkiː
نانوائی	nɒːnvɒːʔiː,nɒːnevɒːʔiː
سكوت	sokuːt
سپید	sepiːd
قاتل	ɢɒːtel
جوهر شوره	d͡ʒouːhæɾeʃuːɾe
ریه	ɾiːje
به	bæh,bæ,be,beh
وصل	væsl
یتیم‌خانه	jætiːmxɒːne
لنگرگاه	lænɡæɾɡɒːh
نان	nɒːn
لینکلن	liːnkoln
القاعده	ælɢɒːde
خلع سلاح کردن	xælʔeselɒːhkæɾdæn
زار	zɒːɾ
معمول	mæʔmuːl
طومار	tuːmɒːɾ
گوساله	ɡuːsɒːle
اندازه گرفتن	ændɒːzeɡeɾeftæn
خرخر کردن	xoɾxoɾkæɾdæn
مداد نوکی	medɒːdenokiː
خوش آمدید	xoʃɒːmædiːd
تعجب	tæʔæd͡ʒd͡ʒob
تازیانه زدن	tɒːziːɒːnezædæn
جرأت داشتن	d͡ʒoɾʔætdɒːʃtæn
صاعقه	sɒːeɢe,sɒːʔeɢe
دست‌نوشته	dæstneveʃte
خواهم	xɒːhæm
تصویب رسیدن	tæsviːbɾesiːdæn
گاز زدن	ɡɒːzzædæn
جر زدن	d͡ʒeɾzædæn
مادر جنده	mɒːdæɾd͡ʒende
پرانتز	pæɾɒːntez
گواهی‌نامه رانندگی	ɡovɒːhiːnɒːmejeɾɒːnændeɡiː
قدرت	ɢodɾæt
عربستان	æɾæbestɒːn
آهار زدن	ɒːhɒːɾzædæn
نماز	næmɒːz
رومانی	ɾuːmɒːniː
پنهانی	penhɒːniː
ماست	mɒːst
خزنده	xæzænde
ستاره	setɒːɾe
دلفین	dolfiːn
کرملین	kɾemliːn
درد گرفتن	dæɾdɡeɾeftæn
کیوسکموتو	kjvskmvtv
وقت	væɢt
چشم انداختن	t͡ʃeʃmændɒːxtæn
رونویسی	ɾuːneviːsiː
فقط	fæɢæt
گمان	ɡomɒːn
معتاد	motɒːd
آبی	ɒːbiː
هملت	hæmlet
هادرون	hɒːdɾon
بلوف زدن	bolofzædæn
تئوری توطئه	teʔoɾiːjetouːteʔe
مرغابی جره	moɾɢɒːbiːjed͡ʒæɾɾe
ادیان ابراهیمی	ædjɒːneebɾɒːhiːmiː
بلد	bælæd
پرهیز	pæɾhiːz
زین	ziːn
بوقلمون	buːɢælæmuːn
کوک	kuːk
حنوکا	hænuːkɒː
مالاریا	mɒːlɒːɾjɒː
ماموریت	mæʔmuːɾiːæt
اغوز	uːɢuːz
پرم	peɾm
عزم داشتن	æzmdɒːʃtæn
شاید	ʃɒːjæd
بیماری آلزایمر	biːmɒːɾeɒːlzɒːjmeɾ
شستن	ʃostæn
تكواژ	tækvɒːʒ
سرکش	sæɾkeʃ
آکواریوم	ɒːkvɒːɾjuːm
بیطار	bejtɒːɾ
سمارا	sɒːmɒːɾɒː
گوزن	ɡævæzn
تیهو	tiːhuː
برنامه‌نویسی	bæɾnɒːmeneviːsiː
اوگاندا	uːɡɒːndɒː
دعوا شدن	dæʔvɒːʃodæn
نظر گرفتن	næzæɾɡeɾeftæn
پیوسته	pejvæste,pejvæstæ
تراوش کردن	tæɾɒːvoʃkæɾdæn
استفاده کردن	estefɒːdekæɾdæn,estefɒːdekæɾdæn
ایرانی	iːɾɒːniː
وصله	væsle
کماره	kæmɒːɾe
پایین پریدن	pɒːjiːnpæɾiːdæn
ترجمه ماشینی	tæɾd͡ʒomemɒːʃiːniː
جاوا	d͡ʒɒːvɒː
وارسی	vɒːɾesiː
اژدها	eʒdehæ
تسلط داشتن	tæsælotdɒːʃtæn,tæsællotdɒːʃtæn
اسلام	eslɒːm
تیر کشیدن	tiːɾkeʃiːdæn
کمین	kæmiːn
سعی کردن	sæʔjkæɾdæn
ملیت	melliːjjæt
مبتذل	mobtæzæl
افترا خوردن	efteɾɒːxoɾdæn
قد	ɢæd
پنگوئن	pænɡuːæn
دشنام دادن	doʃnɒːmdɒːdæn
رهبر جامعه اسلامی	ɾæhbæɾed͡ʒɒːmeʔejeeslæmiː
آرایش دادن	ɒːɾɒːjeʃdɒːdæn
قاب کردن	ɢɒːbkæɾdæn
چین دادن	t͡ʃiːndɒːdæn
سوسو	suːsuː
کشف شدن	kæʃfʃodæn
پیشنهاد کردن	peʃnæhɒːdkæɾdæn,piːʃnæhɒːdkæɾdæn
نیکاراگوئه	niːkɒːɾɒːɡuːʔe
پرواز کردن	pæɾvɒːzkæɾdæn,pæɾvɒːzkæɾdæn
طاووس	tɒːvuːs
همزه	hæmze
دم‌جنبانک	domd͡ʒombɒːnæk
دریغ	dæɾiːɢ
یکم	jekom
غرب	ɢæɾb
سکس مقعدی	seksemæɢʔædiː
غول	ɢuːl
خودشویی	xodʃuːjiː
سرباز	sæɾbɒːz
تا	tɒː
حلال	hælɒːl
سبک	sæbok
سپرز	sepoɾz
دستاورد	dæstɒːvæɾd
پای	pɒːj
جرأت	d͡ʒoɾʔæt
کیلو	kiːluː
عمیق	ʔæmiːɢ
سراغ گرفتن	soɾɒːɢɡeɾeftæn
بيگـاری	biːɡɒːɾiː
تحمل کردن	tæhæmmolkæɾdæn
پنجول	pænd͡ʒuːl
هندو‌اروپایی	hendooɾuːpejiː
آنتن	ɒːnten
شیرین کردن	ʃiːɾiːnkæɾdæn
مرغ خانگی	moɾɢexɒːneɡiː
کودن	kodæn
وجود آوردن	vod͡ʒuːdɒːvæɾdæn
برآمده	bæɾɒːmæde
نفت	næft
معاشرت	moʔɒːʃeɾæt
چاباق‌سر	t͡ʃɒːbɒːɢsæɾ
واحد نجومی	vɒːhednod͡ʒuːmiː
عرف	oɾf
طعنه زدن	tæʔnezædæn
اعلام شدن	eʔlɒːmʃodæn
زبان آفریکانز	zæbæneɒːfɾiːkɒːnz
بلال	bælɒːl
توصیف	toʊsiːf
مداد شمعی	medɒːdeʃæmʔiː
تبر	tæbæɾ
جلیقه ی نجات	d͡ʒeliːɢejened͡ʒɒːt
کارد	kɒːɾd
چهار	t͡ʃæhɒːɾ
ماندارین	mɒːndɒːɾiːn
شیار	ʃiːɒːɾ
مژه زدن	moʒezædæn
غنی	ɢæniː
بیلیارد	biːljɒːɾd
چوب خوردن	t͡ʃuːbxoɾdæn
قهوه سیاه	ɢæhvesiːjɒːh
سوفیه	sofiːje
دریاچه‌های بزرگ	dæɾjɒːt͡ʃehɒːjebozoɾɡ
فینال	fiːnɒːl
مدال طلا	medɒːletælɒː
چمدان	t͡ʃæmedɒːn
قياس	ɢiːɒːs
بلا	bælɒː
پک	pok
ریشه	ɾiːʃæ,ɾiːʃe
نفرین	nefɾiːn
کس	kæs,kos
ظهور	zohuːɾ
کرم زدن	keɾemzædæn
ظالم	zɒːlem
تاکسی	tɒːksiː
قالیچه پرنده	ɢɒːliːt͡ʃejepæɾænde
مه	mə,mɒːh,mæh,me
پهلو	pæhluː
داشتن	dɒːʃtæn
پسرعمه	pesæɾæmme,pesæɾʔæmme
نامه به افسسیان	næmhbhæfssɒːn
اطلس	ætlæs
زنبورک	zænbuːɾæk
اتفاقه دیگه	ettefɒːɢediːɡe
پمپ بنزین	pompebenziːn
نرم‌افزار	næɾmæfzɒːɾ
نور	nuːɾ
صدا کردن	sedɒːkæɾdæn
جاکارتا	d͡ʒɒːkɒːɾtɒː
مهار	mæhɒːɾ
میل	mejl
دکان	dokɒːn,dokkɒːn
گریستن	ɡeɾiːstæn
غم	ɢæm
کدو تنبل	kæduːtænbæl
کودنی	koʊdæniː
بازنامیدن	bɒːznɒːmiːdæn
ایجاد شدن	iːd͡ʒɒːdʃodæn
گذشتن	ɡozæʃtæn
همسان درمانی	hæmsɒːndæɾmɒːniː
ارمنی	æɾmæniː
نگره	neɡæɾe
تغییرعقیده	tæɢʔiːɾeæɢiːde
اجرا	ed͡ʒɾɒː
پشتیبانی کردن	poʃtiːbɒːniːkæɾdæn
پولاد	puːlɒːd
چهل	t͡ʃehel
درد کشیدن	dæɾdkeʃiːdæn
همه	hæme
بخواهم	bexɒːhæm
سخنرانی	soxænɾɒːniː
خواستم	xɒːstæm
گزارش دادن	ɡozɒːɾeʃdɒːdæn
پیمانه	pejmɒːne,pejmɒːnæ
بان	bɒːn
نفرین ابدی	nefɾiːneæbædiː
دو	do
درستی سنجی	doɾostiːsænd͡ʒiː
سرد	sæɾd
از حفظ	æzhefz
بین	biːn,bejn
ملاحظه	molɒːheze
ذوق	zoʊɢ
قرص	ɢoɾse
صندلی	sændæliː
سفارش دادن	sefɒːɾeʃdɒːdæn,sefɒːɾeʃdɒːdæn
تیغ	tiːɢ
دیوانگی زدن	diːvɒːneɡiːzædæn
بوئنوس آیرس	buːʔenuːsɒːjɾes
فراگیر	fæɾɒːɡiːɾ
خواهرخوانده	xwɒːhæɾxwɒːnde
شماره تلفن	ʃomɒːɾejetelefon
ویلز	vejlz
ساکسوفون	sɒːksofon
لنز گذاشتن	lenzɡozɒːʃtæn
شیطان	ʃejtɒːn
از طرف ديگر	æztæɾæfdîɡæɾ
گنوستیک	ɡnostiːk
تقویم	tæɢviːm
دوست‌پسر	duːstpesæɾ
یهودی‌ستیزی	jæhuːdiːsetiːziː
هیلاری	hiːlɒːɾiː
دارند می‌خواهند	dɒːɾændmíxɒːhænd
زازاکی	zɒːzɒːkiː
انتخابات	entexɒːbɒːt
کاغذدیواری کردن	kɒːɢæzdiːvɒːɾiːkæɾdæn
ورشو	væɾʃouː
عروس دریایی	oɾuːsdæɾjɒːjiː
شام	ʃɒːm
نفس	næfæs,næfs
بوسنی و هرزگوین	bosniːvæheɾzeɡoviːn,bosniːoheɾzeɡoviːn
تعمیر	tæʔmiːɾ
آهنگ داشتن	ɒːhænɡdɒːʃtæn
عطسه زدن	ætsezædæn
غر	ɢoɾ
لاله	lɒːle
بدو بدو زدن	bodobodozædæn
صحت	sehæt
دخترخوانده	doxtæɾxwɒːnde
جو	d͡ʒævv,d͡ʒoʊ,d͡ʒuː
بسط	bæst
نیاهندو‌اروپایی	niːjɒːhendooɾuːpɒːjiː
کینه	kiːne
وول زدن	vuːlzædæn
رحم کردن	ɾæhmkæɾdæn
نجّار	næd͡ʒd͡ʒɒːɾ
کشتارگاه	koʃtɒːɾɡɒːh
ویلا	viːllɒː,viːlɒː
طفل	tefl
پزشک کودکان	pezeʃkekuːdækɒːn
بلند کردن	bolændkæɾdæn
نیروی برانگیزنده	niːɾuːjebæɾɒːnɡiːzænde
یاوری	jɒːvæɾiː
پالکی	pɒːlkiː
نفهمی زدن	næfæhmiːzædæn
تبت	tæbbæt,tebbet
تیز	tiːz
قهوهای شدن	ɢæhveʔiːʃodæn
تا اين اندازه	tɒːiːnændɒːzæ,tɒːiːnændɒːze
کتاب	ketɒːb
شمار	ʃomɒːɾ
بووم	buːm
باینجا	bæʔiːnd͡ʒɒː
روان‌نویس	ɾævɒːnneviːs
حلقه	hælɢe
خراش دادن	xæɾɒːʃdɒːdæn
کوهستان	kuːhestɒːn
قوی	ɢæviː
معامله	moʔɒːmele
تشبیه کردن	tæʃbiːhkæɾdæn
صربستان	seɾbestɒːn
آبخاز	ɒːbxɒːz
فردریک	feɾedɾiːk
داستان	dɒːstɒːn
البته	ælbæte
بي صدا	biːsedɒː
اذیت	æziːjæt
طراحی	tæɾɾɒːhiː
هیچ	hiːt͡ʃ
شاهین	ʃɒːhiːn
چرم	t͡ʃæɾm
حصار	hesɒːɾ
آرامش بخشیدن	ɒːɾɒːmeʃbæxʃiːdæn
رتیل	ɾotejl
تشويق شدن	tæʃviːɢʃodæn
شهر فرنگ	ʃæhɾefæɾænɡ
آهو	ɒːhuː
جسم	d͡ʒesm
شیمی هسته‌ای	ʃiːmiːjehæsteʔiː
درک کردن	dæɾkkæɾdæn
چطور	t͡ʃetouːɾ
وداع	vedɒːʔ
اختیار	extiːɒːɾ
کرسی زدن	koɾsiːzædæn
فضایی	fæzɒːjiː
نعلچیک	næʔlt͡ʃiːk
خواسته باشم	xɒːstebɒːʃæm
یاری کردن	jɒːɾiːkæɾdæn
راولپندی	ɾɒːvɒːlpendiː
زبان تامیل	zæbɒːnetɒːmiːl
خدا حافظ	xodɒːhɒːfez
جوهر	d͡ʒoʊhæɾ
گپ زدن	ɡæpzædæn
بوسیدن	buːsiːdæn
چای	t͡ʃɒːj
انس	ons
شستی	ŝæstiː
توت فرنگی	tuːtfæɾænɡiː
تصویب	tæsviːb
می‌خواستم	míxɒːstæm
مسلمانی	mosælmɒːniː
صبر	sæbɾ
کاشته زدن	kɒːʃtezædæn
سکوت	sokuːt
چاک	t͡ʃɒːk
چکه کردن	t͡ʃekkekæɾdæn
ینی‌چری	jeniːt͡ʃeɾiː
پاکت	pɒːkæt
اعتقاد	eʔteɢɒːd
قلاب ماهيگيري	ɢollɒːbmɒːhiːɡiːɾiː
ایمیل کردن	iːmejlkæɾdæn
پادشاه	pɒːdʃɒːh,pɒːdeʃɒːh
سر گرفتن	sæɾɡeɾeftæn
گلپر	ɡolpæɾ
دنبال کردن	donbɒːlkæɾdæn,donbɒːlkæɾdæn
قلعه	ɢælʔe
پارو زدن	pɒːɾuːzædæn
هجده	hed͡ʒdæh
سه‌شنبه	seʃænbe
تبخال	tæbxɒːl
خنیا	xoniːjɒː
ورزا	væɾzɒː
ترغیب کردن	tæɾɢiːbkæɾdæn
شمشیرماهی	ʃæmʃiːɾmɒːhiː
والدین	vɒːledejn
آماج	ɒːmɒːd͡ʒ
ترفند زدن	tæɾfændzædæn
پایان گرفتن	pɒːjɒːnɡeɾeftæn
دلپذیر	delpæziːɾ
دور	doʊɾ,duːɾ,douːɾ
مجارستان	mæd͡ʒɒːɾestɒːn
ازدواج کردن	ezdevɒːd͡ʒkæɾdæn,ezdevɒːd͡ʒkæɾdæn
جرقه	d͡ʒæɾæɢɢe,d͡ʒeɾæɢɢe
دفاع کردن	defɒːʔkæɾdæn
قبول	ɢæbuːl
سر خوردن	soɾxoɾdæn
پایان رسیدن	pɒːjɒːnɾesiːdæn
مالش	mɒːleʃ
کنایه زدن	kenɒːjezædæn
باور شدن	bævɒːɾʃodæn
مادرشوهر	mɒːdæɾʃoʊhæɾ
فنجان	fend͡ʒɒːn
دشت زدن	dæʃtzædæn
همکار	hæmkɒːɾ
غوطه	ɢuːte
روز بخیر	ɾuːzbexejɾ
اخته	æxte
سپردن	sepoɾdæn
کف	kæf
تهمت زدن	tohmætzædæn
زوزه	zuːze
شهسوار	ʃæhsævɒːɾ
لطفا	lotfæn
سندی	sendiː
عادت دادن	ɒːdætdɒːdæn
تشکیل	tæʃkiːl
آرمان	ɒːɾmɒːn
تارتنک	tɒːɾtænæk
نصیحت	næsiːhæt
درگذشتن	dæɾɡozæʃtæn
شیلر	ʃiːleɾ
برکلیم	beɾkeliːom
غش کردن	ɢæʃkæɾdæn
روشن کردن	ɾoʊʃænkæɾdæn
کنف	kenæf
لیمون	liːmuːn
زبان کشیدن	zæbɒːnkeʃiːdæn
شخم کردن	ʃoxmkæɾdæn
زیره‌ی سبز	ziːɾejesæbz
شن	ʃen
راهب	ɾɒːheb
اوآگادوگو	oɒːɡɒːduːɡuː
سراغ داشتن	soɾɒːɢdɒːʃtæn
دست کم گرفتن	dæstekæmɡeɾeftæn
نوشته	neveʃte
کیف	kiːjef,kiːf,kejf
خیز زدن	xiːzzædæn
پر زدن	pæɾzædæn
اشک	æʃk
اندرز دادن	ændæɾzdɒːdæn
خاطر نشان	xɒːteɾneʃɒːn
بعد	bæʔd,bæʔde
عشق‌آباد	eʃɢɒːbɒːd
آموزگار	ɒːmuːzɡɒːɾ
خوشنویس	xoʃneviːs
مدیر	modiːɾ
کاربر	kɒːɾbæɾ
داخلی	dɒːxeliː
یاد گرفتن	jɒːdɡeɾeftæn,jɒːdɡeɾeftæn
چیدن	t͡ʃiːdæn
مریخی	meɾɾiːxiː
لجاجت کردن	led͡ʒɒːd͡ʒætkæɾdæn
فیجی	fiːd͡ʒiː
اسکلت	eskelet
طعنه	tæʔne
زاگرب	zɒːɡɾeb
اورشلیم مقدس	oɾʃæliːmemoɢæddæs
انجام	ænd͡ʒɒːm
ظفر	zæfæɾ
دماغ	dæmɒːɢ
پرتو	pæɾtuː
چیدمان	t͡ʃiːdemɒːn
هل دادن	holdɒːdæn
اروگوئه	oɾuːɡuːʔe
هنگامی که	hænɡɒːmiːke
صبح	sobh
دگرجنس‌گرایی	deɡæɾd͡ʒensɡæɾɒːjiː
بازتاب دادن	bɒːztɒːbdɒːdæn
دادن	oftɒːdæn,dɒːdæn
قوس زدن	ɢoʊszædæn
بعضی وقتها	bæziːvæɢthɒː
قوزک	ɢuːzæk
بوسه	buːse
خاندان	xɒːndɒːn
دبیر	dæbiːɾ
کرگوشی	kæɾɡuːʃiː
احترام گذاشتن	ehteɾɒːmɡozɒːʃtæn,ehteɾɒːmɡozɒːʃtæn
تیله	tiːle
جمهوری ارمنستان	d͡ʒomhuːɾiːjeæɾmænestɒːn
غراب	ɢoɾɒːb
دهانی	dæhɒːniː
شکل	ʃækl
ماکارونی	mɒːkɒːɾoniː
بانک	bɒːnk
آوند	ɒːvænd
آیینه	ɒːjiːne
زمین‌لرزه	zæmiːnelæɾze
بیست	biːst
سنباده خوردن	sombɒːdexoɾdæn
سیگار‌فروش	siːɡɒːɾfoɾuːʃ
باغبانی کردن	bɒːɢbɒːniːkæɾdæn
زتا	zetɒː
هیچ‌کس	hiːt͡ʃkæs
دهن  دهان زدن	dæhænzædæn
مجازات	mod͡ʒɒːzɒːt
دخالت کردن	dexɒːlætkæɾdæn
معماری	meʔmɒːɾiː
قسم خوردن	ɢæsæmxoɾdæn
امروز غروب	emɾuːzɢoɾuːb
گشنیز	ɡeʃniːz
بیگانه‌هراسی	biːɡɒːnehæɾɒːsiː
ناخنک	nɒːxonæk
جبرییل	d͡ʒebɾejiːl
ملخ	mælæx
فرض کردن	fæɾzkæɾdæn
سخن گفتن	soxænɡoftæn
اسیر	æsiːɾ
ادامه داشتن	edɒːmedɒːʃtæn
مازندران	mɒːzændæɾɒːn
دیشب	diːʃæb
داغستان	dɒːɢestɒːn
نیشتر زدن	niːʃtæɾzædæn
ترکیه	toɾkiːje
گام	ɡɒːm
پسند کردن	pæsændkæɾdæn
رد و بدل شدن	ɾædobædælʃodæn
معمار	meʔmɒːɾ
بی‌تفاوتی	biːtæfɒːvotiː
برنا	boɾnɒː
زرین	zæɾɾiːn,zæɾiːn
شوونیسم	ʃouːvæniːsm
خاطر آوردن	xɒːteɾɒːvæɾdæn
لرز گرفتن	læɾzɡeɾeftæn
لجن زدن	læd͡ʒænzædæn
دهلی نو	dehliːnouː
لطمه	lætme
مشک	moʃk
تخفیف دادن	tæxfiːfdɒːdæn
گل کلم	ɡolekælæm
بهشت	‎beheʃt,beheʃt
نرد	næɾd
پرهام	pæɾhɒːm
کرت	keɾet
سنجاب	sænd͡ʒɒːb
پرتغالی	poɾteɢɒːliː
بابا یاگا	bɒːbɒːjɒːɡɒː
توت	tuːt
خواهرزاده	xwɒːhæɾzɒːde
آسیب	ɒːsiːb
پوسده	puːsedæh
فریزی	feɾiːziː
رزرو کردن	ɾezeɾvkæɾdæn
نظم	næzm
جنوبگان	d͡ʒuːnuːbeɡɒːn
تنگه هرمز	tænɡejehoɾmoz
کیسه زدن	kiːsezædæn
لب‌های بزرگ	læbhɒːjebozoɾɡ
پاستا	pɒːstæ
آمپول زدن	ɒːmpuːlzædæn
غلبه کردن	ɢælæbekæɾdæn
یار	jɒːɾ
سیمین	siːmiːn
بانوج	bɒːnuːd͡ʒ
پونز	puːnez
اوج لذت جنسی	od͡ʒlezætd͡ʒensiː
تراوش	tæɾɒːvoʃ
نگریستن	neɡæɾiːstæn
کناره گرفتن	kenɒːɾeɡeɾeftæn
پوزخند	puːzxænd
ماهی تابه	mɒːhiːtɒːbe
زالو	zɒːluː
سعی داشتن	sæʔjdɒːʃtæn
نقطه	noɢte
سوسن	souːsæn
فرج	fæɾd͡ʒ
دكان نانوائی	dokɒːnnɒːnevɒːʔiː
غرش	ɢoɾɾeʃ
پسندیده	pæsændiːdæ,pæsændiːde
پرو	peɾuː
جنوب شرقی	d͡ʒonuːbeʃæɾɢiː
ارسطو	æɾestuː
مهر زدن	mohɾzædæn
شماره گرفتن	ʃomɒːɾeɡeɾeftæn
زمردی	zomoɾɾodiː
سکون	sokuːn
قهقهه	ɢæhɢæhe
یقین	jɒːɢiːn
عربی مصری	ʔæɾæbiːmesɾiː
فر خوردن	feɾxoɾdæn
عربده کشیدن	æɾbædekeʃiːdæn
قل زدن	ɢolzædæn
چوبی	t͡ʃuːbiː
داد کشیدن	dɒːdkeʃiːdæn
زنی گرفتن	zæniːɡeɾeftæn
نهسد	nohsæd
آفتابگیر	ɒːftɒːbɡiːɾ
میاندوراه	miːjɒːndoɾɒːh
نارنج	nɒːɾend͡ʒ,nɒːɾænd͡ʒ
ژاویدن	ʒɒːviːdæn
گرز	ɡoɾz
راحت	ɾɒːhæt
گتو	ɡetuː,ɡeto
چال افتادن	t͡ʃɒːloftɒːdæn
عقیده	æɢiːde
اسلام‌آباد	eslɒːmɒːbɒːd
لق خوردن	læɢxoɾdæn
اما	ɒːmmæ,æmmɒː
قلمه زدن	ɢælæmezædæn
لیف زدن	liːfzædæn
انجمن	ænd͡ʒomæn
احضار کردن	ehzɒːɾkæɾdæn
قلاب	ɢollɒːb
متغیر	moteɢejjeɾ
اردو	oɾduː
همبرگر	hæmbeɾɡeɾ
موزه	muːze
راست‌گرا	ɾɒːstɡæɾɒː
دریا	dæɾjɒː
حل	hæl
تباه	tæbɒːh
کلروفیل	kloɾofiːl
بدرقه	bædɾæɢe
آنتیگوا و باربودا	ɒːntiːɡvɒːvæbɒːɾbuːdɒː
ترمز	toɾmoz
در سمت راست	dæɾsemetɾɒːst
آشکار کردن	ɒːŝkɒːɾkæɾdæn
يشب	jæʃb
مجلس	mæd͡ʒles
برز	boɾz
تنیس زدن	teniːszædæn
فلوریدا	feloɾiːdɒː
چاقوی سوئیسی	t͡ʃɒːɢuːjesuːiːsiː
ترجمان	tæɾd͡ʒomɒːn
کمک	komæk
ناخن زدن	nɒːxonzædæn
تلگراف زدن	teleɡɾɒːfzædæn
کنار زدن	kenɒːɾzædæn
بی‌کاری	biːkɒːɾiː
بی کار	biːkɒːɾ
مایکوپ	mɒːjkuːp
تایید شدن	tæʔiːdʃodæn
گود افتادن	ɡoʊdoftɒːdæn
کرایه کردن	keɾɒːjækæɾdæn
پشت گردنی	poʃtɡæɾdæniː
آزادی	ɒːzɒːdiː
گزنه	ɡæzne
تهدید کردن	tæhdiːdkæɾdæn
کفش راحتی	kæfʃeɾɒːhætiː
وق	væɢ
خواسته بود	xɒːstebúd
آزادی بیان	ɒːzɒːdiːjebejɒːn
فن	fæn
اطمینان داشتن	etmiːnɒːndɒːʃtæn
گزاف گفتن	ɡæzɒːfɡoftæn
نابینا	nɒːbiːnɒː
زنجبیل	zænd͡ʒebiːl
نایپیداو	nɒːjpiːdɒːv
احتیاج داشتن	ehtiːɒːd͡ʒdɒːʃtæn
موز	moʊz,mouːz
جمهوری‌خواه	d͡ʒomhuːɾiːxɒːh
نوک پستان	nokepestɒːn
آبگینه	ɒːbɡiːne
مخاطب	moxɒːtæb
موریانه	muːɾiːjɒːne
غیب	ɢejb
پیوستن	pejvæstæn
نقل	noɢl,næɢl
سپاسگزارم	sepɒːsɡozɒːɾæm
بلیط	beliːt
پینه بستن	piːnebæstæn
خیّاط	xæjjɒːt
اظهار کردن	ezhɒːɾkæɾdæn
عاریه گرفتن	ɒːɾjeɡeɾeftæn
وصفی	væsfiː
برنزه	bɾonze
جبرئیل	d͡ʒebɾæʔiːl
زکام	zokɒːm
خواجگان	xɒːd͡ʒeɡɒːn
نشریه	næʃɾiːje
ستاره سینما	setɒːɾejesiːnæmɒː,setɒːɾejesiːnæmɒː
فرانسوی	fæɾɒːnsæviː
برابری	bæɾɒːbæɾiː
نیلوفر آبی	niːluːfæɾeɒːbiː
آهنگ	ɒːhænɡ
احتیاج	ehtiːɒːd͡ʒ
کوک زدن	kuːkzædæn
چروک خوردن	t͡ʃoɾuːkxoɾdæn
مداد رنگی	medɒːdeɾænɡiː
دورنگاریدن	duːɾneɡɒːɾiːdæn
سرود ملی	suːɾuːdemelliː
نشانه گرفتن	neʃɒːneɡeɾeftæn
حلزون	hælæzuːn
بیمار	biːmɒːɾ
فردوس	feɾdoʊs
بر زدن	beɾzædæn,boɾzædæn
پاپوش	pɒːpoʃ
کفیر	kefiːɾ
کوچه زدن	kuːt͡ʃezædæn
دفن	dæfn
فردا صبح	fæɾdɒːsobh
برانگیزنده	bæɾɒːnɡiːzænde,bæɾɒːnɡiːzændæ
الحمد لله	ælhæmdoleʔllɒːh
لاس زدن	lɒːszædæn
بعد از	bæʔdæz
ماه گذشته	mɒːheɡozæʃte
تکنیک	tekniːk
نقاب زدن	neɢɒːbzædæn
حمایت کردن	hemɒːjætkæɾdæn
درد دل کردن	kæɾdæn
خارجی	xɒːɾed͡ʒiː
شنیدن	ʃeniːdæn
فرضی	fæɾziː
هاشور	hɒːʃuːɾ
جیبوتی	d͡ʒiːbuːtiː
اتحادیه اروپا	ettehɒːdiːjeoɾuːpɒː
باراک	bɒːɾɒːk
چالش	t͡ʃɒːleʃ
بمب ساعتی	bombesɒːʔætiː
گسترش یافتن	ɡostæɾeʃjɒːftæn
هجوم	hod͡ʒuːm
پیشنهاد دادن	piːʃnæhɒːddɒːdæn
ملال آور	mælɒːlɒːvæɾ
دستار	dæstɒːɾ
پریدن	pæɾiːdæn
چسب	t͡ʃæsb
ارنی ترنگ	oɾniːtoɾænɡ
چندک زدن	t͡ʃondækzædæn
آبدست	ɒːbdæst
سوئد	suːʔed
با احترام	bɒːehteɾɒːm
تنباکو	tæbɒːko
همکاری	hæmkɒːɾiː
جزر	d͡ʒæzɾ
زبان آفریکانس	zæbɒːneɒːfɾiːkɒːns
گریپ فروت	ɡeɾiːpfoɾuːt
سورابایا	suːɾɒːbɒːjɒː
زیرشیروانی	ziːɾeʃiːɾvɒːniː
ضربت	zæɾbæt
می	mej
خاکستری	xɒːkestæɾiː
جامعه	d͡ʒɒːmeʔe
شنگرف	ʃænɡæɾf
پاشا	pɒːʃɒː
تیپا	tiːpɒː
فرمول	foɾmuːl
یهودی	jæhuːdiː
تخته نرد	tæxtenæɾd
آرمانی	ɒːɾmɒːniː
بچه گرگ	bæt͡ʃeɡoɾɡ
خوش اومدین	xoʃuːmædiːn
طلوع	toluːʔ
استونیایی	estuːniːjɒːjiː
جریب	d͡ʒæɾiːb
خواستیم	xɒːstiːm
برادری	bæɾɒːdæɾiː
چادر شب	t͡ʃɒːdæɾeʃæb
رامنی	ɾɒːmniː
چتر	t͡ʃætɾ
انگلیسی قدیم	enɡeliːsiːɢædiːm
دهن	dæhæn
شستشو دادن	ʃosteʃuːdɒːdæn
غسل	ɢosl
کردن	kæɾdæn
سینه زدن	siːnezædæn
عکس	æks
دموکراتیک	demokɾɒːtiːk
گاه	ɡɒːh
فلوئور	feloʔoɾ,foluːʔoɾ,fluːʔoɾ
لپ	lop,lopp
سر دادن	soɾdɒːdæn
نادانی	nɒːdɒːniː
ورود	voɾuːd
علامت زدن	ælɒːmætzædæn
هدهد	hodhod
ایدز	ejdz
شوهرخاله	ʃoʊhæɾxɒːle
سد	sæd
آموزش دادن	ɒːmuːzeʃdɒːdæn
نوک‌اردکی	nokoɾdækiː
وبلاگ	veblɒːɡ
رها کردن	ɾæhɒːkæɾdæn
دیوان	diːvɒːn
شیکاگو	ʃiːkɒːɡo
کاروان	kɒːɾvɒːn
تابستان	tɒːbestɒːn
آبادی	ɒːbɒːdiː
جنگ اسفلال طلبی	d͡ʒænɡeesteɢlɒːltælæbiː
مراکشی	mæɾɒːkeʃiː
نادیا	nɒːdiːjɒː
چشمک زدن	t͡ʃeʃmækzædæn
قند	ɢænd
سفید	sefiːd
حل شدن	hælʃodæn
گند	ɡænd
عاشق شدن	ɒːʃeɢʃodæn
بخیه زدن	bæxiːjezædæn
ابوظبی	æbuːzɒːbiː
فکر افتادن	fekɾoftɒːdæn
فردا شب	fæɾdɒːʃæb
غنوصی	ɢnuːsiː
ارتش	æɾteʃ
بابا نوئل	bɒːbɒːnoʔel
دری	dæɾiː
هجوم آوردن	hod͡ʒuːmɒːvæɾdæn
قل	ɢol
خواهد خواست	xɒːhædxɒːst
ژوئن	ʒuːʔæn
هول	hoʊl
صف	sæf
سنا	senɒː
حماس	hæmɒːs
دوریان	duːɾiːɒːn
نیش و کنایه	niːʃokenɒːje
نیم‌خط	niːmxæt
تخمین	tæxmiːn
حرف ندا	hæɾfenedɒː
دودمانه	duːdmɒːne
هوا	hævɒː
مهره‌دار	mohɾedɒːɾ
مقدار زیاد	meɢdɒːɾeziːjɒːd
پرتاب کردن	pæɾtɒːbkæɾdæn
پرواربندی	pæɾvɒːɾbændiː
صدا دادن	sedɒːdɒːdæn
زیادروی	ziːɒːdeɾæviː
نابرادری	nɒːbæɾɒːdæɾiː
شکوه	ʃokuːh
ودکا	vodkɒː
شوپرک	ʃoʊpæɾæk
تکرار	tekɾɒːɾ,tækɾɒːɾ
منچوری	mænt͡ʃuːɾiː
اندازه زدن	ændɒːzezædæn
زیربغل	ziːɾbæɢæl
فمینیسم	femiːniːsm
موج زدن	moʊd͡ʒzædæn
چراغ مطالعه	t͡ʃeɾɒːɢemotɒːleʔe
لو رفتن	loʊɾæftæn
تاریکی	tɒːɾiːkiː
اظهار	ezhɒːɾ,æzhɒːɾ
سیستم	siːstem
تکیه دادن	tækjedɒːdæn
شاذ	ʃɒːzz
خواهش می‌کنم	xwɒːheʃmiːkonæm,xɒːheʃmiːkonæm
بیشه	biːʃe
عجله	æd͡ʒæle
روس	ɾuːs
چاله	t͡ʃɒːle
رومی	ɾuːmiː
خرمالو	xoɾmɒːluː
فاس	fɒːs
روتیل	ɾuːtiːl
خانه	xɒːne,xɒːnæ
دل سوختن	delsuːxtæn
باخ	bɒːx
خرده گرفتن	xoɾdeɡeɾeftæn
پس‌زمینه	pæszæmiːne
ادا درآوردن	ædɒːdæɾɒːvæɾdæn
همچنین	hæmt͡ʃeniːn
آنگولا	ɒːnɡuːlɒː
جهد کردن	d͡ʒæhdkæɾdæn
دکتر داروساز	doktoɾedɒːɾuːsɒːz
قياس کردن	ɢiːɒːskæɾdæn
دزدی	dozdiː
دوستی	duːstiː
روی سخته	ɾuːjsæxte
حشیش زدن	hæʃiːʃzædæn
اعلامیه زدن	eʔlɒːmiːjezædæn
بسیار	besiːjɒːɾ
شوهر دادن	ʃohæɾdɒːdæn
گرجستان	ɡoɾd͡ʒestɒːn
راحت‌الحلقوم	ɾɒːhætelholɢuːm
تن کردن	tænkæɾdæn
کافی	kɒːfiː
اندیشیدن	ændiːʃiːdæn
ديوانه	diːvɒːne
سیاه	siːjɒːh
شمال شرقی	ʃæmɒːleʃæɾɢiː,ʃomɒːleʃæɾɢiː
جهاد	d͡ʒehɒːd
عربده	æɾbæde
دانمارکی	dɒːnmɒːɾkiː
نژادی	neʒɒːdiː
جان گرفتن	d͡ʒɒːnɡeɾeftæn
امسال	emsɒːl
طبقه کارگر	tæbæɢejekɒːɾɡæɾ
خنجر زدن	xænd͡ʒæɾzædæn
جهنم	d͡ʒæhænnæm
شیعی	ʃiːʔiː
کمین گرفتن	kæmiːnɡeɾeftæn
مستقل	mostæɢel
گذشته	ɡozæʃte
قرقاول	ɢæɾɢɒːvol
کتاب‌فروشی	ketɒːbfoɾoʃiː
كروآت	kɾoɒːt
فیصل‌آباد	fejsælɒːbɒːd
حدیث	hædiːs
بین‌المللی	bejnolmelæliː
محاکمه	mohɒːkeme
پوچ	puːt͡ʃ
هلیکوپتر	heliːkuːpteɾ
نازک	nɒːzek
آبریز	ɒːbɾiːz
کیمیاگر	kiːmiːɒːɡæɾ
سیلی زدن	siːliːzædæn
میلک شیک	miːlkʃejk
کابوس	kɒːbuːs
تک‌تیرانداز	tæktiːɾændɒːz
داشتیم می‌خواستیم	dɒːʃtiːmmíxɒːstiːm
حضور داشتن	hozuːɾdɒːʃtæn
مهمانی منزل مبارکی	mehmɒːniːjemænzelemobɒːɾækiː
اختصاص دادن	extesɒːsdɒːdæn
پرتقال	poɾteɢɒːl
تشویق کردن	tæʃviːɢkæɾdæn
تتراهیدروکانابینول	tetɾɒːhiːdɾokɒːnɒːbiːnol
حركت	hæɾekæt
میوه	miːve
رگ زدن	ɾæɡzædæn
آب کشیدن	ɒːbkeʃiːdæn
بسط دادن	bæstdɒːdæn
اختیار دادن	extiːɒːɾdɒːdæn
اتهام	ettehɒːm
زبان تاجیکی	zæbɒːnetɒːd͡ʒiːkiː
محمد	mohæmmæd
به قلاب انداختن	beɢollɒːbændɒːxtæn
معالجه	moʔɒːled͡ʒe
یورش آوردن	joɾeʃɒːvæɾdæn
آلش	ɒːlæʃ
جشن گرفتن	d͡ʒɒːʃnɡeɾeftæn
پورنوگرافی	poɾnoɡɾɒːfiː
حتما	hætmæn
تخت طاووس	tæxtetɒːvuːs
نو	noʊ,nouː,nuː
تلفن زدن	telefonzædæn,telefonzædæn
قناری	ɢænɒːɾiː
کتاب داوران	ketɒːbdæwɾæn
فرمانده کل قوا	fæɾmɒːndejekolleɢovɒː
توجه	tævæd͡ʒd͡ʒoh
برای اینکه	bæɾɒːjeiːnke
شفتالو	ʃæftɒːluː
جیمز	d͡ʒejmz
تعلق گرفتن	tæʔælloɢɡeɾeftæn
افشنگ	æfʃænɡ
تفریح	tæfɾiːh
علامت خوردن	ælɒːmætxoɾdæn
رومنی	ɾuːmniː
صورت دادن	suːɾætdɒːdæn
اسير	æsiːɾ
جلال‌آباد	d͡ʒælɒːlɒːbɒːd
مرغابی	moɾɢɒːbiː
پشتک زدن	poʃtækzædæn
ساس	sɒːs
پختن	poxtæn
آرام شدن	ɒːɾɒːmʃodæn
رنگین‌کمان	ɾænɡiːnkæmɒːn
انگ	ænɡ
دوباره!	dobɒːɾe
این به اون در	iːnbeondæɾ
طلایی	tælɒːjiː
جدول تناوبی	d͡ʒædvæletænɒːvobiː
ترنسنیستریا	tɾænsniːstɾiːjɒː
آرزو داشتن	ɒːɾezuːdɒːʃtæn,ɒːɾezuːdɒːʃtæn
صربی	seɾbiː,sæɾbiː
فوران زدن	fævæɾɒːnzædæn
ران	ɾɒːn
غزال	ɢæzɒːl
نجات دادن	ned͡ʒɒːtdɒːdæn
زدودن	zoduːdæn
تازیانه	tɒːziːɒːne,tɒːziːjɒːne
زبان‌شناسی	zæbɒːnʃenɒːsiː
آمین	ɒːmiːn
ریز	ɾiːz
قاهره	ɢɒːheɾe
سازدهنی	sɒːzdæhæniː
شکنجه	ʃekænd͡ʒe
ضرورت	zæɾuːɾæt
واژه	vɒːʒe
مکاتبه داشتن	mokɒːbebedɒːʃtæn
ارومیه	oɾuːmiːe
عر کشیدن	æɾkeʃiːdæn
یورش بردن	joɾeʃboɾdæn
یاس	jɒːs
فشار	feʃæɾ
احتياط	ehtiːɒːt
ایسلندی	ʔiːslændiː
قرارملاقات گرفتن	emolɒːɢɒːtɡeɾeftæn
تحمیل	tæhmiːl
شبه‌جزیره	ʃebed͡ʒæziːɾe
لیتر	liːtɾ
جنگ جهانی یكم	d͡ʒænɡed͡ʒæhɒːniːejekom
بررسی	bæɾɾesiː
حركت درآوردن	hæɾekætdæɾɒːvæɾdæn
زلکوا	zelkovɒː
یادگاری	jɒːdeɡɒːɾiː
چشم زخم	t͡ʃeʃmzæxm
قرض	ɢæɾz
گوجه	ɡod͡ʒe,ɡoʊd͡ʒe
بو	buː
دمبل	dæmbel
عضله	ʔæzole
نژاد برتر	neʒɒːdebæɾtæɾ
شلوار	ʃælvɒːɾ
تکیه زدن	tækjezædæn
باور کردن	bɒːvæɾkæɾdæn,bɒːvæɾkæɾdæn
اسب دریایی	æsbedæɾjɒːjiː
هست	hæst
گیوه	ɡiːve
آمیزش جنسی	ɒːmiːzeʃed͡ʒensiː
دریاچه خوارزم	dæɾjɒːt͡ʃeexoɾæzm
جدال	d͡ʒedɒːl
ریمل زدن	ɾiːmelzædæn
فرش	fæɾʃ
ثابت	sɒːbet
خیر	xejɾ
بمب خوردن	bombxoɾdæn
تعقیب	tæʔɢiːb
معنی	mæʔniː
فامیل	fɒːmiːl
نپال	nepɒːl
سیرابی	siːɾɒːbiː
سبد	sæbæd
برج	boɾd͡ʒ
آلو	ɒːluː
اسلام‌گرایی	eslɒːmɡæɾɒːjiː
دوشیزه	douːʃiːze,duːʃiːze
کانبرا	kɒːnbæɾɒː
دانشمند	dɒːneʃmænd
متریک	metɾiːk
دستمال	dæstmɒːl
شطرنج زدن	ʃætɾænd͡ʒzædæn
پدرشوهر	pedæɾʃouːhæɾ,pedæɾʃoʊhæɾ
كیف کردن	kejfkæɾdæn
بسپار	bæspɒːɾ
کشو	keʃo
جهان عرب	d͡ʒæhɒːneʔæɾæb
ممنوع است	memnuːæst
حلقه کردن	hælɢekæɾdæn
خین	xiːn
بکارت	bækɒːɾæt
اظهارنظر	ezhɒːɾenæzæɾ
جورج	d͡ʒoɾd͡ʒ
گره	ɡeɾe,ɡeɾeh
لیمویی	liːmuːjiː
آفریکانز	ɒːfɾiːkɒːnz
رسیدن	ɾæsiːdæn,ɾesiːdæn,ræsiːdæːn
گل زدن	ɡolzædæn,ɡolzædæn
فرستادن	feɾestɒːdæn
یمن	jæmæn
سنباده کشیدن	sombɒːdekeʃiːdæn
طوفان ریگ	tuːfɒːneɾiːɡ
نعره کشیدن	næ’ɾekeʃiːdæn
ندیده	nædiːde
هخامنشی	hæxɒːmæneʃiː
زاری کردن	zɒːɾiːkæɾdæn
واگن	vɒːɡon
در زمان	dæɾzæmɒːne
رودخونه	ɾuːdxuːne
کمک کردن	komækkæɾdæn
باقالا	bɒːɢɒːlɒː
قطب‌نما	ɢotbnæmɒː
دورواژیدن	duːɾvɒːʒiːdæn
ثابت پلانک	sɒːbeteplɒːnk
امان دادن	æmɒːndɒːdæn
سند	sænæd,send
تلمبه زدن	tolombezædæn
ارکستر	oɾkestɾ
خوراک سگ	xoɾɒːksæɡ
فنلاند	fænlɒːnd
عسل	æsæl
بدرقه کردن	bædɾæɢekæɾdæn
بنگ	bænɡ
اسباب	æsbɒːb
سال آینده	sɒːleɒːjænde
ولزی‌ها	velziːhɒː
بندر سری بگاوان	bændæɾseɾiːbeɡɒːvɒːn
چندگانه	t͡ʃændɡɒːne
نمک	næmæk
انگ زدن	ænɡzædæn
ذهنیت	zehniːjjæt
مادراندر	mɒːdæɾændæɾ
قانون	ɢɒːnuːn
عدد صحیح	ædædesæhiːh
همسر	hæmsæɾ
نسبت دادن	nesbætdɒːdæn
می‌خواهی	míxɒːhiː
نگاه کردن	neɡɒːhkæɾdæn,neɡɒːhkæɾdæn
حنا	hænɒː,hennɒː
سکندر کبیر	eskændæɾkæbiːɾ
کارمزد	kɒːɾmozd
اره کشیدن	æɾɾekeʃiːdæn
ساری	sɒːɾiː
تنهایی	tænhɒːjiː
خورشیدفش	xuːɾʃiːdfæʃ
ماسک	mɒːsk
چال	t͡ʃɒːl
دست و پا	dæstopɒː
ریال	ɾiːɒːl
هیزم	hiːzom
کانادا	kɒːnɒːdɒː
پیاز	piːjɒːz
سنجش	sænd͡ʒeʃ
بنتلی	bentliː
کم حرف	kæmhæɾf
ثمر رسیدن	sæmæɾɾesiːdæn
حقیقت	hæɢiːɢæt
توحید	touːhiːd
نوتلا	nuːtelɒː
عق گرفتن	oɢɢɡeɾeftæn
خراب	xæɾɒːb
مسجد	mæsd͡ʒed
دشمنی	doʃmæniː
جیغ کشیدن	d͡ʒiːɢkeʃiːdæn
آسفالت	ɒːsfɒːlt
لگد	læɡæd
مارخور	mɒːɾxoɾ
اکتفا کردن	ektefɒːkæɾdæn
دزدیدن	dozdiːdæn
گاو نر	ɡɒːvenæɾ
بیراهه زدن	biːɾɒːhezædæn
عاریه	ɒːɾje
کوشیدن	kuːŝiːdæn
جادو	d͡ʒɒːduː
خرج	xæɾd͡ʒ
حقه خوردن	hoɢɢexoɾdæn
چبوق	t͡ʃebuːɢ
خبر کردن	xæbæɾkæɾdæn
سالن	sɒːlon
جنگل زدن	d͡ʒænɡælzædæn
نماد	næmɒːd
دنیا آوردن	donjɒːɒːvæɾdæn
بدون	beduːne
شم ارا	ʃomɒːɾɒː
دانشكده	dɒːneʃkæde
لق زدن	læɢzædæn
متی	mætiː
سیلی خوردن	siːliːxoɾdæn
شهردار	ʃæhɾdɒːɾ
حریم	hæɾiːm
دیابت	diːjɒːbet
کوفته	kuːfte
عذاب کشیدن	æzɒːbkeʃiːdæn
ترکستان	toɾkestɒːn
رازآميز	ɾɒːzɒːmiːz
عمل آمدن	æmælɒːmædæn
مستی زدن	mæstiːzædæn
بخشیدن	bæxʃiːdæn
رسم	ɾæsm
نادر	nɒːdeɾ
حشره	hæʃæɾe
زیست‌شناسی	ziːstʃenɒːsiː
معالجه شدن	moʔɒːled͡ʒeʃodæn
واقعی	vɒːɢeiː
پیشه	piːʃæ,piːʃe
ورقه	væɾæɢe
واژهشناسی	vɒːʒeʃenæsiː
یاوه گفتن	jɒːvæɡoftæn
مایکروسافت	mɒːjkɾosoft
پیچیده	piːt͡ʃiːde
گویش	ɡuːjeʃ
آب و هوا	ɒːbohævɒː
جیک	d͡ʒiːk
تورات	tuːɾɒːt,tævɾɒːt
بادام	bɒːdɒːm
همگام	hæmɡɒːm
زبان روسی	zæbɒːneɾuːsiː
پرش	pæɾeʃ
بندی	bændiː
زرشکی	zeɾeʃkiː
نرگس	næɾɡes
اخراج	exɾɒːd͡ʒ
جوش زدن	d͡ʒuːʃzædæn
پیاله زدن	piːɒːlezædæn
نعناع	næʔnɒːʔ
آتش	ɒːtæʃ
خرس	xeɾs
دکوراسیون	dekoɾɒːsjon
ضمنی	zemniː
ساندویچ	sɒːndeviːt͡ʃ
باج گرفتن	bɒːd͡ʒɡeɾeftæn
همایش	hæmɒːjeʃ
بند آوردن	bændɒːvæɾdæn
شمار آوردن	ʃomɒːɾɒːvæɾdæn
باش	bɒːʃ
نیروی دریایی	niːɾuːjedæɾjɒːjiː
گیتاریست	ɡiːtɒːɾiːst
درنگ كردن	dɾænɡkæɾdæn
نقصان یافتن	noɢsɒːnjɒːftæn
ظهور کردن	zohuːɾkæɾdæn
امری	æmɾiː
کلک	kælæk
حنا زدن	hænɒːzædæn
چرتکه	t͡ʃoɾtke
عروسک	ʔæɾuːsæk
پیش از ظهر	piːʃæzzohɾ
بخواهی	bexɒːhiː
جست	d͡ʒæst
خودداری کردن	xoddɒːɾiːkæɾdæn
اره‌ماهی	æɾɾemɒːhiː
یخ	jæx
ورم کردن	væɾæmkæɾdæn
مالدار	mɒːldɒːɾ
دست زدن	dæstzædæn,dæstzædæn
زبان طبیعی	zæmɒːnetæbiːʔiː
تحریم	tæhɾiːm
سداب	sodɒːb
آگره	ɒːɡɾe
سفارش کردن	sefɒːɾeʃkæɾdæn
تخته سیاه	tæxtejesiːjɒːh
پرپر زدن	pæɾpæɾzædæn
گریز	ɡoɾiːz
غروب کردن	ɢoɾuːbkæɾdæn
موعظه کردن	moʔezekæɾdæn
لذت	lezzæt
سه‌نقطه	senoɢte
گیک	ɡiːk
سودمند	suːdmænd
عطسه کردن	ætsekæɾdæn
نوکیا	nuːkiːjɒː
جوانه	d͡ʒævɒːne
تپق زدن	topoɢzædæn
هسته‌ای	hæsteʔiː
یاد آمدن	jɒːdɒːmædæn
درست	doɾost
قبله	ɢeble
استخر	estæxɾ
صدمه خوردن	sædæmexoɾdæn
حساب آمدن	hesɒːbɒːmædæn
جاده	d͡ʒɒːdde
ور	veɾ
نظم دادن	næzmdɒːdæn
بچگی	bæt͡ʃeɡiː
همین	hæmiːn
دختر برادر	doxtæɾebæɾɒːdæɾ
کویت	koveiːt
ربه‌کا	ɾebekɒː
الهام شدن	elhɒːmʃodæn
فضا	fæzɒː
بیشکک	biːʃkek
دیرکرد	diːɾkæɾd
پخته	poxte
کبریت	kebɾiːt
صلیب سرخ	sæliːbesoɾx
نانوا	nɒːnvɒː
گفتن	ɡoftæn
الله آباد	ællɒːhɒːbɒːd
حق	hæɢɢ
دعوت کردن	dæʔvætkæɾdæn
یونیکس	juːniːks
کاتولیک	kɒːtoliːk
برونئی	boɾuːnej
انگوین	ænɡoviːn
هر از گاهی	hæɾæzɡɒːhiː
سیما	siːmɒː
موش‌مردگی زدن	muːʃmoɾdeɡiːzædæn
داشتند می‌خواستند	dɒːʃtændmíxɒːstænd
دریاچه	dæɾjɒːt͡ʃe
قم	ɢom
شیردال	ʃiːɾdɒːl
آئورت	ɒːʔoɾt
ناواهو	nɒːvɒːho
گولاگ	ɡuːlɒːɡ
ها	hɒː
لکهٔ زرد	lækkejezæɾd
آهار	ɒːhɒːɾ
مادرزن	mɒːdæɾzæn
مریم مقدس	mæɾjæmemoɢæddæs
تو	to,tuː
بلخ	bælx
اژدهای بالدار	eʒdehæjebældæɾ
تلفن کردن	telefonkæɾdæn,telefonkæɾdæn
خلاصه	xolɒːse
گریه زدن	ɡeɾjezædæn
بازیکن	bɒːziːkon
مغز	mæɢz
ارزانی	æɾzɒːniː
بسته بندی کردن	bestebændiːkæɾdæn
عصبانیت	æsæbɒːnjjiːæt
نمایاندن	næmɒːjɒːndæn
سوریه	suːɾiːje
برای	bæɾɒːje
شاخص	ʃɒːxes
کشتی نوح	kæʃtiːjenuːh
پرستار	pæɾæstɒːɾ
لمس کردن	læmskæɾdæn
بالا	bɒːlɒː
گنجشک	ɡond͡ʒeʃk
تجدیدنظر کردن	tæd͡ʒdiːdenæzæɾkæɾdæn
آخرت	ɒːxeɾæt
او را	uːɾɒː
ممنون	mæmnuːn
پزشک زایمان	pezeʃkezɒːjemɒːn
طبیب	tæbiːb
نق	neɢ
خاک	xɒːk
بانکوک	bɒːnkok
آدینه	ɒːdiːne
کوستروما	kostɾomɒː
قسمت	ɢesmæt
مثلثات	mosælæsɒːt
شوریدن	ʃuːɾiːdæn
مه تنک	meetonok
سال نوری	sɒːlenuːɾiː
صهیونیسم	sæhjuːniːsm
شکنجه دادن	ʃekænd͡ʒedɒːdæn
هریوا	hæɾejvɒː
وعده	væʔde
دشمن	doʃmæn
دستگاه	dæstɡɒːh
ثمر داشتن	sæmæɾdɒːʃtæn
ویکی	viːkiː
بدبده	bædbæde
حسادت	hesɒːdæt
کپک	kæpæk
سر کیر	sæɾekiːɾ
شبکیه	ʃæbækiːje
شطرنج	ʃætɾænd͡ʒ
معلق زدن	mællæɢzædæn
برانداز کردن	bæɾændɒːzkæɾdæn
مسلسل	mosælsæl
اگر	æɡæɾ
هم​بستر شدن	hæmbæstæɾʃodæn
دعوا	dæʔvɒː
کوچیدن‌	kuːt͡ʃiːdæn
برنج	beɾend͡ʒ
یونانی	juːnɒːniː
آتش کشیدن	ɒːtæʃkeʃiːdæn
موتورگازی	motoɾɡɒːziː
عقب	ʔæɢb,æɢæb
شمردن	ʃemoɾdæn,ʃomoɾdæn
هزار	hezɒːɾ
اوستیا	osetiːjɒː
.واشینگتن دی.سی	vɒːʃenɡtondiː.siː.
دخترعمه	doxtæɾʔæmme,doxtæɾæmme
عقد کردن	æɢdkæɾdæn
اسپرز	espoɾz
حکایت	hekɒːjæt
برنده	bæɾænde
عهده داشتن	ohdedɒːʃtæn
نارنجی	nɒːɾænd͡ʒiː,nɒːɾend͡ʒiː
نگاره	neɡɒːɾæ,neɡɒːɾe
چامه سرایی	t͡ʃɒːmesæɾɒːjiː
احساس کردن	ehsɒːskæɾdæn
تلاش بودن	tælɒːʃbuːdæn
علامت تعجیب	ʔælɒːmætetæʔd͡ʒiːb
مهر	mohɾ,mehɾ
مثلث	mosælæs
آهسته	ɒːheste
هدف	hædæf
پی‌غذا	t͡ʃiːɢæzɒː
هزاردستان	hæzɒːɾdæstɒːn
تعظیم	tæʔziːm
بحث کردن	bæhskæɾdæn
صد	sæd
لقب	læɢæb
مشرق	mæʃɾeɢ
عموزاده	æmuːzɒːde
یاری دادن	jɒːɾiːdɒːdæn
ارج نهادن	æɾd͡ʒnæhɒːdæn
هاینه	hɒːjne
لباس شنا	lebɒːseʃenɒː
بهت زدن	bohtzædæn
زنانگی	zænɒːneɡiː
پس‌فردا	pæsfæɾdɒː
جهالت	d͡ʒ��hɒːlæt
کوشک	kuːʃk
موعظه	moʔeze
انگور	ænɡuːɾ
روده	ɾuːde
تشر زدن	tæʃæɾzædæn
نهیب	næhiːb
تودهنی	tuːdæhæniː
نیشتر	niːʃtæɾ
سس	sos
نسل	næsl
جلو زدن	d͡ʒelozædæn
پایان دادن	pɒːjɒːndɒːdæn
عیبجویی کردن	ʔejbd͡ʒuːjiːkæɾdæn
مراکش	mæɾɒːkeʃ
گرده	ɡoɾde
مخالفت کردن	moxɒːlefætkæɾdæn
پژوهیدن	pæʒuːhiːdæn
فراكهكشانی	fæɾɒːkæhkeʃɒːniː
صبح زود	sobhezuːd
بریتانیا	beɾiːtɒːniːjɒː
تکان خوردن	tekɒːnxoɾdæn
زلاند نو	zelɒːndenouː
شرابی	ʃæɾɒːbiː
بچه قورباغه	bæt͡ʃt͡ʃejeɢuːɾbɒːɢe
محراب	mehɾɒːb
بهار	bæhɒːɾ
کمیاب	kæmjɒːb
محاصره	mohɒːseɾe
تطبیق کردن	tætbiːɢkæɾdæn
آهن	ɒːhæn
اخطار	extɒːɾ
ترشیده	toɾʃiːdæh
یوزپلنگ	juːzpælænɡ
پلنگ	pælænɡ
آغاز	ɒːɢɒːz
فهمیدم	fæhmiːdæm
خشم گرفتن	xæʃmɡeɾeftæn
همنژادان	hæmnæʒɒːdɒːn
اسوار	æsvæɾ
مهم	mohem
زن‌عمو	zænæmuː
سطح	sætæh
ترمتای	tæɾmætɒːj
بلیت	beliːt
باده	bɒːdæ
سریر	sæɾiːɾ
آی‌پاد	ɒːjpɒːd
کشتن	koʃtæn
رعد	ɾæʔd
سواری کردن	sævɒːɾiːkæɾdæn
پیتزا	piːtzɒː
غلت خوردن	ɢæltxoɾdæn
پنجول کشیدن	pænd͡ʒuːlkeʃiːdæn
دختردائی	doxtæɾdɒːʔiː
چاک خوردن	t͡ʃɒːkxoɾdæn
سرطان	sæɾætɒːn
سلطنت	sæltænæt
خواستگاری	xɒːsteɡɒːɾiː,xvɒːstɡɒːɾiː
هر چند وقت یک بار	hæɾt͡ʃændvæɢtjekbɒːɾ
دیگ	dîɡ,diːɡ
عکس گرفتن	æksɡeɾeftæn
خراب کردن	xæɾɒːbkæɾdæn
ویکی‌پدیا	viːkiːpediːjɒː
نفس زدن	næfæszædæn
برانکارد	bɾɒːnkɒːɾd
داغ	dɒːɢ
شیهه زدن	ʃejhezædæn
رو به راه	ɾuːbeɾɒːh
خاقان	xɒːɢɒːn
ارزیابی	æɾzjɒːbiː
شاهزاده‌خانم	ʃɒːhzɒːdexɒːnom
عصب	ʔæsæb,æsæb
گروه	ɡoɾuːhʔ,ɡoɾuːh
احضار	ehzɒːɾ
عادت گرفتن	ɒːdætɡeɾeftæn
مشغول	mæʃɢuːl
خواسته باشد	xɒːstebɒːʃæd
دوربین	duːɾbiːn
گپ	ɡæp
تکنولوژی	teknoloʒiː
درست کردن	doɾostkæɾdæn
شو	ʃuː
شناخت	ʃenɒːxt
روستایی	ɾuːstɒːjiː,ɾuːstɒːʔiː
جارو کردن	d͡ʒɒːɾuːkæɾdæn
فارسی دری	fɒːɾsiːjedæɾiː
گفتگو کردن	ɡofteɡuːkæɾdæn
چینی	t͡ʃiːniː
ﺱیﺲﺘﻣ ﻉﺎﻤﻟ	siːstemɒːmæl
آشتی	ɒːʃtiː,æʃtiː
دلبر	delbæɾ
چای سیاه	t͡ʃɒːjesiːjɒːh
اصلاح کردن	eslɒːhkæɾdæn
نهان	nehɒːn
خود آمدن	xodɒːmædæn
بوی	büj
چال انداختن	t͡ʃɒːlændɒːxtæn
خمپاره زدن	xompɒːɾezædæn
چشم زخم زدن	t͡ʃeʃmzæxmzædæn
شهامت	ʃæhɒːmæt
ضربت خوردن	zæɾbætxoɾdæn
چوگان	t͡ʃoʊɡɒːn
پهپاد	pæhpɒːd
آمودریا	ɒːmuːdæɾjɒː
گریه افتادن	ɡeɾjeoftɒːdæn
او	æw,oʊ,uː
کنگر فرنگی	kænɡæɾefæɾænɡiː
عرق کردن	æɾæɢkæɾdæn
اطمینان	etmiːnɒːn
زیانشانه‌شناسی	ziːɒːneʃæneʃenɒːs
تهی	tohiː
تزیین	tæzʔiːn
آفریقایی	ɒːfɾiːɢɒːjiː
راز	ɾɒːz
بی‌خیالی	biːxiːjɒːliː
می‌خواستید	míxɒːstiːd
خندیدن	xændiːdæn
هفته‌ی آینده	hæftejeɒːjænde
میانبر	miːɒːnboɾ
رسم کردن	ɾæsmkæɾdæn
کلک خوردن	kælækxoɾdæn
سرماخوردگی زدن	sæɾmɒːxoɾdeɡiːzædæn
تشر	tæʃæɾ
بلعیدن	bæliːdæn,bælʔiːdæn
استراتژی	esteɾɒːteʒiː
تعریف کردن	tæʔɾiːfkæɾdæn,tæʔɾiːfkæɾdæn
ایسلند	ʔiːslænd
نظاره	nezɒːɾe
قلمه	ɢælæme
جنسیت	d͡ʒensiːjæt
خاموش	xɒːmuːʃ
طفره رفتن	tæfɾeɾæftæn
اذیت کردن	æziːjætkæɾdæn
لیبی	liːbiː
نارنجک	nɒːɾend͡ʒæk
انگشت	ænɡoʃt
تحریم‌ کردن	tæhɾiːmkæɾdæn
نروژ	noɾveʒ
نمودار	nemuːdɒːɾ
شعر	ʃʔeɾ
درآوردن	dæɾɒːvæɾdæn
بوئینگ	boʔiːnɡ
روغن	ɾoʊɢæn,ɾuːɢæn
اسکار	oskæɾ
خراش	xæɾɒːʃ
شیمی	ʃiːmiː
خواسته‌ام	xɒːsteæm
سگدو زدن	sæɡdozædæn
یاسمن	jɒːsæmen
وصول	vosuːl
ارمود	æɾmuːd
گشودن	ɡoʃuːdæn
آويزان كردن	ɒːviːzɒːnkæɾdæn
راهبرد	ɾɒːhboɾd
استارت زدن	estɒːɾtzædæn
گلایه	ɡelɒːje
زن	zæn
شیء	ʃejʔ
سندیکا	sendiːkɒː
تو راه	tuːɾɒːh
روشن	ɾoʊʃæn,ɾouːʃæn,ɾoŝæn,ɾoʃæn
صبر کردن	sæbɾkæɾdæn,sæbɾkæɾdæn
نیمکت	niːmkæt
مادام	mɒːdɒːm
زنده	zendæ,zende
روزی از روزها	ɾuːziːæzɾuːzhɒː
توپ وتشر	tuːpotæʃæɾ
سیاه خروس	siːjɒːhexoɾuːs
مست تلو تلو خوردن سست	sostmæst
پنیسیلین	peniːsiːliːn
باز خواندن	bɒːzxɒːndæn
امیر	æmiːɾ
پلاتو	pelæto
اسمیت	iːsmiːt
زمانی که	zæmɒːniːke
بهانه آوردن	bæhɒːneɒːvæɾdæn
شعله	ʃoʔle,ʃo’le
اصل	æsl
لژیون	leʒiːon
شهوتی	ʃæhvætiː
غش غش زدن	ɢæʃɢæʃzædæn
اتفاقا	ettefɒːɢæn
بنیانگذار	bonjɒːnɡozɒːɾ
به یاد داشتن	bejɒːddɒːʃtæn
کلنجار	kælænd͡ʒɒːɾ
بجنب	bed͡ʒonb
هفتصد	hæftsæd
ناشتا	nɒːʃtɒː
دختر خواهر	doxtæɾexwɒːhæɾ
آبگونه	ɒːbɡuːne
جوانه زدن	d͡ʒævɒːnezædæn
کرکس	kæɾkæs
تخفیف	tæxfiːf
مروارید	mæɾvɒːɾiːd
قابل نداشت	ɢɒːbelnædɒːʃt
چهارشنبه	t͡ʃæhɒːɾʃænbe
جرم	d͡ʒoɾm,d͡ʒeɾm
انباز	ænbɒːz
حاکم	hɒːkem
آی‌فون	ɒːjfuːn
اعلامیه	eʔlɒːmiːje
بینش	biːneʃ
والده	vɒːlede
شانه زدن	ʃɒːnezædæn
قتل	ɢætl
براروسی	bæɾɒːɾuːsiː
صفحه	sæfhe
برخواندن	bæɾxɒːndæn
خوابیدن	xɒːbiːdæn,xwɒːbiːdæn
مکانیک	mekɒːniːk
صافی	sɒːfiː
دادگری	dɒːdɡæɾiː
چوبان	t͡ʃuːbɒːn
پزنده	pæzændæ,pæzænde
گیلک	ɡiːlæk
مقاله	mæɢɒːle
پوسته	puːste,puːstæ
تشویق	tæʃviːɢ
نق زدن	neɢzædæn,neɢzædæn
هشتاد	hæʃtɒːd
کاباره	kɒːbɒːɾe
گورستان	ɡuːɾestɒːn
لاف زدن	lɒːfzædæn
شیون کردن	ʃiːvænkæɾdæn
درودن	dɾuːdæn,doɾuːdæn
حمله بردن	hæmleboɾdæn
افلاطون	æflɒːtuːn
پریشتینا	peɾiːʃtiːnɒː
مومیا	muːmjɒː
کشیده	kæʃiːdæ,keʃiːde,kæʃiːde
کمین کردن	kæmiːnkæɾdæn
پله برقی	pelebæɾɢiː
جویدن	d͡ʒæviːdæn
پوکر	pokeɾ,puːkeɾ
وب نوشت	vebneveʃt
آتشسوزی	ɒːtæʃsuːziː
لطمه زدن	lætmezædæn
مهر کردن	mohɾkæɾdæn
تنگستن	tænɡesten
مطب	mætæb
حمل	hæml
غر زدن	ɢoɾzædæn
ستاد	setɒːd
کرایست‌چرچ	kɾɒːjstt͡ʃeɾt͡ʃ
حیرت	hejɾæt
جا به جا	d͡ʒɒːbed͡ʒɒː
زبانه	zæbɒːne
رقص	ɾæɢs
داداش	dɒːdɒːʃ
شترمرغ	ʃotoɾmoɾɢ,ʃotoɾmoɾɢ
انتیموان	æntiːmoɒːn
خروشچف	xɾuːʃt͡ʃef
کنسولگری	konsuːlɡæɾiː
گازولین	ɡɒːzuːliːn
گل آویز	ɡolɒːviːz
آنکارا	ɒːnkæɾæ
اوباما	obɒːmɒː
باسلق	bɒːsloɢ
شیوه	ʃiːve
چامه	t͡ʃɒːme
فرمان	fæɾmɒːn
یاماکا	jɒːmɒːkɒː
مرحله	mæɾhæle
حیله	hiːle
ناسازگاری	nɒːsɒːzɡɒːɾiː
ترش	toɾʃ
اروپا	oɾuːpɒː
واکس	vɒːks
گردن بند	ɡæɾdænbænd
سلام دادن	sælɒːmdɒːdæn
کوبیدن	kuːbiːdæn
دانایی	dɒːnɒːjiː
هشت‌پا	hæʃtpɒː
حضور	hozuːɾ
جیحون	d͡ʒejhuːn
غیر مجاز کردن	ɢejɾemod͡ʒɒːzkæɾdæn
ناهید	nɒːhiːd
سازمان	sɒːzmɒːn
ادب	ædæb
ناله کردن	nɒːlekæɾdæn
بار کردن	bɒːɾkæɾdæn
خوشگلی	xoʃɡeliː
خلاف	xælɒːf
پاشنه	pɒːʃne
آسیب خوردن	ɒːsiːbxoɾdæn
کله معلق زدن	kællemoællæɢzædæn
ابجد	ɒːbǧæd
خارطوم	xɒːɾtuːm
قله	ɢolle
دهانه	dæhɒːne
دست خوردن	dæstxoɾdæn
آنان	ɒːnɒːn
پاسپورت	pɒːspoɾt
موسولینی	muːsuːliːniː
مفعول	mæfʔuːl
عکاسی	ækkɒːsiː
فرانسویان	fæɾɒːnsæviːjɒːn
عمل	æmæl
وهم	væhm
حذر	hæzæɾ
رقص باله	ɾæɢsebɒːle
خوک	xuːk
چهارده	t͡ʃæhɒːɾdæh
رنگ زیتونی	ɾænɡzæiːtuːniː
پیچیدن	piːt͡ʃiːdæn
اسکاتلند	eskɒːtlænd
معلم	moʔællem
جنازه	d͡ʒænɒːze,d͡ʒenɒːze
هندایرانی	hendiːɾɒːniː
هیچ‌چیز	hiːt͡ʃt͡ʃiːz
نفرت	næfɾæt
بلد بودن	bælædbuːdæn
فکر کردن	fekɾkæɾdæn,fekɾkæɾdæn
انار	ænɒːɾ
غذا	ɢæzɒː
نظر داشتن	næzæɾdɒːʃtæn
بلور	bellôɾ
تقلید	tæɢliːd
پشت گردنی زدن	poʃtɡæɾdæniːzædæn
کوپرنیک	kuːpeɾniːk
جهالت زدن	d͡ʒæhɒːlætzædæn
نازیسم	nɒːziːsæm
باران گرفتن	bɒːɾɒːnɡeɾeftæn
مسلمان	mosælmɒːn
طعم	tæʔm
جمهوری	d͡ʒomhuːɾiː
تاتارستان	tætæɾstɒːn
گهگاه	ɡæhɡɒːh
بز	boz
رود	ɾuːd
برادرشوهر	bæɾɒːdæɾʃoʊhæɾ
پنجابی	pænd͡ʒɒːbiː
غیرالکلی	ɢejɾeælkoliː
تهيه	tæhiːje
ایراد	iːɾɒːd
سنگ	sænɡ
دوشنبه	doʃænbe,doʃæmbe
حمام رفتن	hæmmɒːmɾæftæn
خی	xiː
باسک	bɒːsk
آزمایشگاه	ɒːzmɒːjeʃɡɒːh
علامت منها	ʔælɒːmætemenhɒː
سادگی زدن	sɒːdeɡiːzædæn
میلیون	miːljuːn,miːljon
جبران	d͡ʒobɾɒːn
بافر	bɒːfeɾ
غارت	ɢɒːɾæt
مچ دست	mot͡ʃedæst
اندروا	ændæɾvɒː
تایلند	tɒːjlɒːnd
کس‌کش	koskeʃ
کینگستون	kiːnɡston
قبلا	ɢæblæn
بات	bɒːt
اختر	æxtæɾ
مطبوعات	mætbuːʔɒːt
جهاز	d͡ʒæhɒːz
اطاعت	etɒːʔæt
اسلام‌هراسی	eslɒːmhæɾɒːsiː
سمفونی	semfuːniː,siːmfuːniː
الجزایر	æld͡ʒæzɒːjeɾ
کرفس	kæɾæfs
آرزو كردن	ɒːɾezuːkæɾdæn
مچ گرفتن	mot͡ʃɡeɾeftæn
عنوان کردن	onvɒːnkæɾdæn
دورنگار	doɾneɡɒːɾ
ادرار	edɾɒːɾ
هوادار	hævɒːdɒːɾ
تصدیق کردن	tæsdiːɢkæɾdæn
خربزه	xæɾboze
بیرونی	biːɾuːniː
تصمیم گرفتن	tæsmiːmɡeɾeftæn
حسودی شدن	hæsuːdiːʃodæn
شگرف	ʃeɡæɾf
بلغم	bælɢæm
یخ بستن	jæxbæstæn
نیرنگ زدن	nejɾænɡzædæn
نمایه	næmɒːje
پرسیدن	poɾsiːdæn
شامپاین	ʃɒːmpɒːiːn
خواهش	xɒːheʃ
گاو	ɡɒːv
تایلندی	tɒːjlændiː
گذر	ɡozæɾ
خرچنگ	xæɾt͡ʃænɡ
شرط	ʃæɾt
خواست	xɒːst
مش زدن	meʃzædæn
چینی سنتی	t͡ʃiːniːjesonætiː
ماتیک زدن	mɒːtiːkzædæn
دگمه	doɡmæ,doɡme
مردگی	moɾdeɡiː
کارخانه	kɒːɾxɒːne
کف زدن	kæfzædæn
نخست	noxost
صبح بخیر	sobhbexejɾ
تقویت	tæɢviːæt
تكرار	tekɾɒːɾ
کتف	ketf
وول	vuːl
اندلس	ændælos
نشان	neŝɒːn,neʃɒːn
گریه کردن	ɡeɾjekæɾdæn,ɡeɾjekæɾdæn
صحبت	sohbæt
آمریکا	ɒːmɾiːkɒː
زیتونی	zejtuːniː
انگشت زدن	ænɡoʃtzædæn
بدلیل آن	bedæliːleɒːn
تصویر	tæsviːɾ
بوس کردن	buːskæɾdæn
اس ام اس کردن	esemeskæɾdæn
الفبای سیریلیک	ælefbɒːjesiːɾiːliːk
بسکتبال	bæsketbɒːl
یه ی	jeiː
یورتمه	joɾtmæ
واکسن زدن	vɒːksænzædæn
رونوشت	ɾuːneveʃt
نیزه‌دار	nejzedɒːɾ
طرابلس	tæɾɒːbolos
درد دل	dæɾdedel
فلز	felez
زیرآبی زدن	ziːɾɒːbiːzædæn
یکی یکی	jekiːjekiː
کوچولو	kuːt͡ʃuːluː
خریت زدن	xæɾiːjjætzædæn
شایع	ʃɒːjeʔ
اندرز	ændæɾz
جنس بلند کردن	ɡensbolændkæɾdæn
شیرین	ʃiːɾiːn
رکاب زدن	ɾekɒːbzædæn
درمانگاه	dæɾmɒːnɡɒːhʔ
آخر هفته	ɒːxeɾehæfte,ɒːxæɾehæfte
شماره‌گذاری شدن	ʃomɒːɾeɡozɒːɾiːʃodæn
نامیدن	nɒːmiːdæn
فلفل	felfel
شروع کردن	ʃoɾuːʔkæɾdæn,ʃoɾuːʔkæɾdæn
هاوانا	hɒːvɒːnɒː
فواره	fævvɒːɾe
چماق زدن	t͡ʃomɒːɢzædæn
در میان	dæɾmiːjɒːne
فرز	feɾz
چاپ زدن	t͡ʃɒːpzædæn
جشنواره	d͡ʒæʃnvɒːɾe
خوک خاکی	xuːkexɒːkiː
آزاد کردن	ɒːzɒːdkæɾdæn
شناگر	ʃenɒːɡæɾ
ورم	væɾæm
مستند	mostænæd
رساندن	ɾesɒːndæn
ستخوان	sotxɒːn
آتش زدن	ɒːtæʃzædæn
سازمان ملل متّحد	sɒːzmɒːnemelælemottæhed
تکمه	tokme,tokmæ
بنيانگذاري	bonjɒːnɡozɒːɾiː
پیامک	pæjɒːmæk
فکر	fekɾ
هند	hend
پستچی	postt͡ʃiː
شهبانو	ʃæhbɒːnuː
خطاط	xættɒːt
کوزپلی	kosplej
مترجم	motæɾd͡ʒem
جنگل	d͡ʒænɡæl
هارد راک	hɒːɾdɾɒːk
جنوب	d͡ʒonuːb
بیان شدن	bæjɒːnʃodæn
چاک پستان	t͡ʃɒːkpestɒːn
تمنا	tæmænnɒː
خر و پف	xoɾopof
سردابه	sæɾdɒːbe
نام	nɒːm
موش	muːʃ
نشستن	neʃæstæn
در	dæɾ
ترانه	tæɾɒːne
داغ زدن	dɒːɢzædæn
گلابی	ɡolɒːbiː
اروتیکی	eɾotiːkiː
انجام رساندن	ænd͡ʒɒːmɾesɒːndæn
مرض قند	mæɾæzeɢænd
جیم	d͡ʒiːm
کنیسه	kæniːse
مجهول	mæd͡ʒhuːl
برانگیختن	bæɾɒːnɡiːxtæn
هسپانیه	hespɒːniːje
شتر بیکوهان	ʃotoɾebiːkohɒːn
شخص	ʃæxs
دنده	dænde
خاور	xɒːvæɾ
فیلیپین	fiːliːpiːn
گابورون	ɡɒːboɾon
فوت کردن	foʊtkæɾdæn,fuːtkæɾdæn
برانداز	bæɾændɒːz
چاه	t͡ʃɒːh
کوارک	kuːɒːɾk
عق	oɢ,oɢɢ
افق	ofoɢ
قفقاز جنوبی	ɢæfɢɒːzed͡ʒonuːbiː
دیروز	diːɾuːz
تقریب زدن	tæɢɾiːbzædæn
گسترده شدن	ɡostæɾdæʃodæn,ɡostæɾdeʃodæn
ویرگول	viːɾɡuːl
کشف	kæʃf
هندو	henduː
صدمه	sædæme
معمولی	mæʔmuːliː
خنجر	xænd͡ʒæɾ
ایسیک کول	iːstiːkkuːl
گود	ɡoʊd
بادام هندی	bɒːdɒːmehendiː
دم گرفتن	dæmɡeɾeftæn
قصد	ɢæsd
سکه	sekke
ترک کردن	tæɾækkæɾdæn,tæɾkkæɾdæn
ارشمیدس	æɾʃemiːdes
آمور	ɒːmuːɾ
بامداد	bɒːmdɒːd
تراش	tæɾɒːʃ
جرگه‌سالاری	d͡ʒæɾɡesɒːlɒːɾiː
لهستان	læhestɒːn
ختنه‌گاه	xætneɡɒːh
نقطه‌ی ذوب	noɢtejezob
اژدر	æʒdæɾ
جن	d͡ʒen
فلفل قرمز	felfelɢeɾmez,felfeleɢeɾmez
گل‌کلم	ɡolkælæm
بید مجنون	biːdmæd͡ʒnuːn
اف‌بی‌آی	efbiːɒːj
عرب	ʔæɾæb
مخالفت	moxɒːlefæt
شامگاه	ʃɒːmɡɒːh
پرل هاربر	peɾlhɒːɾboɾ
مشروب	mæʃɾuːb
اسم فامیل	esmefɒːmiːl
دریا زدن	dæɾjɒːzædæn
وحشت	væhʃæt
روی	ɾuːj
خوشبختی	xoʃʔbàxtiː
ازگیل	æzɡiːl
شیرفروش	ʃiːɾfoɾuːʃ
انبه	ænbe
قره‌باغ	ɢæɾebɒːɢ
فروسرخ	foɾuːsoɾx
زبانه کشیدن	zæbɒːnekeʃiːdæn
خنگ	xenɡ
گستاخ	ɡostɒːx
آسیای جنوبی	ɒːsiːjɒːjed͡ʒonuːbiː
یاد کردن	jɒːdkæɾdæn
دادگاه	dɒːdɡɒːh
کیک	kejk
هم خوردن	hæmxoɾdæn
نيز	niːz
سورنای	suːɾnɒːj
آبغوره	ɒːbɢuːɾe
تصور	tæsævvoɾ
اثر کردن	æsæɾkæɾdæn
چقدر	t͡ʃeɢædɾ
بهار عربی	bæhɒːɾeʔæɾæbiː
تاجیک	tɒːd͡ʒiːk
درد	dæɾd
هامین	hɒːmiːn
شوی	ʃuːj
شدت گرفتن	ʃeddætɡeɾeftæn
راجع به	ɾɒːd͡ʒeʔbe
هوس کردن	hævæskæɾdæn
شبان	ʃobɒːn,ʃæbɒːn
گاوبندی	ɡɒːvbændiː
بیهوشی	biːhuːʃiː
زحمت	zæhmæt
آبفشاری	ɒːbfeʃæɾiː
فریبکار	fæɾiːbkɒːɾ
عبارت باقاعده	ʔebɒːɾætebɒːɢɒːʔede
!یاهو	jɒːhuː!
ژنوم	ʒenuːm,ʒenom
سرفه گرفتن	soɾfeɡeɾeftæn
موزامبیک	muːzɒːmbiːk
پذیرایی	pæziːɾɒːjiː
کناره گیری کردن	kenɒːɾeɡiːɾiːkæɾdæn
صندلی راحتی‏	sændæliːɾɒːhætiː
عالی	ʔɒːliː
دست دادن	dæstdɒːdæn
اعتنا	eʔtenɒː
کاپوت	kɒːpuːt
سنگاپور	senɡɒːpuːɾ
نوکر	nouːkæɾ
حقه زدن	hoɢɢezædæn
نم کردن	næmkæɾdæn
آسیب‌شناسی	ɒːsiːbʃenɒːsiː
رویارویی	ɾuːjɒːɾuːʔiː
میانه	miːjɒːne
آذر	ɒːzæɾ
حساب کردن	hesɒːbkæɾdæn
آلت	ɒːlæt
گیلگمش	ɡiːlɡæmeʃ
متن	mætn
شوش	ʃuːʃ
آلمان شرقی	ɒːlemɒːnʃæɾɢiː
ادا	ædɒː
بادنگان	bɒːdenɡɒːn
علامت مساوی	ʔælɒːmætemosɒːviː
کول گرفتن	kuːlɡeɾeftæn
صوفیا	sofiːjɒː
خواسته بودی	xɒːstebúdiː
عاشق	ʔɒːʃeɢ
الکل	ælkol
ساختن	sɒːxtæn
وسعت دادن	vosʔætdɒːdæn
کف دادن	kæfdɒːdæn
جادار	d͡ʒɒːdɒːɾ
بهترین	behtæɾiːn
نر	næɾ
موت	mouːt
ونگوگ	vænɡôɡ
کانجی	kɒːnd͡ʒiː
پرواز	pæɾvɒːz
بار آوردن	bɒːɾɒːvæɾdæn
مقام	mæɢɒːm
کنعان	kænʔɒːn
ضرب	zæɾb
آخشیج	ɒːxʃiːd͡ʒ
مباهات	mobɒːhɒːt
سنقر	sonɢoɾ
بدلیل	dæliːl
سرکوفت خوردن	sæɾkuːftxoɾdæn
توضیح دادن	tæwziːhdɒːdæn,toʊziːhdɒːdæn
بور	boɾ,buːɾ
نهایتا	næhɒːjætæn
تب کردن	tæbkæɾdæn
عطر زدن	ætɾzædæn
انبار	ænbɒːɾ
نامْور	nɒːmvæɾ
شمار آمدن	ʃomɒːɾɒːmædæn
نام‌آوا	nɒːmɒːvɒː
خواهند	xɒːhænd
فیروزه	fiːɾuːze
دودوئی	dodoiː
نقصان	noɢsɒːn
وعده دادن	væʔdedɒːdæn
سرک	sæɾæk
کشیدن	keʃiːdæn
فلافل	fælɒːfel
به ندرت	benodtɾæt
دو زار	dozɒːɾ
سقلمه زدن	soɢolmezædæn
نایاب	nɒːjɒːb
قیچی زدن	ɢejt͡ʃiːzædæn
لکنت افتادن	loknætoftɒːdæn
شورش‌ها	ʃuːɾeʃhɒː
پشت پا زدن	poʃtepɒːzædæn
شصت	ʃæst
حجاب	hed͡ʒɒːb
عرق	ʔæɾæɢ,æɾæɢ
در حال	dæɾhɒːle
پروتئین	poɾoteiːn
طلا	tælɒː
منبع	mænbæ
چمچه	t͡ʃæmt͡ʃe,t͡ʃomt͡ʃe
لج	læd͡ʒ
ولفرام	volfɾɒːm
ونسان ونگوگ	vænsɒːnvænɡôɡ
خو	xuː
کونا	kuːnɒː
مشتق گرفتن	moʃtæɢɡeɾeftæn
فرومون	feɾuːmuːn
شدت	ʃeddæt
ایزد	iːzæd
پیش	piːʃ
درس دادن	dæɾsdɒːdæn,dæɾsdɒːdæn
انتقاد کردن	enteɢɒːdkæɾdæn
دندانساز	dændɒːnsɒːz
مصاحبه کردن	mosɒːhebekæɾdæn
سعی	sæʔj
کلر	koloɾ
مرا	mæɾɒː
محک زدن	mæhækzædæn
دانشگاه	dɒːneʃɡɒːh
بقال	bæɢɢɒːl
عصر بخیر	æsɾbexejɾ
رحم آمدن	ɾæhmɒːmædæn
جا زدن	d͡ʒɒːzædæn
خردمند	xeɾædmænd
معنی‌شناسی	mæʔniːʃenɒːsiː
کشیش	keʃiːʃ
نوک	nok
زرافه	zæɾɾɒːfe
خرید رفتن	xæɾiːdɾæftæn
آهنگ زدن	ɒːhænɡzædæn
ستون	sotuːn
رشک	ɾæʃk
آزار دادن	ɒːzɒːɾdɒːdæn
همنوع‌خواری	hæmnouːʔxɒːɾiː
ماک	mɒːk
آدام	ɒːdɒːm
پر و بال زدن	pæɾobɒːlzædæn
نماز خواندن	næmɒːzxɒːndæn
متاسفانه	motæʔæssefɒːne
آها	ɒːhɒː
ساز	sɒːz
سرشیر	sæɾʃiːɾ
پستان	pestɒːn
جلا	d͡ʒælɒː
پرووکاتور	pɾovokɒːtoɾ
طوطی	tuːtiː
شرق	ʃæɾɢ
جنوب غربی	d͡ʒonuːbeɢæɾbiː
رمزگذاری	ɾæmzɡozɒːɾiː
صلیب	sæliːb
پردیس	pæɾdiːs
رسانه‌های گروهی	ɾæsɒːnehɒːjeɡoɾuːhiː
اقلیم	eɢliːm
دار کردن	dɒːɾkæɾdæn
عطسه	ætse
ماه	mɒːh
ماندگاری	mɒːndeɡɒːɾiː
تاج	tɒːd͡ʒ
آفتابه	ɒːftɒːbe
نشانه‌گذاری شدن	neʃɒːneɡozɒːɾiːʃodæn
برنز	bɾonz
آشامیدنی	ɒːʃɒːmiːdæniː
پنهان	penhɒːn
يوزپلنگ	juːzpælænɡ
همیستار	hæmiːstɒːɾ
کیش و مات	kiːʃomɒːt
جولان	d͡ʒoʊlɒːn
حجم	hæd͡ʒm
الکلی	ælkoliː
باریم	bɒːɾiːjom
شیرگاه	ʃiːɾɡɒːh
سرزمین	sæɾzæmiːn
غر غر	ɢoɾɢoɾ
دامن خوردن	dɒːmænxoɾdæn
کف دست	kæfedæst
تعمیرکار	tæʔmiːɾkɒːɾ
تلسکوپ	teleskop
هاشور خوردن	hɒːʃuːɾxoɾdæn
لبخند	læbxænd
صدف	sædæf
شهد	ʃæhd
مداد	medɒːd
شنبه	ʃænbe
زبان برمه‌ای	zæbɒːnebeɾmeʔɒːjiː
خاک سپردن	xɒːksepoɾdæn
شاه	ʃɒːh
رحم گرفتن	ɾæhmɡeɾeftæn
زبردستی	zebæɾdæstiː
انفورماتیک	ænfoɾmɒːtiːk
آبتنی	ɒːbtæniː
بگذریم	beɡzæɾiːm
روسپی‌گری	ɾuːspiːɡæɾiː
جواب گرفتن	d͡ʒævɒːbɡeɾeftæn
بارداری	bɒːɾdɒːɾiː
گائیدن	ɡɒːʔiːdæn
جیب زدن	d͡ʒiːbzædæn
وجد آمدن	væd͡ʒdɒːmædæn
دهان	dæhɒːn
اينقدر	iːnɢædɾ
طبیعت	tæbiːjʔæt
بروز	boɾuːz
آوردن	ɒːvæɾdæn,ɒːvoɾdæn
مقیاس ریشتر	meɢjɒːsɾiːʃteɾ
کیسه	kiːse
وطن	vætæn
خیمه	xejme
کرسی	koɾsiː
سال نو	sɒːlnouː
داریم می‌خواهیم	dɒːɾiːmmíxɒːhiːm
جفتک زدن	d͡ʒoftækzædæn
مائوری	mɒːʔoɾiː
ناتاراجا	nɒːtɒːɾɒːd͡ʒɒː
انگشت پا	ænɡoʃtepɒː
مشیمیه	mæʃiːmiːje
بارو	bɒːɾuː
ما	mɒː
کراچی	kæɾɒːt͡ʃiː
موسی	muːsɒː
آشیانه	ɒːʃjɒːne
نویسه	neviːsæ
تک	tæk
زاغ	zɒːɢ
پالائی	pɒːlɒːʔiː
میل کردن	mejlkæɾdæn
اندیشه	ændiːʃe,ændiːŝæ,ændiːŝe
سیلی	siːliː
گوته	ɡote,ɡuːte
سنت	sonnæt
پروتکل اینترنت	pɾotokoleiːnteɾnet
میکائیل	miːkɒːʔiːl
بابا	bɒːbɒː
قبول کردن	ɢæbuːlkæɾdæn,ɢæbuːlkæɾdæn
پرهیز کردن	pæɾhiːzkæɾdæn
ارزن	æɾzæn
خواهنده	xɒːhænde
خواب رفتن	xɒːbɾæftæn
هرچه زودتر	hæɾt͡ʃezuːdtæɾ
توجه کردن	tævæd͡ʒd͡ʒohkæɾdæn
غلت	ɢælt
بلوط	boluːt,bæluːt
شاخاب	ʃɒːxɒːb
قوچ	ɢuːt͡ʃ
مین	miːn
درس خواندن	dæɾsxɒːndæn
زمین خوردن	zæmiːnxoɾdæn
تطبیق	tætbiːɢ
نیرنگباز	nejɾænɡbɒːz
کپی کردن	kæpiːkæɾdæn,kopjkæɾdæn
کودک	kuːdæk
نادانی زدن	nɒːdɒːniːzædæn
چین تایپه	t͡ʃiːntɒːjpe
مؤذن	moʔæzzen
انجيلي	end͡ʒiːliː
نفس نفس	næfæsnæfæs
ستاره‌ی دریایی	setɒːɾejedæɾjɒːjiː
آه	ɒːh
چمباتمه زدن	t͡ʃombɒːtmezædæn
نی	nej
انتقاد شدن	enteɢɒːdʃodæn
هپاتیت	hiːpɒːtiːt
لاکشمی	lɒːkʃmiː
ناسا	nɒːsɒː
مغازه زدن	mæɢɒːzezædæn
هول زدن	hoʊlzædæn
آمیختن	ɒːmiːxtæn
ایستادن	iːstɒːdæn
کثافت زدن	kesɒːfætzædæn
ابرنواختر	æbæɾnouːæxtæɾ
بریتانی	beɾiːtɒːniː
اسلوونیائی	esluːveniːjɒːʔiː
لیس	liːs
عاریت گرفتن	ɒːɾjætɡeɾeftæn
نقلی	næɢliː
مینسک	miːnsk
آواز زدن	ɒːvɒːzzædæn
مالزیایی	mɒːleziːjɒːjiː
رشک ورزیدن	ɾæʃkvæɾziːdæn
بارون	bɒːɾuːn
نظر	næzæɾ
سماق	somɒːɢ
سالم	sɒːlem
زمزمه	zemzeme
بهت	boht
ستاره‌شناس	setɒːɾeʃenɒːs
لوله‌کش	luːlekeʃ
مضراب	mezɾɒːb
نژاد	neʒɒːd
رم	ɾom,ɾæm
یهودستیزی	jæhuːdsetiːziː
تگزاسی	teɡzɒːsiː
چنین	t͡ʃoniːn
کاج	kɒːd͡ʒ
نشان دادن	neʃɒːndædɒːn,neʃɒːndɒːdæn,neʃɒːndɒːdæn
رژیم	ɾeʒiːm
مفتی	moftiː
میدان سرخ	mejdɒːnesoɾx
از دست دادن	æzdæstdɒːdæn
زر	zeɾ,zæɾ
زبان قرقیزی	zæbɒːneɢiːɾɢiːziː
فرمودن	fæɾmuːdæn
سرخک	soɾxæk
خلاف کردن	xælɒːfkæɾdæn
اشغال کردن	eʃɢɒːlkæɾdæn
گاییدنی	ɡɒːjedæniː
قربانی	ɢoɾbɒːniː
هفت	hæft
پسگک	pæsæɡæk
طرف گرفتن	tæɾæfɡeɾeftæn
داس و چکش	dɒːsot͡ʃækoʃ
بد ترکیب	bædtæɾkiːb
سان فرانسیسکو	sɒːnfɾɒːnsiːsko
یکشنبه	jekʃænbe
سبزینه	sebziːne
فضاپیما	fæzɒːpeiːmɒː
تاریخ	tɒːɾîx,tɒːɾiːx
موج	moʊd͡ʒ
دنیا آمدن	donjɒːɒːmædæn
پاناما	pɒːnɒːmɒː
بامبول	bɒːmbuːl
کنایه	kenɒːje
تن	ton,tæn
تقویت نمودن	tæɢviːætnemuːdæn
ایمیل زدن	iːmejlzædæn
عینک زدن	ejnækzædæn
مته	mæte
آفریکانس	ɒːfɾiːkɒːns
فوت	foʊt,fuːt
هستم	hæstæm
پرپر	pæɾpæɾ
باعث	bɒːʔes
جاده زدن	d͡ʒɒːddezædæn
گوشتخوار	ɡuːʃtxɒːɾ
بوداپست	buːdɒːpest
شامل کردن	ʃɒːmelkæɾdæn
نارگیله	nɒːɾɡiːle
تقلا کردن	tæɢællɒːkæɾdæn
آلت تناسلی مرد	ɒːlætetænɒːsoliːjemæɾd
همروزگار	hæmɾuːzeɡɒːɾ
خرمن	xæɾmæn
گیتار	ɡiːtɒːɾ
دروغ	doɾuːɢ
ریشه‌شناسی	ɾiːʃeʃenɒːsiː
بال	bɒːl
موشی	muːʃiː
مستی	mæstiː
بیولوژی	biːoloʒiː
ده	de,dæh
دراییدن	dæɾɒːjiːdæn
چرخیدن	t͡ʃæɾxiːdæn
نقب	næɢb
سارا	sɒːɾɒː
مدور	modævvæɾ
زرد چوبه	zæɾdt͡ʃuːbe
سکس دهنی	seksedæhæniː
عید پاک	ejdepɒːk
موفق باشی	movæffæɢbɒːʃiː
نوک زدن	nokzædæn
سینی	siːniː
خدای پدر	xodɒːjepedæɾ
مقدونی	mæɢduːniː
سوره	suːɾe
روسی	ɾuːsiː
مسین	mesiːn
آلتای	ɒːltɒːj
سماور	sæmɒːvæɾ
ضرر خوردن	zæɾæɾxoɾdæn
زرد معتدل	zæɾdemoʔtædel
مهتاب	mæhtɒːb
گسترش دادن	ɡostæɾeʃdɒːdæn
روش	ɾæveʃ
مفید	mofiːd
روادید	ɾævɒːdiːd
گذشته ی بعید	ɡozæʃtejebæʔiːd
بازسازی	bɒːzsɒːziː
باغی	bɒːɢiː
نم	næm
بیمار شدن	biːmɒːɾʃodæn
هولی	holiː
زئوس	zeuːs
یادگار	jɒːdɡɒːɾ
برف گرفتن	bæɾfɡeɾeftæn
باختریان	bɒːxtæɾiːjɒːn
پنکه	pænke
حک	hæk
استقبال کردن	esteɢbɒːlkæɾdæn
دویدن	dæviːdæn
برداشت	bæɾdɒːʃt
خیز گرفتن	xiːzɡeɾeftæn
روباه	ɾuːbɒːh
التزام	eltezɒːm
جبران شدن	d͡ʒobɾɒːnʃodæn
کتک خوردن	kotækxoɾdæn
هدیه	hedje,hædiːje,hediːje
بالش	bɒːleʃ
جهانی‌سازی	d͡ʒæhɒːniːsɒːziː
پشتیبانی	poʃtiːbɒːniː
تپق	topoɢ
سازش	sɒːzeʃ
گوشه و کنایه	ɡuːʃeokenɒːje
تقویت شدن	tæɢviːætʃodæn
ترکمنستان	toɾkæmænestɒːn
پنجه زدن	pænd͡ʒezædæn
پروستریکا	peɾostɾiːkɒː
برج لندن	boɾd͡ʒelændæn
پیراهن	piːɾɒːhæn
تمبک	tombæk
ظهر	zohɾ
زنگ	zænɡ
بازیچه	bɒːziːt͡ʃe
اختلاط	extelɒːt
شکلات داغ	ʃokolɒːtedɒːɢ
بدست آوردن	bedæstɒːvoɾdæn
نصب کردن	næsbkæɾdæn,næsbkæɾdæn
نخود	noxod
کنستانتینوپول	konstɒːntiːnopol
پوست درخت	puːstedeɾæxt
سیاست	siːjɒːsæt
کشف کردن	kæʃfkæɾdæn,kæʃfkæɾdæn
اورپا	oɾuːpɒː
خطکش	xætkeʃ
گروزنی	ɡɾuːzniː
تسلط	tæsællot
کوره	kuːɾæ
دهم	dæhom
شیپور	ʃejpuːɾ
مات کردن	mɒːtkæɾdæn
باتری	bɒːtɾiː
برفی	bæɾfiː
گوش رسیدن	ɡuːʃɾesiːdæn
رم کردن	ɾæmkæɾdæn
اوج گرفتن	oʊd͡ʒɡeɾeftæn
زبان زدن	zæbɒːnzædæn
بی قراری	biːɢæɾɒːɾiː
وحشت کردن	væhʃætkæɾdæn
پي ريزي	pejɾiːziː
گدایی زدن	ɡedɒːjiːzædæn
زید	zejd
آژان پرووکاتور	ɒːʒɒːnpɾovokɒːtoɾ
شناس	ʃenɒːs
پاراماریبو	pɒːɾɒːmɒːɾiːbuː
معیار	meʔjɒːɾ
قدس	ɢods
برج حوت	boɾd͡ʒehot
ابابیل	æbɒːbiːl
سرداب	sæɾdɒːb
فعالیت	fæʔɒːliːjæt
کاراگاه	kɒːɾɒːɡɒːh
خوش حال	xoʃhɒːll
غاز	ɢɒːz
گير دادن قلاب	ɡiːɾdɒːdæneɢollɒːb
سودان جنوبی	suːdɒːned͡ʒænuːbiː
عقاب طلایی	oɢɒːbetælɒːjiː
درد آمدن	dæɾdɒːmædæn
دزدی کردن	dozdiːkæɾdæn
دخیل	dæxiːl
تاجیکی	tɒːd͡ʒiːkiː
جهیدن	d͡ʒæhiːdæn
زبان خمر	zæbɒːnexæmeɾ
درز گرفتن	dæɾzɡeɾeftæn
