dubhghall	d̪ˠʊwəl
olca	ʌlˠkə
méine	mʲeːnʲə
bpósfadh	bˠoːsˠətʲ
ádh	æː
glanadh	ɡl̪ˠɑn̪ˠəɡ
bogadh	bˠɔɡəvˠ
bod	bˠɔd̪ˠ
chucu	xuːxə
ardscoil	ɑːɾˠd̪ˠsˠkʌl
díomsa	dʲiːmˠsˠə
chuardaigh	xuəɾˠd̪ˠə
dúirt	d̪ˠuːɾʲtʲ
phianfadh	fʲiənˠhuː
ós	ɔːʃ
mhóir	woːɾʲ
chinn	çəiɲ
nbhur	n̪ˠuːɾˠ
tsíle	tʲiːlʲə
cónaigh	koːnˠiː
oraibh	ɞɾˠiː
deirfiúr	dʲɛɾʲəfʲaɾˠ
olc	ʌlˠk
chead	çad̪ˠ
gceann	ɟaun̪ˠ
cac	kɑk
spád	sˠpˠɑːd̪ˠ
claíomh	klˠiːvˠ
borb	bˠaɾˠəbˠ
scairt	sˠkaɾˠtʲ
abhras	əuɾˠəsˠ
áille	æːl̠ʲə
imithe	ɪmʲɪhɪ
galar	ɡɔlˠəɾˠ
caithfidh	kaɪhə
dhíobh	ɣiːbˠ
dall	d̪ˠɑːl̪ˠ
mise	mʲɪʃə
mhóir	wɔːɾʲ
mís	mʲiːʃ
fonn	fˠʌn̪ˠ
fuadh	fˠuəɡ
buail	bˠɔlʲ
easpag	æsˠpˠoːɡ
spreagadh	sˠpʲɾʲaɡuː
clathacha	kl̪ˠɑhəxə
seanscéal	ʃan̪ˠʃcial̪ˠ
maol	mˠiːlˠ
céim	ceːmʲ
d'fhill	dʲɪl̠ʲ
clocha	kl̪ˠɔxə
libhse	lʲɪvʲʃə
comhlacht	kɔːlˠaht̪ˠ
oileánach	ɛlʲænˠah
ceird	cəiɾˠdʲ
breab	bʲɾʲabˠ
tosaigh	t̪ˠɔsˠɪɟ
cille	cɪl̠ʲə
crochta	kɾˠʌxt̪ˠə
oscar	ʌsˠkəɾˠ
aimsir	amʲʃəɾʲ
feistigh	fʲɛʃtʲi
cnoc	kn̪ˠʊk
magadh	mˠaɡuː
aerga	eːɾˠɡə
chnoc	xɾˠɔk
soitheach	sˠəhax
agad	aɡəd̪ˠ
gcasadh	ɡasˠəx
múr	mˠuːɾˠ
daichead	d̪ˠahəd̪ˠ
maise	mˠaʃə
thoiligh	hʌlʲi
féar	fʲeːɾˠ
stiofán	ʃtʲʊfˠænˠ
déan	dʲɪn
slat	sˠl̪ˠat̪ˠ
ógánach	oːɡɑːnˠəx
beadh	bʲɛw
socraigh	sˠɔkɾˠɪɟ
cadhnra	kəinˠɾˠə
eatarthusan	aːt̪ˠɾˠəbˠsˠənˠ
leic	l̠ɛc
saoile	sˠiːlʲə
cosán	kəsˠɑːn̪ˠ
phálás	fˠɑːlˠɑːsˠ
fúm	fˠuːmˠ
iarsmalann	iəɾˠsˠmˠəlˠən̪ˠ
bromach	bˠɾˠəmˠɑx
bú	bˠuː
bacach	bˠakəx
tosaí	t̪ˠəsˠiː
fheiceanna	ɛcən̪ˠə
áisiúil	aːʃuːlʲ
fiodh	fʲɪ
lím	l̠ʲiːmʲ
troigh	t̪ˠɾˠɔ
tuilleadh	t̪ˠɪlʲə
arc	aɾˠk
caor	kiːɾˠ
feiliúint	fʲɪlʲuːnʲtʲ
sheaicéad	hæːceːd̪ˠ
cuimhnigh	kiːnʲɪɟ
altadh	al̪ˠt̪ˠə
seám	ʃaːmˠ
saoradh	sˠeːɾˠəɡ
aire	æɾʲə
ceathrú	cæɾˠuː
dara	d̪ˠaɾˠə
gcurach	ɡʊɾˠəx
téanam	tʲeːnˠəmˠ
cloigeann	klˠɛɟən̪ˠ
bogadh	bˠɔɡəx
acusan	akəpˠsˠənˠ
bealtaine	bʲal̪ˠt̪ˠənʲə
ghall	ɣɑːl̪ˠ
ghrian	jɾʲiənˠ
anglaise	aŋɡləʃə
liosta	l̠ʲɪsˠt̪ˠə
fiche	fʲiː
tuilleadh	t̪ˠɪl̠ʲə
iascach	iəskəx
cinn	ciːn̠ʲ
deargadh	dʲaɾˠəɡə
ceil	cɛlʲ
d'fhonn	d̪ˠʌn̪ˠ
glac	ɡlˠɑk
chéibh	çeːvʲ
clann	kl̪ˠaun̪ˠ
coileach	kɛlʲax
béic	bʲeːc
clogaid	klˠʌɡədʲ
ghobadh	ɣɔbˠu
píoba	pʲiːbˠə
leanbh	l̠ʲanˠəwˠ
cailleadh	kal̠ʲətʲ
adhlaic	əil̪ˠəc
uaighe	uəj
cuimhnigh	kiːmʲɾʲə
treabh	tʲɾʲau̯
taispeáin	spˠɑːnʲ
amanna	amˠən̪ˠə
fortacht	fˠʌɾˠt̪aht̪ˠ
sara	sˠaɾˠə
caoimhe	kiː
mbeas	mʲɛsˠ
ceacht	cæxt̪ˠ
barr	bˠɑːɾˠ
har	haɾˠ
punta	pˠʊn̪ˠt̪ˠə
acht	ax
torc	t̪ˠɔɾˠk
duaidh	d̪ˠuəɟ
bog	bˠɔɡ
chuirfeadh	xɪɾˠhəx
aonghuthach	eːn̪ˠɣʊhah
earra	aɾˠə
éide	eːdʲə
gcuireadh	ɡɪɾʲətʲ
táille	t̪ˠæːl̠ʲə
próifíl	pˠɾˠɔːfʲilʲ
fáilte	fˠɑːlʲtʲə
iontach	iːn̪ˠt̪ˠəx
gearradh	ɟaɾˠu
amach	əmˠax
gcóstaí	ɡoːsˠt̪ˠiː
troigh	t̪ˠɾˠiː
'ur	ə
bhuail	vˠuəlʲ
námhaid	n̪ˠæːwədʲ
teachtaire	tʲaxt̪ˠəɾʲə
blás	blɔːs
culaith	kl̪ˠɞh
asainne	aːsˠt̪ˠən̠ʲə
aimsir	æːmʲʃəɾʲ
artaire	aɾˠt̪ˠəɾʲə
suíonn	sˠiːn̪ˠ
buntáiste	bˠʊn̪ˠt̪ˠɑːʃtʲə
chás	xæːsˠ
dtorann	d̪ˠɔɾˠən̪ˠ
páirtí	pˠæːɾˠtʲi
ál	ɑːlˠ
oilim	ɪlʲəmʲ
bara	bˠaɾˠə
amhras	ə̃ũɾˠəsˠ
mhúchadh	wuːxuː
léi	lʲeːi
cinnigí	cɪn̠ɪɟiː
mhúchadh	wuːxətʲ
míol	mʲiːlˠ
múchadh	mˠuːxu
cearc	kæːɾˠk
séan	ʃeːnˠ
roghanna	ɾˠoun̪ˠə
cú	kuː
ithe	ɪhə
itear	ɪtʲəɾˠ
adhairce	əiəɾʲcɪ
aga	aɡə
tráth	t̪ˠɾˠɑː
as	æsˠ
chuige	ɛɟɪ
fleá	fʲlʲæː
cíor	ciːɾˠ
dul	d̪ˠʊlˠ
poll	pˠəul̪ˠ
faoin	fˠiːnʲ
blais	bˠlˠaʃ
uaine	wɛnʲə
tiománaí	tʲʊmˠɑːnˠiː
log	l̪ˠʌɡ
ógh	oːɣ
breatnach	bʲɾʲən̪ˠax
fón	fˠoːnˠ
meánn	mʲæːn̪ˠ
cogain	kɔɡənʲ
cúthail	kuːhəlʲ
leon	lʲoːn̪ˠ
rúin	ɾˠuːnʲ
sásair	sˠæːsˠəɾʲ
saothraigh	sˠiːɾˠə
éasca	eːsˠkə
cam	kɑːmˠ
díol	dʲiəl̪ˠ
iodáil	ɪd̪ˠælʲ
anamnacha	ɑnəmˠnɑxə
gcnuic	ɡnˠɪc
máirín	mˠɑːɾʲiːnʲ
eithne	ɛnʲə
ruda	ɾˠʊd̪ˠə
tóireacha	t̪ˠoːɾʲəxə
fheadha	ɑː
aontaigh	iːn̪ˠt̪ˠiː
airleacan	ɑːɾˠl̠ʲəkənˠ
oileann	ɛlʲən̪ˠ
fén	fʲeːn̪ˠ
scanraigh	sˠkæːn̪ˠɾˠi
náire	n̪ˠɑːɾʲə
oideachas	ɛdʲəxəsˠ
oidhreacht	əiɾʲiəxt̪ˠ
amhrasach	ɑnvɾˠəsˠəx
deartháir	dʲɾʲiçaːɾʲ
bheo	vʲɔː
b'	bˠ
droichead	d̪ˠɾˠeːd̪ˠ
tinn	tʲɪn̠ʲ
cogadh	kɔɡəx
chasta	xɑsˠt̪ˠə
lúcháir	l̪ˠɛvˠɑːɾʲ
casadh	kasˠu
meacain	mʲakənʲ
cré	cɾʲeː
míre	mʲiːɾʲə
chuirfeadh	xɪɾˠhu
contae	kuːndeː
fliuchadh	fʲlʲɔxəəx
róid	ɾˠɔːdʲ
sinne	ʃɪn̠ʲə
gearradh	ɟaɾˠətʲ
churaigh	xɔɾˠə
lasadh	l̪ˠasuː
magadh	mˠaɡə
bhris	vʲɾʲɪʃ
altadh	al̪ˠt̪ˠu
bhrisfeadh	vʲɾʲɪʃətʲ
dúiseacht	d̪ˠuːʃaht̪ˠ
áil	ɑːlʲ
brónach	bˠɾˠoːnˠəx
nua	n̪ˠuː
uafás	uːɑːsˠ
cuid	kɪdʲ
fheiceadh	ɛcu
ósta	ɔːsˠt̪ˠə
reiligiún	ɾˠɛlʲɪɟuːnˠ
bróin	bˠɾˠoːnʲ
fós	fˠoːsˠ
fhómhar	uːwəɾˠ
eolais	ɔːlˠəʃ
blagaid	bˠlˠaɡədʲ
ramhar	ɾˠəʊɾˠ
conchúr	kʊnˠxuːɾˠ
farraige	fˠaɾˠɪɟɪ
díbríodh	dʲiːbʲɾʲiːvˠ
cloch	klˠɔx
múchadh	mˠuːxuː
fairsing	fˠɑɾˠʃənʲ
tiorma	tʲɾʲʊmə
coitianta	kʌtʲən̪ˠt̪ˠə
pianadh	pʲiənˠəvˠ
coinníoll	kɪnʲiːl̪ˠ
cáisc	kɑːʃc
sámh	sˠæːw
urraim	ɪɾʲəmʲ
uinge	ɪɲɟɪ
cainteoir	kan̠ʲtʲoːɾʲ
falamh	fˠal̪ˠə
strainséir	sˠt̪ˠɾˠan̠ʲʃaɾʲ
lán	l̪ˠɑːnˠ
uainín	uənʲiːnʲ
d'oileadh	d̪ˠɪlʲu
maith	mˠah
éanacha	eːn̪ˠəxiː
sasana	sˠasˠənˠə
críochnaigh	cɾʲiːxn̪ˠi
banríon	bˠanˠɾˠiːnˠ
sáigh	sˠɑː
tráta	t̪ˠɾˠæːt̪ˠə
aindriú	anʲɾʲuː
iarthar	iəɾˠhəɾˠ
cinneadh	cɪn̠ʲəvˠ
thabharfadh	hoːɾˠəx
seans	ʃan̪ˠsˠ
pící	pʲiːciː
srón	sˠɾˠoːnˠ
bacaí	bˠakiː
cúinge	kuːɲɪ
teann	tʲan̪ˠ
bogadh	bˠɔɡətʲ
fhómhair	uːwəɾʲ
iaguar	iəɡuəɾˠ
san	sˠənʲ
leite	l̠ʲɛtʲə
cóstaí	koːsˠt̪ˠiː
camall	kamˠəl̪ˠ
gcuireadh	ɡɪɾʲu
lag	l̪ˠɑɡ
oibrí	əibʲɾʲiː
cairde	kɑːɾˠdʲə
ngeall	ɲal̪ˠ
gealbhan	ɟalˠəwənˠ
trealamh	tʲɾʲalˠu
baiste	bˠaʃtʲə
uirrim	ɪɾʲəmʲ
canadh	kɑn̪ˠə
fógra	fˠoːɡɾˠə
bradach	bˠɾˠɑd̪ˠəx
ceachtar	caxt̪ˠəɾˠ
fírinneach	fʲiːɾʲən̠ʲah
damh	d̪ˠaw
imreoir	ɪmʲɾʲoːɾʲ
iaguair	iəɡuəɾʲ
garraí	ɡaɾˠi
tosú	t̪ˠʌsˠu
agam	əɡɑmˠ
caill	kal̠ʲ
taoschnó	t̪ˠiːsˠxɾˠoː
síochán	ʃiːxɑːn̪ˠ
b'éigean	bʲeːɟənˠ
aisteoir	aʃtʲoːɾʲ
gníomh	ɟɾʲiːəw
dragan	d̪ˠɾˠaɡənˠ
saoradh	sˠiːɾˠə
íoc	iːk
dhubh	ɣʊw
inse	ɪnʲʃə
bratach	bˠɾˠat̪ˠah
focail	fˠɔkəlʲ
cabhrach	kəuɾˠəx
im	iːmʲ
cána	kɑːnˠə
muinín	mˠɪnʲiːnʲ
gréasáin	ɟɾeːsˠænʲ
pléigh	pʲlʲeːɟ
céadta	ceːt̪ˠə
síleachtáil	ʃiːlʲəxt̪ˠɑːlʲ
tithe	tʲɪhɪ
aontaigh	iːn̪ˠt̪ˠə
tinte	tʲɪn̠ʲtʲə
réitigh	ɾˠeːtʲɪɟ
peann	pʲan̪ˠ
míreanna	mʲiːɾʲən̪ˠə
bardasach	bˠɑːɾˠd̪ˠəsˠəx
gobadh	ɡɔbˠuː
dócha	d̪ˠɔːxə
gruama	ɡɾˠuəmˠə
gréas	ɟɾiasˠ
chuadhadh	xuəw
crochadh	kɾˠʌxu
bacacha	bˠəkɑxə
faol	fˠeːlˠ
chugam	hʊɡəmˠ
stoca	sˠt̪ˠʌkə
oiltear	ɪlʲtʲəɾˠ
ó	oː
ceapadh	capˠəɡ
asaibhse	asˠiʃə
daonchairdiúil	d̪iːn̪xɑːɾˠdʲuːlʲ
meacain	mʲakanʲ
cáis	kæːʃ
fuinneog	fˠɪn̠ʲoːɡ
casadh	kasˠəvˠ
cailleadh	kɑːl̠ʲəvˠ
athraigh	aːɾˠə
fágann	fˠɑːɡən̪ˠ
tarta	t̪ˠaɾˠt̪ˠə
déanamh	dʲɪn̪ˠə
tigh	tʲɪɟ
na	nˠə
phóca	pˠoːkə
truaí	t̪ˠɾˠuəj
aithreachas	ahəɾʲəxəsˠ
bródúil	bˠɾˠɔːd̪ˠulʲ
tsagart	t̪ˠæɡəɾˠt̪ˠ
náisiún	n̪ˠɑːʃuːnˠ
léi	lʲeːhə
dall	d̪ˠɑl̪ˠ
sleamhnaigh	ʃlʲəunˠiː
bail	bˠalʲ
aoire	eːɾʲɪ
leon	l̠ʲɔːnˠ
pasfhocal	pˠasˠɔkəlˠ
horlaí	həuɾˠl̪ˠiː
canúnach	kanˠunˠah
croí	kɾˠiː
bhur	mˠəɾˠ
leathuair	l̠ʲæuəɾʲ
oifigiúil	ɛfʲɪɟuːlʲ
máistreás	mˠɑːʃtʲɾʲɑːsˠ
garraí	ɡaɾˠiː
iompar	ʊmˠpˠəɾˠ
theas	hasˠ
céadaoin	ceːd̪ˠiːnʲ
scian	ʃciənˠ
lettáeb	l͈ʲetaːi̯v
breabadh	bʲɾʲabˠuː
pógadh	pˠɔːɡətʲ
clainne	kl̪ˠanʲə
acu	aku
dár	d̪ˠɑːɾˠ
dráma	d̪ˠɾˠɑːmˠə
ainneoin	an̠ʲoːnʲ
farc	fˠaɾˠk
pianadh	pʲiənˠu
aiféala	afʲeːlˠ
cos	kɔsˠ
smior	sˠmʲɪɾ
cás	kæːsˠ
ré	rˠeː
sceideal	ʃcɛdʲəlˠ
folláin	fˠal̪ˠæːnʲ
fágadh	fˠɑːɡuː
chuiris	xɪɾʲəʃ
móire	moːɾʲə
ruainne	ɾˠuːn̠ʲə
sop	sˠɔpˠ
siad	ʃiəd̪ˠ
d'oileadh	d̪ˠɛlʲu
phósfadh	fˠɔːsˠətʲ
clú	klˠuː
dhul	ɣʊlˠ
ardghlórach	ɑːɾˠd̪ˠɣl̪ˠoːɾˠəx
bheifeá	vʲɛɑː
dabhach	d̪ˠəuwi
seanchas	ʃanəxəsˠk
ann	ɑːn̪ˠ
muide	mˠɪdʲə
seol	ʃoːl
iodáilis	ɪdˠaːlʲɪʃ
amhras	avˠɾˠəsˠ
bacaigh	bˠakiː
dtóireacha	d̪ˠoːɾʲəxə
domhnall	d̪ˠuːnˠəl̪ˠ
bromach	bˠɾˠɔmˠəx
romhatsa	ɾˠuːt̪ˠsˠə
dtiocfá	dʲʊkfˠɑː
móra	mˠɔːɾˠə
faitíos	fˠatʲisˠ
abrán	ɑbˠəɾˠɑːn̪ˠ
deirfiúracha	dʲeɾʲəfʲəɾˠəxə
plump	pˠl̪ˠʊmˠpˠ
ainbhios	ænəʃ
caomh	kiːvˠ
cearnóg	caːɾˠn̪ˠoːɡ
niamh	n̠ʲiːvˠ
grua	ɡɾˠuə
pusa	pˠʊsˠə
air	aɾʲ
páras	pˠɑːɾˠəsˠ
chuardaigh	xuəɾˠd̪ˠiː
buíoch	bˠeːx
leithead	l̠ʲɛhəd̪ˠ
fiacha	fʲiəxə
meacan	mʲakanˠ
grámhar	ɡɾˠɑːvˠəɾˠ
múchadh	mˠuːxəɡ
póca	pˠoːkə
pheacaí	fʲakiː
freastal	fʲɾʲasˠt̪ˠəlˠ
briseadh	bʲɾʲɪʃəɡ
bríste	bʲɾʲiːʃtʲə
ceannaigh	can̪ˠə
bhuí	vˠiː
mbas	mˠasˠ
rang	ɾˠaŋ
bearradh	bʲɑːɾˠəvˠ
ligh	l̠ʲiː
foide	fˠɛdʲə
muiris	mˠɪɾʲəʃ
mhéid	vʲeːdʲ
teannta	tʲəun̪ˠt̪ˠə
altfaidh	al̪ˠt̪ˠəɟ
á	ɑː
beich	bʲɛç
báire	bˠɑːɾʲə
díbríodh	dʲiːbʲɾʲiːw
chasadh	xasˠu
gan	ɡan̪ˠ
laoch	l̪ˠiːx
tamall	t̪ˠamˠəl̪ˠ
mbard	mˠæːɾˠd̪ˠ
chruinne	xɾˠɪn̠ʲə
lios	l̠ʲʊsˠ
lampa	l̪ˠamˠpˠə
altadh	al̪ˠt̪ˠətʲ
ráth	ɾˠɑː
fliuchadh	fʲlʲɔxəvˠ
beid	bʲɛdʲ
múinte	mˠuːn̠ʲtʲə
buíoch	bˠiːx
neamh	n̠ʲaw
dhíobh	jiːbˠ
fuiriste	fʲɾʲɪʃtʲə
iarraidh	iəɾˠə
fheadha	æː
créacht	cɾʲeːxt̪ˠ
ghníomhaíocht	ɣɾˠiːwiaht̪ˠ
robé	robʲeː
aimhleas	avl̠ʲas
cónra	kuːɾˠhə
éalaigh	eːlˠiː
mbriseadh	mʲɾʲɪʃətʲ
árainn	ɑːɾˠən̠ʲ
dreoigh	dʲɾʲoːj
bunúsach	bən̪ˠuːsˠəx
maide	mˠadʲə
mól	mˠoːlˠ
hata	hat̪ˠə
sinn	ʃɪnʲ
fichid	fʲiːdʲ
imleacán	imʲlʲəkɑːn̪ˠ
diana	dʲiənˠə
deireadh	dʲɛɾʲuː
pógadh	pˠoːɡuː
orainne	ɔɾˠən̠ʲə
fírinne	fʲiːɾʲənʲə
d'fhágadh	d̪ˠæːɡətʲ
adharca	əiəɾˠkə
ríomhleabhar	ɾʲiːvˠlʲəuɾˠ
acusan	əkusˠənˠ
nóin	n̪ˠɔːnʲ
lucharachán	l̪ˠʊxəɾˠəxɑːnˠ
teastaigh	t̪ˠasˠt̪ˠə
veigeatóir	vʲɛɟɪt̪ˠɔrʲ
riarann	ɾˠiəɾˠən̪ˠ
chruit	xɾˠɪtʲ
cláracha	kl̪ˠɑɾˠəxiː
chasadh	xasˠuː
bréan	bʲɾʲeːnˠ
gasóg	ɡasˠɔɡ
seanmóir	ʃanˠəmoːɾʲ
breabadh	bʲɾʲabˠəvˠ
easpag	ɑsˠpˠək
cinneadh	cɪɲəx
cairdeas	kɑːɾˠdʲəsˠ
gealach	ɟalˠəx
peann	pʲaun̪ˠ
bheo	vʲoː
taibhse	t̪ˠavʲʃə
cailleadh	kal̠ʲu
dona	d̪ˠɔnˠə
bunábhar	bˠʊnˠɑːwəɾˠ
mhí	vʲiː
mbíonns	mʲiːn̪ˠsˠ
ullmhaigh	ʊl̪ˠwə
cata	kɑt̪ˠə
braon	bˠɾˠeːn̪ˠ
sláinte	sˠl̪ˠɑːn̠ʲtʲə
rúnda	ɾˠuːn̪ˠd̪ˠə
chósta	xoːsˠt̪ˠə
trasinscneach	t̪ˠɾˠasˠɪn̠ʲʃcnʲəx
fraincis	fˠɾˠæɲcɪʃ
gobadh	ɡʌbˠu
athrú	aːɾˠuː
cearnóige	cæːɾˠn̪ˠɔɟə
cuardaigh	kuəɾˠd̪ˠiː
traochta	t̪ˠɾˠeːxt̪ˠə
pianfaidh	pʲiənhɪɟ
gránach	ɡɾˠɑːnˠəx
dtuigeann	d̪ˠɪɟən̪ˠ
iompair	ʊmˠpˠəɾʲ
thiománach	hɪmˠænah
bhfeirm	vʲɛɾʲəmʲ
ab	əbˠ
gortaigh	ɡɔɾˠt̪ˠə
salú	sˠal̪ˠu
miste	mʲɪʃtʲə
timpiste	tʲiːmˠpˠəʃtʲə
mhaithe	vˠahə
ceannann	can̪ˠən̪ˠ
deoch	dʲɔx
uait	wætʲ
scaradh	sˠkaɾˠə
aeróstach	eːɾˠoːsˠt̪ˠəx
oileadh	ɛlʲu
feirm	fʲɛɾʲəmʲ
bhain	wɪnʲ
phósadh	fˠɔːsˠu
caoi	kiː
pinc	pʲɪɲc
sinsear	ʃiːn̠ʲsʲəɾˠ
nae	n̪ˠeː
gabh	ɡoː
shagart	haɡəɾˠt̪ˠ
breo	bʲɾʲɔː
réitigh	ɾˠeːtʲiː
cnagaire	knˠaɡəɾʲə
lile	l̠ʲɪlʲə
bradach	bˠɾˠad̪ˠəx
gcaoi	ɡiː
bradán	bˠɾˠəd̪ˠaːn̪ˠ
tacht	t̪ˠɑxt̪ˠ
cuil	kɪlʲ
fheadh	æː
bun	bˠʊnˠ
úinéara	uːnʲeːɾˠə
polainn	pˠɔl̪ˠɪɲ
cóta	kɔːt̪ˠə
chomh	xʊ
athraigh	ɑɾˠə
seamhan	ʃəunˠ
í	iː
fuisce	fˠɪʃcɪ
altadh	al̪ˠt̪ˠəɡ
fionnghuala	fʲɪn̪ˠuːəlˠə
chnáimh	xɾˠɑːvʲ
naoscann	n̪ˠeːsˠkən̪ˠ
dtaisce	d̪ˠaʃcɪ
scrúdaigh	sˠkɾˠuːd̪ˠi
uaigneach	uəɟnʲəx
mhéad	vʲeːd̪ˠ
oifig	ɛfʲɪc
oilfidh	ɛlʲhə
peile	pʲɛlʲə
torainn	t̪ˠɔɾˠɪɲ
clár	klˠæːɾˠ
máistreása	mˠæːʃtʲɾʲæsˠə
oileadh	ɪlʲətʲ
muintir	mˠɪn̠ʲtʲəɾʲ
cánacha	kæːnˠahə
saoire	sˠiːɾʲə
fágfaidh	fˠɑːkiː
saoradh	sˠiːɾˠətʲ
cloth	klˠɔh
gránaigh	ɡɾˠɑːnˠiː
phiocadh	fʲʊkuː
coisric	kɛʃɾʲɪc
d'oileadh	d̪ˠɛlʲətʲ
fiaradh	fʲiəɾˠuː
d'fhiafraigh	dʲiəɾˠə
athraím	ɑɾˠiːmʲ
bhéarfadh	vʲeːɾˠəx
mhá	vˠɑː
déanamh	dʲiːn̪ˠə
rialtas	ɾˠiəl̪ˠt̪ˠəsˠ
lann	l̪ˠaun̪ˠ
thugadh	hʊɡuː
tige	tʲɪɟɪ
saothar	sˠiːhəɾˠ
gealt	ɟal̪ˠt̪ˠ
cúis	kuːʃ
can	kanˠ
suas	sˠuəsˠ
tarlaigh	t̪ˠɑːɾˠl̪ˠə
féil	fʲeːlʲ
trátha	t̪ˠɾˠɑːhə
ghob	ɣɔbˠ
peadar	pʲad̪ˠəɾˠ
císte	ciːʃtʲə
ríomhleabhar	ɾʲiːwlʲoːɾˠ
clann	kl̪ˠan̪ˠ
comh	kɔ
soir	sˠɛɾʲ
cruinniú	kɾˠɪn̠ʲuː
loim	l̪ˠiːmʲ
mbíos	mʲiːsˠ
molfaidh	mʌlhə
atá	at̪ˠæ
arú	aɾˠuː
súil	sˠuːl
cótaí	kɔːt̪ˠi
streabhóg	ʃtʲɾʲəuɔɡ
cosa	kɔsˠə
tiomáin	tʲəmˠɑːnʲ
amanna	amˠən̪ˠiː
ngobadh	ɡʌbˠu
gcasadh	ɡasˠu
glúin	ɡlˠuːnʲ
scanrú	sˠkaun̪ˠɾˠuː
dhó	ɣoː
mháistreása	vˠɑːʃtʲɾʲɑːsˠə
fheis	ɛʃ
mallacht	mˠal̪ˠaxt̪ˠ
iodáil	ɪd̪ˠɑːlʲ
ort	ɔɾˠt̪ˠ
clár	klˠɑːɾˠ
ríomh	ɾˠiːvˠ
freagair	fʲɾʲaɡəɾʲ
bruth	bˠɾˠʊh
dílse	dʲiːl̠ʲʃə
sliabh	ʃlʲiəvˠ
milis	mʲɪlʲəʃ
naoscann	n̪ˠɯːsˠkən̪ˠ
buntáiste	bˠən̪ˠt̪ˠɑːʃtʲə
súile	sˠuːlʲə
fómhar	fˠõːɾˠ
bardasach	bˠæːɾˠd̪ˠəsˠah
snas	sˠn̪ˠasˠ
phléisiúr	fʲlʲeːʃuːɾˠ
cóirigh	koːɾʲə
amuigh	əmˠʊ
pobail	pˠɔbˠəlʲ
ceintiméadar	cɛn̠ʲtʲəmʲed̪ˠəɾˠ
dorchacht	d̪ˠɔɾˠəxəxt̪ˠ
aisti	aʃtʲə
lóistín	l̪ˠoːʃtʲiːnʲ
gcathaoir	ɡɑhiːrʲ
coróin	kɔɾˠuːnʲ
bhrisfeadh	vʲɾʲɪʃəx
veigeán	vʲɛɟaːn̪ˠ
coll	kal̪ˠ
bearradh	bʲaɾˠətʲ
bris	bʲɾʲɪʃ
blarnan	bˠlˠɑːɾˠn̪ˠənˠ
sea	ʃa
bearradh	bʲaɾˠəvˠ
saile	salʲə
leithid	l̠ʲɛhədʲ
comrádaí	kʊmˠɾˠɑːd̪ˠiː
droim	d̪ˠɾˠiːmʲ
gnóthaigh	ɡɾˠuː
feola	fʲoːlˠə
magairle	mˠaɡəɾˠl̠ʲə
soip	sˠɪpʲ
haithne	hænə
pháras	fˠɑːɾˠəsˠ
athar	æhəɾˠ
adhmad	ɑːmˠəd̪ˠ
bhfiaradh	vʲiəɾˠə
meon	mʲuːn̪ˠ
naoi	n̪ˠiː
fhada	ad̪ˠə
lasadh	l̪ˠasˠəvˠ
bocht	bˠɔxt̪ˠ
scairteadh	sˠkaɾˠtʲuː
aonghas	eːŋɣəsˠ
shíníomar	hiːnʲimˠəɾˠ
chomh	xə
rinc	ɾˠɪɲc
caoimhín	kiːvʲinʲ
cósta	kɔːsˠt̪ˠə
bís	bʲiːʃ
réidh	ɾˠeːɟ
damáiste	d̪ˠəmˠɑːʃtʲə
tréithe	tʲɾʲeːhə
mhúchadh	vˠuːxəx
timpeall	tʲiːmˠpˠəl̪ˠ
critic	cɾʲɪtʲɪc
oileadh	ɛlʲətʲ
fheicfeadh	ɛcu
pósadh	pˠoːsˠəɡ
bliosán	bʲlʲɪsˠænˠ
d'altfadh	d̪ˠal̪ˠt̪ˠuː
bhfiaradh	vʲiəɾˠu
mhuire	vˠɪɾʲə
bharúil	vˠɑɾˠuːlʲ
éalaigh	ial̪ˠɪɟ
tlú	t̪ˠlˠuː
leapacha	l̠ʲæpˠəxiː
croch	kɾˠɔx
céide	ceːdʲə
naofa	n̪ˠiːfˠə
aithníodh	ænʲiːtʲ
scaití	sˠkatʲiː
cailleadh	kal̠ʲəvˠ
caith	kɑh
cónaí	koːn̪ˠiː
shagart	hæɡəɾˠt̪ˠ
catán	kat̪ˠænˠ
dhínn	ɣiːn̠ʲ
mianach	mʲiən̪ˠəx
raidió	ɾˠadʲiɔ
ngránaigh	ŋɾˠɑːnˠə
faca	fˠakə
ainm	ænʲəmʲ
crúb	kɾˠuːbˠ
lasrach	l̪ˠasˠɾˠəx
cait	kɪtʲ
faoina	fˠiːnˠə
tachtadh	t̪ˠɑxt̪ˠəx
dhom	ʊmˠ
critice	cɾʲɪtʲɪcɪ
gréasáin	ɟɾeːsˠɑːnʲ
dhíom	iːmˠ
bunscoil	bˠʊnˠsˠkɛlʲ
ocht	ɔxt̪ˠ
leoraís	lʲɔɾˠiːsˠ
éan	eːnˠ
canadh	kanˠu
codanna	kɔd̪ˠən̪ˠə
tógálaí	t̪ˠoːɡaːlˠiː
mur	mˠəɾˠ
tuirseach	t̪ˠɤɾˠʃah
tamall	t̪ˠɑmˠəl̪ˠ
nimh	nʲɪvʲ
chuireadh	xɪɾʲuː
carcair	kaɾˠkəɾʲ
ngobadh	ŋɔbˠə
meidhbhín	mʲəivʲiːnʲ
púdar	pˠuːd̪ˠəɾˠ
rud	ɾˠʊd̪ˠ
fúthu	fˠuːbˠ
ad	əd̪ˠ
lasracha	l̪ˠasˠəɾˠəxə
bodhrán	bˠoːɾˠæn̪ˠ
anáil	ənɑːl
pógadh	pˠoːɡəx
ró	ɾˠɔː
phléisiúr	fʲlʲeːʃuɾˠ
fiaradh	fʲiəɾˠəx
litear	l̠ʲɪtʲəɾˠ
salm	sˠɑl̪ˠəmˠ
dtorann	d̪ˠʌɾˠən̪ˠ
múnadh	mˠuːn̪ˠətʲ
máirt	mˠaːɾˠtʲ
éalaigh	eːlˠə
gcaptaen	ɡɑpˠt̪ˠeːn̪ˠ
bpáipéar	bˠaːpʲeːɾˠ
cnáib	knˠɑːbʲ
scaradh	sˠkɑɾˠəx
déantar	dʲɪn̪ˠt̪ˠəɾˠ
ochtar	ʌxt̪ˠəɾˠ
snáth	sˠn̪ˠæː
socraigh	sˠɔkɾˠiː
céanna	ceːn̪ˠə
chomh	xu
eisceacht	ɛʃcaht̪ˠ
gealach	ɟæl̪ˠəx
gcapall	ɡapˠəl̪ˠ
bál	bˠæːlˠ
hais	haʃ
iontráil	ɪn̪ˠt̪ˠɾˠælʲ
breaca	bʲɾʲakə
annamh	an̪ˠuː
dheacair	jækəɾʲ
tiarna	tʲiəɾˠn̪ˠə
triomach	tʲɾʲʊməx
teocht	tʲoːxt̪ˠ
cheann	çaun̪ˠ
maíomh	mˠiːvˠ
amhlaidh	ɑwl̪ˠə
feiceadh	fʲɛcu
torcán	̪tˠəɾˠkɑːn̪ˠ
breoiteacht	bʲɾʲoːtʲəxt̪ˠ
nollag	n̪ˠʌl̪ˠək
beoir	bʲoːɾʲ
treascair	tʲrʲaskaɾʲ
casadh	kɑsˠəx
uí	iː
miadh	mʲiə
óm	oːmˠ
fhreastalaíodh	ɾʲasˠt̪ˠəlˠiːx
dubh	d̪ˠʊfˠ
d'fhonn	d̪ˠuːn̪ˠ
bruíon	bˠɾˠiːnˠ
moladh	mˠɔlˠəx
holc	hʌlˠk
fírinneach	fʲiːɾʲɪɲəx
ciotach	cɪt̪ˠəx
lasadh	l̪ˠasˠə
abar	abˠəɾˠ
ba	bˠɑh
pictiúr	pʲɪctʲuɾˠ
atuirseach	at̪ˠʊɾˠʃəx
gine	ɟɪnʲə
acadamh	akəd̪ˠuː
cneas	cɾʲasˠ
múch	mˠuːx
leathan	l̠ʲahanˠ
cuisliméara	kɪʃlʲəmʲeːɾˠə
conchúr	knˠʊxuːɾˠ
bagún	bˠaɡunˠ
iomlán	ʌmˠlˠænˠ
glanadh	ɡlˠanˠuː
eabar	abˠəɾˠ
deirfiúracha	dʲɾʲehuːɾˠəxə
scar	skaɾˠ
stada	sˠt̪ˠɑd̪ˠə
stábh	sˠt̪ˠɑːvˠ
coisin	kɔʃɪnʲ
dot	d̪ˠɔt̪ˠ
crúigh	kɾˠuːj
coinnigh	kɪn̠ʲə
mbó	moː
ghabhas	ɣəisˠ
dhíom	jiːmˠ
beadh	bʲɛfˠ
chósta	xɔːsˠt̪ˠə
tarraingt	t̪ˠaɾˠən̠ʲtʲ
mbata	mˠat̪ˠə
speala	sˠpʲalˠə
galúin	ɡalˠuːnʲ
bhíonns	vʲiːn̪ˠsˠ
tríd	tʲɾʲiːdʲ
ciarraí	ciəɾˠiː
airne	æːɾˠn̠ʲə
domsa	d̪ˠɔmˠsˠə
muileann	mˠɪlʲən̪ˠ
spriogadh	sˠpʲɾʲʊɡəɡ
cosúil	kʌsˠulʲ
galach	ɡalˠəx
móil	mˠoːlʲ
fhiaradh	iəɾˠə
cogadh	kɔɡəvˠ
araon	əɾˠeːnˠ
d'fhill	dʲiːl̠ʲ
fheadh	aɡ
rialtais	ɾˠiəl̪ˠt̪ˠəʃ
álainn	æːlˠən̠ʲ
luch	l̪ˠʌx
chodladh	xɔl̪ˠə
éigin	eːɟɪnʲ
tánn	t̪ˠɑːn̪ˠ
cnaipe	kɾˠapʲə
fhreastalódh	ɾʲasˠt̪ˠəlˠoːx
loim	l̪ˠɪmʲ
phioc	fʲʊk
briseadh	bʲɾʲɪʃuː
sloinne	sˠl̪ˠɪɲɪ
mianach	mʲiːnˠəx
aice	acɪ
peanna	pʲaːn̪ˠə
caith	kaih
cóirigh	kɔːɾʲi
deire	dʲɛɾʲə
shínigh	hiːnʲi
cóiste	kɔːʃtʲə
fliuchadh	fʲlʲʊxu
abhann	əun̪ˠ
aeróstach	eːɾˠɔːsˠt̪ˠax
damáiste	d̪ˠamˠæʃtʲə
cé	ceː
bhád	wæːd̪ˠ
d'fháisc	d̪ˠɑːʃc
déistin	dʲeːʃtʲənʲ
caipín	kapʲinʲ
bhríd	vʲɾʲiːdʲ
taifead	t̪ˠafʲəd̪ˠ
páirc	pˠaːɾʲc
gliocais	ɟlʊkəʃ
carbónach	kaɾˠəbˠoːn̪ˠəx
mílte	mʲiːl̠ʲtʲə
caint	kəin̠ʲtʲ
brí	bʲɾʲiː
lenarbh	lʲɛnˠəɾˠvˠ
carbón	kəɾˠəbˠoːn̪ˠ
dhíomsa	jiːmˠsˠə
comhairle	koːɾˠl̠ʲə
tharlódh	hɑːɾˠl̪ˠoːx
breá	bʲɾʲɑː
féasóg	fʲeːsˠoːɡ
brollach	bˠɾˠal̪ˠax
phianfadh	fʲiənˠhu
bearradh	bʲɑːɾˠətʲ
ráinig	ɾˠɑːnʲɪc
clog	klˠɔɡ
caillte	kal̠ʲtʲə
gol	ɡʌlˠ
bhreab	vʲɾʲabˠ
cinneadh	cɪɲə
duilleog	dʲɪloːɡ
brocach	bˠɾˠɔkəx
traidisiún	t̪ˠɾˠadʲəʃuːn̪ˠ
ceart	cæɾˠt̪ˠ
anseo	ən̪ˠʃɔ
sáigh	sˠɑːɟ
coirnis	koːɾˠnʲɪʃ
bhun	vˠʊnˠ
sibhse	ʃɪvʲʃə
áille	ɑːl̠ʲə
báinín	bˠæːnʲinʲ
chaith	xa
bpáipéar	bˠɑːpʲeːɾˠ
neodar	n̠ʲoːd̪ˠəɾˠ
glacann	ɡlˠakən̪ˠ
mhór	woːɾˠ
'sé	ʃeː
chugainn	ʊɡən̠ʲ
gcrainn	ɡɾˠiːnʲ
chasfadh	kasˠətʲ
caith	ka
traidisiún	t̪ˠɾˠədʲɪʃuːnˠ
gruaig	ɡɾˠuəɡ
soiléir	sˠɛlʲeːɾʲ
cochall	kɔxəl̪ˠ
scóp	sˠkɔːpˠ
spreag	sˠpʲɾʲaɡ
siúinéir	ʃuːnʲeːɾʲ
íseal	iːʃəlˠ
ubh	ɔvˠ
dhom	mˠ
cuibhrigh	kɪvʲɾʲiː
mearcair	mʲaɾˠkəɾʲ
tóra	t̪ˠoːɾˠə
thuaidh	huəɟ
bláthmhar	bˠlˠɑːfˠəɾˠ
báisteach	bˠɑːʃtʲəx
shábháil	hɑːwɑːlʲ
óstach	oːsˠt̪ˠəx
samhain	sˠəunʲ
siúlóid	ʃuːlˠoːdʲ
gceann	ɟɑːn̪ˠ
cime	cɪmʲə
uirthi	ɔɾˠə
pósadh	pˠoːsˠətʲ
móin	mˠoːnʲ
chéid	çeːdʲ
phuca	fˠʊkə
gnách	ɡɾˠæːx
dainséar	d̪ˠainʲʃeːɾˠ
ithir	ɪhəɾʲ
fos	fˠʌsˠ
go	ɡɔ
sinéad	ʃɪnʲad̪ˠ
gcósta	ɡoːsˠt̪ˠə
gáir	ɡɑːɾʲ
samhradh	sˠəuɾˠuː
mná	mˠɾˠæː
phósfadh	fˠoːsˠəx
séabra	ʃeːbˠɾˠə
bréagach	bʲɾʲiaɡəx
ormsa	ɔɾˠəmˠsˠə
brata	bˠɾˠat̪ˠə
foclóirí	fˠʌkl̪ˠɔɾʲi
saolta	sˠeːl̪ˠt̪ˠə
gcósta	ɡɔːsˠt̪ˠə
eiteog	ɛtʲaɡ
fúmsa	fˠuːmˠsˠə
goirid	ɡʌɾʲədʲ
goil	ɡɔlʲ
nóta	nˠoːt̪ˠə
spáinne	sˠpˠɑːɲɪ
fear	fʲæɾˠ
carraigín	kaɾˠɪɟiːnʲ
churaigh	xʊɾˠə
fhágadar	ɑːɡəd̪ˠəɾˠ
caithfidh	kahə
lean	l̠ʲan̪ˠ
ghobadh	ɣɔbˠəx
fómhar	fˠɔːwəɾˠ
náireach	n̪ˠɑːɾʲəx
mháthair	wæhəɾʲ
do	ɡə
banana	bˠən̪ˠan̪ˠə
fada	fˠad̪ˠə
monabhar	mˠʊnˠəwəɾˠ
leabhair	l̠ʲəurʲ
amharc	aːfˠɾˠək
gearradh	ɟɑːɾˠəx
aimsire	æmʲʃəɾʲə
srian	sˠɾˠiənˠ
spriogadh	sˠpʲɾʲʊɡə
tógaint	t̪ˠoːɡənʲtʲ
breá	bʲɾʲaː
thabharfadh	hoːɾˠətʲ
ceist	cɛʃtʲ
leagaim	l̠ʲaɡəmʲ
bhfuair	vˠuəɾʲ
pioc	pʲʊk
arbhar	aɾˠuːɾˠ
linne	lʲɪn̠ʲə
ata	at̪ˠə
earrach	əɾˠax
soilse	sˠiːlʲʃə
ród	ɾˠɔːd̪ˠ
gualainn	ɡuˑəl̪ˠənʲ
chaill	xailʲ
liom	lʲəmˠ
bhfuair	wiːɾʲ
án	ɑːn̪ˠ
bard	bˠæːɾˠd̪ˠ
siobhán	ʃʊwaːn̪ˠ
preab	pʲɾʲabˠ
san	sˠənˠ
geala	ɟalˠə
linn	l̠ʲɪn̠ʲ
idir	ɪdʲəɾʲ
lem	lʲɛmˠ
ngé	ɲeː
treabhsar	tʲɾʲəusˠəɾˠ
ceapadh	cæpˠətʲ
bhfreastalódh	vʲɾʲasˠt̪ˠəlˠoːtʲ
tom	t̪ˠuːmˠ
oifige	ɛfʲɪɟɪ
cáin	kæːnʲ
méid	mʲeːdʲ
blianta	bʲlʲiən̪ˠt̪ˠə
chrann	xɾˠaun̪ˠ
eascann	æsˠkən
teilifíse	tʲɛlʲəfʲiːʃə
bhád	vˠɑːd̪ˠ
lasadh	l̪ˠɑsˠəx
iomrá	ɤmɾˠæ
eidheann	eːn̪ˠ
éireoidh	əiɾʲoː
d'fheicfeadh	dʲɛcu
gaol	ɡiːlˠ
leagadh	l̠ʲaɡuː
críochnaithe	cɾʲiːxn̪ˠɪhɪ
samhlaigh	sˠəul̪ˠə
gcead	ɟæːd̪ˠ
seol	ʃoːl̪ˠ
madadh	mˠad̪ˠu
biorán	bʲɪɾˠɑːn̪ˠ
fiabhras	fʲiəvˠɾˠəsˠ
feadh	fʲa
tosaigh	t̪ˠɔsˠiː
chama	xamˠə
cár	kaːɾˠ
smaoinigh	sˠmˠiːnʲə
vác	wæːk
cailleadh	kal̠ʲuː
inteacht	ɪn̠ʲtʲaht̪ˠ
aíocht	iəxt̪ˠ
duilleach	d̪ˠɪl̠ʲəx
iontach	iːn̪ˠt̪ˠah
feoilséantóir	fʲɔːlʲʃeːn̪ˠt̪ˠɔrʲ
brónach	bˠɾˠuːnˠəx
claí	kləi
tirim	tʲɾʲɪmʲ
trom	t̪ˠɾˠoumˠ
ciú	cuː
tuairim	t̪ˠuəɾʲəmʲ
iomlán	əmˠl̪ˠɑːn̪ˠ
eadáine	ad̪ˠɑːn̠ʲə
dúide	d̪ˠuːdʲə
bith	bʲɪ
biorán	bɾʲɑːn̪ˠ
meall	mʲɑːl̪ˠ
diaidh	dʲiə
sámh	sˠɑːw
freo	fˠɾˠoːbˠ
broim	bˠɾˠiːmʲ
glaoigh	ɡl̪ˠiː
ag	ɛɟ
dhúinn	ɪn̠ʲ
aibreán	ɑbˠəɾˠɑːn̪ˠ
leanbhín	lʲanəvʲiːnʲ
cleachtadh	clʲaxt̪ˠuː
aithiseach	æhəʃəx
thoiligh	hɞlʲɪɟ
easna	ɑsˠn̪ˠə
veinéiseach	vʲɛnʲeʃax
mianach	mʲiənˠəx
thorann	hʌɾˠən̪ˠ
ord	əuɾˠd̪ˠ
seanmóir	ʃanˠəmɔɾʲ
bunúsach	bʊn̪ˠuːsˠəx
bisigh	bʲɪʃɪɟ
neosad	nʲoːsˠəd̪ˠ
cuntais	kʊn̪ˠt̪ˠəʃ
chuig	ɛɟ
neide	n̠ʲɛdʲə
muis	mˠɪʃ
aonraic	eːn̪ˠɾˠɪc
ordú	oːɾˠd̪ˠu
madraí	mˠɑːd̪ˠɾˠiː
fill	fʲiːlʲ
féin	fʲeːnʲ
bata	bˠat̪ˠə
fairsing	fˠaɾˠʃən̠ʲ
cineál	cɪnʲælˠ
polainn	pˠɔlˠən̠ʲ
bóthar	bˠɔhəɾˠ
ortsa	ɔɾˠt̪ˠsˠə
haige	haɟɪ
leath	l̠ʲæ
uilig	əlʲɪɟ
mbás	mˠɑːsˠ
dinnéar	dʲɪnʲeːɾˠ
snáithim	sˠn̪ˠæːihəmˠ
gearrán	ɟaɾˠɑːnˠ
orthu	ɞɾˠəbˠ
miosúir	mʲɪsˠuːɾʲ
ascaill	asˠkəl̪ˠ
dúigh	d̪ˠuːj
coscair	kɔsˠkəɾʲ
lasair	l̪ˠasˠəɾʲ
aibreán	əibʲɾʲɑːn
piléir	pʲɪlʲeːɾʲ
eadrainn	ad̪ˠɾˠən̠ʲ
seilbh	ʃɛlʲəvʲ
féinín	fʲeːnʲiːnʲ
macra	mˠakɾˠə
clástrafóibe	klˠɑːsˠt̪ˠɾˠəfˠoːbʲə
beithíoch	bʲɛix
teastaigh	tʲasˠt̪ˠi
ancaire	aŋkəɾʲə
sáinn	sˠæːn̠ʲ
támh	t̪ˠæːw
d'fhonn	d̪ˠəun̪ˠ
líos	l̠ʲiːsˠ
anam	ɑnəmˠ
leigheas	l̠ʲeːsˠ
freastail	fʲɾʲasˠt̪ˠəlʲ
saoil	sˠiːlʲ
mearadh	mʲaɾˠə
feaca	fʲakə
tar	t̪ˠaɾˠ
beir	bʲɛɾʲ
dóchas	d̪ˠoːxəsˠ
d'oilfeadh	d̪ˠɛlʲhuː
scaraid	sˠkaɾˠədʲ
patrún	pˠɑt̪ˠɾˠuːnˠ
eolaíocht	oːlˠiəxt̪ˠ
múinteoirí	mˠuːn̠ʲtʲoːɾʲiː
cláirseach	klˠæːɾˠʃah
gobadh	ɡɔbˠəvˠ
cnámh	knɑːvʲ
chaoi	xiː
seasamh	ʃasˠuː
treoracha	tʲɾʲoːɾˠəxiː
saothrú	sˠiːɾˠuː
cathair	kahɪɾʲ
bpáistí	bˠæːʃtʲi
laga	l̪ˠɑɡə
ag	əɡ
beacha	bʲaxə
ghliocais	jlʊkəʃ
slán	sˠl̪ˠɑːn̪ˠ
héirinn	heːɾʲɪɲ
pógadh	pˠoːɡə
molfaidh	mʌlhi
ngránaigh	ŋɾˠæːnˠi
dála	d̪ˠɑːlˠə
pionta	pʲɪn̪ˠt̪ˠə
oileadh	ɪlʲu
nguíonna	ŋiːn̪ˠə
scilling	ʃcilʲənʲ
iontrálacha	ɪn̪ˠt̪ˠɾˠælˠaxə
oileadh	ɛlʲuː
cinnidh	cɪnʲɪɟ
foirgneamh	fˠɔɾʲɪɟənʲəvˠ
gean	ɟanˠ
acaiseach	ækəʃəx
faitíos	fˠatʲiəsˠ
cead	cæːd̪ˠ
aice	ɛcɪ
fáinne	fˠɑːn̠ʲə
gníomhaíocht	ɡn̪ˠiːvˠiəxt̪ˠ
féicheamh	fʲeːçəvˠ
abhaill	əuwəl̠ʲ
rúis	ɾˠuːʃ
anamhaith	ɑn̪ˠəvˠɑh
bonnán	bˠun̪ˠɑːn̪ˠ
mbriseadh	mʲɾʲɪʃuː
síos	ʃiːsˠ
ard	æːɾˠd̪ˠ
ochtó	oxt̪ˠoː
chuala	xuəlˠə
uaithi	woːhə
mholfadh	wɔlˠhu
fanacht	fˠanˠaxt̪ˠ
curach	kɤɾˠax
maiseach	mˠaʃəx
fuair	fˠuəɾʲ
pós	pˠoːsˠ
frainc	fɾˠaɲc
dhúinn	ɣuːn̠ʲ
ae	eː
próis	pˠɾˠoːʃ
donncha	d̪ˠɔn̪ˠəxə
goileann	ɡɛlʲən̪ˠ
abair	abˠəɾʲ
claíomh	klˠiːw
gléas	ɟlʲeːsˠ
fail	fˠalʲ
samhain	sˠounʲ
chuici	xuːhʲə
bile	bʲɪlʲə
fáinne	fˠɑːɲə
críochnaigh	cɾʲiːxn̪ˠɪɟ
dó	d̪ˠoː
amadán	amˠəd̪ˠɑːnˠ
clampar	klˠamˠpˠəɾˠ
d'éirigh	dʲəiɾʲə
uirthi	ɛɾʲhə
sorcha	sˠɔɾˠəxə
náid	n̪ˠæːdʲ
géagach	ɟeːɡah
bolcáin	bəl̪ˠkɑːnʲ
gránach	ɡɾˠæːnˠah
dhéag	jeːɡ
teacht	tʲæːxt̪ˠ
briosca	bʲɾʲɪsˠkə
acusan	ɑkəpˠsˠənˠ
ásc	ɑːsˠk
aiges	ɛɟɪsˠ
cibé	cɪbʲeː
tír	tʲiːɾʲ
agaibh	ɑɡiː
baile	bˠalʲə
paidir	pˠadʲəɾʲ
aireach	æɾʲəx
cuireadh	kɪɾʲəɡ
fhómhar	õːɾˠ
atá	at̪ˠɑː
árasáin	æːɾˠəsˠænʲ
manainnis	mˠanˠən̠ʲɪʃ
dtigh	dʲiː
aibhneacha	əivʲn̠ʲəxiː
gabh	ɡavʲ
cheannach	çan̪ˠah
gob	ɡʌbˠ
sop	sˠapˠ
d'fheicfeadh	dʲɛcətʲ
bearradh	bʲaɾˠə
torann	t̪ˠʌɾˠən̪ˠ
oilim	ɪlʲəmˠ
seasamh	ʃæsˠə
spreagtha	sˠpʲrʲakə
rialta	ɾˠiəl̪ˠt̪ˠə
crochadh	kɾˠɔxuː
achadh	axu
cuarc	kuəɾˠk
bhriseadh	vʲɾʲɪʃu
tiubh	tʲʊw
suite	sˠɪtʲə
pheann	fʲan̪ˠ
foradh	fˠɔɾˠə
deargadh	dʲaɾˠəɡətʲ
láthair	l̪ˠɑːhəɾʲ
gasóg	ɡasˠaɡ
círe	ciːɾʲə
rá	ɾˠɑː
mheas	vʲasˠ
ciseal	cɪʃəlˠ
pianfaidh	pʲiənhə
giúistís	ɟuːʃtʲiːʃ
tuaisceart	t̪ˠuəʃcəɾˠt̪ˠ
seadadh	ʃad̪ˠə
againne	aɡən̠ʲə
coinne	kɪn̠ʲə
don	d̪ˠʌnˠ
dugaire	d̪ˠɤɡəɾʲə
fomhuireán	fɔvˠərʲɑːn̪ˠ
aibhne	uəvn̠ʲə
fríd	fʲɾʲiːdʲ
poill	pˠəil̠ʲ
miosúir	mʲɪsˠuɾʲ
réiteach	ɾˠeːtʲah
deartháireacha	dʲæːɾˠhaɾʲaxə
boig	bˠɪɟ
dramanna	d̪ˠɾˠamˠən̪ˠiː
asainn	ɑsˠən̠ʲ
smál	sˠmˠɑːl̪ˠ
bláth	bˠl̪ˠæː
am	amˠ
féinín	fʲeːnʲinʲ
chloch	xlˠʌx
cleachtadh	clʲæxt̪ˠətʲ
intinn	iːn̠ʲtʲən̠ʲ
aiseag	aʃək
craos	kɾˠiːsˠ
carbán	karˠbˠɑːnˠ
fliuchadh	fʲlʲʊxuː
chailleas	xalʲəsˠ
folláin	fˠɔl̪ˠɑːnʲ
tostar	t̪ˠɔsˠt̪ˠəɾˠ
druncaera	d̪ˠɾˠʊŋkeːɾˠə
m'anam	mˠanˠəmˠ
hoibre	hɛbʲərʲə
chas	xasˠ
dhaoibhse	jiːpʲʃə
bandach	bˠan̪ˠd̪ˠəx
bhfaigheann	wæːn̪ˠ
mapa	mˠapˠə
créatúr	cɾʲeːt̪ˠuɾˠ
fúibhse	fˠuːpʲʃə
cuireadh	kɪɾʲuː
naoscann	n̪ˠiːsˠkən̪ˠ
captaen	kɑpˠt̪ˠeːn̪ˠ
uaibh	wæbʲ
plainc	pˠlˠaɲc
sceacha	ʃcaxə
bhean	vʲæːnˠ
chnuic	xnˠɪc
chroí	xɾˠiː
ionsaí	ɔnˠsˠiː
baintreach	bˠanʲtʲɾʲəx
dhínn	iːn̠ʲ
tanaí	t̪ˠan̪ˠiː
saorann	sˠiːɾˠən̪ˠ
suarach	sˠuˑəɾˠəx
fearr	fʲɑːɾˠ
tarbh	t̪ˠaɾˠuː
sáigh	sˠæːj
stiofán	ʃtʲʊfˠɑːnˠ
póg	pˠɔːɡ
tobac	t̪ˠəbˠak
crom	kɾˠaumˠ
snáith	sˠn̪ˠɑːiç
án	ɑːnˠ
cognadh	kɔɡnˠə
shuigh	hʊ
maor	mˠiːɾˠ
chian	çiənˠ
ainm	anʲəmʲ
dheacair	jakəɾʲ
leigheas	l̠ʲəisˠ
bacach	bˠəkɑx
comrádaí	kʌmˠɾˠæd̪ˠi
costas	kɔsˠt̪ˠəsˠ
suaimhneach	sˠuənʲəx
tábhacht	t̪ˠɑːxt̪ˠ
sáigh	sˠɑːj
uafásach	uhæsˠah
amaideach	ɑmˠədʲəx
ola	ɔlˠə
crith	crʲɪh
churaigh	xʊɾˠiː
ód	oːd̪ˠ
mhór	wɔːɾˠ
daonra	dˠeːn̪ˠɾˠə
orthu	ɔɾˠhə
bóthar	bˠoːhəɾˠ
aineolaí	anʲɔli
mhol	wɔlˠ
uaidh	uəɟ
théas	heːsˠ
mhoill	vˠiːlʲ
firéad	fʲɪrʲeːd̪ˠ
deargadh	dʲaɾˠəɡəx
uafásach	uːhɑːsˠəx
saibhir	sˠɛvʲəɾʲ
deirfiúr	dʲɛɾʲəfˠuːɾˠ
cheann	çan̪ˠ
clóscríobhaithe	klˠoːʃcɾʲiːwiː
feoigh	fʲɔːj
déan	dʲiːn
chasta	xasˠt̪ˠə
saothar	sˠihəɾˠ
dhomsa	ɣɔmˠsˠə
oideachais	ɛdʲəxəʃ
cuisneoir	kɪʃnʲɔɾʲ
oil	ɛlʲ
córas	kɔːɾˠəsˠ
amhras	ãvˠɾˠəsˠ
tiománaí	tʲɪmˠænˠi
cath	kah
toir	t̪ˠɛɾʲ
aoife	iːfʲə
cluin	klɨn
bpianadh	bʲiənˠəvˠ
orm	əɾˠmˠ
albanach	alˠəbˠənəx
íosfaidh	iːsiː
uaibhse	wæpʲʃə
doiciméad	d̪ˠɪcɪmʲeːd̪ˠ
teastáil	t̪ˠasˠt̪ˠɑːlʲ
cam	kaumˠ
dhearna	jɑːɾˠn̪ˠə
réiteach	ɾˠeːtʲəx
agus	ɡəsˠ
snáthaid	sˠn̪ˠæhəd̪ˠ
ann	aun̪ˠ
tuirse	t̪ˠʊɾˠʃə
d'oileadh	d̪ˠɛlʲuː
péinis	pʲeːnʲəʃ
gríos	ɡɾʲɪsˠ
leo	lʲoːbˠ
doiciméad	d̪ˠɔcɪmʲed̪ˠ
guta	ɡʊt̪ˠə
seasca	ʃasˠkə
bior	bʲɪɾ
gcasadh	ɡɑsˠəx
scuab	sˠkuəbˠ
crúigh	kɾˠuː
móire	mɔːɾʲə
léarscáil	lʲeːɾˠsˠkaːlʲ
ollmhargadh	ɔl̪ˠwaɾˠəɡuː
míos	mʲiːsˠ
freis	fˠɾˠɛʃ
dhóibh	oːbˠ
gnách	ɡɾˠɑːx
amú	əmˠuː
bealach	bʲəl̪ˠɑx
laethe	l̪ˠeːhɪ
riocht	ɾˠʊxt̪ˠ
lios	l̠ʲɪsˠ
ardchlár	ɑːɾˠd̪ˠxlˠɑːɾˠ
gcodladh	ɡɔl̪ˠuː
dorcha	d̪ˠʌɾˠəxə
chinn	çiːnʲ
níos	n̠ʲiːsˠ
cánach	kɑːn̪ˠəx
toradh	t̪ˠʌɾˠu
sás	sˠɑːsˠ
eagla	aːɡlə
maoin	mˠiːnʲ
ghníomhaíocht	ɣn̪ˠiːvˠiəxt̪ˠ
mullach	mʊl̪ˠəx
airg	aɾʲɪɟ
salaigh	sˠalˠi
labhair	l̪ˠəuɾʲ
canúnach	kan̪ˠuːn̪ˠəx
séipéal	ʃeːpʲal̪ˠ
cónaí	kuːnˠiː
caisleán	kəʃlʲɑːn̪ˠ
oileán	əlʲɑːnˠ
síoraí	ʃiːɾˠiː
pálás	pˠɑːlˠɑːsˠ
stól	sˠt̪ˠoːlˠ
seasamh	ʃasˠu
oirnis	əuɾʲn̠ʲəʃ
chearnóg	çɑːɾˠn̪ˠoːɡ
dtiocfad	d̪ˠʊkəd̪ˠ
meá	mʲaː
cíora	ciːɾˠə
tuilleadh	tʲɪl̠ʲə
mholadh	wɔlˠuː
píce	pʲiːcɪ
aire	aɾʲə
faocha	fˠeːxə
minic	mʲnʲɪc
cuireadh	kɪɾʲəx
abhann	oːn̪ˠ
gcoill	ɡɞl̠ʲ
molfaidh	mɔlhiː
curach	kɔɾˠəx
chaoil	xiːlʲ
shinsir	hɪn̠ʲsʲəɾʲ
méad	mʲeːd̪ˠ
agaibhse	aɡəvʲʃə
seanathair	ʃanˠahəɾʲ
hainmneacha	hanʲəmʲnʲəxiː
cúr	kuːɾˠ
iadsan	iəd̪ˠsˠənˠ
d'éalaigh	dʲeːlˠiː
féarach	fʲiarəx
colúr	kəl̪ˠuːɾˠ
scilling	ʃcɪlʲɪɲ
cuach	kuəx
coicís	kəikiːsˠ
leath	lʲæ
braon	bˠɾˠiːnˠ
dúntar	d̪ˠuːn̪ˠt̪ˠəɾˠ
ab	abˠ
cheart	çaɾˠt̪ˠ
feiceáil	fʲɛcɑːlʲ
dol	d̪ˠɔlˠ
ná	n̪ˠɑː
mothaíonn	muːiːn̪ˠ
údar	uːd̪ˠəɾˠ
ceathrú	caɾˠhu
réir	ɾˠeːɾʲ
curaigh	kʊɾˠiː
bacacha	bˠakəxə
dinnéar	dʲɪnʲeɾˠ
imleacán	imʲlʲəkɑːnˠ
aeráid	eːɾˠɑːdʲ
curaí	kɤɾˠi
bearradh	bʲɑːɾˠəx
clúdach	klˠuːd̪ˠax
díbhse	dʲiːvʲʃə
bunús	bən̪ˠuːsˠ
crith	crʲɪç
tigh	tʲiː
scriú	sˠkɾˠuː
anamhór	ɑn̪ˠəvˠuəɾˠ
búistéara	bˠuːʃtʲeːɾˠə
suíochán	sˠiːxɑːnˠ
suigh	sˠʊ
croíúil	kɾˠiːuːlʲ
piléar	pʲɪlʲeːɾˠ
casann	kɑsən̪ˠ
curach	kɤɾˠa
coileach	kɛlʲəx
tosú	t̪ˠəsˠuː
oileadh	ɛlʲəx
lean	lʲan̪ˠ
uaim	wæmʲ
paca	pˠakə
toiligh	t̪ˠʌlʲi
cinneadh	cɪɲəɡ
toinn	t̪ˠaɪɲ
asam	asˠəmˠ
páipéar	pˠaːpʲeːɾˠ
fheiceadh	ɛcətʲ
beas	bʲɛɪsˠ
anamacha	an̪ˠəmˠəxiː
chinn	çɪn̠ʲ
mála	mˠæːl̪ˠə
ciúin	cuːnʲ
ionamsa	ɪnəmˠsˠə
domhnall	d̪ˠoːnˠəl̪ˠ
sagairt	sˠæɡəɾˠtʲ
gcéadta	ɟeːt̪ˠə
cuán	kuːænˠ
nós	n̪ˠɔːsˠ
scéal	ʃceːlˠ
tráta	t̪ˠɾˠɑːt̪ˠə
cuibhrigh	kɪvʲɾʲɪɟ
cuisneoir	kɪʃnʲoːɾʲ
céard	ceːɾˠd̪ˠ
bheadh	vʲɛx
féarach	fʲeːrax
aithrí	aɾʲhiː
mháighistreása	vˠɑːʃtʲəɾʲɑːsˠə
sobal	sˠɔbˠəlˠ
di	dʲiː
d'éalaigh	dʲeːlˠi
cosaint	kʌsˠən̠ʲtʲ
gcead	ɟad̪ˠ
bróg	bˠɾˠoːɡ
deachaigh	dʲaxiː
thoir	hɛɾʲ
guidte	ɡɪtʲə
fáil	fˠɑːlʲ
coinníoll	kɪn̠ʲil̪ˠ
gníomhaíocht	ɡɾˠiːwiəxt̪ˠ
seacht	ʃaxt̪ˠ
cnoc	kɾˠʊk
seáin	ʃæːnʲ
gnó	ɡɾˠɔː
dtiarna	dʲiəɾˠn̪ˠə
gos	ɡəsˠ
srón	sˠɾˠoːn
tnúth	t̪ˠn̪ˠuː
goidte	ɡɛtʲə
cuimhne	kiːmʲɾʲə
aneas	ən̠ʲæsˠ
ciseáin	cɪʃɑːnʲ
luachair	l̪ˠuəxəɾʲ
domhan	d̪ˠaʊən̪ˠ
gearradh	ɟaɾˠuː
fágáil	fˠæːɡælʲ
monabhar	mˠɔnˠəwəɾˠ
dosna	d̪ˠɔsˠn̪ˠə
chor	xɔɾˠ
cúigiú	kuːɟuː
héirinn	heːɾʲən̠ʲ
asaibh	ɑsˠəvʲ
nollaigí	n̪ˠɔl̪ˠəɟiː
iontu	uːn̪ˠt̪ˠə
tuill	t̪ˠiːl̠ʲ
cnagaire	kɾˠaɡəɾʲə
tiús	tʲuːsˠ
amhráin	oːɾˠɑːnʲ
amaideacha	ɑmədʲəxə
brice	bʲɾʲɪcɪ
caillte	kail̠ʲtʲə
pheadair	fʲad̪ˠəɾʲ
philéir	fʲlʲeːɾʲ
mhná	vˠɾˠɑː
oigheann	əiən
fhir	ɪɾʲ
leagadh	l̠ʲaɡu
leagfaidh	l̠ʲakiː
trínarb	tʲɾʲiːnˠəɾˠbˠ
ráinig	ɾˠɑːnʲɪɟ
gearradh	ɟaɾˠəvˠ
protastúnach	pˠɾˠɔt̪ˠəsˠt̪ˠuːn̪ˠəx
cuireadh	kɪɾʲu
cliste	cʲlʲɪʃtʲə
uirthi	ɞɾˠə
churaigh	xʊɾˠɪɟ
cluiche	klˠɪçə
inar	ɪnˠəɾˠ
gol	ɡɔlˠ
cruit	kɾˠɪtʲ
garda	ɡɑːɾˠd̪ˠə
'un	ənˠ
mallacht	mˠəl̪ˠɑxt̪ˠ
seanmóir	ʃan̪ˠəmoːɾʲ
lao	l̪ˠeː
cósta	koːsˠt̪ˠə
pláta	pˠlˠæːt̪ˠə
macánta	məkɑːn̪ˠt̪ˠə
ráite	ɾˠɑːtʲə
codladh	kɔl̪ˠuː
grinne	ɟɾʲɪɲə
coróin	kɾˠoːnʲ
móide	mˠoːdʲə
clann	kl̪ˠɑːn̪ˠ
bhriseadh	vʲɾʲɪʃəx
fuinneog	fˠɪn̠ʲɔɡ
cuimhne	kiːnʲə
pianadh	pʲiənˠuː
cóta	koːt̪ˠə
furasta	fˠʊɾ̪ˠəst̪ˠə
shnámh	hn̪ˠɑːvˠ
spáin	spˠɑːnʲ
citeal	cɪtʲəlˠ
áirithe	ɑːɾʲəhə
fearthainn	fʲaɾˠhən̠ʲ
fliuchadh	fʲlʲʊxətʲ
chapaill	xapˠəl̪ʲ
marbh	mˠarˠu
túir	t̪ˠuːɾʲ
gearr	ɟɑːɾˠ
monarcha	mˠɔnˠəɾˠxə
fógair	fˠɔːɡəɾʲ
d'fhill	dʲiːlʲ
aithne	ehnʲə
di	d̪ˠiː
stoic	sˠt̪ˠɪc
uaitse	wætʲʃə
gránna	ɡɾˠæːn̪ˠə
deich	dʲɛ
istigh	əʃtʲɪj
cailín	kalʲinʲ
traidisiún	t̪ˠɾˠədʲɪʃunˠ
fuath	fˠuə
luigh	l̪ˠɪɟ
a'	ə
ádh	ɑː
fhágadh	ɑːɡuː
ábhar	ɑːvˠəɾˠ
uait	wɛtʲ
mhná	vˠnˠɑː
chairde	xɑːɾˠdʲə
neamh	n̠ʲavˠ
baoth	bˠiː
orthu	ɔɾˠəbˠ
hainmneacha	hanʲəmʲnʲəxə
glanadh	ɡlˠanˠu
aigesan	ɛɟəsˠən
airím	æɾʲiːmʲ
meitheamh	mʲɛhu
feirge	fʲɛɾʲɪɟɪ
chodlata	kʌl̪ˠət̪ˠə
ghránaigh	ɣɾˠɑːn̪ˠɪɟ
áirid	ɡəhɑːɾʲədʲ
binse	bʲiːnʲʃə
fál	fˠɑːl̪ˠ
aibhne	əivʲn̠ʲə
gcoill	ɡəil̠ʲ
sé	ʃeː
gorm	ɡɔɾˠəmˠ
maor	mˠeːɾˠ
fria	fˠɾˠeː
stopallán	sˠt̪ˠɑpəlˠænˠ
náire	n̪ˠæːɾʲə
fíniúnach	fʲiːnʲunˠah
atá	ət̪ˠɑː
éirigh	əiɾʲiː
uíbh	iːvʲ
cainte	kan̠ʲtʲə
eadrainne	aːt̪ˠɾˠən̠ʲə
cathaoir	kaihiɾʲ
aoire	iːɾʲə
tuairisc	t̪ˠuˑəɾʲɪʃc
dúchas	d̪ˠuːxəsˠ
chodladh	xʌl̪ˠu
bhfreastalaíodh	vʲɾʲasˠt̪ˠəlˠiːx
clearer	klɪɹɚ
airigh	æːɾʲə
speal	sˠpʲalˠ
bréagach	bʲɾʲeːɡah
feall	fʲɑːl̪ˠ
luail	l̪ˠuəlʲ
conas	knɞs
ceannaí	can̪ˠiː
seamróg	ʃamˠɾˠoːɡ
mar	mˠɑɾˠ
eagar	aɡəɾˠ
lorg	l̪ˠɔɾˠəɡ
lúcháir	l̪ˠʊxæɾʲ
turtar	t̪ˠʊɾˠt̪ˠəɾˠ
ósna	oːsˠn̪ˠə
ghaibh	ɣavʲ
blaosc	bˠlˠeːsˠk
socra	sˠʌkɾˠə
bac	bˠak
nathair	n̪ˠæhəɾʲ
pógadh	pˠoːɡətʲ
sábháil	sˠɑːvˠɑːlʲ
alastar	al̪ˠəsˠt̪ˠəɾˠ
suim	sˠɪmʲ
ordú	oːɾˠd̪ˠuː
sáinn	sˠɑːn̠ʲ
luíonn	l̪ˠəin̪ˠ
sceitimíní	sˠcɛtʲəmʲiːnʲiː
imíodh	ɪmʲiːx
scairteadh	sˠkaɾˠtʲəɡ
dúlamán	d̪ˠuːlˠəmˠɑːnˠ
do	d̪ˠɔ
íosánach	iːsˠɑːn̪ˠəx
mímhúinte	mʲiːwuːn̠ʲtʲə
céibhe	ceːvʲə
lao	l̪ˠiː
bog	bˠʌɡ
aon	eːnˠ
íosfadh	iːsətʲ
gaedhlaing	ɡeːlɪɲ
adhairce	əiɾʲcɪ
ceanna	can̪ˠə
ithe	iː
neada	n̠ʲad̪ˠə
cupán	kʊpˠɑːnˠ
buille	bˠɪl̠ʲə
éadach	eːd̪ˠah
phianadh	fʲiənˠətʲ
amuigh	əmˠɪɟ
geimhreadh	ɟɛvʲɾʲuː
ionadh	iːnˠuː
gasóg	ɡəsˠoːɡ
curacha	kɔɾˠəxə
gaedhilge	ɡeːlʲɟə
cha	xa
nbhur	nˠə
tosaí	t̪ˠʌsˠi
leoraí	lʲɔɾˠiː
cóir	koːɾʲ
do	d̪ˠə
bhfeadh	vʲa
fhiacha	iəxə
nid	n̠ʲɪdʲ
caoirigh	kiːɾʲɪɟ
oileánach	ɪlʲɑːnˠəx
plás	pˠlˠæːsˠ
páistí	pˠɑːʃtʲiː
léigh	lʲeː
buairt	bˠuəɾˠtʲ
bheifeá	vʲɛhɑː
baol	bˠiːlˠ
daoibh	d̪ˠiːbʲ
saoradh	sˠeːɾˠə
órga	oːɾˠɡə
tógáil	t̪ˠoːɡɑːlʲ
duais	d̪ˠuəʃ
doire	d̪ˠɛɾʲə
rúnaí	ɾˠuːn̪ˠiː
séis	ʃeːʃ
mná	mˠɾˠɑː
airc	aɾʲc
saoradh	sˠeːɾˠəx
pógtha	pˠɔːkə
rós	ɾˠoːsˠ
cróga	kɾˠoːɡə
cion	cʊnˠ
coinneáil	kɪn̠ʲɑːlʲ
deifir	dʲɛfʲəɾʲ
fuinneoga	fˠɪɲoːɡə
bradán	bˠɾˠɑd̪ˠɑnˠ
os	ɔsˠ
fhómhair	õːɾʲ
thá	hɑː
linn	lʲɪn̠ʲ
bille	bʲɪlʲə
polainn	pˠʌlˠən̠ʲ
shínigh	hiːnʲə
fuinneoga	fˠɪn̠ʲoːɡiː
réasúnta	ɾˠeːsˠun̪ˠt̪ˠə
salú	sˠəl̪ˠuː
comrádaithe	kʊmˠɾˠɑːd̪ˠiː
dán	d̪ˠɑːnˠ
iorua	ɪɾˠuə
fírinne	fʲiːɾʲən̠ʲə
samhraíocha	sˠəuɾˠiːxiː
bláthanna	bˠl̪ˠɑːhən̪ˠə
loca	l̪ˠɔkə
dearmad	dʲæɾˠəmˠəd̪ˠ
scíth	ʃciː
luas	l̪ˠuəsˠ
uaigneach	uəɟɪnʲəx
ceannasaí	can̪ˠəsˠiː
phóca	pˠɔːkə
rinn	ɾˠɪn̠ʲ
beiridh	bʲɛɾʲɪɟ
thuilleamar	hɪl̠ʲəmˠəɾˠ
faigheann	fˠæːn̪ˠ
chuairt	xuəɾˠtʲ
chuathas	xuəhəsˠ
fhiaradh	iəɾˠuː
coinneal	kɪnʲəl̪ˠ
dorais	d̪ˠɔɾˠəʃ
ceilte	cɛlʲtʲə
foirgneamh	fˠɔɾʲɪɟnʲəvˠ
garsún	ɡɑɾˠsˠuːn̪ˠ
fágfaidh	fˠæːkə
ionadh	iːnˠu
dearthár	dʲæːɾˠhaɾˠ
rós	ɾˠɔːsˠ
caithfidh	kaɪhi
gcéibheanna	ɟeːvʲən̪ˠiː
gáir	ɡæːɾʲ
scairteadh	sˠkaɾˠtʲətʲ
scannán	sˠkən̪ˠaːn̪ˠ
mckeon	məkiːən
oscail	ɔsˠkəlʲ
romhat	ɾˠuːt̪ˠ
tosaigh	t̪ˠʌsˠi
éirinn	eːɾʲɪɲ
bhfreastalódh	vʲɾʲasˠt̪ˠəlˠoːx
curaí	kɔɾˠiː
spáinne	sˠpˠɑːn̠ʲə
stopadh	sˠt̪ˠɔpˠətʲ
dochar	d̪ˠɔxəɾˠ
cogadh	kɔɡuː
oraibhse	ɔɾˠiːʃə
seadadh	ʃad̪ˠətʲ
thiocfá	hʊkfˠɑː
dhúinne	ɣuːn̠ʲə
francach	fˠɾˠɑŋkəx
péitseog	pʲeːtʲʃaɡ
feitheamh	fʲɪhəv
ithe	iːə
gearrán	ɟəɾˠɑːnˠ
síneadh	ʃiːnʲəɡ
aidiacht	adʲaht̪ˠ
bóthar	bˠoːɾˠ
cleachtadh	clʲaxt̪ˠəɡ
taithí	t̪ˠahi
foirfe	fˠɪɾʲəfʲə
faitíos	fˠatʲçiːsˠ
ollmhargadh	ɔl̪ˠvˠaɾˠəɡə
anoir	ən̪ˠɛɾʲ
tíocht	tʲiəxt̪ˠ
cairéad	kaɾʲad̪ˠ
leagadh	l̠ʲaɡəvˠ
dínn	d̪ˠiːn̠ʲ
gobadh	ɡɔbˠəx
pasam	pˠasˠəmˠ
phálás	fˠælˠæsˠ
dearthár	dʲɾʲɑːhərˠ
léi	lʲeːiː
baisteadh	bˠaʃtʲəɡ
cinneadh	cɪn̠ʲəx
coileach	kɛlʲah
torann	t̪ˠɔɾˠən̪ˠ
ait	atʲ
annamh	ɑn̪ˠə
spreagadh	sˠpʲɾʲaɡəx
thigh	hiː
asainn	asˠən̠ʲ
caithfidh	kahɪɟ
cluich	klˠɪç
oilim	ɛlʲəmˠ
anchroí	ɑnxɾˠə
scaradh	sˠkɑɾˠə
báille	bˠɑːl̠ʲə
fíonghort	fʲiːnˠɣɔɾˠtˠ
easpaig	asˠpˠɪɟ
dhícheall	jiːhəl̪ˠ
eang	aŋ
ins	ɪnˠsˠ
ligean	l̠ɪɟənˠ
buí	bˠiː
aoibhneas	iːvʲnʲəsˠ
luigh	l̪ˠɔ
stábh	sˠt̪ˠɑːw
cheithre	çɛɾʲə
fuinneoga	fˠɪn̠ʲoːɡə
caisleán	kaʃl̠ʲɑːnˠ
fíon	fʲiːnˠ
scuabadh	sˠkuəbˠə
eiscir	ɛʃcəɾʲ
támh	t̪ˠɑːvˠ
rúibín	ɾˠuːbʲinʲ
boid	bˠɪdʲ
brasaíl	bˠɾˠasˠiːlʲ
ráinig	ɾˠæːnʲɪc
tobar	t̪ˠʌbˠəɾˠ
álainn	ɑːl̪ˠənʲ
cháiliúil	xɑːlʲuːlʲ
meanma	mʲanˠmˠə
éigint	eːɟɪn̠ʲtʲ
scríofa	ʃcɾʲiːfˠə
aibreán	abʲəɾʲɑːn̪ˠ
airne	ɑːɾˠn̠ʲə
náireach	n̪ˠæːɾʲah
d'oilfeadh	d̪ˠɪlʲhuː
fill	fʲɪl̠ʲ
aosta	iːsˠt̪ˠə
oileán	ɛlʲænˠ
páidín	pˠɑːdʲiːnʲ
athair	æːɾʲ
piocadh	pʲʊkətʲ
aisteach	æʃtʲəx
tuilleadh	t̪ˠɪl̠ʲu
corraigh	kɔɾˠiː
milseán	mʲɪlʲʃɑːn̪ˠ
both	bˠɔh
hiomlán	həmˠl̪ˠɑːn̪ˠ
spleáchas	sˠpʲlʲaːxəsˠ
aspal	asˠpˠəlˠ
gcóstaí	ɡɔːsˠt̪ˠi
caillte	kɑːl̠ʲtʲə
crích	cɾʲiːç
aontaigh	eːn̪ˠt̪ˠɪɟ
cleachtadh	clʲaxt̪ˠu
cnoc	knˠɔk
deannach	dʲanˠəx
ceannasach	can̪ˠəsˠəx
pósadh	pˠoːsˠəx
cócaráil	koːkəɾˠaːlʲ
cearnóga	caːɾˠn̪ˠoːɡə
drama	d̪ˠɾˠamˠə
féicheamh	fʲeːçu
seic	ʃɛc
agam	aɡəmˠ
baineannach	bˠanʲənˠəx
gcás	ɡæːsˠ
iomas	ʊmˠəsˠ
brónach	bˠɾˠɔːnˠah
aerfort	eːɾˠfɔɾˠt̪ˠ
cheada	çad̪ˠə
chughamsa	xuːmˠsˠə
abhac	auk
aithin	ahənʲ
faoisean	fˠɯːsˠən
caoine	kiːnʲə
bhíodh	vʲiːw
bia	bʲiə
starr	sˠt̪ˠɑːɾˠ
clé	clʲiː
lapa	l̪ˠapˠə
circe	cɪɾʲcə
scóip	sˠkɔːpʲ
fuair	fˠiːɾʲ
sibh	ʃɪbʲ
díbh	dʲiːbʲ
freastalaíodh	fʲɾʲasˠt̪ˠəlˠitʲ
spás	sˠpˠæːsˠ
deichniúr	dʲɪn̠ʲuːɾˠ
fhreastail	ɾʲasˠt̪ˠəlʲ
banc	bˠaŋk
ceathrar	cahɾˠəɾˠ
ngobadh	ŋɔbˠəx
póg	pˠoːɡ
suigh	sˠiː
gealach	ɟalˠah
mairt	mˠaɾˠtʲ
spáinnis	sˠpˠɑːn̠ʲəʃ
chás	xɑːsˠ
lenarb	lʲɛnˠəɾˠbˠ
deartháireacha	dʲaɾˠhaɾʲəxə
bac	bˠɑk
pinginí	pʲiːn̠ʲiː
lastar	l̪ˠasˠt̪ˠəɾˠ
desna	dʲɛsˠn̪ˠə
badhbh	bˠəivˠ
deich	dʲɛh
cosa	kʌsˠə
beacht	bʲaxt̪ˠ
chúichi	xuːhʲə
canadh	kanˠə
luath	l̪ˠuə
fuacht	fˠuəxt̪ˠ
amharclann	əuɾˠklˠən̪ˠ
agus	ɑɡəsˠ
chóisir	xoːʃəɾʲ
síocháin	ʃiəxɑːnʲ
chnoc	xnˠɔk
cailc	kalʲc
protastúnach	pˠɾˠʌt̪ˠəsˠt̪ˠun̪ˠah
breith	bʲɾʲɛ
cheintiméadar	çɛnʲtʲəmʲeːd̪ˠəɾˠ
dearg	dʲaɾˠəɡ
sruith	sˠɾˠʊh
mothaigh	mˠuː
vác	vˠɑːk
brath	bˠɾˠa
píbe	pʲiːbʲə
deartháireacha	dʲɾʲɑːhərʲəxə
pince	pʲɪɲcɪ
bacaí	bˠəkiː
roimh	ɾˠɪvʲ
téis	tʲeːʃ
trian	tʲɾʲiənˠ
dod	d̪ˠɔd̪ˠ
d'altfadh	d̪ˠal̪ˠt̪ˠətʲ
déanaí	dʲeːn̪ˠiː
beannacht	bʲən̪ˠaxt̪ˠ
bpianadh	bʲiənˠəɡ
déantóir	dʲian̪ˠt̪ˠoːɾʲ
chun	xʊnˠ
creid	cɾʲɛdʲ
cultúr	kʊl̪ˠt̪ˠuːɾˠ
salaigh	sˠalˠiː
geobhad	ɟoːd̪ˠ
samhain	sˠauwənʲ
pholainn	fˠɔlˠən̠ʲ
ainmneacha	anʲəmʲnʲaxə
leáigh	lʲɑːɟ
bhreoiteacht	vʲɾʲɔːtʲaht̪ˠ
rang	ɾˠaːŋɡ
creidfead	cɾʲɛtʲəd̪ˠ
aithreacha	ahɾʲəxə
chead	çæːd̪ˠ
freastalaíodh	fʲɾʲasˠt̪ˠəlˠiːɡ
saoradh	sˠiːɾˠəx
dhóibh	ɣoːbʲ
scríobh	ʃcɾʲiːvˠ
aisig	aʃɪɟ
geata	ɟæt̪ˠə
gealach	ɟəl̪ˠɑx
veinéiseach	vʲənʲeːʃəx
pobal	pˠʌbˠəlˠ
scaoilte	sˠkiːlʲtʲə
aisce	aʃcɪ
gcearnóg	ɟaːɾˠn̪ˠoːɡ
foghar	fˠoːɾˠ
deireadh	dʲɛɾʲətʲ
busta	bˠʊsˠt̪ˠə
troithe	t̪ˠɾˠɛhə
briseadh	bʲɾʲɪʃu
gradam	ɡɾˠɑd̪ˠəmˠ
gearradh	ɟɑːɾˠə
ceapadh	capətʲ
róid	ɾˠoːdʲ
mholfadh	wɔlˠhəx
ngránaigh	ŋɾˠɑːnˠiː
moladh	mˠɔlˠuː
fiaradh	fʲiəɾˠəɡ
leitean	l̠ʲɛtʲənˠ
ionam	ʊn̪ˠəmˠ
asat	asˠəd̪ˠ
dhaoibh	ɣiːbʲ
doirse	d̪ˠʌɾˠʃə
athraithe	aɾˠiː
diúl	dʲuːlˠ
uainn	wɛn̠ʲ
theacht	haxt̪ˠ
bhain	wanʲ
eitleán	ɛtʲəlʲænˠ
scáthán	sˠkɑːn̪ˠ
d'fhágadh	d̪ˠæːɡu
amh	aw
breabadh	bʲɾʲabˠəɡ
aeir	eːɾʲ
scátháin	sˠkɑːnʲ
curach	kɤɾˠah
téigh	tʲeːɟ
raidió	ɾˠadʲiːoː
folláin	fˠəl̪ˠɑːnʲ
faigh	fˠaɟ
bheag	vʲɞɡ
mais	mˠaʃ
toradh	t̪ˠɔɾˠə
chasadh	xasˠəx
cruinnigh	kɾˠɪɲɪɟ
dola	d̪ˠʌlˠə
grámhar	ɡɾˠɑːwəɾˠ
cluas	kluəʃ
agair	aɡəɾʲ
maraigh	mˠaɾˠi
stopadh	sˠt̪ˠɔpˠəx
liathróid	l̠ʲiəhɾˠɔdʲ
cuan	kuənˠ
lathach	l̪ˠɑhəx
ionad	ɔnˠəd̪ˠ
buail	bˠuəlʲ
dhínne	jiːn̠ʲə
gunna	ɡɤn̪ˠə
séide	ʃeːdʲə
cáibín	kaːbʲiːnʲ
beannacht	bʲan̪ˠaht̪ˠ
seoirse	ʃoːɾˠʃə
d'fheiceadh	dʲɛcuː
meas	mʲæːsˠ
gcóngar	ɡuːŋɡəɾˠ
gasúr	ɡasˠuɾˠ
breithiúnas	bʲɾʲɛhuːnˠəsˠ
ngall	ŋɑːl̪ˠ
geimhreadh	ɟiːɾʲə
doras	d̪ˠʌɾˠəsˠ
críoch	cɾʲiəx
uainín	uənʲinʲ
siad	ʃəd̪ˠ
churach	xɤɾˠax
eangach	aŋɡəx
cairdiúil	kæːɾˠdʲulʲ
iasc	iəsˠk
fána	fˠæːnˠə
ducht	d̪ˠʊxt̪ˠ
gceist	ɟɛʃtʲ
piléar	pʲəlʲeːɾˠ
bolcán	bɔlˠkɑːnˠ
boireannach	bˠɛɾʲən̪ˠəx
maithe	mˠahə
cloig	klˠɪɟ
oilfeadh	ɪlʲhəx
cheannacht	çæːn̪ˠəxt̪ˠ
rinneas	ɾˠɪn̠ʲəsˠ
sionnach	ʃɪn̪ˠah
broim	bˠɾˠɪmʲ
ligh	lʲɪɟ
cánacha	kɑːnˠəxə
cosán	kɔsˠɑːnˠ
litir	l̠ʲɪtʲəɾʲ
oibre	əibʲrʲə
cánacha	kɑːn̪ˠəxə
dara	d̪ˠɑɾˠə
magadh	mˠaɡu
mothú	muː
astu	ɑstə
chuici	hɛcɪ
fual	fˠuəlˠ
tréith	tʲɾʲeː
fortacht	fˠɔɾˠt̪əxt̪ˠ
tarraing	t̪ˠaɾʲɪɟ
ghlan	ɣlˠanˠ
cos	kʌsˠ
teoiric	tʲoːɾʲɪc
cinnire	cɪɲɪɾʲə
cáiliúil	kæːlʲulʲ
fágadh	fˠɑːɡəx
caoin	kiːnʲ
circ	cɪɾʲc
chreideadh	çɾʲɛdʲuː
dóthain	d̪ˠɔhənʲ
ciumhaiseanna	cuːʃən̪ˠiː
cluiche	klˠɪhə
asat	ɑsˠət̪ˠ
tair	t̪ˠaɾʲ
ngoid	ŋɛdʲ
té	tʲeː
trínarbh	tʲɾʲiːnˠəɾˠvˠ
capaill	kapil͈ʲ
seanduine	ʃan̪ˠd̪ˠɪnʲə
ceannaire	can̪ˠəɾʲə
tuilleadh	t̪ˠɪl̠ʲuː
póirse	pˠoːɾˠʃə
haithne	hæn̠ʲə
tiománaí	tʲəmˠɑːn̪ˠiː
chloisfeadh	xlˠɔʃətʲ
pacáil	pˠakælʲ
diabhal	dʲiəl̪ˠ
óstán	ɔːsˠt̪ˠænˠ
déantar	dʲeːn̪ˠt̪ˠəɾˠ
daoibh	dʲiːbʲ
chearnóg	çæːɾˠn̪ˠɔɡ
roinnt	ɾˠɪn̠ʲtʲ
eatarthu	at̪ˠɾˠəbˠ
briseadh	bʲɾʲɪʃətʲ
d'fhreastalaíodh	dʲɾʲasˠt̪ˠəlˠiːtʲ
geata	ɟat̪ˠə
tsál	t̪ˠæːlˠ
coin	kɪnʲ
táille	t̪ˠɑːl̠ʲə
dóthain	d̪ˠoːnʲ
támh	t̪ˠɑːw
biseach	bʲɪʃəx
cónaigh	koːnˠə
dhaoibh	jiːbʲ
cnuic	kn̪ˠɪc
feabhra	fʲauɾˠə
vicipéid	vʲɪcɪpʲeːdʲ
chóta	xɔːt̪ˠə
ár	ə
déag	dʲeːɡ
altfadh	al̪ˠt̪ˠu
feiceann	fʲɛcən̪ˠ
miotas	mʲʊt̪ˠəsˠ
balsamach	bˠalˠsˠəmˠəx
pingin	pʲiːn̠ʲ
luch	l̪ˠɔx
tairne	t̪ˠɑːɾˠn̠ʲə
nigh	nʲiː
cleite	clʲɛtʲə
sál	sˠæːlˠ
oibre	ɛbʲrʲə
gadaí	ɡəd̪ˠiː
ceangal	caŋəlˠ
oireachtas	ɛɾʲəxt̪ˠəsˠ
chúcha	xuːhə
malairt	mˠalˠəɾˠtʲ
leaga	l̠ʲaɡə
fachta	fˠɑxt̪ˠə
d'oileadh	d̪ˠɪlʲəx
airsean	ɛɾʲsən
nocht	n̪ˠɔxt̪ˠ
cheird	çəiɾˠdʲ
síneadh	ʃiːnʲə
naonúr	n̪ˠiːnˠuːɾˠ
cáin	kɑːnʲ
aisteoir	aʃtʲɔɾʲ
tarbh	t̪ˠɑɾˠəvˠ
maith	mˠaɪ
síneadh	ʃiːnʲətʲ
cara	kɑɾˠə
soirbis	sˠɔɾʲəbʲɪʃ
salach	sˠalˠah
leat	lʲat̪ˠ
cogar	kʌɡəɾˠ
scarúint	sˠkɑɾˠuːnʲtʲ
gearrán	ɟaɾˠanˠ
bláthaí	bˠl̪ˠɑːhiː
cúinne	kuːɲɪ
deiseal	dʲɛʃəlˠ
lasrach	l̪ˠasˠɾˠah
hait	hatʲ
beannacht	bʲan̪ˠəxt̪ˠ
eaglais	aɡlˠəʃ
fómhar	fˠoːɾˠ
mbriseadh	mʲɾʲɪʃəx
tráthnóna	t̪ˠɾˠɑːhoːn̪ˠə
baisteadh	bˠaʃtʲuː
fabht	fˠəut̪ˠ
macha	mˠaxə
chath	xah
bás	bˠæːsˠ
breabadh	bʲɾʲabˠə
cliabh	clʲiəvˠ
neipeailis	n̠ʲɛpʲalʲɪʃ
cáil	kɑːlʲ
ásc	æːsˠk
cruinne	kɾˠɪn̠ʲə
oraibh	ɔɾˠəvʲ
cál	kɑːlˠ
síoraí	ʃiːɾˠi
coróin	kəɾˠoːnʲ
dóibhsean	d̪ˠoːpˠsˠən
aiféalach	afʲeːləx
lóistín	l̪ˠɔːʃtʲinʲ
rísín	ɾˠiːʃinʲ
ionamsa	æn̪ˠəmˠsˠə
máistreás	mˠæːʃtʲɾʲæsˠ
moladh	mˠʌlˠətʲ
siar	ʃiəɾˠ
caitheamh	ka
barda	bˠæːɾˠdˠə
blarna	bˠlˠæːɾˠn̪ˠə
grámhar	ɡɾˠæːwəɾˠ
aige	ɪɟɛ
asainn	ɑsˠənʲ
caoineadh	kiːnʲəx
tabhairt	t̪ˠoːɾˠtʲ
siadsan	ʃiəd̪ˠsənˠ
gcuairteanna	ɡuəɾˠtʲən̪ˠə
oileáin	əlʲɑːnʲ
ea	a
bhó	wɔː
foraois	fʌɾˠiʃ
am	aumˠ
ag	ɪɟ
tá	t̪ˠɑː
lasann	l̪ˠasˠən̪ˠ
hiomlán	hʌmˠlˠænˠ
poiblí	pˠəibʲlʲiː
chaill	xɑːl̠ʲ
ceathrú	caɾˠhuː
scuabadh	sˠkuəbˠəvˠ
ábhar	ɑːwəɾˠ
turtar	t̪ˠʌɾˠt̪ˠəɾˠ
dearcadh	dʲaɾˠkəx
éirí	əiɾʲiː
breoite	bʲɾʲɔːtʲə
fhómhair	oːɾʲ
mholfadh	wɔlˠhətʲ
chos	xʌsˠ
lenár	lʲɛnˠɑːɾˠ
canadh	kanˠuː
tosach	t̪ˠɔsˠəx
mé	mʲeː
meánn	mʲɑːn̪ˠ
dóibh	d̪ˠoːbˠ
anfa	anˠəfˠə
creidim	cɾʲɛdʲəmʲ
cheannacht	çan̪ˠəxt̪ˠ
agam	əɣɑmˠ
donasach	d̪ˠʌnˠəsˠah
cleacht	clʲæxt̪ˠ
philéir	fʲəlʲeːɾʲ
deiseanna	dʲɛʃən̪ˠə
bacach	bˠakah
láthair	l̪ˠɑːɾʲ
ceannaigh	can̪ˠiː
'ur	uːɾˠ
sparán	sˠpˠaɾˠɑːnˠ
maite	mˠatʲə
oisín	ʌʃinʲ
ós	oːʃ
freastalaím	fʲɾʲasˠt̪ˠəlˠiːmʲ
téad	tʲiad̪ˠ
alta	al̪ˠt̪ˠə
tadhg	t̪ˠəiɡ
luaidhe	l̪ˠuːiː
mbriseadh	mʲɾʲɪʃu
bhfear	vʲæɾˠ
aithníonn	ahnʲiːn̪ˠ
spleách	sˠpʲlʲaːx
anraith	an̪ˠɾˠəh
téarma	tʲeːɾˠmˠə
feirg	fʲɛɾʲɪɟ
tionchar	tʲʊŋxəɾˠ
áthas	ɑːhəsˠ
bruach	bˠɾˠuəx
pósadh	pˠoːsˠəvˠ
miailíteas	mʲiəlʲiːtʲəsˠ
fhonn	uːn̪ˠ
aithreacha	æːɾʲəxiː
seise	ʃɛʃə
fanacht	fˠanˠəxt̪ˠ
rúnaí	ɾˠuːnˠiː
rite	ɾˠɪtʲə
coscairt	kɔsˠkəɾʲtʲ
phósfadh	fˠɔːsˠu
síle	ʃiːlʲə
cuardaigh	kuəɾˠd̪ˠɪɟ
fliuchadh	fʲlʲʊxə
chuardaigh	xuəɾˠd̪ˠɪɟ
crochadh	kɾˠɔxəvˠ
fáil	fˠɑːlʲtʲ
nós	n̪ˠoːsˠ
phlúr	fˠlˠuːɾˠ
troid	t̪ˠɾˠɪdʲ
acra	akɾˠə
spás	sˠpˠɑːsˠ
rith	ɾˠʊ
fionnghall	fʲuːnɣal
liach	l̠ʲiəx
feamainn	fʲamˠən̠ʲ
mháistreása	wæːʃtʲɾʲæsˠə
bpéin	bʲeːnʲ
óstán	oːsˠt̪ˠɑːn̪ˠ
gile	ɟɪlʲə
leastar	l̠ʲasˠt̪ˠəɾˠ
bhuail	wuəlʲ
freagra	fʲɾʲaɡəɾˠə
fós	fˠɔːsˠ
gcrainn	ɡɾˠiːn̠ʲ
naofa	n̪ˠeːfˠə
coicís	kəikiːʃ
cobra	kɔbˠɾˠə
ngairdín	ŋæːɾˠdʲinʲ
láma	l̪ˠɑːmˠə
piana	pʲiənˠə
gráin	ɡɾˠæːnʲ
d'ullmhaigh	d̪ˠʌl̪ˠwi
falsa	fˠal̪ˠsˠə
clúdach	klˠuːd̪ˠəx
halla	hal̪ˠə
scaitheamh	sˠka
aithníodh	ænʲiːvˠ
sagairt	sˠaɡəɾˠtʲ
eascann	asˠkən̪ˠ
de	dʲɛ
cinnidh	cɪn̠ʲə
breathnaigh	bˠɾˠæːn̪ˠə
dorn	d̪ˠoːɾˠn̪ˠ
cím	ciːmʲ
beithíoch	bʲɛhiəx
féinfhostaithe	fʲeːnʲosˠt̪ˠəhə
d'oilfeadh	d̪ˠɛlʲhəx
chuici	ɛcɪ
mairg	mˠaɾʲɪɟ
fearg	fʲaɾˠəɡ
cruth	kɾˠʊh
bandach	bˠɑn̪ˠd̪ˠəx
lúcháir	l̪ˠuːxɑːɾʲ
iontas	uːn̪ˠt̪ˠəsˠ
iníon	ɪnʲiːnʲ
glúine	ɡlˠuːnʲə
dochtúr	d̪ˠɔxt̪ˠuːɾˠ
nigh	n̠ʲiː
go	ɡə
feisigh	fʲɛʃiː
cluifí	kl̪ˠɪfʲiː
dhóthain	ɣɔhənʲ
gcuairt	ɡuəɾˠtʲ
greann	ɟɾʲɑːn̪ˠ
dáiríre	d̪ˠɑːɾʲiːɾʲə
amháin	əwɑːnʲ
tirim	tʲɛɾʲəmʲ
donn	d̪ˠəun̪ˠ
isteach	əʃtʲax
uaimh	uəvʲ
thiar	hiəɾˠ
brise	bʲɾʲɪʃə
leas	l̠ʲæsˠ
beachlann	bʲaxlən̪ˠ
péatar	pʲeːt̪ˠəɾˠ
leathanach	l̠ʲahənˠəx
coicís	kʌkəʃ
beag	bʲɛɡ
fomhuireán	fɔwərʲɑːnˠ
ngairdín	ŋɑːɾˠdʲiːnʲ
fuadh	fˠuəx
hithe	hɪhə
feabhas	fʲəusˠ
asaibh	ɑsˠiː
codail	kɔd̪ˠɪlʲ
spád	sˠpˠæːd̪ˠ
cuimhne	kiːvʲɾʲə
sáile	sˠɑːlʲə
láma	l̪ˠæːmˠə
eallach	al̪ˠəx
dtarbh	d̪ˠaɾˠuː
mharaigh	waɾˠə
ciumhais	cuːʃ
ndomhan	n̪ˠaʊən̪ˠ
bisigh	bʲɪʃə
seaicéad	ʃæːceːd̪ˠ
líoma	l̠ʲiːmˠə
dhúinn	ɣɪn̠ʲ
oilfidh	ɪlʲhɪɟ
craiceann	kɾˠɛcən̪ˠ
naoscach	n̪ˠiːsˠkah
goid	ɡɛdʲ
trach	t̪ˠɾˠɑx
corcaigh	kʌɾˠki
d'aithneodh	d̪ˠænʲəx
linne	l̠ʲɪn̠ʲə
liom	lʲʊmˠ
má	mˠɑː
ainneoin	an̠ʲɔnʲ
sobal	sˠʌbˠəlˠ
tugann	tˠʊɡən̪ˠ
cailleadh	kal̠ʲəx
mód	mˠoːd̪ˠ
miosúr	mʲɪsˠuːɾˠ
lite	l̠ʲɪtʲə
achadh	axuː
carraig	kɑɾˠɪɟ
goilim	ɡɛlʲəmʲ
bháis	vˠɑːʃ
aifreann	afʲɾʲən̪ˠ
chum	xʊmˠ
gnó	ɡɾˠoː
díbríodh	dʲiːbʲɾʲiːɡ
aiséirí	æʃəiɾʲə
sealg	ʃalˠəɡ
dáir	d̪ˠæːɾʲ
corrú	kɔɾˠuː
smál	sˠmˠæːlˠ
baisc	bˠaʃc
easóg	ɑsˠɔɡ
ngránaigh	ŋɾˠɑːn̪ˠɪɟ
dris	dʲɾʲɪʃ
agaibh	aɡəvʲ
póirse	pˠɔːɾˠʃə
caitliceach	katʲlʲɪcah
tuismigh	t̪ˠɪʃmi
ciúnas	cuːnˠəsˠ
dúnfad	d̪ˠuːnˠhəd̪ˠ
grád	ɡɾˠɑː
falla	fˠɑl̪ˠə
geasa	ɟasˠə
cairde	kæːɾˠdʲə
ionam	æn̪ˠəmˠ
cleachtadh	clʲaxt̪ˠətʲ
fheicfeadh	ɛcuː
fial	fʲiəlˠ
ghada	ɣad̪ˠə
gasúr	ɡasˠuːɾˠ
thuas	huəsˠ
arcán	aɾˠkanˠ
muintir	mˠiːn̠ʲtʲəɾʲ
aodh	iː
fill	fʲiːl̠ʲ
greim	ɟɾʲəɪmʲ
d'oileadh	d̪ˠɪlʲətʲ
foirfe	fˠɛɾʲəfʲə
orm	ɔɾˠəmˠ
cúntóir	kuːnˠt̪ˠoːɾʲ
spideog	spʲiːd̪ˠoːɡ
d'ainneoin	d̪ˠan̠ʲoːnʲ
cáil	kæːlʲ
dochar	d̪ˠʌxəɾˠ
long	l̪ˠuːŋɡ
brachán	bˠɾˠəxɑːnˠ
don	ɡənˠ
marbh	mˠɑɾˠəvˠ
muid	mˠɪdʲ
bogach	bˠəɡɑx
dtalamh	d̪ˠalˠə
cárb	kaːɾˠbˠ
spéis	sˠpʲeːʃ
inchinn	ɪɲçən̠ʲ
chúns	xuːn̪ˠsˠ
asat	asˠət̪ˠ
hail	halʲ
ith	ɪ
tachtadh	t̪ˠaxt̪ˠəx
iarraidh	iəɾˠi
chugat	xuːt̪ˠ
cuisle	kɪʃl̠ʲə
nó	n̪ˠoː
dán	d̪ˠæːnˠ
bogadh	bˠɔɡuː
aici	ɪcɪ
brad	bˠɾˠad̪ˠ
anall	ən̪ˠɑːl̪ˠ
gasúir	ɡasˠuːɾʲ
leaba	l̠ʲæːbˠə
rinn	ɾˠiːnʲ
gcaoirigh	ɡiːɾʲiː
tuir	t̪ˠɪɾʲ
béal	bʲeːl
daltach	d̪ˠal̪ˠt̪ˠah
dóthain	d̪ˠoːhənʲ
corraigh	kɔɾˠə
foighid	fˠəidʲ
bearach	bʲaɾˠax
tsál	t̪ˠɑːlˠ
dreancaid	dʲɾʲaŋkədʲ
scairteadh	sˠkaɾˠtʲəx
cíocrach	ciːkɾˠah
saora	sˠeːɾˠə
gnáth	ɡɾˠæː
moladh	mˠʌlˠu
reoiteog	ɾˠoːtʲoːɡ
athraím	æɾˠiːmʲ
freagairt	fʲrʲaɡəɾˠtʲ
léim	l̠ʲeːmʲ
dhíbh	jiːvʲ
dtalamh	d̪ˠalˠuː
sábháil	sˠɑːwɑːlʲ
bogearraí	bˠoɟəɾˠiː
gadhar	ɡəiɾˠ
casúr	kasˠuːɾˠ
cóngar	kuːŋɡəɾˠ
lucht	l̪ˠɤxt̪ˠ
glóire	ɡlˠoːɾʲə
aisling	aʃlʲɪɲ
síl	ʃiːlʲ
capall	kapˠəl̪ˠ
míol	mʲiːl
pratastúnach	pˠɾˠaːt̪ˠəsˠt̪ˠuːn̪ˠəx
múchadh	mˠuːxəx
seamróga	ʃamˠɾˠaɡə
caoineadh	kiːnʲəɡ
oibrithe	ɪbʲɾʲəhə
imleacán	imʲlʲəkænˠ
bhfiaradh	vʲiəɾˠəvˠ
faitíos	fˠatʲçəsˠ
shnámh	hn̪ˠæːw
gcoill	ɡiːlʲ
cheist	çɛʃtʲ
glóir	ɡlˠɔːɾʲ
ag	ə
bhfadhb	vˠəibˠ
uaigneas	uəɟnʲəsˠ
stábh	sˠt̪ˠæːw
chuimhnigh	xiːnʲɪɟ
gearradh	ɟɑːɾˠəvˠ
níochán	nʲiːxɑːn̪ˠ
bealtaine	bʲɑːl̪ˠt̪ˠənʲə
iarr	iəɾˠ
ceapadh	cæpˠəx
mair	mˠaɾʲ
aithnigh	ænʲə
curacha	kɤɾˠahə
eiteog	ɛtʲoːɡ
boireannach	bˠɛɾʲən̪ˠah
an	ənˠ
cúige	kuːɟɪ
ngnóthaí	n̪ˠuːiː
dearcadh	dʲaɾˠkə
lasadh	l̪ˠasətʲ
pháras	fˠæːɾˠəsˠ
comhrá	koːɾˠæ
aoi	iː
pá	pˠɑː
mhaoin	vʷiːnʲ
scuabadh	sˠkuəbˠəx
gearradh	ɟɑːɾˠətʲ
caitliceach	katʲlʲɪcəx
deacair	dʲakəɾʲ
tógaimid	t̪ˠoːɡəmʲədʲ
íosánach	iːsˠɑːnˠəx
dhom	ɣʊmˠ
snagcheol	sˠn̪aɡçoːlˠ
mart	mˠaɾˠtˠ
leagadh	l̠ʲaɡətʲ
maighdean	mˠəɪdʲənˠ
chuirfeadh	xɪɾˠhuː
athróidh	ɑɾˠoː
litre	l̠ʲitʲɾʲə
chugat	aɡədˠ
comharsanna	kuːɾˠsˠən̪ˠiː
póca	pˠɔːkə
iontach	uːn̪ˠt̪ˠəx
suí	sˠiː
dínn	dʲiːn̠ʲ
cum	kuːmˠ
pobail	pˠʌbˠəlʲ
long	l̪ˠɔŋ
más	mˠæːsˠ
gortú	ɡoɾˠt̪ˠuː
fógair	fˠoːɡəɾʲ
thuaidh	huə
bhealach	vʲalˠəx
snag	sˠn̪ˠaɡ
réitigh	ɾˠeːtʲə
álainn	ɑːliːn̠ʲ
feiceáil	fʲɛcælʲ
bhfuil	vˠɪlʲ
margadh	mˠaɾˠəɡə
bean	bʲæːnˠ
naí	n̪ˠiː
aonghuthach	eːn̪ˠɣʊhəx
mallacht	mˠal̪ˠəxt̪ˠ
samhradh	sˠəuɾˠə
aghaidh	əiɟ
rása	ɾˠɑːsˠə
teo	tʲoː
sorcas	sˠʌɾˠkəsˠ
gearb	ɟaɾˠəbˠ
uaire	uəɾʲə
milseáin	mʲɪlʲʃaːnʲ
mó	mˠuː
samhain	sˠaunʲ
bharr	bˠæːɾˠ
chaith	xɑh
mheas	vʲæːsˠ
samhradh	sˠəuɾˠu
critheann	crʲɪçən̪ˠ
prios	pɾʲɪsˠ
bleacht	bʲlʲaxt̪ˠ
crann	kɾˠɑːn̪ˠ
ghnách	ɣn̪ˠɑːx
ascaill	asˠkəl̠ʲ
sábh	sˠɑːw
bas	bˠasˠ
acadamh	akəd̪ˠu
tháinig	hæːnʲɪc
vása	wɑːsˠə
donncha	d̪ˠʊn̪ˠəxə
phianfadh	fʲiənˠhəx
uaigh	uə
suíomh	sˠiːvˠ
nollag	n̪ˠɔl̪ˠəɡ
sluasad	sˠl̪ˠuəsˠəd̪ˠ
d'éalaigh	dʲial̪ˠɪɟ
pluma	pˠlˠʊmˠə
mór	mˠoːɾˠ
léigh	lʲeːɟ
miotal	mʲɪt̪ˠəlˠ
gruag	ɡɾˠuəɡ
cinneadh	cɪn̠ʲətʲ
ceathair	cahəɾʲ
naonúr	n̪ˠeːn̪ˠuːɾˠ
mháire	wɑːɾʲə
bharúil	waɾˠulʲ
miongháire	mʲɪnˠɣaːɾʲə
deirfiúr	dʲɛɾʲəhuːɾˠ
tá	t̪ˠæː
phearsana	fʲaɾˠsˠənˠə
aithneachtáil	ænʲəxt̪ˠɑːlʲ
foghar	fˠauɾˠ
crua	kɾˠuə
is	ʃ
grá	ɡɾˠæː
ciseáin	cɪʃænʲ
carbónach	kəɾˠəbˠoːn̪ˠəx
athraithe	ahɾˠɪhə
seachas	ʃɔxəsˠ
déanamh	dʲian̪ˠə
aontaím	eːn̪ˠt̪ˠiːmʲ
buan	bˠuənˠ
teas	tʲæsˠ
cúnamh	kuːn̪ˠəvˠ
ciarán	ciəɾˠɑːnˠ
gnás	ɡnˠɑːsˠ
ngeall	ɲɑːl̪ˠ
féinspéis	fʲeːnʲsˠpʲeːʃ
oide	ɛdʲə
péinteáil	pʲeːn̠ʲtʲɑːlʲ
oileadh	ɪlʲəx
bhfear	vʲaɾˠ
ngeall	ɲaul̪ˠ
banna	bˠanˠə
déanaí	dʲeːn̪ˠi
déad	dʲeːd̪ˠ
tseamróg	tʲamˠɾˠaɡ
seán	ʃæːn̪ˠ
deinim	dʲɪnʲɪmʲ
baisteadh	bˠaʃtʲəvˠ
sinsear	ʃɪn̠ʲsʲəɾˠ
foghar	fˠeːɾˠ
seasamh	ʃasˠə
d'fhreastail	dʲɾʲasˠt̪ˠəlʲ
ollscoil	ɔl̪ˠsˠkɔlʲ
galach	ɡalˠah
fiú	fʲuː
chugham	xuːmˠ
aréir	əɾʲeːɾʲ
feiceadh	fʲɛcəx
freastalaíodh	fʲɾʲasˠt̪ˠəlˠiːvˠ
tairg	t̪ˠaɾʲɪɟ
breathnú	bˠɾˠæːn̪ˠuː
hanamhaith	hɑn̪ˠəvˠɑh
ráth	ɾˠæː
éadach	eːd̪ˠəx
limis	l̠ʲɪmʲɪʃ
praiseach	pˠɾˠaʃah
bunaigh	bˠʊn̪ˠɪɟ
piocadh	pʲɪkətʲ
leictreachas	l̠ʲɛctʲɾʲahəsˠ
tuairisceoir	t̪ˠuˑəɾʲɪʃcoːɾʲ
fíniúin	fʲiːnʲunʲ
fáth	fˠɑː
fhéidir	eːdʲəɾʲ
dínne	dʲiːn̠ʲə
imigh	ɪmʲə
láidir	l̪ˠɑːdʲəɾʲ
d'inseodh	dʲiːnʲʃoːtʲ
'ad	ɑt̪ˠ
suaimhneach	sˠiːmʲɾʲəx
bródúil	bˠɾˠoːd̪ˠuːlʲ
slán	sˠlˠæːnˠ
sibh	ʃɪvʲ
oilfeadh	ɪlʲhətʲ
caithfidh	kahiː
sin	ʃɪnʲ
sorcha	sɔɾˠəxə
scuabadh	sˠkuəbˠu
coileach	kəlʲax
gliceas	ɟlʲɪcəs
pógadh	pˠɔːɡu
mola	mˠɔlˠə
níochán	nʲiːxæn̪ˠ
scriúta	ʃcɾʲuːt̪ˠə
seadadh	ʃad̪ˠəɡ
bacadh	bˠaku
saora	sˠiːɾˠə
roinnt	ɾˠiːn̠ʲtʲ
craiceann	kɾˠɪcən̪ˠ
urlár	uːɾˠl̪ˠɑːɾˠ
imní	ɪmʲɾʲiː
grád	ɡɾˠæː
fearr	fʲaːɾˠ
faoinár	fˠiːnˠɑːɾˠ
gairdín	ɡæːɾˠdʲinʲ
sráid	sˠɾˠæːdʲ
maitheamh	mˠahu
cearnóga	cɑːɾˠn̪ˠoːɡə
aithinne	æhən̠ʲə
duid	d̪ˠɪdʲ
d'éirigh	dʲiːɾʲi
iúr	uːɾˠ
clogaid	klˠɔɡədʲ
mholadh	wɔlˠu
chrann	xɾˠɑːn̪ˠ
bharúil	waɾˠuːlʲ
ordóg	əuɾˠd̪ˠoːɡ
amhráin	əuɾˠɑːnʲ
mbí	mʲiː
díot	dʲiːt̪ˠ
dte	dʲɛ
bhur	uːɾˠ
beidh	bʲɛj
gobadh	ɡʌbˠətʲ
scoileanna	sˠkɛlʲən̪ˠə
stiofán	ʃtʲəfˠɑːn̪ˠ
cuibhrinn	kɪvʲɾʲən̠ʲ
atá	ət̪ˠæː
inteacht	ɪn̠ʲtʲəxt̪ˠ
ceangail	caŋəlʲ
grúdaire	ɡɾˠuːd̪əɾʲə
caoineas	kiːnʲəsˠ
díreacha	dʲiːɾʲaxə
breoiteacht	bʲɾʲɔːtʲaht̪ˠ
bíobla	bʲiːbˠl̪ˠə
fógra	fˠɔːɡɾˠə
gcnoic	ɡnˠɪc
seachas	ʃæxəsˠ
arcán	aɾˠkɑːnˠ
ngráin	ŋɾˠɑːnʲ
milliún	mʲil̠ʲuːnˠ
dise	dʲɪʃə
fhírinne	iːɾʲɪɲɪ
triomach	tʲɾʲɪməx
ardchlár	æːɾˠd̪ˠxlˠæːɾˠ
bhuntáiste	wˠʊn̪ˠt̪ˠɑːʃtʲə
gairdín	ɡɑːɾˠdʲiːnʲ
liathróid	l̠ʲiəhɾˠoːdʲ
déarfadh	dʲeːɾˠhətʲ
comhair	koːrʲ
foscadh	fˠasˠkə
chara	xɑɾˠə
bearr	bʲɑːɾˠ
ainmhí	anʲəvʲiː
torainn	t̪ˠʌɾˠən̠ʲ
leagfaidh	l̠ʲakɪɟ
páidín	pˠæːdʲinʲ
cacht	kaxt̪ˠ
dúid	d̪ˠuːdʲ
ionam	ɪnəmˠ
iompaigh	ʊmˠpˠə
athrú	ahɾˠuː
clé	clʲeː
gcurach	ɡɤɾˠah
rásúr	ɾˠɑːsˠuːɾˠ
easpa	æspə
fhear	aɾˠ
saoi	sˠiː
damhsaigh	d̪ˠausˠə
'spáin	spˠɑːnʲ
ceapadh	capˠuː
meireacá	mʲɛɾʲəkɑː
airsean	ɛɾʲʃənˠ
mhór	vˠoːɾˠ
faoi	fˠiː
cuma	kʊmˠə
íosfaidh	iːsə
goidte	ɡɪtʲə
dearcadh	dʲaɾˠkəvˠ
dún	d̪ˠuːnˠ
fáil	fˠæːlʲ
trínár	tʲɾʲiːnˠɑːɾˠ
meiriceá	mʲɛɾʲəcaː
bál	bˠɑːlˠ
mbláthanna	mˠl̪ˠæhən̪ˠə
ghairid	ɣaɾʲədʲ
cóiste	koːʃtʲə
bó	bˠoː
gcuireadh	ɡɪɾʲuː
ól	ɔːlˠ
deargadh	dʲaɾˠəɡəɡ
dhubh	ɣʊvˠ
aifreannacha	afʲɾʲən̪ˠəxiː
tsín	tʲiːnʲ
gcuan	ɡuənˠ
briseadh	bʲɾʲɪʃə
cairéad	kaɾʲiad̪ˠ
thanaic	hanˠɪc
bod	bˠʌd̪ˠ
fios	fʲɪsˠ
bhfillfeadh	vʲiːlʲhəx
fhiaradh	iəɾˠu
ciumhaise	cuːʃə
scrúdaigh	sˠkɾˠuːd̪ˠiː
eagla	aɡlˠə
catán	kat̪ˠɑːnˠ
cuardaigh	kuəɾˠd̪ˠə
éadrom	eːd̪ˠɾˠəmˠ
troithe	t̪ˠɾˠɪhə
tachtadh	t̪ˠaxt̪ˠə
bhfeaca	vʲakə
leon	l̠ʲuːnˠ
gránaigh	ɡɾˠæːnˠi
báille	bˠæːl̠ʲiː
tarlú	t̪ˠɑːɾˠl̪ˠuː
cuimhne	kɪmʲnʲə
aimhleas	ɑvl̠ʲas
bhíobhair	vʲiːwəɾʲ
glan	ɡlˠanˠ
snáite	sˠn̪ˠæːtʲə
dúigh	d̪ˠuːɟ
dhíot	iːt̪ˠ
beaga	bʲɞɡə
rath	ɾˠɑh
oscar	ɔsˠkəɾˠ
bhfeadh	vʲaw
aingeal	æɲɟəl
thír	hiːɾʲ
veigeán	vʲɛɟænˠ
traochta	t̪ˠɾˠiːxt̪ˠə
phiocadh	fʲʊkə
fód	fˠoːd̪ˠ
tanaí	t̪ˠɑniː
torainn	t̪ˠɔɾˠən̠ʲ
peirsil	pʲɛɾʲʃəlʲ
againne	æn̠ʲə
gadaí	ɡad̪ˠi
dhaingníodar	ɣaɲɟənʲiːd̪ˠəɾˠ
leafaos	l̠ʲafˠiːsˠ
leatsa	lʲat̪ˠsˠə
pholainn	fˠʌlˠən̠ʲ
ionad	ʊn̪ˠəd̪ˠ
aistritheoir	aʃtʲɾʲəhoːɾʲ
aisling	aʃlʲənʲ
deise	dʲɛʃə
aibhneacha	əivʲnəxə
altann	al̪ˠt̪ˠən̪ˠ
ainm	ænəmʲ
leosan	lʲoːpˠsˠənˠ
dán	d̪ˠɑːn̪ˠ
ndomhan	n̪ˠoːən̪ˠ
scairteadh	sˠkaɾˠtʲu
íosa	iːsˠə
ligeann	l̠ʲɪɟən̪ˠ
glanadh	ɡlˠanˠəx
bearna	bʲɑːɾˠn̪ˠə
sionnach	ʃɪn̪ˠəx
bhriseadh	vʲɾʲɪʃətʲ
ród	ɾˠoːd̪ˠ
leabhar	l̠ʲəuɾˠ
greannach	ɟrʲan̪ˠəx
bearradh	bʲaɾˠəx
oirthear	eɾʲhəɾˠ
bláfar	bˠlˠɑːfˠəɾˠ
obair	ɔbˠəɾʲ
naoscach	n̪ˠiːsˠkəx
ceirnín	cɛɾˠn̠ʲiːnʲ
fad	fˠad̪ˠ
maiseach	mˠaʃah
bháis	wɑːʃ
snámh	sˠn̪ˠɑːvˠ
béim	bʲeːmʲ
siad	ʃeːd̪ˠ
aithin	æn
saraiste	sˠaɾˠəʃtʲə
sliabh	ʃl̠ʲiəvˠ
éireannach	eːɾʲən̪ˠah
culaith	kʌlˠi
francach	fˠɾˠaːŋkəx
aithním	æn̠ʲiːmʲ
freastalaí	fʲɾʲasˠt̪ˠəlˠi
spáinn	sˠpˠɑːɲ
teastaigh	tʲasˠt̪ˠəɟ
alltracha	ɑl̪ˠt̪ˠɾˠəxə
lasa	l̪ˠasˠə
goirt	ɡɪɾˠtʲ
cineál	cɪnʲɑːl̪ˠ
ál	ɑːl̪ˠ
túr	t̪ˠuːɾˠ
banda	bˠan̪ˠd̪ˠə
uaibh	wɛbʲ
tuath	t̪ˠuəh
páistí	pˠæːʃtʲi
aoibheallach	iːvʲəl̪ˠah
miotas	mʲɪt̪ˠəsˠ
slisne	ʃl̠ʲɪʃn̠ʲə
phota	fˠɔt̪ˠə
iarann	iəɾˠən̪ˠ
coileán	kɪlʲaːn̪ˠ
leithid	l̠ʲeːdʲ
reo	ɾˠoː
cúigiú	kuːɟu
mhúchadh	wuːxəx
ghoid	ɣɛdʲ
oibre	ɛbʲərʲə
eireaball	ɾˠɨbˠəl̪ˠ
arabach	aɾˠəbˠəx
ngealach	ɲalˠəx
déin	dʲeːnʲ
cothaigh	kohə
sinéad	ʃənʲeːd̪ˠ
ceas	casˠ
fonn	fˠəun̪ˠ
carraig	kaɾˠəc
gobadh	ɡɔbˠətʲ
crom	kɾˠuːmˠ
ghabhais	ɣəiʃ
sionnach	ʃɪn̪ˠɑx
tógaim	t̪ˠɔːɡəmˠ
mhóir	vˠoːɾʲ
rásúirí	ɾˠɑːsˠuːɾʲiː
múinid	mˠuːnʲədʲ
brú	bˠɾˠuː
rinneadar	ɾˠɪn̠ʲəd̪ˠəɾˠ
aisteach	aʃtʲəx
casfaidh	kasˠə
chinn	çiːn̠ʲ
bheith	vʲɛ
éirí	əiɾʲə
éidí	eːdʲi
inste	ɪn̠ʲʃtʲə
dhíbh	ɣiːbʲ
codladh	kʌl̪ˠu
díbh	d̪ˠiːbʲ
craos	kɾˠeːsˠ
fúthusan	fˠuːpˠsˠən
scuabadh	sˠkuəbˠətʲ
trá	t̪ˠɾˠæː
dreoite	dʲɾʲoːtʲə
oileánach	əlʲɑːn̪ˠəx
anamnacha	an̪ˠəmˠn̪ˠəxiː
ádhúil	ɑːwəl
seomra	ʃuːmˠɾˠə
fútsa	fˠuːt̪ˠsˠə
gcuraigh	ɡʊɾˠi
déantóir	dʲeːn̪ˠt̪ˠoːɾʲ
mbeas	mʲɛɪsˠ
chairde	xæːɾˠdʲə
bainne	bˠan̠ʲə
flaith	fˠlˠah
pinginí	pʲɪɲɟənʲiː
tomhais	t̪ˠuːʃ
astusan	ɑsˠt̪ˠəpˠsˠən
árasán	ɑːɾˠəsˠɑːn̪ˠ
madadh	mˠad̪ˠə
folamh	fˠɔlˠuː
tanaíocha	t̪ˠanˠiːxə
múchadh	mˠuːxətʲ
poncán	pˠʊŋkɑːnˠ
gcaoirigh	ɡiːɾʲi
beár	bʲaːɾˠ
deich	dʲɛç
más	mˠæːʃ
phlainc	fˠlˠaɲc
fanacht	fˠɑnˠəxt̪ˠ
seas	ʃasˠ
airigh	aɾʲɪɟ
tilleadh	tʲɪl̠ʲə
rann	ɾˠanˠ
d'inseodh	dʲiːnʲʃoːx
trua	t̪ˠɾˠuəj
d'aithníodh	dˠahnʲiːtʲ
donncha	d̪ˠʌn̪ˠaxə
faocha	fˠiːxə
lear	l̠ʲaɾˠ
mucár	mˠʊkɑːɾˠ
ngobadh	ŋʌbˠətʲ
fiaradh	fʲiəɾˠu
ónarb	oːnˠəɾˠbˠ
chugam	amˠ
tosach	t̪ˠʌsˠah
'ad	ɑːt̪ˠ
liomsa	lɞmˠsˠə
cailleadh	kal̠ʲəɡ
bóthair	bɔhəɾʲ
fliuch	fʲlʲɔx
faoinarbh	fˠiːnˠəɾˠvˠ
árasáin	ɑːɾˠəsˠɑːnʲ
clogaide	klˠʌɡədʲə
gairleog	ɡɑːɾˠlʲaɡ
piliúr	pʲɛlʲuːɾˠ
tirim	tʲɪɾʲəmʲ
péin	pʲeːnʲ
uaisle	uəʃl̠ʲə
bunús	bʊnˠuːsˠ
plódaithe	pˠlˠɔːd̪ˠɪhə
cuntais	kuːn̪ˠt̪ˠəʃ
cluiche	klˠiː
cleachtadh	clʲæxt̪ˠə
ros	ɾˠɔsˠ
eastóinis	asˠtˠoːnʲɪʃ
caighdeánach	kəidʲaːn̪ˠəx
ghlúine	ɣluːnə
spriogadh	sˠpʲɾʲʊɡəx
leac	l̠ʲak
oilfidh	ɛlʲhɪɟ
billí	bʲɪlʲiː
fút	fˠuːt̪ˠ
muise	mˠɪʃə
lomabharróg	l̪ˠɔmˠəvˠɑɾˠoːɡ
siúil	ʃuːlʲ
tusa	t̪ˠʊsˠə
gadaí	ɡad̪ˠiː
ndomhan	n̪ˠaʊn̪ˠ
cliabh	clʲiəw
iarraidh	iəɾˠiː
murach	mˠʊɾˠəx
ospidéal	ɔsˠpʲədʲeːlˠ
bean	bʲanˠ
mhine	vʲɪnʲə
dháréag	ɣɑːɾˠeːɡ
fhágadh	ɑːɡətʲ
glanadh	ɡlˠanˠəvˠ
chéile	çeːlʲə
gol	ɡɔl̪ˠ
samhain	sˠɑvˠən
bagún	bˠaɡuːnˠ
tinneas	tʲɪn̠ʲəsˠ
cistin	cɪʃtʲənʲ
shínigh	hiːnʲɪɟ
sínigh	ʃiːnʲi
leanbh	l̠ʲanˠu
galún	ɡalˠunˠ
dhom	ɣəmˠ
príomhchathair	pˠɾˠiːvˠxaːɾʲ
rása	ɾˠæːsˠə
bodach	bˠʌd̪ˠah
eicínt	əciːn̠ʲtʲ
miosúr	mʲɪsˠuɾˠ
brón	bˠɾˠuːn̪ˠ
faitíos	fˠaːtʲiəsˠ
plúir	pˠlˠuːɾʲ
leith	l̠ʲɛh
colún	kʌlˠunˠ
túisce	t̪ˠuːʃcɪ
tuirne	t̪ˠuːɾˠn̠ʲə
dhéanfadh	jiːnətʲ
cearnóg	cæːɾˠn̪ˠɔɡ
chúig	xuːɟ
taibhse	t̪ˠəiʃə
deilbh	dʲɛlʲəvʲ
eadraibhse	aːt̪ˠɾˠiːʃə
sinsir	ʃiːn̠ʲsʲəɾʲ
bacacha	bˠakahə
goil	ɡɛlʲ
cailleadh	kɑːl̠ʲətʲ
ag	ɪɟə
beanna	bʲan̪ˠə
chion	çɪnˠ
sínid	ʃiːnʲidʲ
cognadh	kɔɡnuː
gránna	ɡɾˠɑːn̪ˠə
guid	ɡɪdʲ
mharbh	vˠɑɾˠəvˠ
gairid	ɡaɾʲədʲ
croíúil	kɾˠiːulʲ
saoileann	sˠiːlʲən̪ˠ
gabha	ɡəu
imigh	ɪmʲɪɟ
bith	bʲɪh
d'fheiceadh	dʲɛcətʲ
ónar	oːnˠəɾˠ
gcurach	ɡɤɾˠax
isteach	əʃtʲæx
againn	aɡən̠ʲ
diarmaid	dʲiəɾˠmˠədʲ
deireadh	dʲɛɾʲəx
sínigh	ʃiːnʲɪɟ
neamh	nʲavˠ
ospidéal	ɔsˠpʲədʲeːl̪ˠ
tnúth	t̪ˠɾˠuː
maireann	mˠɛɾʲən̪ˠ
comórtas	kəmˠoːɾˠt̪ˠəsˠ
lacha	l̪ˠaxə
soiléir	sˠʌlʲeɾʲ
colún	kɔlˠuːnˠ
compordach	kuːmˠpˠoːɾˠd̪ˠəx
mall	mˠɑul̪ˠ
iomrá	ʊmɾˠɑː
báthair	bɑːhəɾʲ
bromach	bˠɾˠɤmˠax
dónall	d̪ˠuːnˠəl̪ˠ
gcuireadh	ɡɪɾʲəx
déantóir	dʲæːn̪ˠt̪ˠɔɾʲ
shuigh	hɪɟ
catán	kət̪ˠɑːn̪ˠ
b'fhearr	bʲɑːɾˠ
focal	fˠʌkəlˠ
aríst	əɾʲiːʃtʲ
geansaí	ɟanˠsˠiː
aithinne	æhn̠ʲə
talamh	t̪ˠalˠu
caol	keːl̪ˠ
imeacht	ɪmʲaxt̪ˠ
uafás	uːhɑːsˠ
ticéad	tʲɪceːd̪ˠ
fréamhacha	fʲɾʲeːwəxə
ndoirse	n̪ˠɔɾˠʃə
saothar	sˠiːɾˠ
mbeid	mʲɛdʲ
chuaigh	fˠuəj
bliain	bʲlʲiənʲ
d'altfadh	d̪ˠal̪ˠt̪ˠəx
piléir	pʲɪlʲeɾʲ
gaillimh	ɡal̠ʲɪvʲ
féile	fʲeːlʲə
ceo	cɔː
veinéiseach	vʲɛnʲeːʃəx
léimt	l̠ʲeːmʲtʲ
fhaightear	ahaɾˠ
saoradh	sˠiːɾˠuː
lag	l̪ˠaɡ
suím	sˠiːmʲ
péire	pʲeːɾʲə
litiam	l̠ʲɪtʲiəmˠ
fillfir	fʲiːlʲhərʲ
eadhon	aːən
mhuire	wɪɾʲə
tabhair	t̪ˠuːɾʲ
bró	bˠɾˠoː
eaglais	aːɡlˠəʃ
déanamh	dʲeːnˠu
brobh	bˠɾˠɔvˠ
chonaic	xɔnˠɪc
samhlú	sˠəul̪ˠuː
iontas	ʌn̪ˠt̪ˠəsˠ
curach	kʊɾˠəx
broim	bˠɾˠaimʲ
rinneadh	ɾˠɪnʲu
oilim	ɛlʲəmʲ
call	kal̪ˠ
tuite	t̪ˠɪtʲə
cheada	çæːd̪ˠə
di	dʲɪ
cáit	kæːtʲ
dhóigh	ɣoː
aoibhinn	iːvʲən̠ʲ
dom	d̪ˠəmˠ
spáinne	sˠpˠæːn̠ʲə
cheannacht	çan̪ˠaxt̪ˠ
fíniúnach	fʲiːnʲuːn̪ˠəx
stéig	ʃdʲeːɟ
ciseán	cɪʃaːn̪ˠ
buíochas	bˠiəxəsˠ
cuimhnigh	kɪvʲnʲiː
bhisigh	vʲɪʃiː
aithním	æniːmʲ
árannach	ɑːɾˠən̪ˠəx
uirthise	ɞɾˠəʃə
canúnach	kanˠuːnˠəx
pósad	pˠoːsˠəd̪ˠ
áit	æːtʲ
cruan	kɾˠuənˠ
airgid	æːɾʲəɟədʲ
oisín	əʃiːnʲ
ghobadh	ɣɔbˠətʲ
bualadh	bˠuəlˠə
chuimhnigh	xɪvʲnʲiː
chugainne	hɞn̠ʲə
dtalamh	d̪ˠalˠu
cleas	clʲasˠ
oilfeadh	ɪlʲhu
thusa	hʊsˠə
úsáideach	uːsˠɑːdʲəx
riug	ɾʲʊɡ
oifig	ɔfʲɪc
ógánach	ɔːɡænˠah
óg	oːɡ
bolcán	bɔlˠkænˠ
coisrig	kɛʃɾʲɪc
cláirseach	klˠɑːɾˠʃəx
culaith	kl̪ˠɪh
tibhe	tʲɪvʲə
fheiceadh	ɛcəx
fás	fˠæːsˠ
créatúr	cɾʲeːt̪ˠuːɾˠ
blarnan	bˠlˠæːɾˠn̪ˠənˠ
stócach	sˠt̪ˠɔːkah
leaca	l̠ʲakə
ár	æːɾˠ
bhfeiceanna	vʲɛcən̪ˠə
bhealach	vʲalˠah
sholas	hʌlˠəsˠ
phrioc	fʲɾʲʊk
dusta	d̪ˠʊsˠt̪ˠə
lasta	l̪ˠasˠt̪ˠə
greannmhar	ɟɾʲan̪ˠuːɾˠ
liom	lʲɞmˠ
luígí	l̪ˠəiɟiː
cearnóige	cɑːɾˠn̪ˠoːɟə
toghchán	t̪ˠəuxɑːn̪ˠ
casúr	kasˠuɾˠ
ainmneacha	anʲəmʲnʲəxə
abraid	abˠɾˠədʲ
bascais	bˠasˠkəʃ
geas	ɟasˠ
tiomáint	tʲɪmæn̠ʲtʲ
grian	ɟɾʲiənˠ
cinnte	ciːn̠ʲtʲə
asaibhse	asˠəvʲʃə
albain	aləbˠənʲ
saoirse	sˠiːɾˠʃə
gcaoirigh	ɡiːɾʲə
chasadh	xɑsˠə
cairéad	kaɾʲeːd̪ˠ
ceapadh	capˠu
sú	sˠuː
ceannacht	can̪ˠaxt̪ˠ
sáil	sˠɑːlʲ
suim	sˠiːmʲ
báire	bˠæːɾʲə
féicheamh	fʲeːhəvˠ
feadha	fʲæː
greann	ɟɾʲan̪ˠ
fara	fˠaɾˠə
cairt	kaɾˠtʲ
tiocfad	t̪ˠʊkəd̪ˠ
fírinne	fʲiːɾʲɪɲɪ
chasadh	xasˠətʲ
libhse	lʲɪpʲʃə
bruscar	bˠɾˠʊsˠkəɾˠ
bláthach	bˠl̪ˠɑːhəx
taos	t̪ˠeːsˠ
páí	pˠɑːiː
piocadh	pʲʊkuː
dhíbh	iːbʲ
réim	ɾˠeːmʲ
pingin	pʲɪɲənʲ
amáireach	əmˠɑːɾʲəx
tuismigh	t̪ˠɪʃmiː
baisteadh	bˠaʃtʲəx
gleo	ɟlʲoː
cinneadh	cɪn̠ʲu
bard	bˠɑːɾˠd̪ˠ
uibhe	ɪvʲə
chrainn	xɾˠiːnʲ
séú	ʃeːuː
deartháireacha	dʲæːɾˠhəɾʲaxə
briseann	bʲɾʲɪʃən̪ˠ
amha	awə
árasán	æːɾˠəsˠanˠ
déanamh	dʲanˠu
eala	alˠə
dhom	əmˠ
bun	bˠʌnˠ
plána	pˠlˠæːnˠə
orainn	əɾˠən̠ʲ
mhúchadh	wuːxə
léigh	lʲeːj
éinne	eːnʲə
punt	pˠuːn̪ˠt̪ˠ
eithne	ɛhnʲə
oileadh	ɪlʲuː
ró	ɾˠoː
treoir	tʲɾʲɔːɾʲ
halbain	haləbˠənʲ
grá	ɡɾˠɑː
ár	ɑːɾˠ
acadamh	akəd̪ˠəvˠ
cuimhniú	kiːmʲɾʲuː
bláthanna	bˠl̪ˠæhən̪ˠə
cruinn	kɾˠiːnʲ
d'ainneoin	d̪ˠan̠ʲɔnʲ
canadh	kanˠətʲ
áirithe	æːɾʲəhə
binn	bʲɪnʲ
capaill	kapˠəl̪ʲ
dé	dʲeː
chuige	xɪɟɪ
coinníoll	kɪn̠ʲiːl̪ˠ
maidin	mˠadʲənʲ
dreoigh	dʲɾʲoːɟ
tairbhe	t̪ˠaɾʲəvʲə
nua	n̪ˠuə
foláir	fʲlʲɑːɾˠ
mearadh	mʲaɾˠuː
cnámh	knaːvʲ
altfaidh	al̪ˠt̪ˠə
paráiste	pˠʊɾˠɑːʃtʲə
míosa	mʲiːsˠə
cogadh	kɔɡətʲ
bhfiaradh	vʲiəɾˠəɡ
ubh	uː
puball	pˠʊbˠəl̪ˠ
pháirt	fˠɑːɾˠtʲ
geall	ɟal̪ˠ
dúlamán	d̪ˠuːlˠəmˠænˠ
tarbh	t̪ˠaɾˠu
geac	ɟak
súil	sˠuːlʲ
fuadh	fˠuəvˠ
claidh	kl̪ˠəiɟ
athraigh	aɾˠə
lenar	lʲɛnˠəɾˠ
leanbh	lʲan̪ˠə
saill	sˠæl̠ʲ
balbh	bˠalˠəvˠ
ansin	ən̪ˠʃɪnʲ
sásta	sˠɑːsˠt̪ˠə
de	ɡə
sráid	sˠɾˠɑːdʲ
nímid	n̠ʲiːmʲədʲ
fiar	fʲiəɾˠ
teastas	tʲasˠt̪ˠəsˠ
bhfeadh	vʲaɡ
nó	n̪ˠuː
ainbhios	ɛnʲəvʲɪsˠ
cleachtadh	clʲæxt̪ˠəx
mholadh	wɔlˠətʲ
feoil	fʲɔːlʲ
anseo	in̠ʲʃɔ
gheala	jalˠə
pobal	pˠɔbˠəlˠ
seasamh	ʃasˠəvˠ
phian	fʲiənˠ
acra	ɑkɾˠə
gabha	ɡəuə
feoil	fʲoːlʲ
deargadh	dʲaɾˠəɡu
chos	xɔsˠ
chasán	xɑsˠɑnˠ
cata	kat̪ˠə
bacaí	bˠaki
mí	mʲiː
fáilt	fˠɑːlʲtʲ
eite	ɛtʲə
chí	çiː
téana	tʲia̯n̪ˠə
dheireadh	jɛɾʲu
innealtóir	inʲəlˠt̪ˠoːɾʲ
fuiseog	fˠəʃoːɡ
díot	d̪ˠiːt̪ˠ
droichead	d̪ˠɾˠɛhəd̪ˠ
creideamh	cɾʲɛdʲəvˠ
lasracha	l̪ˠasˠɾˠahə
spreagadh	sˠpʲɾʲaɡəvˠ
uachtarán	uəxt̪ˠəɾˠɑːnˠ
ach	ax
sorcas	sˠɔɾˠkəsˠ
franc	fˠɾˠaŋk
ceithre	cɛɾʲə
chucu	akəbˠ
nóra	n̪ˠuːɾˠə
bacaigh	bˠakə
phá	fˠɑː
seas	ʃæsˠ
trá	t̪ˠɾˠɑːɟ
arán	əɾˠɑːn
chuir	xɪɾʲ
socraigh	sˠɔkɾˠə
d'ullmhaigh	d̪ˠʊl̪ˠwiː
slaghdán	sˠl̪ˠəid̪ˠɑːn̪ˠ
caoimhe	kiːvʲə
gcurach	ɡɔɾˠəx
piléar	pʲlʲeːɾˠ
gá	ɡɑː
suaimhneas	sˠuənʲəsˠ
clois	klˠɔʃ
scuabadh	sˠkuəbˠəɡ
ostair	ɔsˠt̪ˠəɾʲ
chugaibh	ɑɡiː
díreach	dʲiːɾʲəx
leagan	l̠ʲæɡən̪ˠ
pite	pʲɪtʲə
éalaigh	eːlˠi
tíor	tʲiːɾˠ
dté	dʲeː
risteard	ɾˠɪʃtʲɑːɾˠd̪ˠ
cóir	kɔːɾʲ
casán	kɑsˠɑnˠ
chearnóg	çaːɾˠn̪ˠoːɡ
crúca	kɾˠuːkə
pacáil	pˠakɑːlʲ
den	dʲənˠ
lúbtha	l̪ˠuːpˠə
cuardaigh	kuəɾˠd̪ˠi
beag	bʲɔɡ
aige	ɛɟ
fómhar	fˠuːwəɾˠ
áil	æːlʲ
leagfadh	l̠ʲakuː
tuismigh	t̪ˠɪʃmɪɟ
déarfadh	dʲeːɾˠhu
bolcáin	bɔlˠkɑːnʲ
daoibh	d̪ˠiːvʲ
tuirseach	t̪ˠɔɾˠʃəx
shuigh	hiː
iascaireacht	iəsˠkəɾʲəxt̪ˠ
craiceann	kɾˠacən̪ˠ
bláthaí	bˠlɑhiː
aithne	æːnʲə
tóg	t̪ˠɔːɡ
galach	ɡəl̪ˠɑx
ríomhleabhar	ɾʲiːwlʲəuɾˠ
aithreacha	æhɾʲəxə
glanadh	ɡl̪ˠɑn̪əx
ligthe	l̠ʲɪcɪ
duas	d̪ˠuəsˠ
gcaoirigh	ɡiːɾʲɪɟ
bliosán	bʲlʲəsˠɑːn̪ˠ
fuinneog	fˠɪn̠ʲaɡ
áiteacha	ɑːtʲəxiː
clogad	klˠʌɡəd̪ˠ
ríomhaire	ɾˠiːvˠəɾʲə
chíre	çiːɾʲə
folamh	fˠɔlˠu
aithneodh	ænʲoːtʲ
ochtar	ɔxt̪ˠəɾˠ
allas	al̪ˠəsˠ
caighdeán	kəidʲaːn̪ˠ
phósfadh	fˠoːsˠuː
deargadh	dʲaɾˠəɡəvˠ
taos	t̪ˠiːsˠ
leithead	l̠ʲeːd̪ˠ
taghd	t̪ˠəid̪ˠ
plúr	pˠlˠuːɾˠ
ainmneacha	anʲəmʲnʲəxiː
broinn	bˠɾˠiːn̠ʲ
roimhe	ɾˠɪvʲə
measa	mʲæsˠə
loingeas	l̪ˠɪɲɟəsˠ
féarach	fʲeːrəx
príomhchathair	pˠɾˠiːvˠxahɪɾʲ
leáis	l̠ʲɑːʃ
fiaradh	fʲiəɾˠətʲ
séasúr	ʃeːsˠuːɾˠ
mharbh	warˠuː
léir	l̠ʲeːɾʲ
beag	bʲɞɡ
cathair	kaːɾʲ
bualadh	bˠuəlˠu
ocras	ɔkɾˠəsˠ
deara	dʲaɾˠə
buile	bˠɪlʲə
eich	ɛç
déarfadh	dʲeːɾˠhəx
chúrsa	xuːɾˠsˠə
aifreann	æfʲɾʲən̪ˠ
dabhaigh	d̪ˠəuwi
amaid	amˠədʲ
baisteadh	bˠaʃtʲətʲ
daid	d̪ˠadʲ
cánach	kæːnˠah
paráistí	pˠəɾˠɑːʃtʲiː
churach	xɤɾˠah
cosúil	kəsˠuːlʲ
cama	kamˠə
mharaigh	waɾˠi
macánta	makən̪ˠt̪ˠə
inne	ɪn̠ʲə
sliasad	ʃlʲiəsˠəd̪ˠ
as	asˠ
d'éirigh	dʲəiɾʲɪɟ
casfaidh	kasˠɪɟ
bláthmhar	bˠlˠæːfˠəɾˠ
ósta	oːsˠt̪ˠə
huis	hɪʃ
breabadh	bʲɾʲabˠu
anois	ənʲɪʃ
gréasán	ɟɾeːsˠænˠ
nead	nʲad̪ˠ
cráite	kɾˠɑːtʲə
mhacha	waxə
cruinnigh	kɾˠɪn̠ʲə
deor	dʲoːɾˠ
spúnóg	sˠpˠuːnˠoːɡ
tomhais	t̪ˠɛʃ
scéal	ʃcialˠ
fúinne	fˠuːn̠ʲə
canadh	kɑn̪ˠəɡ
creideamh	cɾʲɛdʲuː
scara	sˠkaɾˠə
breithiúnas	bʲɾʲəhuːn̪ˠəsˠ
comhrialtas	koːɾˠiəl̪ˠt̪ˠəsˠ
muinín	mˠɪnʲinʲ
piocadh	pʲʊkəvˠ
cheana	hanˠə
lus	l̪ˠʊsˠ
seosamh	ʃoːsˠəvˠ
coillte	kiːlʲtʲə
corn	koːɾˠn̪ˠ
lae	l̪ˠeː
thig	hɪɟ
nua	uːrˠ
mbard	mˠɑːɾˠd̪ˠ
gceann	ɟan̪ˠ
ainmhí	anʲəvʲi
ádhúil	ɑːwʊl
moladh	mˠɔlˠə
so	sˠɔ
cac	kak
duitse	d̪ˠɪtʲʃə
pheann	fʲaun̪ˠ
éscae	eːske
ardchlár	ɑːɾˠd̪ˠxl̪ˠɑːɾˠ
bpianadh	bʲiənˠətʲ
shíníomar	hiːnʲiːmˠəɾˠ
troimide	t̪ˠɾˠɪmʲədʲə
den	ɡənˠ
fada	fˠɑd̪ˠə
spreagadh	sˠpʲɾʲaɡətʲ
siúinéaracht	ʃuːnʲeːɾˠəxt̪ˠ
choil	xɛlʲ
cúram	kuːɾˠəmˠ
díobhsan	dʲiːpˠsˠən
piléar	pʲɪlʲaɾˠ
buana	bˠuənˠə
dhá	ɣæː
peirsis	pʲɛɾʲʃɪʃ
fiafraigh	fʲiəɾˠə
ribe	ɾˠɪbʲə
airigh	aɾʲi
chú	xuː
aitheanta	ahən̪ˠt̪ˠə
b'éigint	bʲeːɟɪn̠ʲtʲ
íosánach	iːsˠænˠah
guigh	ɡɪɟ
fiche	fʲɪçə
mearadh	mʲaɾˠu
feoilséantóir	fʲoːlʲʃia̯n̪ˠt̪ˠoːrʲ
stopadh	sˠt̪ˠɔpˠə
pá	pˠæː
altfadh	al̪ˠt̪ˠətʲ
nóra	n̪ˠoːɾˠə
crochadh	kɾˠɔxətʲ
daoirse	d̪ˠiːɾˠʃə
ceannasaí	can̪ˠəsˠi
uafásach	uːɑːsˠəx
bhéarfadh	vʲeːɾˠətʲ
cnuic	kɾˠɪc
lice	l̠ʲɪcɪ
máilín	mˠæːlʲinʲ
airím	aɾʲimˠ
chóisir	xɔːʃəɾʲ
breatnach	bʲɾʲan̪ˠah
bradach	bˠɾˠad̪ˠah
socrú	sˠɔkɾˠuː
muic	mˠɪc
túis	t̪ˠuːʃ
suipéar	sˠɪpʲeɾˠ
athléim	aleːmʲ
síoda	ʃiːd̪ˠə
deireadh	dʲɛɾʲu
dínnéar	dʲiːn̠ʲeːɾˠ
gort	ɡɔɾˠt̪ˠ
geall	ɟaul̪ˠ
gcodladh	ɡʌl̪ˠu
mothaím	muːiːmʲ
ceannacht	cæːn̪ˠəxt̪ˠ
orainn	ɔɾˠən̠ʲ
francach	fˠɾˠaŋkah
dóigh	d̪ˠoːɟ
ním	n̠ʲiːmʲ
rinneamar	ɾˠɪn̠ʲəmˠəɾˠ
aithneodh	ænʲoːx
sa	sˠə
bpianadh	bʲiənˠuː
phósadh	fˠoːsˠuː
aidmheáil	adʲvʲælʲ
ghob	ɣʌbˠ
braith	bˠɾˠa
bisigh	bʲɪʃi
biorach	bʲɪɾˠɑx
cheap	çapˠ
róis	ɾˠoːʃ
gcodladh	ɡɔl̪ˠə
ball	bˠal̪ˠ
eorna	ɔːɾˠn̪ˠə
ith	ɪh
troithe	t̪ˠɾˠeː
beimid	bʲɛmʲədʲ
fírinneach	fʲiːɾʲənʲəx
brachán	bˠɾˠaxɑːnˠ
géar	ɟeːɾˠ
móra	mˠoːɾˠə
molas	mˠʌlˠəsˠ
gruama	ɡɾˠuːmˠə
téad	tʲeːd̪ˠ
cótaí	koːt̪ˠiː
cleachtadh	clʲaxt̪ˠəx
feiliúnach	fʲɪlʲuːn̪ˠəx
páirt	pˠɑːɾˠtʲ
díomá	dʲiːmˠɑː
cigire	cɪɟɪɾʲə
síneadh	ʃiːnʲu
neach	n̠ʲax
fhocal	ɔkəlˠ
h	h
deoir	dʲɔːɾʲ
costas	kʌsˠt̪ˠəsˠ
trua	t̪ˠɾˠuə
curaigh	kɔɾˠə
siolla	ʃɪl͈ə
stuidéir	sˠt̪ˠədʲeːrʲ
ail	alʲ
tomacha	t̪ˠʊmˠəxiː
balla	bˠal̪ˠə
scéalaí	ʃceːlˠiː
annamh	anəvˠ
sách	sˠæːx
thair	haɾʲ
taga	t̪ˠaɡə
dall	d̪ˠaul̪ˠ
gealbhan	ɟalˠəwanˠ
ullmhaigh	ʌl̪ˠwi
deinim	dʲɛnʲɪmʲ
síneadh	ʃiːnʲuː
bróig	bˠɾˠoːɟ
eaglais	ɑːɡlˠəʃ
aithin	eːhən
ise	ɪʃə
strainséara	sˠt̪ˠɾˠæːnʲʃeːɾˠə
bpósfadh	bˠɔːsˠətʲ
buail	bˠiːlʲ
fad	fˠɑd̪ˠ
claidh	kl̪ˠəi
fionnuar	fʲɪnˠuəɾˠ
óg	ɔːɡ
soitheach	sˠeːx
seachain	ʃæxənʲ
tharlaigh	hɑɾˠl̪ˠɪɟ
bomaite	bˠʌmˠətʲə
scátháin	sˠkæhænʲ
giota	ɟɪt̪ˠə
oibrigh	əibʲɾʲiː
coill	kəil̠ʲ
gaoth	ɡeːh
sibhse	ʃɪbʲʃə
beagán	bʲɞɡɑːnˠ
anocht	ən̪ˠɔxt̪ˠ
altfaidh	al̪ˠt̪ˠi
ionadh	uːn̪ˠə
breatnach	bʲɾʲan̪ˠəx
buidéal	bˠɪdʲeːlˠ
shéabraí	heːbˠɾˠiː
scil	ʃcɪlʲ
thiocfadh	hʊkəx
aiféala	afʲeːɾˠ
dlúth	d̪ˠlˠuː
iontas	ɤːn̪ˠt̪ˠəsˠ
laethanta	l̪ˠeːhən̪ˠt̪ˠə
cirt	cɪɾˠtʲ
sna	sˠnˠə
b'fhéidir	bʲeːdʲəɾʲ
buaine	bˠuənʲə
tógáil	t̪ˠɔːɡælʲ
nollaig	n̪ˠʌl̪ˠəc
plaic	pˠlˠac
cogaíocha	kɔɡeːxiː
dada	d̪ˠad̪ˠə
péinteáil	pʲeːnʲtʲaːlʲ
carad	kɑɾˠəd̪ˠ
crios	cɾʲɪsˠ
dhá	ɣɑː
labhairt	l̪ˠəuɾʲtʲ
pósadh	pˠoːsˠuː
staighre	sˠt̪ˠəiɾʲə
libh	lʲɪvʲ
gorta	ɡɔɾˠt̪ˠə
ábalta	æːbˠəl̪ˠt̪ˠə
innseann	iːnʲʃən̪ˠ
seada	ʃad̪ˠə
seamróg	ʃamˠəɾˠoːɡ
corcaigh	kɔɾˠkə
freastalaíodh	fʲɾʲasˠt̪ˠəlˠiːw
lúb	l̪ˠuːbˠ
coir	kɛɾʲ
chuireadh	xɪɾʲu
lasrach	l̪ˠasˠəɾˠəx
nóin	n̪ˠuːnʲ
nuair	n̪ˠɛɾʲ
sílim	ʃiːlʲəmʲ
ceatha	cahə
oireachtas	ɛɾʲaht̪ˠəsˠ
fiach	fʲiəx
eascaine	asˠkənʲə
dochtúir	d̪ˠʌxt̪ˠuɾʲ
guidid	ɡɪdʲədʲ
tóra	t̪ˠɔːɾˠə
veinéis	vʲɛnʲeːʃ
toinn	t̪ˠiːn̠ʲ
tastaigh	t̪ˠasˠt̪ˠə
bhán	vˠɑːn̪ˠ
abarthach	abˠəɾˠəx
téigh	tʲeː
dearthár	dʲɾʲiçaːɾˠ
más	mˠɑːsˠ
seilide	ʃɛlʲədʲə
bileogach	bʲɪlʲoːɡəx
agamsa	ɑmˠsˠə
beidh	bʲɛɟ
treoracha	tʲɾʲɔːɾˠahə
cathaoir	kəiɾʲ
béarla	bʲeːɾˠl̪ˠə
fhaigheann	æːn̪ˠ
aniar	ən̠ʲiəɾˠ
cantar	kan̪ˠt̪ˠəɾˠ
chugainne	xʊɡən̠ʲə
féich	fʲeːç
deil	dʲɛlʲ
seilg	ʃɛlʲɪɟ
geall	ɟaːl̪ˠ
sách	sˠɑːx
taspáin	t̪əspˠɑːnʲ
colainn	kɔlˠən̠ʲ
acu	əku
cluife	klˠɪfʲə
báite	bˠɑːtʲə
geis	ɟɛʃ
dúideanna	d̪ˠuːdʲən̪ˠə
aon	iːnˠ
arda	ɑːɾˠd̪ˠə
tairne	t̪ˠæːɾˠn̠ʲə
deartháir	dʲɾʲɑːɾʲ
múnadh	mˠuːn̪ˠəvˠ
ardrí	ɑːɾˠd̪ˠɾˠiː
snámh	sˠn̪ˠæːw
rabhadh	ɾˠou
laidin	l̪ˠadʲɪnʲ
chara	xaɾˠə
donna	d̪ˠɔn̪ˠə
caite	katʲə
oileadh	ɪlʲəɡ
ollmhargadh	ɔl̪ˠwaɾˠəɡə
scáthán	sˠkɑːhɑːnˠ
dhún	ɣuːnˠ
dhaoine	ɣiːnʲə
hár	hæːɾˠ
pluid	pˠlˠɪdʲ
péacóg	pʲeːkoːɡ
fadhb	fˠəibˠ
máthar	mˠæhəɾˠ
aill	ɑːl̠ʲ
fásach	fˠæːsˠax
dúinn	d̪ˠuːn̠ʲ
guigh	ɡɪvʲ
dúil	d̪ˠuːlʲ
gos	ɡɔsˠ
barúlach	bˠaɾˠuːlˠəx
sláinte	sˠl̪ˠəin̠ʲtʲə
chileagram	çɪlʲəɡɾˠamˠ
stiall	ʃtʲiəl̪ˠ
tóg	t̪ˠoːɡ
faghta	fˠɑxt̪ˠə
scáthán	sˠkɑːhɑːn̪ˠ
bainne	bˠɑɲə
chéim	çeːmʲ
dhuine	ɣɪnʲə
eangach	aŋax
agaibhse	aɡiːʃə
hanam	hanˠəmˠ
laoch	l̪ˠeːx
bodhar	bˠəuɾˠ
plúra'	pˠlˠuːɾˠə
mhac	wak
béal	bʲia̯l̪ˠ
díograis	dʲiːɡɾˠəʃ
d'aithníodh	dˠahnʲiːx
oilfeadh	ɪlʲhuː
chrainn	xɾˠiːn̠ʲ
cogain	kaɡənʲ
phiocadh	fʲɪkətʲ
pingin	pʲɪɲɟənʲ
casadh	kasˠʊ
faigh	fˠæːj
oscailt	ɔsˠkəl̠ʲtʲ
píopa	pʲiːpˠə
tuama	t̪ˠuəmˠə
beo	bʲɔː
láib	l̪ˠæːbʲ
dúlra	d̪ˠuːlˠɾˠə
cailleadh	kɑːl̠ʲə
cogadh	kɔɡəɡ
leice	l̠ʲɛcɪ
alba	alˠəbˠə
pinn	pʲəinʲ
leath	l̠ʲah
chip	çɪpʲ
dusta	d̪ˠɪsˠt̪ˠə
monabhar	mˠɔnˠəvˠəɾˠ
asat	asˠt̪ˠəd̪ˠ
pógtha	pˠoːkə
bileogach	bʲəlʲoːɡəx
piléir	pʲəlʲeːɾʲ
fraoch	fˠɾˠiːx
ursa	ʊɾˠsˠə
fheiceadh	ɛcuː
cór	koːɾˠ
chór	xoːɾˠ
aithint	an̠ʲtʲ
éisteacht	eːʃtʲəxt̪ˠ
crios	cɾʲʊsˠ
éirinn	eːɾʲən̠ʲ
díleas	dʲiːlʲəsˠ
mac	mˠɑk
miotóg	mʲɪt̪ˠaɡ
gcroí	ɡɾˠiː
tóin	t̪ˠoːnʲ
os	ʌsˠ
ciarán	ciəɾˠɑːn̪ˠ
molann	mˠɔlˠən̪ˠ
deartháireacha	dʲɾʲəhaːɾʲəxə
ghránaigh	ɣɾˠɑːnˠiː
réad	ɾˠeːd̪ˠ
astu	asˠt̪ˠʊ
scoil	sˠkɔlʲ
cileagram	cɪlʲəɡɾˠamˠ
éadach	ia̯d̪ˠəx
rúibín	ɾˠuːbʲiːnʲ
suíochán	sˠiːxænˠ
shnáith	nˠæːiç
anart	ɑnəɾˠt̪ˠ
coighcíos	kəiciːsˠ
ghnách	ɣɾˠæːx
dteach	dʲæːx
fhuiriste	ɾʲɪʃtʲə
airgid	aɾʲəɟədʲ
pósadh	pˠɔːsˠu
brobh	bˠɾˠow
geall	ɟɑːl̪ˠ
thuiscint	hɪʃcɪn̠ʲtʲ
baineann	bˠɪɾʲən̪ˠ
brá	bˠɾˠæː
'am	amˠ
fómhar	fˠoːvˠəɾˠ
inarb	ɪnˠəɾˠbˠ
téann	tʲeːn̪ˠ
goid	ɡɪdʲ
margadh	mˠaɾˠəɡuː
dola	d̪ˠɔlˠə
díbríodh	dʲiːbʲɾʲitʲ
dhúil	ɣuːlʲ
croith	kɾˠɔh
mbás	mˠæːsˠ
mhóra	woːɾˠə
galúin	ɡəlˠuːnʲ
suipéar	sˠɪpʲeːɾˠ
dhóibhsean	ɣoːpˠsˠən
tit	tʲɪtʲ
garsún	ɡaɾˠsˠunˠ
fuiseog	fˠɪʃoːɡ
deileanna	dʲɛlʲən̪ˠə
aicme	acmʲə
pobalscoil	pˠɔbˠəlˠsˠkɛlʲ
oilfeadh	ɛlʲhəx
aiteach	atʲəx
aireachtáil	aɾʲaxt̪ˠælʲ
ceannasach	can̪ˠəsˠah
thóir	hoːɾʲ
colúr	kɔl̪ˠuːɾˠ
ionam	iːn̪ˠt̪ˠəmˠ
buíochas	bˠiːxəsˠ
pósadh	pˠɔːsˠətʲ
cathaoirleach	kaiɾˠl̠ʲəx
thugadh	hʊɡu
difríocht	dʲɪfʲɾʲiəxt̪ˠ
hallaí	hal̪ˠiː
coicís	kəiciːʃ
pinginí	pʲɪɲənʲiː
chodlata	kɔl̪ˠət̪ˠə
gcaraid	ɡaɾˠədʲ
móinteach	mˠoːnʲtʲəx
féan	fʲeːnˠ
fhírinne	iːɾʲən̠ʲə
mhalairt	vˠɑlˠəɾˠtʲ
pingineacha	pʲiːn̠ʲəxiː
lasracha	l̪ˠasˠɾˠəxə
béarlóireacht	bʲeːɾˠl̪ˠɔɾʲaht̪ˠ
ghobadh	ɣɔbˠuː
géibheann	ɟeːvʲən̪ˠ
fhéin	heːnʲ
miodóg	mʲɪd̪ˠoːɡ
tuí	t̪ˠiː
hóbair	hoːbˠəɾʲ
ding	dʲɪɲɟ
bain	bˠanʲ
sásta	sˠæːsˠt̪ˠə
scáileán	sˠkɑːlʲɑːnˠ
éis	eːʃ
ríse	ɾˠiːʃə
d'oil	d̪ˠɛlʲ
d'fhreastalódh	dʲɾʲasˠt̪ˠəlˠoːtʲ
dair	d̪ˠaɾʲ
clocha	klˠʌxə
salaigh	sˠɑl̪ˠɪɟ
meaisín	mʲəʃiːnʲ
cas	kasˠ
é	eː
fánach	fˠɑːnˠəx
anuraidh	ən̪ˠɔɾˠə
nollaig	n̪ˠɔl̪ˠəɟ
cuntar	kʊn̪ˠt̪ˠəɾˠ
reilig	ɾˠɛlʲɪc
iontas	iːn̪ˠt̪ˠəsˠ
clois	kl̪ˠʊʃ
siúr	ʃuːɾˠ
saoir	sˠiːɾʲ
chugainn	hʊɡən̠ʲ
deireanach	dʲɛɾʲənˠah
cinn	ciːnʲ
gabhar	ɡəuɾˠ
fíor	fʲiəɾˠ
aoibhinn	iːvʲənʲ
buain	bˠuənʲ
tacht	t̪ˠaxt̪ˠ
slua	sˠl̪ˠuə
báis	bˠæːʃ
cearnóga	cæːɾˠn̪ˠɔɡə
seánra	ʃæːn̪ˠɾˠə
chasfadh	kasˠəx
séipéal	ʃeːpʲeːl̪ˠ
a	ə
aontaím	iːn̪ˠt̪ˠimˠ
maca	mˠakə
ceintiméadar	cɛn̠ʲtʲəmʲeːd̪ˠəɾˠ
roc	ɾˠɔk
cónaithe	kuːn̪ˠiː
dóigh	d̪ˠoː
leis	l̠ʲɛʃ
scéalaí	ʃceːlˠi
déantar	dʲiːn̪ˠt̪ˠəɾˠ
fliuchadh	fʲlʲʊxəx
d'aithníodh	dˠahnʲiːw
clairnéid	klˠɑːɾˠnʲeːdʲ
tithe	tʲiː
chugaibh	huɡiː
deoir	dʲoːɾʲ
mholfadh	vˠɔlˠhəx
iacób	iəkoːbˠ
shábháil	hæːwælʲ
agaibh	aɡiː
páras	pˠæːɾˠəsˠ
cisteanach	cɪʃtʲən̪ˠəx
lúba	l̪ˠuːbˠə
díbríodh	dʲiːbʲɾʲiːtʲ
teach	tʲæːx
bheidh	vʲɛj
dhíom	ɣiːmˠ
dreach	dʲɾʲax
leosan	lʲoːsˠənˠ
mhéadar	vʲeːd̪ˠəɾˠ
chomh	xɔ
duit	d̪ˠɪtʲ
mórmheanma	mˠoːɾˠvʲanˠmˠə
iarraigí	iəɾˠəɟiː
dabhach	d̪ˠəuəx
gil	ɟɪlʲ
sadhbh	sˠəi̯vˠ
cogadh	kʌɡətʲ
corraigh	kɔɾˠɪɟ
pholl	fˠəul̪ˠ
fhonn	ʌn̪ˠ
donas	d̪ˠɔnˠəsˠ
rabharta	ɾˠəuɾˠt̪ˠə
álainn	ɑːl̪ˠɪɲ
roimis	ɾˠɪmʲəʃ
pearsana	pʲaɾˠsˠənˠə
mnaoi	mˠɾˠiː
teilg	tʲɛlʲɪɟ
clogaide	klˠɔɡədʲə
comhrialtas	kuːɾˠiəl̪ˠt̪ˠəsˠ
chugam	aɡəmˠ
con	kɔnˠ
bacaigh	bˠɑkɪɟ
ceathrúnaí	cæːɾˠuːn̪ˠiː
aithne	ænə
raibh	ɾˠo
agam	ɑɡəmˠ
séú	ʃeːu
gaire	ɡaɾʲə
tréad	tʲɾʲeːd̪ˠ
sár	sˠɑːɾˠ
bí	bʲiː
gaineamh	ɡanʲəvˠ
corr	kəuɾˠ
bailte	bˠal̠ʲtʲə
olann	ɔlˠən̪ˠ
colm	kɔl̪ˠəmˠ
d'oilfeadh	d̪ˠɪlʲhətʲ
haon	hiːnˠ
molann	mˠʌlˠən̪ˠ
ocht	ʌxt̪ˠ
firéad	fʲərʲeːd̪ˠ
fáinne	fˠæːn̠ʲə
dúinn	d̪ˠɪn̠ʲ
ceangal	caŋɡəlˠ
troime	t̪ˠɾˠɪmʲə
cucól	kʊkoːl̪ˠ
ceart	caɾˠt̪ˠ
gráin	ɡɾˠɑːnʲ
brá	bˠɾˠɑː
smaoin	sˠmˠɨːn
taidhleoir	t̪ˠeːlʲɔɾʲ
cuireadh	kɪɾʲətʲ
fúithise	fˠuːʃə
carachtar	kaɾˠəxt̪ˠəɾˠ
lámh	l̪ˠɑːvˠ
ag	əɟ
d'altadh	d̪ˠal̪ˠt̪ˠu
roibeárd	ɾˠɛbʲɑːɾˠd̪ˠ
deas	dʲasˠ
naimhde	n̪ˠavʲdʲə
téana	tʲeːnˠə
siúinéara	ʃuːnʲeːɾˠə
fán	fˠæːn̪ˠ
d'fhágadh	d̪ˠɑːɡəx
gaineamh	ɡanʲu
nuair	n̪ˠɔɾʲ
thú	huː
dearthár	dʲæːɾˠhəɾˠ
cuir	kɪɾʲ
ndearna	n̠ʲɑːɾˠn̪ˠə
treo	tʲɾʲɔː
bhrasaíl	vˠɾˠasˠiːlʲ
amhrán	ɑːɾˠɑːnˠ
imeacht	ɪmʲəxt̪ˠ
dian	dʲiənˠ
philéir	fʲɪlʲeɾʲ
seamróg	ʃamˠɾˠaɡ
treo	tʲɾʲoː
asal	asˠəlˠ
stail	sˠt̪ˠalʲ
domhan	d̪ˠaʊn̪ˠ
curaí	kʌɾˠiː
hainmneacha	hanʲəmʲnʲahə
bualadh	bˠuəlˠuː
let	lʲɛt̪ˠ
tae	t̪ˠeː
gcearnóg	ɟɑːɾˠn̪ˠoːɡ
bheas	vʲɛsˠ
pógadh	pˠoːɡəɡ
comhréireach	kˠoːɾˠeːɾʲəxˠ
stoca	sˠt̪ˠɔkə
milseán	mʲɪlʲʃæn̪ˠ
súlach	sˠuːl̪ˠəx
pheacaí	fʲaki
bháis	wæːʃ
thiocfadh	hʊkətʲ
sláinte	sˠl̪ˠan̠ʲtʲə
praghas	pɾˠəisˠ
fuinneoga	fˠɪn̠ʲɔɡə
méar	mʲeːɾˠ
glúin	ɡl̪ˠuːnʲ
spreagadh	sˠpʲɾʲaɡu
bréig	bʲɾʲeːɟ
oibleagáid	əibˠləɡədʲ
glanadh	ɡl̪ˠɑn̪ˠə
teo	tʲɔː
pingine	pʲɪɲɟənʲə
thart	haɾˠt̪ˠ
cuimhne	kɪmʲnə
aird	ɑːɾˠdʲ
lách	l̪ˠɑːx
tuirseach	t̪ˠəɾˠʃax
chuaigh	fˠuə
cathal	kahəlˠ
fúithi	fˠʊhə
fleá	fʲlʲɑː
méadaigh	vʲeːd̪ˠɪɟ
athrú	ɑɾˠuː
ceonna	coːn̪ˠiː
cuntar	kuːn̪ˠt̪ˠəɾˠ
aithne	æn̠ʲə
máthair	mˠahærʲ
badhb	bˠəibˠ
dála	d̪ˠæːlˠə
síneadh	ʃiːnʲəvˠ
curaí	kəɾˠiː
dáta	d̪ˠɑːt̪ˠə
mhá	wæː
dligh	dʲlʲiː
ceimic	cɛmʲɪc
amadán	amˠəd̪ˠanˠ
caill	kɑːl̠ʲ
scréach	ʃcɾʲeːx
bhfiaradh	vʲiəɾˠuː
corrú	kʌɾˠu
ndóchas	n̪ˠoːxəsˠ
scáth	sˠkæː
freastalaí	fʲɾʲasˠt̪ˠəl̪ˠiː
det	dʲɛt̪ˠ
phósadh	fˠɔːsˠətʲ
déanta	dʲiːn̪ˠt̪ˠə
shéabra	heːbˠɾˠə
dúlamán	d̪ˠuːl̪ˠəmˠɑːn̪ˠ
bablóinia	bˠabˠlˠoːnʲiə
lig	l̠ʲɪɟ
tuile	t̪ˠɪlʲə
fágfaidh	fˠɑːkɪɟ
aifreann	ɪfʲɾʲən̪ˠ
múinteoir	mˠuːn̠ʲtʲoːɾʲ
máthair	mˠɑːɾʲ
ndiaidh	n̠ʲiə
asaibh	asˠt̪ˠiː
sparán	sˠpˠəɾˠɑːnˠ
bhláthanna	wl̪ˠæhən̪ˠə
bacadh	bˠakətʲ
cáisc	kæːʃc
gaineamh	ɡanʲuː
sé	ʃɛ
bláithche	bˠlˠaːiçə
scaradh	sˠkɑɾˠəɡ
gcrainn	ɡɾˠɪn̠ʲ
órga	ɔːɾˠɡə
aontú	iːn̪ˠt̪ˠuː
teir	tʲɛɾʲ
peacaí	pʲaki
sula	sˠʊlˠə
urú	ʊɾˠuː
sail	salʲ
leathan	l̠ʲahənˠ
ginn	ɟiːn̠ʲ
cruithneacht	kɾˠɪnʲəxt̪ˠ
liathróid	l̠ʲiəɾhˠoːdʲ
pianadh	pʲiənˠətʲ
óstán	oːsˠt̪ˠɑːnˠ
aibí	apˠi
coire	kɛɾʲə
snáthaid	sˠn̪ˠɑːhədʲ
gcnoic	ɡɾˠɪc
grús	ɡɾˠuːsˠ
míl	mʲiːlʲ
vása	wæːsˠə
mhéir	vʲeːɾʲ
tuig	t̪ˠɪɟ
acht	axt̪ˠ
breithiúnas	bʲɾʲɛhunˠəsˠ
tiomáint	tʲɪmɑːn̠ʲtʲ
beadh	bʲɛx
deimhin	dʲɪvʲənʲ
scuabadh	sˠkuəbˠuː
mó	mˠɔː
dlaoi	d̪ˠlˠiː
athair	æhəɾʲ
sínigh	ʃiːnʲiː
brobh	bˠɾˠɔw
suigh	sˠɪɟ
gí	ɟiː
churach	xʊɾˠəx
m'	mˠ
guigh	ɡiː
scanrú	sˠkɑːn̪ˠɾˠuː
amáireach	əmˠæːɾʲah
tsealg	tʲalˠəɡ
conchobhar	kʊnˠxəwaɾˠ
d'imigh	dʲɪmʲɪɟ
míle	mʲiːlʲə
tsúil	t̪ˠuːlʲ
acu	apˠək
sasanach	sˠasˠənˠəx
leás	l̠ʲɑːsˠ
finn	fʲiːɲ
theach	hax
glanadh	ɡlˠanˠə
chum	xʊnˠ
aischuir	aʃxɪrʲ
sí	ʃiː
faill	fˠɑilʲ
criadh	cɾʲiə
téigh	tʲeːj
preas	pʲɾʲasˠ
airgead	æɾʲɪɟəd̪ˠ
chirce	çɪɾʲcə
puisín	pˠɪʃinʲ
b'	bʲ
critheann	crʲɪhən̪ˠ
oibreacha	əibʲrʲəxiː
blás	blaːs
torc	t̪ˠʌɾˠk
áthas	æhəsˠ
briathar	bʲɾʲiəhəɾˠ
deas	dʲæsˠ
dólámhach	d̪ˠɔːl̪ˠæːwah
lann	l̪ˠan̪ˠ
theacht	hæːxt̪ˠ
anamacha	anˠəmˠəxə
phiocadh	fʲʊkəx
asaibhse	ɑsˠiːʃə
paráiste	pˠɾˠɑːʃtʲə
astu	asˠt̪ˠəbˠ
fear	fʲaɾˠ
garbh	ɡaɾˠu
uaimse	wæmʲʃə
sparán	sˠpˠɔɾˠanˠ
cliath	clʲiə
tabhair	t̪ˠoːɾʲ
cuibhreann	kɪvʲɾʲən̪ˠ
díomá	dʲiːmˠvˠɑː
chonamara	xʊn̪ˠəmaɾˠə
geanntracha	ɟɑːn̪ˠt̪ˠɾˠəxiː
bogadh	bˠɔɡə
smacht	sˠmˠɑxt̪ˠ
d'ith	dʲɪh
garbh	ɡaɾˠuː
éireannach	eːɾʲən̪ˠəx
dáiríre	d̪ˠæɾʲiːɾʲə
leanbh	lʲan̪ˠəvˠ
crann	kɾˠan̪ˠ
mháire	wˠæːɾʲə
aithis	æhəʃ
dlí	dʲlʲiː
india	ɪnʲdʲiə
bhfiaradh	vʲiəɾˠətʲ
comhrá	koːɾˠɑː
buartha	bˠuəɾˠhə
puca	pˠʊkə
fuinneog	fˠən̠ʲoːɡ
reilig	ɾˠɪlʲɪɟ
amadán	ɑmˠəd̪ˠɑːnˠ
chugainn	xuːnʲ
clúdach	kl̪ˠuːd̪ˠəx
chucusan	hɞkəpˠsˠən
claon	kl̪ˠeːn̪ˠ
múnadh	mˠuːnˠətʲ
lic	l̠ʲɪc
asaibh	asˠiː
d'oilfeadh	d̪ˠɛlʲhu
seán	ʃɑːn̪ˠ
each	ax
grúdlann	ɡɾˠuːd̪ˠlˠən̪ˠ
chuán	xuːɑːn̪ˠ
dhaoibh	iːbʲ
sráide	sˠɾˠaːdʲə
cupán	kɔpˠænˠ
tána	t̪ˠæːnˠə
frása	fˠɾˠɑːsˠə
casfaidh	kasˠi
tonn	t̪ˠɔn̪ˠ
chomh	xo
casann	kasən̪ˠ
léachtóir	l̠ʲeːxt̪ˠɔɾʲ
guí	ɡiː
mholadh	vˠɔlˠəx
ciaróg	ciəɾˠaɡ
achadh	axə
bratach	bˠɾˠat̪ˠəx
plódaithe	pˠlˠoːd̪ˠɪhə
bád	bˠɑːd̪ˠ
mbriseadh	mʲɾʲɪʃə
máthair	mˠɑ̃hɪɾʲ
ionsaí	ʊnˠsˠiː
siopadóireacht	ʃʊpˠəd̪ˠoːɾʲəxt̪ˠ
crochadh	kɾˠʌxətʲ
cóirigh	koːɾʲɪɟ
donn	d̪ˠuːn̪ˠ
baisteadh	bˠaʃtʲu
abhainn	oːn̠ʲ
clóiséad	klˠoːʃeːd̪ˠ
laighin	l̪ˠəinʲ
smacht	sˠmˠaxt̪ˠ
phósadh	fˠoːsˠə
leaba	l̠ʲabˠə
gnó	ɡn̪ˠoː
talamh	t̪ˠɑlˠəvˠ
ith	iː
barúlach	bˠaɾˠulˠah
gur	ɡʊɾˠ
leis	lʲɛʃ
fíor	fʲiːɾˠ
ionadh	iːnˠə
ndé	n̠ʲeː
cruitireacht	kɾˠɪtʲəɾʲaht̪ˠ
géagach	ɟeːɡəx
cumann	kʊmˠən̪ˠ
maitheamh	mˠahuː
dream	dˠɾˠaumˠ
mhúchadh	vˠuːxə
fíniúnach	fʲiːnʲuːnˠəx
daltach	d̪ˠal̪ˠt̪ˠəx
marbh	mˠarˠuː
ar	ɛɾʲ
gae	ɡeː
leaba	l̠ʲabˠɪɟ
roinn	ɾˠaiɲ
cúnamh	kuːnˠə
chuireadh	xɪɾʲəx
briste	bʲɾʲɪʃtʲə
gréasán	ɟɾeːsˠɑːnˠ
tinn	tʲiːn̠ʲ
vallúinis	wal̪ˠuːnʲɪʃ
caill	kailʲ
billiún	bʲil̠ʲuːnˠ
taobh	t̪ˠiːw
mac	mˠak
liúit	l̠ʲuːtʲ
inín	ɪnʲiːnʲ
mhall	vˠɑul̪ˠ
áith	æː
gránaigh	ɡɾˠɑːnˠə
dual	d̪ˠuəlˠ
aiste	aʃtʲə
dem	dʲɛmˠ
mháighistreása	wɑːʃtʲɾʲɑːsˠə
chasfadh	kɑsˠəx
aithrí	æɾʲiː
mála	mˠɑːl̪ˠə
gciliméadar	ɟɪlʲəmʲeːd̪ˠəɾˠ
seanbhean	ʃanvʲan
braillín	bˠɑɾʲlʲiːnʲ
acusan	akusˠənˠ
d'éirigh	dʲəiɾʲiː
dháiríre	ɣæɾʲiːɾʲə
tús	t̪ˠuːsˠ
piocadh	pʲɪku
fhágaint	ɑːɡənʲtʲ
airím	aɾʲiːmʲ
rogha	ɾˠou
gcurach	ɡɤɾˠa
cill	ciːlʲ
reo	ɾˠɔː
dhíobhsan	jiːpˠsˠən
is	sˠ
fág	fˠɑːɡ
barúlach	bˠaɾˠuːl̪ˠəx
tachtadh	t̪ˠaxt̪ˠəvˠ
lí	l̠ʲiː
díobh	dʲiːbˠ
chrainn	xɾˠaiɲ
trí	tʲɾʲiː
piocadh	pʲʊkəx
taitnigh	t̪ˠan̠ʲə
iomlán	ʊmˠlˠɑːnˠ
ualach	uəlˠəx
sliabh	ʃl̠ʲiəw
chonaic	hanˠɪc
cnáib	kɾˠæːbʲ
d'fhágfadh	d̪ˠɑːkəx
taoschnó	t̪ˠeːsˠxnˠoː
salann	salˠən̪ˠ
mil	mʲɪlʲ
chugamsa	hɞɡəmˠsˠə
tháinig	hɑːnʲɪc
stócáil	sˠt̪ˠoːkɑːlʲ
tsléibh	tʲlʲeːvʲ
chapall	xapˠəl̪ˠ
nuacht	nˠuˑəxt̪ˠ
chruinne	xɾˠɪɲə
fréamh	fʲɾʲeːvˠ
marcra	mˠɑɾˠkɾˠə
ríomh	ɾˠiːw
duibheagán	d̪ˠɪvʲəɡaːn̪ˠ
bisigh	bʲɪʃiː
án	eːnˠ
fomhuireán	fɔːwərʲænˠ
conchúr	kʊnˠəxuːɾˠ
d'éalaigh	dʲeːlˠə
dhiaidh	jiə
anglais	aŋɡləʃ
snáfa	sˠn̪ˠæːfˠə
mairstean	mˠaɾˠsˠtʲənˠ
aontaigh	iːn̪ˠt̪ˠi
taithí	t̪ˠahiː
laethanta	l̪ˠeːn̪ˠt̪ˠiː
lúcháir	l̪ˠɛwɑːɾʲ
muine	mˠɪnʲə
peall	pʲaul̪ˠ
ga	ɡa
gcuraigh	ɡʊɾˠɪɟ
cúrsa	kuːɾˠsˠə
péinteáilte	pʲeːnʲtʲɑːl̠ʲtʲə
múinteoir	mˠuːn̠ʲtʲɔɾʲ
mór	mˠɔːɾˠ
carbónach	kaɾˠəbˠɔn̪ˠah
gall	ɡɑːl̪ˠ
dtóireacha	d̪ˠɔːɾʲahə
aill	ɑːl̪ˠ
phonc	fˠʊŋk
leagadh	l̠ʲaɡəx
carghas	kɑɾˠuːsˠ
culaith	kɔl̪ˠə
ceap	capˠ
car	karˠ
móide	mˠuːdʲə
peaca	pʲaku
choíche	xiːhə
agus	aɡəsˠ
scanraigh	sˠkɑːn̪ˠɾˠə
duille	d̪ˠɪlʲə
aill	ɑilʲ
dúinne	d̪ˠuːn̠ʲə
dhíotsa	jiːt̪ˠsˠə
braillín	bˠɾˠɑːl̠ʲiːnʲ
foirgneamh	fˠɔɾʲɪɟnʲuː
dia	dʲiə
gur	ɡəɾˠ
cinnire	cɪn̠ʲəɾʲə
argóint	ɑɾˠɡɔnʲtʲ
cultúr	kʊl̪ˠt̪ˠuɾˠ
fága	fˠɑːɡə
bearradh	bʲaɾˠəɡ
fearr	fʲæːɾˠ
sparán	sˠpˠaɾˠanˠ
agat	əɡɑt̪ˠ
iníon	ɪnʲiːnˠ
inneall	ɪn̠ʲəl̪ˠ
bláfar	bˠlˠæːfˠəɾˠ
bogadh	bˠʌɡətʲ
stopadh	sˠt̪ˠɔpˠəɡ
cráite	kɾˠæːtʲə
nguí	ŋiː
spealas	sˠpʲalˠəs
bóithrí	bˠoːɾʲiː
aosta	eːsˠt̪ˠə
am	əmˠ
prioc	pʲɾʲʊk
dhi	iː
cófra	kɔːfˠɾˠə
mhadadh	wad̪ˠə
aisig	aʃɪc
pupall	pubal͈
thiocfainn	hʊkən̠ʲ
léigh	l̠ʲeː
luaith	l̪ˠuə
cead	cad̪ˠ
amhras	əuɾˠəsˠ
amhrán	oːɾˠɑːnˠ
dúisigh	d̪ˠuːʃɪɟ
gearradh	ɟaɾˠəɡ
tosach	t̪ˠəsˠɑx
bás	bˠɑːsˠ
pána	pˠɑːnˠə
siopa	ʃʊpˠə
strainséir	sˠt̪ˠɾˠan̠ʲʃeːɾˠə
feighil	fʲəilʲ
normal	n̪ˠɔɾˠəmˠəlˠ
aimsire	amʲʃəɾʲə
gléasann	ɟlʲeːsən̪ˠ
mháthair	wɑːɾʲ
uaim	wɛmʲ
meitheamh	mʲɛhəvˠ
gob	ɡɔbˠ
bhfeis	vʲɛʃ
truaill	t̪ˠɾˠuəl̠ʲ
tachtadh	t̪ˠɑxt̪ˠəɡ
ceo	coː
seachas	ʃaxəsˠ
fód	fˠɔːd̪ˠ
righ	ɾˠɪɟ
alban	nəhaləbˠənˠ
liopa	lʲɪpˠə
airméin	aɾʲəmʲeːnʲ
uaidhsean	wəisən
pheadar	fʲad̪ˠəɾˠ
ghabhar	ɣəuɾˠ
pian	pʲiənˠ
moladh	mˠɔlˠəɡ
soicind	sˠɛcənʲdʲ
tuill	t̪ˠɪl̠ʲ
ciaróg	ciəɾˠoːɡ
dtrátha	d̪ˠɾˠahə
bogha	bˠou
canadh	kanˠəvˠ
finne	fʲɪn̠ʲə
maíomh	mˠiːw
ceapadh	cæpˠəvˠ
caomh	keːvˠ
dhéanfadh	jiːnəx
aithníodh	ahnʲiːw
cinnidh	cɪn̠ʲiː
seanmóirí	ʃanˠəmoːɾʲiː
crín	cɾʲiːnʲ
cér	ceːɾˠ
chailín	xalʲiːnʲ
cailleach	kəlʲax
bogadh	bˠʌɡu
agatsa	əɡɑt̪ˠsˠə
eol	ɔːlˠ
ardghlórach	ɑːɾˠd̪ˠɣlˠoːɾˠəx
finn	fʲɪn̠ʲ
stopadh	sˠt̪ˠɔpˠəvˠ
móir	mˠɔːɾʲ
diúc	dʲuːk
aspal	ɑpˠsˠtˠəl
cruinn	kɾˠɪn̠ʲ
aimsir	æmʲʃəɾʲ
feiceanna	fʲɛcən̪ˠə
d'aithin	d̪ˠænʲ
mol	mˠɔlˠ
seanbhan	ʃanˠwanˠ
craic	kɾˠac
loim	l̪ˠaimʲ
tachtadh	t̪ˠaxt̪ˠətʲ
céad	ceːd̪ˠ
cumha	kuə
dícheall	dʲiːçəl̪ˠ
scrúdaigh	sˠkɾˠuːd̪ˠə
ciliméadar	cɪlʲəmʲed̪ˠəɾˠ
cáit	kɑːtʲ
éirím	iːɾʲimˠ
bláthach	bˠlˠɑːx
cónaigh	koːn̪ˠɪɟ
stoptha	sˠt̪ˠɔpˠə
bodach	bˠɔd̪ˠəx
fuil	fˠɪlʲ
seanscéal	ʃanˠʃcelˠ
clairnéid	klˠæːɾˠnʲedʲ
táin	t̪ˠɑːnʲ
eolas	oːlˠəsˠ
coróin	kɔɾˠænʲ
caighdeánach	kəidʲænˠah
reilig	ɾˠɛlʲɪɟ
díbir	dʲiːbʲəɾʲ
eisceacht	əʃcaxt̪ˠ
dhíobh	iːbˠ
tuigeann	t̪ˠɪɟən̪ˠ
alban	aləbˠənˠ
ára	ɑːɾˠə
seanmóirí	ʃanˠəmɔɾʲiː
d'altadh	d̪ˠal̪ˠt̪ˠəx
puisín	pˠɪʃiːnʲ
díobh	d̪ˠiːbˠ
chuirfeadh	xɪɾˠhətʲ
tagann	t̪ˠaɡən̪ˠ
gaisce	ɡaʃcɪ
anuas	ən̪ˠuəsˠ
crean	cɾʲanˠ
luach	l̪ˠuəx
réaltra	ɾˠeːl̪ˠt̪ˠɾˠə
phá	fˠæː
haithne	hæːnʲə
trealamh	tʲɾʲalˠəvˠ
nádúr	n̪ˠaːd̪ˠuːɾˠ
thit	hɪtʲ
nádúrthach	n̪ˠɑd̪ˠuːɾˠəx
molas	mˠɔlˠəsˠ
chasfadh	kasˠu
cóiriú	koːɾʲuː
sead	ʃad̪ˠ
ardaingeal	ɑːɾˠdˠæɲɟəl
ullmhaigh	ʊl̪ˠəvˠɪɟ
uaithi	woː
claon	kl̪ˠiːnˠ
féicheamh	fʲeːçuː
ospidéil	ʌspʲədʲælʲ
lá	l̪ˠæː
iníon	n̠ʲiənˠ
pé	pʲeː
bándearg	bˠɑːnˠdʲaɾˠəɡ
seach	ʃax
bpáipéar	bˠæːpʲeɾˠ
críon	cɾʲiːnˠ
saghas	sˠəisˠ
cárbh	kaːɾˠvˠ
d'aithin	d̪ˠæn
eol	oːlˠ
roinn	ɾˠiːn̠ʲ
salach	sˠalˠax
meiriceá	mʲɛɾʲəcɑː
foireann	fˠɪɾʲən̪ˠ
oileann	ɪlʲən̪ˠ
gréasán	ɟɾiasˠɑːn̪ˠ
chugatsa	hɞɡət̪ˠsˠə
fhada	ɑd̪ˠə
sinéad	ʃɪnʲeːd̪ˠ
boga	bˠɔɡə
leagann	l̠ʲaɡən̪ˠ
feadh	fʲaw
chrainn	xɾˠɪn̠ʲ
dhóthain	ɣoːnʲ
éirím	əiɾʲiːmʲ
coiste	kɔʃtʲə
féach	fʲiax
lána	l̪ˠæːnˠə
dtóir	d̪ˠoːɾʲ
láth	l̪ˠɑː
oifigiúil	ɪfʲɪɟuːlʲ
le	lʲɛ
mear	mʲaɾˠ
cinneadh	cɪn̠ʲə
páipéar	pˠæːpʲeɾˠ
am	ɑːmˠ
baois	bˠiːʃ
báine	bˠɑːnʲə
annamh	an̪ˠu
aerach	eːɾˠəx
oil	ɪlʲ
gleann	ɟlʲaːnˠ
dearg	dʲæɾˠəɡ
chuigesean	ɛɟəsˠən
thógaint	hoːɡənʲtʲ
ceonna	cɔːn̪ˠə
cneasta	cɾʲasˠt̪ˠə
cuntas	kʊn̪ˠt̪ˠəsˠ
iarla	iəɾˠl̪ˠə
cló	klˠoː
cinnte	cəinʲtʲə
gasúr	ɡɑsˠuːɾˠ
oird	əuɾˠdʲ
truicear	t̪ˠɾˠɪcəɾˠ
chum	xuːmˠ
báisín	bˠæːʃinʲ
seanmóirí	ʃan̪ˠəmoːɾʲiː
scoláireacht	sˠkʌlˠæɾʲaht̪ˠ
cabáiste	ɡʊbˠɑːʃtʲə
triomach	tʲɾʲɪmah
spáinn	sˠpˠɑːn̠ʲ
criostal	kɾˠɪsˠt̪ˠəlˠ
bhí	vʲiː
faoistin	fˠiːsʲtʲinʲ
oraibhse	ɞrˠiːʃə
ospidéal	ʌsˠpʲədʲælˠ
ainneoin	anʲoːnʲ
díon	dʲiːnˠ
speisialta	sˠpʲɛʃiəl̪ˠt̪ˠə
ceonna	coːn̪ˠə
céir	ceːɾʲ
dóibh	d̪ˠoːbʲ
dearcadh	dʲaɾˠkuː
dearthár	dʲɾʲɑːɾˠ
d'ainneoin	d̪ˠanʲoːnʲ
dúr	d̪ˠuːɾˠ
argóint	ɑɾˠɡoːnʲtʲ
stró	sˠt̪ˠɾˠoː
mháthair	wɑːhəɾʲ
pléigh	pʲlʲeː
dtosach	d̪ˠəsˠɑx
gnás	ɡn̪ˠɑːsˠ
scoileanna	sˠkɛlʲən̪ˠiː
tosnaigh	t̪ˠɔsˠən̪ˠɪɟ
sútra	sˠuːt̪ˠɾˠə
múchadh	mˠuːxə
dúin	d̪ˠuːnʲ
tostar	t̪ˠʌsˠt̪ˠəɾˠ
lúthchleas	l̪ˠuːçlʲasˠ
spúnóg	sˠpˠuːnˠaɡ
curaigh	kʊɾˠɪɟ
tiomáin	tʲɪmˠɑːnʲ
scuabtha	sˠkuəpˠə
cruinnigh	kɾˠɪn̠ʲi
ceintiméadar	cɛnʲtʲəmʲeːd̪ˠəɾˠ
pastae	pˠasˠt̪ˠeː
pianfaidh	pʲiənhiː
lorg	l̪ˠʌɾˠəɡ
seamróga	ʃamˠəɾˠoːɡə
móir	mˠoːɾʲ
min	mʲɪnʲ
comharsa	kuːɾˠsˠə
polláire	pˠɔːlˠɑːɾʲə
trína	tʲɾʲiːnˠə
bain	bˠɪnʲ
gram	ɡɾˠamˠ
óstach	ɔːsˠt̪ˠah
casadh	kasˠətʲ
fé	fʲeː
chonaic	hɛnʲɪc
imeall	ɪmʲəlˠ
deir	dʲɛɾʲ
faoinar	fˠiːnˠəɾˠ
phianadh	fʲiənˠə
lucht	l̪ˠʊxt̪ˠ
dearbh	dʲaɾˠəvˠ
gobadh	ɡɔbˠə
tastáil	t̪ˠasˠt̪ˠɑːlʲ
deirfiúr	dʲɾʲauhəɾˠ
arbhar	ɑɾˠuːɾˠ
pheann	fʲɑːn̪ˠ
beoracha	bʲoːɾˠəxə
snáitheann	sˠn̪ˠæːihən̪ˠ
feabhas	fʲoːsˠ
donn	d̪ˠɔn̪ˠ
chugaibhse	ɑɡiːʃə
micheál	mʲɪçaːlˠ
sona	sˠʊn̪ˠə
sásair	sˠɑːsˠəɾʲ
scaradh	sˠkaɾˠətʲ
seáin	ʃɑːnʲ
dúiseacht	d̪ˠuːʃəxt̪ˠ
fheicfeadh	ɛcəx
compóirt	kuːmˠpˠoːɾˠtʲ
aibí	abʲɪɟ
rith	ɾˠɪh
mbád	mˠɑːd̪ˠ
ghairdín	ɣæːɾˠdʲinʲ
fliuchadh	fʲlʲʊxəvˠ
réidh	ɾˠeː
spalptha	sˠpˠalpiː
bhun	wʌnˠ
im	ɪmˠ
leagadh	l̠ʲaɡəɡ
gníomh	ɟɾʲiːəvˠ
cérbh	ceːɾˠvˠ
tóir	t̪ˠɔːɾʲ
múnadh	mˠuːnˠuː
éisteacht	eːʃtʲaht̪ˠ
leictreachas	l̠ʲɛctʲɾʲəxəsˠ
d'fheicfeadh	dʲɛcəx
bearradh	bʲaɾˠu
loscann	l̪ˠɔsˠkən̪ˠ
feidhmeannach	fʲəimʲən̪ˠəx
adhmad	æːmˠəd̪ˠ
aithníonn	ænʲiːn̪ˠ
seisiún	ʃɛʃunˠ
dhóigh	ɣoːɟ
chuimhnigh	xiːvʲɾʲə
sámh	sˠɑːvˠ
seisiún	ʃɛʃuːn̪ˠ
gcnuic	ɡn̪ˠɪc
faightear	fˠahaɾˠ
coillte	kəil̠ʲtʲə
aiseag	aʃəɡ
deirfiúracha	dʲeɾʲəfʲəɾˠaxə
girseach	ɟɪɾˠʃah
ceannaigh	can̪ˠəɟ
cairdiúil	kɑːɾˠdʲuːlʲ
thúis	huːʃ
chuireas	xɪɾʲəsˠ
bronn	bˠɾˠʌn̪ˠ
iascach	iəskah
cúramach	kuːɾˠəmˠəx
fás	fˠɑːsˠ
sábháil	sˠæːwælʲ
gairleog	ɡɑːɾˠlʲoːɡ
dhóibh	ɣoːbˠ
loisc	l̪ˠɛʃc
doras	d̪ˠɔɾˠəsˠ
beiridh	bʲɛɾʲiːɟ
mac	mˠaːk
cuireann	kɪɾʲən̪ˠ
fisic	fʲɪʃɪc
binn	bʲiːnʲ
anam	ɑn̪ˠəmˠ
gair	ɡaɾʲ
barr	bˠæːɾˠ
ceathrú	caɾˠu
cánach	kɑːnˠəx
chailín	xalʲinʲ
leagan	l̠ʲaɡənˠ
méir	mʲeːɾʲ
lasadh	l̪ˠasˠuː
beithíoch	bʲɛhiəh
gnách	ɡn̪ˠɑːx
taidhleoir	t̪ˠailʲoːɾʲ
bhur	ə
poiblí	pˠʌbʲlʲi
chugat	hʊɡəd̪ˠ
bréagach	bʲɾʲeːɡəx
meaingeal	mæɲɟəl
liom	lʲɔmˠ
don	d̪ˠɔnˠ
d'fheiceadh	dʲɛcəx
cuidhil	kiːlʲ
dath	d̪ˠah
hithe	hiə
grúpa	ɡɾˠuːpˠə
punt	pˠʊn̪ˠt̪ˠ
gcasadh	ɡasˠə
tíogar	tʲiːɡəɾˠ
fhágadar	æːɡəd̪ˠəɾˠ
gin	ɟɪnʲ
sáraíocht	sˠɑːɾˠiəxt̪ˠ
reilig	ɾˠəliːc
céilíoch	ceːlʲiːəx
fosclóchaidh	fˠɔsˠklˠaxi
athfhás	ahɑːsˠ
miotóg	mʲɪt̪ˠoːɡ
cúigear	kuːɟəɾˠ
crochadh	kɾˠɔxə
báine	bˠæːnʲə
cuimhniú	kiːvʲɾʲuː
deargadh	dʲaɾˠəɡuː
cáibín	kaːbʲinʲ
phiocadh	fʲɪku
casa	kasˠə
chrann	xɾˠan̪ˠ
it	ɪt̪ˠ
aird	æːɾˠdʲ
micheál	mʲiːɑːl̪ˠ
measa	mʲasˠə
soithí	sˠəi
soilse	sˠʌl̠ʲʃə
adharc	əiɾˠk
déanta	dʲeːn̪ˠt̪ˠə
béas	bʲeːsˠ
ceanna	cæn̪ˠə
aerach	eːɾˠax
agaibh	əɣɪvʲ
galúin	ɡalˠunʲ
glanadh	ɡlˠanˠətʲ
mic	mʲɪc
fleá	fʲlʲaː
gránaigh	ɡɾˠɑːn̪ˠɪɟ
seanchas	ʃanəxəsˠ
fásta	fˠɑːsˠt̪ˠə
caraid	kaɾˠədʲ
saothar	sˠeːhəɾˠ
inné	ən̠ʲeː
miúil	mʲuːlʲ
maorga	mˠiːɾˠɡə
d'oilfeadh	d̪ˠɛlʲhətʲ
cora	kɔɾˠə
síneadh	ʃiːnʲəx
gcrainn	ɡɾˠaiɲ
cailleach	kal̠ʲah
dream	dˠɾˠoumˠ
timpiste	tʲɪmˠpˠəʃtʲə
fúibh	fˠuːbʲ
feadh	fʲæː
dtír	dʲiːɾʲ
chónaithe	xuːn̪ˠiː
úr	uːɾˠ
líonra	lʲiːn̪ˠɾˠə
scóp	sˠkoːpˠ
foscail	fˠasˠkəlʲ
críoch	cɾʲiːx
d'fhágadar	d̪ˠæːɡəd̪ˠəɾˠ
niamh	n̠ʲiəvˠ
dhuitse	ɣɪtʲʃə
giuirléid	ɟuːɾˠlʲedʲ
ceann	caːn̪ˠ
sínigh	ʃiːnʲə
snáth	sˠn̪ˠɑː
foighne	fˠəinʲə
líne	l̠ʲiːnʲə
maraigh	mˠaɾˠə
lathach	l̪ˠɑːx
cinnte	cɪn̠ʲtʲə
veigeán	vʲɛɟɑːnˠ
ainseabhaí	anʲʃəwiː
ngram	ŋɾˠamˠ
troigh	t̪ˠɾˠɪɟ
uaidh	wəi
coillteach	kʌl̠ʲtʲah
compord	kuːmˠpˠoːɾˠtʲ
caoineadh	kiːnʲəvˠ
tosú	t̪ˠɔsˠuː
cisteanaí	cɪʃtʲən̪ˠiː
árthach	ɑːɾˠhəx
seadadh	ʃad̪ˠuː
gach	ɡax
fliuchadh	fʲlʲɔxətʲ
líomóid	lʲiːmˠoːdʲ
agat	aɡət̪ˠ
plána	pˠl̪ˠɑːn̪ˠə
héin	heːnʲ
ngobadh	ŋʌbˠu
léas	l̠ʲeːsˠ
óltar	ɔːl̪ˠt̪ˠəɾˠ
seagal	ʃaɡəlˠ
leath	lʲæx
púca	pˠuːkə
pláinéad	pˠl̪ˠɑːnʲeːd̪ˠ
socra	sˠɔkɾˠə
cófra	koːfˠɾˠə
clí	clʲiː
bhrisfeadh	vʲɾʲɪʃu
caoga	kiːɡə
díbríodh	dʲiːbʲɾʲiw
scoitheadh	skahu
d'fhágadar	d̪ˠəɣɑːɡəd̪ˠəɾˠ
cuaird	kuəɾˠdʲ
seachtar	ʃaxt̪ˠəɾˠ
asainne	aːsˠən̠ʲə
d'fhágadh	d̪ˠɑːɡətʲ
sál	sˠɑːlˠ
chaill	xal̠ʲ
hadharca	həiəɾˠkə
lachtach	l̪ˠaxt̪ˠəx
shín	hiːnʲ
finn	fʲiːn̠ʲ
dearmad	dʲaɾˠəmˠəd̪ˠ
libh	lʲɪbʲ
breithiúnais	bʲɾʲəhuːn̪ˠəʃ
tosaigh	t̪ˠɔsˠə
gairm	ɡaɾʲəmʲ
dhaoibh	ɣiːvʲ
inarbh	ɪnˠəɾˠvˠ
scátháin	sˠkɑːhɑːnʲ
scríbend	sʲkʲrʲiːvʲen͈d
ghlúine	ɣl̪ˠuːnʲə
áirithe	ɑːɾʲiː
uair	uəɾʲ
ponc	pˠʊŋk
tine	tʲɪnʲə
mbláthanna	mˠl̪ˠɑːn̪ˠiː
arú	aɾˠu
scaradh	sˠkaɾˠəx
foradh	fˠɔɾˠuː
dearna	dʲɑːɾˠn̪ˠə
aithníodh	ænʲiːx
seadadh	ʃad̪ˠəvˠ
cárta	kɑːɾˠt̪ˠə
oifig	ɪfʲɪɟ
cam	kamˠ
rua	ɾˠuə
bhfiaradh	vʲiəɾˠəx
tiomáin	tʲɪmˠænʲ
cónaí	kɔːnˠi
cluas	klˠuəsˠ
bhlais	vˠlˠaʃ
tóigeáil	t̪ˠoːɟɑːlʲ
féin	heːnʲ
carad	kaɾˠəd̪ˠ
fréamhacha	fʲɾʲeːvˠaxə
ainnir	æn̠ʲəɾˠ
mckeon	məkjoʊn
nóin	n̪ˠoːnʲ
consan	kʊnˠsˠənˠ
orthusan	ɔɾˠəpˠsˠən
bró	bˠɾˠɔː
cabhlach	kəul̪ˠəx
bóthair	boːhəɾʲ
cogaíocha	kɔɡiəxiː
gearradh	ɟaɾˠə
cleacht	clʲaxt̪ˠ
gaibh	ɡavʲ
smig	sˠmʲɪɟ
cróga	kɾˠɔːɡə
ndán	n̪ˠɑːn̪ˠ
ní	n̠ʲiː
folamh	fˠɔl̪ˠəvˠ
fírinneach	fʲiːɾʲən̠ʲəx
cíos	ciːsˠ
luím	l̪ˠiːmʲ
cealgaire	calˠəɡəɾʲə
buaigh	bˠuˑə
próifíl	pˠɾˠoːfʲiːlʲ
paráiste	pˠəɾˠɑːʃtʲə
moladh	mˠɔlˠətʲ
deasa	dʲasˠə
hár	hɑːɾˠ
ngobadh	ɡɔbˠəx
frása	fˠɾˠæːsˠə
d'aithneodh	d̪ˠænʲətʲ
bandach	bˠan̪ˠd̪ˠah
cuán	kuːɑːnˠ
nua	urˠ
feadha	fʲɑː
buinne	bˠɪn̠ʲə
deireadh	dʲɛɾʲə
díbríodh	dʲiːbʲɾʲiːx
breoite	bʲɾʲoːtʲə
cad	kad̪ˠ
stopadh	sˠt̪ˠʌpˠu
meitheamh	mʲɛhuː
fáth	fˠæː
gciliméadar	ɟɪlʲəmʲed̪ˠəɾˠ
peacadh	pʲaku
tóin	t̪ˠuːnʲ
fhaide	adʲə
coill	kɞl̠ʲ
bhriseadh	vʲɾʲɪʃə
corcaigh	kɔɾˠkəɟ
tráthnóna	t̪ˠɾˠɑːn̪ˠuːn̪ˠə
fir	fʲɪɾʲ
roth	ɾˠɔh
focla	fˠɔkl̪ə
ciseán	cɪʃæn̪ˠ
múchadh	mˠuːxəvˠ
righin	ɾˠiːnʲ
aireachtáil	aɾʲəxt̪ˠɑːlʲ
tuismigh	t̪ˠɪʃmə
aireachtáil	æːɾʲəxt̪ˠɑːlʲ
plódaithe	pˠlˠoːd̪ˠiː
éirigh	iːɾʲiː
mhaithe	wãhə
gcuireann	ɡɪɾʲən̪ˠ
ann	an̪ˠ
asatsa	ɑsˠət̪ˠsˠə
dtarbh	d̪ˠaɾˠu
bharr	wˠɑːɾˠ
cruach	kɾˠuəx
haváis	hawaːɪʃ
sé	ʃə
salm	sˠal̪ˠəmˠ
abhainn	əun̠ʲ
urlár	ʊɾˠl̪ˠæɾˠ
led	lʲɛd̪ˠ
greannmhar	ɟɾʲan̪ˠwəɾˠ
lasadh	l̪ˠɑsˠəɡ
bhíothas	vʲiːhəsˠ
oilfidh	ɪlʲhə
eatarthu	ɑt̪ˠɾˠəpˠ
ardeaspag	ɑːɾʲdʲæsˠpˠəɡ
carbón	kaɾˠəbˠoːnˠ
tachtadh	t̪ˠɑxt̪ˠə
dhíbh	jiːbʲ
meisce	mʲɛʃcɪ
peata	pʲat̪ˠə
bachlach	bˠɑhəl̪ˠəx
asaibh	asˠi
géig	ɟeːɟ
lom	lˠoumˠ
trosc	t̪ˠɾˠɔsˠk
cloinne	kl̪ˠɪnʲə
oileáin	ɪlʲɑːnʲ
sár	sˠæːɾˠ
faisean	fˠaʃənˠ
peall	pʲal̪ˠ
bhrí	vʲɾʲiː
rinn	ɾˠiːn̠ʲ
tógann	t̪ˠoːɡən̪ˠ
luím	l̪ˠəimʲ
rinneadh	ɾˠɪnʲuː
gcasadh	ɡɑsˠə
druid	d̪ˠɾˠɪdʲ
clearer	klɪəɹə
francach	fˠɾˠaŋkəx
chiliméadar	çɪlʲəmʲeːd̪ˠəɾˠ
bpianadh	bʲiənˠə
ghránaigh	ɣɾˠæːnˠi
puis	pˠɪʃ
sioc	ʃʊk
ansin	ənʲʃɪnʲ
tuaighe	t̪ˠuəj
ealaín	ɑlˠɨnʲ
binne	bʲɪnʲə
ligfidh	l̠ʲɪcɪ
bogach	bˠɔɡəx
réam	ɾˠeːmˠ
minic	mʲɪnʲɪc
bunaigh	bˠʊnˠiː
guaillí	ɡuəl̠ʲiː
críochnaigh	cɾʲiəxn̪ˠə
thánadar	hɑːn̪ˠəd̪ˠəɾˠ
francach	fˠɾˠauŋkəx
meáchan	mʲaːxənˠ
reoiteog	ɾˠɔːtʲaɡ
leathré	lʲahɾʲeː
scairteadh	sˠkaɾˠtʲə
taobh	t̪ˠiːvˠ
ghránaigh	ɣɾˠɑːnˠə
gcéibh	ɟeːvʲ
srón	sˠɾˠuːn
mód	mˠɔːd̪ˠ
ciach	ciəx
ábaltacht	æːbˠəl̪ˠt̪ˠaxt̪ˠ
ceol	coːlˠ
fuadar	fˠuəd̪ˠəɾˠ
aithin	ænʲ
bheag	vʲɛɡ
imir	ɪmʲəɾʲ
scanrú	sˠkæːn̪ˠɾˠu
donas	d̪ˠʌnˠəsˠ
thoiligh	hɛlʲiː
tharra	haɾˠə
rinn	ɾˠəiɲ
chloisfeadh	xlˠɔʃəx
acu	ɑkəbˠ
nuaíocht	n̪ˠuːiəxt̪ˠ
carraigreacha	kaɾˠɪɟɾʲəxiː
gabhal	ɡoːlˠ
caife	kafʲə
seanfhocal	ʃanˠɔkəlˠ
cogarnaíl	kɔɡəɾˠn̪ˠiːlʲ
trealamh	tʲɾʲalˠuː
éirigh	əiɾʲɪɟ
arsa	aɾˠsˠə
cúthail	kuːlʲ
dúisigh	d̪ˠuːʃiː
baoth	bˠeː
tháinig	hɑːnʲɪɟ
dúnmharú	d̪ˠuːn̪ˠvˠaɾˠuː
mire	mʲɪɾʲə
im	aimʲ
dreoigh	dʲɾʲɔːj
cirt	kʲir͈ʲtʲ
droichead	d̪ˠɾˠɛçəd̪ˠ
cian	ciənˠ
thorann	hɔɾˠən̪ˠ
colm	kʌl̪ˠəmˠ
brocach	bˠɾˠʌkah
mhaoin	wiːnʲ
dónall	d̪ˠoːnˠəl̪ˠ
úd	uːd̪ˠ
caoirigh	kiːɾʲiː
deirfiúracha	dʲeɾʲəfʲaɾˠaxə
dearcadh	dʲaɾˠkətʲ
monarcha	mˠʊnˠəɾˠxə
achar	axəɾˠ
blasta	bˠlˠasˠt̪ˠə
éiríonn	iːɾʲin̪ˠ
cruacha	kɾˠuəxə
luch	l̪ˠʊx
cruinneál	kɾˠɪn̠ʲɑːl̪ˠ
mholadh	wɔlˠəx
tí	tʲiː
seaicéad	ʃacæd̪ˠ
gnáth	ɡɾˠɑː
péinteáil	pʲeːn̠ʲtʲælʲ
nuair	n̪ˠəɾʲ
bheinn	vʲɛn̠ʲ
báite	bˠæːtʲə
guíonna	ɡiːn̪ˠə
léise	leːʃə
gual	ɡuəlˠ
ullmhaigh	ʊl̪ˠwiː
adhnaic	əin̪ˠəc
cladh	klˠəi
ceannaigh	can̪ˠi
asaibhse	asˠt̪ˠiːʃə
chugainn	xʊɡən̠ʲ
bogha	bˠoː
tírghráthóir	tʲiːɾʲɡɾˠaːtʲoːɾʲ
chomh	xuː
oileadh	ɛlʲəvˠ
cána	kɑːn̪ˠə
spealaid	sˠpʲalˠədʲ
tonn	t̪ˠʌn̪ˠ
dhíot	ɣiːt̪ˠ
triall	tʲɾʲiəl̪ˠ
milseáin	mʲiːʃlʲaːnʲ
príomhchathair	pˠɾˠiːwxahɪɾʲ
mbó	mɔː
chreideadh	çɾʲɛdʲəx
gal	ɡɑl̪ˠ
fúinn	fˠuːn̠ʲ
d'oileadh	d̪ˠɪlʲuː
chomhair	xoːrʲ
dainséar	d̪ˠan̠ʲʃaɾˠ
cuisneoir	kəʃnʲoːɾʲ
teoiric	tʲɔːɾʲɪc
buachaill	bˠuəxɪlʲ
colainn	kɔl̪ˠənʲ
brachán	bˠɾˠahanˠ
hocht	hʌxt̪ˠ
cabhantar	kəun̪ˠt̪ˠəɾˠ
laga	l̪ˠaɡə
cruinnigh	kɾˠɪn̠ʲiː
ghlacann	ɣlˠakən̪ˠ
cóisir	koːʃəɾʲ
pianann	pʲiənˠən̪ˠ
id	ɪd̪ˠ
bacadh	bˠakuː
suíomh	sˠiːw
abartha	abˠəɾˠə
gcara	ɡaɾˠə
coillteach	kiːlʲtʲəx
bé	bʲeː
hithe	hiːhə
sáil	sˠæːlʲ
luathcha	l̪ˠuəxə
urlár	əuɾˠl̪ˠɑːɾˠ
gcearnóg	ɟæːɾˠn̪ˠɔɡ
ardeaspag	ɑːɾˠd̪ˠæsˠpˠəɡ
arm	aɾˠəmˠ
ngealach	ɲæːl̪ˠəx
d'fhágadh	d̪ˠɑːɡuː
caor	keːɾˠ
cúramach	kuːɾˠəmˠah
oileán	ɪlʲɑːnˠ
ruacan	ɾˠuəkənˠ
dócha	d̪ˠoːxə
léine	l̠ʲeːnʲə
án	æːnˠ
bunábhar	bˠʊnˠæːwəɾˠ
ceannach	can̪ˠah
bhfreastalaí	fʲɾʲasˠt̪ˠəlˠiː
eile	ɛlʲə
fichid	fʲɪçədʲ
fá	fˠæː
sruthán	sˠɾˠɑːn̪ˠ
chiliméadar	çɪlʲəmʲed̪ˠəɾˠ
shábháil	hɑːvˠɑːlʲ
síleáil	ʃiːlʲaːlʲ
socair	sˠɔkəɾʲ
dhóthain	ɣoːhənʲ
breac	bʲɾʲak
gafa	ɡafˠə
seachtar	ʃæːxt̪ˠəɾˠ
diamant	dʲiˑəmˠən̪ˠt̪ˠ
candáil	kan̪ˠd̪ˠɑːlʲ
sluaiste	sˠl̪ˠuəʃtʲɪ
péine	pʲeːnʲə
cheas	çasˠ
peann	pʲɑːn̪ˠ
orthu	ɔɾˠə
ndóchas	n̪ˠɔːxəsˠ
dhósan	ɣoːsˠənˠ
spáinn	sˠpˠæːn̠ʲ
oraibh	əɾˠiː
éiríonn	əiɾʲiːn̪ˠ
léi	lʲeː
nóiméad	n̪ˠuːmʲeːd̪ˠ
leacht	l̠ʲaxt̪ˠ
príosún	pʲɾʲiːsˠuːn̪ˠ
'adsa	ɑt̪ˠsˠə
rochtain	ɾˠʌxt̪ˠənʲ
beart	bʲaɾˠt̪ˠ
feamainn	fʲamˠɪɲ
ocsatánais	ɔksətˠaːnˠɪʃ
tiúba	tʲuːbˠə
bromach	bˠɾˠɤmˠah
fánach	fˠæːnˠah
firéad	fʲɪrʲad̪ˠ
aigéan	aɟeːnˠ
chat	xat̪ˠ
muc	mˠʊk
sean	ʃanˠ
saoil	sˠeːlʲ
ndéanfadh	n̠ʲiːnəx
bolcáin	bɔlˠkænʲ
leafaos	lʲafˠeːsˠ
mhúchadh	wuːxu
bhfeadh	vʲæː
tiománach	tʲɪmˠænah
díol	dʲiːlˠ
chífinn	çiːhənʲ
'am	ɑːmˠ
baist	bˠaʃtʲ
frainc	fɾˠæɲc
ceacht	caxt̪ˠ
goile	ɡɛlʲə
feis	fʲɛʃ
ól	oːl̪ˠ
gleoite	ɟlʲoːtʲə
dóid	d̪ˠɔːdʲ
tost	t̪ˠɔsˠt̪ˠ
volaifis	wɔl̪ˠəfʲɪʃ
dearcadh	dʲaɾˠku
adhall	əiəl̪ˠ
mhóra	vˠoːɾˠə
lítear	l̠ʲiːtʲəɾˠ
stoc	sˠt̪ˠɔk
géag	ɟeːɡ
néal	n̠ʲeːlˠ
hair	haɾʲ
chuicise	hɛcɪʃə
conchúr	kɾˠɔxuːɾˠ
comhréireach	kˠõɾˠeːɾʲəxˠ
caoirigh	kiːɾʲə
dheireadh	jɛɾʲuː
luígí	l̪ˠiːɟiː
tachtadh	t̪ˠɑxt̪ˠəvˠ
macánta	makɑːn̪ˠt̪ˠə
péas	pʲeːsˠ
suaimhneach	sˠuənʲah
crua	kɾˠuəj
bacaigh	bˠaki
muirear	mˠɪɾʲəɾˠ
pholainn	fˠɔl̪ˠɪɲ
phósadh	fˠoːsˠəx
saibhris	sˠɛvʲəɾʲəʃ
murar	mˠʊɾˠəɾˠ
d'fhágadar	d̪ˠɑːɡəd̪ˠəɾˠ
chiall	çiəl̪ˠ
céille	ceːl̠ʲə
veigeatóir	vʲɛɟɪt̪ˠoːrʲ
oraibh	ɔɾˠiː
fine	fʲɪnʲə
eitleáin	ɛtʲəlʲænʲ
aníos	ən̠ʲiːsˠ
dhi	ɣiː
beatha	bʲahə
traein	t̪ˠɾˠeːnʲ
ót	oːt̪ˠ
cneas	cnʲasˠ
airgead	aɾʲɪɟəd̪ˠ
caighdeánach	kəidʲɑːnˠəx
lean	l̠ʲanˠ
gcuraigh	ɡʊɾˠə
stopadh	sˠt̪ˠʌpˠətʲ
d'fhágfadh	d̪ˠæːku
díreacha	dʲiːɾʲəxə
tig	tʲɪɟ
mhiste	vʲɪʃtʲə
saibhreas	sˠɛvʲəɾʲəsˠ
feadh	fʲaɡ
sheáin	çæːnʲ
ceannach	can̪ˠəx
bíchearb	bʲiːçəɾˠəbˠ
fairsing	fˠɑɾˠʃɪɲ
minicí	mʲɪnɪciː
gluaisrothar	ɡlˠuəʃɾˠɔhəɾˠ
slaghdán	sˠl̪ˠəid̪ˠæn̪ˠ
ithe	iə
más	mˠɑːʃ
tapa	t̪ˠapˠə
fan	fˠanˠ
bpósfadh	bˠoːsˠəx
doiciméad	d̪ˠɔcɪmʲeːd̪ˠ
máthar	mˠɑːhəɾˠ
pínn	pʲiːn̠ʲ
dhe	jɛ
oscailt	ʌsˠkəl̠ʲtʲ
uaithise	woːʃə
fuinneog	fʲɪɲuːɡ
broc	bˠɾˠʌk
altfadh	al̪ˠt̪ˠuː
leiceann	l̠ʲɛcən̪ˠ
trá	t̪ˠɾˠæːj
aois	iːʃ
pósfadsa	pˠoːsˠəd̪ˠsˠ
foscadh	fˠasˠku
cuire	kɪɾʲə
bualadh	bˠɔlˠə
d'ullmhaigh	d̪ˠʊl̪ˠwə
dos	d̪ˠɔsˠ
fhómhar	ɔːwəɾˠ
lúbaire	l̪ˠuːbˠəɾʲə
gceanada	ɟanˠəd̪ˠə
pós	pˠɔːsˠ
má	mˠæː
aeráid	eːɾˠædʲ
gabhar	ɡoːɾˠ
inseodh	iːnʲʃoːx
carraig	kaːɾˠɪɟ
bradán	bˠɾˠad̪ˠaːnˠ
éire	eːɾʲə
craein	kɾˠeːnʲ
caighdeán	kəidʲænˠ
ghnách	ɣnˠɑːx
éigean	eːɟənˠ
damhsa	d̪ˠəusˠə
sinsir	ʃɪn̠ʲsʲəɾʲ
deirfiúracha	dʲɾʲauɾˠəxiː
iodáil	əd̪ˠɑːlʲ
cat	kɑt̪ˠ
titim	tʲɪtʲəmʲ
caolas	keːl̪ˠəsˠ
chasadh	xɑsˠəx
phianfadh	fʲiənˠhətʲ
thall	hɑːl̪ˠ
droichid	d̪ˠɾˠeːdʲ
chucól	xʊkoːl̪ˠ
oisín	ɔʃiːnʲ
droma	d̪ˠɾˠɔmˠə
teas	tʲasˠ
ardghlórach	ɑːɾˠd̪ˠɣlˠɔːɾˠah
bréag	bʲɾʲeːɡ
tomhais	t̪ˠɞʃ
stopallán	sˠt̪ˠɔpəl̪ˠɑːnˠ
nollag	n̪ˠɔl̪ˠək
siúcra	ʃuːkɾˠə
freastalóidh	fʲɾʲasˠt̪ˠəlˠoːj
fhiaradh	iəɾˠətʲ
pice	pʲɪcɪ
phianadh	fʲiənˠəx
aoibhinn	iːvʲɪɲ
garraí	ɡɑɾˠiː
mine	mʲɪnʲə
im	ɪmʲ
áth	ɑː
dháiríre	ɣɑːɾʲiːɾʲə
thuaidh	huəj
spéir	spʲeːɾʲ
tambóirín	t̪ˠamˠbˠoːɾʲiːnʲ
lachtach	l̪ˠaxt̪ˠah
gá	ɡæː
fhreastalaíodh	ɾʲasˠt̪ˠəlˠiːtʲ
chnoc	xn̪ˠɔk
ionam	ʊn̪ˠt̪ˠəmˠ
tseilg	tʲɛlʲɪɟ
bua	bˠuə
peaca	pʲakə
thosnaigh	hɔsˠən̪ˠɪɟ
toll	t̪ˠɔl̪ˠ
bhuntáiste	vˠən̪ˠt̪ˠɑːʃtʲə
chéad	çeːd̪ˠ
páirtí	pˠɑːɾˠtʲiː
anois	ən̪ˠɪʃ
gan	ɡɑn̪ˠ
díograiseach	dʲiːɡɾˠəʃəx
córam	koːɾˠəmˠ
máistreása	mˠɑːʃtʲɾʲɑːsˠə
dol	d̪ˠʌlˠ
breá	bʲɾʲæː
harc	haɾˠk
coiteann	kɔtʲən̪ˠ
sleamhnaigh	ʃlʲəunˠə
náid	n̪ˠɑːdʲ
dtiocfá	d̪ˠʊkfˠɑː
uilig	əlʲʊɡ
carbán	karˠbˠænˠ
fliuch	fʲlʲʊx
áith	ɑː
teann	tʲɑːn̪ˠ
páiste	pˠæːʃtʲə
mholfadh	wɔlˠhuː
d'ullmhaigh	d̪ˠʊl̪ˠəvˠɪɟ
cleachtadh	clʲaxt̪ˠə
eadáineach	ad̪ˠoːnəx
iontrálacha	ʊn̪ˠt̪ˠɾˠɑːl̪ˠəxə
báisín	bˠɑːʃiːnʲ
ealaín	æliːn
rúsc	ɾˠuːsˠk
deartháracha	dʲɾʲɑːɾˠəxiː
amuigh	əmˠɪj
breithiúnais	bʲɾʲɛhuːnˠəʃ
cónra	kõːnəɾʲ
bhfuil	wɪlʲ
claí	klˠiː
dhi	jɪ
píb	pʲiːbʲ
caomh	kiːw
spúnóg	sˠpˠuːn̪ˠoːɡ
smál	sˠmˠɑːlˠ
nollaig	n̪ˠɔl̪ˠəc
feoilséantóir	fʲoːlʲʃeːn̪ˠt̪ˠoːrʲ
dáir	d̪ˠɑːɾʲ
aimsire	æːmʲʃəɾʲə
fágáil	fˠɑːɡɑːlʲ
claí	klˠəi
dealbh	dʲalˠəvˠ
lasas	l̪ˠasˠəsˠ
airigh	æɾʲə
ngobadh	ŋɔbˠətʲ
ois	ɪʃ
fhaill	ɑilʲ
geal	ɟalˠ
donna	d̪ˠʊn̪ˠə
mhalairt	walˠəɾˠtʲ
bogadh	bˠɔɡəɡ
beas	bʲɛsˠ
galún	ɡəlˠuːnˠ
cogadh	kɔɡə
tonn	t̪ˠaun̪ˠ
bpáistí	bˠɑːʃtʲiː
rúisis	ɾˠuːʃəʃ
bheidís	vʲɛdʲiːʃ
leagfadh	l̠ʲakəx
roinn	ɾˠiːɲ
donasach	d̪ˠɔnˠəsˠəx
saolta	sˠiːl̪ˠt̪ˠə
uaireanta	uəɾʲən̪ˠt̪ˠiː
mhac	vˠɑk
aici	ɛcɪ
nuachtán	nˠuˑəxt̪ˠaːnˠ
deartháir	dʲɾʲɑːhərʲ
bhuntáiste	wˠʊn̪ˠt̪ˠæʃtʲə
bearach	bʲaɾˠəx
athléim	ɑleːmʲ
ealaín	alˠiːnʲ
briseadh	bʲɾʲɪʃəx
amh	avˠ
cáinte	kɑːn̠ʲtʲə
uathusan	woːpsən
chuaigh	xuəɟ
faigh	fˠəi
eadraibh	at̪ˠɾˠiː
d'fhágfadh	d̪ˠɑːkətʲ
maol	mˠeːl̪ˠ
carraigín	kɑɾˠɪɟiːnʲ
chugat	ʊɡədˠ
fhocal	ʌkəlˠ
cnáimh	kɾˠɑːvʲ
fuinneog	fˠəɲoːɡ
siúlta	ʃuːl̪ˠt̪ˠə
cealg	calˠəɡ
náisiún	n̪ˠæːʃunˠ
greim	ɟɾʲiːmʲ
tonn	t̪ˠuːn̪ˠ
ceapaire	capˠəɾʲə
seachtó	ʃaxt̪ˠoː
lúcháir	l̪ˠəwɑːɾʲ
aibhneacha	uəvn̠ʲəxə
acht	ɑxt̪ˠ
tais	t̪ˠaʃ
fáisc	fˠɑːʃc
ospidéil	ɔspʲədʲeːlʲ
toinn	t̪ˠɪn̠ʲ
tada	t̪ˠad̪ˠə
bhisigh	vʲɪʃə
seile	ʃɛlʲə
vóta	woːt̪ˠə
féidir	fʲeːdʲəɾʲ
caoineadh	kiːnʲə
beiche	bʲɛçɪ
duine	d̪ˠɪnʲə
ite	ɪtʲə
giúistís	ɟuːʃtʲiʃ
gaineamh	ɡanʲəvʲ
arán	ɾˠɑːn
crúigh	kɾˠuːɟ
curacha	kɤɾˠaxə
bhfir	vʲɪɾʲ
tóireacha	t̪ˠɔːɾʲahə
mháistreása	wɑːʃtʲɾʲɑːsˠə
ról	ɾˠoːlˠ
fhómhar	oːvˠəɾˠ
gasúir	ɡasˠuɾʲ
seanscéal	ʃanˠʃceːlˠ
faide	fˠadʲə
uinge	ɪɲɪ
cat	kat̪ˠ
gléasaimid	ɟlʲeːsˠəmʲədʲ
ghobadh	ɣɔbˠə
cosaint	kɔsˠən̠ʲtʲ
bailteacha	bˠal̠ʲtʲəxiː
beach	bʲax
earrach	aɾˠəx
easóg	ɑsˠɑɡ
gabháilt	ɡvˠɑːlʲtʲ
lann	l̪ˠɑːn̪ˠ
gcasadh	ɡasˠətʲ
toiligh	t̪ˠɞlʲɪɟ
at	ɑt̪ˠ
fusa	fˠʊsˠə
scairteadh	sˠkaɾˠtʲəvˠ
airigh	aɾʲiː
bhfaightear	wahaɾˠ
caol	kiːlˠ
lúibe	l̪ˠuːbʲə
geit	ɟɛtʲ
d'fheiceadh	dʲɛcu
féilire	fʲeːlʲəɾʲə
tráthnóna	t̪ˠɾˠænˠoːnˠə
chnáimh	xn̪ˠɑːvʲ
glas	ɡlˠasˠ
fireann	fʲɪɾˠən̪ˠ
cnaipe	knˠapʲə
broc	bˠɾˠɔk
cleachtadh	clʲæxt̪ˠəvˠ
bhriseadh	vʲɾʲɪʃuː
mairteoil	mˠaɾʲtʲoːlʲ
mol	mˠʌlˠ
ba	bˠə
sleamhnaigh	ʃlʲəunˠi
séabraí	ʃeːbˠɾˠiː
feic	fʲɛc
teacht	tʲaxt̪ˠ
adharc	əiəɾˠk
bláth	bˠl̪ˠɑː
iontrálacha	ʊn̪ˠt̪ˠɾˠɑːlˠəxə
óltar	oːl̪ˠt̪ˠəɾˠ
fharraige	aɾˠəɟɪ
réasúnta	ɾˠeːsˠuːn̪ˠt̪ˠə
náisiún	n̪ˠɑːʃuːn̪ˠ
dtigh	dʲɪɟ
feola	fʲɔːlˠə
glúin	ɡluːn
focal	fˠɔkəlˠ
maraigh	mˠaɾˠiː
úrscéal	uːɾˠʃceːlˠ
treoracha	tʲɾʲoːɾˠəxə
dtrátha	d̪ˠɾˠɑːhə
abhac	ɑuwək
mheall	vʲɑːl̪ˠ
malaeis	mˠalˠeːɪʃ
fágadh	fˠæːɡu
margadh	mˠaɾˠəɡu
díom	d̪ˠiːmˠ
fiartha	fʲiəɾˠhə
murarbh	mˠʊɾˠəɾˠvˠ
eolas	ɔːlˠəsˠ
úsáideach	uːsˠædʲah
goideann	ɡɛdʲən̪ˠ
leas	l̠ʲasˠ
d'aithníodh	dˠænʲiːtʲ
seisiún	ʃɛʃuːnˠ
sciath	ʃciə
saor	sˠiːɾˠ
táirg	t̪ˠɑːɾʲɟ
chomh	xoː
gcás	ɡɑːsˠ
maith	mˠaɪh
plaice	pˠlˠacɪ
freastalta	fʲɾʲasˠt̪ˠəl̪ˠt̪ə
críochnaigh	cɾʲiəxn̪ˠiː
imní	ɪmʲənʲiː
leat	lʲæt̪ˠ
chír	çiːɾʲ
d'fhás	dˠɑːsˠ
bheadh	vʲɛfˠ
céibheanna	ceːvʲən̪ˠiː
freastalaíodh	fʲɾʲasˠt̪ˠəlˠiw
cérb	ceːɾˠbˠ
soithí	sˠeː
beocha	bʲoːxə
eochair	ɔxəɾʲ
brionglóid	bʲɾʲɪŋl̪ˠoːdʲ
amhrán	oːɾˠanˠ
lonta	l̪ˠʊn̪ˠt̪ˠə
máirín	mˠæːɾʲinʲ
an	ə
againn	əɣɪnʲ
milse	mʲɪlʲʃə
athar	æɾˠ
rásúr	ɾˠæːsˠuɾˠ
pingine	pʲɪɲənʲə
bróin	bˠɾˠuːnʲ
báisteach	bˠæːʃtʲah
freagra	fʲɾʲaɡɾˠə
carbán	kɑrˠbˠɑːn̪ˠ
buidéal	bˠɪdʲeːl̪ˠ
gasóg	ɡasˠoːɡ
pointe	pˠɪn̠ʲtʲə
cruinnigh	kɾˠɪnʲɪɟ
coill	kiːlʲ
brisid	bʲɾʲɪʃɪdʲ
seadadh	ʃad̪ˠəx
dhíbhse	jiːvʲʃə
baisteadh	bˠaʃtʲə
biseach	bʲɪʃah
comharsa	koːɾˠsˠə
gloine	ɡlˠɪnʲə
daonra	dˠiːn̪ˠɾˠə
tána	t̪ˠɑːn̪ˠə
gaothrán	ɡiːɾ̥ˠɑːn̪ˠ
piléir	pʲlʲeːɾʲ
bróg	bˠɾˠɔːɡ
coicís	kəiciːsˠ
máilín	mˠɑːlʲiːnʲ
fágfaidh	fˠæːki
naíonda	n̪ˠiːn̪ˠd̪ˠə
tagtar	t̪ˠaɡt̪ˠəɾˠ
murab	mˠʊɾˠəbˠ
buíocha	bˠiːxə
moill	mˠəil̠ʲ
bainne	bˠɑnʲə
peall	pʲɑːl̪ˠ
gael	ɡeːlˠ
ngealach	ɲəl̪ˠɑx
nuair	n̪ˠuəɾʲ
fágfaidh	fˠɑːkə
breithiúnais	bʲɾʲɛhunˠəʃ
bocht	bˠʌxt̪ˠ
aoinne	eːnʲə
charaid	xaɾˠədʲ
scríobhaim	scɾʲiːmʲ
ós	ɔːsˠ
paráistí	pˠɾˠɑːʃtʲiː
scoláireacht	sˠkəlˠɑːɾʲəxt̪ˠ
aithníodh	ahnʲiːɡ
gabh	ɡaw
airigh	aɾʲə
d'fhreastalódh	dʲɾʲasˠt̪ˠəlˠoːx
tachtadh	t̪ˠɑxt̪ˠətʲ
tú	t̪ˠuː
codlata	kɔl̪ˠət̪ˠə
péint	pʲeːnʲtʲ
fuadh	fˠuəw
asamsa	asˠəmˠsˠə
béal	bʲeːlˠ
ceada	cad̪ˠə
sheisear	hɛʃəɾˠ
céid	ceːdʲ
snáfa	sˠn̪ˠɑːfˠə
díom	dʲiːmˠ
meabhair	mʲəuɾʲ
gcuraigh	ɡʊɾˠiː
phinc	fʲɪɲc
eitleán	ɛtʲəlʲɑːnˠ
cum	kʊmˠ
feiceadh	fʲɛcətʲ
maoth	mˠeː
dreoite	dʲɾʲɔːtʲə
níl	n̠ʲiːlʲ
bláthanna	bˠl̪ˠɑːn̪ˠiː
tiobraid	tʲʊbɾˠɪdʲ
altadh	al̪ˠt̪ˠuː
cuimhnigh	kɪvʲnʲi
thar	haɾˠ
dhuit	ɣɪtʲ
caora	kiːɾˠə
bord	bˠoːɾˠd̪ˠ
cluin	kl̪ˠɪnʲ
plána	pˠlˠɑːnˠə
cuntais	kɤn̪ˠt̪ˠəʃ
coillte	kʌl̠ʲtʲə
sileacan	ʃɪlʲəkənˠ
báis	bˠɑːʃ
neart	n̠ʲaɾˠt̪ˠ
frainc	fɾˠaiɲc
fuar	fˠuəɾˠ
gnáth	ɡn̪ˠɑː
bacadh	bˠakəvˠ
píobaire	pʲiːbˠəɾʲə
aibhneacha	avʲnʲəxə
ábhar	æːwəɾˠ
bhláthanna	wl̪ˠɑːn̪ˠiː
sás	sˠæːsˠ
dathúil	d̪ˠəulʲ
feac	fʲɛcɪ
righin	ɾˠəinʲ
laois	l̪ˠiːʃ
rún	ɾˠuːnˠ
aici	ɛciː
tarraing	t̪ˠaɾˠən̠ʲ
réalta	ɾˠeːl̪ˠt̪ˠə
ciotach	cɪt̪ˠah
sise	ʃɪʃə
deisceart	dʲɛʃcəɾˠt̪ˠ
luíonn	l̪ˠiːn̪ˠ
maraigh	mˠɑɾˠɪɟ
hocht	hɔxt̪ˠ
cat	kʊt̪ˠ
úna	uːnˠə
soiléir	sˠəlʲeːɾʲ
scanraigh	sˠkaun̪ˠɾˠɪɟ
tráth	t̪ˠɾˠæː
imirt	ɪmʲəɾˠtʲ
céile	ceːlʲə
roinnt	ɾˠəɪn̠ʲtʲ
fhómhair	ɔːwəɾʲ
gnaíúil	ɡɾˠiːuːlʲ
abhus	əwʊsˠ
pinn	pʲiːn̠ʲ
bríce	bʲɾʲiːcɪ
salach	sˠəl̪ˠax
mhol	vˠɔlˠ
hoibre	hɛbʲrʲə
plé	pʲlʲeː
diúil	dʲuːlʲ
greann	ɟɾʲaun̪ˠ
binne	bʲɪn̠ʲə
cóisir	kɔːʃəɾʲ
earrach	æːɾˠəx
cíoch	ciːx
seafóid	ʃæfˠoːdʲ
déarfadh	dʲeːɾˠhuː
tiubh	tʲuː
cúnamh	kuːnˠu
déan	dʲeːnˠ
chic	çɪc
cuntas	kuːn̪ˠt̪ˠəsˠ
aisfhreagar	asˠɾˠɪɡəɾˠ
lá	l̪ˠɑː
sagart	sˠaɡəɾˠt̪ˠ
fhágadh	æːɡu
béarlóireacht	bʲeːɾˠl̪ˠoːɾʲəxt̪ˠ
geansaí	ɟænʲsˠiː
oilfeadh	ɛlʲhuː
earrach	aɾˠah
duilleach	d̪ˠɪl̠ʲax
foradh	fˠaɾˠu
saill	sˠail̠ʲ
aibhneacha	əivʲn̠ʲəxə
dligh	dʲlʲɪɟ
bhó	woː
muineál	mˠɪnɑːl
dochtúir	d̪ˠɔxt̪ˠuːɾʲ
cois	kɞʃ
hanamhór	hɑn̪ˠəvˠuəɾˠ
abú	əbˠuː
cíocrach	ciːkɾˠəx
loch	l̪ˠɔx
caisleán	kʊʃl̠ʲɑːnˠ
sméar	sˠmʲeːɾˠ
againn	æːn̠ʲ
fonn	fˠuːn̪ˠ
cóiriú	koːɾʲu
dóid	d̪ˠoːdʲ
oidhre	əiɾʲə
glóir	ɡlˠoːɾʲ
bhíodh	vʲiːx
taisce	t̪ˠaʃcɪ
paidreacha	pˠɑːdʲɾʲəxiː
buíon	bˠiːnˠ
codladh	kɔl̪ˠə
cuibhrigh	kɪvʲɾʲə
bhád	wɑːd̪ˠ
idir	ɛdʲəɾʲ
máistir	mˠɑːʃtʲəɾʲ
cruinníocha	kɾˠɪn̠ʲiəxiː
díreacha	dʲiːɾʲahə
áth	æː
m'	mʲ
tuga	t̪ˠʊɡə
asainne	asˠən̠ʲə
dearthár	dʲɾʲəhaːɾˠ
bromach	bˠɾˠʊmˠəx
bád	bˠæːd̪ˠ
poncán	pˠʌŋkænˠ
glúine	ɡluːnə
bheas	vʲɛɪsˠ
déardaoin	dʲeːɾˠd̪ˠiːnʲ
tobar	t̪ˠɔbˠəɾˠ
caipín	kapʲiːnʲ
toitín	t̪ˠɛtʲiːnʲ
ciclipéid	cɪclʲɪpʲeːdʲ
tite	tʲɪtʲə
bacadh	bˠakə
brón	bˠɾˠoːnˠ
tógaim	t̪ˠoːɡəmʲ
inne	ɪɲə
mar	mˠaɾˠ
éidí	eːdʲiː
leathanach	l̠ʲɑːnˠəx
beadh	bʲɛtʲ
d'fheicfeadh	dʲɛcuː
glac	ɡlˠak
canadh	kanˠəx
agamsa	aɡəmˠsˠə
gcífinn	ɟiːhənʲ
age	ɛɡə
adhlaic	ɑːl̪ˠəc
púma	pˠuːmˠə
ach	ɑx
cneasta	cnʲasˠt̪ˠə
iarraidh	iəɾˠɪɟ
oiltear	ɛlʲtʲəɾˠ
deirfiúr	dʲɾʲɛhuːɾˠ
phearsa	fʲaɾˠsˠə
aicise	ɛcɪʃə
bród	bˠɾˠoːd̪ˠ
aiféala	afʲeːlˠə
áirid	ɑːɾʲədʲ
ceann	caun̪ˠ
leac	l̠ʲæk
fíniúin	fʲiːnʲuːnʲ
corcaigh	kɔɾˠkiː
corp	kɔɾˠpˠ
lia	l̠ʲiə
úrú	uːɾˠuː
cúraim	kuːɾˠəmʲ
poncán	pˠɔŋkɑːnˠ
carraigín	kaɾˠɪɟinʲ
gairme	ɡaɾʲəmʲə
claíocha	kl̪ˠəixiː
cheird	çɪɾˠdʲ
mhéadaigh	vʲeːd̪ˠɪɟ
eachtra	axt̪ˠɾˠə
dearthár	dʲaɾˠhaɾˠ
dod	d̪ˠʌd̪ˠ
fuiseog	fˠɪʃaɡ
úll	uːl̪ˠ
griandó	ɟɾʲiən̪ˠd̪ˠoː
feidhm	fʲəimʲ
eachra	axɾˠə
céilí	ceːlʲiː
lathach	l̪ˠaiç
blaosc	bˠlˠiːsˠk
scamall	sˠkamˠəl̪ˠ
pháirc	fˠaːɾʲc
baladh	bˠal̪ˠə
chuig	xɪɟ
caitheamh	kahu
fhágfadh	ɑːkəx
déanamh	dʲeːnˠuː
maoth	mˠiː
taoschnó	t̪ˠiːsˠxɾˠɔː
thugadh	hʊɡətʲ
móin	mˠuːnʲ
cumhrán	kuːɾˠɑːnˠ
deirfiúr	dʲɛɾʲəfʲəɾˠ
theas	hæsˠ
gcairde	ɡɑːɾˠdʲə
airgid	æɾʲəɟədʲ
imigh	ɪmʲi
eaglais	aɡəl̪ˠəʃ
oifigiúil	ɔfʲɪɟulʲ
coirnéal	koɾˠnʲeːlˠ
beachaire	bʲaxəɾʲə
laithche	l̪ˠaiçə
galún	ɡalˠuːnˠ
neosainn	nʲoːsˠənʲ
soilse	sˠəil̠ʲʃə
biachlár	bʲiəxlˠɑːɾˠ
éirigh	əiɾʲə
astu	ɑsˠt̪ˠəbˠ
naomh	n̪ˠiːw
stoc	sˠt̪ˠʌk
chuireadh	xɪɾʲətʲ
giosta	ɟɪsˠt̪ˠə
snas	sˠn̪ˠɑsˠ
pus	pˠʊsˠ
feiliúnach	fʲɛlʲuːnˠəx
bricfásta	bʲɾʲɪcfˠɑːsˠt̪ˠə
daonchairdiúil	d̪eːn̪xɑːɾˠdʲuːlʲ
lámh	l̪ˠæːw
bacadh	bˠakəɡ
scrúdaigh	sˠkɾˠuːd̪ˠɪɟ
ceann	can̪ˠ
rath	ɾˠah
pléisiúr	pʲlʲeːʃuɾˠ
tím	tʲiːmˠ
deartháir	dʲæːɾˠhaɾʲ
dainséar	d̪ˠan̠ʲʃeːɾˠ
cléire	clʲeːɾʲə
gleo	ɟlʲɔː
codail	kʌd̪ˠɪlʲ
láidre	l̪ˠɑːdʲɾʲə
amhrasach	ɑvɾˠəsˠəx
eisceacht	ɛʃcəxt̪ˠ
bhán	wɑːnˠ
pláinéad	pˠl̪ˠæːnʲed̪ˠ
brúigh	bˠɾˠuː
dtóir	d̪ˠɔːɾʲ
ciliméadar	cɪlʲəmʲeːd̪ˠəɾˠ
neamhchiontach	nʲaçuːn̪ˠt̪ˠəx
aiceann	acən̪ˠ
piocadh	pʲʊkə
arbhar	aɾˠəwəɾˠ
tachtadh	t̪ˠaxt̪ˠuː
gréasáin	ɟɾiasˠɑːnʲ
pálás	pˠɑːl̪ˠɑːsˠ
leo	lʲoː
chomh	koː
cáis	kɑːʃ
caoga	keːɡə
maidhm	mˠəimʲ
líon	l̠ʲiːnˠ
é	ə
olc	ɔlˠk
inti	ɪn̠ʲtʲə
uisce	ɪʃcɪ
bruith	bˠɾˠʊ
iascaire	iəsˠkəɾʲə
strainséir	sˠt̪ˠɾˠɑːnʲʃeːɾʲ
aibíd	æbʲiːdʲ
peirs	pʲɛɾʲʃ
aimhleas	avlas
seisear	ʃɛʃəɾˠ
aithníodh	ahnʲiːtʲ
gal	ɡal̪ˠ
creidte	cɾʲɛtʲə
sciobtha	ʃcʊpˠiː
pointe	pˠiːn̠ʲtʲə
dhom	ɣɔmˠ
scata	sˠkɑt̪ˠə
feiceadh	fʲɛcuː
crích	cɾʲiː
cine	cɪnʲə
saor	sˠeːɾˠ
breácha	bʲɾʲɑːxə
fheadh	a
freastalaíodh	fʲɾʲasˠt̪ˠəlˠiːtʲ
mhall	wɑːl̪ˠ
snáthadh	sˠn̪ˠahuw
cnáimh	kn̪ˠɑːvʲ
nua	n̪ˠoː
bhláthanna	vˠl̪ˠɑːhən̪ˠə
stró	sˠt̪ˠɾˠɔː
chuaigh	xuə
pianfaidh	pʲiənhi
huile	hɪlʲə
'chuile	xɪlʲə
álainn	ɑːlˠən̠ʲ
churach	xəɾˠax
istigh	əʃtʲɪɟ
stócach	sˠt̪ˠoːkəx
eolais	oːlˠəʃ
sheáin	çɑːnʲ
lasadh	l̪ˠɑsˠə
ceol	cɔːlˠ
sholas	hɔlˠəsˠ
abhainn	əunʲ
stail	sˠt̪ˠælʲ
d'oileadh	d̪ˠɛlʲəx
orlach	əuɾˠl̪ˠəx
mhire	vʲɪɾʲə
lár	l̪ˠɑːɾˠ
albain	aləbˠən
starr	sˠt̪ˠæːɾˠ
trom	t̪ˠɾˠuːmˠ
tuiscint	t̪ˠɪʃcɪnʲtʲ
eitleán	ɛtʲəlʲɑːn̪ˠ
lán	l̪ˠæːnˠ
ubh	uvˠ
damhsa	d̪ˠə̃ũsˠə
deartháir	dʲæːɾˠhəɾʲ
tarraing	t̪ˠɑɾˠən
chugaibh	uɡiː
díotsa	dʲiːt̪ˠsˠə
mícheál	mʲiːhɑːl̪ˠ
talamh	t̪ˠalˠə
daidí	d̪ˠadʲiː
tionchascóir	tʲɪŋxasˠkoːɾʲ
tarra	t̪ˠaɾˠə
mura	mˠʊɾˠə
scar	skar
mhol	wʌlˠ
salaigh	sˠalˠə
acais	ækəʃ
cogadh	kʌɡu
fhómhar	oːɾˠ
éastras	eːsˠt̪ˠɾˠəsˠ
chonaic	xn̪ˠɪc
mharaigh	vˠɑɾˠɪɟ
cuidhil	kiəlʲ
chugaibh	xuːvʲ
'ad	ad̪ˠ
tóir	t̪ˠoːɾʲ
léigh	l̠ʲeːj
aige	ɛɟə
seadadh	ʃad̪ˠu
bunúsach	bʌn̪ˠusˠah
mír	mʲiːɾʲ
scaradh	sˠkaɾˠu
cinnigí	cɪn̠ɪɟi
chúl	xuːlˠ
curaí	kʊɾˠiː
righ	ɾˠɪj
droim	d̪ˠɾˠɪmʲ
aisti	aʃtʲɪ
díbh	dʲiːvʲ
altadh	al̪ˠt̪ˠəx
cois	kɔʃ
dícheall	dʲiːhəl̪ˠ
dtrí	dʲɾʲiː
mhóra	wɔːɾˠə
máthar	mˠɑːɾˠ
dtalamh	d̪ˠɑlˠəvˠ
pianadh	pʲiənˠəx
stad	sˠt̪ˠad̪ˠ
daichead	d̪ˠaçəd̪ˠ
rochtain	ɾˠɔxt̪ˠənʲ
díolann	dʲiːlˠən̪ˠ
bheidh	vʲɛɟ
domhain	d̪ˠəunʲ
scata	sˠkat̪ˠə
moladh	mˠɔlˠəvˠ
mharbh	warˠu
ndán	n̪ˠɑːnˠ
athraigh	æɾˠə
crom	kɾˠʊmˠ
aisteoir	əʃtʲoːɾʲ
neart	n̠ʲæɾˠt̪ˠ
toiligh	t̪ˠɛlʲiː
feistigh	fʲɛʃtʲiː
asamsa	ɑsˠəmˠsˠə
lus	l̪ˠɤsˠ
bhfaide	wadʲə
fagháilt	fˠɑːlʲtʲ
pógadh	pˠoːɡəvˠ
ithid	ɪhɪdʲ
ndéanfadh	n̠ʲiːnətʲ
curacha	kəɾˠaxə
cosán	kɑsˠɑnˠ
cónra	koːɾˠə
sprantais	spˠrˠantˠɪʃ
ceathrú	cahɾˠuː
thóir	hɔːɾʲ
timpeall	tʲɪmʲpʲəl̪ˠ
iontráil	ʊn̪ˠt̪ˠɾˠɑːlʲ
seanfhear	ʃanˠaɾˠ
anonn	ən̪ˠuːn̪ˠ
salach	sˠalˠəx
curacha	kʊɾˠəxə
fágadh	fˠɑːɡəɡ
gearr	ɟaːɾˠ
fhágadh	ɑːɡəx
comórtas	kɔmˠoːɾˠt̪ˠəsˠ
arm	ɑɾˠəmˠ
ndoirse	n̪ˠʌɾˠʃə
te	tʲɛ
freastalaí	fʲɾʲasˠt̪ˠəlˠiː
rainnt	ɾˠəinʲtʲ
phianadh	fʲiənˠuː
cochall	kʌxəl̪ˠ
deimhin	dʲəɪnʲ
ladhar	lˠaiɾˠ
sine	ʃinʲə
gearradh	ɟaɾˠəx
amháin	əwæːnʲ
glic	ɟlʲɪc
glacfaidh	ɡlˠakə
meánscoil	mʲɑːnˠsˠkɛlʲ
tolg	t̪ˠɔlˠəɡ
seacht	ʃæxt̪ˠ
buíonna	bˠiːn̪ˠə
thug	hʊɡ
tarraingím	t̪ˠaɾʲɪɟiːmʲ
liacht	l̠ʲiəxt̪ˠ
croch	kɾˠʌx
pinn	pʲəiɲ
cearnóg	cɑːɾˠn̪ˠoːɡ
cloch	klˠʌx
breabadh	bʲɾʲabˠəx
níonn	nʲiːn̪ˠ
scórtha	sˠkoːɾˠə
luite	l̪ˠɪtʲə
d'fhágfadh	d̪ˠæːkətʲ
comhairle	kõːɾˠl̠ʲə
canaid	kɑn̪ˠədʲ
conas	kʊnˠəsˠ
gada	ɡad̪ˠə
tseamróg	tʲamˠɾˠoːɡ
ionamsa	ɪn̪ˠəmˠsˠə
ionad	ʌnˠəd̪ˠ
maitheamh	mˠahəvˠ
bealach	bʲalˠəx
molfaidh	mɔlhə
tógann	t̪ˠɔːɡən̪ˠ
piocadh	pʲʊkəɡ
leáigh	l̠ʲɑː
anagheairid	ɑnɑjaɾʲədʲ
cheintiméadar	çɛn̠ʲtʲəmʲed̪ˠəɾˠ
gnóthachtáil	ɡɾˠuːxt̪ˠɑːlʲ
crochadh	kɾˠɔxəɡ
freastalaíonn	fʲɾʲasˠt̪ˠəlˠiːn̪ˠ
teann	tʲaun̪ˠ
gcuraigh	ɡɔɾˠə
dream	dʲɾʲɑːmˠ
oileáin	ɛlʲænʲ
foclóirí	fˠəkl̪ˠoːɾʲiː
bpianadh	bʲiənˠu
um	ʊmˠ
fliuchadh	fʲlʲʊxəɡ
bhláthanna	wl̪ˠɑːhən̪ˠə
againn	əɡɪnʲ
curach	kəɾˠax
moill	mˠiːlʲ
thapa	hapˠə
cearc	kaɾˠk
d'íosfadh	dʲiːsətʲ
teaghlach	tʲəiɫ̪əx
ded	dʲɛd̪ˠ
sméar	sˠmʲiaɾˠ
fiafraí	fʲiəɾˠiː
ghníomhaíocht	ɣɾˠiːwiəxt̪ˠ
cas	kɑsˠ
ceird	cɪɾˠdʲ
bunús	bɤnusˠ
orthu	əɾˠəbˠ
ghuí	ɣiː
inti	iːn̠ʲtʲə
inis	ɪnʲɪʃ
cúirt	kuːɾˠtʲ
casfaidh	kasˠiː
síocháin	ʃiːhænʲ
bodhrán	bˠəuɾˠɑːn̪ˠ
gcnoic	ɡn̪ˠɪc
raon	ɾˠiːnˠ
airde	aiɾʲdʲə
iománaíocht	əmˠɑːn̪ˠiəxt̪ˠ
chnuic	xn̪ˠɪc
is	ɪsˠ
bhealach	vʲəl̪ˠɑx
liath	l̠ʲiə
caisleán	kaʃl̠ʲænˠ
calma	kalˠəmˠə
tóga	t̪ˠoːɡə
socrú	sˠʌkɾˠu
dhíolann	jiːlˠən̪ˠ
gníomh	ɟnʲiːəvˠ
milseán	mʲiːʃlʲɑːn̪ˠ
páiste	pˠɑːʃtʲə
féach	fʲeːx
cion	cɪnˠ
ngair	ŋaɾʲ
slige	ʃl̠ʲɪɟɪ
suaimhneas	sˠiːmʲnʲəsˠ
caoineadh	kiːnʲu
faoisean	fˠiːʃənˠ
imigh	ɪmʲiː
d'altadh	d̪ˠal̪ˠt̪ˠətʲ
éist	eːʃtʲ
pósadh	pˠoːsˠə
dhi	jiː
nic	nʲɪc
dtiocfad	dʲʊkəd̪ˠ
pálás	pˠælˠæsˠ
arán	ɾˠɑːnˠ
garsún	ɡaɾˠsˠuːnˠ
phósfadh	fˠoːsˠətʲ
taidhleoir	t̪ˠeːlʲaɾʲ
ceangail	caŋɡəlʲ
múnadh	mˠuːn̪ˠəɡ
dreo	dʲɾʲɔː
cónaigh	kɔːnˠi
rúnaí	ɾˠuːnˠi
bpianadh	bʲiənˠəx
sinn	ʃɪn̠ʲ
alla	al̪ˠə
cic	cɪc
aibhne	əivʲnə
píob	pʲiːbˠ
acu	akəbˠ
crochadh	kɾˠɔxəx
cana	kanˠə
hat	hat̪ˠ
tuathal	t̪ˠuəhəlˠ
cearta	caɾˠt̪ˠə
dósan	d̪ˠoːsˠənˠ
cúng	kuːŋ
pláta	pˠlˠɑːt̪ˠə
anduine	ɑn̪ˠɪnə
foraois	fəɾˠiːʃ
geise	ɟɛʃə
nathrach	n͈aθrax
seanduine	ʃæn̪ˠɪnʲə
gearmáinis	ɟaɾˠəmˠɑːnʲɪʃ
chontráilte	xuːn̪ˠt̪ˠɾˠɑːl̠ʲtʲə
níon	n̠ʲiənˠ
pól	pˠɔːlˠ
agamsa	əɡɑmsə
mall	mˠɑːl̪ˠ
ngobadh	ɡɔbˠuː
sráidbhaile	sˠɾˠɑːdʲwalʲə
leáigh	l̠ʲæːj
ungáiris	ʊŋˠɡaːrʲɪʃ
fré	fˠɾˠeː
aire	ɑːɾʲə
uathu	woːbˠ
ciorcal	ciɾˠkəlˠ
tséabra	tʲeːbˠɾˠə
marc	mˠaɾˠk
milseán	mʲɪlʲʃaːn̪ˠ
féadachtáil	fʲeːd̪ˠəxt̪ˠɑːlʲ
vóta	vˠoːt̪ˠə
déanaí	dʲian̪ˠiː
timpeall	tʲiːmʲpʲəl̪ˠ
dream	dʲɾʲamˠ
mola	mˠʌlˠə
cumha	kuː
feide	fʲɛdʲə
mhoill	wəil̠ʲ
agatsa	ɑɡət̪ˠsˠə
at	at̪ˠ
balsamach	bˠalˠsˠəmˠah
gaeilge	ɡeːlʲɟɪ
cúnamh	koːnˠə
amháin	əvˠɑːnʲ
ceantar	can̪ˠt̪ˠəɾˠ
plaisteach	pˠlˠaʃtʲəx
lúib	l̪ˠuːbʲ
amhrasach	ɑ̃vɾˠəsˠəx
dhiúil	juːlʲ
seachain	ʃaxənʲ
airde	ʌɾˠdʲə
t'	tʲ
fhagháilt	ɑːlʲtʲ
múinteoir	mˠuːn̠ʲtʲaɾʲ
bunoscionn	bʷɪnʲɪʃcuːn̪ˠ
aiteach	atʲax
bhun	wʊnˠ
mo	mˠə
mall	mˠal̪ˠ
deirfiúr	dʲɾʲəfʲuːɾˠ
fhágfadh	ɑːkuː
phianadh	fʲiənˠu
oibrithe	əibʲɾʲiː
soitheach	sˠəix
thigh	hɪɟ
ciall	ciəl̪ˠ
obair	ʌbˠəɾʲ
seisean	ʃɛʃənˠ
sruth	sˠɾˠʊh
beirt	bʲɛɾˠtʲ
aithníodh	ahnʲiːfˠ
spraoi	sˠpˠɾˠiː
ghnách	ɡɾˠɑːx
seoid	ʃoːdʲ
gcurach	ɡəɾˠax
pléisiúr	pʲlʲeːʃuːɾˠ
ard	ɑːɾˠd̪ˠ
cúl	kuːlˠ
dorcha	d̪ˠɔɾˠəxə
ceathrú	cahɾˠu
comharsa	kɔːɾˠsˠə
uile	ɪlʲə
beorach	bʲoːɾˠəx
dheireadh	jɛɾʲə
carbón	kaɾˠəbˠɔnˠ
ceathrar	cæːɾˠ
anmain	anˠəmˠənʲ
aistise	æʃtʲəʃə
bhfadhb	wəibˠ
gaol	ɡeːl̪ˠ
muidne	mˠɪdʲnʲə
rísín	ɾˠiːʃiːnʲ
de	dʲə
cnáib	kɾˠɑːbʲ
fhonn	əun̪ˠ
socrú	sˠəkɾˠuː
coitianta	kətʲiən̪ˠt̪ˠə
diabhal	dʲəul̪ˠ
fágadh	fˠɑːɡətʲ
nós	n̪ˠuːsˠ
amhlaidh	ɑvl̪ˠə
ríomhchláraitheoir	ɾˠiːvˠxlˠaːɾˠəhoːɾʲ
tíre	tʲiːɾʲə
ifreann	ɪfʲɾʲənˠ
seamróga	ʃamˠɾˠoːɡə
asam	ɑsˠəmˠ
chodladh	xɔl̪ˠuː
fuaim	fˠuəmʲ
ithe	iːhə
damáiste	d̪ˠamˠɑːʃtʲə
chugainne	hʊɡən̠ʲə
dathúil	d̪ˠahuːlʲ
cál	kæːlˠ
aisling	aʃl̠ʲən̠ʲ
pósaid	pˠoːsˠədʲ
sionnach	ʃɪn̪ˠax
fead	fʲad̪ˠ
fágadh	fˠæːɡətʲ
dúisigh	d̪ˠuːʃə
dóchas	d̪ˠɔːxəsˠ
róisín	rˠoːʃiːnʲ
chúis	xuːʃ
chuaigh	xuəj
gréas	ɟɾeːsˠ
deis	dʲɛʃ
foraois	fɔɾˠiːʃ
acu	akə
léis	l̠ʲeːʃ
meiriceá	mʲɛɾʲəcæ
teachín	tʲaxinʲ
gaineamh	ɡanʲə
ábalta	ɑːbˠəl̪ˠt̪ˠə
chloch	xlˠɔx
stá	sˠt̪ˠæː
iomarca	ʊmˠəɾˠkə
salachar	sˠalˠəxəɾˠ
uaim	uəmʲ
cearnóige	caːɾˠn̪ˠoːɟə
ngealach	ɲalˠah
eo	oː
maith	mˠa
baol	bˠeːl̪ˠ
acusan	akəsˠənˠ
ollmhargadh	ʌl̪ˠwaɾˠəɡu
veinéis	vʲənʲeːʃ
den	dʲɛnˠ
múinteoirí	mˠuːn̠ʲtʲaɾʲi
leagfadh	l̠ʲakətʲ
seomra	ʃoːmˠɾˠə
scóip	sˠkoːpʲ
churach	xɔɾˠəx
borb	bˠɔɾˠəbˠ
ainnear	æn̠ʲəɾˠ
téanam	tʲia̯n̪ˠəmˠ
seánra	ʃɑːn̪ˠɾˠə
airím	æːɾʲiːmʲ
ceapadh	capəx
fos	fˠɔsˠ
holc	hɔlˠk
poiblí	pˠɔbˠl̪ˠiː
daoine	d̪ˠiːnʲə
d'ith	dʲiː
chreideadh	çɾʲɛdʲu
seift	ʃɛfʲtʲ
mbris	mʲɾʲɪʃ
easóg	æsˠoːɡ
chúcha	xuːxə
itheann	ɪhən̪ˠ
naonúr	n̪ˠiːnˠuɾˠ
gabhal	ɡəulˠ
molad	mˠɔlˠəd̪ˠ
plimp	pʲlʲɪmʲpʲ
casadh	kɑsˠə
nuall	n̪ˠuəl̪ˠ
ardintinneach	ɑːɾˠd̪ˠiːntʲən̠ʲəx
mháthair	vˠɑːhəɾʲ
stopallán	sˠt̪ˠɔpəl̪ˠɑːn̪ˠ
chóta	xoːt̪ˠə
deachaigh	dʲaxə
ionsaí	ɤnˠsˠi
domhan	d̪ˠoːən̪ˠ
áthas	ɑːsˠ
aimhleas	ɑvlas
tsaoir	t̪ˠiːɾʲ
mboga	mˠɔɡə
tharlódh	hɑːɾˠl̪ˠoːtʲ
gearg	ɟaɾˠəɡ
scór	sˠkoːɾˠ
daoi	d̪ˠiː
buin	bˠɪnʲ
nach	n̪ˠax
chucu	hʊkəbˠ
pingine	pʲiːn̠ʲə
ina	ɪnˠə
dhínn	ɣɪn̠ʲ
aoibheallach	iːvʲəl̪ˠəx
daonchairdiúil	d̪iːn̪xæːɾˠdʲulʲ
phálás	fˠɑːl̪ˠɑːsˠ
chirt	çɪɾˠtʲ
ón	oːnˠ
árasán	ɑːɾˠəsˠɑːnˠ
coscairt	kasˠkəɾʲtʲ
dubh	d̪ˠʊw
cata	kʊt̪ˠə
scaradh	sˠkaɾˠəvˠ
dúcha	d̪ˠuːxə
airde	iːɾˠdʲə
haon	heːn̪ˠ
shinsir	hiːn̠ʲsʲəɾʲ
trá	t̪ˠɾˠɑː
fearg	fʲæːɾˠəɡ
cheannach	çan̪ˠəx
tuigim	t̪ˠɪɟɪmʲ
bord	bˠəuɾˠd̪ˠ
ndán	n̪ˠæːnˠ
cruinne	kɾˠɪɲə
céachta	ceːxt̪ˠə
fraoch	fˠɾˠeːx
praiseach	pˠɾˠaʃəx
deirfiúracha	dʲɾʲəfˠuːɾˠəxə
ghairdín	ɣɑːɾˠdʲiːnʲ
luan	l̪ˠuənˠ
folamh	fˠaːl̪ˠə
bhíodh	vʲiːtʲ
fiche	fʲɪhə
raon	ɾˠeːn̪ˠ
bhfreastalaíodh	vʲɾʲasˠt̪ˠəlˠiːtʲ
cadhnraí	kəinˠɾˠiː
grinne	ɟɾʲɪn̠ʲə
torthaí	t̪ˠɔɾˠiː
leathchéad	l̠ʲæçeːd̪ˠ
taispeáin	t̪ˠəspˠɑːnʲ
éad	eːd̪ˠ
hiomlán	hʊmˠlˠɑːnˠ
eo	ɔː
gnás	ɡɾˠɑːsˠ
mhá	wɑː
fí	fʲiː
briseadh	bʲɾʲɪʃəvˠ
sceith	ʃcɛh
ól	oːlˠ
mnaoi	mˠnˠiː
rosa	ɾˠɔsˠə
ceapadh	cæpˠə
maorga	mˠeːɾˠɡə
leabhar	l̠ʲoːɾˠ
aghaidh	əiə
éirigh	iːɾʲi
cloisteáil	klˠɔʃtʲɑːlʲ
dáta	d̪ˠæːt̪ˠə
ghabhar	ɣoːɾˠ
ngobadh	ŋɔbˠuː
raplachán	ɾˠapˠlˠaxænˠ
imní	ɪmʲɾʲi
anam	anˠəmˠ
dreo	dʲɾʲoː
craiceann	kɾˠæcən̪ˠ
cafarr	kafˠəɾˠ
fiaradh	fʲiəɾˠə
dochreidte	d̪ˠɔçɾʲɛtʲə
fága	fˠæːɡə
aineolaí	anʲoːliː
ghine	jɪnʲə
leagfaidh	l̠ʲakə
feistigh	fʲɛʃtʲɪɟ
gabhaim	ɡəimʲ
pána	pˠæːnˠə
siúd	ʃuːd̪ˠ
bealach	bʲalˠah
mianach	mʲiənˠah
cúinne	kuːn̠ʲə
cuimhnigh	kiːvʲɾʲə
cnoc	kn̪ˠɔk
casa	kɑsˠə
dhínn	jiːn̠ʲ
leagfadh	l̠ʲaku
foghlaim	fʲɔːlʲəmʲ
socraigh	sˠʌkɾˠi
siopa	ʃɔpˠə
scáth	sˠkɑː
mícheál	mʲiːɑːl̪ˠ
pósfad	pˠoːsˠəd̪ˠ
cinneadh	cɪn̠ʲəɡ
deacair	dʲækəɾʲ
féad	fʲeːd̪ˠ
guí	ɡɪvʲə
cúnamh	kuːnˠuː
tachtadh	t̪ˠaxt̪ˠu
leithscéal	l̠ʲɛʃceːlˠ
úir	uːɾʲ
chreid	çɾʲɛdʲ
caint	kan̠ʲtʲ
séid	ʃeːdʲ
beireann	bʲɛɾʲən̪ˠ
hí	hiː
coirce	kɛɾʲcɪ
pointeáilte	pˠiːn̠ʲtʲɑːl̠ʲtʲə
gunna	ɡʊn̪ˠə
ciarán	ciəɾˠænˠ
leapa	lʲapˠə
taitneachtáil	t̪ˠæn̠ʲəxt̪ˠɑːlʲ
chneasta	çɾʲasˠt̪ˠə
suim	sˠaimʲ
chuardaigh	xuəɾˠd̪ˠi
gais	ɡaʃ
furasta	fˠɾ̪ˠʊst̪ˠə
luigh	l̪ˠiː
oibreacha	ɛbʲrʲəxə
chreideadh	çɾʲɛdʲətʲ
dhá	ɑː
dhícheall	jiːçəl̪ˠ
chucu	xuːhə
gcoill	ɡʌl̠ʲ
trátha	t̪ˠɾˠahə
bhó	vˠoː
chuán	xuːɑːnˠ
breo	bʲɾʲoː
tseamróg	tʲamˠəɾˠoːɡ
rí	ɾˠiː
fhómhair	oːvˠəɾʲ
ceanada	canˠəd̪ˠə
mé	mʲə
scaradh	sˠkaɾˠuː
altfaidh	al̪ˠt̪ˠiː
pota	pˠɔt̪ˠə
ba	bˠa
abhus	əvˠʊsˠ
gnaithí	ɡɾˠaːiː
méadar	mʲeːd̪ˠəɾˠ
breabadh	bʲɾʲabˠətʲ
inseodh	iːnʲʃoːtʲ
phósadh	fˠoːsˠətʲ
coiteann	kʌtʲən̪ˠ
gearmáinis	ɟaɾˠəmˠænʲɪʃ
triúr	tʲɾʲuːɾˠ
seacláid	ʃæklˠɑːdʲ
muirir	mˠɪɾʲəɾʲ
d'aithin	d̪ˠahənʲ
spriog	sˠpʲɾʲʊɡ
cíocras	ciːkɾˠəsˠ
nod	n̪ˠʌd̪ˠ
t'	t̪ˠ
aigesean	ɛɟəsˠən
dtosach	d̪ˠʌsˠah
facs	fˠaksˠ
asaibhse	asˠiːʃə
tuaithe	t̪ˠuəj
arán	əɾˠɑːn̪ˠ
comórtas	kɤmˠɔɾˠt̪ˠəsˠ
dréimire	dʲɾʲeːmʲəɾʲə
tóig	t̪ˠoːɟ
sceitimíní	ʃcɛtʲəmʲinʲi
formad	fˠɔɾˠəmˠəd̪ˠ
veinéis	vʲɛnʲeʃ
mún	mˠuːnˠ
orlaí	əuɾˠl̪ˠiː
béile	bʲeːlʲə
ciúine	cuːnʲə
cuireadh	kɪɾʲəvˠ
fhágfadh	ɑːkətʲ
láib	l̪ˠɑːbʲ
ancaire	ɑŋkəɾʲə
gliogar	ɟlʲɪɡəɾˠ
deireanach	dʲɛɾʲənˠəx
chuimhnigh	xɪvʲnʲi
d'íosfadh	dʲiːsəx
cairdeas	kæːɾˠdʲəsˠ
ball	bˠɑːl̪ˠ
toll	t̪ˠoːl̪ˠ
mó	mˠoː
cheintiméadar	çɛn̠ʲtʲəmʲeːd̪ˠəɾˠ
chasfadh	kasˠuː
tríú	tʲɾʲiːuː
máthair	mˠɑːhəɾʲ
amharc	afˠəɾˠk
réimeanna	ɾˠeːmʲən̪ˠə
díreach	dʲiːɾʲah
gallúnach	ɡalˠuːnˠəx
ghráin	ɣɾˠæːnʲ
caighdeán	kəidʲɑːnˠ
aer	eːɾˠ
ghrúdlann	ɣɾˠuːd̪ˠlˠən̪ˠ
gluais	ɡlˠuəʃ
toil	t̪ˠɪlʲ
ruainne	ɾˠuən̠ʲə
luí	l̪ˠəi
buidéal	bˠɪdʲælˠ
agat	ɑːɡət̪ˠ
peata	pʲæːt̪ˠə
dalta	d̪ˠalˠt̪ˠə
dona	d̪ˠʊnˠə
caoineadh	kiːnʲuː
cóirigh	koːɾʲiː
cailleadh	kal̠ʲə
saoradh	sˠiːɾˠəvˠ
bolg	bˠɔlˠəɡ
comrádaí	kɔmˠɾˠɑːd̪ˠiː
coill	kʌl̠ʲ
caidé	kədʲeː
fág	fˠæːɡ
múnadh	mˠuːnˠu
páipéar	pˠɑːpʲeːɾˠ
cogar	kɔɡəɾˠ
fhágadh	æːɡətʲ
leag	l̠ʲaɡ
ollainnis	ɔl̪ˠən̠ʲəʃ
contráilte	kuːn̪ˠt̪ˠɾˠɑːl̠ʲtʲə
suíochán	sˠiːxɑːn̪ˠ
múin	mˠuːnʲ
clogad	klˠɔɡəd̪ˠ
binne	bʲɪɲɪ
shínigh	hiːnʲiː
halban	haləbˠənˠ
luí	l̪ˠiː
acht	ɑx
cineál	cɪnˠɑːlˠ
gnáth	ɡnˠɑː
adhmad	əimˠəd̪ˠ
amhráin	oːɾˠænʲ
caife	kafʲeː
beirtear	bʲɛɾʲtəɾʲ
sheaicéad	haceːd̪ˠ
tionchar	tʲɤŋxəɾˠ
amhrán	əuɾˠɑːn̪ˠ
chneasta	çnʲasˠt̪ˠə
teilifís	tʲɛlʲɪfʲiːʃ
seachtain	ʃaxt̪ˠənʲ
churaigh	xʊɾˠi
scian	ʃciːn̪ˠ
cailleadh	kɑːl̠ʲəx
mbláthanna	mˠl̪ˠɑːhən̪ˠə
bheadh	vʲɛtʲ
faol	fˠiːlˠ
biseach	bʲɪʃax
seabhac	ʃəuk
giuirléid	ɟuːɾˠlʲeːdʲ
móide	mˠɔːdʲə
fhírinne	iːɾʲənʲə
ghráin	ɣɾˠɑːnʲ
chugam	xuːmˠ
bagún	bˠəɡuːn̪ˠ
dreoigh	dʲɾʲoː
sinne	ʃɪɲɪ
muire	mˠɪɾʲə
deirfiúr	dʲɾʲəfˠuːɾˠ
deirfiúracha	dʲɾʲauhəɾˠəxə
d'aithníodh	dˠahnʲiːfˠ
iad	iəd̪ˠ
crann	kɾˠaun̪ˠ
clamhsán	klˠəusˠɑːnˠ
talamh	t̪ˠalˠuː
múnadh	mˠuːn̪ˠə
foclóirí	fˠɔklˠoːɾʲiː
bogach	bˠʌɡah
bpósfadh	bˠoːsˠuː
breis	bʲɾʲɛʃ
dtosach	d̪ˠɔsˠəx
deachaigh	dʲaxi
cháiliúil	xæːlʲulʲ
fhéar	eːɾˠ
ball	bˠəul̪ˠ
éigéille	eːɟeːl̠ʲə
d'fhágfadh	d̪ˠɑːkuː
cirt	kʲir͈t
glór	ɡlˠoːɾˠ
cána	kæːnˠə
big	bʲɪɟ
céibh	ceːvʲ
coirm	kɞɾʲəmʲ
eitil	ɛtʲɪlʲ
ciseán	cɪʃɑːn̪ˠ
dhó	ɣɔː
comhlacht	koːlˠəxt̪ˠ
ná	n̪ˠæː
uaigh	uəɟ
eadhon	aːn
freastalaíodh	fʲɾʲasˠt̪ˠəlˠiːx
bileogach	bʲɪlʲaɡah
trínar	tʲɾʲiːnˠəɾˠ
uachtar	uəxt̪ˠəɾˠ
reiligiún	ɾˠɛlʲɪɟunˠ
abcáisis	abˠkaːʃɪʃ
lúcháir	l̪ˠɛfˠɑːɾʲ
ordú	əuɾˠd̪ˠuː
plás	pˠlˠɑːsˠ
