melandro	melandɾo̝
zangro	θaŋɡɾo̝
milagre	milaɣɾe̝
trasnoitar	tɾasnojtaɾ
carozo	kaɾoso̝
cacarexar	kakaɾeʃaɾ
varela	baɾɛla̝
soarego	so̯aɾɛɣo̝
cazacú	kaθaku
mazadura	masaðuɾa̝
acibeche	asiβɛt͡ʃe̝
choca	t͡ʃɔka̝
pra	pɾa
trouzo	tɾowθo̝
aferventar	afeɾβentaɾ
pousada	powsaða̝
lagosta	laɣosta̝
esparexer	espaɾeʃeɾ
tonel	tonɛl
esterpe	estɛɾpe̝
bonome	bonɔme̝
chamorro	t͡ʃamoro̝
orela	oɾɛla̝
muimenta	mujmenta̝
amolecer	amoleθeɾ
areal	aɾeal
resío	resio̝
queiroa	kejɾɔa̝
soarego	soaɾɛɣo̝
coroa	kɾoa̝
nena	nena
encartar	eŋkaɾtaɾ
rexeitamento	reʃejtamento̝
bedugo	beðuɣo̝
incenso	inθenso̝
rens	reŋs
vendima	bendima̝
peixe	pejʃ
neal	neal
peneque	penɛke̝
cantón	kantoŋ
teixo	tejʃo̝
vedraño	beðɾaɲo̝
abaixar	aβajʃaɾ
beiril	bejɾil
cocho	kot͡ʃo̝
convite	kombite̝
decatar	dekataɾ
sacaúntos	sakaunto̝s
xeitar	ʃejtaɾ
senllos	senʎo̝s
balastrón	balastɾoŋ
escarvadentes	eskaɾβaðɛnte̝s
sortella	soɾteʎa̝
aguia	aɣja̝
fenda	fenda̝
mergullador	meɾɣuʎaðoɾ
achorentar	at͡ʃoɾentaɾ
bigornia	biɣɔɾnja̝
brouca	bɾɔwka̝
fallocas	faʎoka̝s
arrecender	areθendeɾ
sangano	saŋɡano̝
grea	ɡɾea̝
tega	tɛɣa̝
molar	mɔlaɾ
manto	manto̝
verea	bɾea̝
gulapo	ɡulapo̝
atoar	atoaɾ
bálsamo	balsa̝mo̝
arroz	aros
costureiro	kostuɾejɾo̝
vilán	bilaŋ
bagaña	baɣaɲa̝
freta	fɾɛta̝
reuma	rɛwma̝
cervo	θɛɾβo̝
armentío	aɾmentio̝
segur	seɣuɾ
eiva	ɛjβa̝
rello	reʎo̝
noelo	noɛlo̝
aplicado	aplikaðo̝
quer	kɛɾ
tusir	tusiɾ
cercar	seɾkaɾ
abouxar	aβowʃaɾ
cabezada	kaβesaða̝
altamira	altamiɾa̝
meimendro	mejmendɾo̝
broco	bɾɔko̝
desarranxar	desaranʃaɾ
crás	kɾas
amoado	amoaðo̝
xuízo	ʃwis̻ʊ
rinchar	rint͡ʃaɾ
bermui	beɾmuj
fervellasverzas	feɾβeʎasβeɾθa̝s
carqueixa	kaɾkejʃa̝
camba	kamba̝
cebola	θeβola̝
parvada	paɾβaða̝
esquecer	eskɛseɾ
cruz	kɾuθ
padrón	paðɾoŋ
estrullar	estɾuʎaɾ
atuar	atuaɾ
garabullo	ɡaɾaβuʎo̝
chicote	t͡ʃikɔte̝
rebolo	reβolo̝
paspallás	paspaʎas
cerquiño	seɾkiɲo̝
fento	fento̝
ferruxe	feruʃe̝
lixo	liʃo̝
rustrido	rustɾiðo̝
praza	pɾasa̝
agatuñar	ɡatuɲaɾ
unha	uŋa̝
cámara	kama̝ɾa̝
cruz	kɾus
broza	bɾoθa̝
condomiña	kondomiɲa̝
noiro	nojɾo̝
verba	berβa̝
esfregar	esfɾeɣaɾ
zuchar	sut͡ʃaɾ
louza	lowsa̝
fraco	fɾako̝
varar	baɾaɾ
estarrecer	estareθeɾ
canudo	kanuðo̝
cocido	koθiðo̝
vila	bila̝
pescuda	peskuða̝
becho	bet͡ʃo̝
bexato	beʃato̝
teor	teoɾ
con	kɔŋ
forneiro	foɾnejɾo̝
bidente	biðɛnte̝
espeteira	espetejɾa̝
trousar	tɾowsaɾ
agaitar	aɣajtaɾ
esqueira	eskejɾa̝
farangulla	faɾaŋɡuʎa̝
maniño	maniɲo̝
alfar	alfaɾ
queimada	kejmaða̝
bocexar	boseʃaɾ
cea	θea̝
canteiro	kantejɾo̝
faro	faɾo̝
xerga	ʃɛɾɣa̝
repelo	repɛlʊ
envorcar	embɔɾkaɾ
lene	lɛne̝
rebor	reβɔɾ
trabucar	tɾaβukaɾ
fiandón	fiandoŋ
toutizo	towtiso̝
cebola	sɛβɔla̝
cafurna	kafuɾna̝
fío	fiʊ̯
fume	fume̝
ermida	eɾmiða̝
bordo	boɾðo̝
sucar	sukaɾ
mexar	meʃaɾ
arañeira	aɾaɲejɾa̝
francuín	fɾaŋkuiŋ
galdaripo	ɡaldaɾipʊ
arroutada	arowtaða̝
rouco	rowko̝
codia	koðja̝
cachaza	kat͡ʃasa̝
maquía	makia̝
coca	kɔka̝
saboroso	saβoɾoso̝
ulla	uʎa̝
espeluxar	espeluʃaɾ
cenlla	senʎa̝
esmarfallar	esmaɾfaʎaɾ
vianda	bianda̝
mainel	majnɛl
luscofusco	luskofusko̝
candeloria	kandelɔɾja̝
macheta	mat͡ʃeta̝
envorcallar	emboɾkaʎaɾ
bruión	bɾujoŋ
cambota	kambɔta̝
trela	tɾɛla̝
leriar	lɛɾiaɾ
mosca	moska̝
solda	sɔlda̝
primaveras	pɾimaβeɾas
cango	kaŋko̝
departir	depaɾtiɾ
galla	ɡaʎa̝
vao	bao̯
carazo	kaɾaθo̝
esmendrellar	esmendɾeʎaɾ
fiar	fiaɾ
laranxa	laɾanʃa̝
refusar	refusaɾ
mantel	mantɛl
liño	liɲo̝
singrar	siŋɡɾaɾ
deosto	deɔsto̝
poupar	powpaɾ
achaiar	at͡ʃajaɾ
gorar	ɡoɾaɾ
seeta	sɛɛta̝
carba	kaɾβa̝
pezuño	pɛθuɲo̝
callau	kaʎaw
abesouro	aβesowɾo̝
lenzo	lɛnso̝
pelica	pɪlika̝
ladaíña	laðaiɲa
solar	solaɾ
guillufe	ɡiʎufe̝
rozar	roθaɾ
gosende	ɡosende̝
amarelo	amaɾɛlo̝
ripo	ripo̝
trallar	tɾaʎaɾ
lagarteiro	laɣaɾtejɾo̝
ruína	ruina̝
ventureira	bentuɾejɾa̝
palmo	palmo̝
burbullar	buɾβuʎaɾ
nifroso	nifɾoso̝
freixó	fɾejʃɔ
gabia	ɡaβja̝
picote	pikɔte̝
lura	luɾa̝
polbo	pɔlβo̝
nomeada	nomeaða̝
xear	ʃiaɾ
rexurdir	reʃuɾðiɾ
sabela	saβɛla̝
bao	bao̯
escarapote	eskaɾapɔte̝
feixón	fejʃoŋ
cóbado	koβa̝ðo̝
obreiro	ɔβɾejɾo
mesmo	miɾmo̝
gurgullón	ɡuɾɣuʎoŋ
debaer	deβaeɾ
gurgullar	ɡuɾɣuʎaɾ
cachar	kat͡ʃaɾ
azo	aθo̝
chourizo	t͡ʃowɾiso̝
lebre	lɛβɾe̝
secar	sekar
caravel	kɑɾaβɛl
portugués	poɾtuɣes
trola	tɾɔla̝
anafil	anafil
arrepiar	arepiaɾ
fibela	fiβɛla̝
cola	kɔla̝
moer	moeɾ
bortel	boɾtɛl
paz	paθ
ladrillo	laðɾiʎo̝
beira	bejɾa̝
percebeiro	peɾθeβejro̝
soterrar	soteraɾ
chaira	t͡ʃajɾa̝
mandorla	mandɔɾla̝
tragove	tɾaɣɔβe̝
fazula	fasula̝
relustro	relustɾo̝
berbia	bɛɾβja̝
aguillar	aɣiʎaɾ
relanzo	relanθo̝
eslava	eslaβa̝
avó	aβo̝
invernía	imbɛɾnia̝
loar	loaɾ
tolete	tolete̝
rebandar	reβandaɾ
bordinga	boɾðiŋɡa̝
denociña	denosiɲa̝̝
anguía	aŋɡia̝
rodo	rɔðo̝
illeu	iʎew
camouco	kamowko̝
nifrón	nifɾoŋ
nó	nɔ
tardiña	taɾðiɲa̝
reburdiar	reβuɾðjaɾ
ganduxar	ɡanduʃaɾ
forraxe	foraʃe̝
gondomar	ɡondomaɾ
fol	fɔl
reino	rejno̝
cichote	θit͡ʃɔte̝
zoco	sɔko̝
levada	leβaða̝
belsar	belsaɾ
treitoira	tɾejtojɾa̝
trousa	tɾowsa
careixa	kaɾejʃa̝
mércores	mɛɾko̝ɾe̝s
demo	dɛmo̝
canal	kanal
illar	iʎaɾ
vegada	beɣaða̝
pingueira	piŋɡejɾa̝
preguizoso	pɾeɣisoso̝
enxexar	enʃeʃaɾ
fieito	fjejto̝
rabuxa	raβuʃa̝
manta	manta̝
posse	pɔse̝
celme	θɛlme̝
boh	bɔ
tesoiras	tesojɾa̝
ceno	aθeno̝
gralla	ɡɾaʎa̝
tato	tato̝
arzaña	aɾθaɲa̝
aguacil	aɰwasil
teta	teta̝
bousán	bowsaŋ
brinco	bɾiŋko̝
broeiro	bɾoejɾo̝
peto	peto̝
ledo	leðo̝
obrigar	oβɾiɣaɾ
orgulloso	ɔɾɣuʎoso̝
estarrecer	estareseɾ
randa	randa̝
pintar	pintaɾ
aguacil	aɡwaθil
quinteiro	kintejɾo̝
centola	θentola̝
viveiro	biβejɾo̝
becerro	besero̝
couza	kowθa̝
muíño	muiɲo̝
carallo	kaɾaʎo̝
chagorza	t͡ʃaɣɔɾθa̝
escochar	eskot͡ʃaɾ
xenro	ʃɛŋɾo̝
lábil	labiːl
riola	riɔla̝
bazar	baθaɾ
baamonde	bamonde̝
neada	niaða̝
botafumeiro	botafumejɾo̝
esterlino	esterlino̝
reira	rejɾa̝̝
arremedar	aremeðaɾ
freán	fɾeaŋ
zucho	θut͡ʃo̝
cheirento	t͡ʃejɾɛnto̝
afastar	afastaɾ
bicar	bikaɾ
diante	diante̝
abrótea	aβɾɔte̯a̝
estrondo	estɾondo̝
chupeta	t͡ʃupeta̝
planta	planta̝
recuncho	rekunt͡ʃo̝
garimar	ɡaɾimaɾ
milgrandeira	milɣɾandejɾa̝
bater	bateɾ
landeira	landejɾa̝
esmechar	esmet͡ʃaɾ
pouco	powko̝
formal	foɾmal
xoaniña	ʃo̯aniɲa̝
medeiro	meðejɾo̝
esparto	espaɾto̝
morte	mɔɾte̝
coto	kɔto̝
escada	eskaða̝
matanza	matanθa̝
zarangallo	θaɾaŋɡaʎo̝
bance	banse̝
saloucar	salowkaɾ
antártida	antaɾtiða
traballo	tɾaβaʎo̝
breu	bɾɛw
abeto	aβeto̝
gurgulla	ɡuɾɣuʎa̝
leira	lejɾa̝
forca	fɔɾka̝
coiote	kojɔte
montar	montaɾ
arneiro	aɾnejɾo̝
cerponzóns	θeɾponθoŋs
escarva	eskaɾβa̝
xostra	ʃostɾa̝
engadir	eŋɡaðiɾ
galdrapa	ɡaldɾapa̝
bourear	bowɾeaɾ
estampar	estampaɾ
lemos	lɛmo̝s
apeiro	apejɾo̝
dentabrún	dɛntaβɾuŋ
chapar	t͡ʃapaɾ
escoler	eskɔlɛɾ
roxo	roʃo̝
guilfrei	ɡilfɾej
choio	t͡ʃɔjo̝
daquela	dakela
focha	fot͡ʃa̝
chacina	t͡ʃaθina̝
angazo	aŋɡaθo̝
estantiga	estantiɣa̝
calafatear	kalafateaɾ
cillobre	siʎɔβɾe̝
faio	fajo̝
obreiro	oβɾejɾo
frauga	fɾawɣa̝
nabiza	naβisa̝
guillo	ɡiʎo̝
miar	miaɾ
osca	ɔska̝
menciñeiro	menθiɲejɾo̝
esvaír	ez̺β̞ɐiɾ
avinza	aβinθa̝
targa	taɾɣa̝
pobre	pɔβɾe̝
peito	pejto̝
pico	piko̝
alfiestra	alfiɛstɾa̝
pascua	paskwa̝
trabe	tɾaβe̝
forxás	foɾʃas
pescozo	peskoso̝
serán	seɾaŋ
espetada	espeto̝
quenda	kɛnda̝
cruceiro	kɾusejɾo̝
pioga	piɔɣa̝
lestrobe	lestɾɔβe̝
cismar	sismaɾ
depenar	depenaɾ
rapariga	rapaɾiɣa̝
almorzar	almoɾθaɾ
reloxo	relɔ
finamento	finamento̝
mexamorno	meʃa̝mɔɾno̝
arpeo	aɾpeo̯
agoiro	aɣojɾo̝
belota	belɔta̝
mouta	mowta̝
tobo	toβo̝
gramalleira	ɡɾamaʎejɾa̝
bolboreta	bolβoɾeta
carraxe	karaʃe̝
temporal	tɛmpoɾal
moucho	mowt͡ʃo̝
azo	aso̝
reboreda	reβoɾeða̝
envurullar	embɾuʎaɾ
loro	loɾo̝
alor	alɔɾ
xógara	ʃɔɣa̝ɾa̝
merlán	merlaŋ
mosteirón	mostejɾɔŋ
mudo	muðo̝
carroucha	karowt͡ʃa̝
cordeiro	koɾðejɾo̝
anazar	anaθaɾ
tósego	tos̺eɣo̝
enchenta	ent͡ʃenta̝
papoia	papɔja̝
cepa	sepa̝
brañento	bɾaɲento̝
chiscar	t͡ʃiskaɾ
corte	koɾte̝
salgar	salɣaɾ
pasamento	pasamento̝
tufeira	tufejɾa̝
cairo	kajɾo̝
enredar	enreðaɾ
garrocha	ɡarɔt͡ʃa̝
pipa	pipa̝
gorgolo	ɡoɾɣolo̝
capón	kapoŋ
canizo	kaniθo̝
carpir	kaɾpiɾ
boquexar	bokeʃaɾ
esfollar	eɾfoʎaɾ
gondulfes	ɡondulfe̝s
brosa	bɾɔsa̝
corre	kore̝
rechán	ret͡ʃaŋ
cerollo	θeɾoʎo̝
estala	estala̝
chacina	t͡ʃasina̝
angueira	aŋɡejɾa̝
espichar	espit͡ʃaɾ
gondollín	ɡondoʎiŋ
segorella	seɣoɾeʎa̝
sangaño	saŋɡaɲo̝
cristián	kɾistjaŋ
chorar	t͡ʃoɾaɾ
latricar	latɾikaɾ
raro	raɾo̝
abruño	aβɾuɲo̝
achandar	at͡ʃandaɾ
escolleito	eskoʎejto̝
esmagar	esmaɣaɾ
esterco	esteɾko̝
bancal	baŋkal
anoxar	anoʃaɾ
peirao	pejɾaʊ
rastro	rastɾo̝
fermento	feɾmɛnto̝
gaita	ɡajta̝
malado	malaðo̝
beleguín	beleɣiŋ
graxa	ɡɾaʃa̝
marzapán	marθapaŋ
faia	faja̝
fío	fio̝
aninovo	aninɔβo̝
testeira	tɛstejɾa̝
tuimil	tujmil
mestura	mestuɾa̝
cálice	kalise
correa	korea̝
cabazo	kaβaθo̝
ciringallo	θiɾiŋɡaʎo̝
feal	feal
óso	ɔso̝
requián	rekiaŋ
robra	rɔβɾa̝
xaxún	ʃaʃuŋ
míllaras	miʎa̝ɾa̝s
espicho	espit͡ʃo̝
ladeira	laðejɾa̝
bébedo	beβe̝ðo̝
xiao	ʃiao̯
golpe	ɡɔlpe̝
reinar	rejnaɾ
orzón	oɾsoŋ
corte	kɔɾte̝
balvís	balβis
apalpar	apalpaɾ
trasnada	tɾasnaða̝
libraría	liβɾaɾia̝
ribada	riβaða̝
reguengo	reɣɛŋɡo̝
poleiro	pulejɾo̝
morado	moɾaðo̝
píntega	pinte̝ɣa̝
arcipreste	aɾθipɾɛste̝
acougar	akowɣaɾ
varcia	baɾsja̝
lobishome	loβisɔme̝
picheleiro	pit͡ʃɛlejɾo̝
pechadura	pet͡ʃaðuɾa̝
cántara	kanta̝ɾa̝
mexer	meʃeɾ
marouba	maɾowβa̝
farrapo	farapo̝
pixa	piʃa̝
charamusca	t͡ʃaɾamuska̝
isqueiro	iskejɾo̝
cavorco	kaβɔɾko̝
acaer	akaeɾ
recudir	rekuðiɾ
rebordelo	reβoɾðɛlo̝
ferrado	feraðo̝
frouma	fɾowma̝
tronco	tɾoŋko̝
montecelo	monteselo̝
buxardo	buʃaɾð̝o
arroutado	arowtaðo̝
alxofre	alʃofɾe̝
monteiro	montejɾo̝
navío	naβio̝
tríscele	tɾisθe̝le̝
anga	aŋka̝
mantenza	mantɛnθa̝
abeaca	aβeaka̝
arteiro	aɾtejɾo̝
pallote	paʎɔte̝
baixel	bajʃɛl
teixugo	tejʃuɣo̝
rego	rɛɣo̝
barreira	barejɾa̝
riscar	riskaɾ
tesouro	tesowɾo̝
garrote	ɡarɔte̝
pequeno	pekeno̝
desalgar	desalɣaɾ
martelo	maɾtɛlo̝
tasca	taska̝
entrefollo	entɾefoʎo̝
guiar	ɡiaɾ
ledo	lɛðo̝
irmá	iɾma
mallada	maʎaða̝
carreto	kareto̝
fouce	fowθe̝
lercha	lɛɾt͡ʃa̝
seixebra	sejʃeβɾa̝
prea	pɾea̝
almallo	almaʎo̝
roer	roeɾ
galar	ɡalaɾ
patín	patiŋ
amolentar	amolentaɾ
cumial	kumial
cisco	θisko̝
mollar	moʎaɾ
tomar	tomaɾ
pemento	pemento̝
banzo	banso̝
orballar	oɾβaʎaɾ
cascón	kaskoŋ
sombreiro	sombɾejɾo̝
napia	napja̝
castromaior	kastɾomajoɾ
lucenza	luθɛnθa̝
estarricar	estarikaɾ
faceira	fasejɾa̝
escarolar	eskaɾolaɾ
muiñeiro	muiɲejɾo̝
rosmar	rɔsmaɾ
xear	ʃeaɾ
mariz	maɾiθ
chimpo	t͡ʃimpo̝
aliviar	aliβjaɾ
franqueza	fɾaŋkeθa̝
afalar	afalaɾ
tear	teaɾ
toar	toaɾ
taboada	taβo̯aða̝
corenta	kɔrɛnta̝
seca	seka̝
egua	ɛɣwɐ
rebulir	rebuliɾ
xuízo	ʃwiθʊ
bradar	bɾaðaɾ
estrar	estɾaɾ
beleguín	beleɰiŋ
peneireiro	penejɾejɾo̝
golfe	ɡɔlfe̝
badalo	baðalo̝
birollo	biɾɔʎo̝
carpaza	kaɾpaθa̝
escambrón	eskambɾoŋ
marco	maɾko̝
arrefecer	arefeθeɾ
lenzo	lɛnθo̝
xogo	ʃɔɣo̝
arnal	aɾnaʊ̯
breixo	bɾejʃo̝
ganzo	ɡanθo̝
desleixar	deslejʃaɾ
vindima	bindima̝
denociña	denoθiɲa̝̝
axear	aʃeaɾ
ganir	ɡaniɾ
hucha	ut͡ʃa̝
oliva	oliba
cabaneiro	kaβanejɾo̝
bertamil	beɾtamil
machucar	mat͡ʃukaɾ
gorgoiro	ɡoɾɣojɾo̝
bouza	bowθa̝
entregar	entɾeɡaɾ
ceibo	θejβo̝
seimeira	sejmejɾa̝
leirón	lejɾoŋ
tabuela	taβuɛla̝
mandar	mandaɾ
touzo	towθo̝
gabear	ɡaβeaɾ
rabaño	raβaɲo
remol	remɔl
candeeiro	kandiejɾo̝
da	d̪ɐ
lareira	laɾejɾa̝
galdaripo	ħaldaɾipʊ
penca	peŋka̝
atufado	atufaðo̝
alvariza	alβaɾiθa̝
broa	bɾoa̝
vexiga	biʃiɣa̝
demoucar	demowkaɾ
boirao	bɔjɾaw
preguiceiro	pɾeɣisejɾo̝
xogral	ʃoɣɾal
próximo	pɾɔksimʊ
vincha	bint͡ʃa̝
vaxina	baʃina
soer	soeɾ
fozar	foθaɾ
choqueiro	t͡ʃɔkejɾo̝
tapada	tapaða̝
billarda	biʎaɾða̝
avea	aβea̝
ardora	aɾðoɾa̝
trincheira	tɾint͡ʃaɾ
avoengo	aβoeŋɡo̝
debandar	deβandaɾ
cacheira	kat͡ʃejɾa̝
convidar	kombiðaɾ
machada	mat͡ʃaða̝
cómaro	koma̝ɾo̝
cavaxe	kaβaʃe̝
castizal	kastisal
pabea	paβea̝
furón	fuɾoŋ
casanova	kasanɔβa̝
cagar	kaɣaɾ
crica	kɾika̝
fochanca	fot͡ʃaŋka̝
descascar	deskaskaɾ
terrón	teroŋ
atuír	atuiɾ
beberaxe	beβeɾaʃe̝
tecelán	teselaŋ
carnocho	kaɾnot͡ʃo̝
nai	naj
rechumir	ret͡ʃumiɾ
coriscada	koɾiskaða̝
fornir	foɾniɾ
acivro	aθiβɾo̝
lareto	laɾeto̝
bullo	buʎo̝
xofre	ʃɔfɾɪ
costal	kostal
pabío	paβio̝
tomé	tomɛ
xurelo	ʃuɾɛlo̝
couto	kowto̝
enganido	eŋɡaniðo̝
toneleiro	tonelejɾo̝
reburdiar	reβuɾðeaɾ
nana	nana̝
carrizo	kariθo̝
molete	molete̝
noiteboa	nojteβoa̝
gradar	ɡɾaðaɾ
castelo	kastɛlo̝
prol	pɾɔl
tomada	tomaða̝
abruñeiro	aβɾuɲejɾo̝
achantar	at͡ʃantaɾ
relinga	reliŋɡa̝
celme	sɛlme̝
chafariz	t͡ʃafaɾiθ
miga	miɣa̝
esquío	eskio̝
oso	oso̝
tacha	tat͡ʃa̝
cora	kɔɾa̝
costeiro	kɔstejɾo̝
estragar	estɾaɣaɾ
fornecer	fɔɾnɛseɾ
cagalleta	kaɣaʎeta̝
riazón	riaθoŋ
moza	moθa̝
carro	karo̝
corredoira	koreðojɾa̝
prado	pɾaðo̝
ariño	aɾiɲo̝
abrigar	aβɾiɣaɾ
zorro	soro̝
bagulla	baɣuʎa̝
esbullar	esβuʎaɾ
murcho	muɾt͡ʃo̝
angarellas	aŋɡaɾeʎa̝s
cadea	kaðea̝
esfolar	esfolaɾ
parada	paɾaða̝
cerca	θeɾka̝
monifate	monifate̝
carrasco	karasko̝
con	ko̝ŋ
alcalde	alkalðe̝
sequeiro	sekejɾo̝
coco	koko̝
cirurxián	θiɾuɾʃjaŋ
cobiza	koβisa̝̝
livián	liβiaŋ
requesende	rekesende̝
porta	pɔɾta̝
roxón	roʃoŋ
cueiro	kuejɾo
banqueta	baŋketa̝
alcuñar	alkuɲaɾ
cumprir	kumpɾiɾ
palleiro	paʎejɾo̝
sarro	saro̝
tormento	toɾmento̝
rancio	ranθjo̝
mentir	mintiɾ
catorce	katoɾθɪ
papuxas	papuʃa̝s
esbellar	esβeʎaɾ
sen	sɛŋ
pexa	peʃa̝
irixoa	iɾiʃɔa̝
osa	ɔsa̝
voitre	bojtɾe̝
poial	pojal
asinar	asinaɾ
petouco	petowko̝
compaña	kompaɲa̝
beiramar	bejɾamaɾ
fondal	fondal
cheda	t͡ʃeða̝
amieiro	amiejɾo̝
medio	meðio̝
folgueira	folɣejɾa̝
bosque	bɔske
marís	maːɾis
cereixa	θɾɛjʃa̝
peniz	peniθ
voitirón	bojtiɾo̝ŋ
refugallo	refuɣaʎo̝
cárdeo	kaɾðeo̝
cristo	kɾisto̝
preada	pɾeaða̝
unlla	unʎa̝
bermún	beɾmuŋ
trouso	tɾowso̝
muiñeira	muiɲejɾa
cimbro	θimbɾo̝
solda	solda̝
choutar	t͡ʃowtaɾ
gota	ɡota̝
anta	anta̝
anaco	anako̝
fraixolé	fɾajʃʊlɛ
carmear	kaɾmeaɾ
céltigos	sɛltiɣo̝s
estivada	estiβaða̝
brandariz	bɾandaɾiθ
morriñento	moriɲɛnto̝
zorra	sora̝
canafrecha	kanafɾet͡ʃa̝
mallante	maʎante̝
derrego	derɛɣo̝
cruceiro	kɾuθejɾo̝
fiollo	fioʎo̝
ervellaca	eɾβeʎaka̝
rodrigo	rodɾiɣo̝
ferraña	feraɲa̝
sino	sino̝
matadoiro	mataðojɾo̝
baiuca	bajuka̝
merda	mɛɾða̝
garela	ħaɾɛla̝
topar	topaɾ
boeta	boeta̝
entullo	entuʎo̝
angumil	aŋɡumil
bacorelo	bakoɾɛlo̝
acibeche	aθiβɛt͡ʃe̝
faca	faka̝
banir	baniɾ
sabelo	saβɛlo̝
cregaxe	kɾɛɣaʃe̝
viturón	bituɾo̝ŋ
grelo	ɡɾilo̝
beresmo	beɾesmo̝
esfrangullar	esfɾaŋɡuʎaɾ
poalla	poaʎa̝
ruxidoiro	ruʃiðojɾo̝
morcego	moɾθɛɣo̝
golmar	ɡolmaɾ
galgar	ɡalɣaɾ
volta	bɔlta̝
treina	trejna̝
area	aɾea̝
rebisaco	rɛβiz̺ako̝
troita	tɾuta̝
tallar	taʎaɾ
couzón	kowsoŋ
tolosa	tolosa
lighó	liħoŋ
espora	espɔɾa̝
xente	ʃente̝
albó	alβo̝
cabo	kaβo̝
caetano	kaetano̝
avesedo	aβeseðo̝
enxebre	enʃeβɾe̝
funil	funil
esfollar	esfoʎaɾ
cismar	θismaɾ
gorentar	ɡoɾɛntaɾ
bici	biθi
niñeiro	niɲejɾo̝
espádoa	espado̯a
estiar	estiaɾ
beliscar	beliskaɾ
moeche	moet͡ʃe̝
miañar	miaɲaɾ
pazó	paθɔ
soro	soɾo̝̝
morea	moɾea̝
corpiño	koɾpiɲo̝
envurullar	embuɾuʎaɾ
feila	fejla̝
capelo	kapelo̝
capa	kapa̝
borralla	boraʎa̝
gaio	ɡajo̝
orfo	ɔɾfo̝
enfeitizar	eɱfejtisaɾ
filloa	fiʎɔa̝
voleibol	bo̞le̞iβ̞o̞l
moio	mojo̝
buxeu	buʃɛw
orxo	ɔɾʃo̝
diñeiro	diɲejɾo̝
escorrentar	eskorentaɾ
decepar	deθepaɾ
prezo	pɾeθo̝
amizade	amiθaðe̝
tanza	tansa
tarabela	taɾaβɛla̝
alpendre	alpendɾe̝
verza	beɾθa̝
pezuño	pɛsuɲo̝
liñaxe	liɲaʃe
bedulo	beðulo̝
peluxe	peluʃe̝
noxento	noʃɛnto̝
mazarico	masaɾiko̝
carbón	kaɾβoŋ
pouta	powta̝
entullar	entuʎaɾ
campo	kãmpo̝
chozo	t͡ʃɔso̝
paes	paes
orneón	oɾneoŋ
ceibe	θejβe̝
adiviñar	aðiβiɲaɾ
encetar	ensetaɾ
bascullo	baskuʎo̝
serantes	seɾante̝s
vacina	basina̝
tiro	tiɾo̝
zoscar	θoskaɾ
apio	apjo̝
monteira	montejɾa̝
babuxa	baβuʃa̝
xilbarbeira	ʃilβaɾβejɾa̝
felgo	fɛlɣo̝
xardineiro	ʃaɾðinejɾo
afungar	afuŋɡaɾ
veiga	bejɣa̝
pagar	paɣaɾ
zoca	sɔka̝
vilar	bilaɾ
bourar	bowɾaɾ
devagar	deβaɣaɾ
pousa	powsa̝
avia	aβja̝
mormenta	moɾmenta̝
prego	pɾɛɣo̝
pía	pia̝
menta	mɛnta̝
baladrón	balaðɾo̝n
ceba	seβa̝
cubeta	kuβeta̝
amencer	amenθeɾ
barbanza	baɾβansa̝
caneiro	kanejɾo̝
país	pais
cozo	kɔθo̝
miguéns	miɣɛŋs
fervenza	feɾβɛnsa̝
chumbada	t͡ʃumbaða̝
campa	kampa
pedregullo	peðɾeɣuʎo̝
espadeleiro	espaðelejɾo̝
billardo	biʎaɾðo̝
alporizar	alpoɾisaɾ
chá	t͡ʃa
liaza	liaθa̝
cinto	sinto̝
pano	pano
paa	paː
tranca	tɾaŋka̝
arroto	aroto̝
vagalume	baɣalume̝
cuspe	kuspe̝
incenso	inθɛnso̝
dependurar	dependuɾaɾ
rapaz	rapaθ
cuspido	kuspiðo̝
abelurio	aβeluɾio̝
sapoconcho	sapokont͡ʃo̝
estada	estaða̝
croque	kɾɔke̝
freáns	fɾeaŋs
eiré	ejɾe
escádea	eskaðe̯a̝
combarro	kombaro̝
argana	aɾɣana̝
guindar	ɡindaɾ
avesar	aβesaɾ
limiar	limjaɾ
atián	atiaŋ
aguilloar	aɣiʎoaɾ
mincha	mint͡ʃa̝
cadaleito	kaðalejtʊ
galiza	ɡaliθɐ
cárcere	kaɾθe̝ɾe̝
arzán	aɾθaŋ
rebuldar	reβuldaɾ
cillobre	θiʎɔβɾe̝
cádavo	kaða̝βo̝
chorón	t͡ʃoɾoŋ
ceifa	sɛjfɐ
che	t͡ʃe
aguisar	aɣisaɾ
vilargondurfe	bilaɾɡonduɾfe̝
manle	manle̝
bocha	bɔt͡ʃa̝
chamuscar	t͡ʃamuskaɾ
poseiro	posejɾo̝
zoqueiro	θɔkejɾo̝
taxa	taʃa̝
mesto	mesto̝
cedo	seðo̝
embude	embuðe̝
faiado	fajaðo̝
almorzo	almoɾso̝
forqueta	foɾketa̝
sacar	sakaɾ
moina	mɔjna̝
meiga	mejɣa̝
buraco	buɾako̝
francada	fɾaŋkaða̝
cepo	θepo̝
miguel	miɣɛl
rostro	rostɾo̝
chisca	t͡ʃiska̝
cerne	sɛɾne̝
sola	sɔla̝
bordón	boɾðoŋ
xeada	ʃeaða̝
lobio	loβjo̝
armadura	aɾmaduɾa
viso	biso̝
faiar	fajaɾ
sarria	sarja̝
doca	dɔka̝
ansemar	ansemaɾ
comarca	komaɾka̝
conda	kɔnda̝
tallo	taʎo̝
caldas	kalda̝s
cea	sea̝
zapping	θapin
nandufe	nandufe̝
sobexo	soβeʃo̝
picota	pikota̝
embora	embɔɾa̝
hedreira	ɛðɾejɾa̝
coral	koɾal
proer	pɾoeɾ
tacoar	takoaɾ
brancellao	bɾanθeʎao̯
isca	iska̝
subela	suβɛla̝
rabo	raβo̝
sarxar	saɾʃaɾ
costa	kɔsta̝
poallo	poaʎo̝
gancho	ɡant͡ʃo̝
zapateiro	sapatejɾo̝
fervenza	feɾβɛnθa̝
feso	feso̝
trincado	tɾiŋkaðo̝
mexericas	meʃeɾika̝s
coroa	koɾoa̝
saa	saː
groria	ɡɾɔɾja̝
reseso	resɛso̝
recuar	rekuaɾ
manicomio	manikɔmjo
buligar	buliɣaɾ
cebro	θeβɾo̝
chorir	t͡ʃoɾiɾ
corgo	kɔɾɣo̝
elmo	ɛlmʊ
buraz	buɾas
truel	tɾuɛl
pampo	pampo̝
mascato	maskato̝
augueiro	awɣejɾo̝
aturuxar	atuɾuʃaɾ
boto	bɔto̝
traballar	tɾaβaʎaɾ
pedreiro	peðɾejɾo̝
xan	ʃaŋ
mi	mi
salame	salame
garela	ɡaɾɛla̝
mantemento	mantemɛnto̝
ventas	ventas
chambergas	t͡ʃambeɾɣa̝s
aparellar	apareʎaɾ
tauromaquia	tauɾomakja
belesar	belesaɾ
olveira	olβejɾa̝
cerna	θɛɾna̝
magán	maɣaŋ
brancaneves	bɾaŋka̝nɛβe̝s
mouco	mowko̝
sella	seʎa̝
sabugueiro	saβuɣejɾo̝
garfela	ɡaɾfɛla̝
zoar	zoaɾ
pisón	pisoŋ
madeiro	maðejɾo̝
liame	liame̝
tapar	tapaɾ
pirixel	piɾiʃɛl
bafarada	bafaɾaða̝
chourela	t͡ʃowɾɛla̝
ningún	niŋɡuŋ
inzar	inθaɾ
asoballar	asoβaʎaɾ
perexil	peɾeʃil
garfelo	ɡaɾfɛlo̝
acabar	akabaɾ
cornacha	kɔɾnat͡ʃa̝
muíña	muiɲa̝
famento	famɛnto̝
guillado	ɡiʎaðo̝
apostar	apostaɾ
mordomo	mɔɾðomo̝
charamisca	t͡ʃaɾamiska̝
budión	buðioŋ
casula	kasula̝
chosco	t͡ʃosko̝
arrufar	arufaɾ
compás	kompas
coriscar	koɾiskaɾ
entroido	entɾujðo̝
videira	biðejɾa̝
richar	rit͡ʃaɾ
cuada	kuaða̝
axe	aʃe̝
engastallar	eŋɡastaʎaɾ
zamarra	θamara̝
ladrar	laðɾaɾ
bastir	bastiɾ
zanfona	θaɱfona̝
habelencia	aβelɛnθja̝
boroa	boɾoa̝
cruto	kɾuto̝
tecer	teθeɾ
esculca	eskulka̝
macho	mat͡ʃo̝
recear	reseaɾ
sombra	sombɾa̝
randulfe	randulfe̝
agasallar	aɣasaʎaɾ
esteiro	estejɾo̝
acoro	akoɾo̝
galar	ħalaɾ
gago	ɡaɣo̝
buxeo	buʃeo̯
esmigallar	esmiɣaʎaɾ
pergamiño	peɾɣamiɲo̝
halar	alaɾ
portelo	poɾtɛlo̝
salmón	salmoŋ
friúce	fɾiuθe̝
gola	ɡɔla
oito	ojto̝
manlle	manʎe̝
randolfe	randolfe̝
pardiña	paɾðiɲa̝
loitosa	lojtosa̝
queimar	kejmaɾ
carepa	kaɾepa̝
moreira	moɾejɾa̝
aparcar	apaɾkaɾ
menciña	menθiɲa̝
volandeira	bolandejɾa̝
escenario	esθenaɾjo
anello	aneʎo̝
retrinco	retɾiŋko̝
fortaleza	foɾtaleθa
xermolo	ʃeɾmolo̝
zapato	θapato̝
alcanzar	alkansaɾ
bucio	buθjo̝
espernear	espeɾneaɾ
dubra	duβɾa̝
alcouce	alkowθe̝
valo	balo̝
estela	estɛla̝
cichón	sit͡ʃoŋ
gondufe	ɡondufe̝
loderno	loðɛɾno̝
coial	kɔjal
verga	bɛɾɣa̝
castizal	kastiθal
redondo	reðondo̝
ferro	fɛro̝
cirola	θiɾɔla̝
encetar	enθetaɾ
pinchacarneiro	pint͡ʃakaɾnejɾo̝
míllara	miʎa̝ɾa̝
asma	asma̝
cerna	sɛɾna̝
chapeu	t͡ʃapew
gallar	ɡaʎaɾ
cabezal	kaβesal
bulló	buʎɔ
solleiro	soʎejɾo̝
miño	miɲo̝
apodrentar	apoðɾentaɾ
canaval	kanaβal
abelá	aβela
cincha	θint͡ʃa̝
gavela	ɡaβɛla
cerquiño	θeɾkiɲo̝
guindareza	ɡindaɾeθɐ
carracha	karat͡ʃa̝
lagarto	laɣaɾto̝
bando	bando̝
betoque	betɔke̝
prebe	pɾɛβe̝
lear	leaɾ
catasol	katasol
abrigo	aβɾiɣo̝
cela	θɛla̝
xunco	ʃuŋko̝
abafar	aβafaɾ
croia	kɾɔja̝
dourado	dowɾaðo̝
gomesende	ɡomesende̝
pallota	paʎɔta̝
poceiro	poθejɾo̝
bendrade	bendɾaðe̝
feixe	fejʃe̝
cativo	katiβo̝
abur	aβuɾ
cumieira	kumjejɾa̝̝
trabuco	tɾaβuko̝
espeta	espeta̝
tina	tina̝
besta	bɛsta̝
ameixeira	amejʃejɾa̝
picapau	pikapaw
amalloar	amaʎoaɾ
homofobia	o̞mo̞fo̞βja̠
curmán	kuɾmao̯
escenario	esenaɾjo
freixa	fɾejʃa̝
facha	fat͡ʃa̝
gaiola	ɡajɔla̝
abra	aβɾa̝
gramar	ɡɾamaɾ
escolma	eskɔlma̝
beldrogo	beldɾoɣo̝
anubrar	anuβɾaɾ
medoña	meðoɲa̝
zamborca	sambɔɾka̝
igrexa	iɣɾeʃa̝
esgrevio	esɣɾeβjo̝
faceiroa	faθejɾoa̝
tamén	tamɛŋ
tronzar	tɾonsaɾ
cadeado	kaðeaðo̝
póla	pɔla̝
buscar	buskaɾ
morriña	muriɲa
cachear	kat͡ʃeaɾ
pedrazo	peðɾaso̝
pinaza	pinaθa̝
mouro	mowɾo̝
obús	ɔβus
chamador	t͡ʃamaðoɾ
asenso	asɛnso̝
lentura	lentuɾa̝
abeiro	aβejɾo̝
pisar	pisaɾ
coio	kɔjo̝
doente	doente̝
fato	fato̝
rubir	ruβiɾ
graña	ɡɾaɲa̝
limaco	limako̝
vesada	besaða̝
uz	us
áspero	aspɾo̝
deostar	deɔstaɾ
albor	alβoɾ
fesga	fesɣa̝
arume	aɾume̝
tranga	tɾaŋɡa̝
rueiro	ruejɾo̝
churrasco	t͡ʃurasko̝
abada	aβaða̝
trinca	tɾiŋka̝
rodeiro	roðejɾo̝
cenza	θɛnθa̝
azouta	asowta̝
poza	posa̝
trema	tɾema̝
fodechinchos	foðet͡ʃint͡ʃo̝s
recuncar	rekuŋkaɾ
consonte	konsonte̝
pallabarro	paʎaβaro̝
prema	pɾema̝
fento	fɛnto̝
soneca	sonɛka̝
esnacar	esnakaɾ
insua	inswa̝
marmelo	maɾmɛlo̝
albarda	alβaɾða̝
toutón	towtoŋ
can	kaŋ
golfiño	ɡolfiɲo̝
escarmear	eskaɾmeaɾ
eu	ew
arqueiro	aɾkejɾo
mentir	mentiɾ
freba	fɾeβa̝
rocín	rosiŋ
pozo	poθo̝
lambonada	lambonaða̝
marra	mara̝
alverxón	alβ̞eɾʃoŋ
cobizoso	koβisoso̝
guindastre	ɡindastɾe̝
cadoiro	kaðojɾo̝
herdanza	ɛɾðanθa̝
cerca	seɾka̝
viravolta	biɾaβɔlta̝
aferretar	aferetaɾ
acibecheiro	asiβɛt͡ʃeiɾo̝
colmea	kolmea̝
apocalipse	apokalipse̝
pernil	pɛɾnil
parrulo	parulo̝
merdento	mɛɾðento̝
bago	baɣo̝
boutureira	bowtuɾejɾa̝
coiraza	kojɾaθa̝
negrón	neɣɾoŋ
repugnante	repuɡnante̝
regueifa	reɣejfa̝
cervexa	seɾβeʃa̝
fito	fito̝
mamada	mamaða
galocha	ɡalɔt͡ʃa̝
boira	bɔjɾa̝
gallado	ɡaʎaðo̝
ceibe	sejβe̝
esmeriz	esmeɾiθ
ateigar	atejɣaɾ
buso	bus̻o̝
sementeira	sementejɾa
bastar	bastaɾ
foula	fowla̝
mirfallo	mirfaʎʊ
remollar	remoʎaɾ
feitizo	fejtiθo̝
adormentar	aðoɾmɛntaɾ
podrecer	poðɾeθeɾ
torgo	tɔɾɣo̝
guisande	ɡisande̝
almariz	almaɾiθ
orxo	oɾʃo̝
torrente	torɛnte̝
meada	meaða̝
chisqueiro	t͡ʃiskejɾo̝
poula	powla̝
derradeiro	deraðejɾo̝̝
congostra	koŋɡostɾa̝
sé	sɛ
deschoer	dest͡ʃoeɾ
peixe	pejʃe̝
rolla	roʎa̝
saña	saɲa̝
feira	fejɾa̝
fretar	fɾetaɾ
orella	oɾeʎa̝
entrouxo	entɾowʃo̝
esfamear	esfameaɾ
enchoupar	ent͡ʃowpaɾ
cheiro	t͡ʃɛjɾo̝
fariña	faɾiɲa̝
coxo	koʃo̝
aceiro	asθejɾo̝
renxer	renʃeɾ
crista	kɾista̝
cabaleiro	kaβalejɾo̝
bertomil	beɾtomil
callar	kaʎaɾ
fedello	feðeʎo̝
traíña	tɾaiɲa̝
ordenanza	oɾðenanθa̝
guillamil	ɡiʎamil
caetano	kae̯tano̝
venda	benda̝
céltigos	θɛltiɣo̝s
soio	sojo̝
raíña	raiɲa̝
petón	petoŋ
molo	molo̝
cisma	ʃiɾma̝
esporón	espoɾoŋ
gonzar	ɡonθaɾ
terroeira	teroejɾa
mucio	muθjo̝
chuvasqueiro	t͡ʃuβaskejɾo̝
badalar	baðalaɾ
guillado	ħiʎaðo̝
han	an
escolmar	eskolmaɾ
lucenza	luθenθa̝
franco	fɾaŋkʊ
natura	natura̝
pombal	pɔmbal
barbanza	baɾβanθa̝
arrufado	arufaðo̝
becerra	beθera̝
tralla	tɾaʎa̝
dubidar	duβiðaɾ
torrar	toraɾ
sachar	sat͡ʃo̝
frangulla	fɾaŋɡuʎa̝
trepia	tɾepja̝
lavadura	laβaðuɾa̝
nobelo	noβelo̝
bota	bota̝
teito	tejto̝
cabrafigo	kaβɾa̝fiɣo̝
gana	ɡana̝
acha	at͡ʃa
roldán	roldaŋ
ofraxe	ɔfɾaʃe̝
arroupar	arowpaɾ
esboirar	esβojɾaɾ
lofa	lofɐ
morno	mɔɾno̝
randeeira	randeejɾa̝
catuxa	katuʃa̝
vizo	biso̝
puñal	puɲal
pan	paŋ
pravoa	pɾaβo̯a̝
nío	niw
ollar	oʎaɾ
escurecer	eskuɾeθeɾ
boo	bo
tacho	tat͡ʃo
rollo	roʎo̝
gulfariz	ɡulfaɾiθ
lapar	lapaɾ
galega	ħaleħɐ
falangueiro	falaŋɡejɾo̝
vorco	bɔɾko̝
toro	toɾo̝
barón	baɾoŋ
enxerir	enʃeɾiɾ
laretar	laɾetaɾ
escarallar	eskaɾaʎaɾ
ábrego	aβɾe̝ɣo̝
pitela	pitɛla̝
xibardo	ʃiβaɾðo̝
teimudo	tejmuðo̝
faceiroa	fasejɾoa̝
carnoedo	kaɾnoeðo̝
pasal	pasal
guerra	ɡɛra̝
cadillo	kaðiʎo̝
colo	kɔlo̝
rapante	rapante̝
estalar	estalaɾ
touza	towθa̝
xurro	ʃuro̝
corno	kɔɾno̝
cear	θeaɾ
parede	paɾeðe̝
brea	bɾea̝
aza	aθa
mastro	mastɾo̝
bagazo	baɣaso̝
xerme	ʃɛɾme̝
bota	bɔta̝
vizoso	biθoso̝
sisa	sisa̝
doutro	dowtɾo
cebada	mendɾeʎo̝
chencha	t͡ʃent͡ʃa̝
remexer	remeʃeɾ
louredo	lowɾeðo̝
lesta	lɛsta̝
dicir	diθiɾ
cortiza	koɾtiθa̝
estévez	esteβeθ̝
estripacontos	estɾipakonto̝s
escoda	es̺koð̞ɐ
aluscar	aluskaɾ
meda	mɛða̝
lousado	lowsaðo̝
chor	t͡ʃoɾ
bidueiro	biðuejɾo̝
cincho	sint͡ʃo̝
meu	mew
fouciña	fowθiɲa̝
lento	lento̝
trabanco	tɾaβaŋko̝
zuncho	θunt͡ʃo̝
enxaugar	enʃawɣaɾ
melgacho	mɛlɣat͡ʃo̝
bieiteiro	biejtejɾo̝
touticeira	towtiθejɾa̝
peza	pɛθa̝
mallar	maʎaɾ
chata	t͡ʃata̝
florín	floɾiŋ
zorra	θora̝
miolo	miolo̝
pezoia	pesoja̝
sartaña	saɾtaɲa
alínea	alinea
godallo	ɰoðaʎo̝
piquelo	pikɛlo̝
nin	niŋ
escuso	eskuso̝
chover	t͡ʃoβeɾ
pontón	puntoŋ
luar	luaɾ
alabarar	alaβaɾaɾ
risada	risaða̝
pallaza	paʎaθa̝
cisma	sisma̝
borro	boro̝
xadrez	ʃaðɾeθ
des	des
caca	kaka̝
mañufe	maɲufe̝
roda	rɔða̝
melón	meloŋ
leiba	lɛjβa̝
chafariz	t͡ʃafaɾis
xurreira	ʃurejɾa̝
casco	kasko̝
toimil	tojmil
restrelo	restɾelo̝
laido	lajðo̝
marta	maɾta̝
sorte	sɔɾte̝
quiñón	kiɲoŋ
vestir	bistiɾ
finar	finaɾ
ruído	ruiðo̝
treboada	tɾeβoaða̝
papafigo	papafiɣo̝
ventureiro	bentuɾejɾo̝
topete	topɛte̝
palma	palma̝
grixoa	ɡɾiʃɔa̝
picar	pikaɾ
prestar	pɾestaɾ
guldrís	ɡuldɾis
berce	bɛɾse̝
aixada	ajʃaða̝
vendaval	bendaβal
chedeiro	t͡ʃeðejɾo̝
escangallar	eskaŋɡaʎaɾ
chan	t͡ʃaŋ
bácoro	bako̝ɾo̝
trouzo	tɾowso̝
nabiza	naβiθa̝
esposa	esposa̝
maariz	maːɾiθ
podrén	poðɾɛŋ
esbourar	esβowɾaɾ
afreitas	afɾejta̝s
cotián	kɔtjaŋ
aceda	aθeða̝
feixe	fejʃ
pitelo	pitɛlo̝
trapela	tɾapɛla̝
barallete	baɾaʎete̝
lamia	lamja̝
fiúza	fiuθa̝
gorxa	ɡɔɾʃa̝
fraga	fɾaɣɐ
milmanda	milmanda̝
zafra	safɾa
trepar	tɾepaɾ
orballo	oɾβaʎo̝
trisco	tɾisko̝
arameña	aɾameɲa̝
ollar	ɔʎaɾ
trade	tɾaðe̝
sa	sa
pelexar	peleʃaɾ
maragoto	maɾaɣɔto̝
alustrar	alustɾaɾ
augardente	awɣaɾðɛnte̝
axirxilar	aʃiɾʃilaɾ
sable	saβle̝̝
argallar	aɾɣaʎaɾ
zorregar	soreɡaɾ
valente	balɛnte̝
comesto	komesto̝
cazón	kaθoŋ
bou	bow
gargallar	ɡaɾɣaʎaɾ
longo	loŋɡo̝
buxeu	buʃew
palmeira	palmeiɾa
infondura	ɪŋfonduɾa̝
baeta	baeta̝
fastío	fastio̝
sar	saɾ
entruido	entɾujðo̝
vara	baɾa̝
caluga	kaluɣa̝
revellido	reβeʎiðo̝
tinta	tinta̝
guindareza	ɡindaɾesɐ
portela	pɔɾtɛla̝
faragulla	faɾaɣuʎa̝
faba	faβa̝
arpeo	aɾpeo̝
esburgar	esβuɾɣaɾ
barco	baɾkʊ
escofar	eskofaɾ
acibecheiro	aθiβɛt͡ʃeiɾo̝
barqueiro	baɾkejɾo̝
bacieiro	baθiejɾo̝
do	d̪ʊ
cepar	θepaɾ
ganapán	ɡanapaŋ
atrapallar	atɾapaʎaɾ
acaroar	akaɾoar
arfar	aɾfaɾ
canga	kaŋɡa̝
troba	tɾɔβa̝
coitelo	kojtɛlo̝
xas	ʃaːs̺
bacelo	baθɛlo̝
cisco	sisko̝
senlleiro	senʎejɾo̝
braga	bɾaɣa̝
galiñeiro	ɡaliɲejɾo̝
buzaco	busako̝
vurullo	buɾuʎo̝
querer	keɾeɾ
riazó	riaθɔ
froila	fɾɔjla̝
escavar	eskaβaɾ
baraza	baɾasa̝
meleiro	mɛlejɾo̝
cheo	t͡ʃeo̝
guerreiro	ɡɛrejɾo̝
afogar	afoɣaɾ
grilanda	ɡrilanda̝
testa	testa̝
bozo	boθo̝
trincar	triŋkaɾ
eixido	ejʃiðo̝
fornello	forneʎo̝
cova	kɔβa̝
xendra	ʃendɾa̝
estribeira	estɾiβejɾa̝
cerrar	sɛraɾ
meogo	meɔɣo̝
suorento	suoɾɛnto̝
toleiro	tɔlejɾo̝
portal	poɾtal
estripar	estɾipaɾ
porén	poɾeŋ
fronza	fɾonsa̝
cona	kona̝
coira	kojɾa̝
lide	liðe̝
camiño	kamiɲo̝
peregrino	peɾeɣɾino̝
foxo	foʃo̝
abetocar	aβetɔkaɾ
monticelo	montiθɛlo̝
leito	lejto̝
laderno	laðɛɾno̝
venres	bɛnre̝s
zorregar	θoreɡaɾ
canizo	kaniso̝
labrada	laβɾaða̝
moneca	monɛka
chirlar	t͡ʃiɾlaɾ
cerrar	θɛraɾ
presuño	pɾɛsuɲo̝
percebe	peɾseβe̝
troita	tɾujta̝
golfón	ɡolfoŋ
saleiro	salejɾo̝
fregar	fɾeɣaɾ
debuxar	deβuʃaɾ
retrucar	retɾukaɾ
gurgullo	ɡuɾɣuʎo̝
tragar	tɾaɣaɾ
drola	dɾɔla̝
mellora	meʎoɾa̝
guillade	ɡiʎaðe̝
bilurico	biluɾiko̝
chencha	t͡ʃɛnt͡ʃa̝
galga	ɡalɣa̝
cruzado	kɾusaðo̝
xerar	ʃeɾaɾ
legua	lɛɣʊ̯a̝
toiberde	tujβeɾðe̝
escairar	eskajɾaɾ
torco	tɔɾko̝
illarga	iʎaɾɣa̝
abondo	aβondo̝
foia	fɔja̝
longaínza	loŋɡainθa̝
lampaza	lampaθa̝
mordomádego	moɾðomaðe̝ɣo̝
taberneiro	taβɛɾnejɾo̝
zamarra	samara̝
colmo	kɔlmo̝
piar	piaɾ
lembrar	lembɾaɾ
sociable	sɔθjable
galicia	ɡalisjɐ
teiga	tɛjɣa̝
toutizo	towtiθo̝
freila	fɾejla̝
arrombar	aromβaɾ
pomar	pomaɾ
almorzar	almoɾsaɾ
ril	ril
lanza	lanθa̝
besta	besta̝
cosmogonía	kosmoɣonia
caravilla	kaɾaβiʎa̝
arroaz	aroaθ
solla	soʎa̝
tamouca	tamowka̝
entón	entoŋ
pereira	peɾejɾa̝
carballo	kaɾβaʎo̝
pelota	pelɔta̝
reo	reo̝
asolagar	asolaɡaɾ
empoleirar	empolejɾaɾ
leiva	lɛjβa̝
ceibar	sejβaɾ
praza	pɾaθa̝
xoga	ʃɔɣa̝
celeiro	θelejɾo̝
xostra	ʃɔstɾa̝
cerro	sero̝
cadrifollo	mendɾeʎo̝
librar	liβɾaɾ
raso	raso̝
solaina	solajna̝
portádego	pɔɾtaðe̝ɣo̝
robaliza	roβalisa̝
regatón	reɣatoŋ
carallada	kaɾaʎaða̝
suor	suoɾ
depenicar	depenikaɾ
rocha	rɔt͡ʃa̝
estoupar	estowpaɾ
retriza	retɾiθa̝
mallo	maʎo̝
lote	lɔte̝
encaixar	eŋkajʃaɾ
aloumiñeiro	alowmiɲejɾo̝
mada	maða̝
cornecho	kɔɾnet͡ʃo̝
encanto	eŋkanto̝
soá	soa
abrente	aβɾɛnte̝
consello	konseʎo̝
abetouro	aβetowɾo̝
brandarís	bɾandaɾis
couce	kowse
néboa	nɛβo̯a̝
colmear	kolmear
acereiro	aθeɾejɾo̝
facho	fat͡ʃo̝
couso	kowso̝
valume	balume̝
mámoa	mamo̯a
relusco	relusko̝
amolegar	amoleɣaɾ
cancelo	kansɛlo̝
cortello	koɾteʎo̝
couzoeira	kowsoejɾa̝
escaravello	eskaɾaβɛʎo̝
labestro	laβestɾo̝
celamín	θelamiŋ
botella	botɛʎɐ
lesende	lesende̝
vira	biɾa̝
entrego	entɾɛɣo̝
gornecer	ɡoɾneθeɾ
centulo	θentulo̝
sobrado	soβɾaðo̝
celanova	θelanɔβa̝
ferra	fɛra̝
lagoa	laɣoa̝
érbedo	eɾβe̝ðo̝
bacío	basio̝
mexillón	miʃiʎoŋ
curuxa	kuɾuʃa̝
fumegar	fumeɣaɾ
louzán	lowθaŋ
panca	paŋka̝
fionllo	fionʎo̝
polaina	polajna̝
nifrar	nifɾaɾ
buceta	buθeta̝
laredo	laɾiðo̝
miradoiro	miɾaðojɾo̝
trapallada	tɾapaʎaða̝
mariñeiro	maɾiɲejɾo̝
ledesma	leðesma̝
claro	klaɾo̝
tenda	tenda̝
chea	t͡ʃea̝
leria	lɛɾja̝
semellar	semeʎaɾ
mantenza	mantɛnsa̝
mosteiró	mostejɾɔ
esterqueira	esteɾkejɾa̝
estear	esteaɾ
achorentar	at͡ʃoɾɛntaɾ
moufa	mowfa̝
arando	aɾando̝
tordo	toɾðo̝
basculla	baskuʎa̝
guincho	ɡint͡ʃo̝
ola	ola̝
agro	aɣɾo̝
quecer	kɛθeɾ
sandar	sandaɾ
amencer	amenseɾ
taboado	taβo̯aðo̝
bogada	boɣaða̝
nariz	naɾis
chincho	t͡ʃit͡ʃaro̝
xabre	ʃaβɾe̝
chufar	t͡ʃufaɾ
trocar	tɾokaɾ
langrán	laŋɡɾaŋ
artigo	aɾtiɣo̝
baraza	baɾaθa̝
pote	pɔte̝
apeladoira	apelaðojɾa̝
melga	mɛlɣa̝
estremo	estɾemo̝
ferrada	fɛraða̝
andrade	andɾaðe̝
gastallo	ɡastaʎo̝
fouce	fowse̝
perdiz	peɾðiθ
pádoa	pað̞wa̝
cable	kaβle̝
rodeira	roðejɾa̝
rubién	ruβjɛŋ
rexión	reʃjoŋ
belvís	bɛlβis
torrontés	torontes
cristal	kɾistal
borreiro	borejɾo̝
táboa	taβo̯a̝
freixedo	fɾejʃeðo̝
cargar	kaɾɣaɾ
sacho	sat͡ʃo̝
zanfoga	θaɱfɔɣa̝
esmilfallar	esmilfaʎaɾ
grei	ɡrɛj
cincho	θint͡ʃo̝
tamuxe	tamuʃe̝
piringalla	piriŋɡaʎa̝
esfaragullar	esfaɾaɣuʎaɾ
magosto	maɣosto̝
mión	mioŋ
vedro	bɛðɾo̝
triabá	tɾiaβa
varón	baɾoŋ
saído	saiðo̝
illó	iʎɔ
mexada	meʃaða̝
peleteiro	peletejɾo̝
coello	koeʎo̝
desqueixar	deskejʃaɾ
nubeiro	nuβejɾo
arrotar	arotaɾ
aduanada	aðwanaða̝
cinlla	θinʎa̝
cerviño	θɛɾβiɲo̝
allada	aʎaða̝
tren	tɾɛŋ
rixo	riʃo̝
suorento	suoɾento̝
cangar	kaŋɡaɾ
ambroesa	ambɾuesa̝
agulla	aɣuʎa̝
rousar	rowsaɾ
esnaquizar	esnakisaɾ
enfeitar	eɱfejtaɾ
rachar	rat͡ʃaɾ
espremer	espɾemeɾ
asmo	asmo̝
peneirar	penejɾaɾ
noxo	noʃo̝
rodrigar	roðɾiɣaɾ
parvo	paɾβo̝
trueiro	tɾuejɾo̝
emprestar	empɾestaɾ
podre	poðɾe̝
xeración	ʃeɾaθjoŋ
sebo	seβo̝
vascullo	baskuʎo̝
xoaniña	ʃwaniɲa̝
espulla	espuʎa̝
rengue	rɛŋɡe̝
tinalla	tinaʎa̝
atar	ataɾ
vilariño	bilaɾiɲo̝
empanar	empanaɾ
azougue	aθowɣe̝
paixón	pajʃoŋ
trono	tɾono̝
galardón	ɡalaɾðoŋ
árgoma	aɾɣo̝ma̝
esculcar	eskulkaɾ
caer	kaeɾ
refungar	refuŋkaɾ
cas	kas
gobelete	ɡoβelete̝
fozar	fosaɾ
garavanzo	ɡaraβanθo̝
vitureira	bituɾejɾa̝
cadeirado	kaðejɾaðo
arrecender	aresendeɾ
intre	intɾe̝
furancho	fuɾant͡ʃo̝̝
mergullar	meɾɣuʎaɾ
dentón	dɛntoŋ
raíz	rais
marcar	maɾkaɾ
zafra	θafɾa
tecelán	teθelaŋ
pota	pɔta̝
cego	sɛɣo̝
acevo	aθeβo
gafo	ɡafo̝
pescozada	peskosada̝
andar	andaɾ
escorar	eskɔɾaɾ
zanca	θaŋka̝
doira	dojɾa̝
señeiro	seɲejɾo̝
olmo	olmo̝
sangiao	sanʃiao̯
gallo	ħaʎʊ
sobreira	soβɾejɾa̝
choupar	t͡ʃowpaɾ
esmola	esmɔla̝
recear	reθeaɾ
camisa	kamisa̝
cancela	kansɛla̝
preguiceiro	pɾeɣiθejɾo̝
lamazal	lamasal
berro	bɛro̝
baril	baɾil
alto	alto̝
buxarda	buʃaɾða̝
buxón	buʃoŋ
auga	awɡa
perexil	pɾeʃil
doente	doɛnte̝
parladoiro	paɾlaðojɾo̝
olga	ɔlɣa̝
serpe	sɛɾpe̝
caíño	kaiɲo̝
boullón	bowʎoŋ
fita	fita̝
birollo	biɾoʎo̝
balorento	baloɾɛnto̝
alcácer	alkasɛɾ
monllo	mɔnʎo̝
parrumeira	parumejɾa̝
rusia	rusja
aquí	aki
espiar	espiaɾ
sorrir	soriɾ
trenla	tɾɛnla̝
loureiro	lowɾejɾo̝
tronada	tɾonaða̝
escarpear	eskaɾpeaɾ
biqueira	bikejɾa̝
cezobre	θeθɔbɾe̝
xeitoso	ʃejtoso̝
tol	tɔl
goro	ɡɔɾo̝
abafo	aβafo̝
roñar	roɲaɾ
sarillo	saɾiʎo̝
troula	tɾowla̝
pasadoiro	pasaðojɾo̝
pá	paː
adrede	aðɾeðe̝
mazaroca	maθaɾɔka̝
xalundes	ʃalundes
seara	seaɾa̝
moufada	mowfaða̝
balboa	balβoa̝
agromar	aɣɾomaɾ
orgullo	oɾɣuʎo̝
arre	are̝
cinchar	θint͡ʃaɾ
requeixo	rekejʃo̝
dobrar	doβɾaɾ
casquete	kaskete̝
decote	dekɔte̝
túzaro	tusa̝ɾo̝
acio	aθjo̝
baloco	balɔko̝
ferros	fɛro̝s
muxe	muʃe̝
despender	despendeɾ
enriquecer	enrikeθeɾ
ferir	feɾiɾ
nembargantes	nɛmbaɾɣa̝nte̝s
galega	ɡaleɣɐ
xouba	ʃowβa̝
mosende	mosende̝
abalo	aβalo̝
estourar	estowɾaɾ
aparello	apaɾeʎo̝
veitureira	bejtuɾejɾa̝
liñó	liɲɔ
olfate	ɔlfate̝
estevo	esteβo̝
esguizar	esɣiθaɾ
maceira	maθejɾa̝
piscar	piskaɾ
campaza	kampaθa̝
gaivota	ɡajβɔta̝
brandián	bɾandiaŋ
borrea	borea̝
morar	moɾaɾ
calvo	kalβo̝
avesío	aβesio̝
vezo	beso̝
puño	puɲo̝
aguillada	aɡiʎaða̝
buxola	buʃɔla̝
bicho	bit͡ʃo̝
tirador	tiɾaðoɾ
zoar	soaɾ
merdento	mɛɾðɛnto̝
ansoar	anso̯aɾ
perna	pɛɾna̝
recanto	rekanto̝
regato	reɣato̝
samos	samo̝s
treito	tɾejto̝
rodriga	roðɾiɣa̝
predela	pɾeðɛla
berberecho	beɾβeɾet͡ʃo̝
desferrado	desferaðo̝
sa	saː
chapeu	t͡ʃapɛw
hortelá	ɔɾtela
cervún	θɛɾβuŋ
fungar	fuŋkaɾ
chicharro	t͡ʃit͡ʃaro̝
milgranda	milɣɾanda̝
malleira	maʎejɾa̝
doado	duaðo̝
carballa	kaɾβaʎa̝
mosqueira	moskejɾa̝
pesqueira	peskejɾa̝
muruxa	muɾuʃa̝
xiba	ʃiβa̝
eslumar	eslumaɾ
morteiro	moɾtejɾo̝
espadela	espaðɛla̝
canle	kanle̝
lesma	lɛsma̝
rairo	rajɾo̝
mariola	maɾjɔla̝
lambefoula	lambefowla̝
zurro	θuro̝
fillo	fiʎo̝
mazá	maθaː
parruma	paruma̝
brocha	bɾɔt͡ʃa̝
tornarratos	tɔɾnarato̝s
rocho	rɔt͡ʃo̝
buso	buso̝
seda	seða
sazón	saθoŋ
eirado	ejɾaðo̝
chaga	t͡ʃaɣa̝
pobo	pɔβo̝
busto	busto̝
caixón	kajʃoŋ
chavella	t͡ʃaβeʎa̝
cinta	sinta̝
rosmar	rosmaɾ
labrego	laβɾɛɣo̝
sidra	siðɾa̝
cano	kano̝
rabiza	raβisa̝
ámboa	ambo̯a̝
buxa	buʃa̝
cabaza	kaβaθa̝
banco	baŋko̝
hortensa	ɔɾtens̺ɐ
feo	feo̝
choza	t͡ʃɔsa̝
bardo	baɾðo̝
carapucha	kaɾaput͡ʃa̝
pedir	pɨðiɾ
rabilongo	raβiloŋɡo̝
xilbarda	ʃilβaɾða̝
fociño	fuθiɲo̝
guillerme	ɡiʎɛɾme
cumial	kumjal
estorbada	estoɾβaða̝
limáchega	limat͡ʃe̝ɣa̝
taro	taɾo̝
tabardo	taβaɾðo̝
albiscar	alβiskaɾ
noval	noβal
nial	nial
lorcho	lɔɾt͡ʃo̝
liña	liɲa̝
limpar	limpaɾ
andaina	andajna̝
cenceno	senseno̝
trinque	triŋke̝
tascar	taskaɾ
pailaroco	pajlaɾoko̝
zarzallo	θaɾθaʎo̝
sementar	sementaɾ
arxemil	aɾʃemil
pintor	pintoɾ
aba	aβa̝
obradoiro	ɔβɾaðojɾo̝
burdiar	buɾðjaɾ
bulir	buliɾ
estrinque	estɾiŋke̝
tripar	tɾipaɾ
sarrio	sarjo̝
cancelo	kanθɛlo̝
espiño	espiɲo̝
estrumeira	estɾumejɾa̝
lousar	lowsaɾ
chufa	t͡ʃufa̝
sollo	soʎo̝
almucela	almuθɛla̝
maínzo	mainθo̝
toa	toa̝
amora	amɔɾa̝
forcado	foɾkaðo̝
alfaiate	alfajat̪ɪ
percebeiro	peɾseβejro̝
devesa	deβesa̝
fradar	fɾaðaɾ
aparelloa	apaɾeʎoa̝
paraíso	paɾaiso
mato	mato̝
trinta	trinta̝
papas	papa̝s
merlo	mɛɾlo̝
tenda	tɛnda̝
a	a̝
cordeiro	kɔɾðejɾo̝
bichoco	bit͡ʃɔko̝
lagareta	laɣaɾetɐ
foupa	fɔwpa̝
zurrar	θuraɾ
cego	θɛɣo̝
ricaz	rikas
mariño	maɾiɲʊ
búsula	busula̝
pichel	pit͡ʃɛl
laxe	laʃe̝
parolar	parɔlar
pezoña	pesoɲa̝
deva	deβa̝
ortiga	oɾtiɣa̝
vacina	baθina̝
bacía	baθia̝
artesa	aɾtesa̝
bubela	buβɛla̝
toxal	toʃal
vinco	biŋko̝
salto	saltʊ
fiúncho	fiunt͡ʃo̝
raño	raɲo̝
remuíño	remuiɲo̝
cancil	kanθil
caeira	kɐɛjɾɐ
zoupo	sowpo̝
formaxe	formaʃe̝
chegar	t͡ʃeɣaɾ
saber	saβeɾ
remanecer	remaneθeɾ
mantemento	mantemento̝
caivanca	kajβaŋka̝
dentagruño	dentaɣɾuɲo̝
desfeita	desfejta̝
colludo	koʎuðo̝
estinga	estiŋɡa̝
pirolazo	piɾolaθo
randufe	randufe̝
porcallada	pɔɾkaʎaða
vestir	bestiɾ
mazá	masaː
papa	papa̝
entendemento	entendemento̝
botelo	botɛlo̝
bortelar	boɾtelaɾ
escalo	eskalo̝
penico	peniko̝
apancar	apaŋkaɾ
bufarda	bufaɾða̝
endeita	endejta̝
pingo	piŋɡo̝
tesoira	tesojɾa̝
calcar	kalkaɾ
touca	towka̝
forra	fora
virilla	biɾiʎa̝
verea	beɾea̝
chorume	t͡ʃoɾume̝
furar	fuɾaɾ
cernella	θeɾneʎa̝
pega	peɣa̝
laranxeira	laɾanʃejɾa̝
cardar	kɑɾðaɾ
lamprea	lampɾea̝
cobre	kɔβɾe̝
canado	kanaðo̝
chumaceira	t͡ʃumaθejɾa̝
coteiro	kotejɾo̝
cachucha	kat͡ʃut͡ʃa̝
cercar	θeɾkaɾ
mosquete	moskete̝
cánabo	kana̝βo̝
pasamento	pasamɛnto̝
sollío	sɔʎio̝
abrazar	aβɾaθaɾ
bola	bola̝
batoco	batoko̝
papuxa	papuʃa̝
centeo	senteo̝
chisco	t͡ʃisko̝
galicia	ɡaliθjɐ
requecer	rekɛθeɾ
bulicio	buliθjo̝
esqueiro	eskejɾo̝
chifre	t͡ʃifɾe̝
chuchar	t͡ʃut͡ʃaɾ
tolo	tolo̝
pólvora	pɔlβo̝ɾa̝
espirrar	espiraɾ
anga	aŋɡa̝
gabar	ɡaβaɾ
legume	leɣume̝
curar	kuɾaɾ
touriñán	towɾiɲaŋ
canela	kanɛla̝
rubio	ruβjo̝
baleeiro	baliejɾo̝
cafúa	kafua̝
chumazo	t͡ʃumaθo̝
noxento	noʃento̝
eido	ejðo̝
esqueira	eskɛjɾa̝
baamonde	baːmonde̝
rengo	rɛŋɡo̝
torrente	torente̝
acá	aka
ulloa	uʎoa̝
xantar	ʃantaɾ
gume	ɡume̝
amádego	amaðe̝ɣo̝
lenlla	lenʎa̝
codia	koðia̝
bousán	bɔwsaŋ
garganta	ɡaɾɣanta̝
choiar	t͡ʃɔjaɾ
coroza	koɾɔθa̝
ribadavia	riβaðaβja̝
zoco	θoko̝
albedro	alβeðɾo̝
zamburiña	sambuɾiɲa̝
zarro	θaro̝
sésamo	sesa̝mo̝
estirar	estiɾaɾ
cozo	koθo̝
cornacho	kɔɾnat͡ʃo̝
forcada	fɔɾkaða̝
tremer	tɾemeɾ
chantar	t͡ʃantaɾ
bocoi	bokoj
abanar	aβanaɾ
espiñaca	espiɲaka̝
maio	majo̝
vasalo	basalo̝
burgo	buɾɣo̝
saída	saiða̝
lamazal	lamaθal
mariña	maɾiɲa̝
vilancico	bilanθiko
parro	paro̝
picota	pikɔta̝
esquecer	eskɛθeɾ
lomba	lomba̝
rebento	rebento
carcás	kaɾkas
esmiuzar	esmiuθaɾ
medorra	meðora̝
choca	t͡ʃoka̝
raíz	raiθ
manxadoira	manʃaðojɾa̝
mendrello	mendɾeʎo̝
gardar	ɡaɾðaɾ
casta	kasta̝
teaz	teaθ
furco	fuɾko̝
chumazo	t͡ʃumaso̝
oleiro	olejɾo̝
lumieira	lumiejɾa̝
troulear	tɾowleaɾ
naseiro	nasejɾo̝
gondulfe	ɡondulfe̝
agoireiro	aɣojɾejɾo̝
engalar	eŋɡalaɾ
tomentelo	tomentɛlo̝
cenzo	θenθo̝
taleiga	talejɣa̝
canda	kanda̝
lameiro	lamejɾo̝
couzoeira	kowθoejɾa̝
vedizo	bɛːðiθo̝
pena	pena̝
rangua	raŋɡwa̝
diaño	diaɲo̝
curota	kuɾɔta̝
roca	rɔka̝
castrove	kastɾɔβe̝
escandear	eskandeaɾ
piñeiro	piɲejɾo̝
empurrón	empuroŋ
capeirote	kapejɾɔte̝̝
pelamio	pelamio̝
arrincar	ariŋkaɾ
vieites	biejte̝s
patarroxa	pataroʃa̝
escarabana	eskaɾaβana̝
cadrar	kaðɾaɾ
burla	buɾla̝
nandulfe	nandulfe̝
chamoso	t͡ʃamoso̝
trotar	tɾɔtaɾ
envorco	embɔɾko̝
bieiteira	biejtejɾa̝
revirar	reβiɾaɾ
vichelocrego	bit͡ʃelokɾɛɣo̝
coieira	kɔjejɾa̝
miguélez	miɣɛle̝θ
tufo	tufo̝
creba	kɾɛβa̝
racha	rat͡ʃa̝
cichar	sit͡ʃaɾ
tambre	tambɾe̝
larcha	lart͡ʃa̝
folía	fɔlia̝
barallar	baɾaʎaɾ
lambecricas	lambekɾika̝s
espeto	espeto̝
atopar	atopaɾ
valigoto	baliɣoto̝
ourizo	owɾiθo̝
loitador	lojtaðoɾ
sinxelo	sinʃɛlo̝
forxa	fɔɾʃa̝
galiña	ɡaliɲa̝
rever	reβeɾ
arnela	aɾnɛla̝
lago	laɣo
quella	kɛʎa̝
espionaxe	espionaʃe̝
arquivo	aɾkiβo̝
verquer	beɾkeɾ
cabezada	kaβeθaða̝
mondariz	mondaɾiθ
colorado	koloɾaðo̝
canzobre	kanθɔbɾe̝
froallo	fɾoaʎo̝
botar	botar
fitar	fitaɾ
carrizo	kariso̝
coar	koaɾ
garabato	ɡaɾaβato̝
soldadura	soldaðuɾa̝
marchar	maɾt͡ʃaɾ
zapón	sapoŋ
froia	fɾɔja̝
lumbrigante	lumbɾiɣante̝
trives	tɾiβe̝s
testar	tɛstaɾ
dos	d̪ʊs̺
adala	aðala̝
grixó	ɡɾiʃɔ
manter	manteɾ
agulletar	aɣuʎetaɾ
coraxe	koɾaʃe̝
cenlla	θenʎa̝
beleigán	belejɣaŋ
aturuxo	atuɾuʃo̝
rebordelos	reβoɾðɛlo̝s
somoza	somoθa̝
valgada	balɣaða̝
pairar	pajɾaɾ
samesuga	samesuɣa̝
toleiro	tolejɾo̝
baldón	baldoŋ
toller	toʎeɾ
arangaños	aɾaŋɡaɲo̝s
biosbardo	biosβaɾðo̝
mazaroca	masaɾɔka̝
puga	puɣa̝
soltar	soltaɾ
camposa	kamposa̝
saín	saiŋ
vaira	bajɾa̝
tempas	t̪ɛmpɐs̻
pousafoles	powsafɔles
palleta	paʎeta̝
serodio	seɾoðjo̝
melide	meliðe̝
heree	eɾɛ
paderne	paðɛɾne̝
escudeiro	eskuðejɾo̝
tona	tona̝
rolo	rolo̝
pontenova	pɔntenɔβa̝
rego	reɣo̝
graba	ɡɾaβa̝
santafollo	santafoʎo̝
louzao	lowθao̯
asmo	aɾmo̝
romaría	romaɾia̝
cacharela	kat͡ʃaɾɛla̝
inferno	iɱfɛɾno̝
baiona	bajona̝
laído	laiðo̝
bode	bɔðe̝
torga	tɔɾɣa̝
chuvasco	t͡ʃuβasko̝
beladona	bɛladona̝
roseira	rosejɾa̝
louro	lowɾo̝
ourive	owɾiβe̝
guitiriz	ɡitiɾiθ
cicha	θit͡ʃa̝
raxo	raʃo̝
aleixar	alejʃaɾ
retorto	retɔɾto̝
perixel	peɾiʃɛl
trono	tɾɔno̝
boia	bɔja̝
gulfar	ɡulfaɾ
illargada	iʎaɾɣaða̝
rial	rial
farelo	faɾɛlo̝
furado	fuɾaðo̝
barro	baro̝
seitura	sejtuɾa̝
brenza	bɾenθa̝̝
magoar	maɣoaɾ
neal	nial
escaleira	eskalejɾa̝
malataría	malataɾia̝
rapaza	rapaθa
uzal	uθal
galra	ɡalra̝
ceibo	sejβo̝
amiguiño	amiɣiɲo̝
franzomil	fɾanθomil
porcallán	pɔɾkaʎaŋ
relustrar	relistɾaɾ
árbore	aɾβo̝ɾe̝
pemento	pemɛnto̝
guillurfe	ɡiʎuɾfe̝
abano	aβano̝
tombo	tombo̝
noitiña	nojtiɲa̝
arrequeixar	arekejʃaɾ
mirrar	miraɾ
proído	pɾoiðo̝
ons	ɔŋs
adobar	aðoβaɾ
esgarrar	esɣaraɾ
empedrar	empeðɾaɾ
cadril	kaðɾil
adobo	aðoβo̝
lacón	lakoŋ
escoupro	eskowpɾo̝
morca	mɔɾka̝
boga	bɔɣa̝
molar	molaɾ
polpa	polpa̝
murador	muɾaðoɾ
pasal	pasaʊ̯
murar	muɾar
banzo	banθo̝
armaría	armaɾia̝
regatear	reɣateaɾ
gabanza	ɡaβanθa̝
premer	pɾemeɾ
ruada	ruaða̝
buxeo	buʃeo̝
bordo	bɔɾðo̝
piche	pit͡ʃe̝
fiuncho	fjunt͡ʃo̝
lesma	lesma̝
saco	sako̝
esmilfar	esmilfaɾ
ledicia	leðiθja̝
touzo	towso̝
orasme	ɔɾaz̺me̝
esbedro	esβeðɾo̝
adormentar	aðoɾmentaɾ
liñaza	liɲasa̝
franco	fraŋko̝
coima	kojma
pontella	ponteʎa̝
tourón	towɾoŋ
percebe	peɾθeβe̝
alustro	alustɾo̝
sucho	sut͡ʃo̝
ferrón	feroŋ
chancho	t͡ʃant͡ʃo̝
barreiro	barejɾo̝
costela	kostɛla̝
lella	leʎa̝
meixengra	mejʃeŋɡɾa̝
bringuelo	bɾiŋɡɛlo̝
taberneiro	taβeɾnejɾo̝
treu	tɾɛw
tolosano	tolosano
zarra	θara̝
ames	ame̝s
espeteira	espitejɾa̝
reboira	reβojɾa̝
enxerir	inʃeɾiɾ
rancor	raŋkoɾ
cumio	kumio̝
zoupón	sowpoŋ
acea	aθea̝
carracho	karat͡ʃo̝
londra	londɾa̝
fanar	fanaɾ
parola	paɾɔla̝
argueiro	aɾɣejɾo̝
afi	afi
baluga	baluɣa̝
comezo	komɛθo̝
queixume	kejʃume̝
asaño	asaɲo̝
roxar	roʃaɾ
carreiro	karejɾo̝
guiado	ɡiaðo̝
gorgozada	ɡoɾɣoθaða̝
eslañar	eslaɲaɾ
parabéns	paɾaβɛŋs
fungueiro	fuŋɡejɾo̝
viña	biɲa̝
areixa	aɾɛjʃa̝
quecer	kɛseɾ
tenza	tensa̝̝
cadarnoxo	kaðaɾnoʃo̝
reborido	reβoɾiðo̝
rodeira	rɔðejɾa̝
tósego	tos̺eħo̝
noitebra	nojteβɾa̝
nubrar	nuβɾaɾ
beberricar	beβerikaɾ
marear	maɾeaɾ
monllo	monʎo̝
trebello	tɾeβeʎo̝
teixón	tejʃoŋ
coller	koʎeɾ
estampinar	estampinaɾ
soán	soaŋ
pinto	pinto̝
fornecer	fɔɾnɛθeɾ
balouco	balowko̝
groto	ɡɾoto̝
esquina	eskina̝
entroido	antɾojðo̝
moza	mosa̝
alumear	alumeaɾ
albar	alβaɾ
tambor	tamboɾ
carcán	kaɾkaŋ
nadal	naðal
balorento	baloɾento̝
carrabouxo	karaβowʃo̝
billa	biʎa̝
tacón	takoŋ
binguelete	biŋɡelete̝
cheiro	t͡ʃejɾo̝
lobato	loβato̝
tira	tiɾa̝
perfia	pɛɾfja̝
piolla	pioʎa̝
bisbarra	bisbara̝
ateán	ateaŋ
louzán	lowθao̯
decotío	dekotio̝
buxana	buʃana̝
xardón	ʃaɾðoŋ
espaller	espaʎɛɾ
pebidal	peβiðal
burgueiro	buɾɣejɾo̝
boubín	bowβiŋ
queixar	kejʃaɾ
lufiada	lufjaða̝
escotar	eskɔtaɾ
mexillón	meʃiʎoŋ
masa	masa̝
enfeitizar	eɱfejtiθaɾ
badal	baðal
migalla	miɣaʎa̝
candeeiro	kandeejɾo̝̝
peneira	penejɾa̝
couzón	kowθoŋ
azougue	asowɣe̝
comechón	komet͡ʃoŋ
fidalgo	fiðalɣo̝
notar	notaɾ
lostregar	lustɾiɣaɾ
rodríguez	roðɾiɣe̝θ
ceila	θejla̝
toelo	toelo̝
buzaco	buθako̝
fazula	faθula̝
trabada	tɾaβaða
montouto	montowto̝
estrada	estɾaða̝
besteiro	bɛsteiɾo̝
vizoso	bisoso̝
traxe	tɾaʃe̝
gabido	ɡaβiðo̝
estorniño	estoɾniɲo̝
moxena	moʃena̝
entroido	entɾojðo̝
castaña	kastaɲa̝
sobradar	soβɾaðaɾ
desferrar	desferaɾ
chourizo	t͡ʃowɾiθo̝
virxinidade	biɾʃiniðaðe̝
cebrisca	θeβɾiska̝
espiña	espiɲa̝
folerpa	folɛɾpa̝
nervio	neɾβjo̝
baltar	baltaɾ
ensanguentar	ensaŋɡentaɾ
brandariz	bɾandaɾis
bafo	bafo̝
choupelo	t͡ʃowpɛlo̝
xuramento	ʃuɾamentʊ
falcón	falkoŋ
folello	foleʎo̝
carozo	kaɾoθo̝
amañar	amaɲaɾ
pitoño	pitoɲo̝
tenza	tenθa̝̝
abadengo	aβaðeŋɡo̝
viéitez	biejte̝θ
comprar	kompɾaɾ
fronza	fɾonʃa̝
groucho	ɡɾowt͡ʃo̝
ti	ti
esfarelar	esfaɾelaɾ
tampa	tampa̝
ventar	bentaɾ
xoves	ʃɔβe̝s
choco	t͡ʃoko̝
ferreiro	ferejɾo̝
achar	at͡ʃaɾ
retriza	retɾisa̝
ouriolo	owɾiɔlo̝
freire	fɾejɾe̝
pértega	peɾte̝ɣa̝
albaroque	alβaɾɔke̝
colmo	kolmo̝
ancoradoiro	aŋkoɾaðojɾo̝
ceifa	θɛjfɐ
almadraque	almaðɾake̝
mensaxeiro	mensaʃejɾo̝
varenga	baɾɛŋɡa̝
esfargallar	esfaɾɣaʎaɾ
ollo	ɔʝʊ
hoste	ɔste̝
pescozada	peskoθaða̝
mulime	mulime̝
biscar	biskaɾ
vendimar	bendimaɾ
terra	tɛra̝
cailón	kajloŋ
raña	raɲa̝
cidreira	siðɾejɾa̝
cabestro	kaβestɾo̝
pomba	pɔmba̝
acañar	akaɲaɾ
orizó	oɾiθɔ
miñato	miɲato̝
bugallo	buɣaʎo̝
chorida	t͡ʃoɾiða̝
cárcava	kaɾka̝βa̝
gándara	ɡanda̝ɾa̝
manteiga	mantejɣa̝
non	nʊŋ
nugalla	nuɣaʎa̝
mazo	maso̝
peón	peoŋ
orizó	oɾisɔ
hábito	aβito̝
tea	tea̝
adra	aðɾa̝
boi	bɔj
barato	baɾato̝
braña	bɾaɲa̝
mazar	masaɾ
mancha	mant͡ʃa̝
arado	aɾaðo̝
constipado	konstipaðo
piago	piaɣo̝
espelir	espeliɾ
canella	kaneʎa̝
refugo	refuɣo̝
gorgozo	ɡoɾɣoso̝
home	ɔmɪ
palloza	paʎɔθa̝
borra	bora̝
coruñés	koɾuɲes
aquel	akel
pitar	pitaɾ
mexo	meʃo̝
tirizó	tiɾiθɔ
serra	sɛra̝
sorbeira	soɾβejɾa̝
chouto	t͡ʃowto̝
eito	ɛjto̝
patela	patɛla̝
humillar	umiʎaɾ
laño	laɲo̝
parlar	parlar
empanada	empanaða̝
sendeiro	sendejɾo̝
rodo	roðo̝
caramuxo	kaɾamuʃo̝
fananco	fanaŋko̝
vea	bea̝
portela	poɾtɛla̝
pescoso	peskoso̝
varcia	baɾθja̝
testo	tɛsto̝
ranquear	raŋkeaɾ
bolo	bɔlo̝
un	uŋ
toimil	tɔjmil
poio	pojo̝
acender	aθendeɾ
solpor	solpoɾ
trabar	tɾaβaɾ
xeonlleira	ʃeonʎejɾa̝
ningunha	niŋɡuŋa̝
godallo	ɡoðaʎo̝
ferraxe	feraʃe̝
mesado	mesaðo̝
moimendro	mojmendɾo̝
sangue	saŋɡe̝
garavanzo	ħraβanso̝
tempestade	tempɛstaðe̝
escorregar	eskoreɣaɾ
gromo	ɡɾomo̝
caamouco	kamowko̝
vez	bes
callo	kaʎo̝
algaria	alɣaɾja̝
abalar	aβalaɾ
lazo	laθo̝
pior	pɨɔɾ
escarís	eskaɾis
bouza	bowsa̝
gorgomil	ɡoɾɣomil
engo	ɛŋɡo̝
fisga	fisɣa̝
estruga	estɾuɣa̝
rozavales	roθaβale̝s
adormiñar	aðoɾmiɲaɾ
trompa	tɾompa
derrego	dereɣo̝
testeiro	tɛstejɾo̝
zopo	θopo̝
curuto	kuɾuto̝
imitar	imitaɾ
seita	sejta̝
pontón	pontoŋ
entrousar	entɾowsaɾ
fillar	fiʎaɾ
cervúa	θɛɾβua̝
algunha	alɣuŋa̝
cuito	kujto̝
estripeiro	estɾipejɾo̝
lapo	lapo̝
birlo	biɾlo̝
causela	kowsela̝
felga	fɛlɣa̝
bucina	buθina̝
maga	maɣa̝
toxo	toʃo̝
charco	t͡ʃaɾko̝
pontevedra	ponteβɛðɾa̝
sabariz	saβaɾiθ
acio	aθio̝
mosqueira	mɔskejɾa̝
beizo	bejso̝
ganso	ɡanso̝
cichón	θit͡ʃoŋ
trapallo	tɾapaʎo̝
esnaquizar	esnakiθaɾ
marxa	maɾʃa̝
lideira	liðejɾa̝
pesco	pesko̝
calvario	kalβaɾjo̝
costume	kostume̝
rouceo	rowθɛʊ
sopa	sopa̝
guldriz	ɡuldɾiθ
a	a
é	ɛ
peido	pejðo̝
carpear	kaɾpeaɾ
escolla	eskoʎa̝
aloumiño	alowmiɲo̝
señor	seɲoɾ
engra	ɛŋɡɾa̝
elefante	ɛlefante̝
fender	fendeɾ
pino	pino̝
falcatruada	falkatɾuaða̝
xunto	ʃunto̝
en	eŋ
abeneiro	aβenejɾo̝
leña	leɲa̝
bolo	bolo̝
estaca	estaka̝
maravalla	maɾaβaʎa̝
peniz	penis
eis	ejs
valdeorras	baldeora̝s
feitío	fejtio̝
sanxenxo	sanʃɛnʃo̝
aceno	aθeno̝
agruño	aɣɾuɲo̝
maza	maθa̝
saudades	sawðaðes
vime	bime̝
xunta	ʃunta̝
tixela	tiʃɛlɐ
gaspeto	ɡaθpeto̝
arrochar	arot͡ʃaɾ
burela	buɾɛlɐ
carne	kaɾne̝
alporizar	alpoɾiθaɾ
felmil	felmil
abetar	aβetaɾ
chasco	t͡ʃasko̝
lamacento	lamaθɛnto̝
bacelo	baθelo̝
mazo	maθo̝
lousa	lowsa̝
rabiza	raβiθa̝
orelleira	oɾeʎejɾa̝
levar	leβaɾ
onte	ɔnte̝
torneira	toɾnejɾa̝
porqueira	pɔɾkeiɾa̝
saudade	sawðaðɪ
chocallo	t͡ʃokaʎo̝
tose	tɔsɪ
cru	kɾu
cao	kao̯
rato	rato̝
leitón	lejtoŋ
adubo	aðuβo̝
aldara	aldaɾa̝
porfía	poɾfia̝
trapo	tɾapo̝
rexelo	reʃɛlo̝
trasvirar	tɾasbiɾaɾ
ralbar	ralβaɾ
lembranza	lembɾanθa̝
morriña	moriɲa
estronca	estɾoŋka̝
tinto	tinto̝
pau	paʊ̯
peaxe	peaʃe̝
serrón	seroŋ
virar	biɾaɾ
leituga	lejtuɣa̝
ferrollo	feroʎo̝
adro	aðɾo̝
daquela	dakɛla
fartura	faɾtuɾa̝
brexo	bɾɛʃo̝
mourén	mowɾɛŋ
aceso	aseso̝
aldraxe	alðɾaʃe̝
tanguer	taŋɡeɾ
vizo	biθo̝
sísamo	sisa̝mo̝
robalo	roβalo̝
congro	koŋɡɾo̝̝
estrinxir	estɾinʃiɾ
meter	meteɾ
devalar	deβalaɾ
celeiro	selejɾo̝
bulleiro	buʎɛjɾo̝
preguiza	pɾeɣiθa̝
bouta	bowta̝
enxerdar	enʃeɾðaɾ
cereixa	θeɾejʃa̝
costrán	kostɾaŋ
azul	asul
escoura	eskowɾa̝
odre	oðɾe̝
gabia	ɡaβia̝
doela	doɛla̝
xeonllo	ʃeonʎo̝
estatua	estatwa̝
lello	leʎo̝
maruxa	maɾuʃa̝
desexar	deseʃaɾ
ronsel	ronsɛl
ansimonde	ansimonde̝
galafre	ɡalafɾe̝
gastar	ɡastaɾ
cinlla	sinʎa̝
vexar	beʃaɾ
rodaballo	roðaβaʎo̝
salgadeira	salɣaðejɾa̝
rifa	rifa̝
vilasantar	bilasantaɾ
nogueira	noɣejɾa̝
maleta	maleta̝
orneallo	oɾneaʎo̝
gulfián	ɡulfjaŋ
fiestra	fiɛstɾa̝
nora	nɔɾa̝
lecer	leθeɾ
allariz	aʎaɾiθ
cedo	θeðo̝
ceba	θeβa̝
reboredo	reβoɾeðo̝
curro	kuro̝
costro	kostɾo̝
apodrecer	apoðɾeseɾ
agua	aɡwa
chozo	t͡ʃɔθo̝
muar	muaɾ
ansemonde	ansemonde̝
cálice	kaliθe
ardentía	aɾðentia̝
bulleiro	buʎejɾo̝
ozca	ɔzka̝
comechón	komit͡ʃoŋ
forno	foɾno̝
gundián	ɡundiaŋ
esmorir	esmoɾiɾ
asollar	asoʎaɾ
abanqueiro	aβaŋkejɾo̝
carballeira	kaɾβaʎejɾa̝
carranca	karaŋka̝
reviravolta	reβiɾaβɔlta̝
mollo	moʎo̝
mercadoría	meɾkaðoɾia̝
caes	kajs
bullar	βuʎaɾ
ningures	niŋɡuɾe̝s
turuleque	turulɛke̝
anciño	anθiɲo̝
aciñeira	aθiɲejɾa̝
amaravallar	amaɾaβaʎaɾ
páez	paeθ
gabeta	ɡaβeta̝
cascar	kaskaɾ
trillar	tɾiʎaɾ
cotra	kotɾa̝
mar	maɾ
cedofeita	θeðofejta̝
xenebra	ʃenɛβɾɐ
casqueiro	kaskejɾo̝
vougo	bowɣo̝
perrencha	peɾent͡ʃa̝
acedo	aseðo̝
cerco	θeɾko̝
mioca	miɔka̝
bendia	bendja̝
asemade	asemaðe̝
cagalla	kaɣaʎa̝
coroar	koɾoaɾ
irmá	iɾmaŋ
brúo	bɾuo̝
vasca	baska̝
ouriceira	owɾisejɾa̝
zapón	θapoŋ
feito	fɛjto̝
silva	silβa̝
acender	asendeɾ
forrar	foraɾ
barbuda	baɾβuðo̝
herdade	ɛɾðaðe̝
francante	fɾaŋkante̝
tromentelo	tɾomentɛlo̝
o	o̝
laverca	laβɛɾka̝
teiroa	tejɾɔa̝
porro	pɔro
marxe	maɾʃe̝
morro	moro̝
cocido	kosiðo̝
tormenta	toɾmenta̝
barullo	baɾuʎo̝
aramio	aɾamjo̝
vermello	beɾmeʎo̝
méixamo	mejʃa̝mo̝
carambelo	kaɾambelo̝
rebentar	rebentaɾ
lontra	lontɾɐ
poldra	poldɾa̝
anxeriz	anʃeɾiθ
luns	luŋs
bazuncho	baθunt͡ʃo̝
trigar	tɾiɣaɾ
virxinidade	biɾʃiniða
deitar	dejtaɾ
estraño	estɾaɲo̝
estrado	estɾaðo̝
tilla	tiʎa̝
chama	t͡ʃama̝
zamborca	θambɔɾka̝
mazarico	maθaɾiko̝
zoca	θɔka̝
beizo	bejθo̝
empachar	empat͡ʃaɾ
cepo	sepo̝
coto	koto̝
beizón	bejθoŋ
trabalinguas	tɾaβaliŋɡwa̝s
aplicar	aplikaɾ
azor	aθoɾ
canga	kaŋka̝
rancio	ransjo̝
donfreán	doɱfɾeaŋ
uceira	usejɾa̝
cabeza	kaβeθa̝
merenda	meɾenda̝
rella	reʎa̝
pailán	pajlaŋ
porcalleiro	pɔɾkaʎejɾo̝
teixelo	tejʃelo̝
abastecer	aβasteseɾ
arró	arɔ
bagazo	baɣaθo̝
ergaleirón	eɾɣalejɾoŋ
xacer	ʃaθeɾ
gamela	ɡamɛla̝
tellado	teʎaðo̝
pelica	pelika̝
xurdir	ʃuɾðiɾ
rapar	rapaɾ
famento	famento̝
pais	pajs
zuncho	sunt͡ʃo̝
alcacén	alkaθɛŋ
empola	empola̝
abelleira	aβeʎejɾa̝
torque	tɔɾke̝
frito	fɾito̝
fungar	fuŋɡaɾ
osmo	ɔsmo̝
esquipar	eskipaɾ
macio	maθjo̝
bardanca	baɾðaŋka̝
piteiro	pitejɾo̝
canteira	kantejɾa̝
vencello	benθeʎo̝
espir	espiɾ
findar	findaɾ
empregar	empɾeɣaɾ
habenza	aβɛnθa̝
debagar	deβaɣaɾ
escachar	eskat͡ʃaɾ
bordear	boɾðeaɾ
beirado	bejɾaðo̝
pago	paɣo̝
escá	eska
bravo	bɾaβo̝
queixo	kejʃʊ
gontar	ɡontaɾ
croio	kɾɔjo̝
costoia	kostɔja̝
aloumiñar	alowmiɲaɾ
baña	baɲa̝
mozo	moso̝
liñar	liɲaɾ
afagar	afaɣaɾ
termar	teɾmaɾ
crebar	kɾeβaɾ
linguaxe	liŋɡwaʃe̝
mazar	maθaɾ
regazo	reɣaso̝
rexeitar	reʃejtaɾ
sangomiño	saŋɡomiɲo̝
bandullo	banduʎo̝
elo	ɛlo̝
lapacaldos	lapakaldo̝s
coella	koeʎa̝
chao	t͡ʃaw
debullar	deβuʎaɾ
estío	estio̝
serea	seɾea̝
antepeito	antepejto̝
requiás	rekias
cascuda	kaskuða̝
lamela	lamɛla̝
barda	baɾða̝
abrótega	aβɾɔte̝ɣa̝
menta	menta̝
esmorgueiro	esmɔɾɣejɾo
tola	tɔla
foraño	foɾaɲo̝
angarela	aŋɡaɾela̝
salaiar	salajaɾ
burbulla	buɾβuʎa̝
trobe	tɾɔβe̝
escoitar	eskojtaɾ
chau	t͡ʃaw
atafal	atafal
dentexil	denteʃil
mañá	maɲa
seta	sɛta̝
outono	owtono̝
cárcere	kaɾse̝ɾe̝
estrobo	estɾoβo̝
ornear	oɾneaɾ
cunca	kuŋka̝
grei	ɡrej
farila	faɾila̝
caldeireiro	kaldejɾejɾo̝
relón	reloŋ
xiringar	ʃiɾiŋɡaɾ
lentella	lenteʎa̝
chapacuña	t͡ʃapakuɲa̝
colmazo	kolmaθo̝
carolo	kaɾɔlo̝
alcobre	alkɔβɾe̝
caixa	kajʃa̝
outrora	owtɾɔɾa
culler	kuʎɛɾ
sabuxo	saβuʃo̝
choco	t͡ʃɔko̝
uceira	uθejɾa̝
mota	mɔta̝
garabito	ɡaɾaβuʎo̝
pita	pita̝
sarna	saɾna̝
lera	lɛɾa̝
bicha	bit͡ʃa̝
lorda	lɔɾða̝
wifi	wifi
cacho	kat͡ʃo̝
cinguir	θiŋɡiɾ
abancar	aβaŋkaɾ
moega	moɛɣa̝
cozar	koθaɾ
ameixa	amejʃa̝
lunada	lunað̞a̝
xarxa	ʃaɾʃa
cobizar	koβisaɾ
legua	lɛɣwa̝
bedugo	beðuħo̝
trapa	tɾapa̝
carambo	kaɾamβo̝
cañoto	kaɲoto̝
foliada	fɔljaða̝
catar	kataɾ
abadía	abadia
arneste	aɾneste̝
lanzoa	lanθoa̝
alalá	alala
moa	mɔa̝
fondo	fondo̝
garabizo	ɡaɾaβiso̝
partir	paɾtiɾ
galladura	ɡaʎaðuɾa̝
risco	risko̝
destallar	destaʎaɾ
varga	baɾɣa̝
escarvadentes	eskaɾβaðente̝s
voutureira	bowtuɾejɾa̝
anseán	anseaŋ
mexarela	meʃaɾɛla̝
chantada	t͡ʃantaða̝
sabarís	saβaɾis
costura	kostuɾa̝
ferver	feɾβeɾ
figueira	fiɣejɾa̝
pardo	paɾðo̝
cabido	kaβiðo̝
reste	rɛste̝
gadaña	ɡaðaɲa̝
peteiro	petejɾo̝
sucho	θut͡ʃo̝
brañento	bɾaɲɛnto̝
arxón	aɾʃoŋ
robaliza	roβaliθa̝
horta	ɔɾta̝
chanzo	t͡ʃanθo̝
vezo	beθo̝
ontre	ontɾe̝
arrocho	arot͡ʃo̝
remorso	remɔɾso̝
canterla	kantɛɾla̝
cernada	θeɾnaða̝s
malladura	maʎaðuɾa̝
amecer	ameθeɾ
nortello	noɾteʎo̝
nordés	nɔɾðɛs
folión	folioŋ
brindar	bɾindaɾ
murcego	muɾθɛɣo̝
couceiro	kowθejɾo̝
astroso	astɾoso̝
xebrar	ʃeβɾaɾ
rebumbio	reβumbjo̝
coitado	kojtaðo̝
bafexar	bafeʃaɾ
micáceo	mikaθe̯o̝
cortiza	koɾtisa̝
fumeiro	fumejɾo̝
mornal	moɾnal
escacho	eskat͡ʃo̝
trangallo	tɾaŋɡaʎo̝
uz	uθ
eivar	ejβaɾ
ben	bɛŋ
erguer	eɾɡeɾ
esvarar	esβaɾaɾ
corazón	koɾaθoŋ
amorogo	amoɾoɡo̝
pancada	paŋkaða̝
galeón	ɡaleoŋ
depenicar	depinikaɾ
escoitar	eskujtaɾ
rosamonde	rosamonde̝
burga	buɾɣa̝
mariz	maːɾiθ
arregazar	reɣaθaɾ
falar	falaɾ
bacía	basia̝
pegar	peɣaɾ
dala	dala̝
esposo	esposo̝
fresca	fɾeska̝
tregua	tɾɛɣwa̝
ferrador	feraðoɾ
ombre	ɔmbɾe̝
estrema	estɾema̝
tinguir	tiŋɡiɾ
cisma	θisma̝
boto	boto̝
furrular	furulaɾ
monte	montɪ
repugnante	repunante̝
estaño	estaɲo̝
laxa	laʃa̝
gañar	ɡaɲaɾ
cabrón	kaβɾoŋ
torrada	toraða̝
nata	nata̝
escribán	eskɾiβaŋ
meniño	meniɲo̝
cuarto	kwaɾto̝
veriño	bɾiɲo̝
cuspir	kuspiɾ
esmorga	esmɔɾɣa̝
podón	poðoŋ
madeixa	maðejʃa̝
altar	altaɾ
cruzado	kɾuθaðo̝
regateiro	reɣateiɾo̝
gallar	ħaʎaɾ
furaño	fuɾaɲo̝
zoupón	θowpoŋ
muller	muɟɛɾ
arrimar	arimaɾ
arzón	aɾsoŋ
brosque	bɾɔske
esfarrapar	esfarapaɾ
silla	siʎa̝
foder	foðeɾ
matanza	matansa̝
couce	kowθe
mecha	met͡ʃa̝
forte	fɔɾte̝
regoldo	reɣɔldo̝
lúa	luɐ
cális	kalis
siso	siso̝
estremar	estɾemaɾ
beligo	bɪliɣo̝
cardo	kaɾðo̝
fros	fɾɔs
teitar	tejtaɾ
acotío	akotio̝
papo	papo̝
rocín	roθiŋ
asexar	aseʃaɾ
reloxo	relɔʃo̝
outeiro	owtejɾo
pisca	piska̝
cheirar	t͡ʃejɾaɾ
xeno	ʃeno̝
pousar	powsaɾ
gacear	ɡaθeaɾ
triacastela	tɾiakastɛla̝
raiola	rajɔla̝
landra	landɾa̝
moimenta	mojmenta̝
moca	mɔka̝
gobernallo	ɡoβeɾnaʎo̝
azor	asoɾ
muxir	muʃiɾ
cuartillo	kwaɾtiʎo̝
langosta	laŋɡosta̝
destripar	destɾipaɾ
marrón	maroŋ
espelido	espeliðo̝
serodio	seɾoðio̝
nío	nio
amolecer	amoleseɾ
cadela	kaðɛla̝
caseiro	kasejɾo̝
braceiro	bɾaθejɾo̝
armiño	aɾmiɲo̝
zorza	θɔɾθa̝
hermida	eɾmiða̝
gorgolexo	ɡoɾɣoleʃo̝
corra	kora̝
anguria	aŋɡuɾja̝
dioivo	diojβo̝
escariz	eskaɾiθ
pecheira	pet͡ʃejɾa̝
cenrada	senraða̝
hortelán	ɔɾtelaŋ
gando	ɡando̝
comezo	komeso̝
desbotar	desβotaɾ
feltro	fɛltɾo̝
nobelo	nuβelo̝
prixel	pɾiʃɛl
serrapio	serapjo̝
támboga	tambo̝ɣa̝
enfesto	eɱfɛsto̝
dúbida	duβiða̝
carretar	karetaɾ
perpiaño	peɾpiaɲo̝
xudeu	ʃuðew
arrocheiro	arot͡ʃo̝
corvo	kɔɾβo̝
pai	paj
lercho	lɛɾt͡ʃo̝
dorna	dɔɾna̝
fartar	faɾtaɾ
ceibar	θejβaɾ
malato	malato̝
sanguiño	saŋɡiɲo̝
piollo	pioʎo̝
atol	atɔl
nove	nɔβe̝
vilouchada	bilowt͡ʃaða̝
xiabre	ʃiaβɾe̝
abelleiro	aβeʎejɾo̝
larada	laɾaða̝
falabarato	falaβaɾato̝
compostela	kompostɛla
raiar	rajaɾ
tremo	tɾemo̝
cravo	kɾaβo̝
colmar	kolmaɾ
pillabán	piʎaβaŋ
legón	leɣoŋ
banastra	banastɾa̝
allear	aʎeaɾ
espenuca	espenuka̝
lula	lula̝
cai	kaj
padal	paðal
parte	paɾte̝
espiñazo	espiɲaso̝
fura	fuɾa̝
guizo	ɡiso̝
enfondura	ɪŋfonduɾa̝
sabenla	saβɛŋla̝̝
barbudo	baɾβuðo̝
sartego	saɾtɛɣo̝
carioca	kaɾjɔka̝
britar	bɾitaɾ
bacieiro	basiejɾo̝
rima	rima̝
adega	aðɛɣa
nariz	naɾiθ
cosco	kosko̝
arrombar	arumβaɾ
doiro	dojɾo̝
catadura	kataðuɾa̝
revolta	reβɔlta̝
broca	bɾɔka̝
freita	fɾejta̝
mesturar	mestuɾaɾ
fame	fame̝
boirao	bɔjɾao̝
onde	onde̝
berrar	beraɾ
meu	mɛw
doar	doaɾ
celigras	θeliɣɾa̝s
rebordán	reβoɾðaŋ
botelo	bʊtɛlo̝
lambetada	lambetaða̝
escaldar	eskalðaɾ
ricaz	rikaθ
vincallo	biŋkaʎo̝
becerra	besera̝
veo	beo̝
peideiro	pejðejɾo̝
quenlle	kɛnʎe̝
cotarelo	kotaɾɛlo̝
penuxe	penuʃe̝
esnafrar	esnafɾaɾ
policromía	pɔlikɾomia̝
esteo	esteo̝
inzo	inθo̝
caloroso	kaloɾoso̝
edén	ɛðɛŋ
vaíña	baiɲa̝
zoco	θɔko̝
estrume	estɾume̝
fogo	fɔɣo
abastecer	aβasteθeɾ
preguizoso	pɾeɣiθoso̝
barallobre	baɾaʎɔβɾe̝
cisterna	θistɛɾna̝
ansamonde	ansamonde̝
tortilla	toɾtiʎa
medrar	meðɾaɾ
lastra	lastɾa̝
ergueito	eɾɣejto̝
desfeito	desfejto̝
pito	pito̝
debuxo	deβuʃo̝
engoumado	eŋɡowmaðo̝
nimigalla	nimiɣaʎa̝
groba	ɡɾɔβa̝
cesteiro	sestejɾo̝
arco	aɾko̝
poutada	powtaða̝
muro	muɾo̝
cortella	koɾteʎa̝
carapucho	kaɾaput͡ʃo̝
ornear	ɔɾneaɾ
bichoco	bit͡ʃoko̝
tabán	taβaŋ
limpo	limpo̝
eche	et͡ʃe̝
eu	jew
habenza	aβenθa̝
granxa	ɡɾanʃa̝
cicha	sit͡ʃa̝
salvaterra	salβatɛra̝
escusar	eskusaɾ
mosto	mosto̝
bremar	bɾemaɾ
vez	beθ
chío	t͡ʃio̝
marañón	maɾaɲoŋ
pergameo	peɾɣameo̯
araña	aɾaɲa̝
tella	teʎa̝
riba	riβa̝
ámago	ama̝ɣo̝
fuste	fuste̝
pingar	piŋɡaɾ
estornillo	estoɾniɲo̝
asar	asaɾ
grolo	ɡɾolo̝
aveso	aβɛso̝
choer	t͡ʃoeɾ
esteo	esteʊ̯
lavandeira	laβandejɾa̝
cobiza	koβiθa̝
bóveda	bɔβe̝ða̝
lois	lojs
canada	kanaða̝
fía	fia̝
ollomol	oʎomɔl
conto	konto̝
caldeira	kaldejɾa̝
maseira	masejɾa̝
cangallo	kaŋkaʎo̝̝
mal	mal
candea	kandea̝
gorgozo	ɡoɾɣoθo̝
amoucar	amowkaɾ
esmiuzar	esmiusaɾ
remoucar	remowkaɾ
xergón	xeɾɣoŋ
panxoliña	panʃɔliɲa
castrapo	kastɾapo̝
ourizo	owɾiso̝
gaspallo	ɡaspaʎo̝
arrigar	ariɣaɾ
fero	fɛɾo̝
zugar	suɣaɾ
cerponzóns	seɾponsoŋs
peitoril	pejtoɾil
rabela	raβɛla̝
alemparte	alɛmpaɾte̝
cerviña	θɛɾβiɲa̝
lodoeiro	loðoejɾo̝
maza	masa̝
pezoia	peθoja̝
cabeza	kaβesa̝
callao	kaʎao̯
maceda	maθɛða̝
brasa	bɾasa̝
crego	kɾɛɣo̝
goto	ɡoto̝
campá	kampa
brión	bɾioŋ
zoupar	θowpaɾ
verme	bɛɾme̝
garfo	ɡaɾfo̝
peliqueiro	pɪlikejro̝̝
pertencer	peɾtenθeɾ
provizo	pɾoβiθo̝
antonte	antɔnte
partilla	paɾtiʎa̝
ichó	it͡ʃɔ
bicudo	bikuðo̝
touceira	towθejɾa̝
tambo	tambo̝
corrancha	korant͡ʃa̝
fouciña	fowsiɲa̝
chapapote	t͡ʃapapɔte̝
tanza	tanθa
frixir	fɾiʃiɾ
castro	kastɾo̝
baruto	baɾuto̝
lignito	liɡnito
fieito	fiejto̝
esgallar	esɣaʎaɾ
marea	maɾɛa̝
derrubar	deruβaɾ
abellariza	aβeʎaɾiθa̝
brenza	bɾensa̝̝
pardal	paɾðal
tillar	tiʎaɾ
piche	pit͡ʃi
linde	linde̝
brica	bɾika̝
avesada	aβesaða̝
lampo	lampo̝
zucho	sut͡ʃo̝
áspero	aspe̝ɾo̝
disque	diħke̝
centola	sentola̝
tento	tɛnto̝
picapau	pikapaʊ̯
amodo	amɔðo̝
limacha	limat͡ʃa̝
rosca	roska̝
pozo	poso̝
baratar	baɾataɾ
cerco	seɾko̝
abanicar	aβanikaɾ
illa	iʎa
dragón	dɾaɣoŋ
engulir	eŋɡuliɾ
herdar	ɛɾðaɾ
titor	titoɾ
marca	maɾka̝
eira	ejɾa̝
xesta	ʃɛsta̝
ouro	owɾʊ
lecer	leseɾ
chimpar	t͡ʃimpaɾ
piarro	pjaro̝
relinga	reliŋka̝
mera	mɛɾa̝
choza	t͡ʃɔθa̝
poxar	poʃaɾ
abaloucar	aβalowkaɾ
coteiro	kɔtejɾo̝
garduña	ɡaɾðuɲa̝
cima	θima̝
marrán	maraŋ
tripa	tɾipa̝
liñaza	liɲaθa̝
espreitar	espɾejtaɾ
querela	keɾela̝
aguillón	aɡiʎoŋ
irmán	iɾmao̯
trebellar	tɾeβeʎaɾ
cabra	kaβɾa̝
racho	rat͡ʃo̝
bravádego	bɾaβaðe̝ɣo̝
badúa	baðua̝
diante	djante̝
lista	lista̝
petar	petaɾ
carneiro	kaɾnejɾo̝
tillado	tiʎaðo̝
larpeirada	laɾpejɾaða̝
lapa	lapa̝
tebras	tɛβɾa̝s
sucada	sukaða̝
sentir	sentiɾ
pálpebra	palpeβɾa̝
beterraba	beteraba̝
tornecelo	toɾneselo̝
mazarelo	masaɾɛlo̝
padriño	paðɾiɲo̝
cachola	kat͡ʃɔla̝
lei	lei
esmorís	esmoɾis
chaguazo	t͡ʃaɡwaθo̝
renegar	reneɣaɾ
escarvar	eskaɾβaɾ
bamio	bamjo̝
frágoa	fɾaɣwa̝
mundo	munðo̝
carlou	kaɾlow
burdiar	buɾðeaɾ
enchenta	ent͡ʃɛnta̝
saramago	saɾamaɣo̝
randear	randeaɾ
papullo	papuʎo̝
xaula	ʃawla̝
calcañar	kalkaɲaɾ
canivete	kaniβete̝
suspirar	suspiɾaɾ
esgazar	esɣaθaɾ
badalada	baðalaða̝
pazo	paso̝
luva	luβ̞ɐ
viorto	biɔɾto̝
osa	osa̝
senra	sɛnra̝
brandán	bɾanðaŋ
megálito	meɣalito̝
regueiro	reɣejɾo̝
decotar	dekotaɾ
intricar	intɾikaɾ
beldro	beldɾo̝
febra	feβɾa̝
apañar	apaɲaɾ
toupa	towpa̝
acedo	aθeðo̝
barbeito	baɾβejto̝
palabra	palaβ̞ɾɐ
adobe	aðɔβe̝
baleato	baleato̝
formosende	foɾmosende̝
collón	koʎoŋ
almofrei	almofɾej
terreo	tɛreo̝
louza	lowθa̝
chabola	t͡ʃaβɔla̝
goteira	ɡotejɾa̝
dentabrún	dentaβɾuŋ
bama	bama̝
pelamio	pelamjo̝
cinchar	sint͡ʃaɾ
cachelo	kat͡ʃɛlo̝
gorgozada	ɡoɾɣosaða̝̝
talla	taʎa̝
leilán	lejlaŋ
támoga	tamo̝ɣa̝
tendal	tendal
cubo	kuβo̝
neda	neða̝
cenceno	θenθeno̝
temón	temoŋ
caldo	kaldo̝
zoscar	soskaɾ
cospeito	kospejto̝
ervella	eɾβeʎa̝
zarrapico	sarapiko̝
entena	entena̝
escarpa	eskaɾpa̝
ripiar	ripa̝
becerro	beθero̝
abrir	aβrir
bertamiráns	beɾtamiɾaŋs
birta	biɾta̝
pelexa	peleʃa̝
camioneiro	kamjoneɾo
cambo	kambo̝
zurreira	θurejɾa̝
bacío	baθio̝
curuxa	kɾuʃa̝
ra	raː
fabaca	faβaka̝
lobicán	loβikaŋ
gruta	ɡɾuta̝
enfesta	eɱfɛsta̝
cichar	θit͡ʃaɾ
matar	mataɾ
baloncesto	balonθesto
miguez	miɣe̝θ
agudo	aɣuðo̝
entrillar	entɾiʎaɾ
gontade	ɡontaðe̝
enfoscar	enfuskaɾ
ola	ɔla̝
verde	beɾðe̝
grallar	ɡɾaʎaɾ
podar	mendɾeʎo̝
fechadura	fet͡ʃaðuɾa̝
banda	banda̝
fogaza	foɣaθa̝
entrouso	entɾowso̝
puñar	puɲaɾ
tieira	tiejɾa̝
laverco	laβɛɾko
galopar	ɡalopaɾ
cear	seaɾ
gonxar	ɡonʃaɾ
friaxe	fɾiaʃe̝
albacora	alβakɔɾa̝
xián	ʃiaŋ
cabezal	kaβeθal
rocho	rot͡ʃo̝
chuchamel	t͡ʃut͡ʃamɛl
chantaxe	t͡ʃantaʃe̝
foz	fɔs
fociño	fusiɲo̝
cerdeira	θeɾðejɾa̝
guiso	ɡiso̝
pebida	peβiða̝
fogo	foɣo
fermento	feɾmento̝
cheirento	t͡ʃejɾento̝
moscar	moskaɾ
magueiro	maɣejɾo̝
terzo	teɾso̝
tormenta	toɾmɛnta̝
manda	manda̝
canedo	kaneðo̝
lama	lama̝
estopa	estopa̝
marisco	maɾisko̝
unxir	unʃiɾ
ladral	laðɾal
carraca	karaka̝
xeira	ʃejɾa̝̝
cuncha	kunt͡ʃa̝
gallo	ɡaʎo̝
ho	ɔ
lardo	lardo
vista	bista̝
dacosta	dakɔsta̝
arancel	aɾanθel
combater	kombateɾ
ensanguentar	ensaŋɡɛntaɾ
laiar	lajaɾ
tento	tento̝
chao	t͡ʃao̯
tello	teʎo̝
sollar	soʎaɾ
derrafar	derafaɾ
piteira	pitejɾa̝
gadoupa	ɡaðowpa̝
moi	moj
aturar	atuɾaɾ
oural	owɾal
preguiza	pɾeɣisa̝
anca	aŋka̝
balandrán	balandɾaŋ
buraz	buɾaθ
chiar	t͡ʃiaɾ
mirar	miɾaɾ
sedeño	seðeɲo̝
distraer	distɾaeɾ
empuxón	empuʃoŋ
estercar	esteɾkaɾ
pregoeiro	pɾeɣoejɾo̝
berbia	beɾβja̝
cambra	kambɾa̝
branco	bɾaŋkʊ
arangaño	aɾaŋɡaɲo̝
freo	fɾeo̝
zoupo	θowpo̝
améndoa	amendo̯a̝
forma	foɾma̝
moído	moiðo̝
mosteiro	mostejɾo̝
viñoa	biɲɔa̝
temer	temeɾ
bieito	biejto̝
refungar	refuŋɡaɾ
doa	doa̝
estercoar	esteɾkoaɾ
bulicio	bulisjo̝
dentagrón	dentaɣɾuŋ
gaiteiro	ɡajtejɾo̝
moreira	mɔɾejɾa̝
boche	bɔt͡ʃe̝
vareixa	baɾɛjʃa̝
varganzo	baɾɣanθo̝
terzo	teɾθo̝
uña	uɲa̝
teso	teso̝
cachena	kat͡ʃena̝
guilfonxe	ɡilfonʃe̝
nugallán	nuɣaʎa̝ŋ
troitosende	tɾojtosende̝
cervantes	θeɾβante̝s
apupar	apupaɾ
bigode	biɣɔðe̝
cumio	kumjo̝
cango	kaŋɡo̝
fecha	fet͡ʃa̝
provizo	pɾoβiso̝
embelga	embɛlɣa̝
baloca	balɔka̝
cacha	kat͡ʃa̝
ollo	oʎʊ
codeso	koðeso̝
asa	asa
coito	kojto̝
montón	montoŋ
fogar	foɣaɾ
tornés	toɾnes
pescozo	peskoθo̝
remanecer	remaneseɾ
galra	ħalra̝
charrúa	t͡sarua̝
canto	kanto̝
finamento	finamɛnto̝
azul	aθul
morada	moɾaða̝
enludrar	enluðɾaɾ
neada	neaða̝
bido	biðo̝
cichote	sit͡ʃɔte̝
bucina	busina̝
probar	pɾoβaɾ
barazal	baɾaθal
xolda	ʃɔlda̝
lique	like̝
forcarei	foɾkaɾej
barra	bara̝
nantón	nantoŋ
aboar	aβoaɾ
alcrique	alkɾike̝
eslavar	eslaβaɾ
cortiña	koɾtiɲa̝
cachaza	kat͡ʃaθa̝
montecelo	monteθelo̝
leme	lɛme̝
álido	alið̞o̝
bosta	bɔsta̝
lata	lata̝
guinche	ɡint͡ʃe̝
boedo	boeðo̝
manchea	mant͡ʃea̝
colleita	koʎejta̝
vivenda	biβenda̝
barcal	baɾkal
mexacán	meʃakaŋ
saia	saja̝
cubeiro	kuβejɾo̝
curmá	kuɾma
bringa	bɾiŋɡa̝
més	mɛs
lavadoiro	laβaðojɾo̝
dar	daɾ
píllara	piʎa̝ɾa̝
asubío	asuβio̝
baralloca	baɾaʎɔka̝
charro	t͡ʃaro̝
choia	t͡ʃɔja̝
fouciño	fowsiɲo̝
frieira	fɾiejɾa̝
pose	pɔse̝
troita	tɾutja̝
foz	fɔθ
talladeira	taʎaðejɾa̝
tirar	tiɾaɾ
cesteiro	θestejɾo̝
colleitar	koʎejtaɾ
gunxar	ɡunʃaɾ
baño	baɲo̝
charruar	t͡ʃaruaɾ
relustrar	relustɾaɾ
monforte	monfɔɾte̝
esmoucar	esmowkaɾ
roza	rosa̝
bandeira	bandejɾa̝
viana	biana̝
ansariz	ansaɾiθ
noz	nɔθ
curmán	kuɾmaŋ
despeito	despejto̝
baleeiro	baleejɾo̝
apodrecer	apoðɾeθeɾ
ambos	ambo̝s
saibro	sajβɾo̝
braza	bɾaθa̝
reluscar	reluskaɾ
galería	ɡaleɾia̝
torto	tɔɾto̝
brúa	bɾua̝
machinal	mat͡ʃinal
rebordela	reβoɾðɛla̝
rifón	rifoŋ
teimado	tejmaðo̝
rebinxe	reβinʃe̝
callobre	kaʎɔβɾe̝
anduriña	anduɾiɲa̝
alén	aleŋ
cinto	θinto̝
rolo	rɔlo̝
bagullo	baɣuʎʊ
aceso	aθeso̝
castromil	kastɾomil
fronza	fɾonθa̝
toutelo	towtɛlo̝
tosquiar	toskiaɾ
vixiar	biʃiaɾ
cepa	θepa̝
afuar	afuaɾ
trucar	tɾukaɾ
moenda	moenda̝
semente	semɛnte̝
paíño	paiɲo̝
pescudar	peskuðaɾ
sedofeito	seðofejto̝
sedela	seðɛla̝
pequeneiro	pekenejɾo̝
cangalla	kaŋɡaʎa̝
cobizoso	koβiθoso̝
oasis	ɔasis
disque	diske̝
aire	ajɾe̝
brandón	bɾanðoŋ
mortaldade	moɾtaldaðe̝
colleito	koʎejto̝
cachote	kat͡ʃɔte̝
arrós	aros
paz	pas
denegrido	deneɣɾiðo̝
queixada	kejʃaða̝
sinal	sinal
cachotaría	kat͡ʃotaɾia
borraxe	boraʃe̝
cós	kɔs
fritir	fɾitiɾ
furna	fuɾna̝
mestas	mesta̝s
arrefecer	arefeseɾ
maino	majno̝
queimadura	kejmaðuɾɐ
verán	bɾaŋ
poleiro	polejɾo̝
salnés	salnes
touta	towta̝
laredo	laɾeðo̝
mercar	merkaɾ
cousela	kowsela̝
salgueiro	salɣejɾo̝
esmoriz	esmoɾiθ
arteixo	aɾtejʃo̝
restra	rɛstɾa̝
escoller	eskoʎeɾ
frasca	fɾaska̝
remelar	remelaɾ
morno	moɾno̝
opa	ɔpa̝
grama	ɡɾama̝
mesquita	meskita
bafún	bafuŋ
rodela	roðɛla̝
trollo	tɾoʎo̝
castrexo	kastɾeʃo
cobizar	koβiθaɾ
zapateiro	θapatejɾo̝
cancela	kanθɛla̝
caldeiro	kaldejɾo̝
espido	espiðo̝
valado	balaðo̝
lindeiro	lindejɾo̝
cima	sima̝
escuma	eskuma̝
socalco	sokalko̝
bastimento	bastimento̝
inverno	imbɛɾno̝
calella	kaleʎa̝
bucio	busjo̝
espiñazo	espiɲaθo̝
segar	seɣaɾ
vigo	biħo̝
estricar	estɾikaɾ
lorbaga	loɾβaɣa̝
péga	pɛɣa̝
engorde	eŋɡɔɾðe̝
espadoa	espað̞wa̝
túzaro	tuθa̝ɾo̝
tempestade	tempɛsta
agruñeiro	aɣɾuɲejɾo̝
escáncer	eskanθe̝ɾ
antroido	antɾojðo̝
ludro	luðɾo̝
martes	maɾte̝s
vencello	benseʎo̝
aldea	aldea̝
vingar	biŋɡaɾ
vetillo	betiʎo̝
alugar	aluɣaɾ
poldro	poldɾo̝
riádego	riaðe̝ɣo̝
testa	tɛsta̝
brun	bɾuŋ
ambroesa	ambɾoesa̝
vacaloura	bakalowɾa̝
gorgola	ɡoɾɣola̝
oliva	ɔliba
cervexa	θeɾβeʃa̝
moscoso	moskoso̝
eiva	ejβa̝
escudriñar	eskuðɾiɲaɾ
ollomol	ɔʎomɔl
chopa	t͡ʃopa̝
egoa	ɛɣwɐ
vesar	besaɾ
cangalla	kaŋkaʎa̝̝
frenxer	frenʃeɾ
riqueza	rikeθa̝
comida	komiða̝
recostar	rekostaɾ
rabuñar	raβuɲaɾ
acubillar	akuβiʎaɾ
esbardallar	esβaɾðaʎaɾ
mioca	mi̯ɔka̝
neto	nɛto̝
marrar	maraɾ
lourenzá	lowɾenθa
falcatrueiro	falkatɾuejɾo̝
refregar	refɾeɣaɾ
herculino	ɛɾkulino̝
legón	liħoŋ
fochicar	fot͡ʃikaɾ
bigote	biɣɔtɪ
socalcar	sokalkaɾ
esterlín	esterliŋ
cuba	kuβa̝
xuíz	ʃuiθ
arregazar	reɣasaɾ
tafona	tafona̝
ripa	ripa̝
arca	arka̝
boo	boː
cofia	kɔfja
argola	aɾɣɔla̝
lais	lajs
troita	tɾojta̝
arroiar	arojaɾ
toiriz	tojɾiθ
carto	kaɾto̝
carabuxa	kaɾaβuʃa̝
galiza	ɡalisɐ
chuvia	t͡ʃuβja̝
ulido	ulið̞o̝
doniña	doniɲa̝
fogaxe	foɣaʃe̝
bestra	bɛstɾa̝
besugo	besuɣo̝
pedrazo	peðɾaθo̝
pombo	pɔmbo̝
pau	paw
rico	riko̝
pazo	paθo̝
vivir	biβiɾ
mundo	muðo̝
repolo	repolo̝
tascón	taskoŋ
baldomar	baldomaɾ
souto	sowto̝
novo	nɔβʊ
arciprestado	aɾθipɾɛstaðo̝
lagar	laɣaɾ
mourillón	mowɾiʎoŋ
lenllo	lenʎo̝
tasco	tasko̝
milhomes	milɔme̝s
friosende	fɾiosende̝
donicela	doniθɛla̝
berce	bɛɾθe̝
escándalo	eskanda̝lo̝
gueifa	ɡejfa̝
demarcación	demaɾkaθjoŋ
mero	mɛɾo̝
arroio	arojo̝
pitanza	pitanθa̝
nebra	nɛβɾa̝
chamizo	t͡ʃamiθo̝
veo	beʊ̯
abranguer	aβɾaŋɡeɾ
outoeira	owtoejɾa̝
xanela	ʃanɛla
buceta	buseta̝
mazadura	maθaðuɾa̝
piorno	pioɾno̝
regazo	reɣaθo̝
heráldica	eɾalðika̝
tormentelo	toɾmentɛlo̝
abater	aβateɾ
pardiñeiro	paɾðiɲejɾo̝
tremor	tɾemoɾ
gordén	ɡoɾðɛŋ
bemposta	bɛmpɔsta̝
queiro	kejɾo̝
balcón	balkoŋ
vinagre	binaɣɾe̝
coiñal	kɔiɲal
acorar	akoɾaɾ
reguengo	reħɛŋħo̝
casal	kasal
cerello	θeɾeʎo̝
migar	miɣaɾ
ferruxento	feruʃento̝
escote	eskɔte̝
retrincar	retriŋkaɾ
mesmo	mɛsmo̝
palmela	palmɛla̝
abella	aβeʎa̝
aparcadoiro	apaɾkaðojɾo̝
páramo	paɾa̝mo̝
raxeira	raʃejɾa̝
trelo	tɾɛlo̝
cal	kal
vimieiro	bimiejɾo̝
riquián	rikiaŋ
pígaro	piɣa̝ɾo̝
cachón	kat͡ʃoŋ
outón	owtoŋ
quitamerendas	kitameɾenda̝s
intención	intenθjoŋ
vilaguillulfe	bilaɣiʎulfe̝
achegar	at͡ʃeɣaɾ
tixola	tiʃɔla̝
gaspacho	ɡaspat͡ʃo̝
fumeira	fumejɾa̝
ascariz	askaɾiθ
monicreque	monikɾɛke̝
trémbora	tɾembo̝ɾa̝
ouriceira	owɾiθejɾa̝
lacazán	lakaθaŋ
desque	deske̝
cincha	sint͡ʃa̝
edificar	eðifikaɾ
palla	paʎa̝
burel	buɾɛl
veciño	bisiɲo̝
facenda	faθenda̝
niallo	niaʎo̝
meán	meaŋ
lañar	laɲaɾ
repenicar	repinikaɾ
refollo	refoʎo̝
adoito	aðojto̝
atinxir	atiŋʃiɾ
barcia	baɾθja̝
fachenda	fat͡ʃenda̝
gornir	ɡoɾniɾ
ferraría	feraɾia̝
carpinteiro	kaɾpintejɾo̝
cochada	kot͡ʃaða
apremer	apɾemeɾ
vello	bɛʎo̝
pregón	pɾeɣoŋ
pinchar	pint͡ʃaɾ
freás	fɾeas
ser	seɾ
pé	pɛ
maraña	maɾaɲa̝
rifar	rifaɾ
goldra	ɡoldɾa̝
rexeitamento	reʃejtamɛnto̝
soldar	solðaɾ
portelo	poɾtelo̝
travesa	tɾaβɛsa̝
zudre	θuðɾe̝
gorgueira	ɡoɾɣejɾa̝
bozo	boso̝
coco	kɔko̝
unto	unto̝
balistrón	balistɾoŋ
podrecer	poðɾeseɾ
pinchagato	pint͡ʃaɣato̝
espita	espita̝
ascua	askwa̝
cangallo	kaŋɡaʎo̝
perda	pɛɾða̝
pendello	pendeʎo̝
couceiro	kowsejɾo̝
pasteco	pastɛko̝
marfollar	amaɾfoʎaɾ
gorgolexar	ɡoɾɣoleʃaɾ
balea	balea̝
atrás	atɾas
zugar	θuɣaɾ
has	as
cerdeira	seɾðejɾa̝
esgotar	ez̺ɣotaɾ
coroza	koɾoθa̝
estro	estɾo̝
escudela	eskuðɛla̝
miolo	miɔlo̝
alboio	alβojo
niño	niɲo̝
pastequeiro	pastɛkejɾo̝
mol	mɔl
pescar	peskaɾ
mergullo	meɾɣuʎo̝
farpar	faɾpaɾ
gorentar	ɡoɾentaɾ
chanchar	t͡ʃant͡ʃaɾ
corazón	koɾasoŋ
irto	iɾto̝
milladoiro	miʎaðojɾo̝
pandorgada	pandoɾɣaða̝
liscar	liskaɾ
barril	baril
pendurar	penduɾaɾ
barca	baɾka̝
costeiro	kostejɾo̝
couselo	kowselo̝
encantamento	eŋkantamɛnto̝
revirado	reβiɾaðo̝
xeada	ʃiaða̝
maravallada	maɾaβaʎaða̝
cavar	kaβaɾ
dona	dona̝
choromicas	t͡ʃoɾomika̝s
esperrechar	esperet͡ʃaɾ
pear	peaɾ
chanto	t͡ʃanto̝
senllo	senʎo̝
muxica	muʃika̝
xato	ʃato̝
non	noŋ
ocasión	ɔkasjoŋ
veciño	biθiɲo̝
centeo	θentew
tecer	teseɾ
nao	naʊ̯
camposanto	kamposanto̝
marcaxe	maɾkaʃe̝
doiro	dujɾo̝
cenrada	θenraða̝
zuchar	θut͡ʃaɾ
grade	ɡɾaðe̝
verdello	beɾðeʎo̝
francés	fɾanθes
vexiga	beʃiɣa̝
bustofreán	bustofɾeaŋ
cirigaita	siɾiɡajta̝
carreira	karejɾa̝
bogada	buɣaða̝
cerqueiro	seɾkejɾo̝
repenicar	repenikaɾ
froxel	fɾoʃɛl
latar	lataɾ
misto	misto̝
derregar	dereɣaɾ
planeta	planeta
pontenova	pontenɔβa̝
tollemerendas	toʎemeɾenda̝s
frete	fɾɛte̝
fresco	fɾesko̝
batán	bataŋ
rapaz	rapas
rafar	rafaɾ
burlar	buɾlaɾ
feito	fejto̝
toco	toko̝
aseitar	asejtaɾ
epa	ɛpa̝
