σκορδόψωμα	skoɾðopsoma
σκυλί	scili
περισπωμένη	perispomeni
μπέρδεψα	beɾðepsa
κονέκτικατ	konektikat
κληρονομούμε	kliɾonomume
πεισμένη	pizmeni
ελπίζουμε	elpizume
χαλασμένε	xalazmene
τζερτζελέσ	dzeɾdzeles
καθορίζομαι	kaθoɾizome
ματόκλαδο	matoklaðo
ανιψούλη	anipsuli
κουρασμένη	kurazmeni
πλειστόκαινοσ	plistocenos
γκουγκλάρω	ɡuɡlaɾo
απελπισμένου	apelpizmenu
μολογιέμαι	moloʝeme
δεκέμβρηδεσ	ðeceɱvɾiðes
ζωηρόσ	zoiros
σπασμένησ	spazmenis
μαυροπουλιού	mavropuʎu
πειθόμενεσ	piθomenes
τουρκοκρατία	tuɾkokɾatia
νικημένων	nicimenon
αντεύχομαι	andefxome
αναμαλλιασμένα	anamaʎazmena
αηδιασμένουσ	aiðiazmenus
κόκκινησ	kocinis
αμπαλάρομαι	ambalaɾome
πουδριέρα	puðɾʝeɾa
μεσημβρία	mesimvria
αρκούμε	aɾkume
αποταμιεύτηκα	apotamieftika
θήβεσ	θives
επιτρέπομαι	epitɾepome
πειθόμενα	piθomena
βρετανία	vretania
αποδείχθηκαν	apoðixθikan
ακροάζομαι	akroazome
λύνε	line
δυχατέρα	ðuxatera
ήπιε	ipie
παρακλήθηκα	parakliθika
κουτσομπολεύτηκα	kutsoboleftika
τέλεια	telia
ακόνισα	akonisa
γκαστρωμένα	ɡastromena
κολωνία	kolonia
παρεκτράπηκα	paɾektɾapika
μυκόνου	mikonu
βυθισμένου	viθizmenu
ειλημμένοσ	ilimenos
αγκομαχώ	aŋɡomaxo
ιούνη	iuni
ποδόσφαιρων	poðosferon
φρεσκάρισε	fɾeskaɾise
βασιλεύω	vasilevo
προσκεκλημένοσ	pɾosceklimenos
εγκατεστημένοσ	eŋɡatestimenos
σκύλα	scila
λικέρ	liceɾ
παρεισέφρησα	parisefrisa
λουτράκι	lutɾaci
αραχνούλα	aɾaxnula
κόβομαι	kovome
μπονατσάριζε	bonatsaɾize
ξαναγράφω	ksanaɣɾafo
κοινοβιάτησ	cinoviatis
λατρεύω	latɾevo
εγγράφηκα	eŋɣrafika
αιματοβαμμένησ	ematovamenis
εφεύρα	efevɾa
συγκρουόμενου	siŋɡruomenu
εξέλεξα	ekseleksa
φτάνω	ftano
αποκαλύφθηκα	apokalifθika
ξεριζώνω	kseɾizono
ολόφωτε	olofote
βοηθούμε	voiθume
διασκεδάζω	ði̯asceðazo
απολογητικούσ	apoloʝitikus
ερχόμενεσ	erxomenes
επιδοκιμάζομε	epiðocimazome
αξέχαστοσ	aksexastos
βράζω	vrazo
ημέρευε	imeɾeve
φρενάρω	frenaro
αποδέχτηκα	apoðextika
μουνότρυπα	munotɾipa
απαγόρευση	apaɣorefsi
μπιντέσ	bides
ψάχτηκα	psaxtika
πολωνέζικα	polonezika
αντικλεπτικό	andikleptiko
ευημερούσα	evimeɾusa
παρελθόν	parelθon
συγγενήσ	siŋɟenis
αδικώ	aðiko
φημίζομαι	fimizome
μυταράσ	mitaɾas
επαρκώ	epaɾko
περιστράφηκα	peɾistɾafika
αναβράζω	anavrazo
δαγκάνω	ðaŋɡano
χάλυβασ	xalivas
οδήγησα	oðiʝisa
κριθαρόψωμων	kriθaropsomon
συμφυρμούσ	siɱfirmius
αγγελοκρουσμένοσ	aŋɟelokɾuzmenos
τηλεφωνήθηκα	tilefoniθika
λόφοσ	lofos
αναβαλλόμενοι	anavalomeni
πάμμαυρων	pamavɾon
σελίνι	selini
βάλλεται	valete
πεθαμένα	peθamena
αγιασμένοσ	aʝiazmenos
άγιοσ	aʝios
επιδρώ	epiðɾo
παίζομε	pezome
σουβενίρ	suvenir
κακοποιούμαι	kakopiume
διαφωνώ	ði̯afono
βρούμε	vɾume
διπλανή	ðiplani
αλήθεια	aliθça
έβοσκα	evoska
στυμμένε	stimene
αγορεύω	aɣorevo
κριθαρόψωμου	kriθaropsomu
πηδώ	piðo
προσγράφομε	pɾozɣrafome
αναλίσκομαι	analiskome
αποδείχθηκε	apoðixθice
ανατραπήκαν	anatɾapikan
ενθύμιο	enθimio
ορίζουμε	oɾizume
ποντάριζα	pondaɾiza
εντύπωση	endiposi
χορέψτε	xoɾepste
απασχολούμε	apasxolume
απηρχαιωμένου	apirçeomenu
πεθαμένησ	peθamenis
πάγκρεασ	paŋɡɾeas
διέπρεψα	ðiepɾepsa
απορροφήθηκα	apoɾofiθika
καταιγίδων	kateʝiðon
μετείχα	metixa
βαστώ	vasto
υποθηκεύομαι	ipoθicevome
λύσανε	lisane
άθαφτοσ	aθaftos
διαλογίστηκα	ðialoʝistika
εξήρθην	eksirθin
απέσταξα	apestaksa
αναθεματισμένοι	anaθematizmeni
θλιμμένεσ	θlimenes
λάδι	laði
όμικρον	omikron
τσίτσασ	tsitsas
ιούνηδων	iuniðon
αμύγδαλο	amiɣðalo
συναναστράφηκα	sinanastɾafika
ασκήθηκα	asciθika
διαβάζομαι	ðʝavazome
περιέκλεισα	perieklisa
ανθεστήρια	anθestiɾia
απομονωμένεσ	apomonomenes
φυτικούσ	fitikus
αναθεματισμένα	anaθematizmena
μοιράστηκα	miɾastika
διεξάγω	ðieksaɣo
ευγηρία	evʝiɾia
βαθιού	vaθçu
ανέτρεψα	anetɾepsa
υπέροχοσ	ipeɾoxos
γκρίζοι	ɡɾizi
στενοχωρημένοι	stenoxorimeni
γιατρεύομαι	ʝatɾevome
επιγράφομε	epiɣrafome
κανονικόσ	kanonikos
υποβοηθούμενεσ	ipovoiθumenes
καταξοδεύομαι	kataksoðevome
υποσκάφηκα	iposkafika
ωχριώ	oxɾio
αναστρέφω	anastɾefo
εκκόλαψα	ekolapsa
ιρλανδία	iɾlanðia
αξιωματικόσ	aksiomatikos
αιματώνομαι	ematonome
καφεμαντεία	kafemandia
σκατούλα	skatula
γκαέτα	ɡaeta
αλυσοδεμένων	alisoðemenon
αξιολογούμε	aksioloɣume
σπάρτο	spaɾto
δαμάσκηνο	ðamascino
χρονολογήσεωσ	xronoloʝiseos
φάνηκα	fanika
βαθμολογημένου	vaθmoloʝimenu
αποκατάστησα	apokatastisa
πειθαναγκάζομε	piθanaŋɡazome
κωσταντίνοσ	kostandinos
ασπάσθηκα	aspasθika
παρότρυνα	paɾotɾina
γλυκίσματοσ	ɣlicizmatos
στάζουμε	stazume
θέροσ	θeros
ου	u
αντιγράφηκα	andiɣrafika
αναδεικνύω	anaðiknio
ρώτησα	ɾotisa
κορασίδα	koɾasiða
εορτάζουμε	eoɾtazume
ομοφυλοφίλουσ	omofilofilus
σοφότεροσ	sofoteɾos
κληρονομήθηκα	kliɾonomiθika
άμπωτη	amboti
αναφέρουμε	anafeɾume
διαμορφώνομαι	ði̯amoɾfonome
πιλοτάρομαι	pilotaɾome
κατερίνη	kateɾini
ψιτ	psit
αποφάσεωσ	apofaseos
υπαγορεύτηκα	ipaɣoɾeftika
αγενήσ	aʝenis
στραγγίζομαι	stɾaŋɡizome
κόμησ	komis
περιοδεύων	peɾioðevon
καταναγκάζομε	katanaŋɡazome
πλατεία	platia
αγανακτισμένο	aɣanaktizmeno
βουτυρωμένο	vutiromeno
οποίου	opiu
κανακέψτε	kanacepste
αλιεύθηκα	aliefθika
αντιστρέφομε	andistɾefome
προϊών	pɾoion
ανασκάφτηκα	anaskaftika
απομονωμένε	apomonomene
αυγούστουσ	avɣustus
συνοριοφυλάκων	sinoriofilakon
στραβώνομαι	stɾavonome
βαθμολογημένων	vaθmoloʝimenon
τραβώ	tɾavo
υποσκάφθηκα	iposkafθika
παραγγέλλω	paraŋɟelo
τηλεθεατήσ	tileθeatis
καλούμαι	kalume
χριστόψωμων	xristopsomon
εμπιστοσύνη	embistosini
αναστατώνω	anastatono
ἀττικίζων	aticizon
λυνόμαστε	linomaste
γεια	ʝa
απασχολημένεσ	apasxolimenes
δολοφονήθηκα	ðolofoniθika
πίνομαι	pinome
περιοδικών	perioðikon
φιλιών	fiʎon
εγκλείω	eŋɡlio
δήμοσ	ðimos
συζητήθηκα	sizitiθika
στέφουμε	stefume
ασεβέστερα	asevestera
ανακρίνομαι	anakɾinome
κάλμαρε	kalmaɾe
έβαψα	evapsa
σοφίεσ	sofies
σκασμένη	skazmeni
ταπεινώνομαι	tapinonome
διαπνέομε	ðiapneome
γοήτεψα	ɣoitepsa
κένταυροσ	cendavɾos
αποσείομαι	aposiome
νάνου	nanu
ανίδρυσα	aniðrisa
βρεγμένοσ	vɾeɣmenos
σεπτέμβριοσ	septeɱvɾios
φάροσ	faros
άσεβη	asevi
προμηθέα	promiθea
παραβάλλομαι	paɾavalome
σπασμένεσ	spazmenes
κουρασμένουσ	kurazmenus
αγγουριά	aŋɡuɾʝa
πασαπόρτι	pasapoɾti
βιβλιοπωλεία	vivliopolia
διαπληκτίστηκα	ðiapliktistika
έλειψα	elipsa
αμπελοχώραφα	ambeloxoɾafa
σύκο	siko
μισθωτήσ	misθotis
βαν	van
χαράζει	xaɾazi
αγαπημένουσ	aɣapimenus
εφευρίσκομαι	efevɾiskome
τσεκάρισα	tsekaɾisa
κορόιδο	koɾoi̯ðo
διατυπώνω	ðʝatipono
ψηφοφορία	psifofoɾia
καταγράφτηκα	kataɣraftika
αντιστράφηκα	andistɾafika
ροδάκινων	roðacinon
βαθμολογημένοι	vaθmoloʝimeni
αναθεματισμένου	anaθematizmenu
ανιψούληδων	anipsuliðon
φαντάζω	fandazo
περνιέμαι	peɾɲeme
αγιασματάρι	aʝazmatari
αλφάβητο	alfavito
απασχολημένα	apasxolimena
κραγμένη	kraɣmeni
πομφόλυγασ	poɱfoliɣas
μπούρδασ	buɾðas
αναδημιουργημένων	anaðimiurʝimenon
διάνυσα	ðianisa
σημαδιού	simaðʝu
κορακίστικα	koɾacistika
σκασμένα	skazmena
γκουγκλίζω	ɡuɡlizo
πασπατεύτηκα	paspateftika
έτοσ	etos
τρεχούμενο	tɾexumeno
αγναντεύω	aɣnandevo
εγχύνομαι	eŋçinome
ανέπαλλα	anepala
τόπι	topi
κίνδυνοσ	cinðinos
περικλείουμε	perikliume
αναφέρομε	anafeɾome
ανδρείωσα	anðɾiosa
ασπάστηκα	aspastika
λιγότερησ	liɣoteris
ανανήψεισ	ananipsis
κατοικημένοσ	katicimenos
κυβερνιέμαι	civeɾɲeme
έπαυσα	epafsa
απαρχαιωμένοι	aparçeomeni
πρωτοανακάλυψα	pɾotoanakalipsa
ιρλανδέζικοσ	iɾlanðezikos
επαμφοτέριζα	epaɱfoteɾiza
ἐφάπτομαι	efaptome
μεταφέρθηκα	metafeɾθika
παρελθούσησ	parelθusis
ξαγναντεύω	ksaɣnandevo
στυμμένουσ	stimenus
σείστηκα	sistika
νιάτων	ɲaton
πολωνέζασ	polonezas
συνόψεων	sinopseon
στέλλα	stela
ηγουμένουσ	iɣumenus
εμπνέουμε	embneume
ουσιαστικοποίησησ	usiastikopiisis
ήγειρα	iʝiɾa
πώσ	pos
ακροδεξιόσ	akɾoðeksʝos
αμφίλογοσ	aɱfiloɣos
οκτώβρηδων	oktovɾiðon
ψαρίλα	psaɾila
γαμοσταυρίδια	ɣamostavɾiðʝa
παγωμένουσ	paɣomenus
λυπημένησ	lipimenis
αναδιάρθρωση	anaðiaɾθɾosi
λυμένε	limene
κοριτσάρεσ	koritsares
φεβρουάριοι	fevɾuaɾii
αναμελιά	anameʎa
δυσκόλεψα	ðiskolepsa
προκαταβάλλω	pɾokatavalo
βρήκεσ	vɾices
αναμαλλιασμένο	anamaʎazmeno
ενάρξεωσ	enaɾkseos
τιμοκαταλόγων	timokataloɣon
θλιβερή	θliveɾi
κρύπτω	kɾipto
πάρκαρε	paɾkaɾe
κλέφτηκα	kleftika
σαπουνίζω	sapunizo
πίστεψα	pistepsa
κατέστησαν	katestisan
έσκαγα	eskaɣa
γνοιάζομαι	ɣɲazome
ανεβάστηκα	anevastika
φωτόλυση	fotolisi
αμβούργο	aɱvurɣo
έλκομαι	elkome
βιοσφαιρών	viosfeɾon
κούκκοσ	kukos
ανατείνω	anatino
κατασκευάζομαι	katascevazo
μακαρονάδα	makaɾonaða
αμφιλεγόμενων	aɱfileɣomenon
ικανοποιημένα	ikanopiimena
ροδάκινο	roðacino
ερχόμενουσ	erxomenus
ἁγιοποιημένοσ	aʝiopiimenos
θυμωμένη	θimomeni
φύλα	fila
αναφέρομαι	anafeɾome
φυλαγμένοσ	filaɣmenos
ἀττικίζον	aticizon
μάιε	maie
ανιχνεύομαι	anixnevome
λύνομε	linome
πίσω	piso
υποκρύπτω	ipokɾipto
κανάκεψα	kanacepsa
αλαμπουρνέζικοσ	alaburnezikos
σύνθλιψε	sinθlipse
παρέβαλα	paɾevala
αλυσοδεμένησ	alisoðemenis
καταστρέφω	katastɾefo
προσκλήθηκα	pɾoskliθika
επαρκέστεροσ	epaɾcesteɾos
γιατρειάσ	ʝatɾias
θεοτόκο	θeotoko
έμμονοσ	emonos
παρελθόντεσ	paɾelθondes
απορροφούμενων	apoɾofumenon
λατρεύτηκα	latɾeftika
επισυνάπτουμε	episinaptume
έβενοσ	evenos
ξελύνω	kselino
κάδρο	kaðɾo
νεποτισμόσ	nepotizmos
ρίχνω	ɾixno
ακριβοπλήρωσα	akrivopliɾosa
σύνοψη	sinopsi
απόπλων	apoplon
ἀρχαΐζω	arxaizo
ευχαριστήθηκα	efxaɾistiθika
βαθμολογημένη	vaθmoloʝimeni
αγέλη	aʝeli
κουτσομπόλεψα	kutsobolepsa
επαρχία	epaɾçia
αγωνιστή	aɣonisti
κλαδεύτηκα	klaðeftika
φωτογραφείο	fotoɣrafia
συμβουλεύω	siɱvulevo
επικαρπία	epikaɾpia
συγγραφέα	siŋɣrafea
στην	stin
πορτοκαλιά	poɾtokaʎa
βδέλυγμα	vðeliɣma
παρεξετράπησαν	paɾeksetɾapisan
περσέασ	perseas
καταβάλετε	katavalete
εμπνευσμένοι	embnevzmeni
αναπόδεικτοσ	anapoðiktos
διοργανώθηκα	ðioɾɣanoθika
εξωμήτριοσ	eksomitɾios
πιπεριά	piperʝa
αναπαρασταίνω	anaparasteno
μεταφέρομαι	metafeɾome
προάλειψα	pɾoalipsa
αναμελιάσ	anameʎas
εγγράφω	eŋɣɾafo
άγιασα	aʝasa
λύνατε	linate
κατεστημένοσ	katestimenos
κοριτσάρα	koritsara
αλληλοσυγκρούομαι	alilosiŋɡruome
ξεμπέρδεψα	ksebeɾðepsa
μηνύω	minio
απαρχαιωμένε	aparçeomene
λύσου	lisu
λύομαι	liome
μάρτυροσ	maɾtiɾos
κακό	kako
πίτασ	pitas
κάγκελο	kaŋɡelo
αιματοβαμμένη	ematovameni
μουσκεμένοσ	muscemenos
χούφταλο	xuftalo
πληθυντικόσ	pliθindikos
αλωνάρηδεσ	alonaɾiðes
ψηφοφόροσ	psifoforos
αναμμένεσ	anamenes
εντυπωσιακόσ	endiposiakos
αγυιόπαι	aʝiope
μήνυμα	minima
αποκρύφτηκα	apokɾiftika
συνηθισμένων	siniθizmenon
πίσον	pison
ανατρέπομε	anatɾepome
ιερόδουλοσ	ieɾoðulos
αγάμητοσ	aɣamitos
μπαρκάρω	baɾkaɾo
κοριτσιού	koɾitsçu
ασκούμαι	askume
αρχικά	arçika
αισχροκέρδεια	esxrocerðia
θέλω	θelo
παντρεμένα	pandɾemena
σημαδεύω	simaðevo
κορόιδεψε	koɾoi̯ðepse
ευσεβούσ	efsevus
αυξομειώνω	afksomiono
περιθάλπουμε	peɾiθalpume
ημερομηνίεσ	imeɾominies
παντού	pandu
συγκοπή	siŋɡopi
ηδονοβλεψίασ	iðonovlepsias
πεθαμένων	peθamenon
γκαστρωμένων	ɡastromenon
αράπησ	aɾapis
βάζω	vazo
λύσσαξα	lisaksa
ντίνα	dina
αγιοπούλι	aʝopuli
τοποθετήθηκα	topoθetiθika
συναίρεσησ	sineresis
γόνυ	ɣoni
καθελκύουμε	kaθelciume
μυγίτσα	miʝitsa
παυλάκησ	pavlacis
κοτίτσα	kotitsa
χαστουκίζω	xastucizo
χόρευ'	xoɾef
επιχαίρω	epiçero
αρρωστημένησ	arostimenis
οδηγόσ	oðiɣos
ειλημμένουσ	ilimenus
ωραίοσ	oɾeos
οικογενειοκρατία	ikoʝeniokɾatia
γκιλοτίνα	ɟilotina
κορίτσαροσ	koritsaros
χεσμένου	çezmenu
δρέπω	ðɾepo
καστοριά	kastoɾʝa
κλεισμένων	klizmenon
προηγούμενο	proiɣumeno
ηλιθιότητα	iliθiotita
τραβηγμένοσ	tɾaviɣmenos
ντελαπάρω	delapaɾo
χρονολόγησα	xronoloʝisa
ὑπογράφει	ipoɣrafi
αποφασίζω	apofasizo
αγγίζομαι	aŋɟizome
μαυρισμένα	mavrizmena
ξερόψωμων	kseropsomon
χάφτηκα	xaftika
κατάβαλλε	katavale
καθαρματάρα	kaθaɾmataɾa
καλομαθημένησ	kalomaθimenis
ματοβαμμένο	matovameno
άβλαπτοσ	avlaptos
βλαμμένο	vlameno
ομόλογο	omoloɣo
αλάλαξα	alalaksa
γαμάω	ɣamao
μούναροσ	munaɾos
διαμείφθηκα	ðiamifθika
πλάγιασα	plaʝasa
ισχυρίζομαι	isçiɾizome
ικανοποιημένη	ikanopiimeni
κουτόφραγκοσ	kutofɾaŋɡos
επετράπην	epetɾapin
ικετεύω	icetevo
σερβιρίζομαι	seɾviɾizome
ακατάδεκτοσ	akataðektos
σαββατοκύριακο	savatociɾʝako
ρωτούσα	ɾotusa
τούμπανο	tumbano
αμερική	americi
κούκοσ	kukos
χριστόψωμο	xristopsomo
ανωριμότητα	anoɾimotita
προετοιμάζω	pɾoetimazo
κοιτίδων	citiðon
μάτια	matça
ολόλευκοσ	ololefkos
έναρξη	enaɾksi
εορτάζομαι	eoɾtazome
ξύλα	ksila
ουλή	uli
θυμωμένα	θimomena
κινάω	cinao
ζητημένοσ	zitimenos
ρώταγα	ɾotaɣa
έκαμψα	ekampsa
μπουγιαμπέσα	buʝambesa
απετράπησαν	apetɾapisan
κορομηλιά	koɾomiʎa
βάροσ	varos
βίκυ	vici
κατάργησα	kataɾʝisa
κεσεμιού	cesemɲu
αρχιμαλάκασ	aɾçimalakas
γλυκόσ	ɣlikos
παραδεχτεί	paɾaðexti
πουτάνα	putana
ασκούμε	askume
ρεύομαι	ɾevome
χλιαρόσ	xliaros
μυτάκι	mitaci
γκαστρωμένησ	ɡastromenis
τσεκάρω	tsekaɾo
πτολεμαΐδα	ptolemaiða
στρατόσ	stɾatos
ασκάλαφοσ	askalafos
λυθήκανε	liθikane
πίθε	piθe
αναγνωρισμένησ	anaɣnorizmenis
μύξα	miksa
καρδιά	karðʝa
βρίσκομαι	vɾiskome
διψασμένοσ	ðipsazmenos
έγινα	eʝina
επισυνήφθην	episinifθin
βρέχω	vrexo
ιανουαρίου	ianuaɾiu
βυθισμένων	viθizmenon
εγκεφαλοκλάνι	eŋɡefaloklani
άρκτοσ	aɾktos
μνημών	mnimon
φιλί	fili
βρεφοκτονία	vɾefoktonia
αμπαρώνομαι	abaɾonome
ιουνίων	iunion
μιαίνομαι	mienome
δάπεδα	ðapeða
απορροφημένοσ	apoɾofimenos
αέρισα	aeɾisa
φρεσκάρισα	freskarisa
αθανασάκειοσ	aθanasacios
σπασμένουσ	spazmenus
μετατράπηκα	metatɾapika
αποστάζουμε	apostazume
αμοργόσ	amoɾɣos
σκορδόψωμο	skoɾðopsomo
καρφώνομαι	kaɾfonome
πρότρεψα	pɾotɾepsa
αγαπάω	aɣapao
χίοσ	çios
ανθέλληνασ	anθelinas
γαλοπούλα	ɣalopula
κατουριέμαι	katuɾʝeme
σιχτίρι	sixtiɾi
διαχύθηκα	ðiaçiθika
λύση	lisi
εγγραφτήκανε	eŋɣraftikane
γκομενίτσα	ɡomenitsa
ανακρίνομε	anakɾinome
εκκλησία	eklisia
μαρτυρούμε	maɾtiɾume
βέροια	veɾia
συνηθισμένε	siniθizmene
βδελύγματοσ	vðeliɣmatos
πιστεύτηκα	pisteftika
βασιλεία	vasilia
ανελκύομε	anelciome
ανευφημία	anefimia
αίαντασ	eandas
απομονωμένου	apomonomenu
διέκοψα	ðiekopsa
κραγμένε	kraɣmene
μεγαλειοτάτη	meɣaliotati
κρεμώ	kremo
βλάφτει	vlafti
φλίπερ	flipeɾ
περιπλέχθηκαν	peɾiplexθikan
αποδοκιμάζομαι	apoðocimazome
βαλσαμώνομαι	valsamonome
ἄρχομαι	arxome
αποδείχθηκα	apoðixθika
σημαίνω	simeno
ξύνομε	ksinome
αξιολογήσεων	aksioloʝiseon
βιάστηκα	vʝastika
πρώτοσ	pɾotos
εγγόνια	eŋɡoɲa
προηγουμένων	proiɣumenon
περασμένουσ	perazmenus
κακογαμημένησ	kakoɣamimenis
χαλασμένεσ	xalazmenes
αγιάζομαι	aʝiazome
λυμένεσ	limenes
τρομαγμένη	tɾomaɣmeni
αυγό	avɣo
μόρτησ	moɾtis
κάλυψα	kalipsa
προφητεύτηκα	pɾofiteftika
βόσκω	vosko
αγανακτισμένεσ	aɣanaktizmenes
κομμένουσ	komenus
παροτρύνουμε	paɾotɾinume
αγκωνιάστηκα	aŋɡoɲastika
νέμεσισ	nemesis
ανεκκαθάριστοσ	anekaθaɾistos
καδραρίστηκα	kaðɾaɾistika
ευγενία	evʝenia
αβανγκαρντισμούσ	avaŋɡaɾdizmus
αποφοιτώ	apofito
γύρισα	ʝiɾisa
μεσαιωνικόσ	meseonikos
ενάρξεισ	enaɾksis
απομονωμένουσ	apomonomenus
ακροβασία	akrovasia
καταλύομαι	kataliome
κόκκινοσ	kocinos
αλιεύω	alievo
χαϊδεύτηκα	xai̯ðeftika
ερρινισμόσ	erinizmos
χτύπαγα	xtipaɣa
νικημένου	nicimenu
ανασκάπτουμε	anaskaptume
αποκλεισμένησ	apoklizmenis
μαυροπούλια	mavropuʎa
ασελγήσ	aselʝis
λούφα	lufa
μαζικότατοι	mazikotati
τραγουδιστήσ	tɾaɣuðistis
ανταμείβω	andamivo
νοεμβρίων	noeɱvɾion
ντροπιασμένο	dɾopçazmeno
μεταφέρομε	metafeɾome
δοκίμασα	ðocimasa
υποψιάζομαι	ipopsiazome
απεραντολογία	apeɾandoloʝia
σιχάθηκα	sixaθika
ακοομετρίασ	akoometrias
ιόσ	ios
δημαρχία	ðimaɾçia
αβανγκαρντισμό	avaŋɡaɾdizmo
ισχύων	isçion
παράπαια	parapea
θαυμάστηκα	θavmastika
αβγοκομμένων	avɣokomenon
σημασία	simasia
ευσεβάστωσ	efsevastos
ακολουθάω	akoluθao
αγνάντιο	aɣnandʝo
φαρμακώνω	faɾmakono
θάλλω	θalo
μαγιονέζα	maʝoneza
επτά	epta
άγγειλα	aŋɟila
οκτακόσια	oktakosça
πειθαναγκάστηκα	piθanaŋɡastika
μετατρέπουμε	metatɾepume
συγγραφέωσ	siŋɣrafeos
μαθημένησ	maθimenis
απρίληδεσ	apɾiliðes
αποκεφαλίζω	apocefalizo
επιμελητέσ	epimelites
συνέγραψα	sineɣrapsa
φυλάσσομαι	filasome
υπολογιστικοί	ipoloʝistici
φοροαποφυγή	foɾoapofiʝi
στέλλω	stelo
ποδόγυροσ	poðoʝiɾos
φλεβάρηδεσ	flevaɾiðes
σπασμένων	spazmenon
αποσπάστηκα	apospastika
χεσμένα	çezmena
καθισμένουσ	kaθizmenus
παραπέμπομε	paɾapembome
τυλίχτηκα	tilixtika
κοινωνώ	cinono
κλίνομε	klinome
ανεκόπην	anekopin
αποκόπτουμε	apokoptume
καταπολεμούμε	katapolemume
κληρονόμοσ	kliɾonomos
αγαθοεργία	aɣaθoeɾʝia
συνάφθηκα	sinafθika
ανασκάβω	anaskavo
ανταποκρίνομαι	andapokɾinome
τήνοσ	tinos
πείθω	piθo
αθωώθηκα	aθooθika
ἀποκυημάτων	apociimaton
ρωτήθηκα	ɾotiθika
παρφουμάρω	paɾfumaɾo
ίπταμαι	iptame
σοφότερου	sofoteɾu
επανειλημμένα	epanilimena
τσεκάριζε	tsekaɾize
μουσκεμένο	muscemeno
δαγκώθηκα	ðaŋɡoθika
υδράργυροσ	iðɾaɾʝiɾos
ποικιλότατουσ	picilotatus
ερώτησα	eɾotisa
διεγείρομαι	ðieʝiɾome
συγγραφῆσ	siŋɣrafis
έστεψα	estepsa
αλλαξοπίστισα	alaksopistisa
άσεβο	asevo
αγαντάριζε	aɣandarize
λέγομε	leɣome
ευσέβεια	efsevia
ψηφιακή	psifiaci
αλατισμένε	alatizmene
βάλλετε	valete
ἀπασχολῶ	apasxolo
συγκινημένο	siŋɟinimeno
πειθανάγκασα	piθanaŋɡasa
σοροί	soɾi
γκαστρώνω	ɡastɾono
επιχειρήθηκα	epiçiriθika
ασέβεια	asevia
αιγόκερωσ	eɣoceɾos
στενοχωρημένησ	stenoxorimenis
κουνουπίδι	kunupiði
σημειώθηκα	simioθika
κατούρησα	katuɾisa
αληθεύω	aliθevo
βελτιώσεισ	veltiosis
αναστηλώνω	anastilono
τραγουδημένοσ	tɾaɣuðimenos
κατήντησα	katindisa
εμπερικλείομε	emberikliome
νιάου	ɲau
κοινόλεκτε	cinolekte
πόρνη	poɾni
οδηγημένοσ	oðiʝimenos
φιλολογίασ	filoloʝias
διαδέχομαι	ðʝaðexome
ανεφοδιάζω	anefoðiazo
αποσαθρώνω	aposaθɾono
στενοχωρήθηκα	stenoxoriθika
περιεπλάκη	peɾieplaci
κουτόσ	kutos
ιπτάμενοσ	iptamenos
ευσεβέσ	efseves
σαλτάριζε	saltaɾize
ερρινοποιήσεισ	erinopiisis
καταντάω	katandao
ανέκραξα	anekraksa
κινούμε	cinume
στεναχωριέμαι	stenaxorʝeme
θεσσαλονικιώτικοσ	θesalonicotikos
αναπαύομαι	anapavome
φασουλιών	fasuʎon
ανέξοδοσ	aneksoðos
αναστρέφουμε	anastɾefume
αποκρούουμε	apokruume
άγιε	aʝie
διαβάζω	ðʝavazo
αληθείσ	aliθis
ποικιλότερησ	piciloteris
γεράματα	ʝeɾamata
κώδικασ	koðikas
μοναξιά	monaksça
συσσωρεύθηκα	sisoɾefθika
υπεύθυνοσ	ipefθinos
λάτρα	latɾa
αγκίδι	aŋɟiði
ελλάσ	elas
υποδεκανέασ	ipoðekaneas
αδίκησα	aðicisa
ωσαννά	osana
σάλευε	saleve
καθέλκυσα	kaθelcisa
αγιοκέρι	aʝoceri
οινόπνευμα	inopnevma
ανιψούλεσ	anipsules
γάμησα	ɣamisa
πειράζει	piɾazi
δημιουργώ	ðimiuɾɣo
αλλαξοπίστησα	alaksopistisa
σοκάκι	sokaci
στιμμένοι	stimeni
περιπλέχθηκα	peɾiplexθika
διαίρεσα	ðieɾesa
αραχνιάζω	aɾaxɲazo
πέθανε	peθane
μόναχο	monaxo
ανευρίσκω	anevɾisko
διαλελυμένων	ðialelimenon
μήλο	milo
μακάβριοσ	makavɾios
θλιβερέ	θliveɾe
πίθο	piθo
παύθηκα	pafθika
καθιδρύω	kaθiðrio
αναγνώστησ	anaɣnostis
στιμμένουσ	stimenus
βεγγαλικό	veŋɡaliko
άνδρε	anðɾe
μανταρινιά	mandaɾiɲa
φίλαγα	filaɣa
τυροκόμοσ	tiɾokomos
επανιδρύθηκα	epaniðriθika
ερρινότητασ	erinotitas
έλυναν	elinan
πακεταρίστηκα	pacetaɾistika
συγκρουόμενεσ	siŋɡruomenes
υιοθετώ	ioθeto
βιβλιοθήκη	vivlioθici
ξελογιάζω	kseloʝazo
λευκήσ	lefcis
κλιμακώνομαι	klimakonome
ικέτεψα	icetepsa
λευκέσ	lefces
πλέον	pleon
συνήθησ	siniθis
βάλω	valo
αυτή	afti
γεννημένοσ	ʝenimenos
ντροπιαστικά	dɾopçastika
περιπλέκομαι	peɾiplekome
επικράτεια	epikratia
ευκολάκι	efkolaci
κατάστρεψα	katastɾepsa
αποκάλυψη	apokalipsi
ντελιβερά	delivera
κόκκινε	kocine
φλεβάρηδων	flevaɾiðon
γκόμενοσ	ɡomenos
λάμπα	lamba
αλληλοσυγκρουόμενεσ	alilosiŋɡruomenes
μάζεψα	mazepsa
αποκαθίσταμαι	apokaθistame
προφήτευσα	pɾofitefsa
μπανιερούλα	baɲeɾula
πελώριοσ	pelorios
αλυσοδεμένο	alisoðemeno
καλαμάτα	kalamata
μισιέμαι	misçeme
στριμμένα	stɾimena
βάλαμε	valame
αγγελούδι	aŋɟeluði
καταφέρνομαι	katafeɾnome
γητεύτηκα	ʝiteftika
αμφισβητούμε	aɱfisvitume
λιάζομαι	ʎazome
μαθημένων	maθimenon
αλληλοσυγκρουόμενου	alilosiŋɡruomenu
γούσταρα	ɣustaɾa
στριμμένου	stɾimenu
μεσαιωνικοί	meseonici
βλαμμένοι	vlameni
αναγνωσιμότητα	anaɣnosimotita
χέρι	çeɾi
βεβαιώσω	veveoso
φαρμακείο	farmacio
αεροφωτογραφίζομαι	aerofotoɣrafizome
εξοπλισμένουσ	eksoplizmenus
αναγνωρισμένο	anaɣnorizmeno
βρίσκω	vɾisko
έρρινε	erine
βάφηκα	vafika
απορροφάω	aporofao
έφτυσα	eftisa
καταβάλουμε	katavalume
πίνετε	pinete
συγκρούσθηκα	siŋɡrusθika
νεκροκρέβατο	nekɾokɾevato
παίδεψα	peðepsa
ιανουάριο	ianuaɾio
νταβατζήσ	davadzis
διαιρέθηκα	ðieɾeθika
αλαμπουρνέζικεσ	alaburnezices
ακοινωνησιάσ	acinonisças
ανακαινίζω	anacenizo
κακίστρων	kacistɾon
μουσκεμένησ	muscemenis
φωνάζω	fonazo
κάθαρμα	kaθaɾma
ανατρέπομαι	anatɾepome
παρεκτρέπομε	paɾektɾepome
δυόμισι	ðʝomisi
αναζήτησα	anazitisa
απλούστατοσ	aplustatos
ηχώσ	ixos
αναστρέφομαι	anastɾefome
κουλουριάζομαι	kuluɾʝazome
συνέθλιψα	sineθlipsa
γονυπετήσ	ɣonipetis
φόρεσα	foɾesa
ανακόπτομε	anakoptome
μπάρκαρε	baɾkaɾe
προμηθεύομαι	pɾomiθevome
θερμοδυναμικά	θermoðinamika
ακοινωνησίεσ	acinonisies
αντιφρονών	andifronon
τραγούδησα	tɾaɣuðisa
αλαμπουρνέζικων	alaburnezikon
κλαρινογαμπρόσ	klaɾinoɣambɾos
μετέφρασα	metefɾasa
σταμάτησα	stamatisa
καλύπτομε	kaliptome
βίβλοσ	vivlos
τριάκοντα	tɾiakonda
αναπνέω	anapneo
παρηγοριάσ	paɾiɣoɾʝas
αποκλεισμένε	apoklizmene
αναισθησία	anesθisia
ντετερμινισμού	determinizmu
σβηστήρια	zvistiɾʝa
ένδεκα	enðeka
εγγλέζα	eŋɡleza
γνώσησ	ɣnosis
ντουμπλάρω	dublaɾo
γουρούνι	ɣuɾuni
χάλασα	xalasa
γκρίνια	ɡɾiɲa
υποδεχτεί	ipoðexti
τελῶ	telo
καθισμένοσ	kaθizmenos
αγιοποιημένε	aʝiopiimene
ιανουάριοι	ianuaɾii
φορώ	foɾo
καραμπόλα	kaɾambola
αναγκών	anaŋɡon
κόρινθο	koɾinθo
χωριάτησ	xoɾʝatis
μαστίζω	mastizo
καρέκλα	kaɾekla
χεσμένε	çezmene
νικημένοι	nicimeni
φουσκάλα	fuskala
αναμμένοι	anameni
μουντοί	mundi
λιμπίστηκα	limbistika
παραβάλω	paɾavalo
αδρανήσ	aðɾanis
φράουλα	fɾaula
μπαγκέτα	baɟeta
χαίτη	çeti
αναμειγνύομαι	anamiɣniome
καλομαθημένεσ	kalomaθimenes
καταφρονημένοσ	katafɾonimenos
μιλώ	milo
ανέκαμψα	anekampsa
διψασμένε	ðipsazmene
θεότρελοσ	θeotɾelos
εφηύρα	efivɾa
ιουδαίοσ	iuðeos
σάπιοσ	sapços
πολωνικών	polonikon
κεριού	cerʝu
συγκινημένοι	siŋɟinimeni
μαλώνοντασ	malonondas
σπιλώνω	spilono
απέπνευσα	apepnefsa
πάμμαυρου	pamavɾu
ιματιοθήκη	imatioθici
προηγουμένουσ	proiɣumenus
ξερόλα	kseɾola
στιγματίζομαι	stiɣmatizome
εκλήθη	ekliθi
ζημιώνω	zimiono
τάχατε	taxate
αναγκάστηκα	anaŋɡastika
ακρεωφαγία	akɾeofaʝia
οπερέτα	opeɾeta
βαθμολογημένε	vaθmoloʝimene
συγκινητικόσ	siŋɟinitikos
ευκαιρία	efceria
παρέπαιον	parepeon
παιδιά	peðia
κυρούλα	cirula
εγκαθιδρύθηκα	eŋɡaθiðriθika
αγιοποιημένου	aʝiopiimenu
ανθρωπεύομαι	anθɾopevome
πλειοψηφιών	pliopsifion
μαντεία	mandia
μιζούρι	mizuɾi
κινεζοποιήσεισ	cinezopiisis
εξοπλισμένησ	eksoplizmenis
ζαμπόν	zambon
λίγο	liɣo
μαθημένο	maθimeno
ιούνιοι	iunii
πεινασμένων	pinazmenon
τρομοκρατία	tɾomokɾatia
αβγοθήκη	avɣoθici
γιάννησ	ʝanis
εμπνευσμένο	embnevzmeno
πυρών	piɾon
ακροαματικότητα	akɾoamatikotita
σερβιέτα	seɾvieta
συνόρων	sinoron
περιστρέφομαι	peɾistɾefome
διανύουμε	ðianiume
ενόχληση	enoxlisi
κοινολεξία	cinoleksia
φραγκοφονιάσ	fɾaŋɡofoɲas
ήπιεσ	ipies
ήρα	ira
ευαγγελίσθηκα	evaŋɟelisθika
απομονωμένων	apomonomenon
ανασκάπτομαι	anaskaptome
φουμάριζα	fumaɾiza
επισείω	episio
λάλησα	lalisa
μπαράζ	baɾaz
γάδαροσ	ɣaðaɾos
μετέχω	metexo
λιγότερα	liɣotera
επιτρέπεται	epitɾepete
ίδρυσα	iðrisa
ξεπροβάλλω	ksepɾovalo
καταδιώχθηκα	kataðioxθika
ικανοποιημένοι	ikanopiimeni
τησ	tis
μουνόπανο	munopano
ορθογραφία	oɾθoɣɾafia
προστατεύομαι	pɾostatevome
ακούγομαι	akuɣome
βουβαλιών	vuvaʎon
συριζα	siɾiza
τριμμένων	trimenon
παραδεκτοί	paɾaðekti
συγγράφει	siŋɣrafi
ανασκάπτω	anaskapto
αναμαλλιασμένου	anamaʎazmenu
επιτράπηκα	epitɾapika
διημείφθη	ðiimifθi
αναγγελμένοσ	anaŋɟelmenos
ενηλικιώθηκα	enilicioθika
ιδρύματα	iðrimata
γκρίζων	ɡɾizon
ρεζιλεύομαι	ɾezilevome
κρυμμένο	krimeno
μαγικόσ	maʝikos
υποχρεώνω	ipoxɾeono
διαρρέουμε	ðʝareume
εγκαταλείφτηκα	eŋɡataliftika
κετσέσ	ketses
φώνημα	fonima
αποκλείομε	apokliome
απαρχαιωμένου	aparçeomenu
αγάνταρε	aɣandare
καθορίστηκα	kaθoɾistika
ρετσίνα	ɾetsina
επηρεάζομαι	epiɾeazome
ακροβατούσα	akɾovatusa
τίνι	tini
λεβαδειά	levaðʝa
υπέγραψα	ipeɣrapsa
ελβετικόσ	elvetikos
πότε	pote
δημιουργόσ	ðimiuɾɣos
τρίζω	trizo
αναλυτήσ	analitis
επωμίζομαι	epomizome
γαργαλώ	ɣaɾɣalo
επανόρθωση	epanorθosi
πανταχού	pandaxu
ψάχνομαι	psaxnome
ανθρωπόκαινοσ	anθɾopocenos
λέμε	leme
χάνομαι	xanome
αποπέμπουμε	apopembume
ξένησ	ksenis
οραματίζομαι	oɾamatizome
χάφτεται	xaftete
σταματάω	stamatao
πιονιών	pçoɲon
αποκόβουμε	apokovume
δράκαινα	ðɾacena
περιορισμένοσ	peɾioɾizmenos
αφοδεύω	afoðevo
απρίλιοσ	apɾilios
χλιεσ	xʎes
απατιέμαι	apatçeme
εκλεράκι	ekleɾaci
αντιγράφομαι	andiɣrafome
απελπισμένοι	apelpizmeni
τεχνολόγε	texnoloʝe
ζητιέμαι	zitçeme
μπόλικοσ	bolikos
νοσοκομείο	nosokomio
στενοχωρημένο	stenoxorimeno
επισυνάφθηκε	episinafθice
αναμένεισ	anamenis
αρχίδαμοσ	aɾçiðamos
γαζία	ɣazia
ένρινησ	enrinis
ώσπερ	ospeɾ
παρακείμενοσ	paɾacimenos
προηγούμενη	proiɣumeni
περιέθαλψα	peɾieθalpsa
μπιχλιμπίδι	bixlibiði
ερμίνα	eɾmina
αδελφομάνα	aðelfomana
φυλάγομαι	filaɣome
διαλυμένουσ	ðʝalimenus
λιόψωμα	ʎopsoma
σφυρί	sfiri
αποκερματισμοί	apoceɾmatizmi
δήμητρασ	ðimitras
κόλλησα	kolisa
πασαλείφω	pasalifo
μαυρισμένων	mavrizmenon
ακοέσ	akoes
παρακειμένου	paracimenu
μέσα	mesa
τρέπομε	tɾepome
πεπεισμένοι	pepizmeni
εκκρούσθηκα	ekrusθika
κωσταντίνου	kostandinu
ονειρεύτηκα	oniɾeftika
αρνιούμαι	aɾɲume
παραγραφήκανε	paɾaɣɾafikane
κανακεύω	kanacevo
ραγιάσ	ɾaʝas
τραπέζια	tɾapezʝa
πεθαμένε	peθamene
περιέκοψα	peɾiekopsa
ξεγράφομαι	kseɣrafome
καλομαθημένουσ	kalomaθimenus
διαλελυμένοσ	ðialelimenos
αναδέχθηκα	anaðexθika
αβανγκαρντισμών	avaŋɡaɾdizmon
βρομάω	vɾomao
ντετερμινισμέ	determinizme
φωτογραφείου	fotoɣrafiu
κόπτομαι	koptome
εμβολιάζω	eɱvoliazo
εγγράφτηκα	eŋɣɾaftika
υιοθετούμε	ioθetume
εμπερικλείστηκα	emberiklistika
χειρομαντεία	çiɾomandia
ήντα	inda
στρατόπεδα	stɾatopeða
επαρχίασ	epaɾçias
πιθαριών	piθarʝon
ξεριζώθηκα	kseɾizoθika
σωκράτησ	sokɾatis
ινάτι	inati
δούλη	ðuli
παρεμποδίζω	paremboðizo
σεπτέμβρηδων	septeɱvɾiðon
λυθούν	liθun
κατουρώ	katuɾo
αλληλεπιδρώ	alilepiðɾo
εγχέομαι	eŋçeome
αποβλέπω	apovlepo
διατυπώνομαι	ði̯atiponome
άρτα	aɾta
αποκατέστησα	apokatestisa
φτύστηκα	ftistika
εξολόθρεψα	eksoloθɾepsa
ετοιμασιών	etimasion
οχάιο	oxaio
αποκρύβω	apokɾivo
ευσεβείασ	efsevias
επέσεισα	epesisa
ιωάννινα	ioanina
παγωμένε	paɣomene
πάτρα	patɾa
φυτικοί	fitici
πειθόμενων	piθomenon
λακώνων	lakonon
απλότητα	aplotita
φαινυλαμίνη	fenilamini
σπασμένου	spazmenu
κατακάθι	katakaθi
κουτσομπόλα	kutsobola
υπέσκαψα	ipeskapsa
κλίση	kʎisi
αθροίζομαι	aθɾizome
απεκόπην	apekopin
ζημίωσα	zimiosa
συμπλέω	simbleo
κότα	kota
αποστειρώθηκα	apostiɾoθika
περήφανοσ	perifanos
λέω	leo
ακομπανιάρομαι	akompaɲaɾome
παραστέκω	parasteko
κυβέρνησα	civeɾnisa
αποκαλύφτηκα	apokaliftika
αιματώθηκα	ematoθika
καταδύομαι	kataðiome
εἰσέπλευσα	iseplefsa
έλκω	elko
δαγκώσει	ðaŋɡosi
αρετή	areti
βέρα	veɾa
ένατοσ	enatos
χορταίνω	xoɾteno
βαυαρία	vavaria
ξεκωλιάζω	ksekoʎazo
κεσέμι	cesemi
σεπτέμβριο	septeɱvɾio
ιερόδουλη	ieɾoðuli
συγγνώμη	siŋɣnomi
θέματα	θemata
περίοικοσ	periikos
γαμιόλα	ɣamɲola
συναιρέσεων	sinereseon
χίε	çie
βρήκε	vɾice
άκαρποσ	akaɾpos
ηλίθιοσ	iliθios
αγίασα	aʝiasa
στειμμένοσ	stimenos
μπερδεμένοσ	beɾðemenos
κουραστικόσ	kurastikos
χρονολογούμαι	xronoloɣume
εξετάζομαι	eksetazome
κλάδεψα	klaðepsa
λιτότητα	litotita
επιτράπηκαν	epitɾapikan
τριμμένα	trimena
παγωμένεσ	paɣomenes
στυμμένεσ	stimenes
στριμμένοι	stɾimeni
κακίστρασ	kacistɾas
ανάποδοσ	anapoðos
ανακλάστηκα	anaklastika
θήβα	θiva
ολόφωτη	olofoti
αποπνέω	apopneo
αβγοκομμένουσ	avɣokomenus
βρόμικα	vɾomika
ανευρίσκουμε	anevɾiskume
σκληρή	skliri
αντλούμαι	andlume
αλάνα	alana
γελάω	ʝelao
ήγγελλα	iŋɟela
τούμπανο	tubano
ηγεμονεύω	iʝemonevo
ευνοιοκρατία	evniokɾatia
αξιοζήλευτοσ	aksiozileftos
ζηλευτόσ	zileftos
απασχολήθηκα	apasxoliθika
παρών	paɾon
αναδημιουργημένοσ	anaðimiurʝimenos
σπασμένη	spazmeni
συρρέω	sireo
φανταστική	fandastiçi
χαϊδεύομαι	xai̯ðevome
μελίγκρα	meliŋɡɾa
εξαπολύομαι	eksapoliome
ἀνιδρύομαι	aniðriome
λάρισα	larisa
τσέκαρε	tsekaɾe
κιμωλία	cimolia
προηγουμένη	proiɣumeni
ανακρούομε	anakruome
περασμένο	perazmeno
ομολογούμε	omoloɣume
διαδεχθεί	ði̯aðexθi
φυτικέσ	fitices
φεβρουάριοσ	fevɾuaɾios
φακόσ	fakos
απατώμαι	apatome
αγυιόπαιδασ	aʝiopeðas
φωτογραφίζουμε	fotoɣrafizume
υστερώ	isteɾo
κύπελλο	cipelo
παθαίνομαι	paθenome
εκατομμύριο	ekatomiɾio
υστέρησα	isteɾisa
άγγελου	aŋɟelu
οδούσ	oðus
αλατισμένουσ	alatizmenus
γενέσθαι	ʝenesθe
πουδράριζε	puðɾaɾize
περιμένω	perimeno
πορνεία	poɾnia
άσεβοι	asevi
ξεκωλώνω	ksekolono
καθιδρύουμε	kaθiðriume
λύσαν	lisan
μανταρίνι	mandaɾini
κελαϊδάω	celaiðao
αρρωστημένουσ	arostimenus
κυνηγημένουσ	ciniʝimenus
φιλολογιών	filoloʝion
ιταλικό	italiko
ψέλνω	pselno
κατάλογο	kataloɣo
κρεμασμένα	kremazmena
ορισμένοσ	oɾizmenos
κοκκινιστό	kocinisto
κωλύθηκα	koliθika
επρόκειτο	epɾocito
αγιασματάρια	aʝazmataria
διαβεβαιώσεισ	ði̯aveveosis
ιδρύθηκα	iðriθika
θεωρείο	θeoɾio
επτακόσια	eptakosça
θάβομαι	θavome
επίδαυρο	epiðavɾo
σερβίρω	seɾviɾo
διασκελίζω	ðiascelizo
φωτογραφίσεισ	fotoɣrafisis
παροιμία	paɾimia
αδελφόσ	aðelfos
ήλιοσ	ilios
δυνατόν	ðinaton
αγιοποιώ	aʝiopio
παναγιά	panaʝa
εννιακόσια	eɲakosça
μποϊκοτάρομαι	boikotaɾome
περικλείστηκα	periklistika
άλγεβρα	alʝevɾa
παλιατζήσ	paʎadzis
ηδύποτο	iðipoto
κόρινθε	koɾinθe
πλέχτηκα	plextika
πορνόγεροσ	poɾnoʝeɾos
αναβαλλόμενο	anavalomeno
κωλόπαιδο	kolopeðo
κοτέτσι	kotetsi
ερχόμενη	erxomeni
επέπλευσα	epeplefsa
πλέκομε	plekome
παντρεμένε	pandɾemene
πέμφθηκα	pemfθika
ξαναέγραψα	ksanaeɣɾapsa
ερχομένων	erxomenon
γρηγόριοσ	ɣriɣorios
ράβω	ɾavo
ακοόμετρο	akoometro
μυγούλα	miɣula
αντέτι	adeti
συγχωρούμαι	siŋxoɾume
ταχύτητα	taçitita
ανιχνεύτηκα	anixneftika
απομονωμένοι	apomonomeni
κραγμένεσ	kraɣmenes
αναζητημένοσ	anazitimenos
προσείλκυσα	prosilcisa
απέβλεψα	apevlepsa
χέστρα	çestɾa
πίστεψε	pistepse
υποβοηθούμενοσ	ipovoiθumenos
βοσκώ	vosko
εμπνέω	embneo
ράβομαι	ɾavome
συγκρουόμενησ	siŋɡruomenis
αηδιάζω	aiðiazo
πισωκολλητό	pisokolito
ναυσ	nafs
αμοιβάδα	amivaða
αμφιλεγόμενουσ	aɱfileɣomenus
διάρκεσα	ðiaɾcesa
απομονωμένο	apomonomeno
βαστάω	vastao
αγγιγμένησ	aŋɟiɣmenis
ακρωτηριάζω	akɾotiɾiazo
ενδέχεται	enðeçete
ανακρούουμε	anakruume
πλησιάζομε	plisiazome
ειλημμένου	ilimenu
τάφρο	tafro
βιολί	vʝoli
παρουσίασα	paɾusiasa
χεσμένοι	çezmeni
μονάρχη	monarçi
υποβοηθούμενουσ	ipovoiθumenus
ετάφην	etafin
ναυσικάσ	nafsikas
έδεσσα	eðesa
τάλαντο	talando
ψιλό	psilo
αβαράριζα	avaɾaɾiza
νεοελληνική	neoelinici
ολόφωτοσ	olofotos
αξιολόγηση	aksioloʝisi
νεκροί	nekɾi
ζώδιο	zoðio
εργοδότησ	eɾɣoðotis
μαραίνω	maɾeno
ἀντιγραφείσ	andiɣɾafis
ανέμενεσ	anemenes
βιβλιοπωλείο	vivliopolio
προσήλθα	prosilθa
βεβαιώθηκα	veveoθika
βραχυκυκλώνω	vɾaçiciklono
άβλαφτοσ	avlaftos
κάμπτουμε	kamptume
κλαδεύω	klaðevo
κάνοντασ	kanondas
αγγελοκρούομε	aŋɟelokruome
ενημερώσεωσ	enimeroseos
έπεισα	episa
προμηθεύθηκα	pɾomiθefθika
προαγωγή	pɾoaɣoʝi
αρετήσ	aretis
ανανήφω	ananifo
συνεχάρησαν	sinexaɾisan
αποτραβάω	apotɾavao
ρεζιλεύτηκα	ɾezileftika
παραβύστω	paravisto
εξεγείρομαι	ekseʝiɾome
ανάπλι	anapli
στρίβω	stɾivo
κουρασμένησ	kurazmenis
επείγον	epiɣon
καλαμποκόψωμων	kalambokopsomon
στολίζομαι	stolizome
χειλιών	çiʎon
λησμονάω	lizmonao
κομμένα	komena
ανειδοποίητοσ	aniðopiitos
στειρώνομαι	stiɾonome
γιατρεύω	ʝatɾevo
μετάφερε	metafeɾe
μέδουσα	meðusa
εισάκουσα	isakusa
μεταπτώσεωσ	metaptoseos
διέθλασα	ði̯eθlasa
εφοδίασα	efoðiasa
εθνεγερσία	eθneʝersia
οδοί	oði
κολύμπαγα	kolimbaɣa
νοικιάστηκα	nicastika
ακάματοσ	akamatos
μένε	mene
γονυπετούσ	ɣonipetus
τρυγόνεσ	triɣones
επικαλύπτομε	epikaliptome
διαβεβαιώθηκα	ði̯aveveoθika
γιατρόσ	ʝatros
φρανκφούρτη	fraŋkfurti
δολοφονούμε	ðolofonume
συμφώνησα	siɱfonisa
προειδοποιούμαι	pɾoiðopiume
πατεράδεσ	pateraðes
ξινίλα	ksinila
νεκροθάλαμοσ	nekɾoθalamos
ζευσ	zefs
εξαλείφτηκα	eksaliftika
δακτυλογραφούμαι	ðaktiloɣɾafume
εξαίρομαι	ekserome
νικημένα	nicimena
τέλι	teli
τσακωνικών	tsakonikon
σαλαμίνα	salamina
αντίπαροσ	andipaɾos
επιτρέπομε	epitɾepome
πλειοψηφίασ	pliopsifias
σέρνω	serno
υποδημάτων	ipoðimaton
παντρεμένη	pandɾemeni
περιστρέφομε	peɾistɾefome
ναυτολογίου	naftoloʝiu
αποτράπηκα	apotɾapika
ντροπή	dɾopi
λύσω	liso
δαγκώνω	ðaŋɡono
κόκκινου	kocinu
γκομενάκι	ɡomenaci
επανιδρύουμε	epaniðriume
εμπερικλείουμε	emberikliume
μαλάκω	malako
γρηγόρηδεσ	ɣɾiɣoɾiðes
πουλερικό	puleriko
καθελκύομαι	kaθelciome
πουδράρισα	puðɾaɾisa
έρρινων	erinon
γαρίδα	ɣaɾiða
κετσέδεσ	ketseðes
εβδομήντα	evðominda
περιπλεχτήκανε	peɾiplextikane
συμφωνημένοσ	siɱfonimenos
λεσ	les
αποβάλλω	apovalo
συνθλιφτήκανε	sinθliftikane
συνοριοφύλακασ	sinoriofilakas
μπογιατζήσ	boʝandzis
κορόμηλο	koɾomilo
κουράδασ	kuɾaðas
πολωνόσ	polonos
πεισμένοι	pizmeni
κολυμπούσα	kolimbusa
ξεκωλιάρα	ksekoʎaɾa
χάβω	xavo
αλήστευτοσ	alisteftos
άκησ	acis
έπαιξα	epeksa
κερδίζω	cerðizo
μπουζί	buzi
ηλικιωμένησ	iliciomenis
γιαννάκησ	ʝanacis
ζητούμε	zitume
γλυκισμάτων	ɣlicizmaton
καβάλα	kavala
ήταν	itan
γιατρεία	ʝatɾia
εμμανουήλ	emanuil
πρωτοανακαλύπτω	pɾotoanakalipto
παρεγράφησαν	paɾeɣɾafisan
σώσε	sose
πέμπομε	pembome
εξελέγην	ekseleʝin
ελάφι	elafi
κουρεύω	kuɾevo
εορτάζω	eoɾtazo
αλφάδιασα	alfaðʝasa
ειλημμένε	ilimene
θεοτόκου	θeotoku
επίκειται	epicite
λογίζομαι	loʝizome
προμηθέασ	promiθeas
διορθώνω	ði̯oɾθono
πεισμένα	pizmena
επισυνάπτομαι	episinaptome
χρονολογία	xronoloʝia
ανιχνεύω	anixnevo
κοτούλα	kotula
γιάννενα	ʝanena
βαλσαμώνω	valsamono
νοστιμεύομαι	nostimevome
παύλοσ	pavlos
ανακατώνομαι	anakatonome
καλημέρα	kalimera
αγαντάρισα	aɣandarisa
υπερκαινοφανείσ	ipeɾcenofanis
πανεύκολοσ	panefkolos
μαθεύομαι	maθevome
αμφιβάλλω	aɱfivalo
αρρωστημένοι	arostimeni
ντίνοσ	dinos
καίγω	ceɣo
μαρκίων	marcion
συσκέφθηκα	siscefθika
κουμπώνομαι	kumbonome
προμήνυσα	prominisa
καινοτομία	cenotomia
μάησ	mais
στάχτηκα	staxtika
ξενοδοχείο	ksenoðoçio
λογίστηκα	loʝistika
ζητιανέψτε	zitçanepste
προκαταβάλουμε	pɾokatavalume
αιματοβαμμένεσ	ematovamenes
άθροισα	aθɾisa
αηδιαστικά	aiðʝastika
τετρακόσια	tetɾakosça
θερμοδυναμικών	θermoðinamikon
απομονώθηκα	apomonoθika
δεκεμβρίουσ	ðeceɱvɾius
ανακινώ	anacino
εόρτασα	eoɾtasa
εγώ	eɣo
συνεργάζομαι	sineɾɣazome
νταραβερίστηκα	daɾaveɾistika
χεσμένη	çezmeni
έλυνεσ	elines
κατουρλιό	katuɾʎo
αερίζω	aeɾizo
φάντασμα	fandazma
αληθεύομαι	aliθevome
κάτασπροι	kataspɾi
αναλογίστηκα	analoʝistika
γραικόσ	ɣrekos
ανοησία	anoisia
γραφειοκρατία	ɣɾafiokɾatia
ταχυδρόμοσ	taçiðɾomos
αγγαρεύτηκα	aŋɡaɾeftika
αναγνωρισμένη	anaɣnorizmeni
πιάνομαι	pçanome
αποζημιώνομαι	apozimionome
τύλιξα	tiliksa
πολυτελήσ	politelis
παρηγορούμαι	paɾiɣoɾume
θεωρούμαι	θeorume
πορτοκάλι	poɾtokali
διακόπηκα	ðiakopika
οκτώβριοσ	oktovɾios
αστυφύλακασ	astifilakas
ζεσταμένοσ	zestamenos
εμπνεύσθηκα	embnefsθika
τρέπουμε	tɾepume
αναμελιών	anameʎon
παραγραφήκαν	paɾaɣɾafikan
αποστάξεισ	apostaksis
πολωνικόσ	polonikos
γλείφω	ɣlifo
μεσαιωνικέ	meseonice
πρήζω	pɾizo
οκτώβριο	oktovɾio
κορίτσαρε	koritsare
λαλούμαι	lalume
καργαδούρησ	karɣaðuris
εγείρομαι	eʝiɾome
συνεχάρην	sinexarin
κουτσόσ	kutsos
αεροφωτογραφήθηκα	aerofotoɣrafiθika
πιέζω	piezo
ξενιτιών	ksenitçon
αντικλεπτικήσ	andiklepticis
χαλασμένων	xalazmenon
αλάνι	alani
σωματικόσ	somatikos
απόλυσα	apolisa
αναρμόδιοσ	anaɾmoðios
εμβολίου	eɱvoliu
κόκκινη	kocini
ντροπιασμένε	dɾopçazmene
προκαταβάλλομε	pɾokatavalome
διακόπτομε	ðʝakoptome
παρφουμαρίζω	paɾfumaɾizo
βλάμησ	vlamis
διαδέχτηκα	ði̯aðextika
γιάντα	ʝanda
απαιτούμε	apetume
ζάχαρη	zaxari
προσελκύστηκα	proselcistika
βασίλεψε	vasilepse
αηδιασμένεσ	aiðiazmenes
αγρυπνισμένοσ	aɣɾipnizmenos
πανέμορφοσ	panemoɾfos
μαζεμένοσ	mazemenos
τέρπω	teɾpo
κακίστρωσ	kacistɾos
αναμμένο	anameno
φαρμακώθηκα	faɾmakoθika
εγερθήκανε	eʝeɾθikane
καστανιά	kastaɲa
μελβούρνη	melvurni
συνετρίβη	sinetɾivi
γκάιντα	ɡaida
εκχέω	ekçeo
τσακωνικήσ	tsakonicis
διάδοχοσ	ðiaðoxos
αεροφωτογραφήσεισ	aerofotoɣrafisis
αναγεννήθηκα	anaʝeniθika
νικημένο	nicimeno
παπάρα	papaɾa
θλιμμένουσ	θlimenus
κεκλεισμένησ	ceklizmenis
χριστόψωμου	xristopsomu
δάγκασα	ðaŋɡasa
ανέκλασα	aneklasa
ισοδυναμώ	isoðinamo
τετριμμένοσ	tetrimenos
κάπνισα	kapnisa
εκκολάφτηκα	ekolaftika
παρακοιμάμαι	paɾacimame
παραδεχτόσ	paɾaðextos
λογαριασμόσ	loɣaɾʝazmos
εκκενώνομαι	ecenonome
ενδιέφερα	enði̯efeɾa
ανατίναξα	anatinaksa
λυθήκαν	liθikan
ακυρώσεων	aciɾoseon
ανάκλασα	anaklasa
πλακώνω	plakono
μάιο	maio
ευσέβειασ	efsevias
υποδήματοσ	ipoðimatos
λόγο	loɣo
θερμοδυναμικήσ	θermoðinamicis
αμνηστεύομαι	amnistevome
γίγαντασ	ʝiɣadas
κολλούσα	kolusa
κινεζικά	cinezika
μεσαιωνικά	meseonika
υποχρέωση	ipoxɾeosi
αδικούμαι	aðikume
ζητῶ	zito
ιούλησ	iulis
νεκροθάφτησ	nekɾoθaftis
αμαθειών	amaθion
προαλείφουμε	pɾoalifume
ανετράπην	anetɾapin
αντιμετωπίζομαι	andimetopizome
ακταιωρέ	akteore
λαιστρυγών	lestriɣon
παρηγορώ	paɾiɣoɾo
έφερα	efeɾa
δημοκρατία	ðimokratia
ταξιδεύω	taksiðevo
συνηθισμένουσ	siniθizmenus
τσιμπούκι	tsimbuci
ποικίλωσ	picilos
λύθηκα	liθika
αβασκαμένοσ	avaskamenos
βαμπίρ	vampiɾ
κατέστρεψα	katestɾepsa
περιόδου	perioðu
ροδιά	ɾoðʝa
φαρμάκωσα	faɾmakosa
ιούνιο	iunio
κορίνθου	koɾinθu
αντικλεπτική	andikleptici
αναδείχνω	anaðixno
αποσταγμένοσ	apostaɣmenos
παραδεκτή	paɾaðekti
τεχνολογιών	texnoloʝion
ξενιτειών	ksenitçon
σφυρίχτηκα	sfirixtika
τηλεφώνησα	tilefonisa
μισθώνω	misθono
ανακαλύπτουμε	anakaliptume
μεσοστρατίσ	mesostɾatis
κυνηγημένησ	ciniʝimenis
αξιολογήσεισ	aksioloʝisis
έρρινο	erino
σπιθίζω	spiθizo
αναστρέψιμοσ	anastɾepsimos
εγχέομε	eŋçeome
αλλαξοκαιριά	alaskoceɾʝa
κομμένοσ	komenos
αλιεύτηκα	alieftika
δύσκολα	ðiskola
ντροπιασμένου	dɾopçazmenu
αρματώνομε	aɾmatonome
αλώνι	aloni
διαρρέω	ði̯areo
κλέβομαι	klevome
μαυροπίνακασ	mavɾopinakas
πατώνω	patono
λογοκρίθηκα	loɣokɾiθika
αναμμένησ	anamenis
αγνωμοσύνη	aɣnomosini
ανένηψα	anenipsa
χέζομαι	çezome
πούδρα	puðɾa
αρετέσ	aretes
σπουργίτια	spuɾʝitça
αναγνώστρια	anaɣnostɾia
ένρινοσ	enrinos
ανέκρινα	anekɾina
εκλέχτηκα	eklextika
ντροπιασμένοι	dɾopçazmeni
εκβιασμόσ	eɡviazmos
αποκατασταίνομαι	apokatastenome
διέρρευσα	ðʝerefsa
κάμποσ	kambos
κληρονομημένοσ	kliɾonomimenos
συνεθλίβην	sineθlivin
βουλιάχτε	vuʎaxte
βουτυρωμένου	vutiromenu
αιχμαλώτισα	exmalotisa
ντουσ	dus
καμουφλάρω	kamuflaɾo
βάζο	vazo
βάφω	vafo
συνήθωσ	siniθos
κοτσάρισα	kotsaɾisa
θλιβερόσ	θliveɾos
ψωμιά	psomɲa
δέχθηκα	ðexθika
ξέγραφα	kseɣrafa
βίζιτα	vizita
κουτσομπόλευ'	kutsobolef
αβάραρε	avaɾaɾe
δημεύω	ðimevo
ιδιωτικοποίηση	iðiotikopiisi
κατασκόπεψα	kataskopepsa
αυξομειωμένοσ	afksomiomenos
αδελφωμένοσ	aðelfomenos
ξεχέζω	kseçezo
ακουμπιστήρι	akumbistiɾi
χρονολογήθηκα	xronoloʝiθika
φιλόσοφοσ	filosofos
εγγράφηκαν	eŋɣrafikan
πακετάρω	pacetaɾo
εγκαταλείφθηκα	eŋɡatalifθika
αξιολογούμαι	aksioloɣume
λύετε	liete
προηγούμενε	proiɣumene
τρίφτηκα	triftika
καταβάλλομε	katavalome
πουλάρι	pulaɾi
αναλίσκομε	analiskome
μαζέψτε	mazepste
ὑπογράφομαι	ipoɣrafome
ομόλογη	omoloʝi
γυρεύω	ʝiɾevo
παγωμένο	paɣomeno
στρατόπεδο	stɾatopeðo
καταργώ	kataɾɣo
κοιτίδεσ	citiðes
κλώσσα	klosa
χαραλάμπησ	xaɾalambis
θερμοκοιτίδα	θermocitiða
πλησιάζουμε	plisiazume
απελπισμένα	apelpizmena
βρυκόλακασ	vɾikolakas
διώχνομαι	ðʝoxnome
έβδομοσ	evðomos
κουρεύομαι	kuɾevome
αλευρωμένα	alevromena
βουτυρώνομαι	vutiɾonome
ξαράχνιασα	ksaɾaxɲasa
ροχάλισμα	ɾoxalizma
νοστιμίζω	nostimizo
σπέτσεσ	spetses
διαπνέομαι	ðiapneome
αποδείχτηκαν	apoðixtikan
ζωντάνεψα	zondanepsa
τρίπολη	tɾipoli
σκασμένοσ	skazmenos
αλκοολούχοσ	alkooluxos
άγιων	aʝion
κραγμένησ	kraɣmenis
αντιπροσωπεύω	andipɾosopevo
επείγων	epiɣon
αλευρωμένοσ	alevromenos
ντροπαλά	dɾopala
παρακολουθήθηκα	paɾakoluθiθika
κάνσασ	kanzas
εξαναγκάσθηκα	eksanaŋɡasθika
λεία	lia
υπολογιστικών	ipoloʝistikon
συγχωριέμαι	siŋxoɾʝeme
τριακόσια	tɾiakosça
νεκρό	nekɾo
αναδιοργανώνω	anaðioɾɣanono
επιλέγω	epileɣo
ερωτεύομαι	erotevome
πρόσφερα	pɾosfeɾa
διαλελυμένοι	ðialelimeni
καπνίζομε	kapnizome
κεριών	cerʝon
εμβόλια	eɱvolia
εβίβα	eviva
αναρμοδίωσ	anaɾmoðios
απαρηγορήτωσ	apaɾiɣoɾitos
άγιο	aʝio
ακώλυτοσ	akolitos
πληρώνομαι	pliɾonome
αξιολύπητοσ	aksiolipitos
βαθμολογημένο	vaθmoloʝimeno
ασκώ	asko
ανθρακιά	anθraca
εκκολάψεισ	ekolapsis
μέγασ	meɣas
χρησιμοποιούμαι	xɾisimopiume
γιατρείεσ	ʝatɾies
χρεώνομαι	xɾeonome
αμεριμνησίεσ	ameɾimnisies
μαρτυρήθηκα	maɾtiɾiθika
αποσπώ	apospo
μπερδεμένησ	beɾðemenis
πατρικόσ	patrikos
κυνηγημένα	ciniʝimena
κωλόγεροσ	koloʝeɾos
ομολογία	omoloʝia
βρίζω	vɾizo
μελισσοκομία	melisokomia
ανταμώθηκα	andamoθika
λυθήκατε	liθikate
έφτασα	eftasa
σημάδια	simaðʝa
αλητεύω	alitevo
πουτανάκι	putanaci
πύο	pio
χαρτορίχτρα	xaɾtoɾixtɾa
πιστεύομαι	pistevome
βελανίδι	velaniði
βαρύτητα	varitita
αρρωστημένου	arostimenu
μωρόσ	moɾos
αγχώνω	aŋxono
φράζω	frazo
άκαμπτοσ	akamptos
επανειλημμένουσ	epanilimenus
απλοποιώ	aplopio
παράβυστοσ	paravistos
αγίου	aʝiu
σκατά	skata
αντιμετωπίζω	andimetopizo
συνέτριψα	sinetɾipsa
ακοινωνησιέσ	acinonisçes
μαζικότερων	mazikoteron
πάγκοσ	paŋɡos
βαλσάκια	valsaca
αντικλεπτικέ	andikleptiçe
αγγαρεύομαι	aŋɡaɾevome
περασμένε	perazmene
κλήθηκα	kliθika
σκατήσ	skatis
διοργανώνω	ðioɾɣanono
κρεμασμένησ	kremazmenis
περαστικόσ	peɾastikos
διαμορφώσεισ	ðʝamoɾfosis
αναγνωρισμένουσ	anaɣnorizmenus
αμφιλεγόμενοσ	aɱfileɣomenos
φαρσί	farsi
αλυσίδα	alisiða
ασεβώσ	asevos
στερώ	steɾo
αραχνιασμένοσ	aɾaxɲazmenos
ανατινάχτηκα	anatinaxtika
κοσμάκησ	kozmacis
σταγόνεσ	staɣones
φωτογραφικέ	fotoɣrafice
παραβλέπομε	paɾavlepome
κουφάρι	kufaɾi
φορεμένοσ	foɾemenos
λειώνω	ʎono
πίνομε	pinome
νήσσα	nisa
αίσθηση	esθisi
ιντιάνα	indiana
κυβερνήθηκα	civeɾniθika
διαχειρίζομαι	ðiaçiɾizome
προσέρχομαι	proserxome
γερόσ	ʝeɾos
νοεμβρίουσ	noeɱvɾius
ταχυδακτυλουργία	taçiðaktiluɾʝia
αγανάκτησα	aɣanaktisa
αιγίνησ	eʝinis
κακογαμημένουσ	kakoɣamimenus
ξεκούρασα	ksekuɾasa
ιουλίουσ	iulius
δόγμα	ðoɣma
συνδυάστηκα	sinðiastika
αγυιόπαιδοσ	aʝiopeðos
ἐκρούσθην	ekrusθin
τετριμμένεσ	tetrimenes
ανάπαυσα	anapafsa
αδειάστηκα	aðʝastika
άμπελοσ	ambelos
ταλαντούχοσ	talanduxos
κατίσχυσα	katisçisa
φουμάρισε	fumaɾise
εξήρα	eksira
αβαράρισα	avaɾaɾisa
περιθάλπω	peɾiθalpo
λύνεσαι	linese
κρούουμε	kruume
υποθάλπομε	ipoθalpome
υποκρύπτομε	ipokɾiptome
αρρωστημένη	arostimeni
ανορθώνομαι	anoɾθonome
αναμμένου	anamenu
διαχέομε	ðiaçeome
ονομάζω	onomazo
παρελθουσών	parelθuson
ἔκλεισα	eklisa
αποκαλύψεισ	apokalipsis
επικοινωνώ	epicinono
μόρτισσα	moɾtisa
μαυρισμένησ	mavrizmenis
πιόνιο	pionio
άρα	aɾa
χρεώνω	xɾeono
εφευρέθηκα	efevɾeθika
αγαπήσει	aɣapisi
πωλούμε	polume
πεθαμένου	peθamenu
αλωνάρηδων	alonaɾiðon
πρωταγωνιστών	pɾotaɣoniston
λύομε	liome
στείροσ	stiɾos
μυτούλα	mitula
ακοινωνησιά	acinonisça
χειρονομούσα	çiɾonomusa
αποκόπτομε	apokoptome
ταμείο	tamio
ισχίο	isçio
στο	sto
γενιέσ	ʝeɲes
χαζομάρα	xazomaɾa
στενοχωρημένη	stenoxorimeni
διώχθηκα	ðioxθika
δεκέμβριοσ	ðeceɱvɾios
διαμείφθηκαν	ðiamifθikan
σαντουριών	sandurʝon
ανάτεινα	anatina
ακταιωρό	akteoro
αντιστρέφομαι	andistɾefome
αποθηκεύομαι	apoθicevome
καθαρεύουσα	kaθaɾevusa
κλεμμένοσ	klemenos
δημοσιεύεται	ðimosievete
στεναχωρώ	stenaxoro
αξιοσημείωτε	aksiosimiote
κολυμπάω	kolimbao
επιτεύχθηκα	epitefxθika
αμορφωσιών	amoɾfosçon
άσπρισα	aspɾizo
σπιτάκι	spitaci
αμυδρόσ	amiðɾos
ανεγνωρισμένοσ	aneɣnoɾizmenos
ανορθώσεισ	anoɾθosis
άρτοσ	artos
έραψα	eɾapsa
άγγελοσ	aŋɟelos
συνοδέ	sinoðe
τρίβομαι	trivome
πεθερικά	peθeɾika
μολογάω	moloɣao
εξοπλισμένε	eksoplizmene
αλληλοσυγκρουόμενα	alilosiŋɡruomena
κατηγόρησα	katiɣoɾisa
μέρεψα	meɾepsa
παγασών	paɣason
τσεκάριζα	tsekaɾiza
σταφιδόψωμων	stafiðopsomon
συνδέθηκα	sinðeθika
μειώθηκα	mioθika
ντρέπομαι	dɾepome
κατηγορούμαι	katiɣoɾume
ανάβαθοσ	anavaθos
γεννιέμαι	ʝeɲeme
τρομοκρατώ	tɾomokɾato
σουτάρομαι	sutaɾome
θλιβερέσ	θliveɾes
λυθώ	liθo
αλατισμένα	alatizmena
αναμαλλιασμένοσ	anamaʎazmenos
συγχάρηκα	siŋxarika
πασπάτεψα	paspatepsa
πεινασμένησ	pinazmenis
διαμηνύομαι	ðiaminiome
καλώ	kalo
μαργαριτάρι	maɾɣaɾitaɾi
πύον	pion
χαμσίνι	xamsini
γαμημένεσ	ɣamimenes
μη	mi
βασίλεψα	vasilepsa
βάσταξα	vastaksa
πλησιάζομαι	plisiazome
σοφά	sofa
ανεβασιέσ	anevasçes
τελέσθηκα	telesθika
παγκοσμιοποίησησ	paŋɡozmiopiisis
αρματώθηκα	aɾmatoθika
ον	on
διεγείρομε	ðieʝiɾome
συνοδόσ	sinoðos
μυγοσκοτώστρα	miɣoskotostɾa
ανελκυστήρασ	anelcistiɾas
βουτυρωμένα	vutiromena
νικημένησ	nicimenis
απασχολιέμαι	apasxoʎeme
διημείφθησαν	ðiimifθisan
αποβιβάζω	apovivazo
γκομενάρα	ɡomenaɾa
χρωστάω	xɾostao
μαλακισμένησ	malacizmenis
ίε	ie
πηδηγμένοσ	piðiɣmenos
κόλλημα	kolima
απόκρουσα	apokrusa
δημιουργήθηκα	ðimiuɾʝiθika
αληθών	aliθon
τρέμω	tremo
συνάπτομαι	sinaptome
ψοφάω	psofao
χεζάσ	çezas
καλμάριζα	kalmaɾiza
σελάμι	selami
καταπολεμούμαι	katapolemume
νυχτωδία	nixtoðia
συγκινημένα	siŋɟinimena
σκωτία	skotia
παιδεραστία	peðeɾastia
πλίνθο	plinθo
μούσκεψα	muscepsa
σταυροφορία	stavɾofoɾia
ορθοδόξωσ	oɾθoðoksos
λιόψωμο	ʎopsomo
φασκιώνομαι	fascionome
προσαρμόστηκα	pɾosaɾmostika
διψασμένησ	ðipsazmenis
εκκρούουμε	ekruume
απέχθεια	apexθia
αεροφωτογραφίζουμε	aerofotoɣrafizume
σουτάριζε	sutaɾize
αγγιγμένοσ	aŋɟiɣmenos
φύλο	filo
κίμωλε	cimole
κανακεύτηκα	kanaceftika
προήρθα	proirθa
μεταφράζω	metafɾazo
συναίρεση	sineresi
πρωταγωνιστή	pɾotaɣonisti
κονικλοτροφείο	koniklotrofio
παρηγοριέσ	paɾiɣoɾʝes
καταφέρθηκα	katafeɾθika
παλιόγεροσ	paʎoʝeɾos
καλομοίρεσ	kalomires
κέφι	cefi
χείλοσ	çilos
κούρεψα	kuɾepsa
μέρεψε	meɾepse
ψυχολογική	psixoloʝici
φυλώ	filo
οφειλέτησ	ofiletis
ήττα	ita
κάνω	kano
συντρίβομαι	sindrivome
εκτελώ	ektelo
κομμένου	komenu
μάλωμα	maloma
αποτρέπω	apotɾepo
μουσκεμένεσ	muscemenes
δήλωσα	ðilosa
φραντζόλα	frandzola
αναγεννώμαι	anaʝenome
ανάδειξα	anaðiksa
εφτά	efta
απόβαλλε	apovale
στέμμα	stema
τούρτα	tuɾta
έλκοσ	elkos
χρησιμοποιούμε	xɾisimopiume
τριταγωνιστών	tritaɣoniston
λειψανοθήκη	lipsanoθici
διαιρούμαι	ðieɾume
ετεροφυλόφιλοσ	eteɾofilofilos
ενημερώσεων	enimeroseon
δημαρχεία	ðimaɾçia
κοροϊδεύτε	koɾoi̯ðefte
πιγκουίνοσ	piŋɡuinos
ραφείο	ɾafio
διπλάσιοσ	ðiplasios
απομονώνομαι	apomonono
οσάκα	osaka
εξημερώθηκα	eksimeɾoθika
γλάστρα	ɣlastɾa
ντροπιασμένη	dɾopçazmeni
ἐξετελέσθην	eksetelesθin
τραυματίασ	tɾavmatias
σιάτιστα	sçatista
μαραγκόσ	maraŋɡos
αλλοιώσεισ	aliosis
εμπρόσ	ebros
βυθισμένοσ	viθizmenos
ξεγράφτηκα	kseɣraftika
παύομαι	pavome
βυθισμένουσ	viθizmenus
σιχτίρ	sixtiɾ
διεμήνυσα	ðieminisa
σούρθηκα	surθika
αξιοσημείωτα	aksiosimiota
τετριμμένουσ	tetrimenus
διαστροφή	ðʝastɾofi
τείνουμε	tinume
αναθεματισμένησ	anaθematizmenis
χαζόσ	xazos
θρηνήθηκα	θɾiniθika
φορούσα	foɾusa
φωτογραφεία	fotoɣrafia
κετσέ	ketse
νοιάζομαι	ɲazome
λιγότερη	liɣoteri
δηλωμένοσ	ðilomenos
καλύπτομαι	kaliptome
αβουλησίασ	avulisias
αδελφοκτονία	aðelfoktonia
κλέφτικο	kleftika
εφαρμόζω	efaɾmozo
άραξα	araksa
μικρό	mikɾo
κρεμασμένουσ	kremazmenus
διαμηνύθηκα	ðiaminiθika
βρόμικοι	vɾomici
ουαλία	ualia
προσγειώσεισ	pɾozʝiosis
αναβαλλόμενουσ	anavalomenus
προσεκλήθη	pɾosekliθi
μπαλαδόροσ	balaðoɾos
διέκοψα	ðʝekopsa
πομφόσ	poɱfos
επάλειψα	epalipsa
κομμένεσ	komenes
συνετρίβησαν	sinetɾivisan
ανατράπηκε	anatɾapice
δημοσιεύομαι	ðimosievome
ζητώ	zito
αγριοσυκιά	aɣɾiosicʝa
αυξομειώνομαι	afksomionome
θερμοδυναμικό	θermoðinamiko
συσκέπτομαι	sisceptome
κοντρολαρίστηκα	kontrolaɾistika
λουκανικόπιτα	lukanikopita
ραγιάδων	ɾaʝaðon
αύγουστοι	avɣusti
οφείλομε	ofilome
ρώμη	ɾomi
σταγόνασ	staɣonas
σκουντήθηκα	skundiθika
αγκομάχησα	aŋɡomaçisa
τελευταία	teleftea
σπέρνομαι	speɾnome
στρέφουμε	stɾefume
απορροφήσεισ	apoɾofisis
χεσμένοσ	çezmenos
περνάω	peɾnao
ἐνέγραψα	eneɣrapsa
περικόβουμε	peɾikovume
σητεία	sitia
συγκόπτομε	siŋɡoptome
μπλιαχ	bʎax
ακοομετρίεσ	akoometries
αποτραπήκαν	apotɾapikan
θυμωμένοσ	θimomenos
κιάλι	cali
εκχέουμε	ekçeume
βάλουνε	valune
αποστειρώνομαι	apostiɾonome
ενημέρωσησ	enimerosis
ηλιοτρόπιο	iliotɾopio
σοφάδων	sofaðon
αποδοκιμάστηκα	apoðocimastika
νεοζηλανδή	neozilanði
απασχολώ	apasxolo
καθέλκομαι	kaθelkome
μητέρα	mitera
γελοίοσ	ʝelios
σοφιών	sofion
αλαμπουρνέζικε	alaburnezice
λείπω	lipo
χαστούκι	xastuci
πίνεισ	pinis
κοντρολαρίστηκα	kondrolaɾistika
δολοφόνησα	ðolofonisa
διαμορφώνω	ðʝamoɾfono
ήβη	ivi
συγγράφηισ	siŋɣrafis
γενιά	ʝeɲa
σείομε	siome
έβιασα	evʝasa
ανακρούσθηκα	anakrusθika
φώσφοροσ	fosfoɾos
απορροφούμενο	apoɾofumeno
παραειδώθηκα	paɾaiðoθika
περιέπλεξα	peɾiepleksa
ξεχνάω	ksexnao
ανταμώνομαι	andamonome
θυμωμένοι	θimomeni
διεγερμένοσ	ðieʝeɾmenos
αγανακτισμένησ	aɣanaktizmenis
ποιώ	pio
κομπιναδόροσ	kombinaðoɾos
λικεράκι	liceɾaci
αναβιβάσθηκα	anavivasθika
εσωκλείω	esoklio
κλιμακώνω	klimakono
τζιν	dzin
ζεσταμένων	zestamenon
τσακώνικε	tsakonice
αγκαλιάστηκα	aŋɡaʎastika
ενοχλητικόσ	enoxlitikos
πρωτοκολλώ	pɾotokolo
χρησιμοποιημένοσ	xɾisimopiimenos
νεράιδα	neɾaiða
απομόνωσα	apomonosa
οπτιμιστήσ	optimistis
προσφέρω	pɾosfeɾo
γκαστρωμένοσ	ɡastɾomenos
μύκονε	mikone
διαχέουμε	ðiaçeume
αφαιρώ	afeɾo
απόδειξε	apoðikse
βαθμολογημένησ	vaθmoloʝimenis
εγείρω	eʝiɾo
αλαφιασμένοσ	alafçazmenos
αναστύλωσα	anastilosa
έρπω	erpo
συνηθισμένα	siniθizmena
χαρτζιλίκι	xaɾdzilici
μειονότητα	mionotita
δέομαι	ðeome
τρυπημένοσ	tɾipimenos
εσυ	esi
ορίστε	oɾiste
ιουνίου	iuniu
συμφωνώ	siɱfono
φιξαρίστηκα	fiksaɾistika
απόκριση	apokɾisi
γνώσεισ	ɣnosis
όφελοσ	ofelos
ξύλινοσ	ksilinos
βρεφοκομείο	vɾefokomio
έννοια	eɲa
εσπεράντο	espeɾando
ημέρεψε	imeɾepse
ξοδιάστηκα	ksoðʝastika
υπέροχα	ipeɾoxa
κουβαλημένοσ	kuvalimenos
μοιρασμένουσ	miɾazmenus
γελιέμαι	ʝeʎeme
εψέσ	epses
εξού	eksu
αγιάζω	aʝiazo
επαλείφομαι	epalifome
ενημέρωση	enimerosi
άχρηστοσ	axɾistos
ροδάκινου	roðacinu
ερρινότητα	erinotita
γογγύλι	ɣoŋɟili
υπογράφει	ipoɣrafi
υδραυλικόσ	iðravlikos
κωσταντίνε	kostandine
τίνασ	tinas
ανέπλευσα	aneplefsa
ακρίτησ	akritis
δεκατριών	ðekatɾion
ἑορτάζομαι	eoɾtazome
κατεργάζομαι	katerɣazome
καπνίστηκα	kapnistika
αστέρι	asteɾi
όμορφο	omoɾfo
νικολάου	nikolau
επισυνήφθησαν	episinifθisan
κινδύνευσε	cinðinefse
κυκλοφορημένοσ	ciklofoɾimenos
ενεγράφη	eneɣrafi
αίγυπτοσ	eʝiptos
κινδυνεύετε	cinðinevete
σειέμαι	sçeme
αλίμενοσ	alimenos
τούβλο	tuvlo
κατάστρωμα	katastroma
δεχθεί	ðexθi
κυήματα	ciimata
κεκλεισμένων	ceklizmenon
ξεσκατώνω	kseskatono
στιμμένοσ	stimenos
αντιγράφτηκα	andiɣraftika
πίεσα	piesa
βραχυκύκλωσα	vɾaçiciclosa
ντουμπλαρίστηκα	dublaɾistika
συνδιασκέπτομαι	sinðiasceptome
όγδοοσ	oɣðoos
δηλώνομε	ðilonome
επικαλύφθηκα	epikalifθika
οπλισμένο	oplizmeno
μμε	mimie
παράκαμψα	paɾakampsa
προσφύομαι	prosfiome
επαρκέστεροι	epaɾcesteɾi
μεσαιωνικήσ	meseonicis
πεπεισμένη	pepizmeni
πολωνή	poloni
μαυρισμένεσ	mavrizmenes
στυμμένο	stimeno
έλυσαν	elisan
σκέπτομαι	sceptome
ποικιλότατων	picilotaton
συνηθισμένησ	siniθizmenis
σεπτέμβρη	septeɱvɾi
πειθαναγκάζομαι	piθanaŋɡazome
θερμοκοιτίδασ	θermocitiðas
εκχύνομαι	ekçinome
δράμα	ðrama
αναγράφομε	anaɣrafome
επαναφέρω	epanafeɾo
φύλλο	filo
πύργοσ	pirɣos
πλειόκαινοσ	pliocenos
συνεχίζομαι	sineçizome
διαθλώμαι	ði̯aθlome
προκαταβάλλουμε	pɾokatavalume
βροντοχτυπώ	vɾondoxtipo
αλευρωμένε	alevromene
παρακάμπτω	paɾakampto
παρουσιάστηκα	paɾusiastika
εισακούστηκα	isakustika
μεγάλοσ	meɣalos
καίγομαι	ceɣome
αποσαθρώσεισ	aposaθɾosis
πύργουσ	pirɣus
διψασμένοι	ðipsazmeni
λαδιά	laðʝa
προετοιμάζομαι	pɾoetimazome
νάουσα	nausa
πώλησα	polisa
αναρμοδιότητα	anaɾmoðiotita
νεκροκεφαλή	nekɾocefali
αερόμετρο	aeɾometɾo
όλισβοσ	olizvos
βάσω	vaso
εφημερίδα	efimeriða
σεπτεμβρίων	septeɱvɾion
έσταξα	estaksa
καλοφάγωτησ	kalofaɣotis
κουρελιού	kuɾeʎu
κούκλα	kukla
παγωνιά	paɣoɲa
νεβάδα	nevaða
λησμονώ	lizmono
αλφαβήτων	alfaviton
κουρέλιασα	kuɾeʎasa
χριστουγέννων	xɾistuʝenon
επανιδρύω	epaniðrio
φολίδα	foliða
δυτικόσ	ðitikos
προβλέφθηκα	pɾovlefθika
αγιογραφημένοσ	aʝioɣɾafimenos
πωλούμαι	polume
ημερεύω	imeɾevo
ανάγκησ	anaŋɟis
βόσκησα	voscisa
αποτελούμαι	apotelume
αποθανών	apoθanon
ασκημένοσ	ascimenos
σβηστήρα	zvistiɾa
παρακαλώ	parakalo
συγγραφεί	siŋɣrafi
σούρνομαι	surnome
στειμμένου	stimenu
παρφουμαρίστηκα	paɾfumaɾistika
δαγκάσει	ðaŋɡasi
φέρομαι	feɾome
μαρκάριζα	maɾkaɾiza
πρωτοανακαλύπτομαι	pɾotoanakaliptome
ερυθρόσ	eriθros
συνεθλίβησαν	sineθlivisan
κατοικώ	katiko
ακρεοφαγία	akɾeofaʝia
φεβρουαρίων	fevɾuaɾion
έναντι	enandi
τοποθετημένοσ	topoθeto
ερυθροκύανοσ	eriθrocianos
κρούσθηκα	krusθika
φαρμακώνομαι	faɾmakonome
εκκρούομε	ekruome
προβλέπομε	pɾovlepome
καλοκαιρινόσ	kaloceɾinos
ζωντανεύω	zondanevo
εξέλειψα	ekselipsa
γιεν	ʝen
διαλυμένο	ðʝalimeno
προσθέτω	prosθeto
κάμπτω	kampto
μαζικά	mazika
ακληρονόμητοσ	akliɾonomitos
ποδοσφαιρίστρια	poðosfeɾistɾia
χαρχάλεμα	xaɾxalema
υποπτεύομαι	ipoptevome
αγγισμένη	aŋɟizmeni
υπογράφω	ipoɣɾafo
ντουμπλάρισα	dublaɾisa
μουνόψειρα	munopsiɾa
απόπλου	apoplu
εξοπλισμένου	eksoplizmenu
έχασα	exasa
εκλήθησαν	ekliθisan
αηδιασμένοσ	aiðiazmenos
άγγισα	aŋɟisa
διέρχομαι	ðierxome
ύστερα	istera
φυλλομετράμε	filometɾame
ποικίλα	picila
συγγραφέων	siŋɣrafeon
αποτέλεσα	apotelesa
γονυπετή	ɣonipeti
παρηγοριά	paɾiɣoɾʝa
πειθαναγκάζουμε	piθanaŋɡazume
δημοκρατιῶν	ðimokration
αφορίζω	afoɾizo
αφήγηση	afiʝisi
μοίρασα	miɾasa
αγγούρι	aŋɡuɾi
ζύθοσ	ziθos
αντέβαινα	andevena
ρούφηξα	ɾufiksa
αποκλείομαι	apokliome
ἡλικιωμένοσ	iliciomenos
κρίνομαι	kɾinome
δάγκωσα	ðaŋɡosa
αποκαλύπτω	apokalipto
αναβοσβήνω	anavozvino
χρωστούσα	xɾostusa
ξάσπρισα	ksasprisa
ήπιοσ	ipios
πουλάκι	pulaci
χέζω	çezo
βοηθούμενοσ	voi̯θumenos
έλουσα	elusa
περικλείσθηκα	periklisθika
κωνσταντή	kostandi
τραγουδιέμαι	tɾaɣuðʝeme
αγόρι	aɣori
μαφιόζοσ	mafʝozos
ογδοήκοντα	oɣðoikonda
επιγράφω	epiɣrafo
αντλήθηκα	andliθika
κωσταντίνασ	kostandinas
έπεμψα	epempsa
ανατραπήκανε	anatɾapikane
πολυμήχανοσ	polimixanos
διοργανώνομαι	ðioɾɣanonome
κινδύνευσα	cinðinefsa
ξαλεγράρισα	ksaleɣɾaɾisa
αποκαλύπτουμε	apokaliptume
λαμβάνομαι	lamvanome
κατέπλευσα	kateplefsa
χόρεψε	xoɾepse
αγάπησα	aɣapisa
σφαλιαρίτσα	sfaʎaɾitsa
ενστερνίστηκα	ensternistika
μετατρέπομε	metatɾepome
αβαράριζε	avaɾaɾize
φανταχτερόσ	fandaxteros
αναθάλλω	anaθalo
άγιοσ	aʝos
κλείνομαι	klinome
ξύλο	ksilo
αγγιγμένα	aŋɟiɣmena
εγκαθίδρυσα	eŋɡaθiðrisa
κάθισα	kaθisa
ανακαινίζομαι	anacenizome
αποδείχτηκα	apoðixtika
εμπνευσμένου	embnevzmenu
κελαηδάω	celaiðao
πληρώθηκα	pliɾoθika
νοσοκόμοσ	nosokomos
γουστάριζε	ɣustaɾize
πρεσαρίστηκα	pɾesaɾistika
κατισχύω	katisçio
ναυτολόγιο	naftoloʝio
κάτασπρη	kataspɾi
αγνοημένοσ	aɣnoimenos
πνέω	pneo
σωρέ	soɾe
γέρασα	ʝeɾasa
αχάριστοσ	axaɾistos
μισθόσ	misθos
λευκή	lefci
νοστιμεύω	nostimevo
σωροί	soɾi
χρειάζομαι	xɾiazome
άγιου	aʝu
αγαθεύω	aɣaθevo
λαογραφία	laoɣɾafia
σύνθλιψα	sinθlipsa
αλληλοσυγκρουόμενοι	alilosiŋɡruomeni
αχιλλέασ	açileas
αγνάντεψα	aɣnandepsa
περνάει	peɾnai
στρατοπεδεύω	stɾatopeðevo
σκοτώστρα	skotostɾa
θρόμβωση	θɾoɱvosi
φωνή	foni
προσευχή	pɾosefçi
σαμποδρόμιο	samboðromɲo
περικόπτομαι	peɾikoptome
ρεφρέν	refren
υπολογιστικό	ipoloʝistiko
ανιδρύουμε	aniðriume
πέμπτων	pemton
τριάντα	trianda
αφοσιώνομαι	afosionome
λεξιπλασίασ	leksiplasias
λέγουμε	leɣume
κοκκίνων	kocinon
βατραχάνθρωποσ	vatɾaxanθɾopos
παγκάκι	paŋɡaci
άγγιξα	aŋɟiksa
εγγράφουμε	eŋɣrafume
γράμμα	ɣrama
οφιοειδών	ofioiðon
διατηρήθηκα	ði̯atiɾiθika
διαχειρίσθηκα	ðiaçiɾisθika
αντευχήθηκα	andefçiθika
αυνανίζομαι	avnanizome
στιμμένα	stimena
βρισίδι	vɾisiði
ενδιατρίβω	enðiatɾivo
ουσιαστικοποιήσεωσ	usiastikopiiseos
νοστίμισα	nostimisa
μπανιερίτσα	baɲeɾitsa
βοηθάω	voiθao
προμήθευσα	pɾomiθefsa
κεντώ	cento
αράδα	aɾaða
ανθεστηρίων	anθestiɾion
ταίρι	teri
θλιβερά	θliveɾa
γκεσεμιών	ɟesemɲon
ξενιτιέσ	ksenitçes
αλευρωμένοι	alevromeni
παρεκτρέπω	paɾektɾepo
αμπαρώνω	abaɾono
απαραδέκτωσ	apaɾaðektos
πιλόταρα	pilotaɾa
κορίτσια	koɾitsça
τυχερόσ	tiçeros
απόβαλε	apovale
σέρνομαι	sernome
πρωτομάρτυρα	pɾotomaɾtiɾa
κάμψεισ	kampsis
χαρχαλεύω	xaɾxalevo
ξύστρα	ksistra
περιπλέκομε	peɾiplekome
απασχολημένησ	apasxolimenis
κατέβαλλα	katevala
αίγιο	eʝio
γιουγκοσλαβία	ʝuɡozlavia
αβγατισμένησ	avɣatizmenis
αναλυτά	analita
επεγράφησαν	epeɣrafisan
αρκώ	aɾko
αξιοσημείωτο	aksiosimioto
μυκτήρ	miktir
αποστειρώνω	apostiɾono
παρασκεύασα	paɾascevasa
μέιν	mein
ξεκωλιάρησ	ksekoʎaɾis
καλομάνα	kalomana
ραγιάδεσ	ɾaʝaðes
χαϊδεύω	xai̯ðevo
μαλώνω	malono
μαζεύομαι	mazevome
σαγηνευτικόσ	saʝineftikos
λασίθι	lasiθi
ενέργεια	enerʝia
ακλουθάω	akluθao
χωρίζω	xorizo
κλανιά	klaɲa
διαθλασμένοσ	ði̯aθlazmenos
αρδεύομαι	aɾðevome
αλμυρόσ	almiros
αναδείχνομαι	anaðixnome
κατήργησα	katiɾʝisa
λυπημένο	lipimeno
εκλήθην	ekliθin
λύναμε	liname
ψάρεψα	psaɾepsa
ερωτήθηκα	eɾotiθika
κρεμάλα	kɾemala
βάσανοσ	vasanos
καθομιλουμένησ	kaθomilumenis
εκτέλεση	ektelesi
ψηφοφορίασ	psifofoɾias
αμορφωσιάσ	amoɾfosças
απέρριψα	apeɾipsa
μεξικού	meksiku
κακούργημα	kakuɾʝima
σβηστήρι	zvistiɾi
λήμνοσ	limnos
καθίδρυσα	kaθiðrisa
ετοιμασίεσ	etimasies
λειβαδιά	livaðʝa
πάω	pao
φωτογραφίζομε	fotoɣrafizome
ευχαριστημένοσ	efxaɾistimenos
συνεχίζομε	sineçizome
τελείωσα	teliosa
αναζητάω	anazitao
βουτυρωμένων	vutiromenon
περίπλων	periplon
έβαλα	evala
κρεμάστηκε	kɾemastice
απαραίτητοσ	aparetitos
αβανγκαρντισμέ	avaŋɡaɾdizme
κακογαμημένεσ	kakoɣamimenes
βοηθώ	voi̯θo
απογείωση	apoʝiosi
μαθημένοι	maθimeni
μοιάζω	mɲazo
μοιράζομαι	miɾazome
υγεία	iʝia
μοιρασμένα	miɾazmena
στιμμένη	stimeni
αγαπημένου	aɣapimenu
βουτυρωμένη	vutiromeni
συναναστρέφομαι	sinanastɾefome
εορτάζομε	eoɾtazome
κουβαλήθηκα	kuvaliθika
περασμένα	perazmena
ανελκύομαι	anelciome
κακογαμημένα	kakoɣamimena
σκασμένησ	skazmenis
γενεέσ	ʝenees
πολωνικά	polonika
αγγελοκρούω	aŋɟelokruo
σβήστρα	zvistɾa
εξολοθρεύομαι	eksoloθɾevome
ιπποπόταμοσ	ipopotamos
αποκόβομαι	apokovome
ολόφωτησ	olofotis
τομάρι	tomaɾi
στεναχωρημένα	stenaxorimena
άκουσεσ	akuses
αλαμπουρνέζικου	alaburneziku
αρρωστημένεσ	arostimenes
υποδύομαι	ipoðiome
σχηματίζω	sçimatizo
έχε	eçe
στεφάνη	stefani
σπρώχτηκα	spɾoxtika
τσακωνικοί	tsakonici
ταλαίπωροσ	talepoɾos
καυλιάρησ	kavʎaɾis
τορπίλη	toɾpili
απελπισμένη	apelpizmeni
γιαπί	ʝapi
εισέρχομαι	iseɾxome
καταστρέφομαι	katastɾefome
δυσκολεύομαι	ðiskolevome
στερούμαι	steɾume
λύσουμε	lisume
μύριοι	miɾʝi
σούταρα	sutaɾa
σιχαίνομαι	siçenome
ζω	zo
ανατινάχθηκα	anatinaxθika
αγκιστρώνω	aŋɟistɾono
κυήματοσ	ciimatos
δεκεμβρίου	ðeceɱvɾiu
ιουλίων	iulion
διημείφθην	ðiimifθin
αναπάλλομαι	anapalome
πηδιέμαι	piðʝeme
αδυνατισμένοσ	aðinatizmenos
εργάζομαι	eɾɣazome
αβγοκομμένου	avɣokomenu
κουμπώθηκα	kumboθika
ζεσταμένη	zestameni
ερμηνεύω	eɾminevo
προσεκλήθην	pɾosekliθin
αψιθιά	apsiθça
περιπλέκουμε	peɾiplekume
όμορφοσ	omoɾfos
μυγιάστηκα	miʝastika
μπουρνούζι	buɾnuzi
απομονώσεισ	apomonosis
αναπλέω	anapleo
τιτάνασ	titanas
αθροίζω	aθɾizo
αναδιοργανώθηκα	anaðioɾɣanoθika
βουτυρωμένοσ	vutiromenos
χουρμάσ	xuɾmas
παμφάγοσ	paɱfaɣos
πόρνοσ	poɾnos
μαρκάρομαι	maɾkaɾome
χαμπέρι	xambeɾi
αλληλοσυγκρουόμενουσ	alilosiŋɡruomenus
αγαπημένο	aɣapimeno
σχεδιάζω	sçeðiazo
συμπληρώνομαι	simbliɾonome
θεωρεία	θeoria
αποκλεισμένοσ	apoklizmenos
σημειώνουμε	simionume
αμπαλαρίστηκα	ambalaɾistika
ανετράπησαν	anetɾapisan
αμνηστεύω	amnistevo
μαθεύτηκε	maθeftice
ουρανικοποίηση	uranikopiisi
έγχυσα	eŋçisa
αναβαθμολογούμαι	anavaθmoloɣume
σοφίαι	sofie
ενστερνίσθηκα	ensternisθika
σκοντάβω	skondavo
εγχύθηκα	eŋçiθika
λαογράφοσ	laoɣɾafos
στουτγκάρδη	stutɡarði
ακολουθούμαι	akoluθume
ανασκαφτείσ	anaskaftis
φασαρία	fasaɾia
αργυραμοιβόσ	aɾʝiɾamivos
αλλοίωσησ	aliosis
έτοιμοσ	etimos
ανακλώ	anaklo
κοσμοπολιτών	kozmopoliton
βασανίζομαι	vasanizome
τιμονιέρησ	timoɲeɾis
μπερδεμένου	beɾðemenu
πηδήχτηκα	piðixtika
φυτικόσ	fitikos
κρεβατομουρμούρα	kɾevatomuɾmuɾa
στοίβαξα	stivaksa
πειθόμενε	piθomene
πρωταπριλιά	pɾotapɾiʎa
αίτηση	etisi
γέλαγα	ʝelaɣa
ανάγκεσ	anaŋɟes
περιπλεχθήκαν	peɾiplexθikan
παρακολουθούμαι	paɾakoluθume
μαλακίζομαι	malacizome
πιθαριού	piθarʝu
διαδέχθηκα	ði̯aðexθika
επιστράφηκα	epistɾafika
μισαλλοδοξία	misaloðoksia
απορροφούμενα	apoɾofumena
κρέμα	kɾema
αναγγέλθηκα	anaŋɟelθika
αγιάστηκα	aʝiastika
βάλθηκα	valθika
ἤγγισα	iŋɟisa
ανασκάβομαι	anaskavome
ονομάζουμε	onomazume
λύνει	lini
μεσαίωνασ	meseonas
ελιόψωμο	eʎopsomo
δημοσιεύθηκα	ðimosiefθika
βοηθούμαι	voiθume
γκαστρωμένοι	ɡastɾomeni
ανατρέπουμε	anatɾepume
λύσσαγε	lisaʝe
αλατισμένων	alatizmenon
συγκινούμε	siŋɟinume
ψωμί	psomi
οικονόμοσ	ikonomos
διαβεβαιώσεισ	ðʝaveveosis
καταδίωξα	kataðioksa
κουτάβι	kutavi
οκτώβριε	oktovɾie
γρήγοροσ	ɣriɣoros
μυρωμένε	miromene
ορίζομαι	oɾizome
βρήκατε	vɾikate
εξετελέσθην	eksetelesθin
κλασμένοσ	klazmenos
τάφρουσ	tafrus
κιόλασ	colas
μεταφύτεψα	metafitepsa
προτρέπομε	pɾotɾepome
πρησμένησ	pɾizmenis
δικαίωμα	ðiceoma
μαζικότατησ	mazikotatis
κνήμη	knimi
μαγειρέψει	maʝiɾepsi
τείνομαι	tinome
απέκλεισα	apeklisa
απεδείχθησαν	apeðixθisan
ανιλινών	anilinon
κρίνομε	kɾinome
πούντρα	pudɾa
καταντώ	katando
κλαίω	kleo
δυσκολία	ðiskolia
ευημερώ	evimeɾo
αποταμιεύθηκα	apotamiefθika
απολύομε	apoliome
έδιωξα	eðʝoksa
δικάζω	ðikazo
ακοομέτρηση	akoometrisi
αγνάντεψε	aɣnandepse
αλφάβητον	alfaviton
ακυρώσεωσ	aciɾoseos
δώρα	ðoɾa
ανασάλεψε	anasalepse
ισόγειο	isoʝio
σκίζομαι	scizome
ανακοινώνομαι	anacinonome
αλαμπουρνέζικα	alaburnezika
παιδεύομαι	peðevome
αγγελιασμένοσ	aŋɟeʎazmenos
εισακούσθηκα	isakusθika
μωρό	moɾo
κλίνομαι	klinome
κοινή	cini
ουγκιά	uŋɟa
δέχομαι	ðexome
γαμιάσ	ɣamɲas
ξόδεψα	ksoðepsa
παράξενα	paɾaksena
χάριν	xarin
διατηρούμε	ði̯atiɾume
βλαμμένη	vlameni
ενστερνίζομαι	ensternizome
στενοχωρούμε	stenoxorume
σπουργιτιών	spuɾʝitçon
δαχτυλιά	ðaxtiʎa
τσιγγάνοσ	tsiŋɡanos
πουλί	puli
απαρχαιωμένεσ	aparçeomenes
έτριψα	etripsa
λυκάνθρωποσ	likanθɾopos
συγχάρηκαν	siŋxaɾikan
επιγραφτήκανε	epiɣraftikane
ενοχλήθηκα	enoxliθika
θεόδωροσ	θeoðoɾos
κουμπώνω	kumbono
αύγουστε	avɣuste
κλεφτρόνι	kleftɾoni
χρόνια	xronia
ιούνιε	iunie
παρακαλούμε	parakalume
προέτρεψα	pɾoetɾepsa
συμβούλευσα	siɱvulefsa
γιορτάστηκα	ʝoɾtastika
δούλα	ðula
λαλημένοσ	lalimenos
ταλαιπωρούμαι	talepoɾume
παρίσι	paɾisi
κεσέμια	cesemɲa
δαγκαθεί	ðaŋɡaθi
στεναγμόσ	stenaɣmos
κλεισμένοι	klizmeni
επανειλημμένωσ	epanilimenos
ηγουμένη	iɣumeni
στεναχωρημένεσ	stenaxorimenes
σώζω	sozo
τούτοισ	tutis
πατέρεσ	pateres
προηγουμένησ	proiɣumenis
καριόλα	kaɾʝola
τηλεσκόπιον	tileskopion
απασχόλησα	apasxolisa
σκατόγρια	skatoɣɾia
λιμένεσ	limenes
κωστήσ	kostis
καινοτομιών	cenotomion
σκέφτομαι	sceftome
επιγράφουμε	epiɣrafume
τραγουδισμένοσ	tɾaɣuðizmenos
ψωμάδικων	psomaðikon
φωνάρα	fonaɾa
διαλελυμένε	ðialelimene
μαζικόσ	mazikos
βιασμένοσ	viazmenos
ἐκλάπην	eklapin
χεσμένεσ	çezmenes
απαράδεκτοσ	apaɾaðektos
προσέγραψα	pɾoseɣrapsa
κορόιδευα	koɾoi̯ðeva
δέων	ðeon
αηδιασμένων	aiðiazmenon
ένρινε	enrine
διεθνισμόσ	ðieθnizmos
αναφιώτικα	anafçotika
ζουλάω	zulao
αναταράζω	anatarazo
πύργου	pirɣu
αμφιλεγόμενο	aɱfileɣomeno
καθορίζομε	kaθoɾizome
καθέλκομε	kɾuome
φάτνη	fatni
χλιοσ	xʎos
ντουζ	duz
μαρκάρω	maɾkaɾo
ιταλικόσ	italikos
τρυπιέμαι	tɾipçeme
αμείβομαι	amivome
εξεγείρω	ekseʝiɾo
αγκομαχούσα	aŋɡomaxusa
φαρμακολογία	farmakoloʝia
φυλάγω	filaɣo
ιουνίουσ	iunius
κινιέμαι	ciɲeme
συζήτησα	sizitisa
συγγραφεῦ	siŋɣrafef
μισθώνομαι	misθonome
πέμπτη	pempti
σκέφθηκα	scefθika
έδρα	eðɾa
αιδοιολειξία	eðioliksia
λύσουν	lisun
χρονολογίεσ	xronoloʝies
εξαναγκάζομε	eksanaŋɡazome
ναζού	nazu
τέλειωσα	teʎosa
εβδομήκοντα	evðomikonda
περιοδικό	perioðiko
αναθαρρεύω	anaθaɾevo
λιγότεροι	liɣoteri
έλαμψα	elampsa
αγγαρεύω	aŋɡaɾevo
μουσκεμένη	muscemeni
κόκκινο	kocino
θεοφάνια	θeofania
εισπνέουμε	ispneume
κρεμάστηκα	kɾemastika
ζενίθ	zeniθ
εγγράφτηκαν	eŋɣraftikan
εφάπτομαι	efaptome
ντετέκτιβ	detektiv
λιμόσ	limos
αισθάνομαι	esθanome
ἱκέτευσα	icetefsa
αδειάζω	aðʝazo
συμπαθιέμαι	simbaθçeme
ανακρίθηκα	anakɾiθika
ε	e
ήπιεσ	ipçes
αποβλήθηκα	apovliθika
αγαπημένε	aɣapimene
ποικίλη	picili
κλεισμένουσ	klizmenus
αλφάβητοι	alfaviti
στα	sta
κρατάω	kɾatao
κωνσταντίνε	konstandine
έντονοσ	endonos
φάσκιωσα	fasciosa
αίασ	eas
δίπλα	ðipla
γνωρίζω	ɣnoɾizo
ανατράπηκα	anatɾapika
παραδεκτόσ	paɾaðektos
γκαστρωμένη	ɡastɾomeni
χαμπάρι	xabaɾi
ματώνομαι	matonome
πρωτομάρτυρασ	pɾotomaɾtiɾas
αβλαβήσ	avlavis
αποσείω	aposio
ιανουαρίουσ	ianuaɾius
πακετάρισα	pacetaɾisa
πρωταθλήτρια	pɾotaθlitɾia
κέφια	cefça
συγκόπτουμε	siŋɡoptume
οκτώβρησ	oktovɾis
συζητημένοσ	sizitimenos
έχαψα	exapsa
ἐκωλύθην	ekoliθin
καταφρονιέμαι	katafɾoɲeme
μεταφράσθηκα	metafɾasθika
βαφλιέρα	vafʎeɾa
αναδεύω	anaðevo
παντρεμένησ	pandɾemenis
έγκυοσ	eŋɟios
αρχικώσ	arçikos
ποικιλότατοι	picilotati
θαλαμηγόσ	θalamiɣos
παράβαλλε	paɾavale
αντάμωσα	andamosa
χιμπατζήσ	çimbandzis
ημέρεψα	imeɾepsa
αγγέλλομαι	aŋɟelome
έγκριση	eŋɡɾisi
λυμένου	limenu
απαλείφουμε	apalifume
μειώνω	miono
λάμδα	lamða
ενρινοτήτων	enrinotiton
υποπτεύθηκα	ipoptefθika
αγγελμένοσ	aŋɟelmenos
δανάησ	ðanais
αποκόπτω	apokopto
αναγνωρισμένε	anaɣnorizmene
εξετέλεσα	eksetelesa
αγγισμένου	aŋɟizmenu
προμηθεύτηκα	pɾomiθeftika
δημεύτηκα	ðimeftika
μυγοπαγίδα	miɣopaʝiða
έφραξα	efraksa
αναστασία	anastasia
αναθεματισμένοσ	anaθematizmenos
αναζωογόνηση	anazooɣonisi
επισυνάπτω	episinapto
κατοικήθηκα	katiciθika
βουτυροκομία	ɾokomia
ξεσπιτώνω	ksespitono
αναδιοργανώνομαι	anaðioɾɣanonome
μπαστούνι	bastuni
λύθηκαν	liθikan
θλίψη	θlipsi
νάζαρα	nazara
αναγνωρισμένεσ	anaɣnorizmenes
διπλανοί	ðiplani
κραγμένοσ	kɾaɣmenos
ειλημμένο	ilimeno
πρησμένεσ	pɾizmenes
καταφθάνω	katafθano
κουτσουλιά	kutsuʎa
φιλιών	filion
κωλοφωτιά	kolofotça
αποστολή	apostoli
μπονατσάρει	bonatsaɾi
αποκρούω	apokruo
ανευρέθηκα	anevɾeθika
συγγραφεῖσ	siŋɣrafis
υποβοηθούμενου	ipovoiθumenu
κερί	cerri
περιπλέω	peripleo
ψι	psi
σφιχτά	sfixta
μειοψηφίασ	miopsifias
διαπλέω	ðiapleo
σύνορο	sinoro
ξεκωλιάζομαι	ksekoʎazome
τρεισ	tɾis
βάρβαροσ	varvaros
καθικάκι	kaθikaci
κατάβαλε	katavale
πανικοβάλλομαι	panikovalome
γουστάρισα	ɣustaɾisa
δακτυλογράφησα	ðaktiloɣɾafisa
μαλακισμένου	malacizmenu
τοποθετούμε	topoθetume
αποκρύπτομε	apokɾiptome
κλεισμένο	klizmeno
ομολογείτε	omoloʝite
γιατροί	ʝatɾi
βουτυρώνω	vutiɾono
κλείω	klio
ερρινότησ	erinotis
αναγεννησιακό	anaʝenisiako
στολίζω	stolizo
γλωσσίτσα	ɣlositsa
βαθιών	vaθçon
υπομονή	ipomoni
αγγισμένοι	aŋɟizmeni
αγανακτισμένη	aɣanaktizmeni
εκκολάπτω	ekolapto
ανασκάφτω	anaskafto
προηγούμενησ	proiɣumenis
υποθηκεύθηκα	ipoθicefθika
αβγατισμένου	avɣatizmenu
εννοώ	enoo
νταμάρι	damaɾi
διώχτηκα	ðʝoxtika
αναγκάζω	anaŋɡazo
ἀπεύχομαι	apefxome
ψήφισμα	psifizma
σοφήσ	sofis
παρασκευάζω	paɾascevazo
αποθηκεύθηκα	apoθicefθika
τείνομε	tinome
αποκλεισμένων	apoklizmenon
βρικόλακασ	vɾikolakas
εκλάπην	eklapin
αναβόσβησα	anavozvisa
έρρινουσ	erinus
πλειονοψηφία	plionopsifia
αντιμετώπισα	andimetopisa
ακοινωνησιών	acinonisçon
απριλίου	apɾiliu
προηγούμενεσ	proiɣumenes
μορφέασ	morfeas
τάφροσ	tafros
ἔφραξα	efraksa
βλάπτομαι	vlaptome
κάστρο	kastro
αγριοκοιτάζομαι	aɣɾiocitazome
θλίβω	θlivo
επιβάλλω	epivalo
γιορτάζω	ʝoɾtazo
αλάσκα	alaska
μάδυτοσ	maðitos
γονυπετέσ	ɣonipetes
πλακούντασ	plakundas
εκτελέστηκα	ektelestika
δενδροχρονολόγηση	ðendroxronoloʝisi
αβέβαιοσ	aveveos
θλιβεροί	θliveɾi
αποκλεισμένου	apoklizmenu
ποικιλότερη	piciloteri
τσουράπι	tsuɾapi
θεραπεύω	θeɾapevo
φουμάρισα	fumaɾisa
κουραστικούσ	kurastikus
στριμμένο	stɾimeno
κουλουριάστηκα	kuluɾʝastika
ζεσταμένου	zestamenu
καθισμένησ	kaθizmenis
διαπρέπω	ðiapɾepo
παρακείμενη	paɾacimeni
στεναχωρούμε	stenaxorume
βλάφτω	vlafto
ακοήσ	akois
ψημένουσ	psimenus
χοντροκώλησ	xondɾokolis
θριάμβευσα	θɾiaɱvefsa
ανακατώνω	anakatono
ερρινότητεσ	erinotites
κκε	kukue
επισυνήφθη	episinifθi
σκόπια	skopça
ακύρωσησ	aciɾosis
πιλοτάρισα	pilotaɾisa
χαραμίζω	xaɾamizo
δεχτεί	ðexti
εσωκλείομε	esokliome
ηγέρθη	iʝeɾθi
αναθεματισμένη	anaθematizmeni
διψασμένα	ðipsazmena
έκαψα	ekapsa
μαζικότεροσ	mazikoteros
τρεχούμενη	tɾexumeni
είχατε	ixate
πουθενά	puθena
γαλλία	ɣalia
κινούμενοσ	cinumenos
αποκρύψεισ	apokɾipsis
ωφελούμαι	ofelume
οραματίστηκα	oɾamatistika
αβανγκαρντισμόσ	avaŋɡaɾdizmos
γέννησισ	ʝenisis
κανακεύτε	kanacefte
φλερτ	fleɾt
ανακτώ	anakto
απαλλαγή	apalaʝi
εξολοθρεύθηκα	eksoloθɾefθika
στέκω	steko
υποθάλπουμε	ipoθalpume
σεπτέμβριοι	septeɱvɾii
ολόφωτο	olofoto
επαρκήσ	epaɾcis
ψυχιατρικοί	psiçatrici
όμορφεσ	omoɾfes
λήθη	liθi
κοτσάρισε	kotsaɾise
σκύβω	scivo
άνεση	anesi
βελτιώνομαι	veltionome
μοιρασμένοσ	miɾazmenos
καταλύω	katalio
εξοχότατοσ	eksoxotatos
κοροϊδεύομαι	koɾoi̯ðevome
μεσαιωνικών	meseonikon
ανεπανόρθωτοσ	anepanorθotos
μοιρασμένε	miɾazmene
τσίσα	tsisa
πιέστηκα	piestika
προσβλέπω	pɾosvlepo
βουλευτήσ	vuleftis
σβήνω	zvino
γδέρνω	ɣðerno
ρουφηγμένοσ	ɾufiɣmenos
αποδεικνύομε	apoðikniome
αγουστιών	aɣustçon
αιματοκυλίζω	ematocilizo
απολύομαι	apoliome
θλιβερού	θliveɾu
κουράστηκα	kuɾastika
ντροπιάζομαι	dɾopçazome
κιτσαρία	citsaɾia
τάφρε	tafre
διπλασιάζω	ðiplasiazo
εξαναγκάζουμε	eksanaŋɡazume
ειλημμένων	ilimenon
τσίτσιδοσ	tsitsiðos
περισπωμένησ	perispomenis
αβγατίζομαι	avɣatizome
καπνοδόχο	kapnoðoxo
αχαιόσ	açeos
μειονοψηφίασ	mionopsifias
μπάντα	banda
ακουστικόσ	akustikos
κακογαμημένοι	kakoɣamimeni
κεκλεισμένε	ceklizmene
καταργούμαι	kataɾɣume
προσγειώθηκα	pɾozʝioθika
ἐξήρθην	eksirθin
ασυγχώρητοσ	asiŋxoritos
σοφόσ	sofos
ναυτολογίων	naftoloʝion
ανιψούληδεσ	anipsuliðes
ιερόσ	ieɾos
ολόφωτα	olofota
περηφάνια	perifaɲa
γηροκομείο	ʝiɾokomio
πλέκομαι	plekome
μεγαλομάρτυρασ	meɣalomaɾtiɾas
ηθοποιία	iθopiia
ταράχτηκα	taraxtika
λυνόσαστε	linosaste
ανατείνομαι	anatinome
αντέστε	adeste
φωτογράφησα	fotoɣɾafisa
αναγγέλλουμε	anaŋɟelume
ακολασία	akolasia
άσεβα	aseva
εγκλείστηκα	eŋɡlistika
επανιδρύομαι	epaniðriome
ντουλάπι	dulapi
δημήτρησ	ðimitɾis
αναλογώ	analoɣo
ευσέβαστοσ	efsevastos
νοεμβρίου	noeɱvɾiu
μύγα	miɣa
αθίγγανοσ	aθiŋɡanos
αλήτεψα	alitepsa
διαθλάστηκα	ði̯aθlastika
αγιοποιημένων	aʝiopiimenon
εγγράφηκε	eŋɣrafice
χρόνια	xroɲa
συσσωρεύτηκα	sisoɾeftika
κουβαλάω	kuvalao
οφείλω	ofilo
στυμμένα	stimena
ιουλίου	iuliu
διαλυμένοι	ðʝalimeni
συμπαθάω	simbaθao
έσκαζα	eskaza
γκεσέμι	ɟesemi
ίδιοσ	iðʝos
συνδέομε	sinðeome
πρησμένων	pɾizmenon
ορμούζ	ormuz
παράβαλε	paɾavale
μυρωμένο	miromeno
εμπνέομαι	embneome
απεδείχθη	apeðixθi
παζαρεύομαι	pazaɾevome
διαχέομε	ðʝaçeome
απολογητικέσ	apoloʝitices
μάρτιοι	maɾtii
χριστόψωμα	xristopsoma
παροτρύνω	paɾotɾino
απαράδεκτοι	apaɾaðekti
επακολουθώ	epakoluθo
τριμμένο	trimeno
πυραυλικόσ	piɾavlikos
συνδέουμε	sinðeume
σύνορα	sinora
μασούρι	masuɾi
πολωνικοί	polonici
συντομεύθηκα	sindomefθika
καλομάνασ	kalomanas
πλακομούνι	plakomuni
τέρπομαι	teɾpome
αξίζει	aksizi
διαρρέτε	ðʝareete
ακοσμία	akozmia
ιεράπετρα	ieɾapetɾa
κοινολέκτου	cinolektu
ψηφιακέ	psifiace
αιφνιδιάζω	efniðiazo
εξημερώνω	eksimeɾono
επανειλημμένησ	epanilimenis
ισχυρίστηκα	isçiɾistika
βεβαίωσ	veveos
παρηγοριών	paɾiɣoɾʝon
ερωτεύθηκα	eɾotefθika
υγειά	iʝa
α	a
χόρτασα	xoɾtasa
συνεθλίβη	sineθlivi
διαλελυμένο	ðialelimeno
ανοίγω	aniɣo
φυτικόν	fitikon
προφορά	pɾofoɾa
χορό	xoɾo
ορίστηκα	oɾistika
αγγίζω	aŋɟizo
σαρώθηκα	saɾoθika
έλεοσ	eleos
πέρασ	peɾas
αλληλοσυγκρουόμενων	alilosiŋɡruomenon
αλαμπάμα	alabama
βαθμολογημένουσ	vaθmoloʝimenus
επαλείφθηκα	epalifθika
παρακαλιέμαι	parakaʎeme
ανάταση	anatasi
καρατομώ	kaɾatomo
ανακρούομαι	anakruome
ξεκουράζομαι	ksekuɾazome
λουφάρω	lufaɾo
τεσσερισήμισι	teseɾisimisi
δυσανάγνωστοσ	ðisanaɣnostos
καλομοίρικου	kalomiriku
αποτρέπουμε	apotɾepume
μασχάλη	masxali
επανενάρξεων	epanenaɾkseon
ταριχεύθηκα	taɾixefθika
εισρέω	izreo
κοσμοπολίτη	kozmopoliti
αγκιστρωμένοσ	aŋɟistɾomenos
υδροπτέρυγο	iðropteɾiɣo
λυσσώ	liso
ελκύω	elcio
ηγουμένων	iɣumenon
αποδεικνύουμε	apoðikniume
ύψιλον	ipsilon
άχου	axu
έρρινεσ	erines
γλιτώνω	ɣlitono
κοντρολάρισα	kondrolaɾisa
τιτάνοσ	titanos
ξελύθηκα	kseliθika
ξινό	ksino
πεντάγωνο	pendaɣono
περιστρέφω	peɾistɾefo
ευθυμίασ	efθimias
καθισμένο	kaθizmeno
είντα	inda
εθνάρχου	eθnarxu
αιματοβαμμένε	ematovamene
κλέψασ	klepsas
κατέβαλα	katevala
πλειονοτήτων	plionotiton
αβουλιών	avulion
ανακύπτω	anacipto
κλόουν	kloun
αργώ	aɾɣo
κούμπωσα	kumbosa
τσαμπουκάσ	tsambukas
καλομαθημένου	kalomaθimenu
ευθανασία	efθanasia
ερχομένουσ	erxomenus
μετράω	metɾao
επεγράφη	epeɣrafi
υπαγόρευσα	ipaɣoɾefsa
αγκυλιών	aŋɟiʎon
εδέησα	eðeisa
δυνάμεισ	ðinamis
πορτοκαλόπιτασ	poɾtokalopitas
κάθετοσ	kaθetos
κοριτσάρασ	koritsaras
εὔχομαι	efxome
δοκιμαστικά	ðocimastika
εκλέχθηκα	eklexθika
φιξάρισα	fiksaɾisa
νόστιμοσ	nostimos
μαρτυράμε	maɾtiɾame
κτήματα	ktimata
κουβαλώ	kuvalo
εισπλέω	ispleo
νοστίμεψε	nostimepse
παντεσπάνι	pandespani
βασκάνετε	vaskanete
πολωνικέ	polonice
γούστο	ɣusto
κλαρινέτο	klaɾineto
τιτάνεσ	titanes
συγγράφομε	siŋɣrafome
συγχαρήκανε	siŋxaɾikane
κοτομπουκιά	kotobuca
έφθασα	efθasa
αποδειχτήκανε	apoðixtikane
μύρρο	miɾo
πρωτοκολλήθηκα	pɾotokoliθika
ανυπομονώ	anipomono
απολύουμε	apoliume
απαγορεύω	apaɣorevo
ολόφωτοι	olofoti
ιδρύομαι	iðriome
ζευγάρι	zevɣari
σίγουροσ	siɣuɾos
διαλελυμένου	ðialelimenu
αντζούγια	andzuʝa
νιάτα	ɲata
αναγεννησιακή	anaʝenisiaci
πασάλειψα	pasalipsa
κουρασμένοσ	kurazmenos
περιέπλευσα	perieplefsa
στρώμα	stɾoma
παραβλήθηκα	paɾavliθika
συνθλίβομαι	sinθlivome
υπαγορεύομε	ipaɣoɾevome
νοιάζει	ɲazi
αεροφωτογραφίζω	aerofotoɣrafizo
τσιτσίδι	tsitsiði
αγιασματάρια	aʝazmatarʝa
προετοίμασα	pɾoetimasa
γέροσ	ʝeɾos
ανανάσ	ananas
πεθαμένοι	peθameni
πατέρα	patera
διεγείρουμε	ðieʝiɾume
μετρονόμοσ	metɾonomos
αποστάζω	apostazo
νεκρή	nekɾi
αμ	astɾonomicimonaða
τσακώνικεσ	tsakonices
καλμάριζε	kalmaɾize
αγαπιέμαι	aɣapçeme
γουστάρω	ɣustaɾo
φοροαπαλλαγέσ	foɾoapalaʝes
αθετήθηκα	aθetiθika
φθινοπωριάτικα	fθinopoɾʝatika
βοηθῶ	voiθo
κορόιδευ'	koɾoi̯ðef
αναστηλώσεισ	anastilosis
νεκροφυλακείο	nekɾofilacio
ευσεβών	efsevon
μειονότητεσ	mionotites
αλογόμυγα	aloɣomiɣa
καταβάλλουμε	katavalume
εννέα	enea
αναγράφω	anaɣrafo
ακοών	akoon
παριστάνω	paristano
αντλούμε	andlume
σοφών	sofon
χαλασμένοσ	xalazmenos
στερήσεων	steɾiseon
κωλοφυλλάδα	kolofilaða
υπολογισμένησ	ipoloʝizmenis
κατέστην	katestin
εμβόλιο	eɱvolio
κοίταξα	citaksa
κοιτίδασ	citiðas
βάλλομαι	valome
παρακείμενο	paɾacimeno
ποικίλησ	picilis
φιλημένοσ	filimenos
δεκαεννιά	ðekaeɲa
ψαρεύω	psaɾevo
διαβεβαιώνομαι	ði̯aveveonome
απόφαση	apofasi
πούλι	puli
παραχαϊδεύτηκα	paɾaxai̯ðeftika
απασχολημένου	apasxolimenu
κωλόχαρτο	koloxaɾto
αλλοιώσεων	alioseon
διαμορφώνω	ði̯amoɾfono
υποβοηθούμενοι	ipovoiθumeni
αγαπημένοσ	aɣapimenos
μαγειρεύτηκα	maʝiɾeftika
ανδρώνω	anðɾono
αμοιβαιότητα	amiveotita
λάρνακα	laɾnaka
ομοφωνία	omofonia
αναγεννησιακόσ	anaʝenisiakos
συνδέομαι	sinðeome
τιτάνων	titanon
ένρινεσ	enrines
αναδημιουργημένησ	anaðimiurʝimenis
βασιλεύσ	vasilefs
πιόνια	pçoɲa
αμφισβιτιέμαι	aɱfisvitçeme
βρόμη	vɾomi
διψασμένεσ	ðipsazmenes
μαζικότατων	mazikotaton
σκασμένου	skazmenu
στειμμένε	stimene
μαζικότατα	mazikotata
στάζομαι	stazome
πλίνθε	plinθe
πασχαλίτσα	pasxalitsa
αγκωνιάζω	aŋɡoɲazo
χορέψαν	xoɾepsan
ντεντέκτιβ	dedektiv
δεη	ðei
πουδραρίζομαι	puðɾaɾizome
αλυσοδεμένη	alisoðemeni
κούκλοσ	kuklos
ανακάμψεισ	anakampsis
αμορφωσιά	amoɾfosça
πασαλείφτηκα	pasaliftika
βρεμένοσ	vɾemenos
πακέτο	paceto
συγγραφτείσ	siɣraftis
ομολογημένοσ	omoloʝimenos
ντελαπάρισα	delapaɾisa
γαμώντασ	ɣamondas
μπερδεμένα	beɾðemena
ρώγα	roɣa
απέσπασα	apespasa
συντρίφθηκα	sindrifθika
αρπάζομαι	aɾpazome
αλατισμένου	alatizmenu
κίμωλοσ	cimolos
ξελογιαστήσ	kseloʝastis
αναγκάζομε	anaŋɡazome
μισισίπι	misisipi
προσεύχομαι	prosefxome
καταναγκάζω	katanaŋɡazo
αντηχώ	andixo
στιμμένο	stimeno
αναζωογονώ	anazooɣono
αναμαλλιασμένε	anamaʎazmene
δαμασκόσ	ðamaskos
προσκρούω	proskruo
ερρίνωσ	erinos
παρακείμενοι	paracimeni
μαγείρεψα	maʝiɾepsa
λεσβιάζω	lezviazo
συνουσία	sinusia
αγγισμένων	aŋɟizmenon
μαντεύτηκα	mandeftika
κούλουρη	kuluɾi
ακτινογραφία	aktinoɣɾafia
παιδεύτηκα	peðeftika
συμπληρώνω	simbliɾono
θρησκόληπτοσ	θɾiskoliptos
αλευρωμένου	alevromenu
απελπισία	apelpisia
κεκλεισμένο	ceklizmeno
κατασκόπευσα	kataskopefsa
πολεμικούσ	polemikus
αηδιασμένη	aiðiazmeni
αναθάρρησα	anaθaɾisa
αντικρούουμε	andikruume
ξερογλείφομαι	kseɾoɣlifome
πλέκω	pleko
διψασμένου	ðipsazmenu
κουλούρι	kuluɾi
απαλείφομε	apalifome
έπλεξα	epleksa
πατροκτονία	patɾoktonia
εγγράφομαι	eŋɣrafome
ρωτημένοσ	ɾotimenos
τηγανητόσ	tiɣanitos
διάρροια	ðʝaɾia
καταγραφείσ	kataɣrafis
υπολογιστικόσ	ipoloʝistikos
ακολουθώ	akoluθo
μεθυσμένοσ	meθizmenos
ξύνομαι	ksinome
καθέκλα	kaθekla
σώμα	soma
προσκάλεσα	pɾoskalesa
δημοτική	ðimotici
αντέτε	adete
κατέφθασα	katefθasa
βομβαρδίζω	voɱvarðizo
στύβομαι	stivome
τάφροι	tafri
εκτρέπω	ektɾepo
ταλαιπωρία	talepoɾia
λευκοί	lefci
μάηδεσ	maiðes
παππούσ	papus
αναστυλώνομαι	anastilonome
ολόκαινοσ	olocenos
αναπότρεπτοσ	anapotɾeptos
ειδύλλιο	iðilio
ξέκωλοι	ksekoli
φρεσκάριζε	fɾeskaɾize
χτικιάζω	xticazo
δύναμησ	ðinamis
βασιλική	vasilici
κοινώνησα	cinonisa
ηλικιωμένοι	iliciomeni
βράδυ	vraði
εντροπή	endɾopi
ασ'	as
αγαπώ	aɣapo
προηγούμενοσ	pɾoiɣumenos
ήπειροσ	ipiɾos
κίτρο	citɾo
πηδάω	piðao
αγρόκτημα	aɣɾoktima
δεκέμβρησ	ðeceɱvɾis
κλαψομούνησ	klapsomunis
δούλοσ	ðulos
φοράω	foɾao
φασκιώθηκα	fascioθika
αμάρτυροσ	amaɾtiɾos
λυμένα	limena
στριμμένησ	stɾimenis
γκαστρωμένεσ	ɡastromenes
αμοργέ	amoɾʝe
διαμορφώσεισ	ði̯amoɾfosis
δηλώθηκα	ðiloθika
υπογράφουμε	ipoɣrafume
πιλοτάρισε	pilotaɾise
σχίζω	sçizo
παραγράφηκα	paɾaɣɾafika
κυριακή	cirʝaci
περιέγραψα	peɾieɣrapsa
συνδυάσθηκα	sinðiasθika
αντικρούστηκα	andikrustika
αγγελόκρουσα	aŋɟelokrusa
φλόκοι	floci
αποξενώνω	apoksenono
αλαλάζω	alalazo
πόνταρα	pondaɾa
συγκρουόμενων	siŋɡruomenon
περιοδικούσ	perioðikus
κάππα	kapa
αναπαρασταίνομαι	anaparastenome
οπαδόσ	opaðos
δέλτα	ðelta
αγιοποιημένησ	aʝiopiimenis
γιώτα	ʝota
υποτελήσ	ipotelis
μετέφερα	metefeɾa
έχουν	exun
πολέμαγα	polemaɣa
στουτγάρδη	stutɣarði
μαζικέ	mazice
αφοσιωμένοσ	afosiomenos
αποστάσεισ	apostasis
ἔστρεψα	estɾepsa
αντιδράσεισ	andiðɾasis
αμεριμνησίασ	ameɾimnisias
απορρόφησα	apoɾofisa
βηρυτόσ	viritos
τιτάνα	titana
αισιοδοξούσα	esioðoksusa
εξαπολύθηκα	eksapoliθika
αντιβαίνω	andiveno
μπουγαζιού	buɣazʝu
θεοφανίων	θeofanion
κακοκεφιέσ	kakocefçes
θρόνοσ	θronos
πεινασμένα	pinazmena
εορτάσθηκα	eoɾtasθika
απολογητικώσ	apoloʝitikos
μαστόσ	mastos
τεμπελιάζω	tembeʎazo
προφητεύω	pɾofitevo
ιανουάριοσ	ianuaɾios
επιχείρηση	epiçiɾisi
παραπέμπομαι	paɾapembome
ραγιά	ɾaʝa
ματοβαμμένουσ	matovamenus
αγριοκοιταγμένοσ	aɣɾiokitaɣmenos
νεκροστάσιο	nekɾostasio
γένεσισ	ʝenesis
κωνσταντίνασ	konstandinas
βουλιάξτε	vuʎakste
λέγει	leʝi
λύσσαξε	lisakse
διαδηλώνομαι	ðʝaðilonome
διαδηλώνομαι	ði̯aðilonome
αποστέλλω	apostelo
ηλικιωμένοσ	iliciomenos
φοροαπαλλαγή	foɾoapalaʝi
συσσωρεύομαι	sisoɾevome
αιματοβαμμένοι	ematovameni
γκρίζου	ɡɾizu
αρνούμαι	aɾnume
σέντερ	sendeɾ
μέμφομαι	memfome
εγχέουμε	eŋçeume
αναλογίζομαι	analoʝizome
βλαμμένουσ	vlamenus
όζοσ	ozos
ξερογλείφτηκα	kseɾoɣliftika
συρράπτω	siɾapto
βαστάζομαι	vastazome
αναδέχτηκα	anaðextika
απόδειξα	apoðiksa
αναπληρώσεισ	anapliɾosis
απορροφούμενοι	apoɾofumeni
ακρίτασ	akritas
δαγκωθεί	ðaŋɡoθi
μαράθηκα	maɾaθika
επαναφέρθηκα	epanafeɾθika
αδρανοποιημένοσ	aðranopiimenos
ηλικιωμένων	iliciomenon
πολωνικούσ	polonikus
κρεμασμένο	kremazmeno
χτήνοσ	xtinos
συγχώρησα	siŋxoɾisa
αγγόνι	aŋɡoni
προχωράω	pɾoxoɾao
συνθλίβω	sinθlivo
απορροφούμενε	apoɾofumene
αρχήθεν	arçiθen
πλέκουμε	plekume
αλευρωμένουσ	alevromenus
μαρκαρίστηκα	maɾkaɾistika
εκτρέπομαι	ektɾepome
άπειρων	apiron
δημιούργησα	ðimiuɾʝisa
προσκαλέστηκα	pɾoskalestika
αγιασματάριο	aʝazmatario
χορέψανε	xoɾepsane
απρίλιοι	apɾilii
περισπωμένεσ	perispomenes
κουκουλοφόροσ	kukulofoɾos
στενοχωρημένου	stenoxorimenu
αδρανοποιώ	aðɾanopio
αγγέλλω	aŋɟelo
τριμμένουσ	trimenus
έκρηξη	ekɾiksi
γαβ	ɣav
ξαπλώνω	ksaplono
ανασυνιστώ	anasinisto
αλαφιασμένη	alafçazmeni
όλυμποσ	olimbos
κραγμένα	kraɣmena
βάστηξα	vastiksa
πλειστηριασμόσ	plistiriazmos
στέρησησ	steɾisis
ονομάζομαι	onomazome
συνεβούλευσα	sinevulefsa
πολύ	poli
αραχνιασμένου	aɾaxɲazmenu
συμβουλή	siɱvuli
αναφυτεύθηκα	anafitefθika
παιδί	peði
αραχνίτσα	aɾaxnitsa
θεωρία	θeoria
μουνάρα	munaɾa
δημήτριοσ	ðimitɾios
διαρρέω	ðiareo
ήμεθα	imeθa
καλομαθημένο	kalomaθimeno
κερδίζομαι	cerðizome
ξεχειλίζω	kseçilizo
θερμοδυναμικέσ	θermoðinamices
νοικιάζω	nicazo
μεσαιωνικούσ	meseonikus
προσευχήθηκα	prosefçiθika
μπερδεμένων	beɾðemenon
πνεύμα	pnevma
διαδοχή	ðʝaðoçi
εμπνεύστηκα	embnefstika
επωμίστηκα	epomistika
φύτεψα	fitepsa
παρεξετράπην	paɾeksetɾapin
κακοκεφιέσ	kakocefi̯es
τυλίγομαι	tiliɣome
αράχνη	aɾaxni
φλερτάκι	fleɾtaci
σκατάσ	skatas
ποικίλε	picile
αναστυλώνω	anastilono
έλυσε	elise
κοκκίνου	kocinu
θεραπεύομαι	θerapevome
έωσ	eos
προφασίστηκα	pɾofasistika
πλησιάστηκα	plisiastika
ανάλωσα	analosa
έφηβη	efivi
αστέρασ	asteɾas
ενορχηστρώνω	enoɾçistɾono
αγανταρισμένοσ	aɣandaɾizmenos
κουκλάκι	kuklaci
ακοομέτρων	akoometron
διαλελυμένα	ðialelimena
άμαθοσ	amaθos
εγέρθηκα	eʝeɾθika
πάμμαυρεσ	pamavɾes
αμφιλεγόμενα	aɱfileɣomena
γκρίζα	ɡɾiza
φιξάρομαι	fiksaɾome
εμπορία	emboria
λαθραίοσ	laθɾeos
μολύβι	molivi
καντάδα	kandaða
αγιάγκαθο	aʝaŋɡaθo
καψώνι	kapsoni
μπομπότα	bobota
παρεξήγηση	paɾeksiʝisi
δράμι	ðrami
υπολήπτομαι	ipoliptome
μαζική	mazici
καλόσ	kalos
ντροπιαστικόσ	dɾopçastikos
στεναχωρημένο	stenaxorimeno
ανεξολόθρευτοσ	aneksoloθɾeftos
προσέφερα	pɾosefeɾa
ανταλλάζομαι	andalazome
απολίθωμα	apoliθoma
μειώνομαι	mionome
εξέπλευσα	ekseplefsa
κινδυνεύω	cinðinevo
απελπισμένοσ	apelpizmenos
κούνια	kuɲa
καταβάλλομαι	katavalome
ενσταλάζω	enstalazo
αποκατασταίνω	apokatasteno
ζήλοσ	zilos
άθεοσ	aθeos
αξιογέλαστοσ	aksioʝelastos
νοέμβρησ	noeɱvɾis
επιτυχία	epitiçia
συνεχάρη	sinexari
χαλάω	xalao
θυμωμένο	θimomeno
αισχρόσ	esxros
συνθετικά	sinθetika
μαζικήσ	mazicis
ανθρωποκτονία	anθɾopoktonia
κανακέψει	kanacepsi
ήπια	ipia
επανίδρυσα	epaniðrisa
ο	o
μοσχοκάρυδο	mosxokaɾiðo
έσυρα	esira
αβαράρω	avaɾaɾo
αγωνίζομαι	aɣonizome
παραγίνομαι	paɾaʝinome
εγκατέστησα	eŋɡatestisa
αίθουσα	eθusa
φυτικαῖσ	fitices
χρησιμοποιήθηκα	xɾisimopiiθika
επανακάμπτω	epanakampto
σιλάσ	silas
κατοίκησα	katicisa
πάμμαυρο	pamavɾo
ψηφιακά	psifiaka
ερεθίζω	eɾeθizo
αραχνάκι	aɾaxnaci
αγγίζουμε	aŋɟizume
στοχάστηκα	stoxastika
χειρότεροσ	çiɾoteɾos
αγιοποιημένεσ	aʝiopiimenes
λέγω	leɣo
θεοτόκοσ	θeotokos
έλυσεσ	elises
προστατεύθηκα	pɾostatefθika
πούστησ	pustis
φεβρουαρίουσ	fevɾuaɾius
αίσθημα	esθima
εσωκλείουμε	esokliume
κρίνων	krinon
ντάγκλα	daɡla
μυρωμένη	miromeni
υποκλέπτουμε	ipokleptume
ήμαστε	imaste
αρμοδίωσ	aɾmoðios
καλοφάγωτουσ	kalofaɣotus
προσγράφηκα	pɾozɣrafika
υπολογιστικά	ipoloʝistika
άλειψα	alipsa
καταγραφτείσ	kataɣraftis
υγιεινή	iʝiini
σεπτέμβρησ	septeɱvɾis
εμπρόσ	embros
φαντασία	fandasia
αξιολογώ	aksioloɣo
κλεισμένοσ	klizmenos
ὑπέγραψα	ipeɣrapsa
ελκύομε	elciome
περισπωμένων	perispomenon
παρακωλύομε	parakoliome
ανεβαίνω	aneveno
προσεκλήθησαν	pɾosekliθisan
έκταση	ektasi
πατάω	patao
γαργάρα	ɣaɾɣaɾa
αιτιοκρατίεσ	etiokraties
μόσχα	mosxa
εξοπλισμένο	eksoplizmeno
αιτία	etia
απέκρουσα	apekrusa
μαθημένεσ	maθimenes
λυμένη	limeni
μαλάκασ	malakas
δολοφονώ	ðolofono
κυνηγόσ	ciniɣos
απωθήθηκα	apoθiθika
μυρωμένοι	miromeni
κτηνοβασία	ktinovasia
εξαναγκάζομαι	eksanaŋɡazome
χτυπούσα	xtipusa
ανανά	anana
αναρτημένοσ	anaɾtimenos
έρρινοσ	erinos
αθηναίοσ	aθineos
καταγράφομε	kataɣrafome
εξημέρωσα	eksimeɾosa
συγχωνεύω	siŋxonevo
ερχόμενοσ	erxomenos
κουρελιάστηκα	kuɾeʎastika
συγκινημένη	siŋɟinimeni
δήθεν	ðiθen
αναθεματισμένεσ	anaθematizmenes
ανεβασιά	anevasça
απαλείφομαι	apalifome
σφαλιάρα	sfaʎaɾa
σίγμα	siɣma
ανέκυψα	anecipsa
ανέγραψα	aneɣrapsa
ακονίστηκα	akonistika
πολύφωτο	polifoto
αγγισμένο	aŋɟizmeno
πλίνθων	plinθon
άνθιμοσ	anθimos
απέτισα	apetisa
ιατρεύω	iatɾevo
αλάκεροσ	alaceros
εκλέγω	ekleɣo
διαχέομαι	ðʝaçeome
ξεψυχισμένοσ	ksepsiçizmenos
μοιρασμένη	miɾazmeni
βλακεία	vlacia
νταραβερίζομαι	daɾaveɾizome
συγγράφω	siŋɣrafo
πάνσοφοσ	pansofos
παγκοσμιοποιήσεισ	paŋɡozmiopiisis
πάρκινσον	paɾcinson
αγκαζάρισα	aŋɡazaɾisa
χάρτησ	xartis
δαμάζω	ðamazo
αιματοβαμμένουσ	ematovamenus
έγνοια	eɣɲa
βιόσφαιρα	viosfeɾa
μπαρμπούλησ	baɾbulis
κοπή	kopi
σπείρω	spiro
αγιοποιημένο	aʝiopiimeno
κοτάρα	kotaɾa
αλγεινόσ	alʝinos
υπέροχοι	ipeɾoçi
χαλκίδα	xalciða
βαβαρία	vavaria
γένια	ʝeɲa
αυτό	afto
μάρκαρε	maɾkaɾe
εισπνέω	ispneo
πρωτευουσιάνα	pɾotevusiana
χρονολογώ	xronoloɣo
εμπνευσμένησ	embnevzmenis
απεκλείσθη	apeklisθi
συγκινημένων	siŋɟinimenon
συλλογίζομαι	siloʝizome
τήνε	tine
αυτοκινούμενοσ	aftocinumenos
αντέστρεψα	andestɾepsa
σουτάρισα	sutaɾisa
άκοσμοσ	akozmos
κρεμασμένεσ	kremazmenes
πρωτεύον	pɾotevon
συζητούμαι	sizitume
σαντορίνη	sandoɾini
συγκρουόμενε	siŋɡruomene
αναδημιουργημένα	anaðimiurʝimena
ενδεχομένωσ	enðexomenos
αναιδήσ	aneðis
άβλαβοσ	avlavos
κατασκευάζω	katascevazo
βλάκασ	vlakas
όρισα	oɾisa
διακόπτουμε	ðiakoptume
καθίζω	kaθizo
καρδιόσχημοσ	kaɾðiosçimos
εκλείπω	eklipo
ανακόπτω	anakopto
συγγράφτηκα	siŋɣraftika
υποβλέπω	ipovlepo
παρακάλεσα	parakalesa
κακοκεφιά	kakocefça
εγγράφομε	eŋɣrafome
αγκυροβολημένοσ	aŋɟiɾovolimenos
αδυνατώ	aðinato
πόρδοσ	poɾðos
αποστάχθηκα	apostaxθika
σάλταρα	saltaɾa
ένρινουσ	enrinus
είδωλο	iðolo
δηλαδή	ðilaði
πεπεισμένησ	pepizmenis
συγκρουόμενα	siŋɡruomena
τίνων	tinon
υποθάλπομαι	ipoθalpome
άπτομαι	aptome
αβουλησιών	avulision
αλλοιώνω	aliono
ευσέβειεσ	efsevies
πιπί	pipi
ψωλίτσα	psolitsa
οπλισμένοσ	oplizmenos
ταλαιπωρώ	talepoɾo
παρελθούσασ	parelθusas
δημιουργημένοσ	ðimiuɾʝimenos
σταμάτα	stamata
στριμμένεσ	stɾimenes
τετριμμένην	tetrimenin
αντικλεπτικών	andikleptikon
καθισμένων	kaθizmenon
αληθεύει	aliθevi
ρόγα	roɣa
ευωδιών	evoðion
αερίζομαι	aeɾizome
υπερκαινοφανήσ	ipeɾcenofanis
συρράπτουμε	siɾaptume
αναμαλλιασμένεσ	anamaʎazmenes
πειρατήσ	piratis
παρφουμάρομαι	paɾfumaɾome
αντανακλώ	andanaklo
τηλεφωνάω	tilefonao
απασχολημένο	apasxolimeno
χορεύτε	xoɾefte
επαναφέρομε	epanafeɾome
μάιοσ	maios
ανάκρουση	anakɾusi
επισκέφτηκα	episceftika
αιθέρασ	eθeɾas
οφθαλμόσ	ofθalmos
απόσπασα	apospasa
εγέρθηκαν	eʝeɾθikan
θαυμάζουμε	θavmazume
γίντισ	ʝidis
κουραστικών	kurastikon
αγυιόπαισ	aʝiopes
κεφάτοσ	cefatos
θλιμμένε	θlimene
αντικλεπτικοί	andikleptici
ὑπογράφεισ	ipoɣrafis
κορίτσαρων	koritsaron
χαλασμένο	xalazmeno
οθωμανικόσ	oθomanikos
πατσαβούρασ	patsavuɾas
αποβάλλετε	apovalete
χαλώ	xalo
αλληλεπίδραση	allilepiðɾasi
αγγονιών	aŋɡoɲon
αφουγκράζομαι	afuɡɾazome
είμεθα	imeθa
κυκλοφόρησα	ciklofoɾisa
μιλάω	milao
λευκούσ	lefkus
δηλώνουμε	ðilonume
αγανάχτησα	aɣanaxtisa
χαστούκισμα	xastucizma
γοητεύομαι	ɣoitevome
λυκανθρωπία	likanθɾopia
αγχώνομαι	aŋxonome
μεγαλομάρτυρεσ	meɣalomaɾtiɾes
αβγοκομμένη	avɣokomeni
οκτώβριοι	oktovɾii
αξιοσημείωτοι	aksiosimioti
γκάστρωμα	ɡastɾoma
ματζόρε	madzoɾe
κουραστική	kurastici
γένεση	ʝenesi
πολεμιστήσ	polemistis
εξοπλισμένα	eksoplizmena
ελιόψωμου	eʎopsomu
ρέπω	ɾepo
παρκάρισε	paɾkaɾise
σαντούρια	sandurʝa
ολόφωτεσ	olofotes
πιστεύεισ	pistevis
πέριξ	periks
συζητιέμαι	sizitçeme
αρχειοθήκη	arçioθici
άηχοσ	aixos
ακουστόσ	akustos
αμφιλεγόμενου	aɱfileɣomenu
σβηστηριών	zvistiɾʝon
κινεζοποίηση	cinezopiisi
όνοσ	onos
κλέφτησ	kleftis
τέρπομε	teɾpome
ξανάγραψα	ksanaɣɾapsa
ηλιοθεραπεία	iʎoθeɾapia
κρεμούσε	kɾemuse
ήχε	içe
αντλημένοσ	andlimenos
τρύπησα	tɾipao
περικόπτομε	peɾikoptome
διαδέχθηκα	ðʝaðexθika
ανακρίνω	anakɾino
ολόφωτου	olofotu
αποδεικνύομαι	apoðikniome
αγχωμένοσ	aŋxomenos
συμβούλεψα	siɱvulepsa
φλεβάρη	flevaɾi
αλληλοσυγκρουόμενο	alilosiŋɡruomeno
ντουμπλάριζα	dublaɾiza
ίδρυμα	iðrima
βρέχουμε	vrexume
παρακολούθησα	paɾakoluθisa
αφηγήτρια	afiʝitɾia
αποστάχτηκα	apostaxtika
σάλταρε	saltaɾe
πέμπουμε	pembume
μάρανα	maɾana
ερρινοτήτων	erinotiton
τροχόσπιτο	tɾoxospito
ανταμοιβή	andamivi
καταπλέω	katapleo
αγγέλω	aŋɟelo
ανέσκαψα	aneskapsa
καθορίζω	kaθoɾizo
γλυτώνω	ɣlitono
νεκροτομείο	nekɾotomio
θαυμάζομε	θavmazome
σταφιδόψωμο	stafiðopsomo
έκκροτοσ	ekrotos
ποδόσφαιρου	poðosferu
αήθησ	aiθis
αρμοδιότητα	aɾmoðiotita
ανασκάφθηκα	anaskafθika
χαλασμένοι	xalazmeni
αγκύλια	aŋɟiʎa
πόροι	pori
διαπνέω	ðiapneo
ανθόκηποσ	anθocipos
πίθοσ	piθos
αντιδάνειο	andiðanio
τρυπώ	tɾipo
λουιζιάνα	luiziana
ζώο	zoo
παρακάμφθηκα	paɾakamfθika
εστιατόριο	estiatoɾio
γρινιάζω	ɣɾiɲazo
σπω	spo
δοκιμάζομαι	ðocimazome
χλιων	xʎon
χοντρή	xodri
ἄρχω	arxo
πουσταράσ	pustaɾas
απρίλη	apɾili
επίδαυροσ	epiðavɾos
μπερδεμένο	beɾðemeno
πρωτομαρτύρων	pɾotomaɾtiɾon
αρματώνουμε	aɾmatonume
κοτόπουλο	kotopulo
επιγράφτηκα	epiɣraftika
ποικίλουσ	picilus
εκλέγομαι	ekleɣome
λέσβο	lezvo
γκρινιάζω	ɡɾiɲazo
απορροφούμενοσ	apoɾofumenos
ρε	ɾe
παραείδα	paɾaiða
ροδακίνου	roðacinu
ταιριάζετε	terʝazete
ροχαλητό	ɾoxalito
αβεβαίωσ	aveveos
αναλίσκω	analisko
γογγύζω	ɣoŋɟizo
διαλελυμένησ	ðialelimenis
χλια	xʎa
ταρό	taɾo
ενεγράφησαν	eneɣrafisan
αλατισμένοσ	alatizmenos
αποστειρώσεισ	apostiɾosis
ποντάριζε	pondaɾize
ανθελληνίδα	anθeliniða
βεβιασμένοσ	veviazmenos
αγγέλου	aŋɟelu
γλείφομαι	ɣlifome
ανησυχία	anisiçia
ἐπέστρεψα	epestɾepsa
αποτράβηξα	apotɾaviksa
πρωτοχρονιά	pɾotoxɾoɲa
γάντζοσ	ɣandzos
παραδέχθηκα	paɾaðexθika
σοφέσ	sofes
θεούσα	θeusa
χαίρε	çere
γυαλιά	ʝaʎa
αμάθειασ	amaθias
αναμορφώσεισ	anamoɾfosis
κουτσομπόλεψε	kutsobolepse
παρακολουθάω	paɾakoluθao
άρια	aɾia
σημειώθηκαν	simioθikan
αναδιάρθρωση	anaðʝaɾθɾosi
σύνοψησ	sinopsis
άγκιστρο	aŋɟistro
συγκινητικώσ	siŋɟinitikos
κτηνοβάτησ	ktinovatis
ανασυγκροτώ	anasiŋɡɾoto
θερμοδυναμικοί	θermoðinamici
ώρα	ora
προσπαθώντασ	pɾospaθondas
ήσαστε	isaste
τρίβω	trivo
κουράδω	kuɾaðo
μετρήθηκα	metɾiθika
αεροφωτογραφίζομε	aerofotoɣrafizome
περαστικά	peɾastika
γαλήνη	ɣalini
σκιάχτρο	scaxtɾo
αξιοσημείωτεσ	aksiosimiotes
κορίτσαροι	koritsari
ορθόδοξη	oɾθoðoksi
γριά	ɣɾia
γίγνεσθαι	ʝiɣnesθe
ιερουσαλήμ	ieɾusalim
φονεύω	fonevo
επανειλημμένοσ	epanilimenos
απόγευμα	apoʝevma
συλλέχθηκα	silexθika
κουράζω	kuɾazo
σαπουνίζομαι	sapunizome
ποικιλότατου	picilotatu
σύρθηκα	sirθika
θλιμμένησ	θlimenis
γονυπετώσ	ɣonipetos
συγκινημένουσ	siŋɟinimenus
ληστεύω	listevo
σοφία	sofia
τελευταίοσ	telefteos
μαραθώνασ	maɾaθonas
κωνσταντίνα	konstandina
ενορχήστρωση	enoɾçistɾosi
στεφάνι	stefani
αξιαγάπητοσ	aksiaɣapitos
γύρεψα	ʝiɾepsa
ζεσταμένα	zestamena
τάφρου	tafru
σύννεφο	sinefo
μαζικών	mazikon
παροτρύνομαι	paɾotɾinome
αντιμετωπίστηκα	andimetopistika
αλείβομαι	alivome
απατώ	apato
βουλιάζω	vuʎazo
καταξοδεύτηκα	kataksoðeftika
νικήτρια	nicitɾia
προσαρμόζω	pɾosaɾmozo
αγίασ	aʝias
ήμουν	imun
ανάμενα	anamena
αγκαλιάζω	aŋɡaʎazo
βάσανο	vasano
υποσκάπτω	iposkapto
ξεψυχάω	ksepsixao
παράβλεψα	paɾavlepsa
μαρκάριζε	maɾkaɾize
αιχμαλωτίζω	exmalotizo
εγχύνω	eŋçino
χάχανο	xaxano
στυμμένων	stimenon
αλεγράρω	aleɣɾaɾo
μωρέ	moɾe
απολογητικά	apoloʝitika
καταβάλλετε	katavalete
ειρωνικόσ	ironikos
όμορφου	omoɾfu
απορροφιέμαι	apoɾofçeme
συνδιασκέπτομαι	sinði̯asceptome
πουδράριζα	puðɾaɾiza
σκάνδαλο	skanðalo
τάθηκα	taθika
συμπληρώθηκα	simbliɾoθika
πλειονότητεσ	plionotites
εκκλησιάστηκα	eklisiastika
αποκέντρωση	apocendɾosi
καθισμένοι	kaθizmeni
αναμαλλιασμένη	anamaʎazmeni
αγαπηθεί	aɣapiθi
κοντρολάρομαι	kondrolaɾome
πράγμα	pɾaɣma
δώδεκα	ðoðeka
ασέβειασ	asevias
επαλείφω	epalifo
προκύπτει	procipti
αποδεχτεί	apoðexti
πατεράδων	pateraðon
πούδραρα	puðɾaɾa
εισπνέομαι	ispneome
είχε	içe
κοντρολάρω	kontrolaɾo
σορού	soɾu
εννεακόσια	eneakosça
τετριμμένο	tetrimeno
κωσ	kos
άγιεσ	aʝies
σουβλατζίδικο	suvladziðiko
αβγατισμένη	avɣatizmeni
ακυρώνομαι	aciɾonome
αγκυλίου	aŋɟiliu
παζάρεψα	pazaɾepsa
ανακόπτομαι	anakoptome
τελέστηκα	telestika
δίγλωσσοσ	ðiɣlosos
διασκέφθηκα	ðiascefθika
σύδεντρο	siðendro
μισούμαι	misume
εικάζω	ikazo
σπρώχνομαι	spɾoxnome
συμπεριφέρθηκα	simbeɾifeɾθika
βραδέωσ	vɾaðeos
αναβαθμολόγησα	anavaθmoloʝisa
ἐπιστρέφομαι	epistɾefome
άγιο	aʝo
μουριά	muɾʝa
στεναχωρήθηκα	stenaxoriθika
εφευρίσκουμε	efevɾiskume
νεκροφόρα	nekɾofoɾa
αραχνιασμένα	aɾaxɲazmena
αποσιωπήθηκα	aposiopiθika
γιακάσ	ʝakas
ζευγών	zevɣon
κακογαμημένη	kakoɣamimeni
χορεύουνε	xoɾevune
αγαθοπιστίασ	aɣaθopistias
πονοψυχιά	ponopsiça
έσκασα	eskasa
αλλοιώθηκα	alioθika
κοντρολάρομαι	kontrolaɾome
ωρύομαι	oriome
μάρτησ	maɾtis
ιδρύματοσ	iðrimatos
απολογητικέ	apoloʝitice
κουπάκι	kupaci
αποκρουστικόσ	apokrustikos
κατάμαυροι	katamavɾi
κομμένησ	komenis
πλίνθοι	plinθi
κλείνομε	klinome
ομόλογοι	omoloʝi
μπισκότο	biskoto
χάοσ	xaos
ποντάρομαι	pondaɾome
προπονήσεισ	proponisis
ασελγείσ	aselʝis
λυθείσ	liθis
έθαψα	eθapsa
πέοσ	peos
μαυροπουλιών	mavropuʎon
αγυιοπαίδων	aʝiopeðon
μύρο	miɾo
ντροπαλή	dɾopali
αρρωστημένε	arostimene
κύημα	ciima
ανάκρινα	anakɾina
μέρα	mera
άσεβοσ	asevos
βεβαιώνω	veveono
φτάνομαι	ftanome
αβροδίαιτοσ	avroðietos
θλιβερών	θliveɾon
αποκρύβομαι	apokɾivome
χορέψατε	xoɾepsate
διαφήμιση	ðiafimisi
θλιμμένα	θlimena
μαλακισμένη	malacizmeni
τισ	tis
κοζάνη	kozani
θαρραλέου	θaraleu
σφυρίζομαι	sfirizome
μπλουζάκι	bluzaci
μπαρκάριζε	baɾkaɾize
αγανόσ	aɣanos
εκχέομαι	ekçeome
πουτανιάρησ	putanʝaris
αγανακτισμένου	aɣanaktizmenu
διαβεβαιώνω	ðʝaveveono
ναυσικᾶσ	nafsikas
σχίζομαι	sçizome
πιλόταρε	pilotaɾe
σταματώ	stamato
γλωσσοδέτησ	ɣlosoðetis
κρούω	kruo
ηγουμένου	iɣumenu
ἀρετῆσ	aretis
αλεύρωμα	alevɾoma
αξιοπρέπεια	aksiopɾepia
αριστοκρατία	aɾistokɾatia
ντεραπάρισα	deɾapaɾisa
μινεσότα	minesota
κατελύθην	kateliθin
άνθρωποσ	anθɾopos
στείβω	stivo
γκόμενα	ɡomena
σβήνομαι	zvinome
αρχίασ	aɾçias
μετρώ	metɾo
αναβιβάστηκα	anavivastika
διαχύνομαι	ðiaçinome
συγχωρώ	siŋxoɾo
ψωμάδικου	psomaðiku
αγυιά	aʝia
καλομοίρη	kalomiri
αδειάζομαι	aðʝazome
καημένοσ	kaimenos
ωφελούμε	ofelume
μαζικότερουσ	mazikoterus
ξένη	kseni
οκτωβρίουσ	oktovɾius
παρέγραψα	paɾeɣɾapsa
σπασμένο	spazmeno
κιβωτόσ	civotos
στράφηκα	stɾafika
αγγλοποιήθηκα	aŋɡlopiiθika
αμοργού	amoɾɣu
χτυπημένοσ	xtipimenos
θαρραλέοσ	θaraleos
μαζικέσ	mazices
μουνότριχα	munotɾixa
τρυγόνων	triɣonon
λύσει	lisi
λαλάω	lalao
μουσκεύω	muscevo
ώσπου	ospu
έβαλλα	evala
χειλέων	çileon
εξετράπην	eksetɾapin
αναφαίρετοσ	anaferetos
μυτίτσα	mititsa
ίσωσ	isos
αποκρούομε	apokruome
φέρθηκα	feɾθika
χρειάσθηκα	xɾiasθika
διακήρυξη	ðiaciɾiksi
διάρροια	ðiaɾia
κοροϊδεύτηκα	koɾoi̯ðeftika
όπερα	opeɾa
κόρινθοσ	koɾinθos
ανατινάζομαι	anatinazome
στειρώσεισ	stiɾosis
όποιο	opço
ακοινωνησία	acinonisia
άκων	akon
μεταφέρω	metafeɾo
κάρπαθο	kaɾpaθo
άντε	ade
εκτέλεσα	ektelesa
διανομή	ðʝanomi
επήλθα	epilθa
νωθρόσ	noθɾos
τρυγόνι	triɣoni
αναγνωρίζω	anaɣnoɾizo
ζεσταμένο	zestameno
εφευρίσκομε	efevɾiskome
λαμία	lamia
πρωταγωνιστήσ	pɾotaɣonistis
τσιμπουκώνω	tsimbukono
λυπημένουσ	lipimenus
άτονοσ	atonos
μανόλησ	manolis
κοιτάζω	citazo
άνδρωσα	anðɾosa
απαλείφθηκα	apalifθika
εστέφθην	estefθin
διακόπηκα	ðʝakopika
ρόδι	ɾoði
αφυδάτωσα	afiðatosa
φοροκλέπτω	foɾoklepto
πουδρίτσα	puðɾitsa
κυνηγημένων	ciniʝimenon
περσεφόνη	persefoni
βεβαιώσεισ	veveosis
δημοκρατιών	ðimokration
προσέβλεψα	pɾosevlepsa
μέτσοβο	metsovo
στεναχωρημένουσ	stenaxorimenus
διέπνευσα	ðiepnefsa
λέσβοσ	lezvos
αναδημιουργημένοι	anaðimiurʝimeni
ἀνίδρυσα	aniðrisa
περικλείω	periklio
λάμψεισ	lampsis
γείτσεσ	ʝitses
αγουστιάσ	aɣustças
σκυλάδικο	scilaðiko
κακογαμημένων	kakoɣamimenon
πίθου	piθu
συνοδών	sinoðon
ιεροσόλυμα	ieɾosolima
ξαναμοίρασα	ksanamiɾasa
αρχιμηνιά	aɾçimiɲa
ασελγώ	aselɣo
χέστησ	çestis
ψωμιού	psomɲu
αίρομαι	erome
ξαναμοιράζομαι	ksanamiɾazome
φασουλιού	fasuʎu
παραγράφτηκαν	paɾaɣɾaftikan
παντρεύω	pandɾevo
ψημένεσ	psimenes
δαπέδων	ðapeðon
μίσιγκαν	misiɡan
έξι	eksi
κυβερνώμαι	civeɾnome
εξολοθρεύτηκα	eksoloθɾeftika
βροντοχτυπάω	vɾondoxtipao
όντασ	ondas
ἀποκυήματα	apociimata
πρέπει	pɾepi
βρόμικη	vɾomici
ποτέ	pote
κουτσομπολιό	kutsoboʎo
επαναφέρουμε	epanafeɾume
αλατισμένησ	alatizmenis
ήπιε	ipçe
τρέπω	trepo
αθεϊσμού	aθeizmu
πεινασμένεσ	pinazmenes
ποδαριών	poðaɾʝon
σημαδεύομαι	simaðevome
έχεισ	eçis
μάϊσνερ	maizner
αγαπήθηκα	aɣapiθika
κατάφρακτοσ	katafraktos
μπάρκαρα	baɾkaɾa
γελάστηκα	ʝelastika
μιλάνο	milano
θαυμαστικά	θavmastika
στιμμένων	stimenon
ιδρύουμε	iðriume
μαθημένα	maθimena
μοιρασμένοι	miɾazmeni
θυμωμένησ	θimomenis
κλάσμα	klazma
ευαγγελίζομαι	evaŋɟelizome
δεμάτι	ðemati
λερώνομε	leɾonome
δεινόσ	ðinos
αμφιλεγόμενησ	aɱfileɣomenis
καταβάλλω	katavalo
αλείφομε	alifome
αμπαρώνω	ambaɾono
απολογία	apoloʝia
σφαλιάρισμα	sfaʎaɾizma
φουμάρω	fumaro
τιμοκατάλογο	timokataloɣo
γεωγραφίεσ	ʝeoɣrafies
ανόρθωσα	anoɾθosa
φράγκοσ	fɾaŋɡos
αναστηλώνομαι	anastilonome
αμοιβή	amivi
ψωλάκι	psolaci
περπάτησα	peɾpatisa
αποκλεισμένα	apoklizmena
πουτανίτσα	putanitsa
μετρημένοσ	metɾimenos
επόμενοσ	epomenos
απαγάγω	apaɣaɣo
καλοφάγωτοσ	kalofaɣotos
είχαμε	ixame
ανιδρύω	aniðrio
οφιοειδέσ	ofioiðes
φυτικών	fitikon
ετοιμάζομαι	etimazo
αντιπαραβάλω	andipaɾavalo
άγιουσ	aʝus
γκρίζη	ɡɾizi
νήσο	niso
συνέτριψε	sinetɾipse
ολάκεροσ	olaceros
κατάσχω	katasxo
νόσο	noso
ανακτημένοσ	anaktimenos
ιρλανδικόσ	iɾlanðikos
απολογητικού	apoloʝitiku
απαγορεύομαι	apaɣoɾevome
ακροάστηκα	akroastika
κουσούρι	kusuɾi
φτιάχνω	ftçaxno
χορεύομαι	xoɾevome
άπατο	apato
υπαγορεύουμε	ipaɣoɾevume
θαύμασα	θavmasa
λειτουργώ	liturɣo
καρεκλίτσα	kaɾeklitsa
έδρασα	eðɾasa
ιεραρχών	ierarxon
μαρτίου	maɾtiu
κοινόλεκτοσ	cinolektos
ποικιλότερεσ	piciloteres
φλερτάρισμα	flertarizma
όρνιθα	orniθa
ματοβαμμένα	matovamena
ενεγράφην	eneɣrafin
χορεύουν	xoɾevun
αποκρύπτω	apokɾipto
κλάδοσ	klaðos
λιγότερε	liɣotere
φεβρουάριε	fevɾuaɾie
περιπλεχτήκαν	peɾiplextikan
αλαμπουρνέζικοι	alaburnezici
αθετώ	aθeto
στερήσεισ	steɾisis
φρυγανίζω	fɾiɣanizo
ιστορικόσ	istorikos
τοποθετούμαι	topoθetume
ανασαλεύτηκα	anasaleftika
ἀνεσκάφην	aneskafin
αναπλειστηριασμόσ	anaplistiriazmos
παρελθούσα	parelθusa
αθεϊσμοί	aθeizmi
πύργων	pirɣon
αγγισμένησ	aŋɟizmenis
απομονωμένα	apomonomena
προσκαλεσμένοσ	pɾoskalezmenos
κρεμῶ	kremo
ανασάλεψα	anasalepsa
πνεύματοσ	pnevmatos
αγωνιστών	aɣoniston
βλαμμένε	vlamene
αναποδίζω	anapoðizo
δέρνομαι	ðeɾnome
λερώθηκα	leɾoθika
βλάφθηκα	vlafθika
αγανακτισμένουσ	aɣanaktizmenus
ρωτάω	ɾotao
απομονωμένη	apomonomeni
φυλλομετρημένοσ	filometɾimenos
πάμμαυρα	pamavɾa
γάμοσ	ɣamos
βάλουμε	valume
εκπαιδεύω	ekpeðevo
ραμαζάνι	ɾamazani
θεόσ	θeos
χείλη	çili
οπλή	opli
λιώνω	ʎono
διαιρεμένοσ	ðieɾemenos
διαρρέουμε	ði̯areume
επισκέπτομαι	episceptome
αποκερματισμό	apoceɾmatizmo
μετριέμαι	metɾʝeme
ματοβαμμένοσ	matovamenos
τσίρλα	tsiɾla
καταντούσα	katandusa
κωδωνοκρούστησ	koðonokrustis
θεωρώ	θeoro
σκουντώ	skundo
δανάη	ðanai
αμειψισπορά	amipsispoɾa
φονιάσ	foɲas
ξύστηκα	ksistika
φλεβάρησ	flevaɾis
δικόσ	ðikos
μουντόσ	mundos
διέπω	ðiepo
κουλούριασα	kuluɾʝasa
διοχετεύω	ðioxetevo
τάραξα	taraksa
κατέρρευσα	katerefsa
καλύψεισ	kalipsis
σφιχταγκαλιάζω	sfixtaŋɡaʎazo
ψάλθηκα	psalθika
μπελάσ	belas
θλιμμένη	θlimeni
ακοομετριών	akoometrion
αποβιβάζομαι	apovivazome
χρειάζεται	xɾiazete
ζωτικόσ	zotikos
γινάτι	ʝinati
λαδάδικο	laðaðiko
κούπα	kupa
λιμπίζομαι	limbizome
στειμμένων	stimenon
πρεσβευτήσ	pɾezveftis
αναδημιουργημένε	anaðimiurʝimene
παγωμένη	paɣomeni
συμβούλιο	siɱvulio
απεσταγμένοσ	apestaɣmenos
θεοδώρα	θeoðoɾa
προείδα	pɾoiða
παρακώλυσα	parakolisa
τετάρτη	tetaɾti
αριζόνα	aɾizona
πουστάκοσ	pustakos
περιθάλπομε	peɾiθalpome
φυλλομετράω	filometɾao
κοντρολάρω	kondrolaɾo
δημοκρατίασ	ðimokratias
διαλελυμένεσ	ðialelimenes
φτύνω	ftino
ανεμελιέσ	anemeʎes
αυτόλυκοσ	aftolikos
φιξάρω	fiksaɾo
τελούμε	telume
γυρνώ	ʝiɾno
τετριμμένασ	tetrimenas
αλληλεπέδρασα	alilepeðɾasa
συγκροτώ	siŋɡɾoto
φέτα	feta
καλοφάγωτεσ	kalofaɣotes
βροντοχτύπαγα	vɾondoxtipaɣa
προήλθα	proilθa
μιλιέμαι	miʎeme
κάλυμνο	kalimno
μπαρκάρισε	baɾkaɾise
αγαπημένα	aɣapimena
μαυροπούλι	mavropuli
βρήκαμε	vɾikame
ηλικιωμένο	iliciomeno
τεχνολογίασ	texnoloʝias
αγυιόπαιδα	aʝiopeða
βέλγιο	velʝo
πινακοθήκη	pinakoθici
κρεμασμένη	kremazmeni
αγοράστηκα	aɣoɾastika
αεροπλανοφόρον	aeɾoplanofoɾon
αλαφιασμένο	alafçazmeno
καθελκύσθηκα	kaθelcisθika
εκχωρήθηκα	ekxoɾiθika
συνηθισμένοσ	siniθizmenos
εισακούομαι	isakuome
λιπάσματα	lipazmata
αμπαρώνομαι	ambaɾonome
εκτράπηκα	ektɾapika
χιμπαντζήσ	çimbandzis
οκτώβρη	oktovɾi
αναφορά	anafoɾa
έστρεψα	estɾepsa
ελκύουμε	elciume
εγερθήκαν	eʝeɾθikan
δημοσιεύομε	ðimosievome
αριστοκλήσ	aɾistoklis
τεχνολόγοι	texnoloʝi
απωθώ	apoθo
φτιάχνομαι	ftçaxnome
τζαμπέ	tsambe
εκλέρ	ekleɾ
προειδοποιώ	pɾoiðopio
τέχνη	texni
αμφισβητώ	aɱfisvito
αποδειχθήκανε	apoðixθikane
παρακείμενε	paracimene
πάλλευκοσ	palefkos
άγω	aɣo
ξενοδοχοϋπάλληλοσ	ksenoðoxoipalilos
πειράχτηκα	piraxtika
νηστεύω	nistevo
θεμάτων	θematon
παγωμένων	paɣomenon
αλυσοδεμένου	alisoðemenu
φαινυλαμίνησ	fenilaminis
συνέκοψα	sinekopsa
κατουρημένοσ	katuɾimenos
διάνυσμα	ðianizma
έψαξα	epsaksa
αποκλεισμένοι	apoklizmeni
ακτινοσκόπηση	aktinoskopisi
πάριζα	paɾiza
χάφτομαι	xaftome
γενάρηδεσ	ʝenaɾiðes
ματοβαμμένη	matovameni
μωροί	moɾi
τρομοκρατούμαι	tɾomokɾatume
προσέλκυσα	prosilcisa
εξαπολύομε	eksapoliome
απασχολημένε	apasxolimene
έξεισ	eksis
παραλίγο	paɾaliɣo
ανάρτησα	anaɾtisa
χαρουπιά	xaɾupʝa
επετράπησαν	epetɾapisan
γλωσσάκι	ɣlosaci
μαϊντανόσ	maidanos
ξεκινάω	ksecinao
λυθείτε	liθite
καλή	kali
διαμορφώσεισ	ðiamoɾfosis
υψηλοτάτη	ipsilotati
μαντολάτο	mandolato
επανειλημμένο	epanilimeno
γλαστράκι	ɣlastɾaci
εμπερικλείομαι	emberikliome
ηδονίζομαι	iðonizome
άλλοθι	aloθi
απαιτούμαι	apetume
ανιδρύομαι	aniðriome
αγκαζαρίστηκα	aŋɡazaɾistika
κολλημένοσ	kolimenos
γαμιόλησ	ɣamɲolis
ανασκάλεψα	anaskalepsa
πλύσιμο	plisimo
ξελογιάζομαι	kseloʝazome
βρόμικοσ	vɾomikos
αλεξάνδρεια	aleksanðɾia
μάρτηδεσ	maɾtiðes
απέδειξε	apeðikse
εγερθήτω	eʝeɾθito
πεινασμένοσ	pinazmenos
πεισμένου	pizmenu
τέταρτο	tetaɾto
καλησπέρα	kalispera
αναφέρθηκα	anafeɾθika
φώναξα	fonaksa
ανανάδων	ananaðon
πταισματοδίκησ	ptezmatoðicis
θυμωμένου	θimomenu
αντλώ	andlo
στεναχωρούμαι	stenaxorume
εγκλείσθηκα	eŋɡlisθika
αεροφωτογραφούμαι	aerofotoɣrafume
προβλέπω	pɾovlepo
ζωώδησ	zooðis
γλυφάδα	ɣlifaða
οφσάιντ	ofsaid
περιπλέχτηκα	peɾiplextika
κάλμα	kalma
μνήμεσ	mnimes
λυθούνε	liθune
κυκλοφορήθηκα	ciklofoɾiθika
τσακώνικων	tsakonikon
καλομαθημένα	kalomaθimena
πιστεύουμε	pistevume
πεθερόσ	peθeɾos
μπιζάρω	bizaɾo
φυλλομετρώ	filometɾo
πλήρωσα	pliɾosa
δράκουλασ	vɾikolakas
υπερφορτώνω	ipeɾfoɾtono
φονεύθηκα	fonefθika
και	ce
ούτωσ	utos
άντεσ	ades
βυζάκι	vizaci
ποδόσφαιρα	poðosfera
φωτογραφήθηκα	fotoɣrafiθika
βοσκιέμαι	vosceme
μορφέα	morfea
απέρχομαι	apeɾxome
κωνσταντινούπολη	konstandinupoli
παραχαϊδεύω	paɾaxai̯ðevo
λιγότερου	liɣoteru
μίσησα	misisa
υπολογισμένων	ipoloʝizmenon
πάμμαυροι	pamavɾi
αποσαθρώθηκα	aposaθɾoθika
πιλοταρίστηκα	pilotaɾistika
αποστάζομαι	apostazome
κατέλυσα	katelisa
ασεβήσ	asevis
διακομιστήσ	ðiakomistis
αγριεύτηκα	aɣɾieftika
χρεωστώ	xɾeosto
σερβιετάκι	servʝetaci
συγχαίρω	siŋçero
στερήσεωσ	steɾiseos
άρκανσασ	aɾkanzas
δεξιόσ	ðeksʝos
εξαλείφομε	eksalifome
υποθηκεύω	ipoθicevo
κορόιδεψα	koɾoi̯ðepsa
ανγκουίλα	aŋɡuila
βαλσαμώθηκα	valsamoθika
ζημιώθηκα	zimioθika
φάληρο	faliɾo
χόρεψεσ	xoɾepses
ανιλίνησ	anilinis
ακινητοποιώ	acinitopio
κλάπηκα	klapika
στη	sti
έκρουσα	ekrusa
αποταμιεύομαι	apotamievome
μούρο	muɾo
μποϊκοτάρισα	boikotaɾisa
ψηφιακοί	psifiaci
ανοικτίρμων	aniktirmon
πρόσωπο	prosopo
λιανικόσ	lianicos
αμορφωσιέσ	amoɾfosçes
ιδιαιτέρωσ	iðieteɾos
τάχα	taxa
μπαμπούλασ	babulas
άσεβου	asevu
μπαμπάσ	babas
προηγούμενων	proiɣumenon
ενέπνευσα	enepnefsa
απαλείφτηκα	apaliftika
γούσταρε	ɣustaɾe
περιοδική	perioðici
απόρριψα	apoɾipsa
απορρίπτουμε	apoɾiptume
κομμένο	komeno
φωτοστέφανο	fotostefano
καταξοδιάζω	kataksoðʝazo
άσβεστοσ	azvestos
γαμάτοσ	ɣamatos
λύουμε	liume
φύλλα	fila
αποκλεισμένουσ	apoklizmenus
ακοντίζω	akondizo
υψηλότατοσ	ipsilotatos
αποκλείστηκε	apoklistice
αναστέναξα	anastenaksa
συγκίνηση	siŋɟinisi
ταλαιπωρούμε	talepoɾume
έκχυσα	ekçisa
μέρευ'	meɾef
μήτσοσ	mitsos
παραβάλλετε	paɾavalete
αδικιέμαι	aðiceme
συνήφθησαν	sinifθisan
παράξενοσ	paɾaksenos
πεινασμένοι	pinazmeni
διαιρώ	ðieɾo
απολύω	apolio
κορίτσαρο	koritsaro
προαλείφω	pɾoalifo
ξεραίνω	kseɾeno
ακούομαι	akuome
περπατημένοσ	peɾpatimenos
έμπορασ	emboɾas
πληροφορική	pliroforici
φρέσκαρε	fɾeskaɾe
ερρινοποίηση	erinopiisi
ελληναράσ	elinaɾas
ανακρούστηκα	anakrustika
άγραφοσ	aɣrafos
αργοσάλευε	aɾɣosaleve
παιδαριώδησ	peðarioðis
σκυλίτσα	scilitsa
αναβάλλομαι	anavalome
αποπέμπομε	apopembome
παρέπαια	paɾepea
παραμύθι	paɾamiθi
αλατίστηκα	alatistika
πισινόσ	pisinos
αγγλία	aŋɡlia
μαθαίνω	maθeno
αναθάρρυνα	anaθaɾina
ρίχνομαι	ɾixnome
βαστάχτηκα	vastaxtika
μαΐων	maion
ορθόσ	oɾθos
υποβοηθούμενο	ipovoiθumeno
φλιτζανάκια	flidzanaca
ανακάλυψη	anakalipsi
κριθάρι	kriθari
τσακωνιάσ	tsakoɲas
καθισμένου	kaθizmenu
συνεχώσ	sinexos
απογοήτευσα	apoɣoitefsa
ώριμοσ	oɾimos
γενέσεισ	ʝenesis
σκανδάλη	skanðali
διαχέουμε	ðʝaçeume
μουσμουλιά	muzmuʎa
αμπέλι	ambeli
αναστηλώθηκα	anastiloθika
σαρώνομαι	saɾonome
μαυρισμένουσ	mavrizmenus
σαπούνι	sapuni
ταριχεύω	taɾixevo
χορεύουμε	xoɾevume
μπουγάζι	buɣazi
κρεμασμένε	kremazmene
ανεκτίμητοσ	anektimitos
βιάζομαι	vʝazome
εξοπλισμένοι	eksoplizmeni
λέγεται	leʝete
μανάβησ	manavis
αγαθοπιστίεσ	aɣaθopisties
απαρχαιωμένων	aparçeomenon
πανηγύρι	paniʝiɾi
επικείμενοσ	epicimenos
αγιασμένοσ	aʝazmenos
απαράδεχτοσ	apaɾaðextos
μαλαματένιοσ	malamateɲos
κυκλοφορούμαι	ciklofoɾume
λιγοστεύω	liɣostevo
περιγράφομε	peɾiɣrafome
αγγιγμένοι	aŋɟiɣmeni
τσεκαρίστηκα	pondaɾistika
καταφέρνω	katafeɾno
διψασμένουσ	ðipsazmenus
έπνευσα	epnefsa
πιόνι	pçoni
κατούρημα	katuɾima
τσακωνιά	tsakoɲa
ανιλίνεσ	anilines
μυρωδιά	miɾoðʝa
πεσιμιστήσ	pesimistis
συνδέσεισ	sinðesis
χειμωνιάτικοσ	çimoɲatikos
τυροπιτάκι	tiɾopitaki
κκε	kapakapaepsilon
αποστέλλομαι	apostelome
διαλυμένοσ	ðʝalimenos
αρδεύω	aɾðevo
βάλλουμε	valume
ρωτώ	ɾoto
ικανοποιημένο	ikanopiimeno
κυοφορώ	cioforo
κέικ	keik
ενάρξεων	enaɾkseon
μάρτυρεσ	maɾtiɾes
αλληλεπιδράσεισ	alilepiðɾasis
ανέρχομαι	anerxome
βγάζοντασ	vɣazondas
αναστέλλομαι	anastelome
πρησμένη	pɾizmeni
απορρίφτηκα	apoɾiftika
αποπέμφθηκα	apopemfθika
πωλήσιμοσ	polisimos
απέβαλα	apevala
δεκέμβρηδων	ðeceɱvɾiðon
χεσμένο	çezmeno
ακομπανιαρίστηκα	akompaɲaɾistika
προμηνύθηκα	prominiθika
χάψτε	xapste
γνώσεωσ	ɣnoseos
μυγάκι	miɣaci
ντελιβεράδων	deliveraðon
έρρινοι	erini
αλυσοδεμένοσ	alisoðemenos
φίλο	filo
κλέβω	klevo
πεισμένε	pizmene
αναγνωρισμένα	anaɣnorizmena
κραγμένοι	kraɣmeni
αυτοκτονία	aftoktonia
βουτυρωμένεσ	vutiromenes
ακούσθηκε	akusθike
ανιψούλησ	anipsulis
θάφτηκα	θaftika
ικανοποιημένησ	ikanopiimenis
ταλαιπωρημένοσ	talepoɾimenos
πεπεισμένων	pepizmenon
παλιάνθρωποσ	paʎanθɾopos
θωρώ	θoro
συνέρχομαι	sinerxome
ξελύνομαι	kselinome
ηράκλειο	iraklio
μάστορασ	mastoras
ενετοκρατία	enetokɾatia
γυμνάζω	ʝimnazo
πασαλείβω	pasalivo
στυμμένοσ	stimenos
ζεύγοσ	zevɣos
σκασμένεσ	skazmenes
καμουφλάρισα	kamuflaɾisa
μπουγαζιών	buɣazʝon
παραβλέπομαι	paɾavlepome
νόθοσ	noθos
εύβοια	evia
ήμουνα	imuna
επιλοχίασ	epiloçias
ανακατώθηκα	anakatoθika
εισήλθα	isilθa
ιδρύομε	iðriome
παντελήσ	pandelis
προπονήσεων	proponiseon
ευρώπη	evropi
δύο	ðio
αφοσιώθηκα	afosioθika
εμπόδιο	emboðio
δακτυλογραφήθηκα	ðaktiloɣɾafiθika
βουτυρωμένε	vutiromene
ντουμπλάρομαι	dublaɾome
ελεύθεροσ	elefθeros
διαβεβαιώνω	ði̯aveveono
κουράζομαι	kuɾazome
καταστρώματοσ	katastromatos
καπνίζομαι	kapnizome
ζεσταμένησ	zestamenis
πέτροσ	petɾos
πουδράρω	puðɾaɾo
σείομαι	siome
ντροπιασμένησ	dɾopçazmenis
τρίγωνον	tɾiɣonon
μαζικότατε	mazikotate
γραδάρω	ɣɾaðaɾo
οσμίζομαι	ozmizome
εγκαθιδρύομαι	eŋɡaθiðriome
ιουδαία	iuðea
ανάποδα	anapoða
βοηθάμε	voi̯θame
ηχώ	ixo
αλληλούια	alliluia
συμφυρμών	siɱfirmon
καλιαρντά	kaʎarda
ακατάδεχτοσ	akataðextos
χρονολογήσεισ	xronoloʝisis
ανέχτηκα	anextika
ματοβαμμένε	matovamene
εγγλέζοσ	eŋɡlezos
αποκλείετε	apokliete
μουσκεύομαι	muscevome
απόκοψα	apokopsa
φοροαπαλλαγήσ	foɾoapalaʝis
τσόγλανοσ	tsoɣlanos
πεισμένησ	pizmenis
λούζω	luzo
καταφρονούμαι	katafɾonume
κλέψω	klepso
εκατόν	ekaton
θήρα	θiɾa
φοριέμαι	foɾʝeme
αναβαλλόμενησ	anavalomenis
δέρνω	ðeɾno
γκρίζε	ɡɾize
πολωνική	polonici
χλιασ	xʎas
τσακώνικα	tsakonika
περιγράφομαι	peɾiɣrafome
αλλοιώσεωσ	alioseos
καταλόγων	kataloɣon
ψήφε	psife
δράσεισ	ðɾasis
παρέπεμψα	paɾepempsa
παρακωλύουμε	parakoliume
καλοκαιριάτικα	kaloceɾʝatika
ματοβαμμένοι	matovameni
μάρτηδων	maɾtiðon
συγγραφεύσ	siŋɣrafefs
μείωσα	miosa
αποτραβηγμένοσ	apotɾaviɣmenos
περιπλέχθηκε	peɾiplexθice
παρακωλύω	parakolio
άσεβησ	asevis
αποβάλλουμε	apovalume
εκκενώνομε	ecenonome
όφειλα	ofila
γαμημένοσ	ɣamimenos
μεγαλομανιών	meɣalomanion
απορροφούμενη	apoɾofumeni
συνεννόηση	sinenoisi
παραστάθηκα	parastaθika
αλφάβητα	alfavita
λαθρέμποροσ	laθɾemboɾos
ματοβαμμένου	matovamenu
γαμώτο	ɣamoto
μαθημένουσ	maθimenus
γαλακτομπούρεκο	ɣalaktobuɾeko
επιβιβάζω	epivivazo
συνδυάζουμε	sinðiazume
αποκαλύπτομε	apokaliptome
καταιγίδα	kateʝiða
συζητάω	sizitao
δεκατρείσ	ðekatɾis
προηγούμενοι	proiɣumeni
ενεργοποιώ	enerɣopio
μπιζάρισα	bizaɾisa
κριθαρόψωμο	kriθaropsomo
διαχέω	ðʝaçeo
προσγειώνω	pɾozʝiono
πατιναρίστηκα	patinaɾistika
μαζικότερα	mazikotera
ματόκλαδου	matoklaðu
αλληλοσυγκρουόμενοσ	alilosiŋɡruomenos
θυελλωδώσ	θieloðos
εκείνη	ecini
αντιδρώ	andiðɾo
τσακώνικουσ	tsakonikus
νικούσα	nikusa
κεκλεισμένοι	ceklizmeni
διασκεδάζομαι	ði̯asceðazome
διέρρευσα	ði̯erefsa
γκρεμόσ	ɡremos
ψωμιέρα	psomɲera
ανατρέπω	anatɾepo
αναγνωρισμένοσ	anaɣnorizmenos
διέρρευσα	ðierefsa
ξένα	ksena
κώλυσα	kolisa
μαζικότερο	mazikotero
χορτοφαγία	xoɾtofaʝia
καταπολεμώ	katapolemo
αναβαλλόμενοσ	anavalomenos
ανέχθηκα	anexθika
λιγότερο	liɣotero
αποδοκιμάζω	apoðocimazo
δέχτηκα	ðextika
παρεγράφην	paɾeɣɾafin
αναζητούμαι	anazitume
αποπέμπω	apopembo
ενδέκατοσ	endekatos
καταιγίδεσ	kateʝiðes
αναβαλλόμενη	anavalomeni
γεωγραφιών	ʝeoɣrafion
ευωδία	evoðia
εκτελεστικόσ	ektelestikos
φυλάω	filao
όρθωσα	oɾθosa
συλλέγω	sileɣo
πλατιά	platça
βάλε	vale
ποδάρι	poðaɾi
πλέω	pleo
υποκλέπτομε	ipokleptome
επανέφερα	epanefeɾa
τρομοκράτισσα	tɾomokɾatisa
ιταλική	italiki
ταὐτομετάβατοσ	taftometavatos
γήπεδο	ʝipeðo
λύνοντασ	linondas
μπουνατσάριζε	bunatsaɾize
παραπέμπω	paɾapembo
κανάκευ'	kanacef
αγριεμένοσ	aɣɾiemenos
συνελέγην	sineleʝin
συνδέω	sinðeo
ζάκυνθε	zacinθe
λύστε	liste
μεξικό	meksiko
δοκιμασμένοσ	ðocimazmenos
σκυλάρα	scilaɾa
γελωτοποιόσ	ʝelotopios
αγυιόπαιδο	aʝiopeðo
μεσημβρίαν	mesimvrian
διανύομε	ðianiome
περιγράφηκα	peɾiɣrafika
αβγατίστηκα	avɣatistika
δύναμη	ðinami
βουτυρωμένησ	vutiromenis
ανακαλύπτω	anakalipto
αβγοκόβω	avɣokovo
βλάπτει	vlapti
σημειωθήκανε	simioθikane
γιάτρεψα	ʝatɾepsa
κουτσή	kutsi
συγκρούομαι	siŋɡruome
αερόσακοσ	aeɾosakos
ντουμπλάριζε	dublaɾize
σφαλιαρίζω	sfaʎaɾizo
αποκλείουμε	apokliume
μαζικούσ	mazikus
αμνηστεύτηκα	amnisteftika
εκχύθηκα	ekçiθika
συνοριοφύλακα	sinoriofilaka
ανακάλυψα	anakalipsa
πληγείσ	pliʝis
σπάζω	spazo
ρόδοσ	ɾoðos
γερνάω	ʝeɾnao
ισοδύναμο	isoðinamo
αιματοκύλισα	ematocilisa
κοκκινίζω	kocinizo
λόγω	loɣo
βοσκάω	voskao
καταφτάνω	kataftano
πιπώνω	pipono
τύροσ	tiɾos
στησ	stis
υπαγόρεψα	ipaɣoɾepsa
τέταρτοσ	tetaɾtos
καινοφανείσ	cenofanis
κατουράω	katuɾo
δήμητρα	ðimitɾa
πολωνέζοσ	polonezos
καλομαθημένοσ	kalomaθimenos
κουραστικού	kurastiku
ενέσκηψα	enescipsa
σωπαίνω	sopeno
ηγούμενο	iɣumeno
μήπωσ	mipos
καθομιλούμενεσ	kaθomilumenes
αξιοσημείωτη	aksiosimioti
προμηνύομαι	prominiome
ακροχορδόνα	akɾoxoɾðona
συνέρρευσα	sinerefsa
χορεύω	xoɾevo
κυνηγημένεσ	ciniʝimenes
διαθλώ	ði̯aθlo
αλαφιασμένων	alafçazmenon
διαδεχθεί	ðʝaðexθi
αποκαθιστώ	apokaθisto
στειμμένα	stimena
ομοφυλόφιλο	omofilofilo
τασάκι	tasaci
γερασμένοσ	ʝeɾazmenos
πταίσμα	ptezma
διαβεβαίωσα	ðʝaveveosa
συρράφθηκα	siɾafθika
αβαράρισε	avaɾaɾise
πλειονότητα	plionotita
επιβιβάζομαι	epivivazome
αλαφιασμένα	alafçazmena
αμ	am
φύλαγα	filaɣa
ποντίκι	pondici
αναμαλλιασμένησ	anamaʎazmenis
άνδροσ	anðɾos
συμφωνούμε	siɱfonume
ευχαριστούμε	efxaɾistume
χοντρομπαλάσ	xondɾobalas
ντουμπλάρισε	dublaɾise
αφρική	afɾici
μεταφραστών	metafɾaston
βρομώ	vɾomo
ποικιλότερο	picilotero
σπιλώνομαι	spilonome
τσακώνικο	tsakoniko
υπεκλάπην	ipeklapin
μαγκάκι	maŋɡaci
σκόνταψα	skondapsa
λύνονταν	linondan
τρελαίνομαι	tɾelenome
προβλέπομαι	pɾovlepome
αφυδατώνομαι	afiðatonome
συμπεριφέρομαι	simbeɾifeɾome
κατελύθησαν	kateliθisan
διανύομεν	ðianiomen
κρεμούσα	kɾemusa
έβλαψα	evlapsa
έζησα	ezisa
κρυπτογράφησα	kriptoɣrafisa
τιμοκατάλογε	timokataloʝe
θλιμμένοσ	θlimenos
διέγειρα	ðieʝiɾa
τεχνολογιῶν	texnoloʝion
ανασκαλεύομαι	anaskalevome
αναδημιουργημένο	anaðimiurʝimeno
σπίθισα	spiθisa
πασαλείβομαι	pasalivome
καταγράφω	kataɣrafo
αποκύημα	apociima
δημιουργούμε	ðimiuɾɣume
ευχή	efçi
βασίλισσα	vasilisa
καλομαθημένοι	kalomaθimeni
μάρτιοσ	maɾtios
κλεισμένου	klizmenu
ορθώνομαι	oɾθonome
ευαγγελίστηκα	evaŋɟelistika
δυσκόλωσ	ðiskolos
κανόνασ	kanonas
διασπώ	ðʝaspo
κωλοπαιδαράσ	kolopeðaɾas
καλοφάγωτο	kalofaɣoto
διαλυμένου	ðʝalimenu
αναβαλλόμενε	anavalomene
περάσει	peɾasi
κατάλευκοσ	katalefkos
άρχομαι	arxome
θλιμμένο	θlimeno
απαγορευμένοσ	apaɣoɾevmenos
απελπισμένων	apelpizmenon
φυτικήν	fiticin
έριδεσ	eriðes
αεροφωτογράφησα	aeɾofotoɣɾafisa
φθινοπωριάτικοσ	fθinopoɾʝatikos
καταφρονέθηκα	katafɾoneθika
παύω	pavo
λυμένοι	limeni
παρέρχομαι	paɾeɾxome
συμβολομεταφραστών	siɱvolometafɾaston
θερμοκρασία	θeɾmokɾasia
ωφελήθηκα	ofeliθika
μουνοπαγίδα	munopaʝiða
γαλόνι	ɣaloni
αποβάλλεται	apovalete
ράφτηκα	ɾavo
ναδίρ	naðiɾ
ανελκύσθηκα	anelcisθika
κουρεύτηκα	kuɾeftika
φόραγα	foɾaɣa
μονάρχησ	monarçis
λυνόμουν	linomun
ηλικιωμένουσ	iliciomenus
συνθλίφτηκε	sinθliftice
πάμμαυρουσ	pamavɾus
υποσκάπτουμε	iposkaptume
ανατιμώμαι	anatimome
ξεσκάτισμα	kseskatizma
κομπίνα	kombina
σαπουνίστηκα	sapunistika
απέσεισα	apesisa
ηλικιωμένου	iliciomenu
μεσαιωνικό	meseoniko
αγανακτισμένα	aɣanaktizmena
αλωνάρησ	alonaɾis
βάφομαι	vafome
τεχνολόγου	texnoloɣu
παραβύστωι	paravisto
εκκλησιάζομαι	eklisiazome
παραδέχτηκα	paɾaðextika
πείσω	piso
υπολόγισα	ipoloʝisa
μεθ	meθ
κρεμασμένου	kremazmenu
πειθόμενησ	piθomenis
ανατράπηκαν	anatɾapikan
αηδιασμένου	aiðiazmenu
χιονίζει	çonizi
ένρινη	enrini
αλλού	alu
αποβάλετε	apovalete
κλαρίνο	klaɾino
αμφιλεγόμενε	aɱfileɣomene
πέμπω	pembo
εξέπεμψα	eksepempsa
παροτρύνθηκα	paɾotɾinθika
πεισμένο	pizmeno
γένοσ	ʝenos
δυνάμεων	ðinameon
είμαι	ime
αισιοδοξώ	esioðokso
ψάχνω	psaxno
αντιμεθαύριο	andimeθavɾio
θυελλώδεισ	θieloðis
απέκοψα	apekopsa
υπαγορεύθηκα	ipaɣoɾefθika
καταλύθηκαν	kataliθikan
διακοσμώ	ði̯akozmo
φιλοσοφώ	filosofo
αγγιγμένων	aŋɟiɣmenon
εθνάρχη	eθnarçi
συμπάθησα	simbaθiso
παράγραψα	paɾaɣɾapsa
θυμωμένων	θimomenon
λυνόμουνα	linomuna
φουντούκι	funduci
μυτιλήνη	mitilini
υπολογίζω	ipoloʝizo
ζητιάνεψα	zitçanepsa
σκοπεύω	skopevo
ἀπασχολοῦμαι	apasxolume
αραχνιασμένε	aɾaxɲazmene
ζάκυνθο	zacinθo
συμβολομεταφραστήσ	siɱvolometafɾastis
σταθμόσ	staθmos
φρενάρατε	frenarate
διαδέχομαι	ði̯aðexome
θλιμμένων	θlimenon
αναβαθμολογούμε	anavaθmoloɣume
αγιοποιημένουσ	aʝiopiimenus
ανταγωνίζομαι	andaɣonizome
αγγιγμένη	aŋɟiɣmeni
δοκιμάζω	ðocimazo
σκατουλήσ	skatulis
επιβλαβήσ	epivlavis
πομφόλυγα	poɱfoliɣa
γκρίνιαξα	ɡɾiɲaksa
αποσιώπησα	aposiopisa
παρακαλάω	parakalao
φιλάω	filao
αποφοίτησα	apofitisa
στέλνω	stelno
δασμόσ	ðazmos
ευχήθηκα	efçiθika
καλόγρια	kaloɣɾia
ἀνέγραψα	aneɣrapsa
άστραψα	astɾapsa
ανταμώνω	andamono
ήσανε	isane
κινδύνευε	cinðineve
ντεραπάρω	deɾapaɾo
καλοκαιριάτικοσ	kaloceɾʝatikos
τάφηκα	tafika
ανδρειώνω	anðɾiono
νοστιμεύτηκα	nostimeftika
εξώστησ	eksostis
κακόσ	kakos
περιγράφουμε	peɾiɣrafume
βελανιδιά	velaniðʝa
σφιχταγκάλιασα	sfixtaŋɡaʎasa
παρέπλευσα	pareplefsa
ἀνεγράφην	aneɣrafin
αριβάρω	aɾivaɾo
μάρτυρα	maɾtiɾa
γραφείο	ɣɾafio
συμπρωταγωνιστέσ	simbɾotaɣonistes
εξαπολύουμε	eksapoliume
βαθιάσ	vaθças
συνοδοί	sinoði
συγκρουόμενοι	siŋɡruomeni
διήγειρα	ðiiʝiɾa
αεροφωτογραφίστηκα	aerofotoɣrafistika
λύσε	lise
φέρω	feɾo
αυτοκινητάκι	aftocinitaci
επάγγελμα	epaŋɡelma
παιδοβούβαλοσ	peðovuvalos
παραγράφω	paɾaɣɾafo
ανυπομονούσα	anipomonusa
χαράχτηκα	xaɾaxtika
διήρκεσα	ðiiɾcesa
αρμέγω	aɾmeɣo
ψωμάκια	psomacia
ναζιάρησ	nazʝaɾis
συνοδού	sinoðu
ηλιόλουστοσ	iʎolustos
βασταγμένοσ	vastaɣmenos
χεζού	çezu
κολύμπησα	kolimbisa
ανασκαλεύω	anaskalevo
λύσατε	lisate
συρράπτομε	siɾaptome
πεντακόσια	pendakosça
ασεβώ	asevo
βουβάλια	vuvaʎa
κουτσομπολεύω	kutsobolevo
αγριεύομαι	aɣɾievome
ορθωμένοσ	oɾθomenos
ανασκαφείσ	anaskafis
δρόμοσ	ðromos
τεχνολόγο	texnoloɣo
πυροφάνι	piɾofani
βροντάω	vɾondao
ξερόψωμα	kseropsoma
λάμπω	lambo
δημαρχίνα	ksenoðoxa
εξαιτίασ	eksetias
συνέλεξα	sineleksa
ζεσταμένεσ	zestamenes
εμπαίζω	embezo
ανατινάζω	anatinazo
αναδέχομαι	anaðexome
γυαλί	ʝali
ποδαριού	poðaɾʝu
απελπισμένησ	apelpizmenis
άραχλοσ	aɾaxlos
περιπολούσα	peɾipolusa
διαρρέεται	ðiareete
αληθούσ	aliθus
εκπομπέσ	ekpombes
προβολέασ	pɾovoleas
εξέκρουσα	eksekrusa
πλειονοψηφίεσ	plionopsifies
ξύθηκα	ksiθika
αγόγγυστοσ	aɣoŋɟistos
μπερδεμένουσ	beɾðemenus
αλείφομαι	alifome
χτυπήθηκα	xtipiθika
χάνω	xano
τρίτοσ	tɾitos
λύθηκεσ	liθices
τραπέζια	tɾapezia
ανθρώπεψε	anθɾopepse
κείνη	cini
επανειλημμένοι	epanilimeni
περιθάλπομαι	peɾiθalpome
συρράπτομαι	siɾaptome
ανεβάζω	anevazo
απολύθηκα	apoliθika
διαμορφώνομαι	ðiamoɾfonome
θυμωμένεσ	θimomenes
απορροφώ	apoɾofo
ερχόμενο	erxomeno
πολεμική	polemici
αγαντάρω	aɣandaɾo
αμυγδαλιά	amiɣðaʎa
αμπλαούμπλασ	ablaublas
ντούμπλαρε	dublaɾe
βυθισμένεσ	viθizmenes
βόρειοσ	voɾios
κορίτσαρουσ	koritsarus
αναστεναγμόσ	anastenaɣmos
πούστικα	pustika
ενρινότητεσ	enrinotites
θεσσαλονίκη	θesalonici
παντρεμένοι	pandɾemeni
κιαλιών	caʎon
παντρεμένου	pandɾemenu
ομοβροντία	omovɾondia
συμφύομαι	siɱfiome
πρησμένοι	pɾizmeni
καταλύομεν	kataliomen
φυτικού	fitiku
κεφιού	cefçu
ξαναμοιράζω	ksanamiɾazo
ορίζω	oɾizo
συμπρωταγωνιστών	simbɾotaɣoniston
συγχαρήκαν	siŋxaɾikan
στενό	steno
αναβαθμολογήσεισ	anavaθmoloʝisis
επιστρέφουμε	epistɾefume
ουδαμού	uðamu
τίσι	tisi
λούστηκα	lustika
βελόνα	velona
μισθοφόροσ	misθofoɾos
αναστυλώθηκα	anastiloθika
μάλαμα	malama
νικημένουσ	nicimenus
όπισθεν	opisθen
ανακαλύπτομε	anakaliptome
γελώ	ʝelo
πολωνικό	poloniko
ανιλίνη	anilini
ιούλη	iuli
βυθισμένα	viθizmena
λυπημένεσ	lipimenes
διορθώνω	ðʝoɾθono
φιλιού	fiʎu
ακίνδυνοσ	acinðinos
αποστείρωσα	apostiɾosa
ώστε	oste
βδελύγματα	vðeliɣmata
γαργηττόσ	ɣarʝitos
ελευθερουδάκησ	elefθeruðacis
λυγξ	liŋks
πρωκτόσ	proktos
παρακάμπτομαι	paɾakamptome
αλατισμένοι	alatizmeni
ξεράθηκα	kseɾaθika
κερατάσ	ceɾatas
κυριολεκτικά	ciɾiolektika
λυσσάω	lisao
αραχνιασμένη	aɾaxɲazmeni
κίνησα	cinisa
ξυπόλυτοσ	ksipolitos
πλησιάζω	plisiazo
καρεκλοκένταυροσ	kaɾeklocendavɾos
δέω	ðeo
σιγκαπούρη	siŋɡapuɾi
περιπλέχτηκε	peɾiplextice
κρύβω	kɾivo
ανεπίγραφοσ	anepiɣrafos
μινόρε	minoɾe
καταξοδεύω	kataksoðevo
λιτόσ	litos
άσεβουσ	asevus
μαθηματικά	maθimatika
κινεζοποιήσεων	cinezopiiseon
υποκλάπηκα	ipoklapika
θερμά	θerma
ερχόμενα	erxomena
σταφιδόψωμου	stafiðopsomu
ατμόσ	atmos
δακτυλογραφούμε	ðaktiloɣɾafume
έσπειρα	espiɾa
ήσασταν	isastan
ποικίλων	picilon
αβγό	avɣo
συνάπτομε	sinaptome
τσάκωνασ	tsakonas
πολεμικοί	polemici
θυελλώδησ	θieloðis
κότσαρα	kotsaɾa
εξετάσθηκα	eksetasθika
προσφέρομαι	pɾosfeɾome
υπερηφάνεια	iperifania
εγκατάλειψη	eŋɡatalipsi
κουλουριάζω	kuluɾʝazo
μητρικόσ	mitrikos
δένω	ðeno
βιάζω	vʝazo
συντρίφθηκαν	sindrifθikan
σουταρίστηκα	pondaɾistika
αλείφτηκα	aliftika
εγέρθητι	eʝeɾθiti
περιέστρεψα	peɾiestɾepsa
σωρούσ	soɾus
ποτό	poto
απότρεψα	apotɾepsa
πορτοκαλόπιτεσ	poɾtokalopites
λυπημένων	lipimenon
φρεσκάρομαι	freskarome
σερβίρομαι	seɾviɾome
καθέλκω	kaθelko
είστε	iste
περίπλου	periplu
σκοντάφτω	skondafto
μοντέλο	modelo
απάτησα	apatisa
πνίγω	pniɣo
νοέμβριε	noeɱvɾie
αναφυτεύτηκα	anafiteftika
κρίθηκα	kɾiθika
μέγαρα	meɣaɾa
ανάφερα	anafeɾa
προχωρώ	pɾoxoɾo
βασανιστήσ	vasanistis
αβανγκαρντισμοί	avaŋɡaɾdizmi
γλειφομούνι	ɣlifomuni
έδρεψα	eðɾepsa
ζημιώνομαι	zimionome
γεννών	ʝenon
ξεραίνομαι	kseɾenome
εξέτασα	eksetasa
ξεμπερδεύτηκα	ksebeɾðeftika
βυρσοδέψησ	viɾsoðepsis
σωρών	soɾon
εξέγειρα	ekseʝiɾa
εύχομαι	efxome
απαρηγόρητοσ	apaɾiɣoɾitos
περιήγηση	peɾiiʝisi
καταλόγουσ	kataloɣus
κρεμιέμαι	kremɲeme
περπατήθηκα	peɾpatiθika
επιπλέον	epipleon
εννιά	eɲa
αβγοκομμένοι	avɣokomeni
κυνηγήθηκα	ciniɣiθika
σκασμένων	skazmenon
παραπάνω	paɾapano
καλαμποκόψωμου	kalambokopsomu
αναψοκοκκινίζω	anapsokocinizo
αβγατισμένων	avɣatizmenon
κοκότα	kokota
μπούφοσ	bufos
πίνω	pino
ἤπια	ipia
δηλώνομαι	ðilonome
ζήτα	zita
μαγιού	maʝu
χαλίφησ	xalifis
υποδεχθεί	ipoðexθi
κωνσταντῖνοσ	konstandinos
καταφρονήθηκα	katafɾoniθika
άδενδροσ	aðenðɾos
συνδυάζομαι	sinðiazome
διαπληκτίζομαι	ðiapliktizome
βγαίνω	vʝeno
καθίζοντασ	kaθizondas
πατούσα	patusa
στέφομε	stefome
συνηθισμένοι	siniθizmeni
επέγραψα	epeɣɾapsa
περπατιέμαι	peɾpatçeme
σουτάρισε	sutaɾise
πλαγιάζω	plaʝiazo
συνέθλιψε	sineθlipse
ελευθερία	elefθeɾia
αναγεννήσεισ	anaʝenisis
παραλογίζομαι	paɾaloʝizome
ψηφιακού	psifiaku
κατασκευάστηκα	katascevastika
καθισμένε	kaθizmene
κατά	kata
ενστάλαξα	enstalaksa
σοφοί	sofi
υπερβάλλω	ipeɾvalo
πίνουμε	pinume
αργαλειόσ	aɾɣaʎos
πέρασα	peɾasa
επιδαύρου	epiðavɾu
αγανακτισμένοσ	aɣanaktizmenos
αερολιμένασ	aerolimenas
ξωτικό	ksotiko
φλόκι	floci
έκλεισα	eklisa
βάζεισ	vazis
δελφοί	ðelfi
κακοκεφιάσ	kakocefi̯as
καλό	kalo
καρτέρι	kaɾteɾi
νεκρόσ	nekɾos
αλυσοδεμένε	alisoðemene
υποσκάφτηκα	iposkaftika
ιανουάριε	ianuaɾie
δαιμονισμόσ	ðemonizmos
αργοσαλεύω	aɾɣosalevo
κορίτσαρου	koritsaru
απασχολημένων	apasxolimenon
εξαπολύω	eksapolio
ξαναμοιράστηκα	ksanamiɾastika
αίγινα	eʝina
αγωνία	aɣonia
περίπτωση	peɾiptosi
νόσου	nosu
ούτω	uto
περιόδουσ	perioðus
εργάστηκα	eɾɣastika
γαμημένα	ɣamimena
συκιά	sicʝa
ελληνικό	eliniko
πατσαβούρα	patsavuɾa
ψωμάδικα	psomaðika
χοντρομαλάκασ	xondɾomalakas
πενηντάρικο	penindaɾiko
νεκροταφείο	nekɾotafio
πρησμένουσ	pɾizmenus
ευφροσύνη	efɾosini
εισακούομε	isakuome
ντε	de
έχουμε	exume
άλυτοσ	alitos
κατάλογοσ	kataloɣos
γενεών	ʝeneon
πρωτομάρτυροσ	pɾotomaɾtiɾos
παροτρύνομε	paɾotɾinome
πλείστοσ	plistos
ερασιτέχνησ	eɾasitexnis
χρήματα	xrimata
ευχετικόσ	efçetikos
κομμένοι	komeni
ξόδιασα	ksoðʝasa
διαλύω	ði̯alio
έχομε	exome
διανύω	ðianio
σοφίασ	sofias
εγκαταστάθηκα	eŋɡatastaθika
δούναβησ	ðunavis
δημοσιεύτηκα	ðimosieftika
βροντοχτύπησα	vɾondoxtipisa
ακροάσθηκα	akroasθika
αναρτήθηκα	anaɾtiθika
λουτρό	lutɾo
καταξοδιάστηκα	kataksoðʝastika
φιλήθηκα	filiθika
διεγείρω	ðieʝiɾo
δίωξα	ðioksa
πρεζάκιασ	pɾezacas
απορρίπτω	apoɾipto
δημοσιεύουμε	ðimosievume
μάντευ'	mandef
πρωτεύουσα	pɾotevusa
ξεμπερδεύω	ksebeɾðevo
διαλύω	ðʝalio
προφτάνω	pɾoftano
λιπασμάτων	lipazmaton
κατοικούμε	katikume
κερατώνομαι	ceɾatonome
καταξοδιάζομαι	kataksoðʝazome
ικανοποιημένουσ	ikanopiimenus
προσγείωση	pɾozʝiosi
ιούλιοι	iulii
πιονίων	pionion
μυκήνεσ	micines
τιμοκαταλόγου	timokataloɣu
διαρκήσ	ðiarcis
παραβάλτε	paɾavalte
μάγκασ	maŋɡas
μαζικό	maziko
διαβεβαιώνομαι	ðʝaveveonome
καμουφλαρίστηκα	kamuflaɾistika
κουρασμένε	kurazmene
κατασκοπεύω	kataskopevo
κιμάσ	cimas
φυσικά	fisika
εδέσσησ	eðesis
περιεπλάκην	peɾieplacin
καπνόσ	kapnos
έντερο	endeɾo
ανθώ	anθo
ντουλάπα	dulapa
ἀρχαΐζουσα	arxaizusa
επανέναρξη	epanenaɾksi
αποδοκιμάζομε	apoðocimazome
σοφή	sofi
χαρτομάντισσα	xaɾtomandisa
κλάνοντασ	klanondas
κλιμακώθηκα	klimakoθika
αναφύτευσα	anafitefsa
ανεγράφην	aneɣrafin
μπερδεμένη	beɾðemeni
νάνων	nanon
ηρόδοτοσ	iroðotos
επιδοκιμάζω	epiðocimazo
απώλεια	apolia
σορών	soɾon
απειθώ	apiθo
αηδιαστικόσ	aiðʝastikos
αλευρωμένησ	alevromenis
μέτρησα	metɾisa
ενηλικιώνομαι	enilicionome
κωνσταντίνο	toŋɡonstandino
ύφεση	ifesi
στοχάζομαι	stoxazome
διαδηλώνω	ðʝaðilono
σίλασ	silas
ἀδικοῦμαι	aðikume
χρονολογιών	xronoloʝion
ειλημμένεσ	ilimenes
διαλυμένη	ðʝalimeni
βρετανόσ	vretanos
καταλύθηκα	kataliθika
τηλεφωνώ	tilefono
γαμημένων	ɣamimenon
αγγελοκρούουμε	aŋɟelokruume
χαραμοφάησ	xaɾamofais
αναγεννημένοσ	anaʝenimenos
κακογαμημένοσ	kakoɣamimenos
μεσολόγγι	mesoloŋɟi
εισακούω	isakuo
ξαναγράφηκα	ksanaɣɾafika
βέβαιοσ	veveos
συγγραφτείσ	siŋɣraftis
ελάττωμα	elatoma
σεφαρδίτησ	sefaɾðitis
ακριβοπληρώνω	akrivopliɾono
καλομοίρηδων	kalomiriðon
αναζητήθηκα	anazitiθika
απολογητικόσ	apoloʝitikos
βαθιοί	vaθçi
παρελθόντα	parelθonda
δορυφόροσ	ðoriforos
καθαρματάκι	kaθaɾmataci
ἐτάφην	etafin
αποσείστηκα	aposistika
παγιδεύθηκα	paʝiðefθika
κύματα	cimata
ώριμη	oɾimi
αποσυνδέω	aposinðeo
πάμμαυρη	pamavɾi
ημερεύετε	imeɾevete
σβηστήρασ	zvistiɾas
σκύλοσ	scilos
πιρόγα	piɾoɣa
γαμημένου	ɣamimenu
κόσμοσ	kozmos
βάλλομε	valome
αποκερματισμών	apoceɾmatizmon
ζάρι	zaɾi
ακρίβεια	akrivia
καρφώνω	kaɾfono
προστατευόμενοσ	pɾostatevomenos
αισχροκερδήσ	esxrocerðis
μπαλώνω	balono
καταγράφομαι	kataɣrafome
μουσκεμένα	muscemena
αθωώνω	aθoono
υπερίσχυσα	iperisçisa
μαΐουσ	maius
κρουστόσ	krustos
βάλει	vali
ανατείνουμε	anatinume
εισέρρευσα	iserefsa
εὔχεται	efçete
καρδινάλιοσ	kaɾðinalios
αρχή	arçi
λαλώ	lalo
ονομαστικά	onomastika
καταρρέω	katareo
κεκλεισμένου	ceklizmenu
ενάντια	enandia
ποικιλότατα	picilotata
προσγράφομαι	pɾozɣrafome
λακωνία	lakonia
πέμπεισ	pembis
υπαγορεύομαι	ipaɣoɾevome
μισώ	miso
εγγραφή	eŋɣrafi
απέπεμψα	apepempsa
ναυτικοί	naftici
φοροαπαλλαγών	foɾoapalaɣon
σαγηνεύτηκα	saʝineftika
φλώροσ	floɾos
κυνηγημένοσ	ciniʝimenos
αγγόνια	aŋɡoɲa
διακόπτω	ðʝakopto
χλιοι	xʎi
αναστάλθηκα	anastalθika
διαμορφώνω	ðiamoɾfono
μπάμπησ	babis
γιατρειά	ʝatɾia
οκτώβρηδεσ	oktovɾiðes
έρρινου	erinu
φωτογραφία	fotoɣrafia
βεβαίωσα	veveosa
συμπεριφορά	simbeɾifoɾa
τρομοκρατημένοσ	tɾomokɾatimenos
μοίρα	mira
επιβλέπω	epivlepo
λαιστρυγόνεσ	lestriɣones
κοροϊδεύω	koɾoi̯ðevo
ταλέντο	talendo
αγγιγμένου	aŋɟiɣmenu
παντρεμένων	pandɾemenon
κρεμάω	kremao
ζεσταμένουσ	zestamenus
πέρνα	peɾna
αγγαρεμένοσ	aŋɡaɾemenos
καπνοδόχε	kapnoðoçe
φέρετρο	feɾetɾo
κεριά	cerʝa
κουτσοί	kutsi
αυτόσ	aftos
διαρρέομαι	ði̯areome
μετάπτωσησ	metaptosis
κάρπαθε	kaɾpaθe
πετράκησ	petɾacis
ολόφωτουσ	olofotus
ντροπιασμένουσ	dɾopçazmenus
μαρκάρισα	maɾkaɾisa
μάρτυρασ	maɾtiɾas
διαχέομαι	ðiaçeome
οριστικά	oɾistika
σπίτι	spiti
πολεμώ	polemo
παραβάλουμε	paɾavalume
περασμένου	perazmenu
ἀττικίζουσα	aticizusa
αφηγητήσ	afiʝitis
ερχομένη	erxomeni
αγυιόπαιδου	aʝiopeðu
παραγραφτήκανε	paɾaɣɾaftikane
ανταμείβομαι	andamivome
έντρομοι	endɾomi
ντροπιασμένεσ	dɾopçazmenes
έβαλεσ	evales
παλικάρι	palikari
νοητόσ	noitos
απαρχαιωμένα	aparçeomena
φούμαρου	fumaɾu
εβλήθην	evliθin
πολεμικόσ	polemikos
πειθόμενου	piθomenu
ανακαίνισα	anacenisa
ανώριμοσ	anoɾimos
αβουλησία	avulisia
ρίπτω	ɾipto
ξοδεύτηκα	ksoðeftika
πειθαναγκάζω	piθanaŋɡazo
αναδημιουργημένη	anaðimiurʝimeni
αβγοκομμένησ	avɣokomenis
ισχύω	isçio
σπέρνω	speɾno
χαχανίζω	xaxanizo
ποντάρισα	pondaɾisa
φύομαι	fiome
αναδημιουργημένου	anaðimiurʝimenu
πάρκαρα	paɾkaɾa
ευχετήριοσ	efçetirios
κάποτε	kapote
γητεύομαι	ʝitevome
νηστικόσ	nistikos
απορροφώμενοσ	apoɾofomenos
ευχαριστούμαι	efxaɾistume
γέννασ	ʝenas
κλαδεύομαι	klaðevome
σημαδιών	simaðʝon
απολαμβάνω	apolaɱvano
έσπαζα	espaza
πετάγομαι	petaɣome
στράβωσα	stɾavosa
τέρπουμε	teɾpume
ατροφία	atɾofia
διαλελυμένη	ðialelimeni
λίπασμα	lipazma
τριταγωνιστή	tritaɣonisti
τέρψεισ	teɾpsis
χάφτετε	xaftete
υποσκάπτομε	iposkaptome
βερολίνο	verolino
κωσταντίνο	kostandino
αλαφιασμένησ	alafçazmenis
προηγούμενου	proiɣumenu
στυμμένοι	stimeni
μετάπτωση	metaptosi
λευκοπίνακασ	lefkopinakas
βαστήχτηκα	vastixtika
παρακάμψεισ	paɾakampsis
συλλέχτηκα	silextika
φυτικάσ	fitikas
πρωταθλητήσ	pɾotaθlitis
άκουγα	akuɣa
πεινασμένε	pinazmene
μπουνατσάρισε	bunatsaɾise
αντιπαραβάλλω	andipaɾavalo
πειθόμενοσ	piθomenos
αγγλοποιημένοσ	aŋɡlopiimenos
καμουφλάρομαι	kamuflaɾome
διανύομαι	ðianiome
αγελάδα	aʝelaða
αγιοποιημένοσ	aʝiopiimenos
φίδι	fiði
αμφιλεγόμενη	aɱfileɣomeni
κεφιών	cefçon
προαλείφομε	pɾoalifome
πωλήσεισ	polisis
ακοινωνησίασ	acinonisias
διψώ	ðipso
πλοίο	plio
διψάω	ðipsao
ερωτώ	eɾoto
επάρκεια	epaɾcia
καλομοίρικο	kalomiriko
τρυπάω	tɾipao
μοιράζω	miɾazo
αποσάθρωσα	aposaθɾosa
ανεγγύητοσ	aneŋɟiitos
ξοδεύω	ksoðevo
βάλομε	valome
αγαπημένησ	aɣapimenis
προσδοκώ	pɾosðoko
απετράπην	apetɾapin
ανακάτεψα	anakatepsa
στάνη	stani
οδό	oðo
αγγελούδια	aŋɟeluðʝa
εγκαθιδρύω	eŋɡaθiðrio
βρείτε	vɾite
μυρωμένησ	miromenis
σαλεύω	salevo
επιγράφτηκε	epiɣraftice
υπνοβάτησ	ipnovatis
προκοπή	pɾokopi
αθεϊσμούσ	aθeizmus
βρει	vɾi
περσέα	peɾsea
αραχνιασμένησ	aɾaxɲazmenis
κρίνου	krinu
αλαμπουρνέζικησ	alaburnezicis
δεμένοσ	ðemenos
διάτανοσ	ðʝatanos
ορλάνδοσ	orlanðos
καλικαντζαρούδι	kalikandzaɾuði
έξοδοσ	eksoðos
ερωτημένοσ	eɾotimenos
επιδράσεισ	epiðɾasis
προχώρησα	pɾoxoɾisa
χεβρώνα	çevrona
καλοήθησ	kaloiθis
καταλύουμε	kataliume
πειθόμενουσ	piθomenus
ιωάννησ	ioanis
στραβώνω	stɾavono
οπίου	opiu
μεταφυτεύω	metafitevo
κάποιοσ	kapços
αγιοποιημένη	aʝiopiimeni
ζεύγουσ	zevɣus
στοιβάζομαι	stivazome
φυτικήσ	fiticis
κρεατόμυγα	kɾeatomiɣa
δεήθηκα	ðeiθika
βολιδοσκοπήθηκα	voliðoskopiθika
επανέναρξησ	epanenaɾksis
σκοτώνω	skotono
πεολειχία	peoliçia
εθνάρχεσ	eθnarçes
αναγορεύω	anaɣorevo
μαρτυρημένοσ	maɾtiɾimenos
προστατεύτηκα	pɾostateftika
αναμαλλιασμένοι	anamaʎazmeni
επαινούμαι	epenoume
στέψεισ	stepsis
αξιοσημείωτου	aksiosimiotu
μοιρασμένων	miɾazmenon
μαλακισμένων	malacizmenon
φωτογραφήσεισ	fotoɣrafisis
χεσμένησ	çezmenis
διαρρέομαι	ðʝareome
ξαπόστασα	ksapostasa
πίθον	piθon
συμπαθήθηκα	simbaθiθika
συγκρουόμενουσ	siŋɡruomenus
καλοφάγωτη	kalofaɣoti
βραχυκυκλώθηκα	vɾaçicicloθika
τείνω	tino
συνεχίζω	sineçizo
νύσταξα	nistaksa
αγνοούμενοσ	aɣnoumenos
κουράδα	kuɾaða
πατσαβουρόπιτα	patsavuɾopita
σκουντηγμένοσ	skundiɣmenos
κατασκεύασα	katascevasa
αναγκάσθηκα	anaŋɡasθika
χόρεψαν	xoɾepsan
ανθρωπεύω	anθɾopevo
αποβάλλομε	apovalome
θεαματικότητα	θeamatikotita
χιόνισε	çonise
απαράδεκτα	apaɾaðekta
αραχνιασμένο	aɾaxɲazmeno
πρόφτασα	pɾoftasa
κολλήθηκα	koliθika
εντάξει	endaksi
παρκαρίστηκα	paɾkaɾistika
αυτοκτονώ	aftoktono
αγαπούσα	aɣapusa
εισέπλευσα	iseplefsa
αναθεματισμένε	anaθematizmene
καυλώνω	kavlono
εισαγγελέασ	isaŋɟeleas
γαμώτη	ɣamoti
σαπιοκοιλιά	sapçociʎa
τετριμμένα	tetrimena
βαθιά	vaθça
απέδειξα	apeðiksa
αγγιγμένεσ	aŋɟiɣmenes
δεύτεροσ	ðefteɾos
παραγράφηκε	paɾaɣɾafice
πταισματοδικείο	ptezmatoðicio
κουρασμένο	kurazmeno
ακόλλητοσ	akolitos
σπουργίτι	spuɾʝiti
βεβαιώνομαι	veveonome
αγγίστηκα	aŋɟistika
επικαλύπτω	epikalipto
ποικιλότατοσ	picilotatos
ακοντίσθηκα	akondisθika
δοκιμάζουμε	ðocimazume
τιμή	timi
κρίνω	kɾino
κουρελιάζομαι	kuɾeʎazome
επιγραφτήκαν	epiɣraftikan
ξεκινώ	ksecino
ωρίμωσ	oɾimos
αγαπημένοι	aɣapimeni
διατυπώνω	ði̯atipono
πηγαίνω	piʝeno
κεκλεισμένη	ceklizmeni
πιτσαδόροσ	pitsaðoɾos
αθεϊστήσ	aθeistis
φυτεύτηκα	fiteftika
ναυσικᾶ	nafsika
τελευταίωσ	telefteos
στρέφομε	stɾefome
αστυνομία	astinomia
διατηρημένοσ	ði̯atiɾimenos
ετοιμασίασ	etimasias
φυλλομετριέμαι	filometɾʝeme
επισυνάπτομε	episinaptome
ξεγράφω	kseɣrafo
γιουχαΐζω	ʝuxaizo
ποικιλότεροσ	piciloteros
σπιτικό	spitiko
σάλοσ	salos
αηδώσ	aiðos
έργο	eɾɣo
περιοδικά	perioðika
ξιφιόσ	ksifços
εξυπακούονται	eksipakuonde
κωλύουμε	koliume
αποστάλθηκα	apostalθika
νεκροτομή	nekɾotomi
κυνηγάω	ciniɣao
μπογάζι	boɣazi
επιγράφτηκαν	epiɣraftikan
καλοκαίρι	kaloceri
περίοδο	perioðo
εβραίοσ	evɾeos
κουταμάρα	kutamaɾa
βοηθιέμαι	voi̯θçeme
στειμμένο	stimeno
γαργαλιέμαι	ɣaɾɣaʎeme
παραγράφομαι	paɾaɣɾafome
βολιδοσκοπώ	voliðoskopo
οκτωβρίων	oktovɾion
τοποθετώ	topoθeto
κοινόλεκτοι	cinolekti
χτυπώ	xtipo
κοιτίδα	citiða
σπασμένε	spazmene
παπάρασ	papaɾas
εξέγερση	ekseʝersi
ακρωτηριάζομαι	akɾotiɾiazome
μπόλικοι	bolici
σερβίριζα	seɾviɾiza
μπερδεύτηκα	beɾðeftika
σαντουριού	sandurʝu
φτύνομαι	ftinome
τήνο	tino
δισεκατομμύριο	ðisekatomirio
προμνησίεσ	pɾomnisies
στριμμένε	stɾimene
ναζιάρα	nazʝaɾa
ποίηση	piisi
απαρχαιωμένουσ	aparçeomenus
συντομεύτηκα	sindomeftika
πιστεύετε	pistevete
τελούμαι	telume
κόκκινα	kocina
αποκερματισμούσ	apoceɾmatizmus
ανάδοχοσ	anaðoxos
σικελία	sicelia
αμαλιάδα	amaʎada
λερώνομαι	leɾonome
αβγοκομμένεσ	avɣokomenes
τρελάθηκα	tɾelaθika
λάκαινα	lacena
μαντεύω	mandevo
διαλυμένα	ðʝalimena
κατέστη	katesti
άσκησα	ascisa
γκαστρωμένου	ɡastromenu
λάκων	lakon
τρομάζω	tromazo
ανασκάφτουμε	anaskaftume
ιούλιε	iulie
περπατάω	peɾpatao
επιστρέφομε	epistɾefome
φτου	ftu
ενρινότητασ	enrinotitas
κακοκεφιά	kakocefi̯a
ταχυφαγείο	taçifaʝio
αδιευκρίνιστοσ	aðiefkɾinistos
αρδεύθηκα	aɾðefθika
πολεμούσα	polemusa
αναγκάζομαι	anaŋɡazome
υδρόβιοσ	iðrovios
μαζικότατη	mazikotati
αγγλοποιώ	aŋɡlopio
μπερδεύω	beɾðevo
ματόκλαδων	matoklaðon
αγύρτησ	aʝiɾtis
μα	ma
πύργο	pirɣo
οργή	orʝi
ξεριζώνομαι	kseɾizonome
χτύπησα	xtipisa
κουπάκια	kupaca
ιούνησ	iunis
μυταρού	mitaɾu
διψασμένη	ðipsazmeni
έσκισα	escisa
σκασμένοι	skazmeni
κωνσταντινουπόλεωσ	konstandinupoleos
μποϊκοταρίστηκα	boikotaɾistika
υπολογισμένεσ	ipoloʝizmenes
κρούομαι	kruome
σκουντιέμαι	skundʝeme
εξημερώσεισ	eksimeɾosis
κάλυμνε	kalimne
αποτρέπομαι	apotɾepome
ανέπνευσα	anepnefsa
θερμοδυναμικέ	θermoðinamice
ανεμελιών	anemeʎon
σημάδεψα	simaðepsa
κυκλοφοράω	ciklofoɾao
ανοιξιάτικα	aniksçatika
ταράζω	tarazo
μητρική	mitrici
μπερδεύομαι	beɾðevome
υπολείπομαι	ipolipo
εξαναγκάζω	eksanaŋɡazo
πιόνια	pionia
υπερφορτώνομαι	ipeɾfoɾtonome
εφοδιάζομαι	efoðiazo
πείστηκα	pistika
εννοούμαι	enoume
ηλικιωμένη	iliciomeni
έτρεμα	etrema
αεροφωτογράφισα	aerofotoɣrafisa
υποθηκεύτηκα	ipoθiceftika
ἀγορά	aɣoɾa
απάλειψα	apalipsa
χρονολόγηση	xronoloʝisi
λυνόντουσαν	linondusan
εύχεται	efçete
δεκαεννέα	ðekaenea
ψόφοσ	psofos
ανοίγομαι	aniɣome
πιθάρι	piθari
ολόκληροσ	olokliros
απαρχαιωμένη	aparçeomeni
λάκωνα	lakona
φίλησα	filisa
σχολίου	sxoliu
αιτιοκρατιών	etiokration
χειλιού	çiʎu
αποζημιώσεισ	apozimiosis
υποδιαστολή	ipoðiastoli
φλώρινα	floɾina
δημητράκησ	ðimitɾacis
μαζικότεροι	mazikoteri
παραβάλλεται	paɾavalete
νυστάζω	nistazo
συνάπτω	sinapto
προσελκύουμε	proselciume
ανησύχησα	anisixo
αραχνιασμένουσ	aɾaxɲazmenus
ορθώνω	oɾθono
ευσεβέστατα	efsevestata
κραγμένου	kraɣmenu
αγγουριών	aŋɡuɾʝon
έπλευσα	eplefsa
χαλάστηκα	xalastika
ποικίλο	picilo
χέσιμο	çesimo
άγιοι	aʝii
πουσταρέλι	pustaɾeli
συνεχίζουμε	sineçizume
διαρρέω	ðʝareo
ακοή	akoi
άλγοσ	alɣos
αιμομιξία	emomiksia
μπόλικη	bolici
υπολογισμένοσ	ipoloʝizmenos
χρειάστηκα	xɾiastika
συμπολεμίστρια	simbolemistria
τρίτων	tɾiton
φτάστηκα	ftastika
μπονατσάρισε	bonatsaɾise
προστέθηκα	prosteθika
βλήθηκα	vliθika
απαράδεκτη	apaɾaðekti
μουσκεύτηκα	musceftika
σφύζω	sfizo
ποδόσφαιρο	poðosfero
κουταλιά	kutaʎa
καταφρόνεσα	katafɾonesa
υπολογισμένουσ	ipoloʝizmenus
βροντοχτυπούσα	vɾondoxtipusa
βιόσφαιρεσ	viosfeɾes
αλαμπουρνέζικουσ	alaburnezikus
επιδοκιμάζομαι	epiðocimazome
συγνώμη	siɣnomi
ετράπην	etɾapin
αναθάρρεψα	anaθaɾepsa
εθνικόσ	eθnikos
ακονίζω	akonizo
δαγκάθηκα	ðaŋɡaθika
ἀνασκάπτομεν	anaskaptomen
χρονολόγησησ	xronoloʝisis
εκδίκηση	ekðicisi
καλοφάγωτου	kalofaɣotu
σταμάτηδεσ	stamatiðes
πεζομαχία	pezomaçia
ανέμενα	anemena
καλντερίμι	kaldeɾimi
οδού	oðu
κακίστρω	kacistɾo
πολεμικά	polemika
σκασμένο	skazmeno
απομονωμένοσ	apomonomenos
μέσω	meso
βλαμμένοσ	vlamenos
φετινόσ	fetinos
ανεσκάφην	aneskafin
τεϊομαντεία	teiomandia
φτυστόσ	ftistos
χρονιά	xroɲa
αναγέννησα	anaʝenisa
αποκόβω	apokovo
ερρινομελήσ	erinomelis
κανάκευε	kanaceve
αλευρωμένο	alevromeno
σκούντησα	skundisa
νεπάλ	nepal
κλάνω	klano
περίοδε	perioðe
βαστάζω	vastazo
απρίλησ	apɾilis
τριμμένοσ	trimenos
πολωνικήσ	polonicis
προειδοποιημένοσ	pɾoiðopiimenos
ευχαριστώ	efxaɾisto
εξέρρευσα	ekserefsa
δέησα	ðeisa
αίρω	ero
εγγράφτηκε	eŋɣraftice
χέλι	çeli
ποικίλου	picilu
μπούρδεσ	buɾðes
λυπημένα	lipimena
παρεκτρέπομαι	paɾektɾepome
πρησμένοσ	pɾizmenos
μαντεύομαι	mandevome
εξοπλισμένεσ	eksoplizmenes
βυθισμένο	viθizmeno
καν	kan
άραχνοσ	aɾaxnos
υπέρ	iper
υπέροχη	ipeɾoçi
ξεσκατίζω	kseskatizo
αναγράφουμε	anaɣrafume
ηγούμενεσ	iɣumenes
πρωταγωνιστέσ	pɾotaɣonistes
πούτσοσ	putsos
επετράπη	epetɾapi
ρωτιέμαι	ɾotçeme
θείον	θion
αναπαύω	anapavo
καθείλκυσα	kaθilcisa
φυτικοῦ	fitiku
λίαν	lian
ποδοσφαιριστήσ	poðosfeɾistis
μαλακισμένουσ	malacizmenus
αγαπημένη	aɣapimeni
τσογλαναράσ	tsoɣlanaɾas
ανεκαλύφθην	anekalifθin
αποκρύπτομαι	apokɾiptome
ενοικιαστήσ	eniciastis
αναγράφηκα	anaɣrafika
κίτροσ	citɾos
σορέ	soɾe
κανακεύομαι	kanacevome
κλείστηκα	klistika
ωσότου	osotu
πείθομαι	piθome
νταβατζήσ	davandzis
σκουντάω	skundao
περνώ	peɾno
αγίουσ	aʝius
πρωθυπουργόσ	pɾoθipuɾɣos
ἀποστηθίζω	apostiθizo
κεκλεισμένεσ	ceklizmenes
γέννα	ʝena
μάγοσ	maɣos
θαλαμηγέ	θalamiʝe
μπάρμπασ	baɾbas
γκρίζοσ	ɡɾizos
συντριπτικόσ	sindriptikos
αναπλειστηριάζω	anaplistiriazo
εκχύνω	ekçino
κουραστικό	kurastiko
τρομαγμένοι	tɾomaɣmeni
εισπνεύστηκα	ispnefstika
αποσαθρώνομαι	aposaθɾonome
χαίρομαι	çeɾome
δεκανέασ	ðekaneas
ομοφυλόφιλε	omofilofile
όλασπροσ	olaspɾos
εισακούουμε	isakuume
δημιουργούμαι	ðimiuɾɣume
εκρέω	ekreo
έλκομε	elkome
γαμώ	ɣamo
αναδείχτηκα	anaðixtika
ἐξετέλεσα	eksetelesa
ηγούμενε	iɣumene
βασανιστήριο	vasanistiɾio
αγορέσ	aɣores
λαλούμε	lalume
επιχειρώ	epiçiro
απορροφούμενησ	apoɾofumenis
μπουγάζια	buɣazʝa
φιστίκι	fistici
λιγότερουσ	liɣoterus
ενέχυσα	eneçisa
ήσαν	isan
πομφόλυξ	poɱfolix
πόνταρε	pondaɾe
μαρασκίνο	maɾascino
περιπλέχτηκαν	peɾiplextikan
γεωγραφικόν	ʝeoɣɾafikon
κουμπάροσ	kumbaros
ουρώ	uro
συντρίφτηκαν	sindriftikan
εκκρούομαι	ekruome
βουτυρωμένοι	vutiromeni
φυτικά	fitika
σκεπάρνι	sceparni
μωρή	moɾi
λίθοι	liθi
γοήτευσα	ɣoitefsa
νυχτερίδα	nixteɾiða
κλιμάκωσα	klimakosa
λουκουμάσ	lukumas
αναστήλωσα	anastilosa
θέματοσ	θematos
ντροπιασμένων	dɾopçazmenon
ομόλογοσ	omoloɣos
ομοφυλόφιλουσ	omofilofilus
κοριτσιών	koɾitsçon
αναθεματισμένων	anaθematizmenon
χρώμα	xɾoma
αποκόπτομαι	apokoptome
αδικούμε	aðikume
ψυχιατρική	psiçatrici
τρομοκράτησ	tɾomokɾatis
φουμάριζε	fumaɾize
απόσεισα	aposisa
αλατισμένο	alatizmeno
είλκυσα	ilcisa
τελεσμένοσ	telezmenos
δραπέτισσα	ðɾapetisa
προειδοποιούμε	pɾoiðopiume
γουρούνα	ɣuɾuna
ιδιοσυγκρασία	iðiosiŋɡɾasia
μέροσ	meɾos
υποκλέπτω	ipoklepto
καταστράφηκα	katastɾafika
υιοθετήθηκα	ioθetiθika
λάτρεψα	latɾepsa
θα	θa
ένρινου	enrinu
αισχροκερδώ	esxrocerðo
γαργάλησα	ɣaɾɣalisa
αδρεναλίνη	aðɾenalini
πηγαινέλα	piʝenela
υλικόσ	ilicos
προσγράφουμε	pɾozɣrafume
εγκλείομε	eŋɡliome
ομολογώ	omoloɣo
λιμένα	limena
απέλυσα	apelisa
εισροή	izroi
δημοσιεύω	ðimosievo
αγνοώ	aɣnoo
ντροπιασμένα	dɾopçazmena
ποντάρισε	pondaɾise
αναβαλλόμενων	anavalomenon
κοκορέτσι	kokoɾetsi
θλιβερήσ	θliveɾis
εφήμεροσ	efimeros
συμβουλεύομαι	siɱvulevome
διαλυμένε	ðʝalimene
έρρινησ	erinis
πάμμαυρησ	pamavɾis
κύπρου	cipɾu
αποκλείσθηκα	apoklisθika
ορεστιάδα	oɾestiaða
βοήθησα	voiθisa
σημειώνω	simiono
κατανάγκασα	katanaŋɡasa
αλυσοδεμένεσ	alisoðemenes
διεθνήσ	ðieθnis
ρεζίλεψα	ɾezilepsa
κοιτάχτηκα	citaxtika
τζάκι	dzaci
τρεχούμενοι	tɾexumeni
κεμέρι	cemeɾi
τσεκάρομαι	tsekaɾome
κρατώ	kɾato
αμυγδαλή	amiɣðali
ντετερμινισμό	determinizmo
συνεδέθην	sineðeθin
διαχύνω	ðʝaçino
εκπέμπω	ekpembo
βαρκελώνη	vaɾceloni
αποτράπηκε	apotɾapice
βεβαιώσει	veveosi
λύουν	liun
συνέρραψα	sineɾapsa
μετέτρεψα	metetrepsa
παλιόγρια	paʎoɣɾia
ερωτώμαι	eɾotome
θυμωμένουσ	θimomenus
βασιλοκτονία	vasiloktonia
αναλογία	analoʝia
πρωτοανακαλύφτηκα	pɾotoanakaliftika
ἐξέπλευσα	ekseplefsa
γαργαλήθηκα	ɣaɾɣaliθika
ἐγκαθιδρύομαι	eŋɡaθiðriome
παραβάλλουμε	paɾavalume
αγγλοποιούμαι	aŋɡlopiume
θαλασσήσ	θalasis
ορίζομε	oɾizome
στενοχωριέμαι	stenoxorʝeme
ήβησ	ivis
μονάρχεσ	monarçes
ανήλθα	anilθa
τεχνολόγοσ	texnoloɣos
δουλεύω	ðulevo
ομολογείται	omoloʝite
βερνικώνω	veɾnikono
πρεσάρω	pɾesaɾo
ακοινωνησιών	acinonision
μαζικότερε	mazikotere
τύχη	tiçi
θύελλα	θiela
βούληση	vulisi
καθελκύστηκα	kaθelcistika
εκείνοι	ecini
γέννησα	ʝenisa
λουκούμι	lukumi
γρηγόρηδων	ɣɾiɣoɾiðon
τσακωνικέσ	tsakonices
έξη	eksi
ανακαινίστηκα	anacenistika
χίοι	çii
διαδηλώνω	ði̯aðilono
κουρέασ	kuɾeas
τροχονόμοσ	tɾoxonomos
βλέποντασ	vlepondas
λυπημένου	lipimenu
αμεριμνησία	ameɾimnisia
αντιπαραμεθαύριο	andiparameθavɾio
πιέζομαι	piezome
τεμπέλιασα	tembeʎasa
ξύνω	ksino
γεωγραφία	ʝeoɣrafia
άνδρο	anðɾo
άνδρου	anðɾu
ευωδιά	evoðʝa
παγασέσ	paɣases
σαλτάριζα	saltaɾiza
στειρότητα	stiɾotita
θόδωροσ	θoðoɾos
δείχνω	ðixno
γκρίζεσ	ɡɾizes
μεγαλομάρτυροσ	meɣalomaɾtiɾos
ερρινίζω	erinizo
αθεϊσμέ	aθeizme
υπολογιστικήσ	ipoloʝisticis
πλίνθουσ	plinθus
συγκόπτω	siŋɡopto
αναγεννησιακοί	anaʝenisiaci
απογοητεύομαι	apoɣoitevome
προσαρτημένοσ	pɾosaɾtimenos
ντούμπλαρα	dublaɾa
ιούληδων	iuliðon
μεταπτώσεων	metaptoseon
γκαστρωμένουσ	ɡastromenus
κολλιέμαι	koʎeme
ξαραχνιάζομαι	ksaɾaxɲazome
χαζεύω	xazevo
ανακατεύομαι	anakatevome
κελαϊδώ	celaiðo
ψημένη	psimeni
ζευγαριών	zevɣarʝon
απασχολούμαι	apasxolume
εισπνέομε	ispneome
σουτάριζα	sutaɾiza
ιεράρχεσ	ierarçes
έλιασα	eʎasa
κυνηγημένε	ciniʝimene
μολογώ	moloɣo
ψημένων	psimenon
μοσχοκαρυδιά	mosxokaɾiðʝa
ποικίλοσ	picilos
πλαγίασα	plaʝiasa
άσπροσ	aspɾos
κατεργάστηκα	katerɣastika
αρκτικόσ	aɾktikos
ήδη	iði
αντίνοοσ	andinoos
ερρινοποιήσεων	erinopiiseon
σταμάτιοσ	stamatios
διαμηνύω	ðiaminio
περικόπτω	peɾikopto
επιλογή	epiloʝi
σαγιονάρα	saʝonaɾa
εκλείψεισ	eklipsis
στέφθηκα	stefθika
ποικιλότατεσ	picilotates
φασούλι	fasuli
χριστουγεννιάτικα	xristuʝeɲatika
μύκονοσ	mikonos
ενεργειακόσ	eneɾʝiakos
ιλλυρικόσ	iliɾikos
αορτή	aoɾti
αεροφωτογραφίσεισ	aerofotoɣrafisis
διακρίνω	ðiakrino
σύντριψα	sindɾipsa
σφάχτησ	sfaçtis
ανέστρεψα	anestɾepsa
συρράφηκα	siɾafika
τηλεθεάτρια	tileθeatɾia
προφητεύθηκα	pɾofitefθika
συμφυρμόσ	siɱfirmos
περιόδων	perioðon
βρέχομαι	vrexome
έσχισα	esçisa
σαρώνω	saɾono
αποτραβώ	apotɾavo
αγιοποιημένοι	aʝiopiimeni
αξιοθρήνητοσ	aksioθɾinitos
ποια	pça
ξενιτειά	ksenitça
χαλασμένουσ	xalazmenus
φυλλομετρούμαι	filometɾume
ανακλώμενοσ	anaklomenos
εθναρχών	eθnarxon
επαμφοτερίζω	epaɱfoteɾizo
χίασμα	çiazma
διαδέχτηκα	ðʝaðextika
υπαγορεύω	ipaɣoɾevo
αλλοιώνομαι	alionome
αμφισβήτησα	aɱfisvitisa
δημεύθηκα	ðimefθika
ευσεβείσ	efsevis
περιπλέκω	peɾipleko
σορό	soɾo
αϋπνία	aipnia
παραβάλετε	paɾavalete
διαισθάνομαι	ðiesθanome
κανταδόροσ	kantaðoɾos
μαστίζομαι	mastizome
αντίο	adio
περάστηκα	peɾastika
σερβίριζε	seɾviɾize
ανακρίνουμε	anakɾinume
τσίτσεσ	tsitses
αναγνωρισμένου	anaɣnorizmenu
ιδρύω	iðrio
γκαστρωμένο	ɡastromeno
αγκάλιασα	aŋɡaʎasa
επανάφερα	epanafeɾa
ψοφώ	psofo
υποβοηθούμενη	ipovoiθumeni
πραματευτήσ	pɾamateftis
ξεχασμένοσ	ksexazmenos
τούρτεσ	tuɾtes
θερμοδυναμικόσ	θermoðinamikos
ακοομετρία	akoometria
είχεσ	içes
κίτρε	citɾe
παραγράφηκαν	paɾaɣɾafikan
τελειώνω	teʎono
εξυπακουόταν	eksipakuotan
νοστίμευ'	nostimef
αλυσοδέθηκα	alisoðeθika
προστάτεψα	pɾostatepsa
υπερόχωσ	ipeɾoxos
κρυμμένε	krimene
αηδιασμένησ	aiðiazmenis
προηγούμενα	proiɣumena
λύγκασ	liŋɡas
ναύπακτο	nafpakto
ματοκυλίστηκα	matocilistika
συντρίφτηκα	sindriftika
εκδοτικόσ	ekðotikos
βουβάλι	vuvali
δευτεραγωνιστή	ðefteraɣonisti
αλήτεψε	alitepse
δάπεδο	ðapeðo
θάβω	θavo
αλφαδιάστηκα	alfaðʝastika
παρέβαλλα	paɾevala
ανδρειώνομαι	anðɾionome
χαμηλόσ	xamilos
προσφέρομε	pɾosfeɾome
αμφισβητήθηκα	aɱfisvitiθika
σείουμε	siume
βάφτηκα	vaftika
αποξενώνομαι	apoksenonome
λυνότανε	linotane
βοηθήθηκα	voi̯θiθika
πρησμένε	pɾizmene
φωτογραφούμε	fotoɣrafume
αλληλοσυγκρουόμενη	alilosiŋɡruomeni
πεινασμένουσ	pinazmenus
παναγιώτατοσ	panaʝiotatos
μειονοψηφίεσ	mionopsifies
ξυλουργόσ	ksilurɣos
καλομοίρικα	kalomirika
ανατάθηκα	anataθika
λοιπόν	lipon
παιδοβούβαλο	peðovuvalo
ευσεβώσ	efsevos
φαίνεστε	feneste
ιριδίζω	iriðizo
γυρίζομαι	ʝiɾizome
εκτρέπουμε	ektɾepume
εβδομάδα	evðomaða
ξοδιάζομαι	ksoðʝazome
μυρωμένοσ	miromenos
αύγουστο	avɣusto
αποδείχνω	apoðixno
βραδάκι	vɾaðaci
εγκαθιστώ	eŋɡaθisto
αποκρύπτουμε	apokɾiptume
αναλυτικά	analitika
μπανιέρα	baɲeɾa
καθισμένη	kaθizmeni
έρρινη	erini
ληστήσ	listis
εντούτοισ	endutis
άρμα	aɾma
μαζικότατοσ	mazikotatos
ἀναγράφομαι	anaɣrafome
χαμπάρι	xambaɾi
προμηθεύω	pɾomiθevo
επιδοκιμάζουμε	epiðocimazume
ψυχολογικοί	psixoloʝici
καθομιλουμένων	kaθomilumenon
απαίτησα	apetisa
υιοθέτησα	ioθetisa
κρεμασμένοσ	kremazmenos
αποτραβιέμαι	apotɾavʝeme
λακωνικόσ	lakonikos
συμπληρώσεισ	simbliɾosis
προαλείφομαι	pɾoalifome
ιούληδεσ	iuliðes
εγέρθηκε	eʝeɾθice
πειραματίστηκα	piɾamatistika
καλομοίρησ	kalomiris
περίοδοι	perioði
κατέβαλλε	katevale
πειράζομαι	pirazome
κουτσό	kutso
μουσκεμένε	muscemene
ξαραχνιάστηκα	ksaɾaxɲastika
καινοφανήσ	cenofanis
παπαγάλοσ	papaɣalos
πατινάρισα	patinaɾisa
ανιδρύθηκα	aniðriθika
ανιχνεύθηκα	anixnefθika
αιματοβαμμένων	ematovamenon
φορολογία	foɾoloʝia
ψωλή	psoli
επαλείφουμε	epalifume
πιστεύτε	pistefte
πατσαβουρόπιτασ	patsavuɾopitas
διαλελυμένουσ	ðialelimenus
ξεχνώ	ksexno
στάζω	stazo
μήτροσ	mitɾos
πειθόμενοι	piθomeni
ταξιτζού	taksindzu
στεναχωρημένοσ	stenaxorimenos
ευθεία	efθia
πεθαμένουσ	peθamenus
αναθεματισμένο	anaθematizmeno
συντριφτήκαν	sindriftikan
κρεμασμένοι	kremazmeni
κανακεύετε	kanacevete
γιοσ	ʝos
σερβίρισε	seɾviɾise
γεννώ	ʝeno
τσακωνικού	tsakoniku
κωλύομε	koliome
απέκρυψα	apekɾipsa
μοιρασμένησ	miɾazmenis
κατοικούμαι	katikume
απερρίφθην	apeɾifθin
ανοιξιάτικοσ	aniksçatikos
παρασκευάζομαι	paɾascevazo
σφιχταγκαλιάστηκα	sfixtaŋɡaʎastika
αγγλοποιούμε	aŋɡlopiume
πάμμαυροσ	pamavɾos
νόσε	nose
μεταφράστηκα	metafɾastika
βλασταίνω	vlasteno
κραγμένο	kraɣmeno
εξαλείφουμε	eksalifume
αεροβίωση	aeɾoviosi
πρωτοκόλλησα	pɾotokolisa
κατσαπλιάσ	katsapʎas
στεναχωρημένου	stenaxorimenu
ουσιαστικοποιήσεισ	usiastikopiisis
ασπάζομαι	aspazome
κολλάω	kolao
κάλμαρα	kalmaɾa
ζητιάνευ'	zitçanef
πηδήθηκα	piðiθika
ανανάδεσ	ananaðes
σφιγκτήρασ	sfiŋɡtiɾas
παντρεμένοσ	pandɾemenos
αποτρέπομε	apotɾepome
κόποσ	kopos
αντικλεπτικά	andikleptika
απασχολημένη	apasxolimeni
λεπτό	lepto
ποιήθηκα	piiθika
γρίνιαξα	ɣɾiɲaksa
έγγραφο	eŋɣrafo
εγγονιών	eŋɡoɲon
εμπνευσμένεσ	embnevzmenes
υπέκλεψα	ipeklepsa
κεκ	kek
βουτυρωμένουσ	vutiromenus
απόρριμμα	aporima
λιοντάρι	ʎondaɾi
παρασταίνω	parasteno
πίτεσ	pites
παρκάρω	paɾkaɾo
συνέχεια	sineçia
φανταστικοί	fandastiçi
γεωγραφίασ	ʝeoɣrafias
πρησμένα	pɾizmena
περίπλοι	peripli
ερχόμενε	erxomene
βουτάω	vutao
ελιά	eʎa
πειθόμενη	piθomeni
παγωμένου	paɣomenu
λύσσα	lisa
καμπούρησ	kambuɾis
στεναχωρημένοι	stenaxorimeni
οπτικόσ	optikos
παρακαλέστηκα	paralalestika
τύρναβοσ	tiɾnavos
οφειλόμουν	ofilomun
ψωμιέρεσ	psomɲeres
καλομαθημένε	kalomaθimene
αιματοβαμμένοσ	ematovamenos
σερβιετούλα	servietula
ακολούθησα	akoluθisa
σημάδι	simaði
κόπτω	kopto
συνοριοφύλακεσ	sinoriofilaces
σεπτεμβρίου	septeɱvɾiu
ξεψυχώ	ksepsixo
αργό	aɾɣo
εγκαταλείψεισ	eŋɡatalipsis
γενεάσ	ʝeneas
ρεύτηκα	ɾeftika
επιγράφομαι	epiɣrafome
κουραστικά	kurastika
βαστηγμένοσ	vastiɣmenos
αγγουριού	aŋɡuɾʝu
εικοσάρικο	ikosaɾiko
ανακατεύω	anakatevo
επαλείφομε	epalifome
παρακείμενων	paɾacimenon
αφυδατώνω	afiðatono
κόλλαγα	kolaɣa
κρυμμένοι	krimeni
μαθημένε	maθimene
κοινό	cino
ανακάτωσα	anakatosa
προκόβω	pɾokovo
λυτόσ	litos
πύργε	pirʝe
υιοθετούμαι	ioθetume
γέννηση	ʝenisi
συνδιασκέφθηκα	sinðiascefθika
αλλάχ	alax
χτυπάω	xtipao
μπογάζια	boɣazʝa
οδηγάω	oðiɣao
απρίλιε	apɾilie
αναδημιουργημένουσ	anaðimiurʝimenus
ἀνέσκαψα	aneskapsa
προφήτεψα	pɾofitepsa
αρχαιολογία	arçeoloʝia
παρουσιάζω	paɾusiazo
βόλοσ	volos
αγκίστρι	aŋɟistri
ταξιτζήσ	taksindzis
καθορίζουμε	kaθoɾizume
οικοδομικόσ	ikoðomikos
αναλώ	analo
ξενιτειέσ	ksenitçes
αντιγράφω	andiɣrafo
σοφιῶν	sofion
αλυσοδεμένουσ	alisoðemenus
διαβεβαιώθηκα	ðʝaveveoθika
κιμώλου	cimolu
αντεπιτέθηκα	andepiteθika
διαπληκτίσθηκα	ðiapliktisθika
πολωνικέσ	polonices
γκάριξα	ɡariksa
αναχωρώ	anaxoɾo
θαύμα	θavma
αναμειγνύω	anamiɣnio
σπασμένα	spazmena
ανεπαρκώσ	anepaɾkos
απόπλοι	apopli
νικήθηκα	nikiθika
λερώνουμε	leɾonume
επαινούμε	epenoume
έβρεξα	evreksa
τάρανδοσ	taɾanðos
προσέκοψα	pɾosekopsa
γεγονόσ	ʝeɣonos
φωτογραφίζω	fotoɣrafizo
επαινέθηκα	epeneθika
κυνηγῶ	ciniɣo
ακοόμετρα	akoometra
αγγίχτηκα	aŋɟixtika
θεοτόκον	θeotokon
συγγραφήσ	siŋɣrafis
διακόπτουμε	ðʝakoptume
ψήφοσ	psifos
ανταλλάζω	andalazo
ευρίσκω	evɾisko
καλμάρισα	kalmaɾisa
ενέκυψα	enecipsa
μαδρίτη	maðɾiti
περιπολώ	peɾipolo
δυσθυμία	ðisθimia
παρακειμένων	paracimenon
καθιδρύθηκα	kaθiðriθika
ντετερμινισμοί	determinizmi
υπολογιστικέ	ipoloʝistice
κετσέδων	ketseðon
επιγράφηκα	epiɣrafika
υπολογίζομε	ipoloʝizome
μισημένοσ	misimenos
προετοιμασία	pɾoetimasia
τόνοσ	tonos
πεινασμένη	pinazmeni
αίτνα	etna
συγχάρηκε	siŋxaɾice
μεσαιωνικέσ	meseonices
πριγκίπισσα	pɾiŋɟipisa
λιάστηκα	ʎastika
λόξιγκασ	loksiŋɡas
αποζημιώνω	apozimiono
ενσκήπτω	enscipto
ντόρα	doɾa
αθροίστηκα	aθɾistika
διάλειμμα	ðʝalima
ήσουνα	isuna
πίνει	pini
φρεσκαρίστηκα	freskaristika
ερίτιμοσ	eɾitimos
καλμάρισε	kalmaɾise
φυτικό	fitiko
πρωτοκολλούμαι	pɾotokolume
συνηθισμένεσ	siniθizmenes
τίνεσ	tines
αναστενάζω	anastenazo
οκτώ	okto
ψημένε	psimene
τάμα	tama
ορθόδοξοι	oɾθoðoksi
φιστικιά	fisticʝa
βαστιέμαι	vastçeme
παρηγόρησα	paɾiɣoɾisa
αγγιγμένε	aŋɟiɣmene
βραχυκυκλώνομαι	vɾaçiciclonome
μοναρχών	monarxon
όνομα	onoma
κάμφθηκα	kamfθika
πουστοφέρνω	pustofeɾno
μάρκαρα	maɾkaɾa
ηγουμενίτσα	iɣumenitsa
σημειώνομε	simionome
κινούμαι	cinume
κουρασμένοι	kurazmeni
ήσουν	isun
υπογράφομαι	ipoɣrafome
ειλημμένη	ilimeni
χαράζω	xarazo
ασανσέρ	asanseɾ
χύτρα	çitɾa
ανησύχησα	anisiçisa
νοικιάζομαι	nicazome
χι	çi
πωλήθηκα	poliθika
κινώ	cino
προτρέπομαι	pɾotɾepome
φυλλομέτρησα	filometɾisa
κάλυψη	kalipsi
σφιχταγκαλιάζομαι	sfixtaŋɡaʎazome
σκορδόψωμου	skoɾðopsomu
αντέχω	andexo
διατυπώνομαι	ðʝatiponome
σιγά	siɣa
αγυιόπαιδων	aʝiopeðon
ακομπανιάρω	akompaɲaɾo
ψηφίο	psifio
αληθέσ	aliθes
σύνορον	sinoron
αγκαζάρομαι	aŋɡazaɾome
λούζομαι	luzome
κρυμμένοσ	krimenos
βαθμολογημένα	vaθmoloʝimena
μαζικότατο	mazikotato
υπογραφτείσ	ipoɣraftis
κατάλογε	kataloʝe
συντομεύομαι	sindomevome
αντίδραση	andiðɾasi
συνοδούσ	sinoðus
υπόψη	ipopsi
απρίληδων	apɾiliðon
περιεπλάκησαν	peɾieplacisan
ατάλαντοσ	atalandos
ακροχορδών	akɾoxoɾðon
απευχήθηκα	apefçiθika
ξεκουράζω	ksekuɾazo
παλιάτσοσ	paʎatsos
γελάμε	ʝelame
βυζάρα	vizaɾa
παντρεύομαι	pandɾevome
κεσεμιών	cesemɲon
παρελθόντων	parelθondon
φυλάχτηκα	filaxtika
ακλουθώ	akluθo
συνετρίβην	sinetɾivin
καταλυθήκαν	kataliθikan
μαζεύω	mazevo
επιστημολογία	epistimoloʝia
αποδείχτηκε	apoðixtice
εξυπακούεται	eksipakuete
ξέγραψα	kseɣrapsa
ενέγραψα	eneɣrapsa
αναλογούσα	analoɣusa
αραχνιά	aɾaxɲa
πεινασμένου	pinazmenu
χαρτί	xaɾti
φυλλομετρήθηκα	filometɾiθika
νοίκιασα	nicasa
προκαταβλήθηκα	pɾokatavliθika
βάσιμοσ	vasimos
ιλαρά	ilaɾa
αγκωνιάζομαι	aŋɡoɲazome
ποσότητα	posotita
απολογητική	apoloʝitici
διώχνω	ðʝoxno
αποκαταστάθηκα	apokatastaθika
τσεκάρισε	tsekaɾise
πατέρασ	pateras
ανθρωπεύτηκα	anθɾopeftika
βάζοντασ	vazondas
συναιρέσεισ	sineresis
βραβεύω	vravevo
είχανε	ixane
αμφιβολία	amfivolia
τσογλάνι	tsoɣlani
συνόρου	sinoru
φθινοπωρινόσ	fθinopoɾinos
ηγέρθησαν	iʝeɾθisan
αεροφωτογραφώ	aerofotoɣrafo
ματοκυλίζω	matocilizo
έρχομαι	eɾxome
πουδράρισε	puðɾaɾise
άντ'	ad
διαγωνίζομαι	ðʝaɣonizome
κρεμασμένων	kremazmenon
αγγισμένα	aŋɟizmena
αρχηγόσ	aɾçiɣos
συριζαίοσ	siɾizeos
λιγότερεσ	liɣoteres
αναλώνω	analono
τσιτσί	tsitsi
άγιασ	aʝias
κουραστικέ	kurastice
ακομπανιάρισα	akompaɲaɾisa
παγκοσμιοποιήσεων	paŋɡozmiopiiseon
ακούστηκε	akustike
βαρελότο	vaɾeloto
στειμμένοι	stimeni
θοδωρήσ	θoðoɾis
όμορφα	omoɾfa
απαθήσ	apaθis
προσκαλούμε	pɾoskalume
ψημένο	psimeno
εκφύομαι	ekfiome
δεικνύω	ðiknio
ταπεινώνω	tapinono
ακούσθηκα	akusθika
πωσ	pos
βερικοκιά	veɾikocʝa
ανέφερα	anefeɾa
κορνάρισμα	koɾnaɾizma
χειμερινόσ	çimerinos
φιλόδοξοσ	filoðoksos
αφτί	afti
πεισμένοσ	pizmenos
κοντρολάρισα	kontrolaɾisa
κυβερνώ	civeɾno
επανέκαμψα	epanekampsa
αγγελοκρούομαι	aŋɟelokruome
παρασκευάστηκα	paɾascevastika
ανθισμένοσ	anθizmenos
γεωγραφικό	ʝeoɣɾafiko
έζησαν	ezisan
κωνσταντινούπολησ	konstandinupolis
κυημάτων	ciimaton
δολιοφθορά	ðoʎofoɾa
αγοράζομαι	aɣoɾazome
παραβλέπω	paɾavlepo
άσεβεσ	aseves
σκατό	skato
φίλα	fila
διεγέρθηκα	ðieʝeɾθika
αιματοκυλίζομαι	ematocilizome
κόκκινεσ	kocines
κεκλεισμένα	ceklizmena
μειοψηφιών	miopsifion
μυρωμένα	miromena
όπλο	oplo
κοινόν	cinon
καθομιλουμένη	kaθomilumeni
λυμένησ	limenis
κοιτάζομαι	citazome
χρόνοσ	xɾonos
αλατισμένεσ	alatizmenes
αρούμπα	aɾuba
βρήκαν	vɾikan
ξύνουμε	ksinume
βαλσ	vals
αλείφουμε	alifume
συγκινημένου	siŋɟinimenu
ετοιμάζω	etimazo
απελπισμένο	apelpizmeno
αγιάζομαι	aʝazome
χαλασμένα	xalazmena
τούρκικοσ	tuɾcikos
στριμμένουσ	stɾimenus
ανασκαλεύτηκα	anaskaleftika
καμπέρα	kabera
αξιολόγησησ	aksioloʝisis
διαμοιραστήσ	ðiamirastis
πατέρων	pateron
πήδηξα	piðiksa
μαυρίζω	mavrizo
κύπρε	cipɾe
γελασμένοσ	ʝelazmenos
αποπλέω	apopleo
εφοδιάζω	efoðiazo
λευκόσ	lefkos
μαζικότερεσ	mazikoteres
χαλασμένη	xalazmeni
πουδραρίστηκα	puðɾaɾistika
μάντησ	mandis
εκπαραθύρωση	ekpaɾaθiɾosi
οίκοσ	ikos
εκχωρώ	ekxoɾo
απαιτώ	apeto
φαντάζομαι	fandazome
αξιοσημείωτουσ	aksiosimiotus
επαινώ	epeno
εκπέμπομαι	ekpembome
απλούσ	aplus
ακροάτρια	akɾoatɾia
τηλεφωνιέμαι	tilefoɲeme
πρωτοκολλώμαι	pɾotokolome
γλαστρούλα	ɣlastɾula
ανακοινώνω	anacinono
χάφτω	xafto
συνάφθηκαν	sinafθikan
θερμοδυναμικού	θermoðinamiku
μαζικού	maziku
κρίνο	krino
υποδέχθηκα	ipoðexθika
κρούομε	kruome
γενιάσ	ʝeɲas
χτικιό	xtico
κριτσίνι	kritsini
κωνσταντίνου	konstandinu
αεροδρόμιο	aeɾoðɾomio
διαδεχτεί	ðʝaðexti
εμποδίζω	emboðizo
αποδοκιμάσθηκα	apoðocimasθika
πεπεισμένου	pepizmenu
κλεισμένεσ	klizmenes
άρχω	arxo
ντροπιάζω	dɾopçazo
αβγατισμένα	avɣatizmena
έννοια	enia
τετριμμένησ	tetrimenis
αναπαύτηκα	anapaftika
ἐκτελῶ	ektelo
μισήθηκα	misiθika
πικάπ	pikap
λακωνίασ	lakonias
μαρτύρησα	maɾtiɾisa
αγλαόσ	aɣlaos
γκαστρωμένε	ɡastromene
τον	ton
γοητεύω	ɣoitevo
ανακαλύψεισ	anakalipsis
τσίσια	tsisça
κακογαμημένε	kakoɣamimene
ακοινωνησίων	acinonision
ανετράπη	anetɾapi
ξαναγράφομαι	ksanaɣɾafome
θυμώνω	θimono
στριμμένων	stɾimenon
όμορφη	omoɾfi
καραπουτάνα	karaputana
πέδιλο	peðilo
κάτοχοσ	katoxos
τοποθέτησα	topoθetisa
συκοφάντησ	sikofandis
προβλήματα	provlimata
λογοκρίνω	loɣokɾino
αναπόσβεστοσ	anapozvestos
καταβάλλεται	katavalete
καθοίκι	kaθici
ζεσταμένε	zestamene
δραπέτησ	ðɾapetis
αμάθειεσ	amaθies
πασ	pas
ικανοποιημένοσ	ikanopiimenos
έλυνα	elina
επαναφέρομαι	epanafeɾome
αβγοκομμένα	avɣokomena
απασχολημένουσ	apasxolimenus
γενάρηδων	ʝenaɾiðon
παραβάλλω	paɾavalo
κάμπτω	kamto
ακοντίστηκα	akondistika
βοηθάω	voi̯θao
πίθων	piθon
ελληνάρασ	elinaɾas
μαυρισμένη	mavrizmeni
μιχάλησ	mixalis
αργοσάλεψε	aɾɣosalepse
φαρμάκι	faɾmaci
αποκαλύπτομαι	apokaliptome
εγκολπώνομαι	eŋɡolponome
αλαμπουρνέζικη	alaburnezici
επανενάρξεισ	epanenaɾksis
γαργαλίζω	ɣaɾɣalizo
ανάπνευσα	anapnefsa
προτρέπω	pɾotɾepo
τόσοσ	tosos
άκεφοσ	acefos
συνέδεσα	sineðesa
υποσπαδίασ	ipospaðias
κλεισμένε	klizmene
σπιταρόνα	spitaɾona
χαράζομαι	xaɾazome
βάλουν	valun
δεκατέσσερισ	ðekateseɾis
ταιριάζω	terʝazo
νίκησα	nicisa
ώπα	opa
έτεινα	etina
δεκεμβρίων	ðeceɱvɾion
αποκερματισμέ	apoceɾmatizme
ποιήσεωσ	piiseos
χαίρω	çero
γαμημένο	ɣamimeno
χριστουγεννιάτικοσ	xristuʝeɲatikos
διαδηλώνομαι	ðiaðilonome
διαδοχικόσ	ðʝaðoçikos
αποβάθρα	apovaθɾa
διαμοιράζω	ðiamiɾazo
ξεβράκωτοσ	ksevɾakotos
χρονολογήσεων	xronoloʝiseon
αυτώνω	aftono
πυροτέχνημα	piɾotexnima
πασοκ	pasok
αγιάζω	aʝazo
γουστάρισε	ɣustaɾise
απολογητικών	apoloʝitikon
τεχνολογία	texnoloʝia
ναυσικά	nafsika
καίω	ceo
εγκαταλείπω	eŋɡatalipo
μια	mɲa
κρυμμένα	krimena
ανελκύουμε	anelciume
έλληνα	elina
κιονόκρανο	cionokrano
σύνταξη	sindaksi
πεισμένων	pizmenon
ξαλεγράρω	ksaleɣɾaɾo
υποδέχτηκα	ipoðextika
σώπασα	sopasa
κανταδόροσ	kandaðoɾos
ακυρώθηκα	aciɾoθika
καταγράφουμε	kataɣrafume
τσακωνικέ	tsakonice
αδρόσ	aðros
ευθυμιών	efθimion
μνήμα	mnima
διαχύνω	ðiaçino
προφητεύομαι	pɾofitevome
ανακαλώ	anakalo
προέρχομαι	proerxome
ποδαρίλα	poðaɾila
διαδέχομαι	ðiaðexome
αποκλείω	apoklio
ανεπάρκεια	anepaɾcia
θεούλησ	θeulis
ψήφων	psifon
κεραυνόσ	ceravnos
αγορά	aɣora
απ	ap
ανατέλλω	anatelo
καθισμένα	kaθizmena
κουρασμένων	kurazmenon
καλικάντζαροσ	kalikandzaɾos
πεπεισμένοσ	pepizmenos
πλειονοψηφιών	plionopsifion
αγγονιού	aŋɡoɲu
βρισιά	vɾisça
πορδίτσα	poɾðitsa
χαστουκιά	xastuca
λέει	lei
προσφέρθηκα	pɾosfeɾθika
σεβαστουπόλεωσ	sevastupoleos
απελπισμένουσ	apelpizmenus
τριμμένη	trimeni
κρέμαγε	kɾemaʝe
απαρχαιωμένο	aparçeomeno
απαρχαιωμένοσ	aparçeomenos
σκουντημένοσ	skundimenos
καλαμπόκι	kalamboci
ασχολούμαι	asxolume
λύω	lio
λύσομε	lisome
καλύπτω	kalipto
απαλείφω	apalifo
ψήφουσ	psifus
αγορασμένοσ	aɣoɾazmenos
παρουσιάζομαι	paɾusiazome
αραχνιασμένεσ	aɾaxɲazmenes
σφουγγοκωλάριοσ	sfuŋɡokolaɾios
χαλιέμαι	xaʎeme
ευρωπαίοσ	evropeos
νοέμβρη	noeɱvɾi
λαλάμε	lalame
κολοράντο	koloɾado
ταράζομαι	tarazome
βασίλευε	vasileve
ακολουθήθηκα	akoluθiθika
αποζημιώθηκα	apozimioθika
πλειοψηφία	pliopsifia
μελίγκρα	meliɡɾa
σφραγίζω	sfɾaʝizo
γέφυρα	ʝefira
αύγουστοσ	avɣustos
επανακάμψεισ	epanakampsis
αγριοκοιτάζω	aɣɾiocitazo
τουβλάκι	tuvlaci
πίθουσ	piθus
καλοφάγωτοι	kalofaɣoti
στενοχωρημένοσ	stenoxorimenos
τσακωνικούσ	tsakonikus
σκουντήχτηκα	skundixtika
διηρημένοσ	ðiiɾimenos
φραγκοστάφυλο	fɾaŋɡostafilo
βιόσφαιρασ	viosfeɾas
γκομενάκοσ	ɡomenakos
κουντεπιέ	kudepçe
καταβλήθηκα	katavliθika
σύνδεσα	sinðesa
φακλάνα	faklana
αγαναχτώ	aɣanaxto
εργαλειοθήκη	erɣalioθici
ζωντόβολο	zondovolo
καταστρέφομε	katastɾefome
άε	ae
αίσχοσ	esxos
συγχαρητήρια	siŋxaɾitiɾia
χεσμένων	çezmenon
αποστηθίζω	apostiθizo
προφθάνω	pɾofθano
κιάλια	caʎa
πέρδομαι	peɾðome
καταξόδιασα	kataksoðʝasa
εγκαταλείπομε	eŋɡatalipome
αγκαλιασμένοσ	aŋɡaʎazmenos
ενοχλώ	enoxlo
πρωτεύων	pɾotevon
ειδοποιώ	iðopio
καπνίζω	kapnizo
αλγέρι	alʝeri
προστατεύω	pɾostatevo
παγιδεύτηκα	paʝiðeftika
υποτελείσ	ipotelis
είσαστε	isaste
κατάφερα	katafeɾa
ποικιλότατη	picilotati
βρωμοθήλυκο	vɾomoθiliko
μεγαλομάρτυρα	meɣalomaɾtiɾa
πενήντα	peninda
προσελκύσθηκα	proselcisθika
στραβώθηκα	stɾavoθika
τραγουδήθηκα	tɾaɣuðiθika
απογοητεύθηκα	apoɣoitefθika
πρωτάθλημα	pɾotaθlima
αξιολογήσεωσ	aksioloʝiseos
χάιδεψα	xai̯ðepsa
κεκλεισμένοσ	ceklizmenos
κακοποιούμε	kakopiume
αγγισμένοσ	aŋɟizmenos
δυσκοίλιοσ	ðiscilios
έθαλψα	eθalpsa
λητώ	lito
προσγειώνομαι	pɾozʝionome
επανειλημμένεσ	epanilimenes
επαρκώσ	epaɾkos
ποικίλεσ	piciles
κρυμμένων	krimenon
συγκόπτομαι	siŋɡoptome
στισ	stis
ντετερμινισμών	determinizmon
νοέμβριο	noeɱvɾio
φάρμακο	farmako
κατάμαυρη	katamavɾi
στενοχωρημένε	stenoxorimene
ιουδαϊσμόσ	iuðaizmos
άκουα	akua
δημητρούλα	ðimitɾula
κυρογενιά	ciroʝeɲa
μεγαλομανίασ	meɣalomanias
ονομάζομε	onomazome
σπίθιζε	spiθize
κωλύομαι	koliome
θρηνώ	θɾino
στενοχωρούμαι	stenoxorume
τρωάδα	troaða
ζηλεύομαι	zilevome
κληρονομώ	kliɾonomo
ταριχεύτηκα	taɾixeftika
μαλωμένοσ	malomenos
ποντικόσ	pondikos
τσέκαρα	tsekaɾa
επιστρέφομαι	epistɾefome
σκοτωμόσ	skotomos
συνοδό	sinoðo
αποκάλυψα	apokalipsa
υποχρεώνομαι	ipoxɾeonome
υποκρύπτουμε	ipokɾiptume
αγάνταρα	aɣandara
υπογράφτηκα	ipoɣraftika
απέτρεψα	apetɾepsa
γάμα	ɣama
αγαπημένων	aɣapimenon
προτρέπουμε	pɾotɾepume
γλώσσα	ɣlosa
σοφοκλήσ	sofoklis
λεξιπλασιών	leksiplasion
ροδάκινα	roðacina
ανεπαρκήσ	anepaɾcis
διαισθάνθηκα	ðiesθanθika
ανάμενεσ	anamenes
έχω	exo
πισωγλέντησ	pisoɣlendis
αγγισμένουσ	aŋɟizmenus
φιλούσα	filusa
υλοζωισμόσ	ilozoizmos
σημειωθήκαν	simioθikan
κακάσχημοσ	kakasçimos
ενδιαφερούσησ	enðiaferusis
φωτογράφισα	fotoɣrafisa
πεπεισμένε	pepizmene
μπουνατσάρει	bunatsaɾi
αθεϊσμών	aθeizmon
βασκαίνομαι	vascenome
παρεκτράπηκαν	paɾektɾapikan
κανάκευα	kanaceva
τσουραπιών	tsuɾapçon
τσακωνικό	tsakoniko
ροχαλίζω	ɾoxalizo
συναιρέσεωσ	sinereseos
απαγορεύτηκα	apaɣoɾeftika
αλιεύομαι	alievome
παρκάριζα	paɾkaɾiza
γαλακτοκομείο	ɣalaktokomio
αλαλιάζω	alaʎazo
σαράντα	saɾanda
νικιέμαι	niceme
σπιτήσιοσ	spitisios
στρέφω	stɾefo
γρεβενά	ɣɾevena
δαμασκηνιά	ðamasciɲa
ειλημμένοι	ilimeni
ταχυδρομείο	taçiðɾomio
αγία	aʝia
παραξενιά	paɾakseɲa
αβγατισμένο	avɣatizmeno
ιούνιοσ	iunios
λαλιέμαι	laʎeme
γράφω	ɣrafo
σημειώθηκε	simioθice
ανακύψεισ	anacipsis
κλάσιμο	klasimo
ακαδημία	akaðimia
αλυσοδεμένοι	alisoðemeni
γκεσέμια	ɟesemɲa
πεπεισμένο	pepizmeno
αναγγέλλω	anaŋɟelo
κοτσαδόροσ	kotsaðoɾos
ματοκυλίζομαι	matocilizome
προμνησίασ	pɾomnisias
καταξόδεψα	kataksoðepsa
φίλιπποσ	filipos
μαγειρεύομαι	maʝiɾevo
φράζομαι	frazome
χρησιμοποιήσεισ	xɾisimopiisis
αναγεννώ	anaʝeno
αναπαριστάνω	anaparistano
λεξιπλασίεσ	leksiplasies
φλιτζανάκι	flidzanaci
τσάμπα	tsamba
προκαταβάλω	pɾokatavalo
βάλετε	valete
κωλοτρυπίδα	kolotripiða
ψηφίστηκα	psifistika
γλείφτηκα	ɣliftika
λαλήθηκα	laliθika
χείλι	çili
θεραπεία	θeɾapia
σπιτικόσ	spitikos
συγκινητικά	siŋɟinitika
δοντιών	ðondʝon
υποκλέπτομαι	ipokleptome
τάχατεσ	taxates
πακετάρομαι	pacetaɾome
διψασμένων	ðipsazmenon
δημαρχείο	ðimaɾçio
μαρτυράω	maɾtiɾo
αγαθοπιστιών	aɣaθopistion
φωτογραφείων	fotoɣrafion
προέκυψε	proecipse
πεισμένεσ	pizmenes
φοροέκλεψα	foɾoeklepsa
λοχίασ	loçias
καυλιάρα	kavʝaɾa
κυκλοφορώ	ciklofoɾo
βήτα	vita
ασπρίζω	aspɾizo
ρουθούνι	ɾuθuni
αντικλεπτικούσ	andikleptikus
βρήκα	vɾika
λέγετε	leʝete
μειονοψηφία	mionopsifia
επισυνάφθηκα	episinafθika
αδημονούσα	aðimonusa
στερούμε	steɾume
ροπή	ɾopi
μυτάρα	mitaɾa
άντεστε	adeste
αναφέρω	anafeɾo
ενδιαφέρομαι	enði̯afeɾome
πεπεισμένουσ	pepizmenus
ξέλυσα	kselisa
δολοφονούμαι	ðolofonume
γενάρησ	ʝenaɾis
σαντούρι	sanduri
πονταρίστηκα	pondaɾistika
αηδιασμένο	aiðiazmeno
αμνηστεύθηκα	amnistefθika
γενεά	ʝenea
αραχνιασμένων	aɾaxɲazmenon
κατουρήθηκα	katuɾiθika
λυμένων	limenon
νοέμβριοσ	noeɱvɾios
νίκαγα	nikaɣa
προσγράφτηκα	pɾozɣraftika
μπαρκάρισα	baɾkaɾisa
βρομοθήλυκο	vɾomoθiliko
γεωγραφικόσ	ʝeoɣɾafikos
ζητάμε	zitame
τριμμένεσ	trimenes
τσιμπουκότρυπα	tsimbukotɾipa
καταγράφηκα	kataɣrafika
δεκέμβρη	ðeceɱvɾi
αυλόσ	avlos
εκπαιδεύθηκα	ekpeðefθika
πρωτευουσιάνοσ	pɾotevusianos
παρφουμαρίζομαι	paɾfumaɾizome
υπεγράφην	ipeɣrafin
οικογένεια	ikoʝenia
σκατόγεροσ	skatoʝeɾos
βασιλέασ	vasileas
δισ	ðis
συμφυρμοί	siɱfirmi
αποθήκεψα	apoθicepsa
έψιλον	epsilon
φραγκφούρτη	fraŋkfurti
έριδα	eriða
μαζικότατου	mazikotatu
λύνω	lino
ενοχλητικότητα	enoxlitikotita
οργασμόσ	oɾɣazmos
εκκρούω	ekruo
πρόφθασα	pɾofθasa
δικαιολογία	ðiceoloʝia
απρίλιο	apɾilio
ρεζιλεύω	ɾezilevo
γαμήσι	ɣamisi
ποικιλότεροι	piciloteri
φαβορίτα	favorita
αξιολόγησα	aksioloʝisa
οφιοειδούσ	ofioiðus
αποκερματισμόσ	apoceɾmatizmos
λύνεται	linete
βυθισμένησ	viθizmenis
αλατίζω	alatizo
αγαθοπιστία	aɣaθopistia
γνώση	ɣnosi
στιγματίζω	stiɣmatizo
μαζικοί	mazici
αγάπαγα	aɣapaɣa
ιδίωσ	iðios
διασκέπτομαι	ði̯asceptome
ανατείνομε	anatinome
υπολογιστικού	ipoloʝistiku
επιτρέπουμε	epitɾepume
σακάτησ	sakatis
φωτογραφούμαι	fotoɣrafume
σκασμένουσ	skazmenus
μουσκεμένων	muscemenon
πιλοτάρω	pilotaɾo
ενημερώσεισ	enimerosis
πεολειξία	peoliksia
υγείεσ	iʝies
αποσπασμένοσ	apospazmenos
πασπατεύομαι	paspatevome
σορούσ	soɾus
βιάζω	viazo
αναγεννάω	anaʝenao
κακοκεφιάσ	kakocefças
ψημένου	psimenu
αγοράσ	aɣoras
εξαλείφομαι	eksalifome
συγκρουόμενο	siŋɡruomeno
επιτρέπετε	epitɾepete
νικητέσ	nicites
έντεκα	endeka
μαλωμένη	malomeni
εκκενώνουμε	ecenonume
αμέτε	amete
αβάραρα	avaɾaɾa
σεβαστούπολησ	sevastupolis
επισείουμε	episiume
πέταμα	petaɣma
τραγουδάω	tɾaɣuðao
θεία	θia
χαλασμένησ	xalazmenis
πολέμησα	polemisa
ονομάστηκα	onomastika
αγωνιστέσ	aɣonistes
αμεριμνησιών	ameɾimnision
εκπομπή	ekpombi
γλύκισμα	ɣlicizma
ομοφυλοφίλου	omofilofilu
αναγνωρισμένοι	anaɣnorizmeni
επιτράπηκε	epitɾapice
συνδυάζω	sinðiazo
καθιζάνω	kaθizano
μεταφραστέσ	metafɾastes
βάλλε	vale
διάλειμμα	ðialima
χοντροκώλα	xondɾokola
αναστροφή	anastɾofi
κρίνουμε	kɾinume
κάτασπροσ	kataspɾos
συνεχίστηκα	sineçistika
ιστολόγιο	istoloʝio
υποβοηθούμενε	ipovoiθumene
τετριμμένων	tetrimenon
ευγενικότεροσ	evʝenikoteros
βάλανοσ	valanos
βουτώ	vuto
στριμμένοσ	stɾimenos
αυγούστων	avɣuston
μάζεψε	mazepse
διανύθηκα	ðianiθika
μαρκάρισε	maɾkaɾise
γένναγα	ʝenaɣa
συνήψα	sinipsa
κρέασ	kreas
πρωτόγονοσ	pɾotoɣonos
ελαφραίνω	elafɾeno
ζητούμαι	zitume
αποταμιεύω	apotamievo
εξοχοτάτη	eksoxotati
επανενάρξεωσ	epanenaɾkseos
χάη	xai
τρέπομαι	trepome
βοσκήθηκα	vosciθika
καθίκι	kaθici
παρεστιγμένοσ	paɾestiɣmenos
οδηγούμε	oðiɣume
αγωνιζόμενοσ	aɣonizomenos
τραύμα	tɾavma
έχει	eçi
αγγισμένε	aŋɟizmene
θερμοδυναμικούσ	θermoðinamikus
αντιβουίζω	andivuizo
επιβάλλομαι	epivalo
διατηρούμαι	ði̯atiɾume
κατηγορώ	katiɣoɾo
σμύρνη	zmiɾni
μαζικότερου	mazikoteru
φέγγει	feŋɟi
μισό	miso
νοέμβρηδων	noeɱvɾiðon
κέρδοσ	cerðos
αβγοκομμένο	avɣokomeno
ανακόπηκα	anakopika
συνηθισμένο	siniθizmeno
συμβουλεύτηκα	siɱvuleftika
αποσιωπώμαι	aposiopome
ανορθώθηκα	anoɾθoθika
μαζικότερησ	mazikoteris
αλφαδιάζω	alfaðʝazo
αντικείμενο	andicimeno
διακόσια	ðʝakosça
συγκινώ	siŋɟino
φέρνω	feɾno
μακαρόνια	makaɾoɲa
σώγαμπροσ	soɣambɾos
συλλέγομαι	sileɣome
ικανοποιημένεσ	ikanopiimenes
εξοπλισμένη	eksoplizmeni
πρεσάρομαι	pɾesaɾome
αναπτερώνομαι	anapteɾonome
ενδιαφέρθηκα	enði̯afeɾθika
ακυρώνω	aciɾono
μετατρέπω	metatɾepo
αγκαζαρισμένοσ	aŋɡazaɾizmenos
συνέπλευσα	sineplefsa
μάηδων	maiðon
αναγκάζουμε	anaŋɡazume
αρχικόσ	arçikos
πλάτη	plati
προσαρτώ	pɾosaɾto
κρέμαγα	kɾemaɣa
αναγνωρισμένων	anaɣnorizmenon
γεννήθηκα	ʝeniθika
αγαναχτισμένοσ	aɣanaxtizmenos
κατηγορούμε	katiɣoɾume
πορδίζω	poɾðizo
χριστούγεννα	xɾistuʝena
πρήξιμο	pɾiksimo
αναμμένα	anamena
οχτώ	oxto
αγόρασα	aɣoɾasa
αναβιβάζομαι	anavivazome
δυναμιτίζω	ðinamitizo
ἀδικῶ	aðiko
δεσπόζω	ðespozo
αναιτιολόγητοσ	anetioloʝitos
χάραξα	xaɾaksa
γιαννούλα	ʝanula
μειοψηφίεσ	miopsifies
ρέω	reo
αβγάτισα	avɣatisa
εξυπακούομαι	eksipakuome
εκπαιδεύτηκα	ekpeðeftika
δημοψήφισμα	ðimopsifizma
στειμμένη	stimeni
προηγουμένου	proiɣumenu
αστυνομοκρατία	astinomokɾatia
γιορτάζομαι	ʝoɾtazome
ερρινοποιήσεωσ	erinopiiseos
έσπαγα	espaɣa
ερχομένησ	erxomenis
γαργαλίζομαι	ɣaɾɣalizome
αναγγέλλομαι	anaŋɟelome
επικαλύπτουμε	epikaliptume
φιλοσοφικά	filosofika
επισείομε	episiome
προσκαλώ	pɾoskalo
αλκαλιμέταλλο	alkalimetalo
ελλάδα	elaða
μωάμεθ	moameθ
μανώλησ	manolis
φραγκοσταφυλιά	fɾaŋɡostafiʎa
γελούσα	ʝelusa
εγέρθητε	eʝeɾθite
αβλαβέστεροσ	avlavesteros
αναλύω	analio
ενόχλημα	enoxlima
αρμαντίλλο	armadilo
μειώσεισ	miosis
παρηγορήθηκα	paɾiɣoɾiθika
έσφυζα	esfiza
γιάννα	ʝana
απαρχαιωμένησ	aparçeomenis
γαμημένησ	ɣamimenis
μαρτίουσ	maɾtius
φωτογραφίζομαι	fotoɣrafizome
αγγιγμένουσ	aŋɟiɣmenus
ζητήθηκα	zitiθika
απαιτήθηκα	apetiθika
ψαρεύτηκα	psaɾeftika
φιλιά	fiʎa
ψηφίζουμε	psifizume
μαλακισμένεσ	malacizmenes
αγουστιέσ	aɣustçes
διαμορφώνομαι	ðʝamoɾfonome
εικοστόσ	ikostos
τσίτσα	tsitsa
πύραυλοσ	piɾavlos
ζητιάνευε	zitçaneve
μπορώ	boɾo
κολοβόσ	kolovos
καταναγκάζομαι	katanaŋɡazome
παρκαδόροσ	paɾkaðoɾos
γυρνιέμαι	ʝiɾɲeme
αναρτώ	anaɾto
βόσκομαι	voskome
πολωνέζικοσ	polonezikos
σκάνταλο	skandalo
αυγοκομμένοσ	avɣokomenos
ξεσκάτωμα	kseskatoma
ισχνόσ	isxnos
άδεντροσ	aðendɾos
απεχθάνομαι	apexθanome
ανακλασμένοσ	anaklazmenos
επανειλημμένων	epanilimenon
αβγατίζω	avɣatizo
τσακώνικοσ	tsakonikos
ηλιοτρόπιο	iʎotɾopio
παγκοσμιοποίηση	paŋɡozmiopiisi
πρέζα	pɾeza
συγκινημένοσ	siŋɟinimenos
κομμένε	komene
νικάω	nikao
ψηφίζω	psifizo
γέννεσ	ʝenes
ορθόδοξα	oɾθoðoksa
στενοχωρημένων	stenoxorimenon
αντρειώνομαι	andɾionome
στιγματισμένοσ	stiɣmatizmenos
τάφρων	tafron
προστάτευσα	pɾostatefsa
διδάσκω	ðiðasko
ανέπαφοσ	anepafos
αποκρούστηκα	apokrustika
κομμένη	komeni
αιτιοκρατία	etiokratia
μολογήθηκα	moloʝiθika
ξέρανε	kseɾane
λύνομαι	linome
πλίνθου	plinθu
αναβαθμίδα	anavaθmiða
κεφαλάρι	cefalari
απορροφούμενεσ	apoɾofumenes
ορθώνομε	oɾθonome
αληθεύτηκα	aliθeftika
τσακωνικά	tsakonika
ελιόψωμα	eʎopsoma
πολλάκισ	polacis
πολιορκία	poliorcia
αποδείξεισ	apoðiksis
κορίτσι	koɾitsi
αξιοσημείωτησ	aksiosimiotis
ντελιβεράσ	deliveras
φεβρουάριο	fevɾuaɾio
επαρχίεσ	epaɾçies
αλφαβήτου	alfavitu
ποικιλότερα	picilotera
ασεβειών	asevion
ψημένοι	psimeni
γύροσ	ʝiros
λιγότερων	liɣoteron
καπνοδόχοσ	kapnoðoxos
παραλογίστηκα	paɾaloʝistika
καινοτομίεσ	cenotomies
ποδοσφαίρων	poðosferon
χορεύομε	xoɾevome
αλευρωμένων	alevromenon
απασχολήσεισ	apasxolisis
σκληρόσ	skliɾos
εγγίζω	eŋɟizo
ὑπογραφείσ	ipoɣrafis
σωματικώσ	somatikos
κόκκινοι	kocini
ανεπαίσθητα	anepesθita
αλλαξιέρα	alaksçeɾa
βγάζω	vɣazo
πλειστόκαινο	plistoceno
αναμμένουσ	anamenus
παγωμένησ	paɣomenis
γενιών	ʝeɲon
πιλοτάριζα	pilotaɾiza
χελώνα	çelona
υποδήματα	ipoðimata
μερίδα	meɾiða
ορθόδοξοσ	oɾθoðoksos
εμπνευσμένουσ	embnevzmenus
στοιβάζω	stivazo
έλληνεσ	elines
κύπριοσ	ciprios
έκπληξη	ekpliksi
συνεγράφην	sineɣrafin
χαράλαμποσ	xaɾalambos
παϊδάκι	paiðaci
σοβαρολογώ	sovaɾoloɣo
χαράμι	xaɾami
τραβάω	tɾavao
στυμμένησ	stimenis
αναστέλλω	anastelo
συμφυρμό	siɱfirmo
προσάρμοσα	pɾosaɾmosa
έκλειψη	eklipsi
αναπληρώνομαι	anapliɾonome
δυνάμεωσ	ðinameos
στων	ston
στεναχωρημένε	stenaxorimene
θάλπω	θalpo
αγνώμονασ	aɣnomonas
σοφέ	sofe
κακογαμημένου	kakoɣamimenu
σταμάτησ	stamatis
καταφέρομαι	katafeɾome
αλαφιασμένου	alafçazmenu
βεβαιώσετε	veveosete
μαρκαδόροσ	maɾkaðoɾos
παρεξετράπη	paɾeksetɾapi
άγιεσ	aʝes
πουστιά	pustça
αλέθομαι	aleθome
κέρκυρα	cercira
τετριμμέναι	tetrimene
παράκαμψε	paɾakampse
εμπνευσμένοσ	embnevzmenos
ισόπλευροσ	isoplevros
απογειώνω	apoʝiono
γένεσησ	ʝenesis
αποκρίνω	apokɾino
υπολογίστηκα	ipoloʝistika
έκρινα	ekɾina
παρέλαβα	paɾelava
εμπόριο	emboɾio
οδηγούμαι	oðiɣume
χόρεψα	xoɾepsa
αλαφιασμένουσ	alafçazmenus
χρονολογούμε	xronoloɣume
κάρπαθοσ	kaɾpaθos
αφορμή	afoɾmi
επιτρέπω	epitɾepo
καλοφάγωτων	kalofaɣoton
υποχρεωτικόσ	ipoxɾeotikos
τυροκομία	tiɾokomia
υιόσ	ios
σημαντικόσ	simandikos
ντέλαγουερ	delaɣueɾ
καλοφάγωτα	kalofaɣota
ανεμελιάσ	anemeʎas
νάζι	nazi
ενορχηστρώσεισ	enoɾçistɾosis
απασχολημένοι	apasxolimeni
ξεσπίτωμα	ksespitoma
διέθλασα	ðieθlasa
δαμάζομαι	ðamazome
τυλιγμένοσ	tiliɣmenos
γιαγιά	ʝaʝa
αποκλείεται	apokliete
παρακείμενα	paracimena
τιμολόγιο	timoloʝo
μπαστουνιά	bastuɲa
έχοντασ	exondas
ρόδε	ɾoðe
αντικρούσθηκα	andikrusθika
εκκενώνω	ecenono
υπουργόσ	ipuɾɣos
αναστρέφομε	anastɾefome
τσακώνικου	tsakoniku
τσουραπιού	tsuɾapçu
όμορφοι	omoɾfi
καθέλκουμε	kaθelkuume
καταδιώχτηκα	kataðioxtika
βλαμμένα	vlamena
μαλακισμένοσ	malacizmenos
άγια	aʝa
τραβιέμαι	tɾavʝeme
κάμπτομαι	kamtome
καρτεράω	kaɾteɾao
κοίτη	citi
μαρτίων	maɾtion
ανέκοψα	anekopsa
αβούλιαχτοσ	avuʎaxtos
αυγούστου	avɣustu
χαβάη	xavai
μαυρισμένοι	mavrizmeni
ερρίνωση	erinosi
μπερδεμένοι	beɾðemeni
επέτρεψα	epetɾepsa
σοφού	sofu
αναβαλλόμενα	anavalomena
κουραστικέσ	kurastices
γκαστρώνομαι	ɡastɾonome
ξερόλασ	kseɾolas
τόσοι	tosi
προσαρμόζομαι	pɾosaɾmozome
μαθημένου	maθimenu
παπαδιά	papaðʝa
γαμοσταυρίζω	ɣamostavɾizo
καταδιώκω	kataðioko
αναφυτεύομαι	anafitevome
καφετζού	kafendzu
αναβαλλόμενου	anavalomenu
ψημένα	psimena
ιλινόισ	ilinois
ερχομένου	erxomenu
τριφύλλι	tɾifili
καυλιάρησ	kavʝaɾis
δασύπουσ	ðasipus
κιαλιού	caʎu
βλάφτηκα	vlaftika
πορδή	poɾði
παζαρεύω	pazaɾevo
αγανακτισμένοι	aɣanaktizmeni
γιογιό	ʝoʝo
ξελογιάστρα	kseloʝastɾa
κλιμακώσεισ	klimakosis
σχολίων	sxolion
υπολογισμένο	ipoloʝizmeno
μπανάνα	banana
λερώνω	leɾono
πέμπομαι	pembome
ξεχάστηκα	ksexastika
αφορούσε	aforuse
σορόσ	soɾos
κωνσταντίνοσ	konstandinos
μαζικότατεσ	mazikotates
ανεβασιών	anevasçon
υπολογιστικούσ	ipoloʝistikus
ντουντούκα	duduka
αποζημίωσα	apozimiosa
μεταφρασιολογίασ	metafrasioloʝias
ψηφίσατε	psifisate
παραέγραψα	paɾaeɣɾapsa
αναμένει	anameni
διηθώ	ðiiθo
κραυγάζω	kravɣazo
διαλυμένησ	ðʝalimenis
κληρονομάω	kliɾonomao
απεύχομαι	apefxome
γυρίστηκα	ʝiɾistika
πλειοψηφίεσ	pliopsifies
απαγορεύσεισ	apaɣoɾefsis
πάγοσ	paɣos
μπινελίκι	binelici
ξένοσ	ksenos
κάρδαμο	karðamo
επισκέφθηκα	episcefθika
χορέψαμε	xoɾepsame
χιονάνθρωποσ	çonanθɾopos
θερμοκοιτίδεσ	θermocitiðes
παοκ	paok
φόρα	foɾa
απομονωμένησ	apomonomenis
τετριμμένη	tetrimeni
υπολογιστική	ipoloʝistici
αγρίεψα	aɣɾiepsa
απολογητικήσ	apoloʝiticis
υπολογισμένοι	ipoloʝizmeni
λουφαδόροσ	lufaðoɾos
ψήφο	psifo
ηλικιωμένε	iliciomene
μαλακισμένο	malacizmeno
αποκλείσθηκε	apoklisθice
μασσαλία	masalia
φαινυλαμίνεσ	fenilamines
γυρνάω	ʝiɾnao
κατρουλιό	katɾuʎo
διαλυτικά	ðʝalitika
βράχηκα	vɾaçika
δύσκολοσ	ðiskolos
σκατίλα	skatila
ισόγειοσ	isoʝios
έλυνε	eline
προειδοποίησα	pɾoiðopiisa
γαμάτα	ɣamata
θλιμμένου	θlimenu
αποκρίνομαι	apokɾinome
ακολουθούμε	akoluθume
διέπομαι	ðiepome
κότσαρε	kotsaɾe
κουβαλιέμαι	kuvaʎeme
τορόντο	toɾondo
υπολογίζουμε	ipoloʝizume
παραβάλομε	paɾavalome
αμφιδέξιοσ	amfiðeksios
καλαμποκόψωμα	kalambokopsoma
φεύγω	fevɣo
πασαλείφομαι	pasalifome
καταφέρω	katafeɾo
οφιοειδή	ofioiði
χιόνι	çoni
πέμπτοσ	pemptos
γαμάτοι	ɣamati
φέρε	feɾe
άγιων	aʝon
λιμένοσ	limenos
λανθάνων	lanθanon
ολίγοσ	oliɣos
ωφελώ	ofelo
λεξιπλασία	leksiplasia
αποτυχία	apotiçia
ντροπαλοί	dɾopali
σκουλήκι	skulici
αναφτερώνομαι	anafteɾonome
κινεζοποίησησ	cinezopiisis
γιάννινα	ʝanina
δεκατέσσερα	ðekateseɾa
παρηγορημένοσ	paɾiɣoɾimenos
διαρκώ	ði̯aɾko
παρεγράφη	paɾeɣɾafi
παρακολουθώ	paɾakoluθo
χαρτομάντησ	xaɾtomandis
στιμμένησ	stimenis
παρακείμενουσ	paɾacimenus
θλιβερούσ	θliveɾus
συγκόπηκα	siŋɡopika
ματοβαμμένων	matovamenon
στειρώνω	stiɾono
σέρβιρε	seɾviɾe
αδημονώ	aðimono
έχουνε	exune
γκρίζασ	ɡɾizas
οικοδομήθηκα	ikoðomiθika
διαρρέομαι	ðiareome
καδράρω	kaðɾaɾo
πηλοφόρι	pilofoɾi
αιδώσ	eðos
ερωτεύτηκα	eɾoteftika
διατηρώ	ði̯atiɾo
ένρινων	enrinon
αλείφω	alifo
πιροσκί	piroski
μπαρκάριζα	baɾkaɾiza
λύει	lii
ακατοίκητοσ	akaticitos
αλεξανδρούπολη	aleksanðɾupoli
ποικιλότερου	piciloteru
χρειάστηκε	xɾiastice
σκασμένε	skazmene
ζωντανόσ	zondanos
ακατάσβεστοσ	akatazvestos
βαθμολογημένεσ	vaθmoloʝimenes
αντιγραφείσ	andiɣrafis
γκέι	ɟei
ηλικία	ilicia
παπάρι	papaɾi
πομφολύγων	poɱfoliɣon
πιστεύεται	pistevete
αετιδεύσ	aetiðefs
αποβάλλομαι	apovalome
εγείρομε	eʝiɾome
μηνύθηκα	miniθika
βδομάδα	vðomaða
αιματοβαμμένα	ematovamena
περισπώμενεσ	peɾispomenes
ζευγάρια	zevɣarʝa
ανησυχώ	anisixo
εκατό	ekato
ποικιλότερουσ	piciloterus
οσμίστηκα	ozmistika
μεταφράζομαι	metafɾazome
μάζευε	mazeve
ενέκλεισα	eneklisa
βιάζομαι	viazome
καρτερώ	kaɾteɾo
δεκέμβριο	ðeceɱvɾio
ξενιτιάσ	ksenitças
επιγράφηκε	epiɣrafice
αναμιγνύω	anamiɣnio
παύτηκα	paftika
βοηθημένοσ	voi̯θimenos
κλεισμένα	klizmena
κοινολέκτουσ	cinolektus
βοοειδή	vooiði
εγκύπτω	eŋɟipto
προσάρτησα	pɾosaɾtisa
στιγματίστηκα	stiɣmatistika
στυμμένου	stimenu
δρω	ðɾo
αντανακλαστικό	andanaklastiko
δολοφόνισσα	ðolofonisa
ομοφυλόφιλων	omofilofilon
κακοκεφιών	kakocefçon
μαλακισμένοι	malacizmeni
τζένη	dzeni
έκτοποσ	ektopos
αμνησίεσ	amnisies
κάθομαι	kaθome
αγκομαχάω	aŋɡomaxao
ευθέωσ	efθeos
δυσκολεύω	ðiskolevo
οιωνόσ	ionos
αβουλίεσ	avulies
κατέφτασα	kateftasa
βελτιώθηκα	veltioθika
ενισχύω	enisçio
εκπίπτω	ekpipto
λάκωνασ	lakonas
κωσταντίνα	kostandina
κωνσταντινούπολισ	konstandinupolis
έντρομοσ	endɾomos
ψαλμένοσ	psalmenos
κίνητρο	cinitro
βοηθημένοσ	voiθimenos
δημοσιευμένοσ	ðimosievmenos
ενδιέτριψα	enðietɾipsa
αηδιασμένοι	aiðiazmeni
εξοπλισμένων	eksoplizmenon
ταχυδακτυλουργόσ	taçiðaktiluɾɣos
περιοδικέσ	perioðices
άρχοντασ	aɾxondas
ακρογωνιαίοσ	akɾoɣonieos
θεοκρατία	θeokratia
ειλημμένησ	ilimenis
έκλεψα	eklepsa
ποικιλότερων	piciloteron
γράδο	ɣɾaðo
φρενάραμε	frenarame
καλιφόρνια	kalifoɾnia
σεπτέμβρηδεσ	septeɱvɾiðes
μελισσοκόμοσ	melisokomos
τρανσ	tɾans
ανακατεύτηκα	anakateftika
αναστατώθηκα	anastatoθika
αμφισβητούμαι	aɱfisvitume
γκαρίζω	ɡarizo
ανοίκειοσ	anicios
εθνάρχησ	eθnarçis
συγκινούμαι	siŋɟinume
λύνονται	linonde
ισπανία	ispania
σβηστηριού	zvistiɾʝu
υπογράφεισ	ipoɣrafis
υδρογόνο	iðroɣono
σαλτάρω	saltaɾo
τοστιέρα	tostçeɾa
κόκκινων	kocinon
πιονιού	pçoɲu
πασπατεύω	paspatevo
λύνεστε	lineste
ήμασταν	imastan
σκούντηξα	skundiksa
ψήφοι	psifi
καθιδρύομεν	kaθiðriomen
πεσκίρι	pesciɾi
διασκέπτομαι	ðiasceptome
στειμμένησ	stimenis
επιστρέφω	epistɾefo
σύρομαι	sirome
χρώσταγα	xɾostaɣa
πίπα	pipa
άμυαλοσ	amɲalos
ουσιαστικοποιήσεων	usiastikopiiseon
κανάκεψε	kanacepse
λύσαμε	lisame
καδράρομαι	kaðɾaɾome
λυθήκαμε	liθikame
υπολογισμένε	ipoloʝizmene
σχετικά	sçetika
ξερόψωμο	kseropsomo
συσσωρεύω	sisoɾevo
ζάκυνθοσ	zacinθos
επικαλύψεισ	epikalipsis
κατέφερα	katefeɾa
ζεσταμένοι	zestameni
αηδιαστικοί	aiðʝastici
νικημένοσ	nicimenos
θεοτόκε	θeotoce
αγιάστηκα	aʝastika
ανατιμώ	anatimo
ηθικότητα	iθikotita
ερχόμενοι	erxomeni
περίπλουσ	periplus
ασέβειεσ	asevies
θήτα	θita
τζάμπα	tsamba
άστρο	astro
σόι	soi
γυρεύομαι	ʝiɾevome
κολλώ	kolo
αξίζω	aksizo
ιεράρχησ	ierarçis
σημειωτόν	simioton
αξιοσημείωτοσ	aksiosimiotos
ανάπαψα	anapapsa
καλομοίρα	kalomira
πολωνέζεσ	polonezes
αριβάρισα	aɾivaɾisa
κορόιδευε	koɾoi̯ðeve
κριθαρόψωμα	kriθaropsoma
παραγράφτηκε	paɾaɣɾaftice
βελτιώνω	veltiono
ατμ	ei̯tiem
αποσείουμε	aposiume
σφύριξα	sfiriksa
καταιγίδασ	kateʝiðas
θωρούσα	θoɾusa
κοτσάριζε	kotsaɾize
αγανακτώ	aɣanakto
κωλόγρια	koloɣɾia
αγιάσθηκα	aʝiasθika
καλομοίρηδεσ	kalomiriðes
απασχολημένοσ	apasxolimenos
επισείστηκα	episistika
αγκυλίων	aŋɟilion
φλόριντα	floɾida
είμαστε	imaste
αλεγράρισα	aleɣɾaɾisa
αγαντάρισε	aɣandarise
αρχιφύλακασ	aɾçifilakas
αγκύλια	aŋɟilia
περσεύσ	persefs
περασμένη	perazmeni
αποκυημάτων	apociimaton
γοητεύτηκα	ɣoiteftika
ημέρευ'	imeɾef
αιματοβαμμένο	ematovameno
κεντάκι	centaci
έναρξησ	enaɾksis
ζητιανεύτε	zitçanefte
εμπνευσμένα	embnevzmena
αλήθεψα	aliθepsa
σοβαρολογούσα	sovaɾoloɣusa
οδηγήθηκα	oðiʝiθika
εγκλείουμε	eŋɡliume
μυροβλύτησ	miɾovlitis
φιλιέμαι	fiʎeme
καληνύχτα	kalinixta
κωμειδύλλιο	komiðilio
γιατάκι	ʝataci
ξεκωλιάστηκα	ksekoʎastika
έμποροσ	emboɾos
βρε	vɾe
πεντήκοντα	pendikonda
νοέμβριοι	noeɱvɾii
κοτσάρω	kotsaɾo
πιθάρια	piθarʝa
ανασαλεύομαι	anasalevome
λάκωνοσ	lakonos
βαβυλώνα	vavilona
στιβάδα	stivaða
κρυμμένου	krimenu
γερνώ	ʝeɾno
αβγατισμένεσ	avɣatizmenes
αποδοκιμάζουμε	apoðocimazume
κινδυνέψει	cinðinepsi
κατέστησα	katestisa
δεσπότησ	ðespotis
συνθλιφτήκαν	sinθliftikan
βοηθώ	voiθo
σταφιδόψωμα	stafiðopsoma
ομοφυλόφιλοι	omofilofili
μάζευα	mazeva
πλησίασα	plisiasa
σαλτάρισα	saltaɾisa
αγένεια	aʝenia
κράμβη	kraɱvi
φάνταξα	fandaksa
κοκκίνισα	kocinisa
ψημένοσ	psimenos
αναπαύθηκα	anapafθika
ἐξώστησ	eksostis
ποίησησ	piisis
τρελοκομείο	tɾelokomio
ψωμάδικο	psomaðiko
ανέτεινα	anetina
επιμελητήσ	epimelitis
γοητεύθηκα	ɣoitefθika
αβγατισμένουσ	avɣatizmenus
ζαμπονοτυρόπιτα	zambonotiɾopita
τέωσ	teos
μισούμε	misume
χάθηκα	xaθika
περασμένεσ	perazmenes
αρρωστημένοσ	arostimenos
τσακώνικη	tsakonici
μπερδεμένε	beɾðemene
παρκάρομαι	paɾkaɾome
απορώ	apoɾo
ξενοδοχειακόσ	ksenoðoçaos
πηδημένοσ	piðimenos
άγιασ	aʝas
αποτραπήκανε	apotɾapikane
χαμπέρι	xabeɾi
τραπέζι	tɾapezi
πληθυσμόσ	pliθizmos
σοφούσ	sofus
χαμόγελο	xamoʝelo
αλφαδιάζομαι	alfaðʝazome
χρονών	xɾonon
λυπημένη	lipimeni
ανάγγελλα	anaŋɟela
τρόμοσ	tromos
μοναχόσ	monaxos
ανακλαδίζομαι	anaklaðizome
φύλακασ	filakas
υπήκοοσ	ipicoos
κιλκίσ	cilcis
δήμαρχοσ	ðimaɾxos
μεταφυτεύομαι	metafitevome
ανέλκυσα	anelcisa
ευωδιών	evoðʝon
τραγουδώ	tɾaɣuðo
θριαμβεύω	θɾiaɱvevo
ντροπιασμένοσ	dɾopçazmenos
παγωτατζήσ	paɣotadzis
μέμφθηκα	memfθika
αγανακτισμένε	aɣanaktizmene
ανάγκη	anaŋɟi
χίου	çiu
αιτιοκρατίασ	etiokratias
διαχύθηκα	ðʝaçiθika
αλλαγή	alaʝi
δέσποινα	ðespina
καταφρονούμε	katafɾonume
εξαναγκάστηκα	eksanaŋɡastika
αποκλεισμένεσ	apoklizmenes
απορρίψεισ	apoɾipsis
ντροπαλόσ	dɾopalos
λυμένουσ	limenus
παραπαίω	parapeo
εμπεριέκλεισα	emberieklisa
ναύπακτοσ	nafpaktos
διαιρούμε	ðieɾume
τριμμένοι	trimeni
κωσταντήσ	kostandis
έξυσα	eksisa
εγείρουμε	eʝiɾume
φλιπάρω	flipaɾo
αθεϊσμό	aθeizmo
κινδύνεψε	cinðinepse
ήτανε	itane
ηγουμένησ	iɣumenis
πλειστηριάζω	plistiriazo
πίτα	pita
εμβολίων	eɱvolion
αποτράπηκαν	apotɾapikan
αναβαθμολογήθηκα	anavaθmoloʝiθika
τρομαγμένοσ	tɾomaɣmenos
επισείομαι	episiome
λύνεισ	linis
ντετερμινισμούσ	determinizmius
αγκαλιάζομαι	aŋɡaʎazome
ανακαλύφτηκα	anakaliftika
συντριφτήκανε	sindriftikane
ομοφυλόφιλοσ	omofilofilos
πωλώ	polo
αγουστιά	aɣustça
αλληλοσυγκρούστηκα	alilosiŋɡrustika
φιλολογίεσ	filoloʝies
ανακλώμαι	anaklome
λάκωνεσ	lakones
αιχμαλωτίστηκα	exmalotistika
ανευρίσκομαι	anevɾiskome
σπασμένοσ	spazmenos
κόμποσ	kombos
ηφαίστειο	ifestio
στεναχωρημένων	stenaxorimenon
αεροφωτογραφία	aerofotoɣrafia
προσελκύομαι	proselciome
ανεβασιάσ	anevasças
διήθηση	ðiiθisi
κρατικοποιώ	kɾatikopio
συμφυρμέ	siɱfirme
βασιλομήτωρ	vasilomitoɾ
καλομάνεσ	kalomanes
παρηγοράω	paɾiɣoɾao
γρηγόρησ	ɣɾiɣoɾis
τριμμένησ	trimenis
γουστάριζα	ɣustaɾiza
ξέχασα	ksexasa
συντρίβω	sindrivo
σοφότερο	sofoteɾo
σκάσε	skase
έλκουμε	elkume
παραβάλλομε	paɾavalome
στείρωσα	stiɾosa
δέκατοσ	ðekatos
μασαχουσέτη	masaxuseti
ανενταφίαστοσ	anendafiastos
σαχλαμάρα	saxlamaɾa
χοντρομπαλού	xondɾobalu
ελεημοσύνη	eleimosini
εγκαθιδρύομε	eŋɡaθiðriome
προφασίζομαι	pɾofasizome
λύνανε	linane
πλούσιοσ	plusios
γενιού	ʝeɲu
ικανοποιημένων	ikanopiimenon
απελπισμένεσ	apelpizmenes
προπόνησησ	proponisis
φλόκοσ	flokos
φίλησε	filise
αγκύλι	aŋɟili
αντάμωση	andamosi
μυγιάζομαι	miʝazome
απατήθηκα	apatiθika
μαζεύτε	mazefte
έβαλε	evale
παγωμένοσ	paɣomenos
λύνουμε	linume
λογόκρινα	loɣokɾina
αναμμένων	anamenon
αποδεικνύω	apoðiknio
απογοητεύω	apoɣoitevo
εκκενώσεισ	ecenosis
κινδύνεψα	cinðinepsa
έδυσα	eðisa
λιβαδειά	livaðʝa
αρρωστημένο	arostimeno
πλήττω	plito
υποθήκη	ipoθici
αγνάντευε	aɣnandeve
γονυπετείσ	ɣonipetis
παναγία	panaʝia
μάρτιε	maɾtie
φρένα	frena
πατσαβουρόπιτεσ	patsavuɾopites
ζαριά	zaɾʝa
ντροπιαστικοί	dɾopçastici
αναζητιέμαι	anazitçeme
πλειόκαινο	plioceno
σχηματίστηκα	sçimatistika
μεγαλομανία	meɣalomania
κόβω	kovo
γιατρειών	ʝatɾion
προαλείφθηκα	pɾoalifθika
φούμαρο	fumaɾo
ανασκάφηκα	anaskafika
παλτό	palto
διώκω	ðioko
συγκινητικοί	siŋɟinitici
άγιοι	aʝi
γαργαλεύω	ɣaɾɣalevo
αρρωστημένα	arostimena
προσδοκώμαι	pɾosðokome
περιοδικόσ	perioðikos
μάρτιο	maɾtio
βυθισμένοι	viθizmeni
τελώ	telo
καθιστώ	kaθisto
ραμολιμέντο	ɾamolimendo
ξενοδόχα	ksenoðoxa
προμηθείσ	promiθis
περικλείομε	perikliome
αλαφιασμένε	alafçazmene
αρνιέμαι	aɾɲeme
ειλημμένα	ilimena
ναυτολόγια	naftoloʝia
σεβαστιανόσ	sevastçanos
παραβλέφθηκα	paɾavlefθika
χαμόσ	xamos
αραχνιασμένοι	aɾaxɲazmeni
λύεισ	liis
τρυγόνασ	triɣonas
ανιδρύομε	aniðriome
ροβέρτοσ	ɾoveɾtos
βδελυγμάτων	vðeliɣmaton
συνήφθη	sinifθi
ματοκύλισα	matocilisa
αβάρα	avaɾa
προσπαθώ	pɾospaθo
λυπημένοι	lipimeni
αβανγκάρντ	avaŋɡaɾd
πειραματόζωο	piramatozoo
διασπώ	ði̯aspo
απατημένοσ	apatimenos
καθελκύω	kaθelcio
καπνίζουμε	kapnizume
ιωάννα	ioana
ανασκάπτομε	anaskaptome
διπλανόσ	ðiplanos
ξένια	kseɲa
καινούργιοσ	cenuɾʝos
κροτώ	kɾoto
διαρρέεται	ðʝareete
επομένωσ	epomenos
αποσταίνω	aposteno
ξοδεύομαι	ksoðevome
φρυγανίζομαι	fɾiɣanizome
εξυπακούονταν	eksipakuondan
εμπνευσμένε	embnevzmene
φουφού	fufu
ηλικιωμένα	iliciomena
περικλείομαι	perikliome
φοροδιαφυγή	foɾoðʝafiʝi
κλεισμένησ	klizmenis
επαινετόσ	epenetos
ηγούμενοι	iɣumeni
εξέχυσα	ekseçisa
αποβάλουμε	apovalume
ταλαιπωριέμαι	talepoɾʝeme
επερχόμενοσ	epeɾxomenos
χτυπιέμαι	xtipçeme
ψηφοδέλτιο	psifoðeltio
γνώριμοσ	ɣnoɾimos
αστράφτει	astɾafti
φέτοσ	fetos
μετριέμαι	metɾi̯eme
αυτοκράτορασ	aftokratoras
ποιούμαι	piume
αναβάλλω	anavalo
απορροφούμενου	apoɾofumenu
προωθώ	pɾooθo
παραβλέπουμε	paɾavlepume
δοξάζω	ðoskazo
ησυχία	isiçia
ανασαλεύω	anasalevo
λύνουνε	linune
ακούγω	akuɣo
βασιλιάσ	vasiʎas
μυρωμένεσ	miromenes
νομίζω	nomizo
μοχλόσ	moxlos
καθιδρύομε	kaθiðriome
είχαν	ixan
διαμείφθηκε	ðiamifθice
ἀθήναισ	aθines
αγιατολάχ	aʝatolax
ευεπηρέαστοσ	evepireastos
δεκαπέντε	ðekapende
γιατρεύτηκα	ʝatɾeftika
αποδειχθήκαν	apoðixθikan
μαζικότατουσ	mazikotatus
αμήν	amin
διαφωνώ	ðʝafono
διαγωνίζομαι	ðiaɣonizome
αλφαβήτουσ	alfavitus
ανέχομαι	anexome
καυλιάρα	kavʎaɾa
βάλεισ	valis
διαλογίζομαι	ðialoʝizome
φρόσω	fɾoso
ανορθώνω	anoɾθono
καλομαθημένων	kalomaθimenon
έγγαμοσ	eŋɣamos
στύβω	stivo
κομμένων	komenon
σχηματίζομαι	sçimatizome
συμπολεμιστήσ	simbolemistis
τάμεσησ	tamesis
ανταμώσεισ	andamosis
ανακτήθηκα	anaktiθika
επωνυμία	eponimia
πεινάω	pinao
ψαρεύομαι	psaɾevome
κάγκουρασ	kaŋɡuɾas
συνηθισμένη	siniθizmeni
ισχυρισμόσ	isçiɾizmos
καλικαντζαράκι	kalikandzaɾaci
κληρονομούμαι	kliɾonomume
συγχωρήθηκα	siŋxoɾiθika
όρεξη	oɾeksi
ανακαλύφθηκα	anakalifθika
προσαρτώμαι	pɾosaɾtome
επανιδρύομε	epaniðriome
μέτριοι	metrii
ανακάμπτω	anakampto
γιόρτασα	ʝoɾtasa
αρματώνω	aɾmatono
παρετυμολογία	paɾetimoloʝia
εξολοθρεύω	eksoloθɾevo
καρεκλάκι	kaɾeklaci
στειμμένουσ	stimenus
καρβέλι	karveli
θερμοδυναμική	θermoðinamici
λιγότεροσ	liɣoteros
αμφιλεγόμενεσ	aɱfileɣomenes
σφυρίζω	sfirizo
εκκολάπτομαι	ekolaptome
πρήζομαι	pɾizome
αναδημιουργημένεσ	anaðimiurʝimenes
ικανοποιημένε	ikanopiimene
δεν	ðen
ανάργυροσ	anaɾʝiɾos
ακριτικόσ	akritikos
κρότοσ	krotos
φασκιώνω	fasciono
αηδιαστική	aiðʝastici
κυβερνημένοσ	civeɾnimenos
σωρόσ	soɾos
κουραστικήσ	kurasticis
μαθημένη	maθimeni
κοινολέκτων	cinolekton
παρφουμάρισα	paɾfumaɾisa
ηγέρθην	iʝeɾθin
προετοιμάστηκα	pɾoetimastika
ὑπεγράφην	ipeɣrafin
ποικιλότατησ	picilotatis
αποδειχτήκαν	apoðixtikan
αιματοκυλίστηκα	ematocilistika
σταγόνων	staɣonon
ποιούμε	piume
σταγόνα	staɣona
τρεχούμενοσ	tɾexumenos
χαμηλοβλεπούσα	xamilovlepusa
πρεζόνι	pɾezoni
απόκρυψα	apokɾipsa
ακυρώσεισ	aciɾosis
ταλαιπωρήθηκα	talepoɾiθika
επανειλημμένη	epanilimeni
κουρελιών	kuɾeʎon
μεταπτώσεισ	metaptosis
παρατράγουδο	paɾatɾaɣuðo
ακριβοπληρώθηκα	akrivopliɾoθika
χάχασ	xaxas
γαργαλεύομαι	ɣaɾɣalevome
προσελκύομε	proselciome
αμφιλεγόμενοι	aɱfileɣomeni
σούρνω	surno
κατηγορήθηκα	katiɣoɾiθika
γιορτή	ʝorti
φλωρίνησ	florinis
αντικρούω	andikruo
εκπαιδεύομαι	ekpeðevome
γαϊδαράκοσ	ɣaiðaɾakos
ότι	oti
άρον	aron
αποδέχομαι	apoðexome
ακούγοντασ	akuɣondas
στεναχωρημένη	stenaxorimeni
λήγω	liɣo
αντικρούομαι	andikruome
αποστάζομε	apostazome
επικάλυψα	epikalipsa
αποπέμπομαι	apopembome
πείραξα	piraksa
νοστίμεψα	nostimepsa
στυλιανή	stiʎani
αραπίνα	aɾapina
μεταφραστήσ	metafɾastis
μπάνιο	baɲo
γυρεύτηκα	ʝiɾeftika
αποσπώμαι	apospome
μισοσκόταδο	misoskotaðo
ανέδειξα	aneðiksa
περικόβω	peɾikovo
σταματιέμαι	stamatçeme
σπιτόγατοσ	spitoɣatos
ήλιοσ	iʎos
λιμάνι	limani
μετατρέπομαι	metatɾepome
φόροσ	foɾos
ψηφίζομε	psifizome
όπιο	opio
τρυγόνα	triɣona
δεκέμβριε	ðeceɱvɾie
ανεβοκατεβαίνω	anevokateveno
ρόδο	ɾoðo
αγαπημένεσ	aɣapimenes
διαλυμένων	ðʝalimenon
φεβρουαρίου	fevɾuaɾiu
διαμείβομαι	ðiamivome
προστίθεμαι	prostiθeme
σπιτώνω	spitono
αγγλοφέρνω	aŋɡloferno
αμπαλάρω	ambalaɾo
ανθρώπεψα	anθɾopepsa
προμήθεψα	pɾomiθepsa
διαλυμένεσ	ðʝalimenes
ωστόσο	ostoso
υπέκυψα	ipecipsa
αθηνά	aθina
εγγονιού	eŋɡoɲu
συγχώρεσα	siŋxoɾesa
ἐνεγράφην	eneɣrafin
ανακαλύπτομαι	anakaliptome
πλατεῖα	platia
διακόπτω	ðiakopto
οριστική	oɾistici
βαθμολογημένοσ	vaθmoloʝimenos
βοηθήθηκα	voiθiθika
αλείβουμε	alivume
αποκυήματοσ	apociimatos
δακτυλογραφώ	ðaktiloɣɾafo
δηλώνω	ðilono
κόκκινουσ	kocinus
κεραία	cerea
αναφτερώνω	anafteɾono
λιμένων	limenon
παρόν	paɾon
ξενιτιά	ksenitça
στον	ston
εκπνέω	ekpneo
καταλόγου	kataloɣu
προσγράφω	pɾozɣrafo
καλομοίρασ	kalomiras
επηρεάζω	epiɾeazo
επέστρεψα	epestɾepsa
επέρχομαι	epeɾxome
κατάμαυροσ	katamavɾos
πρωκτικόσ	pɾoktikos
αβγατισμένοι	avɣatizmeni
δίεση	ðiesi
δαγκάνομαι	ðaŋɡanome
ποίησισ	piisis
ιούλιο	iulio
κυριακάτικα	cirʝakatika
αναδύομαι	anaðiome
σύντριψε	sindripse
στριμμένη	stɾimeni
άκουσα	akusa
κινήθηκα	ciniθika
όμορφουσ	omoɾfus
λίγοσ	liɣos
στειμμένεσ	stimenes
σημειώνομαι	simionome
ακονίζομαι	akonizome
υπερτροφία	ipeɾtɾofia
κωλάρα	kolaɾa
προμηθέων	promiθeon
ματοβαμμένησ	matovamenis
αναδεικνύομαι	anaðikniome
σαγήνεψα	saʝinepsa
αποξενωμένοσ	apoksenomenos
πρησμένου	pɾizmenu
αναπάλλω	anapalo
τσακώνικησ	tsakonicis
ήτα	ita
ξεκώλιασα	ksekoʎasa
στυλιανόσ	stiʎanos
βρέχομε	vrexome
αναθεματισμένουσ	anaθematizmenus
αποκλεισμένη	apoklizmeni
δευτεραγωνιστών	ðefteraɣoniston
ήπια	ipça
απόπλουσ	apoplus
στενοχωρημένα	stenoxorimena
σεπτέμβριε	septeɱvɾie
σούταρε	sutaɾe
λεμονιά	lemoɲa
σκασμόσ	skazmos
ιπταμένη	iptameni
σπάρθηκα	spaɾθika
γήτεψα	ʝitepsa
συνεννοούμαι	sinenoume
τριταγωνιστέσ	tritaɣonistes
τανάγρα	tanaɣɾa
χειμωνιάτικα	çimoɲatika
αγκύλιο	aŋɟilio
περιγράφτηκα	peɾiɣraftika
αναβαλλόμενεσ	anavalomenes
κουρελιάζω	kuɾeʎazo
κακογαμημένο	kakoɣamimeno
αναδείξεισ	anaðiksis
ουστ	ust
φρέσκαρα	freskara
πάντρεψα	pandɾepsa
πρέβεζα	pɾeveza
αγγάρεψα	aŋɡaɾepsa
ποικιλότατο	picilotato
εξάλειψα	eksalipsa
πρωτοβουλία	pɾotovulia
βυθισμένε	viθizmene
χρονολογίασ	xronoloʝias
ακοντίζομαι	akondizome
λιπών	lipon
δημεύομαι	ðimevome
νικημένε	nicimene
σταγών	staɣon
πέμπτων	pempton
μύλο	milo
τίνοσ	tinos
ερχόμενων	erxomenon
απόσταξα	apostaksa
μοιρασμένου	miɾazmenu
πατινάρομαι	patinaɾome
μαυρισμένοσ	mavrizmenos
αληθή	aliθi
ρουφήχτηκα	ɾufixtika
αγυιόπαιδεσ	aʝiopeðes
απριλίουσ	apɾilius
ακριβομίλητοσ	akɾivomilitos
αθωώνομαι	aθoonome
παραχαϊδεύομαι	paɾaxai̯ðevome
βελτίωσα	veltiosa
μοιρασμένο	miɾazmeno
πούστικοσ	pustikos
ανακόπτουμε	anakoptume
ναύπλιο	nafplio
αγκυλώνω	aŋɟilono
καλοφάγωτε	kalofaɣote
ανέκτησα	anektisa
κεκλεισμένουσ	ceklizmenus
φωτοβολίδα	fotovoliða
έγλειψα	eɣlipsa
σουτ	sut
μάη	mai
λύσουνε	lisune
βίασα	viasa
σπίθα	spiθa
παρακολουθούμε	paɾakoluθume
πιονίου	pioniu
παιδότοποσ	peðotopos
αντιφάσκω	andifasko
φονεύομαι	fonevome
μέριλαντ	meɾiland
ξενοδόχοσ	ksenoðoxos
αναμμένε	anamene
κοινόλεκτο	cinolekto
πεπεισμένα	pepizmena
λεμόνι	lemoni
βρίζομαι	vɾizome
ακολουθιέμαι	akoluθçeme
μνήμησ	mnimis
συνόψεισ	sinopsis
νεκρομαντεία	nekɾomandia
συγχωρέθηκα	siŋxoɾeθika
μαλακισμένε	malacizmene
έχετε	eçete
γαϊδουροκαλόκαιρο	ɣaiðuɾokaloceɾo
αναβάλω	anavalo
εξανάγκασα	eksanaŋɡasa
κομεντί	komedi
διεκόπην	ðiekopin
προσφέρουμε	pɾosfeɾume
εγχέω	eŋçeo
κοντόσ	kondos
χάβομαι	xavome
στοργή	storʝi
ένρινο	enrino
περιοδικοί	perioðici
αγίων	aʝion
ολιγόκαινοσ	oliɣocenos
απορρίφθηκα	apoɾifθika
σκευοθήκη	scevoθici
μερεύω	meɾevo
ξυλόφωνο	ksilofono
περίοδοσ	perioðos
υποδοχή	ipoðoçi
πεθαμένο	peθameno
αγκώνιασα	aŋɡoɲasa
υπολογισμένου	ipoloʝizmenu
των	ton
λέγεισ	leʝis
τσιφούτησ	tsifutis
ολόασπροσ	oloaspɾos
παναγιότατοσ	panaʝiotatos
ποικιλότατε	picilotate
μιάμιση	mɲamisi
απαγορεύθηκα	apaɣoɾefθika
ασέλγεια	aselʝia
διαπνέουμε	ðiapneume
καταναγκάζουμε	katanaŋɡazume
εμπερικλείω	emberiklio
σέβομαι	sevome
παρακείμενου	paɾacimenu
αναγεννιέμαι	anaʝeɲeme
συνδυάζομε	sinðiazome
διαρρέουμε	ðiareume
βραχυκύκλωμα	vɾaçicikloma
συνηθισμένου	siniθizmenu
ψέλνομαι	pselnome
αποκλείστηκα	apoklistika
παγωμένα	paɣomena
στέφομαι	stefome
αμνησίασ	amnisias
τσουράπια	tsuɾapça
μάρτη	maɾti
σαγηνεύθηκα	saʝinefθika
είσαι	ise
κυνηγημένη	ciniʝimeni
αερίστηκα	aeɾistika
λύνετε	linete
μαρτυριέμαι	maɾtiɾʝeme
αγιοποιημένα	aʝiopiimena
εορτάστηκα	eoɾtastika
στεναχωρημένησ	stenaxorimenis
κατάλογοι	kataloʝi
κουραδόμαγκασ	kuɾaðomaŋɡas
φασούλια	fasuʎa
άμε	ame
αμήνυτοσ	aminitos
συγγράφεισ	siŋɣrafis
καινούριοσ	cenuɾʝos
δραπετεύω	ðɾapetevo
ελκυστικόσ	elcistikos
τρώω	tɾoo
αποστολέασ	apostoleas
παρκάριζε	paɾkaɾize
υπερισχύω	iperisçio
στερεύω	steɾevo
τάλιρο	taliɾo
αλληλοσυγκρουόμενε	alilosiŋɡruomene
μποϊκοτάρω	boikotaɾo
δικηγόροσ	ðiciɣoɾos
περασμένων	perazmenon
λιμένασ	limenas
ελκύομαι	elciome
αφθονώ	afθono
μάιοι	maii
παρακωλύομαι	parakoliome
καταβάλω	katavalo
έντρομη	endɾomi
προσήρθα	pɾosiɾθa
πρόκυψε	procipse
πήδησα	piðisa
τσακωνικόσ	tsakonikos
γουρημάδι	ɣuɾimaði
στρίβομαι	stɾivome
αποκόπηκα	apokopika
δίδακτρα	ðiðaktɾa
ματόκλαδα	matoklaða
εμπνέομε	embneome
κλαψομούνα	klapsomuna
αρκέστηκα	aɾcestika
ποδάρια	poðaɾʝa
επαρκέστερη	epaɾcesteɾi
υποπτεύτηκα	ipopteftika
πιθανότητα	piθanotita
ζέμπρα	zebɾa
λυνόσασταν	linosastan
φούμαρα	fumaɾa
στολή	stoli
αφυδατώθηκα	afiðatoθika
ιούνηδεσ	iuniðes
ντετερμινισμόσ	determinizmos
απολογητικοί	apoloʝitici
εμπιστεύομαι	embistevome
πουτανάρα	putanaɾa
κληρονομιέμαι	kliɾonomɲeme
μουσκεμένοι	muscemeni
σύστημα	sistima
προσκαλούμαι	pɾoskalume
αποκρούομαι	apokruome
λιγοστόσ	liɣostos
μάισνερ	maizner
κοιτώ	cito
μύκονο	mikono
φυτεύομαι	fitevome
συμπλήρωσα	simbliɾono
ένρινα	enrina
προσοχή	pɾosoçi
ένρινοι	enrini
καταπίνω	katapino
κουρασμένα	kurazmena
παγωτιέρα	paɣotçeɾa
υόρκη	ioɾci
αλατίζομαι	alatizome
άραγε	aɾaʝe
διάδοχοσ	ðʝaðoxos
αλυσοδένω	alisoðeno
στενοχωρημένεσ	stenoxorimenes
ευσεβή	efsevi
τόσο	toso
αλληλεπίδρασα	alilepiðɾasa
αδειασμένοσ	aði̯azmenos
παρακείμενησ	paɾacimenis
σείω	sio
σταμάτηδων	stamatiðon
περικόβομαι	peɾikovome
λούγκρα	luɡɾa
είλκα	ilka
μάντεψε	mandepse
δάφνη	ðafni
αλευρωμένεσ	alevromenes
κερατώνω	ceɾatono
απόστασα	apostasa
μουνί	muni
ενικόσ	enikos
πλησίον	plision
εγκαθίσταμαι	eŋɡaθistame
μεταφύτευσα	metafitefsa
σελήνη	selini
αντίγραφο	andiɣɾafo
μαΐου	maiu
αναμελιέσ	anameʎes
ορθώνουμε	oɾθonume
αναποδιάζω	anapoðʝazo
δελεάζω	ðeleazo
ψωλάρα	psolaɾa
ομοφυλόφιλου	omofilofilu
υπόγραψα	ipoɣrapsa
αλαφιασμένοι	alafçazmeni
παϊδάκια	paiðaca
διαθήκη	ðiaθici
φωτογραφίστηκα	fotoɣrafistika
άργοσ	aɾɣos
δεκέμβριοι	ðeceɱvɾii
χεριά	çeɾʝa
γλυκίσματα	ɣlicizmata
ικέτευσα	icetefsa
σαγηνεύω	saʝinevo
ρόζοσ	rozos
ζηλεύω	zilevo
παμψυχισμόσ	pampsiçismos
κοροϊδέψτε	koɾoi̯ðepste
θυμωμένε	θimomene
πρησμένο	pɾizmeno
πολυσυζητημένοσ	polisizitimenos
αληθώσ	aliθos
αντικρούομε	andikruome
ψηφοδόχοσ	psifoðioxos
ανήγγελλα	anaŋɟila
εβραία	evɾea
συγκινητική	siŋɟinitici
νοέμβρηδεσ	noeɱvɾiðes
γκρίζουσ	ɡɾizus
όμορφε	omoɾfe
μαρτυρώ	maɾtiɾo
εκτελέσεισ	ektelesis
κινέζικα	cinezika
αστράφτω	astɾafto
στέκομαι	stekome
μεσαιωνική	meseonici
αβγοκομμένε	avɣokomene
χιλιάδα	çiʎaða
εξέτρεψα	eksetɾepsa
λύκοι	lici
εὐσέβεια	efsevia
τιμοκατάλογοσ	timokataloɣos
γαμάτη	ɣamati
επαρκείσ	epaɾcis
συμφυρμού	siɱfirmu
βερίκοκο	veɾikoko
φυλάσσω	filaso
φουντουκιά	funducʝa
ρόμπερτ	ɾobeɾt
ώριμοι	oɾimi
μεταφραστή	metafɾasti
συκή	siki
φούμαρε	fumaɾe
ξαποσταίνω	ksaposteno
μαλάκα	malaka
πεζομαχίασ	pezomaçias
σέρρεσ	seɾes
διαρρέομε	ðiareome
ευσεβειών	asevion
επιβιβάσθηκα	epivivasθika
κατηγορημένοσ	katiɣoɾimenos
βλαμμένων	vlamenon
αγανακτισμένων	aɣanaktizmenon
τιμοκατάλογοι	timokataloʝi
ασεβέστατα	asevestata
αποθηκεύτηκα	apoθiceftika
υποσκάπτομαι	iposkaptome
τολμάω	tolmao
πρωτομάρτυρεσ	pɾotomaɾtiɾes
περιοδικήσ	perioðicis
μάστιγα	mastiɣa
οικοδομώ	ikoðomo
αβάνα	avana
δοκιμάζομε	ðocimazome
συζητούμε	sizitume
φετίχ	fetix
σταυρόσ	stavros
αλυσοδένομαι	alisoðenome
κάθιδροσ	kaθiðros
υπολογισμένα	ipoloʝizmena
επισύναψα	episinapsa
παντρεύτηκα	pandɾeftika
εξαλείφω	eksalifo
μεσαιωνικού	meseoniku
επανειλημμένου	epanilimenu
ποικιλότερε	picilotere
βούλιαξα	vuʎaksa
κινδύνευα	cinðineva
ανεπαισθήτωσ	anepesθitos
μετάφρασα	metafɾasa
αναρμόδια	anaɾmoðia
ακαταδεξία	akataðeksia
διακόπτομαι	ðʝakoptome
παρελθούσεσ	paɾelθuses
αναστράφηκα	anastɾafika
σκαντζόχοιροσ	skandzoçiɾos
είχα	ixa
καλμάρω	kalmaɾo
τετριμμένε	tetrimene
σκορδόψωμων	skoɾðopsomon
κορνάρω	kornaro
μελετιέμαι	meletçeme
αλλόφυλοσ	alofilos
σπίτωμα	spitoma
περικόπηκα	peɾikopika
εξαπέλυσα	eksapelisa
μυθολογία	miθoloʝia
κουκλίτσα	kuklitsa
σημαδεύτηκα	simaðeftika
ρουφιέμαι	ɾufçeme
αναμμένη	anameni
εξετάστηκα	eksetastika
χώρεσα	xoɾesa
διακόπτομαι	ðiakoptome
αντέγραψα	andeɣrapsa
προηγούμενουσ	proiɣumenus
βρομόκαιροσ	vɾomoceɾos
ανεπιθύμητοσ	anepiθimitos
ερχόμενου	erxomenu
θαλαμηγό	θalamiɣo
αναζητώ	anazito
προκαταβάλλομαι	pɾokatavalome
απαρηγόρητα	apaɾiɣoɾita
αγγελοκρούστηκα	aŋɟelokrustika
γκρίζο	ɡɾizo
άνοιξη	aniksi
ανάγγειλα	anaŋɟila
απάντηση	apandisi
ανέπαλα	anepala
προβλέπουμε	pɾovlepume
πι	pi
ηδονίστηκα	iðonistika
πούδραρε	puðɾaɾe
παγίδεψα	paʝiðepsa
πρωτότυποσ	pɾototipos
ευκολότατοσ	efkolotatos
αμπαλάρισα	ambalaɾisa
σάπων	sapon
άμετε	amete
καταργήθηκα	kataɾʝiθika
αγγλοποίησα	aŋɡlopiisa
μαθημένοσ	maθimenos
παρεστιγμένη	paɾestiɣmeni
αμοργό	amoɾɣo
υπολογιστικέσ	ipoloʝistices
κακίστρεσ	kacistɾes
διαδηλώνω	ðiaðilono
συμβολομεταφραστέσ	siɱvolometafɾastes
αμοιβαίοσ	amiveos
νήσε	nise
ευσεβέστερα	efsevestera
καταστρώματα	katastromata
πνεύμονασ	pnevmonas
συμφωνούμαι	siɱfonume
αναστατώνομαι	anastatonome
δροσίζω	ðɾosizo
αναφύομαι	anafiome
αγλάισμα	aɣlaizma
βρετάνη	vretani
πίθοι	piθi
αρχιδούκισσα	aɾçiðucisa
χείλουσ	çilus
συνθλίφτηκαν	sinθliftikan
ιδρωτίλα	iðɾotila
ημερεύτε	imeɾefte
απορροφούμενουσ	apoɾofumenus
πόδι	poði
ροδακίνων	roðacinon
ζέβρα	zevɾa
αϊ	ai
βλαμμένεσ	vlamenes
δίψασα	ðipsasa
στενοχωρώ	stenoxoro
ξεμπερδεύομαι	ksebeɾðevome
καρπάθου	kaɾpaθu
βρεισ	vɾis
μπινέσ	bines
κατουράω	katuɾao
δηλώσεισ	ðilosis
υπεροχή	ipeɾoçi
κόρνα	koɾna
τιτάν	titan
απατάω	apatao
αντιγράφεισ	andiɣrafis
σκάω	skao
ομοφυλοφίλων	omofilofilon
ανεπηρέαστοσ	anepiɾeastos
μεγαλομαρτύρων	meɣalomaɾtiɾon
αισιόδοξο	esioðokso
δημοκρατίεσ	ðimokraties
αμάθεια	amaθia
καθοριστικά	kaθoɾistika
κρυμμένησ	krimenis
λυπημένοσ	lipimenos
πεινώ	pino
παραπέμπουμε	paɾapembume
δείγμα	ðiɣma
αποκλεισμένο	apoklizmeno
υπογράφηκα	ipoɣrafika
κοιτιέμαι	citçeme
αλαμπουρνέζικο	alaburneziko
νήστεψα	nistepsa
λυνόσουν	linosun
περιοδικού	perioðiku
αυνανίστηκα	avnanistika
σοφίαν	sofian
λευκέ	lefce
ταυ	taf
παντρεμένο	pandɾemeno
διακόπτομε	ðiakoptome
προσθήκη	prosθici
κούρασα	kuɾasa
στεναχωράω	stenaxorao
χωρώ	xoɾo
αλληλοσυγκρουόμενησ	alilosiŋɡruomenis
όφισ	ofis
χλιου	xʎu
ανέπαυσα	anepafsa
ιεράρχη	ierarçi
κωλομέρι	kolomeɾi
αναλυτόσ	analitos
βρέθηκα	vɾeθika
φυτικέ	fitice
χρηματοκιβώτιο	xɾimatokivotio
βούδασ	vuðas
σοφάδεσ	sofaðes
γκεσεμιού	ɟesemɲu
μαραίνομαι	maɾenome
δολοφονημένοσ	ðolofonimenos
πρεσάρισα	pɾesaɾisa
αμίλητοσ	amilitos
τρομοκράτησα	tɾomokɾatisa
εφευρίσκω	efevɾisko
μυρωμένουσ	miromenus
φαινυλαμινών	fenilaminon
καδράρισα	kaðɾaɾisa
κινδυνεύσει	cinðinefsi
καραβάνι	kaɾavani
σωρού	soɾu
γιορκ	ʝoɾk
αλευρωμένη	alevromeni
παγίδευσα	paʝiðefsa
αυτοκινητάκια	aftocinitaca
αρδεύτηκα	aɾðeftika
λατρεύομαι	latɾevome
επισυνήψα	episinipsa
τελειώθηκα	telioθika
παρακαλούμαι	parakalume
αναγράφομαι	anaɣrafome
κατέγραψα	kateɣrapsa
ιεροδουλία	ieɾoðulia
λύκοσ	likos
αγκυλιού	aŋɟiʎu
κοινόσ	cinos
σταματία	stamatia
προσεχήσ	pɾoseçis
πρόκειται	pɾocite
τριμμένου	trimenu
στρατοπέδων	stɾatopeðon
φούμαρων	fumaɾon
αλάτισα	alatisa
αβγατισμένε	avɣatizmene
περιγράφω	peɾiɣrafo
μεθαύριο	meθavɾio
ανορθόδοξοσ	anoɾθoðoksos
σιταποθήκη	sitapoθici
κοσμοπολίτησ	kozmopolitis
χεσμένουσ	çezmenus
παρεκτραπήκαν	paɾektɾapikan
εξημερώνομαι	eksimeɾonome
στέλιοσ	steʎos
κατάντησα	katandisa
αποστηθίζομαι	apostiθizome
τούρτασ	tuɾtas
μαγειρεύω	maʝiɾevo
ψηφίζομαι	psifizome
τριμμένε	trimene
βλαμμένησ	vlamenis
παρέκαμψα	paɾekampsa
ανελκύστηκα	anelcistika
ζήτησα	zitisa
επιγράφηκαν	epiɣrafikan
οφιοειδήσ	ofioiðis
κάηκα	kaika
οδέ	oðe
χαίρετε	çerete
σχημάτισα	sçimatisa
συγγραφείσ	siŋɣrafis
σοφίαισ	sofies
γεννούσα	ʝenusa
απειλώ	apilo
σπασμένοι	spazmeni
εμπνευσμένη	embnevzmeni
ψωμιών	psomɲon
υποδέχομαι	ipoðexome
ανέκρουσα	anekrusa
άσεβε	aseve
ενοχλητικά	enoxlitika
ανθό	anθo
τετριμμένοι	tetrimeni
σοφό	sofo
διαρκώ	ðiaɾko
κυνηγημένο	ciniʝimeno
φυτεύω	fitevo
σωρό	soɾo
αντιπαραβάλλομαι	andipaɾavalome
αρρωστημένων	arostimenon
εγκλείομαι	eŋɡliome
γεννήτορασ	ʝenitoras
άδικη	aðici
στιμμένεσ	stimenes
αποσιωπώ	aposiopo
βαριέμαι	varʝeme
σουτάρω	sutaɾo
εμπνευσμένων	embnevzmenon
προσελκύω	proselcio
ακριβοπληρώνομαι	akrivopliɾonome
μέσο	meso
καταφρονώ	katafɾono
παραγράφτηκα	paɾaɣɾaftika
αντιστέκομαι	andistekome
υδρόφιλοσ	iðrofilos
μειονότητασ	mionotitas
αγοράζω	aɣoɾazo
οκτωβρίου	oktovɾiu
κακοποιώ	kakopio
προηγουμένωσ	proiɣumenos
τιμόνι	timoni
ανασκευάζω	anascevazo
λονδίνο	lonðino
μαλακτικό	malaktiko
αράζω	arazo
εισέπνευσα	isepnefsa
ισορροπία	isoropia
προϊόν	pɾoion
ακύρωσα	aciɾosa
τεχνολόγουσ	texnoloɣus
πειθαναγκάσθηκα	piθanaŋɡasθika
αβουλησίεσ	avulisies
γιαλόσ	ʝalos
πανικοβάλλω	panikovalo
ανεμελιά	anameʎa
περασμένοσ	perazmenos
προπονήσεωσ	proponiseos
σπρώχνω	spɾoxno
αντιστρέφουμε	andistɾefume
δοντιού	ðondʝu
δοκιμάστηκα	ðocimastika
φυτικῆσ	fiticis
κεράτωμα	ceɾatoma
καθισμένεσ	kaθizmenes
χαλασμένου	xalazmenu
πράσινοσ	pɾasinos
τελειώνω	teliono
χλιο	xʎo
ντο	do
εξήγειρα	eksiʝiɾa
σηκωμάρα	sikomaɾa
κραγμένων	kraɣmenon
κενοτάφιο	cenotafio
υποκύπτω	ipocipto
συγκινημένεσ	siŋɟinimenes
απορρίπτομε	apoɾiptome
αρμόδιοι	aɾmoðii
ζητιανεύω	zitçanevo
λαβών	lavon
έρρινα	erina
τρίκαλα	tɾikala
μαυρισμένε	mavrizmene
αμείβω	amivo
λυνόμασταν	linomastan
σταματημένοσ	stamatimenos
έτερψα	eteɾpsa
χείλια	çiʎa
μαθεύεται	maθevete
δαγκώνομαι	ðaŋɡonome
κοινοβίτησ	cinovitis
βυζί	vizi
καταδιώκομαι	kataðiokome
αγγίζομε	aŋɟizome
λύομεν	liomen
ψηφιακών	psifiakon
σκίστηκα	scistika
χορεύτηκα	xoɾeftika
ιδρυμάτων	iðrimaton
αφεντικό	afendiko
ήγγειλα	iŋɟila
ύπνοσ	ipnos
άγιουσ	aʝius
μάζευ'	mazef
αγγούρια	aŋɡuɾʝa
παρελθών	parelθon
περασμένοι	perazmeni
έσπασα	espasa
νατο	nato
σχόλιο	sxolio
καταστρέφουμε	katastɾefume
συνήρθα	sinirθa
τσακώνω	tsakono
δευτεραγωνιστέσ	ðefteraɣonistes
συγγράφηκα	siŋɣrafika
επικαλύφτηκα	epikaliftika
κυανόσ	cianos
ερχόμενησ	erxomenis
αναφυτεύω	anafitevo
μμε	mimiepsilon
αφυδατώσεισ	afiðatosis
κοτσάριζα	kotsaɾiza
αηδιασμένα	aiðiazmena
χωράω	xoɾao
πολωνέζα	poloneza
συγγραφέασ	siŋɣrafeas
εκλαίρ	ekleɾ
προειδοποιήθηκα	pɾoiðopiiθika
συνθλίφτηκα	sinθliftika
αλωνάρη	alonaɾis
παρηγορούμε	paɾiɣoɾume
χίο	çio
αχθοφόροσ	axθoforos
πλέθρο	pleθro
αποκρύφθηκα	apokɾifθika
κουτσομπολεύομαι	kutsobolevome
αλείβω	alivo
απεκαλύφθην	apekalifθin
μουσκεμένουσ	muscemenus
βησιγότθοσ	visiɣotθos
εκκένωσα	ecenosa
εξακόσια	eksakosça
εξεγέρθηκα	ekseʝeɾθika
αβγουλάκι	avɣulaci
απογοητεύτηκα	apoɣoiteftika
παντρεμένεσ	pandɾemenes
χρωστώ	xɾosto
παρακειμένουσ	paracimenus
παιδεύω	peðevo
κρέμασα	kɾemasa
σπιτικοί	spitici
κακίστρα	kacistɾa
ωμέγα	omeɣa
πρεζάρω	pɾezaɾo
αληθήσ	aliθis
καταλύθηκε	kataliθice
αγλαϊσμένοσ	aɣlaizmenos
ντροπιαστική	dɾopçastici
μπα	ba
ρέθυμνο	ɾeθimno
αλκάλιο	alkalio
βραχώδησ	vɾaxoðis
φασολιά	fasoʎa
προσέκρουσα	prosekrusa
κύηση	ciisi
γενέσεωσ	ʝeneseos
στέκει	steci
γαμημένουσ	ɣamimenus
το	to
επαναλαμβάνω	epanalaɱvano
ψηφιακό	psifiako
ποικίλοι	picili
κυράτσα	ciɾatsa
δυσκολεύτηκα	ðiskoleftika
μέτριοσ	metrios
αποβάλομε	apovalome
σαλτάρισε	saltaɾise
ευχαριστιέμαι	efxaɾistçeme
καλαμποκόψωμο	kalambokopsomo
αποκομίζω	apokomizo
κουβάλησα	kuvalisa
προέβλεψα	pɾoevlepsa
αντικλεπτικού	andikleptiku
αιματώνω	ematono
εσώρουχο	esoɾuxo
παθαίνω	paθeno
απελπισμένε	apelpizmene
στουσ	stus
αηδιασμένε	aiðiazmene
έκθεση	ekθesi
διατυπώνομαι	ðiatiponome
θερμοκοιτίδων	θermocitiðon
στάζει	stazi
αγιοπουλιών	aʝopuʎon
βιάστηκα	viastika
αποκόμισα	apokomisa
στρατοπέδου	stɾatopeðu
καλομοίρικων	kalomirikon
αναπόφευκτοσ	anapofefktos
αποθήκευσα	apoθicefsa
ακρόαση	akroasi
φίλαγε	filaʝe
συγγραφτεί	siŋɣrafti
υποβοηθούμενων	ipovoiθumenon
ξαραχνιάζω	ksaɾaxɲazo
δανία	ðania
πλειστάκισ	plistacis
καριόλησ	kaɾʝolis
ποπόσ	popos
καταδύσεισ	kataðisis
όριο	orio
λευκάδα	lefkaða
μπαρδόν	baɾðon
ιβηρικόσ	iviɾikos
χανιά	xaɲa
αδικήθηκα	aðiciθika
αδελφή	aðelfi
παγωμένοι	paɣomeni
κωλοπαίδι	kolopeði
φαντάστηκα	fandastika
στέρηση	steɾisi
παρέκαμψε	paɾekampse
αισχύνη	esçini
ξεχνιέμαι	ksexɲeme
κραγμένουσ	kraɣmenus
κουρασμένεσ	kurazmenes
πάμμαυρε	pamavɾe
έρρευσα	erefsa
υπέθαλψα	ipeθalpsa
ἀποκυήματοσ	apociimatos
αγνώμων	aɣnomon
πιλοτάριζε	pilotaɾize
αγαντάριζα	aɣandariza
λάμπει	lambi
επισυνάφθηκαν	episinafθikan
μαόνι	maoni
έκτοσ	ektos
άκακοσ	akakos
λυπάμαι	lipame
δαίμονασ	ðemonas
μειονοψηφιών	mionopsifion
σοφάσ	sofas
ολόμαυροσ	olomavɾos
γκάρισα	ɡarisa
λυμένο	limeno
φασόλι	fasoli
υπολογίζομαι	ipoloʝizome
βόηθησα	voi̯θisa
προμνησία	pɾomnisia
μαρτυρούμαι	maɾtiɾume
αποκρούσθηκα	apokrusθika
λιπάσματοσ	lipazmatos
μειόκαινοσ	miocenos
λυνόσουνα	linosuna
λυμένοσ	limenos
νικημένεσ	nicimenes
ματώθηκα	matoθika
θλιβερό	θliveɾo
μουσκεμένου	muscemenu
καθορίσθηκα	kaθoɾisθika
ντελιβεράδεσ	deliveraðes
απριλίων	apɾilion
τεχνολογίεσ	texnoloʝies
διασπώ	ðiaspo
καταναγκάστηκα	katanaŋɡastika
φιλώ	filo
παραέβαλα	paɾaevala
γεροντοκρατία	ʝeɾondokɾatia
ήπειροσ	ipiros
ζωή	zoi
αυτί	afti
κουτσομπόλησ	kutsobolis
χρησιμοποίησα	xɾisimopiisa
άργησα	aɾʝisa
φιλοσοφία	filosofia
χαζοκούτι	xazokuti
κατεργάσθηκα	katerɣasθika
κάστανο	kastano
ιατρείο	iatɾio
ηλικιωμένεσ	iliciomenes
προπόνηση	proponisi
μειονοτήτων	mionotiton
συμβολομεταφραστή	siɱvolometafɾasti
φυλλομετρούμε	filometɾume
περνά	peɾna
κουνέλι	kuneli
εσωκλείομαι	esokliome
σερβιρίζω	seɾviɾizo
κεράσι	ceɾasi
αναπαύσεισ	anapafsis
ανακρούω	anakruo
στρέφομαι	stɾefome
κρυμμένεσ	krimenes
ανεπαίσθητοσ	anepesθitos
υπέκρυψα	ipekɾipsa
φυτική	fitici
πιστεύομε	pistevome
αγριεύω	aɣɾievo
αφορά	afora
αποκυήματα	apociimata
γαμημένοι	ɣamimeni
συνάπτουμε	sinaptume
σύρω	siro
αποδεχθεί	apoðexθi
βασανίστρια	vasanistɾia
καλύπτουμε	kaliptume
παίζομαι	pezome
εμβατήριο	eɱvatiɾio
απορροφώμαι	apoɾofome
πομφόλυγεσ	poɱfoliʝes
οφιοειδείσ	ofioiðis
ανασκάφτομαι	anaskaftome
λιγάκι	liɣaci
αλλοίωσα	aliosa
σύναψα	sinapsa
όντωσ	ondos
βρωμώ	vɾomo
υποβοηθούμενησ	ipovoiθumenis
κηροπήγιο	ciɾopiʝio
παρενέργεια	paɾeneɾʝia
εγκαταλείπομαι	eŋɡatalipome
γενοκτονία	ʝenoktonia
πεπεισμένεσ	pepizmenes
καλέ	kale
λογοκρίνομαι	loɣokɾinome
αξιοσημείωτων	aksiosimioton
κοινωνάω	cinonao
ρωμαίοσ	ɾomeos
κιτσ	cits
κώστασ	kostas
οδών	oðon
όμορφων	omoɾfon
τίνα	tina
παρακολουθιέμαι	paɾakoluθçeme
συγκρούστηκα	siŋɡrustika
ορθώθηκα	oɾθoθika
παρεστιγμένοι	paɾestiɣmeni
διακόσια	ðʝakosia
σώπα	sopa
παρελθόντοσ	parelθondos
τόση	tosi
τελειώνομαι	telionome
λευχαιμία	lefçemia
φαιόσ	feos
αναπάλθηκα	anapalθika
χαραμίζομαι	xaɾamizome
κοσμάκη	kozmaci
εξολόθρευσα	eksoloθɾefsa
ρουφώ	ɾufo
αναμαλλιασμένων	anamaʎazmenon
ύβρισ	ivɾis
αβανγκαρντισμού	avaŋɡaɾdizmu
εισιτήριο	isitiɾio
κυριακάτικοσ	cirʝakatikos
ψωμιέρασ	psomɲeras
αρνήθηκα	aɾniθika
παραγραφτήκαν	paɾaɣɾaftikan
αρπάζω	aɾpazo
πρωτοκολλημένοσ	pɾotokolimenos
κεραμίδι	ceɾamiði
αξιόπιστοσ	aksiopistos
πανεύκολα	panefkola
φυλάχθηκα	filaxθika
υπογραφείσ	ipoɣɾafis
γητεύω	ʝitevo
νερό	nero
φύλαξα	filaksa
δένομαι	ðenome
αιχμαλωτίζομαι	exmalotizome
σουίτα	suita
εγκαθιδρύουμε	eŋɡaθiðriume
τρεισήμισι	tɾisimisi
υποβοηθούμενα	ipovoiθumena
σύμβουλοσ	siɱvulos
καινοτομίασ	cenotomias
ζητιάνεψε	zitçanepse
έτρεψα	etɾepsa
συγγράφουμε	siŋɣrafume
αποδέχθηκα	apoðexθika
σερβίρισα	seɾviɾisa
λύνουν	linun
διψασμένο	ðipsazmeno
αηδήσ	aiðis
τζέτζησ	dzedzis
παρηγοράμε	paɾiɣoɾame
ξέκωλη	ksekoli
ενδιαφέρω	enði̯afeɾo
βάλλω	valo
διατυπώνω	ðiatipono
τηλεθέαση	tileθeasi
μία	mia
προσκόπτω	pɾoskopto
αρχίζω	arçizo
αναγκαίοσ	anaŋɟeos
πουστεύω	pustevo
εφοδιάστηκα	efoðiastika
πολιτιστικόσ	politistikos
αβγατισμένοσ	avɣatizmenos
ψήφου	psifu
αϊόβα	aiova
κάλλιο	kaʎo
παίζουμε	pezume
καταλύομε	kataliome
έλυσα	elisa
οστεοφυλάκιο	osteofilacio
γαμιέμαι	ɣamɲeme
πλειονοψηφίασ	plionopsifias
ιατρεύομαι	iatɾevome
