जलसा	d͡ʒəl̪s̪äː
छूना	t͡ʃʰuːn̪äː
फ़तवा	pʰət̪wäː
हमला	ɦə̃ml̪äː
सहस्रमान	s̪ɛɦɛs̪ɾəmä̃ːn̪
खाली	kʰäːl̪iː
इलाज	ɪl̪äːd͡ʒ
संयोग	s̪ə̃joːɡ
आइज़ोल	äːɪzoːl̪
धर्मस्थलों	d̪ʱəɾməs̪t̪ʰəl̪õː
फ़ीस	pʰiːs̪
गुलज़ार	ɡʊl̪zäːɾ
संक्रामक	s̪ə̃ŋkɾäːmək
मज़लूम	məd͡ʒl̪ũːm
शुक्रगुज़ार	ʃʊkɾəɡʊzäːɾ
चूल्हा	t͡ʃuːl̪ɦäː
देखना	d̪eːkʰn̪äː
ख़ुशनसीब	kʰʊʃn̪əs̪iːb
बछड़ा	bət͡ʃʰɽäː
संबंध	s̪ə̃mbə̃n̪d̪ʱ
अव्यवस्था	əʋjəʋəs̪t̪ʰäː
ऋणायन	ɾɪɳäːjə̃n̪
कम्पन	kə̃mpə̃n̪
समायोजित	s̪əmäːjoːd͡ʒɪt̪
अलबत्ता	əl̪bət̪̚t̪äː
अर्थशास्त्री	əɾt̪ʰəʃäːs̪t̪ɾiː
सूक्ष्माणु	s̪uːkʃmäːɳuː
छितराना	t͡ʃʰɪt̪ɾäːn̪äː
कानून	käːn̪ũːn̪
वाचिक	ʋäːt͡ʃɪk
ल्हासा	l̪ɦäːs̪äː
धोना	d̪ʱoːn̪äː
फैसला	fɛːs̪l̪äː
अर्धसरकारी	əɾd̪ʱs̪əɾkäːɾiː
मधुशाला	məd̪ʱʊʃäːl̪äː
अविचल	əʋɪt͡ʃəl̪
सेनेगल	s̪eːn̪eːɡəl̪
तख़्तापलट	t̪əxt̪äːpəl̪əʈ
विश्वासघात	ʋɪʃʋäːs̪ɡʱäːt̪
भड़काऊ	bʱəɽkäːuː
तजुर्बा	t̪əd͡ʒʊɾbäː
ज़ुकाम	zʊkä̃ːm
उत्पीठिका	ʊt̪piːʈʰɪkäː
टलना	ʈəl̪n̪äː
उनका	ʊ̃n̪käː
अंत्येष्टि	ə̃n̪t̪jeːʃʈiː
लोकाचार	l̪oːkäːt͡ʃäːɾ
भूल	bʱuːl̪
आकर्षक	äːkəɾʃək
ताम्र	t̪ä̃ːmɾᵊ
वाक़ई	ʋäːkəiː
डायनोसोर	ɖäːjn̪oːs̪oːɾ
कमीना	kəmiːn̪äː
योग्यकार्ता	joːɡjəkäːɾt̪äː
अनुवांशिकी	ən̪ʊʋä̃ːn̪ʃɪkiː
सेंटीमीटर	s̪ẽːɳʈiːmiːʈəɾ
दिहाड़ी	d̪ɪɦäːɽiː
धनुर्विद्या	d̪ʱən̪ʊɾʋɪd̪jäː
प्राचल	pɾäːt͡ʃəl̪
कडपा	kəɖpäː
बिजली	bɪd͡ʒl̪iː
पटकना	pəʈəkn̪äː
पराठा	pəɾäːʈʰäː
केंद्र	kẽːn̪d̪ɾᵊ
मख़मल	məxməl̪
हंस	ɦə̃n̪s̪
फ़्रान्सीसी	pʰɾä̃ːn̪s̪iːs̪iː
बिजलीघर	bɪd͡ʒl̪iːɡʱəɾ
म्यान्मा	mjä̃ːn̪mäː
आया	äːjäː
भुगतना	bʱʊɡət̪̚n̪äː
वेबकॅम	ʋeːbkæ̃m
साक्षी	s̪äːkʃiː
अनाथालय	ən̪äːt̪ʰäːl̪əj
छोला	t͡ʃʰoːl̪äː
आग	äːɡ
तेरा	t̪eːɾäː
रस्म	ɾəs̪ə̃m
एकतरफ़ा	eːkt̪əɾfäː
मुहावरा	mʊɦäːʋɾäː
कार्ड	käːɾɖ
आकृष्ट	äːkɾɪʂʈ
स्वाभाविक	s̪ʋäːbʱäːʋɪk
वायुमंडलीय	ʋäːjʊmə̃ɳɖl̪iːjᵊ
बेज़बान	beːzbä̃ːn̪
माशूक़	mäːʃuːq
आप्रवास	äːpɾəʋäːs̪
बहलना	bɛɦɛl̪n̪äː
मैंने	mɛ̃ːn̪eː
थकान	t̪ʰəkä̃ːn̪
बल	bəl̪
हुक्मरान	ɦʊkmɾä̃ːn̪
बलगतिकी	bəl̪ɡət̪ɪkiː
आशिक़मिज़ाज	äːʃɪqmɪzäːd͡ʒ
अध्यापक	əd̪ʱjäːpək
कष्टसाध्य	kəʂʈs̪äːd̪ʱjᵊ
हिंदी	ɦɪ̃n̪d̪iː
लखन	l̪əkʰə̃n̪
भाषाविद्	bʱäːʃäːʋɪd̪
महबूबा	mɛɦbuːbäː
कोष्ठक	koːʃʈʰək
चुम्मा	t͡ʃʊ̃mmäː
शिवालय	ʃɪʋäːl̪əj
चाँद	t͡ʃä̃ːn̪d̪
घुसड़ना	ɡʱʊs̪əɽn̪äː
बहिर्वेशन	bəɦɪɾʋeːʃə̃n̪
नामकरण	n̪ä̃ːmkəɾə̃ɳ
विस्तार	ʋɪs̪t̪äːɾ
फालतू	fäːl̪t̪uː
शख़्सियत	ʃəxs̪ijət̪
गाउँ	ɡäːũː
आकार	äːkäːɾ
ब्यान	bjä̃ːn̪
पहरा	pɛɦɾäː
लुग़त	l̪ʊɡət̪
महत्वपूर्ण	mɛɦɛt̪wəpuːɾɳ
आयातक	äːjäːt̪ək
दराज़	d̪əɾäːz
टेलिविजन	ʈeːl̪ɪʋɪd͡ʒə̃n̪
वापस	ʋäːpəs̪
रचनावली	ɾət͡ʃn̪äːʋəl̪iː
उलूक	ʊl̪uːk
बलिदान	bəl̪ɪd̪ä̃ːn̪
समावेश	s̪əmäːʋeːʃ
फ़ाख़्ता	fäːxt̪äː
झोली	d͡ʒʱoːl̪iː
संगोष्ठी	s̪ə̃ŋɡoːʃʈʰiː
एकाएक	eːkäːeːk
ख़ुशनसीब	xʊʃn̪əs̪iːb
लज्जित	l̪əd̚d͡ʒɪt̪
क़िस्सा	qɪs̪s̪äː
पहला	pɛɦl̪äː
अंग्रेजी	ə̃ŋɡɾeːziː
मसूर	məs̪uːɾ
आफ़त	äːpʰət̪
अचंभा	ət͡ʃə̃mbʱäː
खंड	kʰə̃ɳɖ
पगडंडी	pəɡɖə̃ɳɖiː
दौलतमंद	d̪ɔːl̪ət̪mə̃n̪d̪
पुतली	pʊt̪l̪iː
माँग	mä̃ːŋɡ
अहं	ɛɦɛ̃
चटकारा	t͡ʃəʈkäːɾäː
बेदख़ल	beːd̪əkʰl̪ᵊ
हथ्यार	ɦət̪ʰjäːɾ
जलपान	d͡ʒəl̪pä̃ːn̪
शैंपू	ʃɛ̃ːmpuː
सुरक्षा	s̪ʊɾəkʃäː
फटफटिया	pʰəʈpʰəʈijäː
गुल्लक	ɡʊl̪l̪ək
जाहिल	d͡ʒäːɦɪl̪
गिरफ़्तार	ɡɪɾəpʰt̪äːɾ
वालिदैन	ʋäːl̪ɪd̪ɛ̃ːn̪
ज़मानत	zəmäːn̪ət̪
रंजन	ɾə̃n̪d͡ʒə̃n̪
प्रासंगिक	pɾäːs̪ə̃ŋɡɪk
आकाशी	äːkäːʃiː
सुनना	s̪ʊ̃n̪n̪äː
समोसा	s̪əmoːs̪äː
रंजित	ɾə̃n̪d͡ʒɪt̪
हुस्न	ɦʊs̪n̪
ऋषिकेश	ɾɪʃɪkeːʃ
खच्चर	kʰət̚t͡ʃəɾ
आरज़ू	äːɾd͡ʒuː
बिचौलिया	bɪt͡ʃɔːl̪ijäː
अपराधी	əpɾäːd̪ʱiː
असम	əs̪ə̃m
आजादी	äːd͡ʒäːd̪iː
सैकड़ा	s̪ɛːkɽäː
इस्म	ɪs̪m
बचना	bət͡ʃn̪äː
सलामत	s̪əl̪äːmət̪
माफ़	mäːpʰ
आ	äː
संग्राम	s̪ə̃ŋɡɾä̃ːm
कैरम	kɛːɾə̃m
असमान	əs̪əmä̃ːn̪
बंदीघर	bə̃n̪d̪iːɡʱəɾ
सुसंगत	s̪ʊs̪ə̃ŋɡət̪
सेल्फ़ी	s̪eːl̪pʰiː
असमंजस	əs̪əmə̃n̪d͡ʒəs̪
गुंडागर्दी	ɡʊ̃ɳɖäːɡəɾd̪iː
सम्मति	s̪ə̃mmət̪iː
श्रीलंका	ʃɾiːl̪ə̃ŋkäː
सब्र	s̪əbɾ
बुड्ढा	bʊɖ̚ɖʱäː
ग़ायब	ɣäːjb
चलाना	t͡ʃəl̪äːn̪äː
रिवाज़	ɾɪʋäːd͡ʒ
घराना	ɡʱəɾäːn̪äː
प्रतिक्रियावादी	pɾət̪ɪkɾijäːʋäːd̪iː
संप्रति	s̪ə̃mpɾət̪iː
हिम	ɦɪ̃m
अंबर	ə̃mbəɾ
बुरक़ा	bʊɾqäː
चिरंजीव	t͡ʃɪɾə̃n̪d͡ʒiːʋ
कागद	käːɡəd̪
मसका	məs̪käː
रज़ामंदी	ɾəzäːmə̃n̪d̪iː
लिखने	l̪ɪkʰn̪eː
साज़िश	s̪äːd͡ʒɪʃ
गिलास	ɡɪl̪äːs̪
साउथहैंपटन	s̪äːʊt̪ʰɦɛ̃ːmpʈə̃n̪
अल्पावस्था	əl̪päːʋəs̪t̪ʰäː
रेलवे	ɾeːl̪ʋeː
थपथपाना	t̪ʰəpət̪ʰpäːn̪äː
आगा	äːɡäː
नारा	n̪äːɾäː
डार्विन	ɖäːɾʋɪ̃n̪
क़ुरान	qʊɾä̃ːn̪
बाँचना	bä̃ːt͡ʃn̪äː
झगड़ालू	d͡ʒʱəɡɽäːl̪uː
नकेल	n̪əkeːl̪
मिक्सर	mɪks̪əɾ
क़ानूनगो	qäːn̪ũːn̪ɡoː
महफिल	mɛɦfɪl̪
बंग्ली	bə̃ŋɡl̪iː
कंडीशनर	kə̃ɳɖiːʃn̪əɾ
समझाना	s̪ə̃md͡ʒʱäːn̪äː
होशियार	ɦoːʃijäːɾ
आकाशगंगा	äːkäːʃɡə̃ŋɡäː
मानववाद	mäːn̪əʋʋäːd̪
परंपरागत	pəɾə̃pəɾäːɡət̪
पुतला	pʊt̪l̪äː
स्टेशन	ɪs̪ʈeːʃə̃n̪
खिलवाना	kʰɪl̪ʋäːn̪äː
छंटना	t͡ʃʰə̃ɳʈn̪äː
दाँत	d̪ä̃ːt̪
नौकरशाही	n̪ɔːkəɾʃäːɦiː
नागालैंड	n̪äːɡäːl̪ɛ̃ːɳɖ
तापक्रम	t̪äːpəkɾə̃m
जोबन	d͡ʒoːbə̃n̪
बहुत	bɔɦɔt̪
परिपाटी	pəɾɪpäːʈiː
बेलचा	beːl̪t͡ʃäː
दिखावा	d̪ɪkʰäːʋäː
बहस	bɛɦɛs̪
बेअक़्ल	beːəkl̪ᵊ
लुभाना	l̪ʊbʱäːn̪äː
फ़ीलपाँव	pʰiːl̪pä̃ːʋ
डायनासोर	ɖäːjn̪äːs̪oːɾ
पत्नी	pət̪̚n̪iː
शक्ल	ʃəkl̪ᵊ
नई	n̪əiː
बेशुमार	beːʃʊmäːɾ
असहिष्णु	əs̪əɦɪʃɳuː
ढोल	ɖʱoːl̪
समायोजन	s̪əmäːjoːd͡ʒə̃n̪
मंगोलिया	mə̃ŋɡoːl̪ijäː
लेबनान	l̪eːbn̪ä̃ːn̪
यमुना	jəmʊn̪äː
परिभाषा	pəɾɪbʱäːʃäː
फ़ारिग़	pʰäːɾɪɡ
पिघलाना	pɪɡʱl̪äːn̪äː
प्रश्न	pɾəʃn̪ə
स्वभाव	s̪ʋəbʱäːʋ
चंपा	t͡ʃə̃mpäː
ताजपोशी	t̪äːd͡ʒpoːʃiː
पत्थरबाज़	pət̪̚t̪ʰəɾbäːd͡ʒ
धनराशि	d̪ʱə̃n̪ɾäːʃiː
मार्फ़िया	mäːɾfijäː
ज़बान	zəbä̃ːn̪
लाई	l̪äːiː
पहेली	pəɦeːl̪iː
हराम	ɦəɾä̃ːm
मीरा	miːɾäː
संरक्षणवाद	s̪ə̃ɾəkʃə̃ɳwäːd̪
घुंघरू	ɡʱʊ̃ŋɡʱɾuː
आस्तीन	äːs̪t̪ĩːn̪
परात	pəɾäːt̪
तिरसठ	t̪ɪɾs̪əʈʰ
प्रस्थान	pɾəs̪t̪ʰä̃ːn̪
गर्दन	ɡəɾd̪ə̃n̪
सत्तासी	s̪ət̪̚t̪äːs̪iː
लक्ष्मी	l̪əkʃmiː
निवाला	n̪ɪʋäːl̪äː
मुक़ाबला	mʊqäːbl̪äː
गाण्डू	ɡä̃ːɳɖuː
ग्वाला	ɡʋäːl̪äː
बुर्जुआ	bʊɾd͡ʒʊäː
नामोत्पत्ति	n̪äːmoːt̪pət̪̚t̪iː
नागरिक	n̪äːɡəɾɪk
दारुलहुकूमत	d̪äːɾʊl̪ɦʊkuːmət̪
अप्रत्यक्ष	əpɾət̪jəkʃ
कन्हैया	kə̃n̪ɦə̯ijäː
मेलबॉर्न	meːl̪bɔɾn̪
खुबानी	xuːbäːn̪iː
स्वस्थ	s̪ʋəs̪t̪ʰ
लिखनेवाला	l̪ɪkʰn̪eːʋäːl̪äː
मुजाहिदीन	mʊd͡ʒäːɦɪd̪ĩːn̪
बिन	bɪ̃n̪
आसन्द	äːs̪ə̃n̪d̪
भूटान	bʱuːʈä̃ːn̪
देहांत	d̪eːɦä̃ːn̪t̪
वीज़ा	ʋiːd͡ʒäː
लौकी	l̪ɔːkiː
फ़व्वारा	pʰəʋʋäːɾäː
विद्यार्थिनी	ʋɪd̪jäːɾt̪ʰɪn̪iː
जंगम	d͡ʒə̃ŋɡə̃m
नेक	n̪eːk
अग्निशस्त्र	əɡn̪ɪʃəs̪t̪ɾᵊ
सूर्यास्त	s̪uːɾjäːs̪t̪
तेहरान	t̪eːɦɾä̃ːn̪
इजाज़त	ɪd͡ʒäːzət̪
बिछौना	bɪt͡ʃʰɔːn̪äː
सौरमंडल	s̪ɔːɾmə̃ɳɖəl̪
मअनी	məən̪iː
बासन	bäːs̪ə̃n̪
पौष	pɔːʃ
परवाज़	pəɾʋäːd͡ʒ
चोंच	t͡ʃõːn̪t͡ʃ
दरमियानी	d̪əɾmijäːn̪iː
आलु	äːl̪uː
उत्सर्जन	ʊt̪s̪əɾd͡ʒə̃n̪
पाया	päːjäː
भौतिकवाद	bʱɔːt̪ɪkwäːd̪
सुलझाना	s̪ʊl̪d͡ʒʱäːn̪äː
टिकाऊ	ʈɪkäːuː
स्लोवेनियन	s̪l̪oːʋeːn̪ijə̃n̪
सरसों	s̪əɾs̪õː
शास्त्र	ʃäːs̪t̪ɾᵊ
चुकना	t͡ʃʊkn̪äː
कूटनीतिक	kuːʈn̪iːt̪ɪk
चुपचाप	t͡ʃʊpt͡ʃäːp
पत्रकार	pət̪ɾəkäːɾ
तिरुचिरापल्ली	t̪ɪɾʊt͡ʃɪɾäːpəl̪l̪iː
नस्तालीक़	n̪əs̪t̪äːl̪iːk
शुक्रिया	ʃʊkɾijäː
दिल्ली	d̪ɪl̪l̪iː
कल्टी	kəl̪ʈiː
पालना	päːl̪n̪äː
ओढ़ना	oːɽʱn̪äː
जहाँगीर	d͡ʒəɦä̃ːŋɡiːɾ
बोलने	boːl̪n̪eː
मुबारकबाद	mʊbäːɾəkbäːd̪
चित्रकार	t͡ʃɪt̪ɾəkäːɾ
असामयिक	əs̪äːməjɪk
वाणिज्य	ʋäːɳɪd͡ʒjᵊ
प्रभारी	pɾəbʱäːɾiː
अजिल्द	əd͡ʒɪl̪d̪
बहुव्रीहि	bɔɦɔʋɾiːɦiː
इनको	ɪ̃n̪koː
न्यायपालिका	n̪jäːjpäːl̪ɪkäː
खुजलाना	kʰʊd͡ʒl̪äːn̪äː
ऐयाशी	ə̯ijäːʃiː
तृष्णा	t̪ɾɪʃɳäː
सुबोध	s̪ʊboːd̪ʱ
भाँति	bʱä̃ːn̪t̪iː
देशव्यापी	d̪eːʃəʋjäːpiː
प्रवास	pɾəʋäːs̪
मुसाफ़िर	mʊs̪äːfɪɾ
शूरसेन	ʃuːɾs̪ẽːn̪
आकर्षण	äːkəɾʃə̃ɳ
चिट्ठी	t͡ʃɪʈ̚ʈʰiː
स्नायु	s̪n̪äːjuː
टीम	ʈĩːm
असंख्य	əs̪ə̃ŋkʰjᵊ
यवशर्करा	jəʋʃəɾkəɾäː
आरामगाह	äːɾä̃ːmɡäːɦ
अहोभाग्य	əɦoːbʱäːɡjᵊ
सदर	s̪əd̪ɾ
जायज़ा	d͡ʒäːjzäː
तशद्दुद	t̪əʃəd̪̚d̪ʊd̪
सबक	s̪əbəq
असत्य	əs̪ət̪jᵊ
गणतंत्र	ɡə̃ɳt̪ə̃n̪t̪ɾᵊ
गौरवशाली	ɡɔːɾəʋʃäːl̪iː
सिफ़ारतख़ाना	s̪ɪfäːɾət̪xäːn̪äː
टटोलना	ʈəʈoːl̪n̪äː
अलंकार	əl̪ə̃ŋkäːɾ
केरल	keːɾəl̪
मेहमानदारी	meːɦmä̃ːn̪d̪äːɾiː
क्रेता	kɾeːt̪äː
अरबिंद	əɾbɪ̃n̪d̪
तालियों	t̪äːl̪ijõː
ग़मज़दा	ɣəməzd̪äː
घना	ɡʱən̪äː
ख़ुलासा	xʊl̪äːs̪äː
जुलाई	d͡ʒʊl̪äːiː
शागिर्द	ʃäːɡɪɾd̪
ज़बानी	zəbäːn̪iː
दुमन	d̪ʊmə̃n̪
चल	t͡ʃəl̪
विनिधान	ʋɪn̪ɪd̪ʱä̃ːn̪
पाठ्य	päːʈʰjᵊ
अमृत	ə̃mɾɪt̪
विराजमान	ʋɪɾäːd͡ʒmä̃ːn̪
नस्ल	n̪əs̪l̪ᵊ
कारखाना	käːɾxäːn̪äː
वैकुंठ	ʋɛːkʊ̃ɳʈʰ
सेहत	s̪eːɦət̪
पट्टिका	pəʈ̚ʈɪkäː
मुक्केबाज़	mʊk̚keːbäːz
क़रीबन	qəɾiːbə̃n̪
ग़ाज़ियाबाद	ɡäːd͡ʒijäːbäːd̪
तीखा	t̪iːkʰäː
अहिवात	əɦɪʋäːt̪
क्रमागत	kɾəmäːɡət̪
अखिलेश	əkʰɪl̪eːʃ
भाग	bʱäːɡ
रिमझिम	ɾɪ̃md͡ʒʱɪ̃m
कालद्वीप	käːl̪əd̪wiːp
सुडौल	s̪ʊɖɔːl̪
क़िस्म	kɪs̪m
चीनी	t͡ʃiːn̪iː
होन्शू	ɦõːn̪ʃuː
नूह	n̪uːɦ
चौका	t͡ʃɔːkäː
ख़रीदवाना	xəɾiːd̪wäːn̪äː
कुल्चा	kʊl̪t͡ʃäː
क़ाज़ी	qäːziː
दाख़िल	d̪äːkʰɪl̪
सेब	s̪eːb
भूखा	bʱuːkʰäː
कोरियाई	koːɾijäːiː
सन्निकट	s̪ə̃n̪n̪ɪkəʈ
आज़ाद	äːzäːd̪
इक्यासी	ɪkjäːs̪iː
सुल्टाना	s̪ʊl̪ʈäːn̪äː
प्रताड़ित	pɾət̪äːɽɪt̪
नवजीवन	n̪əʋd͡ʒiːʋə̃n̪
सीरिया	s̪iːɾijäː
तालव्य	t̪äːl̪əʋjə
दीपावली	d̪iːpäːʋl̪iː
मददगार	məd̪əd̪ɡäːɾ
अनिश्चितता	ən̪ɪʃt͡ʃɪt̪̚t̪äː
कार्यान्वित	käːɾjä̃ːn̪wɪt̪
खनन	kʰən̪ə̃n̪
वीज़ा	ʋiːzäː
सेंकना	s̪ẽːŋkn̪äː
कंजूस	kə̃n̪d͡ʒuːs̪
चील	t͡ʃiːl̪
सुविधा	s̪ʊʋɪd̪ʱäː
मानसिकता	mä̃ːn̪s̪ɪkt̪äː
शिकार	ʃɪkäːɾ
नवनीत	n̪əʋn̪iːt̪
बिगुल	bɪɡʊl̪
खोंसना	kʰõːn̪s̪n̪äː
न्यायाधीश	n̪jäːjäːd̪ʱiːʃ
ओला	oːl̪äː
ऊना	uːn̪äː
तरफ़दार	t̪əɾəpʰd̪äːɾ
शलभ	ʃəl̪əbʱ
सॉफ़्टवेयर	s̪ɔfʈəʋeːjəɾ
विश्लेषण	ʋɪʃl̪eːʃə̃ɳ
अविकसित	əʋɪks̪ɪt̪
सच्चरित्र	s̪ət̚t͡ʃəɾɪt̪ɾᵊ
निर्णायक	n̪ɪɾɳäːjək
आइंदा	äːɪ̃n̪d̪äː
लौ	l̪ɔː
क्षम्य	kʃə̃mjᵊ
मुलायम	mʊl̪äːjə̃m
काव्य	käːʋjᵊ
बदलाव	bəd̪l̪äːʋ
फ़ीता	pʰiːt̪äː
आफिस	äːpʰɪs̪
क़रार	kəɾäːɾ
नति	n̪ət̪iː
गोलंदाज़	ɡoːl̪ə̃n̪d̪äːd͡ʒ
ज़ुल्म	d͡ʒʊl̪m
अजवाइन	əd͡ʒʋäːɪ̃n̪
जलीय	d͡ʒəl̪iːjᵊ
ज़िंदा	d͡ʒɪ̃n̪d̪äː
घन	ɡʱə̃n̪
गुजराती	ɡʊd͡ʒɾäːt̪iː
कलमकारी	kəl̪ə̃mkäːɾiː
सफ़रनामा	s̪əpʰəɾn̪äːmäː
सार्वत्रिक	s̪äːɾʋət̪ɾɪk
स्नानघर	s̪n̪ä̃ːn̪ɡʱəɾ
अनूप	ən̪uːp
संस्कारी	s̪ə̃n̪s̪käːɾiː
कायनात	käːjn̪äːt̪
नज़रबंदी	n̪əzəɾbə̃n̪d̪iː
तेजपत्ता	t̪eːd͡ʒpət̪̚t̪äː
तंज़ानिया	t̪ə̃d͡ʒäːn̪ijäː
अनुमानतः	ən̪ʊmä̃ːn̪t̪əɦ
लोकतांत्रिक	l̪oːkt̪ä̃ːn̪t̪ɾɪk
विकिरणशीलता	ʋɪkɪɾə̃ɳʃiːl̪t̪äː
नहि	n̪əɦiː
पलटवार	pəl̪əʈwäːɾ
ठिठुरना	ʈʰɪʈʰʊɾn̪äː
तग़ाफ़ुल	t̪əɡäːpʰʊl̪
ख़ुराफ़ात	kʰʊɾäːpʰäːt̪
विनाशकारी	ʋɪn̪äːʃkäːɾiː
शिनजियांग	ʃɪ̃n̪d͡ʒijä̃ːŋɡ
संवाद	s̪ə̃mwäːd̪
नी	n̪iː
कक्षा	kəkʃäː
चखना	t͡ʃəkʰn̪äː
तानाशाह	t̪äːn̪äːʃäːɦ
दोपहर	d̪oːpɛɦɛɾ
जलेबी	d͡ʒəl̪eːbiː
अस्पष्ट	əs̪pəʂʈ
आदाब	äːd̪äːb
स़िफ़र	s̪ɪpʰəɾ
इख़्तियार	ɪxt̪ijäːɾ
अल्हड़	əl̪ɦəɽ
यौवनकाल	jə̯uʋə̃n̪käːl̪
खलना	kʰəl̪n̪äː
वायदा	ʋäːjd̪äː
ग़ुस्लख़ाना	ɡʊs̪l̪kʰäːn̪äː
आयातकर्ता	äːjäːt̪kəɾt̪äː
कोड़ा	koːɽäː
भोंकना	bʱõːŋkn̪äː
विनिर्माण	ʋɪn̪ɪɾmä̃ːɳ
आवंटन	äːʋə̃ɳʈə̃n̪
चोरना	t͡ʃoːɾn̪äː
कनीज़	kən̪iːz
शनिवार	ʃən̪ɪʋäːɾ
इसमाईल	ɪs̪mäːiːl̪
मेहमाननवाज़ी	meːɦmä̃ːn̪n̪əʋäːd͡ʒiː
भारोत्तोलक	bʱäːɾoːt̪̚t̪oːl̪ək
फ़ना	fən̪äː
नमाज़गाह	n̪əmäːzɡäːɦ
बक़ाया	bəkäːjäː
शख्स	ʃəkʰs̪
आशय	äːʃəj
लय	l̪əj
स्पैनिश	s̪pɛːn̪ɪʃ
मीम	mĩːm
किया	kijäː
बरामदा	bəɾä̃ːmd̪äː
आदम	äːd̪ə̃m
दाग़	d̪äːɣ
नेपाली	n̪eːpäːl̪iː
खिलाड़ी	kʰɪl̪äːɽiː
अस्थिरता	əs̪t̪ʰɪɾt̪äː
गुनगुनाना	ɡʊ̃n̪ɡʊn̪äːn̪äː
नब्बे	n̪əb̚beː
आराम	ɑːɾɑːm
बालकेलि	bäːl̪keːl̪iː
फ़सल	pʰəs̪əl̪
विकसित	ʋɪks̪ɪt̪
सिफ़त	s̪ɪfət̪
दक्खिन	d̪ək̚kʰɪ̃n̪
संघीय	s̪ə̃ŋɡʱiːjᵊ
बीजांडासन	biːd͡ʒä̃ːɳɖäːs̪ə̃n̪
लिसान	l̪ɪs̪ä̃ːn̪
उरोस्थि	ʊɾoːs̪t̪ʰiː
गूंजना	ɡũːn̪d͡ʒn̪äː
फ़ारसी	pʰäːɾs̪iː
पट्टी	pəʈ̚ʈiː
फ़ॉर्मूला	pʰɔɾmuːl̪äː
ग़ुसल	ɣʊs̪əl̪
शायराना	ʃäːjɾäːn̪äː
सुरिनाम	s̪ʊɾɪn̪ä̃ːm
क्रमसूचक	kɾə̃ms̪uːt͡ʃək
अवैतनिक	ʋɛːt̪ən̪ɪk
राजनय	ɾäːd͡ʒn̪əj
विचारपूर्वक	ʋɪt͡ʃäːɾpuːɾʋək
बम्बई	bə̃mbəiː
सलाहकार	s̪əl̪äːɦkäːɾ
दफ़न	d̪əpʰn̪
फोन	fõːn̪
अटकलपच्चू	əʈkəl̪pət̚t͡ʃuː
नर्तकी	n̪əɾt̪əkiː
संगम	s̪ə̃ŋɡə̃m
बला	bəl̪äː
यथार्थ	jət̪ʰäːɾt̪ʰ
गँवाना	ɡə̃ʋäːn̪äː
बुद्धिमान	bʊd̪̚d̪ʱɪmä̃ːn̪
विख्यात	ʋɪkʰjäːt̪
रूहानियत	ɾuːɦäːn̪ijət̪
अधिलाभ	əd̪ʱɪl̪äːbʱ
आधा	äːd̪ʱäː
नीलगाय	n̪iːl̪ɡäːj
पताका	pət̪äːkäː
राज़	ɾäːz
तुलनात्मक	t̪ʊl̪ən̪äːt̪mək
ख़ानदान	kʰä̃ːn̪d̪ä̃ːn̪
चौंतीस	t͡ʃɔ̃ːn̪t̪iːs̪
दस	d̪əs̪
अरमान	əɾmä̃ːn̪
रूठना	ɾuːʈʰn̪äː
सीताफल	s̪iːt̪äːpʰəl̪
सालाना	s̪äːl̪äːn̪äː
जंतर	d͡ʒə̃n̪t̪əɾ
संप्रभुता	s̪ə̃mpɾəbʱʊt̪äː
दाढ़ी	d̪äːɽʱiː
अनुनासिक	ən̪ʊn̪äːs̪ɪk
आवंटित	äːʋə̃ɳʈɪt̪
पटका	pəʈkäː
सरंजाम	s̪əɾə̃n̪d͡ʒä̃ːm
संपर्क	s̪ə̃mpəɾk
गाना	ɡäːn̪äː
नायाब	n̪äːjäːb
अदाकार	əd̪äːkäːɾ
रजिस्टर	ɾəd͡ʒɪs̪ʈəɾ
रनवास	ɾə̃n̪wäːs̪
बालिका	bäːl̪ɪkäː
थोड़ा	t̪ʰoːɽäː
पिलास	pɪl̪äːs̪
मूर्तिपूजा	muːɾt̪ɪpuːd͡ʒäː
यौम	jɔ̃ːm
डिक्की	ɖɪk̚kiː
सारंगी	s̪äːɾə̃ŋɡiː
पर्याप्त	pəɾjaːpt̪
आधिक्य	äːd̪ʱɪkjᵊ
स्थल	s̪t̪ʰəl̪
ऊर्जा	uːɾd͡ʒäː
आशिक़	äːʃɪq
गवारा	ɡəʋäːɾäː
लालच	l̪äːl̪ət͡ʃ
अर्धविकसित	əɾd̪ʱʋɪks̪ɪt̪
मुग़लई	mʊɣl̪əiː
जीना	d͡ʒiːn̪äː
ल	l̪ə
तंदूरी	t̪ə̃n̪d̪uːɾiː
तुष्टीकरण	t̪ʊʃʈiːkəɾə̃ɳ
जीजा	d͡ʒiːd͡ʒäː
जज़्बात	d͡ʒəd͡ʒbäːt̪
सीख़चा	s̪iːxt͡ʃäː
नकार	n̪əkäːɾ
क़िस्सा	kɪs̪s̪äː
निज	n̪ɪd͡ʒ
बहरापन	bɛɦɾäːpə̃n̪
किलोग्राम	kɪl̪oːɡɾä̃ːm
जहाज़	d͡ʒəɦäːd͡ʒ
इंतिफ़ादा	ɪ̃n̪t̪ɪpʰäːd̪äː
मच्छर	mət̚t͡ʃʰəɾ
राइफ़ल	ɾäːɪpʰəl̪
किस्म	qɪs̪m
रात्रि	ɾäːt̪ɾiː
आत्मकथा	äːt̪mᵊkət̪ʰäː
काफी	käːpʰiː
दुस्साहस	d̪ʊs̪s̪äːɦəs̪
शिष्या	ʃɪʃjäː
पाशुपत	päːʃʊpət̪
अपराध	əpɾäːd̪ʱ
बहुफलक	bɔɦɔpʰəl̪ək
राजवंश	ɾäːd͡ʒʋə̃n̪ʃ
ज़िन्दगी	d͡ʒɪ̃n̪d̪əɡiː
चांपानेर	t͡ʃä̃ːpäːn̪eːɾ
मतदान	mət̪̚d̪ä̃ːn̪
मौसम	mɔːs̪ə̃m
दुर्गन्ध	d̪ʊɾɡə̃n̪d̪ʱ
क्योंकि	kjõːŋkiː
सबूत	s̪əbuːt̪
ख़ैरियत	kʰɛːɾijət̪
पियक्कड़	pijək̚kəɽ
लिफ़ाफ़ा	l̪ɪfäːfäː
षट्कोण	ʃəʈkõːɳ
आख़िरकार	äːkʰɪɾkäːɾ
उपलब्ध	ʊpl̪əbd̪ʱ
क़िस्त	qɪs̪t̪
जनप्रतिनिधित्व	d͡ʒə̃n̪pɾət̪ɪn̪ɪd̪ʱɪt̪wᵊ
झनझन	d͡ʒʱə̃n̪d͡ʒʱə̃n̪
बेक़रार	beːkəɾäːɾ
विनिमय	ʋɪn̪ɪməj
सौंह	s̪ɔ̃ːɦ
पांच	pä̃ːt͡ʃ
मुल्ला	mʊl̪l̪äː
बाँटना	bä̃ːʈn̪äː
मंदी	mə̃n̪d̪iː
बीजांड	biːd͡ʒä̃ːɳɖ
आलसी	äːl̪s̪iː
सारथी	s̪äːɾət̪ʰiː
व्याख्याता	ʋjäːkʰjäːt̪äː
पिछड़ा	pɪt͡ʃʰɽäː
रोज़ा	ɾoːd͡ʒäː
दक्ष	d̪əkʃ
निरंतर	n̪ɪɾə̃n̪t̪əɾ
हीजड़ा	ɦiːd͡ʒɽäː
संदूक़चा	s̪ə̃n̪d̪uːqt͡ʃäː
कुरूपता	kʊɾuːpt̪äː
घुसपैठ	ɡʱʊs̪pɛːʈʰ
फ़साना	fəs̪äːn̪äː
ग़ोता	ɣoːt̪äː
सिलवट	s̪ɪl̪ʋəʈ
इब्राहीम	ɪbɾäːɦĩːm
अच्छापन	ət̚t͡ʃʰäːpə̃n̪
आँख	ä̃ːkʰ
मसल	məs̪əl̪
मुँहमाँगा	mʊ̃ɦmä̃ːŋɡäː
आत्माभिमान	äːt̪mäːbʱɪmä̃ːn̪
बरतन	bəɾt̪ə̃n̪
अनुभव	ən̪ʊbʱəʋ
ग़ुस्सा	ɣʊs̪s̪äː
विशेषता	ʋɪʃeːʃt̪äː
आयुक्त	äːjʊkt̪
बनमानुस	bə̃n̪mäːn̪ʊs̪
पौदा	pɔːd̪äː
जितना	d͡ʒɪt̪̚n̪äː
बख़रा	bəxɾäː
आना	äːn̪äː
हृदयहीन	ɦɾɪd̪əjɦĩːn̪
हिमालय	ɦɪmɑːlɛ
वर्षा	ʋəɾʃäː
विद्युन्मय	ʋɪd̪jʊ̃n̪məj
आवेदन	äːʋeːd̪ə̃n̪
छिहत्तर	t͡ʃʰɪɦət̪̚t̪əɾ
पंडाल	pə̃ɳɖäːl̪
प्रतिनिधि	pɾət̪ɪn̪ɪd̪ʱiː
प्रत्याशी	pɾət̪jäːʃiː
हस्ताक्षर	ɦəs̪t̪äːkʃəɾ
शिक्षाविद्	ʃɪkʃäːʋɪd̪
मानवविज्ञान	mäːn̪əʋʋɪɡjä̃ːn̪
सम्मिश्रण	s̪ə̃mmɪʃɾə̃ɳ
बच्चा	bət̚t͡ʃäː
शेख़ूपुरा	ʃeːkʰuːpʊɾäː
स्तंभ	s̪t̪ə̃mbʱ
नवाज़	n̪əʋäːd͡ʒ
सवार	s̪əʋäːɾ
ख़ैरात	kʰɛːɾäːt̪
गूंगा	ɡũːŋɡäː
कान्ति	kä̃ːn̪t̪iː
बग़दाद	bəɡd̪äːd̪
दंत	d̪ə̃n̪t̪
वक्ता	ʋəkt̪äː
गुनना	ɡʊ̃n̪n̪äː
बेतुका	beːt̪ʊkäː
चौकस	t͡ʃɔːkəs̪
हाँ	ɦä̃ː
सूर्यकान्ति	s̪uːɾjəkä̃ːn̪t̪iː
चाँटा	t͡ʃä̃ːʈäː
नक़्शा	n̪əkʃäː
अंधेरा	ə̃n̪d̪ʱeːɾäː
सिया	s̪ijäː
बिरयानी	bɪɾjäːn̪iː
राजेश	ɾäːd͡ʒeːʃ
राज	ɾäːd͡ʒ
नक़द	n̪əkəd̪
अँगरेज़ी	ə̃ŋɡɾeːziː
कमर्शियल	kəməɾʃijəl̪
जोरदार	d͡ʒoːɾd̪äːɾ
पूंजीवाद	pũːn̪d͡ʒiːʋäːd̪
मसख़री	məs̪xəɾiː
शाणा	ʃäːɳäː
हिन्दवी	ɦɪ̃n̪d̪wiː
चित्रकारी	t͡ʃɪt̪ɾəkäːɾiː
सामी	s̪äːmiː
आचरण	äːt͡ʃəɾə̃ɳ
चढ़ना	t͡ʃəɽʱn̪äː
हालत	ɦäːl̪ət̪
ग्यारह	ɡjäːɾäː
अरोरा	əɾoːɾäː
खीरा	kʰiːɾäː
भाषिक	bʱäːʃɪk
देहकान	d̪eːɦkä̃ːn̪
बिलौटा	bɪl̪ɔːʈäː
निबंध	n̪ɪbə̃n̪d̪ʱ
संपत्ति	s̪ə̃mpət̪̚t̪iː
कलंक	kəl̪ə̃ŋk
लागत	l̪äːɡət̪
शिक्षामित्र	ʃɪkʃäːmɪt̪ɾᵊ
शक्की	ʃək̚kiː
दरिंदा	d̪əɾɪ̃n̪d̪äː
चौंकाना	t͡ʃɔ̃ːŋkäːn̪äː
मायने	mäːjn̪eː
वनों	ʋən̪õː
कत्ल	kət̪l̪
तहत	t̪ɛɦɛt̪
कंठमाला	kə̃ɳʈʰmäːl̪äː
मोहलत	mɔɦl̪ət̪
हसरत	ɦəs̪ɾət̪
मुजरिम	mʊd͡ʒɾɪ̃m
राजधानी	ɾäːd͡ʒd̪ʱäːn̪iː
प्रवाह	pɾəʋäːɦ
नज़रिया	n̪əzəɾijäː
रेलगाड़ी	ɾeːl̪ɡäːɽiː
बाबत	bäːbət̪
राजनीतिक	ɾäːd͡ʒn̪iːt̪ɪk
समीप	s̪əmiːp
व्यथा	ʋjət̪ʰäː
अंधविश्वास	ə̃n̪d̪ʱʋɪʃʋäːs̪
जिन	d͡ʒɪ̃n̪
मछली	mət͡ʃʰl̪iː
प्रतिलोम	pɾət̪ɪl̪õːm
मानना	mä̃ːn̪n̪äː
मक़बरा	məqbəɾäː
पिल्ला	pɪl̪l̪äː
हैसियत	ɦɛːs̪ijət̪
बाघ	bäːɡʱ
लताड़ना	l̪ət̪äːɽn̪äː
उखड़ना	ʊkʰəɽn̪äː
काँस	kä̃ːs̪
दिखाई	d̪ɪkʰäːiː
पतंगबाज़ी	pət̪ə̃ŋɡbäːziː
ग़ुब्बारा	ɣʊb̚bäːɾäː
मुतअल्लिक़	mʊt̪əəl̪l̪ɪq
सामुदायिक	s̪äːmʊd̪äːjɪk
छापाख़ाना	t͡ʃʰäːpäːkʰäːn̪äː
पट्टा	pəʈ̚ʈäː
अग्निपरीक्षा	əɡn̪ɪpəɾiːkʃäː
जादूगर	d͡ʒäːd̪uːɡəɾ
पौराणिक	pɔːɾäːɳɪk
रक्षा	ɾəkʃäː
निकारागुआ	n̪ɪkäːɾäːɡʊäː
उपनेत्र	ʊpn̪eːt̪ɾᵊ
दाब	d̪äːb
ख़्वाहिश	xäːɦɪʃ
सिंहाली	s̪ɪ̃ɦäːl̪iː
तिक्की	t̪ɪk̚kiː
डिल्डो	ɖɪl̪ɖoː
महँगाई	mɛɦɛ̃ŋɡäːiː
शजरा	ʃəd͡ʒɾäː
भोजनालय	bʱoːd͡ʒn̪äːl̪əj
ऋणाग्र	ɾɪɳäːɡɾᵊ
सुविख्यात	s̪ʊʋɪkʰjäːt̪
मूसल	muːs̪əl̪
सिलपट	s̪ɪl̪pəʈ
धनिया	d̪ʱən̪ijäː
भाभी	bʱäːbʱiː
इन्हें	ɪ̃n̪ɦẽː
अनपढ़	ə̃n̪pəɽʱ
मीठा	miːʈʰäː
औषधीय	ɔːʃd̪ʱiːjᵊ
आदिभाषा	äːd̪ɪbʱäːʃäː
नियुक्त	n̪ijʊkt̪
माँसाहारी	mä̃ːs̪äːɦäːɾiː
हवालात	ɦəʋäːl̪äːt̪
मूलाक्षर	muːl̪äːkʃəɾ
अनुगृहीत	ən̪ʊɡɾɪɦiːt̪
पारित	päːɾɪt̪
आजीविका	äːd͡ʒiːʋɪkäː
छननी	t͡ʃʰə̃n̪n̪iː
पाचन	päːt͡ʃə̃n̪
नानी	n̪äːn̪iː
इकत्तीस	ɪkət̪̚t̪iːs̪
नम्र	n̪ə̃mɾᵊ
मखानी	məkʰäːn̪iː
निष्पक्ष	n̪ɪʃpəkʃ
समाचार	s̪əmäːt͡ʃäːɾ
सूजन	s̪uːd͡ʒə̃n̪
डिब्बा	ɖɪb̚bäː
सहेजना	s̪əɦeːd͡ʒn̪äː
ऐरन	ɛːɾə̃n̪
महावत	məɦäːʋət̪
बुज़दिल	bʊd͡ʒd̪ɪl̪
गलत	ɡəl̪ət̪
भंजक	bʱə̃n̪d͡ʒək
धमकाना	d̪ʱə̃mkäːn̪äː
खिलौना	kʰɪl̪ɔːn̪äː
कंकड़	kə̃ŋkəɽ
दिवस	d̪ɪʋəs̪
जिसमें	d͡ʒɪs̪mẽː
स्पेनी	s̪peːn̪iː
बहना	bɛɦn̪äː
नक़ाबपोश	n̪əqäːb̚poːʃ
अभिलेख	əbʱɪl̪eːkʰ
नग़मा	n̪əɣmäː
प्राक्कथन	pɾäːk̚kət̪ʰə̃n̪
मछुआरा	mət͡ʃʰʊäːɾäː
कन्नड़	kə̃n̪n̪əɽᵊ
हज़्म	ɦəzə̃m
लड़ाका	l̪əɽäːkäː
रगड़ना	ɾəɡəɽn̪äː
संयमिनी	s̪ə̃n̪jəmɪn̪iː
नटखट	n̪əʈkʰəʈ
मन	mə̃n̪
शिकम	ʃɪkə̃m
फूलदान	pʰuːl̪d̪ä̃ːn̪
जोतना	d͡ʒoːt̪̚n̪äː
साम	s̪ä̃ːm
बुआ	bʊäː
यज्ञकर्ता	jəɡjəkəɾt̪äː
कंगन	kə̃ŋɡə̃n̪
मीन	mĩːn̪
स्कूल	s̪kuːl̪
बुसान	bʊs̪ä̃ːn̪
भोला	bʱoːl̪äː
धनाग्र	d̪ʱən̪äːɡɾᵊ
नाइजीरिया	n̪äːɪd͡ʒiːɾijäː
आवश्यक	äːʋəʃjək
दुरुस्त	d̪ʊɾʊs̪t̪
ज़हर	d͡ʒɛɦɛɾ
मिमियाना	mɪmijäːn̪äː
समकालीन	s̪ə̃mkäːl̪ĩːn̪
सुस्ताना	s̪ʊs̪t̪äːn̪äː
नानू	n̪äːn̪uː
लड़ना	l̪əɽn̪äː
ग़ुब्बारा	ɡʊb̚bäːɾäː
मछलीपालन	mət͡ʃʰl̪iːpäːl̪ə̃n̪
कसाई	qəs̪äːiː
मसनद	məs̪n̪əd̪
मुहाजिर	mʊɦäːd͡ʒɪɾ
विकिपीडिया	ʋɪkɪpiːɖijäː
जंगजू	d͡ʒə̃ŋɡd͡ʒuː
सफ़र	s̪əpʰəɾ
ताड़ी	t̪äːɽiː
पुरज़ा	pʊɾzäː
ऊनी	uːn̪iː
हड़ताली	ɦəɽt̪äːl̪iː
भेंट	bʱẽːɳʈ
अंग्रेज़ी	ə̃ŋɡɾeːd͡ʒiː
बंदरगाह	bə̃n̪d̪əɾɡäːɦ
मदिरा	məd̪ɪɾäː
असीम	əs̪ĩːm
मस	məs̪
ऑर्थोडॉक्सी	ɔɾt̪ʰoːɖɔks̪iː
मोहताज	moːɦt̪äːd͡ʒ
ऊदबिलाव	uːd̪bɪl̪äːʋ
मुद्दा	mʊd̪̚d̪äː
भला	bʱəl̪äː
ग़ोताख़ोर	ɣoːt̪äːxoːɾ
दिमाग़	d̪ɪmäːɣ
ख़ुशआमदीद	xʊʃəä̃ːmd̪iːd̪
नाखून	n̪äːkʰũːn̪
राष्ट्र	ɾäːʃʈɾᵊ
ललकार	l̪əl̪käːɾ
आग़ाज़	äːɣäːz
अंगूठी	ə̃ŋɡuːʈʰiː
प्रयोगकर्ता	pɾəjoːɡkəɾt̪äː
आश्वासन	äːʃʋäːs̪ə̃n̪
सूती	s̪uːt̪iː
क़ाहिरा	qäːɦɪɾäː
उमंग	ʊmə̃ŋɡ
ईमान	iːmä̃ːn̪
दरवाज़ा	d̪əɾʋäːd͡ʒäː
किशोरा	kɪʃoːɾäː
चेला	t͡ʃeːl̪äː
अपव्यय	əpwjəj
अंकल	ə̃ŋkəl̪
जन्मभूमि	d͡ʒə̃n̪mᵊbʱuːmiː
दुपट्टा	d̪ʊpəʈ̚ʈäː
जिना	d͡ʒɪn̪äː
खटाई	kʰəʈäːiː
अधिकतम	əd̪ʱɪkt̪ə̃m
मेंडक	mẽːɳɖək
उपसमुच्चय	ʊpəs̪mʊt̚t͡ʃəj
आपाधापी	äːpäːd̪ʱäːpiː
बचाना	bət͡ʃäːn̪äː
नहलाना	n̪ɛɦl̪äːn̪äː
गुलदस्ता	ɡʊl̪d̪əs̪t̪äː
नारायण	n̪äːɾäːjə̃ɳ
ध्वन्यात्मक	d̪ʱʋə̃n̪jäːt̪mək
तंज़ीम	t̪ə̃zĩːm
ओटावा	oːʈäːʋäː
धनबाद	d̪ʱə̃n̪bäːd̪
पारदर्शी	päːɾd̪əɾʃiː
मतलब	mət̪l̪əb
गूंज	ɡũːn̪d͡ʒ
जोड़ना	d͡ʒoːɽn̪äː
ख़ैरियत	xɛːɾijət̪
वर्णविपर्यास	ʋəɾɳəʋɪpəɾjäːs̪
अस्सी	əs̪s̪iː
इत्यादि	ɪt̪jäːd̪iː
दर्पण	d̪əɾpə̃ɳ
कम्युनिज़्म	kə̃mjʊn̪ɪzmᵊ
बढ़ावा	bəɽʱäːʋäː
ख़ातून	kʰäːt̪ũːn̪
पुनर्निर्धारण	pʊn̪əɾn̪ɪɾd̪ʱäːɾə̃ɳ
ज़्यादातर	zjäːd̪äːt̪əɾ
जाट	d͡ʒäːʈ
निर्मित	n̪ɪɾmɪt̪
मौन	mɔ̃ːn̪
श्रोता	ʃɾoːt̪äː
मुसल्ला	mʊs̪əl̪l̪äː
बार	bäːɾ
अट्ठा	əʈ̚ʈʰäː
अशांति	əʃä̃ːn̪t̪iː
दहन	d̪ɛɦɛ̃n̪
चाट	t͡ʃäːʈ
कालू	käːl̪uː
अमावस	əmäːʋəs̪
धारा	d̪ʱäːɾäː
घुसपैठिया	ɡʱʊs̪pɛːʈʰijäː
प्रस्तुत	pɾəs̪t̪ʊt̪
धूआँ	d̪ʱuːä̃ː
भरण	bʱəɾə̃ɳ
आलोचना	äːl̪oːt͡ʃn̪äː
समष्टि	s̪əməʃʈiː
सैकण्ड	s̪ɛːkə̃ɳɖ
विनिपेग	ʋɪn̪ɪpeːɡ
अवकलन	əʋkəl̪ə̃n̪
सज्जित	s̪əd̚d͡ʒɪt̪
छाँव	t͡ʃʰä̃ːʋ
सर्वनाम	s̪əɾʋən̪ä̃ːm
नाहर	n̪äːɦəɾ
पचहत्तर	pət͡ʃʰət̪̚t̪əɾ
मुश्ताक़	mʊʃt̪äːk
अदालत	əd̪äːl̪ət̪
सट्टेबाज़ी	s̪əʈ̚ʈeːbäːd͡ʒiː
सस्तापन	s̪əs̪t̪äːpə̃n̪
नवजात	n̪əʋd͡ʒäːt̪
आघात	äːɡʱäːt̪
बैरा	bɛːɾäː
सट्टेबाज़	s̪əʈ̚ʈeːbäːd͡ʒ
पौन	pɔ̃ːn̪
इतवार	ɪt̪wäːɾ
दूरलेख	d̪uːɾl̪eːkʰ
ऐसी	ɛːs̪iː
मिज़ाज	mɪd͡ʒäːd͡ʒ
संप्रभु	s̪ə̃mpɾəbʱuː
ध्वजा	d̪ʱʋəd͡ʒäː
सबील	s̪əbiːl̪
लोगो	l̪oːɡoː
नाती	n̪äːt̪iː
आजमाना	äːzmäːn̪äː
सरकंडा	s̪əɾkə̃ɳɖäː
बाबर	bäːbəɾ
राम	ɾä̃ːm
निगम	n̪ɪɡə̃m
बन्दूक	bə̃n̪d̪uːk
खैरात	xɛːɾäːt̪
हँसना	ɦə̃s̪n̪äː
मायूसी	mäːjuːs̪iː
मद्देनज़र	məd̪̚d̪eːn̪əd͡ʒəɾ
प्रतियोगिता	pɾət̪ijoːɡɪt̪äː
वर्गहीन	ʋəɾɡɦĩːn̪
प्रबंधक	pɾəbə̃n̪d̪ʱək
रखवाल	ɾəkʰʋäːl̪
भाड़ा	bʱäːɽäː
भाजन	bʱäːd͡ʒə̃n̪
उंस	ʊ̃n̪s̪
नेल्लोर	n̪eːl̪l̪oːɾ
नर्तक	n̪əɾt̪ək
देखादेखी	d̪eːkʰäːd̪eːkʰiː
नुकसान	n̪ʊks̪ä̃ːn̪
तुम	t̪ʊ̃m
उनहत्तर	ʊ̃n̪ɦət̪̚t̪əɾ
लफ़ंगा	l̪əfə̃ŋɡäː
भगनासा	bʱəɡn̪äːs̪äː
डायरी	ɖäːjəɾiː
सेंट	s̪ẽːɳʈ
पलटन	pəl̪ʈə̃n̪
प्रतिज्ञापन	pɾət̪ɪɡjäːpə̃n̪
हिजड़ा	ɦɪd͡ʒɽäː
कंकाल	kə̃ŋkäːl̪
बाग़	bäːɣ
आंशिक	ä̃ːn̪ʃɪk
ग्वारपाठा	ɡʋäːɾpäːʈʰäː
ठंडा	ʈʰə̃ɳɖäː
संभालना	s̪ə̃mbʱäːl̪n̪äː
उल्लू	ʊl̪l̪uː
कागज़	käːɣəz
मार्क्सवाद	mäːɾks̪ʋäːd̪
मल्होत्रा	məl̪ɦoːt̪ɾäː
बाथरूम	bäːt̪ʰɾũːm
सराफ़ा	s̪əɾäːfäː
लाबु	l̪äːbuː
दहलना	d̪ɛɦɛl̪n̪äː
प्रतिस्पर्धा	pɾət̪ɪs̪pəɾd̪ʱäː
विवाद	ʋɪʋäːd̪
हलफ़नामा	ɦəl̪əpʰn̪äːmäː
तारपीन	t̪äːɾpĩːn̪
बहाव	bəɦäːʋ
क़सीदा	qəs̪iːd̪äː
मिठास	mɪʈʰäːs̪
रोंगटा	ɾõːŋɡʈäː
विभाजित	ʋɪbʱäːd͡ʒɪt̪
महाधिवक्ता	məɦäːd̪ʱɪʋəkt̪äː
मायूस	mäːjuːs̪
नूर	n̪uːɾ
अनुरूप	ən̪ʊɾuːp
कतार	qət̪äːɾ
तेलुगू	t̪eːl̪ʊɡuː
फ़व्वारा	fəʋʋäːɾäː
रखा	ɾəkʰäː
ढूँढना	ɖʱũːɳɖʱn̪äː
मर्दानगी	məɾd̪ä̃ːn̪ɡiː
रुद्राक्ष	ɾʊd̪ɾäːkʃ
फुनगी	pʰʊ̃n̪ɡiː
मुरदाबाद	mʊɾd̪äːbäːd̪
नास्तिक	n̪äːs̪t̪ɪk
नीलाम	n̪iːl̪ä̃ːm
तारीफ़	t̪äːɾiːf
जमाव	d͡ʒəmäːʋ
उपन्यास	ʊpə̃n̪jäːs̪
मक़बरा	məkbəɾäː
विकार	ʋɪkäːɾ
अर्धवार्षिक	əɾd̪ʱʋäːɾʃɪk
बांझ	bä̃ːn̪d͡ʒʱ
हथियारबंद	ɦət̪ʰijäːɾbə̃n̪d̪
फ़ालसा	fäːl̪s̪äː
चौंसठ	t͡ʃɔ̃ːn̪s̪əʈʰ
एकवर्णीय	eːkwəɾɳiːjᵊ
क्विंटल	kwɪ̃ɳʈəl̪
वामपंथी	ʋä̃ːmpə̃n̪t̪ʰiː
हिंदुत्ववादी	ɦɪ̃n̪d̪ʊt̪wəʋäːd̪iː
प्रवृत्ति	pɾəʋɾɪt̪̚t̪iː
भाप	bʱäːp
प्रदान	pɾəd̪ä̃ːn̪
माओवादी	mäːoːʋäːd̪iː
संबंधी	s̪ə̃mbə̃n̪d̪ʱiː
तापना	t̪äːpn̪äː
मेष	meːʃ
मस्तूल	məs̪t̪uːl̪
आड़	äːɽ
धुंध	d̪ʱʊ̃n̪d̪ʱ
जमना	d͡ʒə̃mn̪äː
बिनती	bɪ̃n̪t̪iː
उधेड़ना	ʊd̪ʱeːɽn̪äː
बेक़रार	beːqəɾäːɾ
तरणक्रीड़ा	t̪əɾɳəkɾiːɽäː
नारियल	n̪äːɾijəl̪
धार्मिक	d̪ʱäːɾmɪk
टेलीफ़ोन	ʈeːl̪iːfõːn̪
सर्वसाधारण	s̪əɾʋs̪äːd̪ʱäːɾə̃ɳ
सरी	s̪əɾiː
ज्ञाता	ɡjäːt̪äː
ज़ाहिर	d͡ʒäːɦɪɾ
आकस्मिक	äːkəs̪mɪk
हॉलैंड	ɦɔl̪ɛ̃ːɳɖ
ठेलना	ʈʰeːl̪n̪äː
क़तरा	qət̪ɾäː
विश्वास	ʋɪʃʋäːs̪
मुस्कुराना	mʊs̪kʊɾäːn̪äː
बाज़ीचा	bäːd͡ʒiːt͡ʃäː
फल	pʰəl̪
मुहैया	mɔɦɔ̯ijäː
अनाचार	ən̪äːt͡ʃäːɾ
सामान्यतः	s̪äːmä̃ːn̪jət̪əɦ
कालक्रम	käːl̪kɾə̃m
ख़्वाहिश	kʰʋäːɦɪʃ
तरीका	t̪əɾiːkäː
आख़िरी	äːxɾiː
तिनका	t̪ɪ̃n̪käː
अनियमित	ən̪ijəmɪt̪
झक्कड़	d͡ʒʱək̚kəɽ
उपेक्षा	ʊpeːkʃäː
टक्कर	ʈək̚kəɾ
फ़र्ज़न्द	fəɾzə̃n̪d̪
यूनिकोड	juːn̪ɪkoːɖ
मरियम	məɾijə̃m
सस्ताई	s̪əs̪t̪äːiː
क़ालीन	käːl̪ĩːn̪
शख्सियत	ʃəkʰs̪ijət̪
पुनरुत्थान	pʊn̪əɾʊt̪̚t̪ʰä̃ːn̪
ख़ूँख़ार	kʰũːkʰäːɾ
बेलफ़ास्ट	beːl̪fäːs̪ʈ
लिखते	l̪ɪkʰt̪eː
रोज़ाना	ɾoːzäːn̪äː
ऋणदाताओ	ɾɪ̃ɳd̪äːt̪äːoː
न	n̪äː
व्यूहरचना	ʋjuːɦɾət͡ʃn̪äː
तन	t̪ə̃n̪
कमाल	kəmäːl̪
यथारूप	jət̪ʰäːɾuːp
कुलक	kʊl̪ək
बहुविवाह	bɔɦɔʋɪʋäːɦ
अवधारण	əʋd̪ʱäːɾə̃ɳ
अंतरंगता	ə̃n̪t̪əɾə̃ŋɡt̪äː
आदतन	äːd̪ət̪ə̃n̪
क्रमबद्ध	kɾə̃mbəd̪d̪ʱ
परवाह	pəɾʋäːɦ
टोकरा	ʈoːkɾäː
कलेजा	kəl̪eːd͡ʒäː
अनुभवी	ən̪ʊbʱəʋiː
उधड़ना	ʊd̪ʱəɽn̪äː
तिल्ली	t̪ɪl̪l̪iː
श्रद्धेय	ʃɾəd̪̚d̪ʱeːj
अनुकूलन	ən̪ʊkuːl̪ə̃n̪
मिसिसॉगा	mɪs̪ɪs̪ɔɡäː
ख़ातिर	xäːt̪ɪɾ
तथा	t̪ət̪ʰäː
गुफा	ɡʊfäː
साधन	s̪äːd̪ʱə̃n̪
बदल	bəd̪əl̪
गर्भपात	ɡəɾbʱpäːt̪
टेलिविज़न	ʈeːl̪ɪʋɪzə̃n̪
बगीचा	bəɣiːt͡ʃäː
सूतिकागृह	s̪uːt̪ɪkäːɡɾɪɦ
जहन्नुम	d͡ʒɛɦɛ̃n̪n̪ʊ̃m
तनना	t̪ə̃n̪n̪äː
ख़मियाज़ा	xəmijäːzäː
राज़ी	ɾäːd͡ʒiː
विजयनगरम	ʋɪd͡ʒjən̪əɡɾə̃m
परिंदा	pəɾɪ̃n̪d̪äː
श्यानता	ʃjä̃ːn̪t̪äː
राहत	ɾäːɦət̪
श्रीकाकुलम	ʃɾiːkäːkʊl̪ə̃m
ख़ानक़ाह	xä̃ːn̪qäːɦ
पनपना	pən̪əpn̪äː
सहन	s̪ɛɦɛ̃n̪
दूँगा	d̪ũːŋɡäː
चिकित्सालय	t͡ʃɪkɪt̪s̪äːl̪əj
संश्लिष्ट	s̪ə̃n̪ʃl̪ɪʂʈ
स्पघेटी	s̪pəɡʱeːʈiː
ऐनिमे	ɛːn̪ɪmeː
जापान	d͡ʒäːpä̃ːn̪
जंग	d͡ʒə̃ŋɡ
करघा	kəɾɡʱäː
पोका	poːkaː
पनडुब्बी	pə̃n̪ɖʊb̚biː
पात	päːt̪
अध्यापिका	əd̪ʱjäːpɪkäː
गुस्सा	ɡʊs̪s̪äː
किलो	kɪl̪oː
यंत्र	jə̃n̪t̪ɾə
ख़ारिज	xäːɾɪd͡ʒ
मालागासी	mäːl̪äːɡäːs̪iː
निगलना	n̪ɪɡəl̪n̪äː
एयरलाइन	eːjəɾl̪äːɪ̃n̪
चलचित्रण	t͡ʃəl̪t͡ʃɪt̪ɾə̃ɳ
बारी	bäːɾiː
आत्मत्याग	äːt̪mət̪jäːɡ
कसम	qəs̪ə̃m
बावन	bäːʋə̃n̪
काजू	käːd͡ʒuː
तेल	t̪eːl̪
प्रतिरोधकता	pɾət̪ɪɾoːd̪ʱəkt̪äː
बिछड़ना	bɪt͡ʃʰəɽn̪äː
जालपृष्ठ	d͡ʒäːl̪pɾɪʂʈʰ
स्वाद	s̪ʋäːd̪
संज्ञा	s̪ə̃ŋɡjäː
शिकस्त	ʃɪkəs̪t̪
संपूर्ण	s̪ə̃mpuːɾɳ
बदतर	bəd̪̚t̪əɾ
आदत	äːd̪ət̪
जुनून	d͡ʒʊn̪ũːn̪
आइसक्रीम	äːɪs̪kɾĩːm
ग़लत	ɣəl̪ət̪
अनसुना	ə̃n̪s̪ʊn̪äː
अपक्व	əpəkwə
मुंडन	mʊ̃ɳɖə̃n̪
स्वागत	s̪ʋäːɡət̪
पुरुष	pʊɾʊʃ
ईरान	iːɾä̃ːn̪
भौगोलिक	bʱɔːɡoːl̪ɪk
व्यंजक	ʋjə̃n̪d͡ʒək
सड़क	s̪əɽək
आबदस्त	äːbd̪əs̪t̪
प्रस्तावक	pɾəs̪t̪äːʋək
मटकना	məʈəkn̪äː
सोमालिया	s̪oːmäːl̪ijäː
बिबाद	bɪbäːd̪
अंतर्धान	ə̃n̪t̪əɾd̪ʱä̃ːn̪
सहस्र	s̪ɛɦɛs̪ɾᵊ
रसद	ɾəs̪əd̪
फ्रेन्चाइज़	pʰɾẽːn̪t͡ʃäːɪd͡ʒ
पतित्व	pət̪ɪt̪wᵊ
मिलन	mɪl̪ə̃n̪
तालु	t̪äːl̪uː
लीद	l̪iːd̪
ऊपरवाला	uːpəɾʋäːl̪äː
सलोतरी	s̪əl̪oːt̪ɾiː
गाँजा	ɡä̃ːn̪d͡ʒäː
प्रजातंत्रवाद	pɾəd͡ʒäːt̪ə̃n̪t̪ɾəʋäːd̪
अत्याचारी	ət̪jäːt͡ʃäːɾiː
बग़ावत	bəɡäːʋət̪
इंफाल	ɪ̃mpʰäːl̪
उनींदा	ʊn̪ĩːn̪d̪äː
खटमिट्ठा	kʰəʈmɪʈ̚ʈʰäː
गिलहरी	ɡɪl̪ɛɦɾiː
मुंसिफ़ाना	mʊ̃n̪s̪ɪpʰäːn̪äː
पीएम	piːẽːm
जुमला	d͡ʒʊ̃ml̪äː
मोबिलिटी	moːbɪl̪ɪʈiː
सौन्दर्य	s̪ɔ̃ːn̪d̪əɾjᵊ
आसाम	äːs̪ä̃ːm
लालफ़ीता	l̪äːl̪pʰiːt̪äː
मांगलिक	mä̃ːŋɡəl̪ɪk
कम्युनिजम	kə̃mjʊn̪ɪzə̃m
कमरबन्द	kəməɾbə̃n̪d̪
शल्यक्रियागार	ʃəl̪jəkɾijäːɡäːɾ
स्वास्थ्य	s̪ʋäːs̪t̪ʰjə
चींटा	t͡ʃĩːʈäː
अंगोट	ə̃ŋɡoːʈ
अनन्नास	ən̪ə̃n̪n̪äːs̪
ग़ुस्लख़ाना	ɣʊs̪l̪xäːn̪äː
ठोकना	ʈʰoːkn̪äː
घंटा	ɡʱəɳʈaː
नानसरा	n̪äːn̪əs̪ɾäː
भावना	bʱäːʋn̪äː
हैज़ा	ɦɛːzäː
आदेश	äːd̪eːʃ
आमंत्रित	äːmə̃n̪t̪ɾɪt̪
पता	pət̪äː
फिसलन	pʰɪs̪l̪ə̃n̪
आलस्य	äːl̪əs̪jᵊ
ओगाज़्म	oːɡäːd͡ʒm
तन्दूरी	t̪ə̃n̪d̪uːɾiː
दरार	d̪əɾäːɾ
भ्रमण	bʱɾəmə̃ɳ
आपत्तिजनक	äːpət̪̚t̪iːd͡ʒən̪ək
दंतमंजन	d̪ə̃n̪t̪mə̃n̪d͡ʒə̃n̪
यान	jä̃ːn̪
डूंगर	ɖũːŋɡəɾ
अफ़्रीका	əpʰɾiːkäː
लड़की	l̪əɽkiː
अधिवार्षिकी	əd̪ʱɪʋäːɾʃɪkiː
मुक्का	mʊk̚käː
तख़ल्लुस	t̪əkʰəl̪l̪ʊs̪
लोहड़ी	l̪oːɦɽiː
हंगरी	ɦə̃ŋɡəɾiː
चुनाव	t͡ʃʊn̪äːʋ
पाकपत्तन	päːkpət̪̚t̪ə̃n̪
प्रकासम	pɾəkäːs̪ə̃m
भैंसा	bʱɛːs̪äː
मनोनित	mən̪oːn̪ɪt̪
हिमाक़त	ɦɪmäːkət̪
भाड़	bʱäːɽ
तीली	t̪iːl̪iː
फ़िल्म	fɪl̪ə̃m
शिकोहाबाद	ʃɪkoːɦäːbäːd̪
जवारी	d͡ʒəʋäːɾiː
ख़ुदावंद	xʊd̪äːʋə̃n̪d̪
मन्नत	mə̃n̪n̪ət̪
ढंग	ɖʱə̃ŋɡ
तपस्वी	t̪əpəs̪ʋiː
संग्रंथन	s̪ə̃ŋɡɾə̃n̪t̪ʰə̃n̪
अतुल्य	ət̪ʊl̪jᵊ
रार	ɾäːɾ
इत्तिहाद	ɪt̪̚t̪ɪɦäːd̪
अभ्यास	əbʱjäːs̪
सन	s̪ə̃n̪
फालसा	pʰäːl̪s̪äː
शख़्स	ʃəxs̪
अंडमान	ə̃ɳɖmä̃ːn̪
तलक	t̪əl̪ək
युग्मनज	jʊɡmən̪əd͡ʒ
अव्यावहारिक	əʋjäːʋɦäːɾɪk
जन्म	d͡ʒə̃n̪mᵊ
भ्रम	bʱɾə̃m
लालफ़ीता	l̪äːl̪fiːt̪äː
मालिकाना	mäːl̪ɪkäːn̪äː
ललाट	l̪əl̪äːʈ
लालफ़ीताशाही	l̪äːl̪fiːt̪äːʃäːɦiː
नमूना	n̪əmuːn̪äː
झाड़	d͡ʒʱäːɽ
उन्नीस	ʊ̃n̪n̪iːs̪
तिरानवे	t̪ɪɾä̃ːn̪weː
धनायन	d̪ʱən̪äːjə̃n̪
सरफ़रोश	s̪əɾfəɾoːʃ
अस्तबल	əs̪t̪əbəl̪
आसक्त	äːs̪əkt̪
वरण	ʋəɾə̃ɳ
उलटना	ʊl̪əʈn̪äː
ढकना	ɖʱəkn̪äː
क्रिस्मस	kɾɪs̪məs̪
बहुसंख्यक	bɔɦɔs̪ə̃ŋkʰjək
उपाय	ʊpäːj
दाता	d̪äːt̪äː
फ़ानी	pʰäːn̪iː
कम्युनिज़म	kə̃mjʊn̪ɪzə̃m
विदा	ʋɪd̪äː
असामान्य	əs̪äːmä̃ːn̪jᵊ
तालीम	t̪äːl̪ĩːm
अफ़सोसजनक	əpʰs̪oːs̪d͡ʒən̪ək
सिक्किम	s̪ɪk̚kɪ̃m
शाही	ʃäːɦiː
मौक़ा	mɔːkäː
शिवलिंग	ʃɪʋl̪ɪ̃ŋɡ
सूचीबद्ध	s̪uːt͡ʃiːbəd̪d̪ʱ
फोड़ा	pʰoːɽäː
रन	ɾə̃n̪
पौरुष	pɔːɾʊʃ
करनाल	kəɾn̪äːl̪
शैक्षणिक	ʃɛːkʃəɳɪk
फोन	pʰõːn̪
शुक्राणु	ʃʊkɾäːɳuː
सशक्तिकरण	s̪əʃəkt̪ɪkəɾə̃ɳ
गैस	ɡɛːs̪
निःशुल्क	n̪ɪɦʃʊl̪k
योग	joːɡäː
अंकुर	ə̃ŋkʊɾ
अर्थालंकार	əɾt̪ʰäːl̪ə̃ŋkäːɾ
अकाल	əkäːl̪
गूगल	ɡuːɡəl̪
दर्जा	d̪əɾd͡ʒäː
निर्दिष्ट	n̪ɪɾd̪ɪʂʈ
शताब्दी	ʃət̪äːbd̪iː
आलपीन	äːl̪pĩːn̪
अजेंडा	əd͡ʒẽːɳɖäː
छलकना	t͡ʃʰəl̪əkn̪äː
वातानुकूलक	ʋäːt̪äːn̪ʊkuːl̪ək
नख़लिस्तान	n̪əkʰl̪ɪs̪t̪ä̃ːn̪
कील	kiːl̪
लेस्टर	l̪eːs̪ʈəɾ
जलारेख	d͡ʒəl̪äːɾeːkʰ
अध्यादेश	əd̪ʱjäːd̪eːʃ
बलग़म	bəl̪ɡə̃m
व्यभिचार	ʋjəbʱɪt͡ʃäːɾ
तुरन्त	t̪ʊɾə̃n̪t̪
मुरझाना	mʊɾd͡ʒʱäːn̪äː
टोकना	ʈoːkn̪äː
अम्मा	ə̃mmäː
प्रयोजन	pɾəjoːd͡ʒə̃n̪
बुलबुला	bʊl̪bʊl̪äː
दुभाषिया	d̪ʊbʱäːʃijäː
हार	ɦäːɾ
गाड़ना	ɡäːɽn̪äː
सुक़रात	s̪ʊqɾäːt̪
सशुल्क	s̪əʃʊl̪k
नाराज़	n̪äːɾäːd͡ʒ
सरहद	s̪əɾɦəd̪
शुरुआती	ʃʊɾʊäːt̪iː
पालतू	päːl̪t̪uː
रौनक़	ɾɔːn̪ək
राजस्थान	ɾäːd͡ʒəs̪t̪ʰä̃ːn̪
शरणार्थी	ʃəɾɳäːɾt̪ʰiː
सकता	s̪əkt̪äː
संग्रहालय	s̪ə̃ŋɡɾəɦäːl̪əj
लहर	l̪ɛɦɛɾ
चेचेन	t͡ʃeːt͡ʃẽːn̪
कान	kä̃ːn̪
बिछवाना	bɪt͡ʃʰʋäːn̪äː
अनुदान	ən̪ʊd̪ä̃ːn̪
तुम्हें	t̪ʊ̃mɦẽː
सत्वर	s̪ət̪wəɾ
तहज़ीब	t̪ɛɦd͡ʒiːb
पश्मीना	pəʃmiːn̪äː
क़बीला	qəbiːl̪äː
एकसमान	eːks̪əmä̃ːn̪
रुग्णालय	ɾʊɡɳäːl̪əj
कत्ल	qət̪l̪
हज़ारहा	ɦəzäːɾɦäː
सैर	s̪ɛːɾ
सलाम	s̪əl̪ä̃ːm
निरपेक्ष	n̪ɪɾpeːkʃ
लिखे	l̪ɪkʰeː
वन	ʋə̃n̪
बरक़रार	bəɾqəɾäːɾ
जोरदार	zoːɾd̪äːɾ
व्यायाम	ʋjäːjä̃ːm
आशीर्वाद	äːʃiːɾʋäːd̪
माधव	mäːd̪ʱəʋ
अनमोल	ə̃n̪moːl̪
इल्मी	ɪl̪miː
फट्टू	pʰəʈ̚ʈuː
अक्षरारंभ	əkʃəɾäːɾə̃mbʱ
गुओमिंदांग	ɡʊoːmɪ̃n̪d̪ä̃ːŋɡ
अधिमास	əd̪ʱɪmäːs̪
मुख़ालिफ़त	mʊkʰäːl̪ɪpʰət̪
अधिकरण	əd̪ʱɪkəɾə̃ɳ
छायावाद	t͡ʃʰäːjäːʋäːd̪
इंगलिस्तान	ɪ̃ŋɡl̪ɪs̪t̪ä̃ːn̪
शुल्क	ʃʊl̪k
सुहाग	s̪ʊɦäːɡ
निपूता	n̪ɪpuːt̪äː
मंत्रिमंडल	mə̃n̪t̪ɾɪmə̃ɳɖəl̪
गुज़श्ता	ɡʊzəʃt̪äː
इलायची	ɪl̪äːjt͡ʃiː
मनोविदलता	mən̪oːʋɪd̪əl̪t̪äː
तरोताज़ा	t̪əɾoːt̪äːd͡ʒäː
सिंघ	s̪ɪ̃ŋɡʱ
तबला	t̪əbl̪äː
बातूनी	bäːt̪uːn̪iː
आत्मरक्षा	äːt̪məɾəkʃäː
पास	päːs̪
सांसद	s̪ä̃ːn̪s̪əd̪
बाल्टी	bäːl̪ʈiː
सहारा	s̪əɦäːɾäː
सचिव	s̪ət͡ʃɪʋ
इंचियोन	ɪ̃n̪t͡ʃijõːn̪
घोड़ा	ɡʱoːɽäː
सपूत	s̪əpuːt̪
विजयादशमी	ʋɪd͡ʒjäːd̪əʃmiː
खाँग	kʰä̃ːŋɡ
शराफत	ʃəɾäːfət̪
समास	s̪əmäːs̪
दिखाऊ	d̪ɪkʰäːuː
खनिज	kʰən̪ɪd͡ʒ
उपधारा	ʊpd̪ʱäːɾäː
मसरूफ़	məs̪ɾuːpʰ
बेल्जियम	beːl̪d͡ʒijə̃m
मौजूदा	mɔːd͡ʒuːd̪äː
जातीय	d͡ʒäːt̪iːjᵊ
छात्र	t͡ʃʰäːt̪ɾᵊ
खानि	kʰäːn̪iː
महफ़ूज़	mɛɦpʰuːd͡ʒ
सहसा	s̪ɛɦs̪äː
सभ्य	s̪əbʱjᵊ
सात	s̪äːt̪
शहज़ादा	ʃɛɦzäːd̪äː
दरमियान	d̪əɾmijä̃ːn̪
नगण्य	n̪əɡə̃ɳjᵊ
चमड़ी	t͡ʃə̃mɽiː
धर्मार्थ	d̪ʱəɾmäːɾt̪ʰ
साग	s̪äːɡ
किला	kɪl̪äː
अभयारण्य	əbʱjäːɾə̃ɳjᵊ
द्विर	d̪wɪɾ
बालतोड़	bäːl̪t̪oːɽ
लंदन	l̪ə̃n̪d̪ə̃n̪
दूधमुँहा	d̪uːd̪ʱmʊ̃ɦäː
क्षमता	kʃə̃mt̪äː
टोली	ʈoːl̪iː
समेटना	s̪əmeːʈn̪äː
बेवा	beːʋäː
वार्तालाप	ʋäːɾt̪äːl̪äːp
स्कूली	s̪kuːl̪iː
चेतावनी	t͡ʃeːt̪äːʋn̪iː
सुलह	s̪ʊl̪əɦ
हलक़	ɦəl̪q
पकवान	pəkwä̃ːn̪
पैंट	pɛ̃ːɳʈ
उदारवाद	ʊd̪äːɾʋäːd̪
मंच	mə̃n̪t͡ʃ
बजना	bəd͡ʒn̪äː
ओसाका	oːs̪äːkäː
कुसल	kʊs̪əl̪
रसोईघर	ɾəs̪oːiːɡʱəɾ
खींचतान	kʰĩːt͡ʃt̪ä̃ːn̪
ख़ुशामद	xʊʃäːməd̪
व्युत्पन्न	ʋjʊt̪pə̃n̪n̪ᵊ
पटल	pəʈəl̪
कारवाँ	käːɾʋä̃ː
नाफ़	n̪äːpʰ
निचोड़	n̪ɪt͡ʃoːɽ
हस्तलिखित	ɦəs̪t̪l̪ɪkʰɪt̪
जाड़ा	d͡ʒäːɽäː
बारूद	bäːɾuːd̪
अल्पकारी	əl̪pəkäːɾiː
अंदाज़ा	ə̃n̪d̪äːd͡ʒäː
अकेलापन	əkeːl̪äːpə̃n̪
संजय	s̪ə̃n̪d͡ʒəj
कैमरा	kɛ̃ːmɾäː
पुरज़ा	pʊɾd͡ʒäː
काढ़ना	käːɽʱn̪äː
गीतकार	ɡiːt̪käːɾ
विस्फोटक	ʋɪs̪pʰoːʈək
आत्मज्ञान	äːt̪məɡjä̃ːn̪
प्रतिनिधित्व	pɾət̪ɪn̪ɪd̪ʱɪt̪wᵊ
आनंद	äːn̪ə̃n̪d̪
देवनागरी	d̪eːʋn̪äːɡɾiː
नक़्क़ारा	n̪ək̚käːɾäː
कोटवाल	koːʈwäːl̪
ख़ारिज	kʰäːɾɪd͡ʒ
जंभ	d͡ʒə̃mbʱ
माघ	mäːɡʱ
घनचक्कर	ɡʱə̃n̪t͡ʃək̚kəɾ
आड़ू	äːɽuː
फ़ायदा	fäːjd̪äː
चालकता	t͡ʃäːl̪əkt̪äː
नित्यप्रति	n̪ɪt̪jəpɾət̪iː
किन्नर	kɪ̃n̪n̪əɾ
कम्युनिज़म	kə̃mjʊn̪ɪd͡ʒm
नत	n̪ət̪
अमचूर	ə̃mt͡ʃuːɾ
आंवला	ä̃ːmwl̪äː
काँव	kä̃ːʋ
परवानगी	pəɾʋä̃ːn̪ɡiː
हामी	ɦäːmiː
ओलंपिक	oːl̪ə̃mpɪk
ख़ूबसूरत	xuːbs̪uːɾət̪
इंतिहा	ɪ̃n̪t̪ɪɦäː
असंभव	əs̪ə̃mbʱəʋ
फ़िलिस्तीनी	pʰɪl̪ɪs̪t̪iːn̪iː
सन्दूक़चा	s̪ə̃n̪d̪uːqt͡ʃäː
मनुज	mən̪ʊd͡ʒ
दरख़ास्त	d̪əɾkʰäːs̪t̪
भास्कर	bʱäːs̪kəɾ
भांजा	bʱä̃ːn̪d͡ʒäː
राज्यानुसार	ɾäːd͡ʒjäːn̪ʊs̪äːɾ
निंदा	n̪ɪ̃n̪d̪äː
स्टाक	s̪ʈäːk
काला	käːl̪äː
करण	kəɾə̃ɳ
भाषा	bʱäːʃäː
तक्षशिला	t̪əkʃəʃɪl̪äː
कॉमनवेल्थ	kɔmə̃n̪weːl̪t̪ʰ
प्रबंधकर्ता	pɾəbə̃n̪d̪ʱkəɾt̪äː
ज़्यादती	d͡ʒjäːd̪ət̪iː
अंतरराष्ट्रीय	ə̃n̪t̪əɾɾäːʃʈɾiːjᵊ
इंग्लैंड	ɪ̃ŋɡl̪ɛ̃ːɳɖ
चमत्कारी	t͡ʃəmət̪käːɾiː
ज़िंदा	zɪ̃n̪d̪äː
मक़दूनिया	məqd̪uːn̪ijäː
द्वारा	d̪wäːɾäː
बनना	bə̃n̪n̪äː
सिरका	s̪ɪɾkäː
गड्ढा	ɡəɖ̚ɖʱäː
स्टेथोस्कोप	s̪ʈeːt̪ʰoːs̪koːp
अयोग्यता	əjoːɡjət̪äː
नेपाल	n̪eːpäːl̪
बुलावा	bʊl̪äːʋäː
ज़लज़ला	zəl̪zəl̪äː
कंठ	kə̃ɳʈʰ
ढील	ɖʱiːl̪
दारू	d̪äːɾuː
मजाल	məd͡ʒäːl̪
क्रान्ति	kɾä̃ːn̪t̪iː
कैसा	kɛːs̪äː
विकिरणशील	ʋɪkɪɾə̃ɳʃiːl̪
वकालत	ʋəkäːl̪ət̪
अच्छाई	ət̚t͡ʃʰäːiː
नरसंहार	n̪əɾs̪ə̃ɦäːɾ
मेघालय	meːɡʱäːl̪əj
प्रत्यर्पण	pɾət̪jəɾpə̃ɳ
हम	ɦə̃m
चौरानवे	t͡ʃɔːɾä̃ːn̪weː
वड़ा	ʋəɽäː
क़ाफ़िला	käːpʰɪl̪äː
आत्मघाती	äːt̪məɡʱäːt̪iː
अनाड़ी	ən̪äːɽiː
धुन्नी	d̪ʱʊ̃n̪n̪iː
बुलेटिन	bʊl̪eːʈɪ̃n̪
दीवार	d̪iːʋäːɾ
अक्सर	əks̪əɾ
लाओस	l̪äːoːs̪
अन्त	ə̃n̪t̪
तंबोला	t̪ə̃mboːl̪äː
अयोध्या	əjoːd̪ʱjäː
तालाबंदी	t̪äːl̪äːbə̃n̪d̪iː
चिमटा	t͡ʃɪ̃mʈäː
मूतना	muːt̪̚n̪äː
उत्तराधिकार	ʊt̪̚t̪əɾäːd̪ʱɪkäːɾ
कालिज	käːl̪ɪd͡ʒ
ब्रह्मदेश	bɾɛɦməd̪eːʃ
आवाजाही	äːʋäːd͡ʒäːɦiː
तसला	t̪əs̪l̪äː
माने	mäːn̪eː
खैरात	kʰɛːɾäːt̪
खुला	kʰʊl̪äː
मुर्दन	mʊɾd̪ə̃n̪
अनौपचारिक	ən̪ɔːpt͡ʃäːɾɪk
मसला	məs̪l̪äː
मातम	mäːt̪ə̃m
मटकाना	məʈkäːn̪äː
आलू	äːl̪uː
यातु	jäːt̪uː
मनोबल	mən̪oːbəl̪
ध्वस्त	d̪ʱʋəs̪t̪
बनवाना	bə̃n̪wäːn̪äː
अपराधिनी	əpɾäːd̪ʱɪn̪iː
तारख़ाना	t̪äːɾkʰäːn̪äː
अहिवाद	əɦɪʋäːd̪
अविश्वासनीय	əʋɪʃʋäːs̪n̪iːjᵊ
संयमी	s̪ə̃n̪jəmiː
नदारद	n̪əd̪äːɾəd̪
छाला	t͡ʃʰäːl̪äː
खुदाई	kʰʊd̪äːiː
इंतज़ार	ɪ̃n̪t̪əzäːɾ
तौल	t̪ɔːl̪
निनानवे	n̪ɪn̪ä̃ːn̪weː
दहना	d̪ɛɦn̪äː
वाटर	ʋäːʈəɾ
मज़ाक़िया	məzäːqijäː
ख़बरनवीस	xəbəɾn̪əʋiːs̪
शर्मनाक	ʃəɾmn̪äːk
अन्न	ə̃n̪n̪ᵊ
हिचकिचाना	ɦɪt͡ʃkɪt͡ʃäːn̪äː
दिलबर	d̪ɪl̪bəɾ
आपातकाल	äːpäːt̪käːl̪
तिमाही	t̪ɪmäːɦiː
सौतेला	s̪ɔːt̪eːl̪äː
समय	s̪əməj
शुष्कफल	ʃʊʃkəpʰəl̪
मानुस	mäːn̪ʊs̪
पच्चीस	pət̚t͡ʃɪs̪
लिखित	l̪ɪkʰɪt̪
प्लीहा	pl̪iːɦäː
स्कॉट्स	s̪kɔʈs̪
मुअज़्ज़िन	mʊəd̚d͡ʒɪ̃n̪
सांख्यिकी	s̪ä̃ːkʰjɪkiː
महापण्डित	məɦäːpə̃ɳɖɪt̪
बुनना	bʊ̃n̪n̪äː
असंतुष्ट	əs̪ə̃n̪t̪ʊʂʈ
फफूँदी	pʰəpʰũːn̪d̪iː
ताक़त	t̪äːqət̪
लगान	l̪əɡä̃ːn̪
हमाहमी	ɦəmäːɦəmiː
नज़र	n̪əzəɾ
बिहार	bɪɦäːɾ
जटा	d͡ʒəʈäː
कुसुम	kʊs̪ʊ̃m
गुप्तचर	ɡʊpt̪̚t͡ʃəɾ
कमान	kəmä̃ːn̪
पुराण	pʊɾä̃ːɳ
थकावट	t̪ʰəkäːʋəʈ
शिलातैल	ʃɪl̪äːt̪ɛːl̪
ग़लती	ɡəl̪t̪iː
सत्रह	s̪ət̪ɾəɦ
इंतज़ाम	ɪ̃n̪t̪əzä̃ːm
अँगरेज़	ə̃ŋɡɾeːz
फूफा	pʰuːpʰäː
बेंच	bẽːn̪t͡ʃ
साड़ी	s̪äːɽiː
पिज़्ज़ा	pɪzzäː
ज़ालिम	d͡ʒäːl̪ɪ̃m
अंशुक	ə̃n̪ʃʊk
समामेलित	s̪əmäːmeːl̪ɪt̪
सदन	s̪əd̪ə̃n̪
मामा	mäːmäː
बीकानेर	biːkäːn̪eːɾ
कथन	kət̪ʰə̃n̪
पुनः	pʊn̪əɦ
एहसानमंद	eːɦs̪ä̃ːn̪mə̃n̪d̪
टोना	ʈoːn̪äː
ख़ंजर	kʰə̃n̪d͡ʒəɾ
क़ौम	qɔ̃ːm
दिलरुबा	d̪ɪl̪ɾʊbäː
आततायी	äːt̪ət̪äːjiː
लेना	l̪eːn̪äː
कुंजड़ा	kʊ̃n̪d͡ʒɽäː
आज़ार	äːd͡ʒäːɾ
रैनबसेरा	ɾɛ̃ːn̪bəs̪eːɾäː
ठेकेदार	ʈʰeːkeːd̪äːɾ
दंत्य	d̪ə̃n̪t̪jᵊ
रूमाल	ɾuːmäːl̪
निश्चित	n̪ɪʃt͡ʃɪt̪
हतोत्साहित	ɦət̪oːt̪s̪äːɦɪt̪
वाक्य	ʋäːkjᵊ
मस्तिष्क	məs̪t̪ɪʃk
नाज़	n̪äːz
आवारा	äːʋäːɾäː
फ़ाश	fäːʃ
पिचकना	pɪt͡ʃəkn̪äː
फुहार	pʰʊɦäːɾ
चीख़ना	t͡ʃiːxn̪äː
मुस्टंडा	mʊs̪ʈə̃ɳɖäː
निर्णय	n̪ɪɾɳəj
इंतख़ाब	ɪ̃n̪t̪əkʰäːb
संकोच	s̪ə̃ŋkoːt͡ʃ
जोहना	d͡ʒoːɦn̪äː
सरेआम	s̪əɾeːä̃ːm
माहिर	mäːɦɪɾ
आग्नेयास्त्र	äːɡn̪eːjäːs̪t̪ɾᵊ
संतान	s̪ə̃n̪t̪ä̃ːn̪
मनीऑर्डर	mən̪iːɔɾɖəɾ
दीपिका	d̪iːpɪkäː
हार्दिक	ɦäːɾd̪ɪk
रमणीय	ɾə̃mɳiːjᵊ
क़त्लेआम	kət̪l̪eːä̃ːm
कोसना	koːs̪n̪äː
मंत्र	mə̃n̪t̪ɾᵊ
सिर	s̪ɪɾ
हंगुल	ɦə̃ŋɡʊl̪
लायक़	l̪äːjəq
चाहना	t͡ʃäːɦn̪äː
धाम	d̪ʱä̃ːm
डेनमार्क	ɖẽːn̪mäːɾk
मोरनी	moːɾn̪iː
लाइन	l̪äːɪ̃n̪
कार्यसमिति	käːɾjəs̪əmɪt̪iː
खलासी	kʰəl̪äːs̪iː
चरख़ा	t͡ʃəɾxäː
ओझल	oːd͡ʒʱəl̪
अनाज	ən̪äːd͡ʒ
हड्डी	ɦəɖ̚ɖiː
विषाणु	ʋɪʃäːɳuː
तुमने	t̪ʊ̃mn̪eː
माहौल	mäːɦɔːl̪
फ़ासला	pʰäːs̪l̪äː
नादान	n̪äːd̪ä̃ːn̪
पाई	päːiː
गांड	ɡä̃ːɳɖ
जागना	d͡ʒäːɡn̪äː
कुख्यात	kʊkʰjäːt̪
पुरुषोचित	pʊɾʊʃoːt͡ʃɪt̪
प्रगतिवाद	pɾəɡət̪ɪʋäːd̪
आत्मबलिदान	äːt̪məbəl̪ɪd̪ä̃ːn̪
ख़्वाबगाह	kʰʋäːbɡäːɦ
प्रवीणता	pɾəʋĩːɳt̪äː
बहादुरी	bəɦäːd̪ʊɾiː
अथवा	ət̪ʰʋäː
ज़ुल्फ़	d͡ʒʊl̪pʰ
उजाला	ʊd͡ʒäːl̪äː
ऋषि	ɾɪʃiː
आत्मा	äːt̪mäː
मरहम	məɾɦə̃m
रत्न	ɾət̪̚n̪ᵊ
प्रयास	pɾəjäːs̪
चिट्टी	t͡ʃɪʈ̚ʈiː
काकी	käːkiː
शोषित	ʃoːʃɪt̪
गायब	ɣäːjəb
छिपाना	t͡ʃʰɪpäːn̪äː
नगर	n̪əɡəɾ
उनसठ	ʊ̃n̪s̪əʈʰ
रामलीला	ɾä̃ːml̪iːl̪äː
चन्द	t͡ʃə̃n̪d̪
ब्रह्मा	bɾɛɦmäː
मेज़बान	meːzbä̃ːn̪
अंजु	ə̃n̪d͡ʒuː
सीढ़ी	s̪iːɽʱiː
आज़माना	äːd͡ʒmäːn̪äː
सम्राज्ञी	s̪ə̃mɾäːɡjiː
तैनाती	t̪ɛːn̪äːt̪iː
राज़	ɾäːd͡ʒ
उसूल	ʊs̪uːl̪
कायोत्सर्ग	käːjoːt̪s̪əɾɡ
स्वच्छता	s̪ʋət̚t͡ʃʰt̪äː
सहपाठी	s̪ɛɦpäːʈʰiː
तराई	t̪əɾäːiː
माता	mäːt̪äː
नजीबाबाद	n̪əd͡ʒiːbäːbäːd̪
सालन	s̪äːl̪ə̃n̪
असमर्थ	əs̪əməɾt̪ʰ
अर्धशिक्षित	əɾd̪ʱʃɪkʃɪt̪
आला	äːl̪äː
गुरुत्वीय	ɡʊɾʊt̪wiːjᵊ
रस	ɾəs̪
लतीफ़ा	l̪ət̪iːfäː
लीडरी	l̪iːɖəɾiː
उबाऊ	ʊbäːuː
तिरपाल	t̪ɪɾpäːl̪
ग़ुसलख़ाना	ɣʊs̪əl̪xäːn̪äː
सर्वनाम	s̪əɾʋn̪ä̃ːm
ख़सरा	xəs̪ɾäː
हालाँकि	ɦäːl̪ä̃ːkiː
मलना	məl̪n̪äː
माशा	mäːʃäː
सोखना	s̪oːkʰn̪äː
पर्यटन	pəɾjəʈə̃n̪
नवाबशाह	n̪əʋäːbʃäːɦ
अभ्यागत	əbʱjäːɡət̪
दासप्रथा	d̪äːs̪pɾət̪ʰäː
बहकना	bɛɦɛkn̪äː
घोराही	ɡʱoːɾäːɦiː
पेटेंट	peːʈẽːɳʈ
गढ़वाल	ɡəɽʱʋäːl̪
पंजा	pə̃n̪d͡ʒäː
लैंडर	l̪ɛ̃ːɳɖəɾ
बोझिल	boːd͡ʒʱɪl̪
कड़वाहट	kəɽʋäːɦəʈ
कहावत	kəɦäːʋət̪
ज़ुल्फ़	zʊl̪f
वैशाख	ʋɛːʃäːkʰ
तात्क्षणिक	t̪äːt̪kʃəɳɪk
छलावा	t͡ʃʰəl̪äːʋäː
व्लादिमीर	ʋl̪äːd̪ɪmiːɾ
पूछताछ	puːt͡ʃʰt̪äːt͡ʃʰ
ममता	mə̃mt̪äː
पृथक्करण	pɾɪt̪ʰək̚kəɾə̃ɳ
मसख़री	məs̪kʰəɾiː
कठुआ	kəʈʰʊäː
गुणधर्म	ɡʊ̃ɳd̪ʱəɾm
खोना	kʰoːn̪äː
अनकहा	ə̃n̪kəɦäː
बताना	bət̪äːn̪äː
अलि	əl̪iː
परिकलित	pəɾɪkl̪ɪt̪
समूहन	s̪əmuːɦə̃n̪
शुरुआत	ʃʊɾʋäːt̪
बंदिश	bə̃n̪d̪ɪʃ
हमशक्ल	ɦə̃mʃəkl̪ᵊ
पत्थरबाज़ी	pət̪̚t̪ʰəɾbäːd͡ʒiː
ख़ानगी	xä̃ːn̪ɡiː
चौथा	t͡ʃɔːt̪ʰäː
अड़ाना	əɽäːn̪äː
चुकंदर	t͡ʃʊqə̃n̪d̪əɾ
नील	n̪iːl̪
कोष	koːʃ
नक़ल	n̪əkəl̪
खुलेआम	kʰʊl̪eːä̃ːm
ज़मीनी	d͡ʒəmiːn̪iː
कुटुंब	kʊʈʊ̃mb
सुअर	s̪ʊəɾ
पगोडा	pəɡoːɖäː
आरज़ू	äːɾzuː
सड़ियल	s̪əɽijəl̪
गंदगी	ɡə̃n̪d̪əɡiː
प्रमाणभूत	pɾəmä̃ːɳbʱuːt̪
लोथ	l̪oːt̪ʰ
शफ़ा	ʃəpʰäː
ख़ातिर	kʰäːt̪ɪɾ
सूचित	s̪uːt͡ʃɪt̪
बांटना	bä̃ːʈn̪äː
रिवाज	ɾɪʋäːd͡ʒ
दम्पती	d̪ə̃mpət̪iː
ढाबा	ɖʱäːbäː
फ़िल्म	fɪl̪m
हरामज़ादा	ɦəɾä̃ːmd͡ʒäːd̪äː
गौरैया	ɡɔːɾə̯ijäː
चीज़बस्त	t͡ʃiːzbəs̪t̪
आपस	äːpəs̪
अभिकलित्र	əbʱɪkəl̪ɪt̪ɾᵊ
कमिश्नर	kəmɪʃn̪əɾ
दुहाई	d̪ʊɦäːiː
यमराज	jə̃mɾäːd͡ʒ
मुँडेर	mʊ̃ɳɖeːɾ
शासन	ʃäːs̪ə̃n̪
दरोग़ा	d̪əɾoːɡäː
त्यागना	t̪jäːɡn̪äː
ठिकाना	ʈʰɪkäːn̪äː
नीदरलैंड	n̪iːd̪əɾl̪ɛ̃ːɳɖ
वित्तीय	ʋɪt̪̚t̪iːjᵊ
सेर	s̪eːɾ
बाक़ी	bäːqiː
स्मारक	s̪mäːɾək
अंतर	ə̃n̪t̪əɾ
कम्युनिजम	kə̃mjʊn̪ɪd͡ʒə̃m
पोलिश	poːl̪ɪʃ
अवयस्क	əʋəjəs̪k
आसामी	äːs̪äːmiː
दहलीज़	d̪ɛɦl̪iːd͡ʒ
चेरापूंजी	t͡ʃeːɾäːpũːn̪d͡ʒiː
टेलिफोन	ʈeːl̪ɪfõːn̪
ऊष्मीकरण	uːʃmiːkəɾə̃ɳ
आश्विन	äːʃʋɪ̃n̪
सराय	s̪əɾäːj
मिथ्या	mɪt̪ʰjäː
अखाड़ा	əkʰäːɽäː
उत्तराधिकारी	ʊt̪̚t̪əɾäːd̪ʱɪkäːɾiː
पत्रवाहक	pət̪ɾəʋäːɦək
संकलन	s̪ə̃ŋkəl̪ə̃n̪
उक़ाब	ʊqäːb
ज़िंबाब्वे	zɪ̃mbäːbweː
परनाना	pəɾn̪äːn̪äː
गोबरैला	ɡoːbɾɛːl̪äː
दीया	d̪iːjäː
जबलपुर	d͡ʒəbəl̪pʊɾ
सुन्नी	s̪ʊ̃n̪n̪iː
मसरूफ़	məs̪ɾuːf
ख़रबूज़ा	xəɾbuːzäː
भिक्षा	bʱɪkʃäː
जलजमाव	d͡ʒəl̪d͡ʒəmäːʋ
कोयल	koːjəl̪
कारबार	käːɾbäːɾ
उदाहरण	ʊd̪äːɦɾə̃ɳ
ईमानदार	iːmä̃ːn̪d̪äːɾ
हरमसरा	ɦəɾə̃m‿s̪əɾäː
टेलीफ़ोन	ʈeːl̪iːpʰõːn̪
पर्चा	pəɾt͡ʃäː
लब	l̪əb
खल्लास	kʰəl̪l̪äːs̪
धान	d̪ʱä̃ːn̪
अंटार्टिका	ə̃ɳʈäːɾʈɪkäː
अप्सरा	əps̪əɾäː
अभिनेत्री	əbʱɪn̪eːt̪ɾiː
हाज़िरजवाब	ɦäːd͡ʒɪɾd͡ʒəʋäːb
गढ़ना	ɡəɽʱn̪äː
कामवाली	kä̃ːmwäːl̪iː
बक़ाया	bəqäːjäː
ख़लिश	kʰəl̪ɪʃ
समालोचना	s̪əmäːl̪oːt͡ʃn̪äː
घीया	ɡʱiːjäː
परिसमापन	pəɾɪs̪mäːpə̃n̪
कंपित	kə̃mpɪt̪
टूटना	ʈuːʈn̪äː
करूंगा	kəɾũːŋɡäː
मानचित्र	mä̃ːn̪t͡ʃɪt̪ɾᵊ
शोषण	ʃoːʃə̃ɳ
कोण	kõːɳ
ग़लतफ़हमी	ɣəl̪ət̪fɛɦmiː
डिजिटलीकृत	ɖɪd͡ʒɪʈəl̪iːkɾɪt̪
अपॉइंटमेंट	əpɔɪ̃ɳʈmẽːɳʈ
सखा	s̪əkʰäː
सुरीला	s̪ʊɾiːl̪äː
सोलह	s̪oːl̪əɦ
लापसी	l̪äːps̪iː
सोआ	s̪oːäː
दाग़ना	d̪äːɣn̪äː
कलाकार	kəl̪äːkäːɾ
नहान	n̪əɦä̃ːn̪
सरकार	s̪əɾkäːɾ
क्षीण	kʃĩːɳ
स्थायी	s̪t̪ʰäːjiː
फ्रांस	fɾä̃ːn̪s̪
मकदूनिया	məqd̪uːn̪ijäː
फ़्लैट	fl̪ɛːʈ
गया	ɡəjäː
सदरी	s̪əd̪ɾiː
धोखाधड़ी	d̪ʱoːkʰäːd̪ʱəɽiː
पुण्डरी	pʊ̃ɳɖɾiː
आतिशबाज़ी	äːt̪ɪʃbäːd͡ʒiː
पंजीकरण	pə̃n̪d͡ʒiːkəɾə̃ɳ
घोंघा	ɡʱõːŋɡʱäː
कहा	kəɦäː
मच्छी	mət̚t͡ʃʰiː
निर्धारण	n̪ɪɾd̪ʱäːɾə̃ɳ
नौकर	n̪ɔːkəɾ
क्लब	kl̪əb
हिमपात	ɦɪ̃mpäːt̪
वाष्पचालित	ʋäːʃpt͡ʃäːl̪ɪt̪
जाँघिया	d͡ʒä̃ːŋɡʱijäː
कोरेगांव	koːɾeːɡä̃ːmw
फ़्लोरिडा	pʰl̪oːɾɪɖäː
उनचास	ʊ̃n̪t͡ʃäːs̪
अभिप्राय	əbʱɪpɾäːj
तिरपन	t̪ɪɾpə̃n̪
सन्देह	s̪ə̃n̪d̪eːɦ
आरंभिक	äːɾə̃mbʱɪk
भावुक	bʱäːʋʊk
परिसंघ	pəɾɪs̪ə̃ŋɡʱ
मच्छ	mət̚t͡ʃʰ
सड़ना	s̪əɽn̪äː
येड़ा	jeːɽäː
क़ुल्फ़ी	qʊl̪fiː
वानर	ʋäːn̪əɾ
पोतना	poːt̪̚n̪äː
अभिकथन	əbʱɪkət̪ʰə̃n̪
पच्चीस	pət̚t͡ʃiːs̪
कामगार	kä̃ːmɡäːɾ
कड़कड़ाना	kəɽkəɽäːn̪äː
रुचिरा	ɾʊt͡ʃɪɾäː
आखिर	äːkʰɪɾ
पड़ाना	pəɽäːn̪äː
ललचाना	l̪əl̪t͡ʃäːn̪äː
ख़ुफ़िया	xʊfijäː
केन्या	kẽːn̪jäː
दूसरे	d̪uːs̪ɾeː
निवृत्त	n̪ɪʋɾɪt̪t̪
भली	bʱəl̪iː
टीका	ʈiːkäː
संक्रमित	s̪ə̃ŋkɾəmɪt̪
प्रगतिवादी	pɾəɡət̪ɪʋäːd̪iː
निदेशक	n̪ɪd̪eːʃək
प्रधानाध्यापक	pɾəd̪ʱäːn̪äːd̪ʱjäːpək
पहुँचना	pɔɦɔ̃n̪t͡ʃn̪äː
बित्ता	bɪt̪̚t̪äː
साम्यवाद	s̪ä̃ːmjəʋäːd̪
इसराईली	ɪs̪ɾäːiːl̪iː
तरफ़दार	t̪əɾəfd̪äːɾ
तत्सम	t̪ət̪s̪ə̃m
दिक़्क़त	d̪ɪk̚kət̪
विनाशक	ʋɪn̪äːʃək
पहाड़	pəɦäːɽ
बदन	bəd̪ə̃n̪
बनाम	bən̪ä̃ːm
चमचमाना	t͡ʃə̃mt͡ʃəmäːn̪äː
सक्षम	s̪əkʃə̃m
दबोचना	d̪əboːt͡ʃn̪äː
गुलाब	ɡʊl̪əb
बाकी	bäːqiː
आज्ञा	äːɡjäː
मराठा	məɾäːʈʰäː
छब्बीस	t͡ʃʰəb̚bɪs̪
संग	s̪ə̃ŋɡ
वास्तविकता	ʋäːs̪t̪əʋɪkt̪äː
किताब	kɪt̪äːb
दुःस्वप्न	d̪ʊs̪ʋəpn̪ə
अर्धांगिनी	əɾd̪ʱä̃ːŋɡɪn̪iː
बाग	bäːɡ
साथसाथ	s̪äːt̪ʰs̪äːt̪ʰ
पशुपालक	pəʃʊpäːl̪ək
प्रतिबंध	pɾət̪ɪbə̃n̪d̪ʱ
सक्सेना	s̪əks̪eːn̪äː
रहस्यमय	ɾɛɦɛs̪jəməj
क़िल्लत	qɪl̪l̪ət̪
खयालें	kʰəjäːl̪ẽː
फ़्लैट	pʰl̪ɛːʈ
बढ़ना	bəɽʱn̪äː
ख़ान	kʰä̃ːn̪
नक़दी	n̪əqd̪iː
आवेदनकर्ता	äːʋeːd̪ə̃n̪kəɾt̪äː
करिश्मा	kəɾɪʃmäː
एकाध	eːkäːd̪ʱ
प्रोग्राम	pɾoːɡɾä̃ːm
पेचकस	peːt͡ʃkəs̪
झाड़ी	d͡ʒʱäːɽiː
उन्होंने	ʊ̃n̪ɦõːn̪eː
रेडियो	ɾeːɖijoː
क़ाफ़िला	qäːfɪl̪äː
शब्दाडंबर	ʃəbd̪äːɖə̃mbəɾ
जॉर्डन	d͡ʒɔɾɖə̃n̪
सब्ज़ी	s̪əbd͡ʒiː
मिसेज़	mɪs̪eːd͡ʒ
अपहर्ता	əpʰəɾt̪äː
बाँसुरी	bä̃ːs̪ʊɾiː
चाँदी	t͡ʃä̃ːn̪d̪iː
ख़रीदारी	kʰəɾiːd̪äːɾiː
औपस्थ्य	ɔːpəs̪t̪ʰjᵊ
पापड़ी	päːpɽiː
हिचकना	ɦɪt͡ʃəkn̪äː
विखंडन	ʋɪkʰə̃ɳɖə̃n̪
रौज़न	ɾɔːd͡ʒə̃n̪
वायुसेना	ʋäːjuːs̪eːn̪äː
सौदा	s̪ɔːd̪äː
अस्पताली	əs̪pət̪äːl̪iː
सम्मानजनक	s̪ə̃mmä̃ːn̪d͡ʒən̪ək
पतलून	pət̪l̪ũːn̪
कृत्रिम	kɾɪt̪ɾɪ̃m
दरांती	d̪əɾä̃ːn̪t̪iː
क़ब्ज़ा	kəbd͡ʒäː
भूजल	bʱuːd͡ʒəl̪
काँच	kä̃ːt͡ʃ
बहुभाषीय	bəɦubʱɑːʂijə
प्याज़	pjäːd͡ʒ
तख़लिया	t̪əxl̪ijäː
संकलक	s̪ə̃ŋkəl̪ək
जमाख़ोरी	d͡ʒəmäːxoːɾiː
पचास	pət͡ʃäːs̪
चमचा	t͡ʃə̃mt͡ʃäː
फ़रिश्ता	fəɾɪʃt̪äː
जिमीकंद	d͡ʒɪmiːkə̃n̪d̪
बीमा	biːmäː
कतराना	kət̪ɾäːn̪äː
आनरेरी	ä̃ːn̪ɾeːɾiː
सन्नाटा	s̪ə̃n̪n̪äːʈäː
सशस्त्र	s̪əʃəs̪t̪ɾᵊ
महावीर	məɦäːʋiːɾ
मज़ाक़	məd͡ʒäːk
गंजा	ɡə̃n̪d͡ʒäː
काँपना	kä̃ːpn̪äː
सुख	s̪ʊkʰ
आमदनी	äːməd̪̚n̪iː
सत्ताईस	s̪ət̪̚t̪äːiːs̪
बुल्गारिया	bʊl̪ɡäːɾijäː
अकड़ना	əkəɽn̪äː
दशम	d̪əʃə̃m
अहं	ɛɦɛ̃m
कानून	qäːn̪ũːn̪
सच्चा	s̪ət̚t͡ʃäː
सिद्धांत	s̪ɪd̪̚d̪ʱä̃ːn̪t̪
पिशाच	pɪʃäːt͡ʃ
अरिहंत	əɾɪɦə̃n̪t̪
जुनहार	d͡ʒʊ̃n̪ɦäːɾ
सुईदाब	s̪ʊiːd̪äːb
नरेश	n̪əɾeːʃ
अपरिपक्व	əpɾɪpəkwᵊ
अनस्तित्व	ən̪əs̪t̪ɪt̪wᵊ
ख़फ़ा	kʰəpʰäː
बमबारी	bə̃mbäːɾiː
शिव	ʃɪʋäː
वाहक	ʋäːɦək
जहान	d͡ʒəɦä̃ːn̪
पलटाना	pəl̪ʈäːn̪äː
सरद	s̪əɾəd̪
छत्तीस	t͡ʃʰət̪̚t̪iːs̪
पूजा	puːd͡ʒäː
कम्युनिज़्म	kə̃mjʊn̪ɪd͡ʒmᵊ
कसके	kəs̪keː
मृदुता	mɾɪd̪ʊt̪äː
लाज़िम	l̪äːd͡ʒɪ̃m
शृंखला	ʃɾɪ̃ŋkʰl̪äː
नक़ाब	n̪əkäːb
मंडलवक	mə̃ɳɖəl̪əʋək
तलवार	t̪əl̪ʋäːɾ
आख़िर	äːkʰɪɾ
कामना	kä̃ːmn̪äː
स्नातक	s̪n̪äːt̪ək
कचरा	kət͡ʃɾäː
आनंदमय	äːn̪ə̃n̪d̪məj
सोमाली	s̪oːmäːl̪iː
खारा	kʰäːɾäː
पंजाब	pə̃n̪d͡ʒäːb
तैनात	t̪ɛːn̪äːt̪
मजनू	məd͡ʒn̪uː
सुंदर	s̪ʊ̃n̪d̪əɾ
असमय	əs̪əməj
ईसाई	iːs̪äːiː
शाश्वत	ʃäːʃʋət̪
क्षितिज	kʃɪt̪ɪd͡ʒ
छायाकार	t͡ʃʰäːjäːkäːɾ
मिलनसार	mɪl̪ə̃n̪s̪äːɾ
रक़्क़ासा	ɾəqqäːs̪äː
दबंग	d̪əbə̃ŋɡ
सिंहला	s̪ɪ̃ŋɡʱl̪äː
कसेरा	kəs̪eːɾäː
आसन्न	äːs̪ə̃n̪n̪ᵊ
पनाहगाह	pən̪äːɦɡäːɦ
हबक्क़ूक़	ɦəbək̚kʊk
भंडार	bʱə̃ɳɖäːɾ
सर्वप्रथम	s̪əɾʋpɾət̪ʰə̃m
मुग़ालता	mʊɣäːl̪t̪äː
सेही	s̪eːɦiː
तारीफ	t̪äːɾiːpʰ
उड़ान	ʊɽä̃ːn̪
ख़ास	kʰäːs̪
लुग़ात	l̪ʊɡäːt̪
इसराज	ɪs̪ɾäːd͡ʒ
मुनीम	mʊn̪ĩːm
अनगिनत	ə̃n̪ɡɪn̪ət̪
ऊंचा	ũːt͡ʃäː
अण्डा	ə̃ɳɖäː
प्रक्षेपास्त्र	pɾəkʃeːpäːs̪t̪ɾᵊ
उस	ʊs̪
वाहन	ʋäːɦə̃n̪
नादानी	n̪äːd̪äːn̪iː
काष्ठशर्करा	käːʂʈʰʃəɾkəɾäː
दफ़नाना	d̪əpʰn̪äːn̪äː
रंगकर्मी	ɾə̃ŋɡkəɾmiː
विद्या	ʋɪd̪jäː
अनूदित	ən̪uːd̪ɪt̪
गुबरैला	ɡʊbɾɛːl̪äː
उत्सुक	ʊt̪s̪ʊk
मार्च	mäːɾt͡ʃ
पुष्प	pʊʃp
तरीका	t̪əɾiːqäː
संभव	s̪ə̃mbʱəʋ
रिज़ल्ट	ɾɪd͡ʒəl̪ʈ
फेफड़ा	pʰeːpʰɽäː
सयाना	s̪əjäːn̪äː
कानपुर	kä̃ːn̪pʊɾ
उत्पादन	ʊt̪päːd̪ə̃n̪
फँसना	pʰə̃s̪n̪äː
फुंसी	pʰʊ̃n̪s̪iː
रोमांच	ɾoːmä̃ːt͡ʃ
परसर्ग	pəɾs̪əɾɡ
तालिका	t̪äːl̪ɪkäː
जल्दबाज़ी	d͡ʒəl̪d̪bäːd͡ʒiː
महकमा	mɛɦɛkmäː
तनख़्वाह	t̪ə̃n̪kʰäːɦ
सुस्ती	s̪ʊs̪t̪iː
इकट्ठा	ɪkəʈ̚ʈʰäː
नान	n̪ä̃ːn̪
भरना	bʱəɾn̪äː
अमेरिका	əmeːɾɪkäː
स़िफ़र	s̪ɪfəɾ
अजाइब	əd͡ʒäːɪb
आतंकमय	äːt̪ə̃ŋkməj
चक्षु	t͡ʃəkʃuː
स	s̪ə
झुमका	d͡ʒʱʊ̃mkäː
मानव	mäːn̪əʋ
मंगलवार	mə̃ŋɡəl̪ʋäːɾ
भौंरा	bʱɔ̃ːɾäː
तैंतालीस	t̪ɛ̃ːn̪t̪äːl̪iːs̪
बिजलीकरण	bɪd͡ʒl̪iːkəɾə̃ɳ
कपड़ा	kəpɽäː
पैकार	pɛːkäːɾ
नक़्क़ारा	n̪əqqäːɾäː
असर	əs̪əɾ
उज्ज्वल	ʊd̚d͡ʒʋəl̪
स्यूत	s̪juːt̪
ट्रेन	ʈɾẽːn̪
क़त्ल	qət̪l̪
साइकल	s̪äːɪkəl̪
ख़्वाहिश	kʰäːɦɪʃ
सैकता	s̪ɛːkt̪äː
गाल	ɡäːl̪
शिश्नमुंड	ʃɪʃn̪əmʊ̃ɳɖ
क़हर	kɛɦɛɾ
निरस्त्रीकरण	n̪ɪɾəs̪t̪ɾiːkəɾə̃ɳ
अधिवक्ता	əd̪ʱɪʋəkt̪äː
परनिंदा	pəɾn̪ɪ̃n̪d̪äː
स्टेशन	s̪ɪʈeːʃə̃n̪
हेज़लनट	ɦeːzəl̪n̪əʈ
प्रयत्नशील	pɾəjət̪̚n̪əʃiːl̪
या	jäː
गुलाबी	ɡʊl̪äːbiː
मुग़ल	mʊɣəl̪
भंकस	bʱə̃ŋkəs̪
हिरन	ɦɪɾə̃n̪
सुधारना	s̪ʊd̪ʱäːɾn̪äː
विद्वान्	ʋɪd̪wä̃ːn̪
सदमा	s̪əd̪mäː
पास्ता	päːs̪t̪äː
बौछाड़	bɔːt͡ʃʰäːɽ
अफगानिस्तान	əpʰɡäːn̪ɪs̪t̪ä̃ːn̪
घरेलू	ɡʱəɾeːl̪uː
तिकड़म	t̪ɪkɽə̃m
एकसदनीयता	eːks̪əd̪ən̪iːjt̪äː
उत्तरदायी	ʊt̪̚t̪əɾd̪äːjiː
सख्खर	s̪əkʰkʰəɾ
भूमिका	bʱuːmɪkäː
क़ायम	qäːjə̃m
आँधी	ä̃ːn̪d̪ʱiː
आस्ति	äːs̪t̪iː
औलिया	ɔːl̪ijäː
हैरानी	ɦɛːɾäːn̪iː
रिक्शा	ɾɪkʃäː
भाँजना	bʱä̃ːn̪d͡ʒn̪äː
चक्कर	t͡ʃək̚kəɾ
बहिष्कार	bəɦɪʃkäːɾ
अंचल	ə̃n̪t͡ʃəl̪
आबरू	äːbɾuː
अड़सठ	əɽs̪əʈʰ
ज़ैतून	d͡ʒɛːt̪ũːn̪
ताल	t̪äːl̪
दंगा	d̪ə̃ŋɡäː
हमसफ़र	ɦə̃ms̪əpʰəɾ
ख़ूँख़ार	xũːxäːɾ
छमाही	t͡ʃʰəmäːɦiː
मुअल्लम	mʊəl̪l̪ə̃m
तालमेल	t̪äːl̪meːl̪
द्रष्टव्य	d̪ɾəʃʈəʋjᵊ
शहज़ादा	ʃɛɦd͡ʒäːd̪äː
चित्रण	t͡ʃɪt̪ɾə̃ɳ
क़हवा	qɛɦʋäː
बहुपद	bɔɦɔpəd̪
दर्शाना	d̪əɾʃäːn̪äː
अभिनय	əbʱɪn̪əj
जमवाना	d͡ʒə̃mwäːn̪äː
इश्तिहार	ɪʃt̪ɪɦäːɾ
रतालू	ɾət̪äːl̪uː
लाल	l̪äːl̪
किर्गिज़स्तान	kɪɾɡɪd͡ʒəs̪t̪ä̃ːn̪
ऊफ़ा	uːfäː
चित्तूर	t͡ʃɪt̪̚t̪uːɾ
टेलीफोन	ʈeːl̪iːpʰõːn̪
मैसिडोनिया	mɛːs̪ɪɖoːn̪ijäː
दुनिया	d̪ʊn̪ijäː
बुंदेली	bʊ̃n̪d̪eːl̪iː
उस्ताद	ʊs̪t̪äːd̪
पारिवारिक	päːɾɪʋäːɾɪk
सर्वथा	s̪əɾʋət̪ʰäː
उसमान	ʊs̪mä̃ːn̪
आवेग	äːʋeːɡ
शिल्पशाला	ʃɪl̪pʃäːl̪äː
क़िल्लत	kɪl̪l̪ət̪
जहर	zɛɦɛɾ
समनुषंगी	s̪ə̃mn̪ʊʃə̃ŋɡiː
शरण	ʃəɾə̃ɳ
आयुर्विज्ञान	äːjʊɾʋɪɡjä̃ːn̪
शास्त्रीय	ʃäːs̪t̪ɾiːjᵊ
तुलसीदास	t̪ʊl̪s̪iːd̪äːs̪
सट्टेबाज़	s̪əʈ̚ʈeːbäːz
मज़ाक़िया	məd͡ʒäːkijäː
फलो	pʰəl̪oː
डाल	ɖäːl̪
सहित	s̪əɦɪt̪
महोदया	məɦoːd̪əjäː
ज़ाहिर	zäːɦɪɾ
आविष्कार	äːʋɪʃkäːɾ
मलयालम	məl̪əjäːl̪ə̃m
अटारी	əʈäːɾiː
नस्लभेद	n̪əs̪l̪bʱeːd̪
इब्तिदाई	ɪbt̪ɪd̪äːiː
लहज़ा	l̪ɛɦd͡ʒäː
ख़र्चा	xəɾt͡ʃäː
प्रत्याशा	pɾət̪jäːʃäː
कुदाल	kʊd̪äːl̪
अझ़दहा	əzd̪əɦäː
गुड़ाकू	ɡʊɽäːkuː
बेहतर	bɛɦt̪əɾ
अवतल	əʋt̪əl̪
न्यूज़	n̪juːd͡ʒ
यक़ीनन	jəkiːn̪ə̃n̪
क्रिस्टल	kɾɪs̪ʈəl̪
मजनूँ	məd͡ʒn̪ũː
निर्देश	n̪ɪɾd̪eːʃ
उन्नाव	ʊ̃n̪n̪äːʋ
अंछर	ə̃n̪t͡ʃʰəɾ
रविवार	ɾəʋɪʋäːɾ
दारु	d̪äːɾuː
मंजन	mə̃n̪d͡ʒə̃n̪
आहिस्ता	äːɪs̪t̪äː
बैंगनी	bɛ̃ːŋɡn̪iː
शिक्षाशास्त्र	ʃɪkʃäːʃäːs̪t̪ɾᵊ
सोहाग	s̪oːɦäːɡ
देखने	d̪eːkʰn̪eː
थरथराना	t̪ʰəɾt̪ʰəɾäːn̪äː
नाई	n̪äːiː
शर्मा	ʃəɾmäː
खिन्न	kʰɪ̃n̪n̪ᵊ
पाहन	päːɦə̃n̪
चौपाई	t͡ʃɔːpäːiː
देने	d̪eːn̪eː
विक्षनरी	ʋɪkʃn̪əɾiː
प्रजातंत्र	pɾəd͡ʒäːt̪ə̃n̪t̪ɾᵊ
चारा	t͡ʃäːɾäː
व्यास	ʋjäːs̪
शाइस्ता	ʃäːɪs̪t̪äː
नास्तिकता	n̪äːs̪t̪ɪkt̪äː
ओलिंपियाड	oːl̪ɪ̃mpijäːɖ
चाची	t͡ʃäːt͡ʃiː
नागरिकता	n̪äːɡɾɪkt̪äː
आपात	äːpäːt̪
लहंगा	l̪ɛːɦŋɡäː
उल्टा	ʊl̪ʈäː
हवा	ɦəʋäː
प्रेमिका	pɾeːmɪkäː
ं	ə̃ŋ
गुझिया	ɡʊd͡ʒʱijäː
मिस्टर	mɪs̪ʈəɾ
देसी	d̪eːs̪iː
मोरक्को	moːɾək̚koː
यांत्रिक	jä̃ːn̪t̪ɾɪk
सूतिकागार	s̪uːt̪ɪkäːɡäːɾ
सूचक	s̪uːt͡ʃək
अज़ाब	əzäːb
साफ़	s̪äːpʰ
बिमारी	bɪmäːɾiː
सरोद	s̪əɾoːd̪
लाइम	l̪äːɪ̃m
घसीटना	ɡʱəs̪iːʈn̪äː
हिमस्खलन	ɦɪ̃ms̪kʰəl̪ə̃n̪
बुभुक्षित	bʊbʱʊkʃɪt̪
छेदना	t͡ʃʰeːd̪̚n̪äː
ख़िलाफ़	xɪl̪äːf
व्यसन	ʋjəs̪ə̃n̪
वा	ʋäː
ठहराना	ʈʰɛɦɾäːn̪äː
टेलिफोन	ʈeːl̪ɪpʰõːn̪
इंटरफ़ेस	ɪ̃ɳʈəɾpʰeːs̪
रुकावट	ɾʊkäːʋəʈ
तलवा	t̪əl̪ʋäː
प्रयोगात्मक	pɾəjoːɡɑt̪mək
विचारधारा	ʋɪt͡ʃäːɾd̪ʱäːɾäː
उतरना	ʊt̪əɾn̪äː
अवगुण	əʋɡʊ̃ɳ
पीपल	piːpəl̪
विघ्न	ʋɪɡʱn̪ᵊ
अर्धसाप्ताहिक	əɾd̪ʱs̪äːpt̪äːɦɪk
धोखेबाज़	d̪ʱoːkʰeːbäːd͡ʒ
मनोरोग	mən̪oːɾoːɡ
बांचना	bä̃ːt͡ʃn̪äː
ढूँढ़ना	ɖʱũːɽʱn̪äː
लिपटना	l̪ɪpəʈn̪äː
अंतर्जातीय	ə̃n̪t̪əɾd͡ʒäːt̪iːjᵊ
मनोरंजन	mən̪oːɾə̃n̪d͡ʒə̃n̪
तौबा	t̪əʊbäː
चुड़ैल	t͡ʃʊɽɛːl̪
त्यौहार	t̪jɔːɦäːɾ
अलगाववादी	əl̪ɡäːʋʋäːd̪iː
पूछना	puːt͡ʃʰn̪äː
मुर्ग़ा	mʊɾɣäː
इंटरनेट	ɪ̃ɳʈəɾn̪eːʈ
ज़ंजीर	zə̃n̪d͡ʒiːɾ
मक़बूल	məkbuːl̪
फ़िलीपीन्स	pʰɪl̪iːpĩːn̪s̪
विपन्नता	ʋɪpə̃n̪n̪t̪äː
सरगोधा	s̪əɾɡoːd̪ʱäː
विमा	ʋɪmäː
संतुलित	s̪ə̃n̪t̪ʊl̪ɪt̪
बत्तख़	bət̪̚t̪əkʰ
दंड	d̪ə̃ɳɖ
दायित्ववान्	d̪äːjɪt̪wəʋä̃ːn̪
मक्खन	mək̚kʰə̃n̪
तालिब	t̪äːl̪ɪb
लाख	l̪äːkʰ
आव्यूह	äːʋjuːɦ
ठेंगा	ʈʰẽːŋɡäː
गुरुवार	ɡʊɾʊʋäːɾ
प्रायद्वीप	pɾäːjd̪wiːp
कठिनाई	kəʈʰɪn̪äːiː
घोषणा	ɡʱoːʃɳäː
पहलू	pɛɦl̪uː
पसीजना	pəs̪iːd͡ʒn̪äː
आईला	äːiːl̪äː
अफसर	əpʰs̪əɾ
इतिहास	ɪt̪ɪɦäːs̪
भारी	bʱäːɾiː
चरखा	t͡ʃəɾxäː
रैन	ɾɛ̃ːn̪
अट्ठाईस	əʈ̚ʈʰäːiːs̪
अधिसूचित	əd̪ʱɪs̪uːt͡ʃɪt̪
सी	s̪iː
हताशा	ɦət̪äːʃäː
मांडलिक	mä̃ːɳɖəl̪ɪk
न्योता	n̪joːt̪äː
सियाप्पा	s̪ijäːp̚päː
शाम	ʃä̃ːm
भारोत्तोलन	bʱäːɾoːt̪̚t̪oːl̪ə̃n̪
इंदुर	ɪ̃n̪d̪ʊɾ
आयात	äːjäːt̪
तुंग	t̪ʊ̃ŋɡ
खाली	xäːl̪iː
मायका	mäːjkäː
फ़्राँसीसी	pʰɾä̃ːs̪iːs̪iː
आमुख	äːmʊkʰ
अमानत	əmäːn̪ət̪
माफ़ी	mäːpʰiː
ख़्याल	xjäːl̪
वॉशिंगटन	ʋɔʃɪ̃ŋɡʈə̃n̪
मिनट	mɪn̪əʈ
दीन	d̪ĩːn̪
जनभाषा	d͡ʒə̃n̪bʱäːʃäː
अठारह	əʈʰäːɾəɦ
व्यवहार	ʋjəʋɦäːɾ
बेक़ाबू	beːqäːbuː
क्रूस	kɾuːs̪
ताक	t̪äːk
लश्कर	l̪əʃkəɾ
पठानकोट	pəʈʰä̃ːn̪koːʈ
क्रीडिका	kɾiːɖɪkäː
अवहेलना	əʋɦeːl̪n̪äː
बहुरूपिया	bɔɦɔɾuːpijäː
सुहाना	s̪ʊɦäːn̪äː
मुक़द्दर	mʊkəd̪̚d̪əɾ
सांझ	s̪ä̃ːn̪d͡ʒʱ
ध्वनी	d̪ʱʋən̪iː
नजूमी	n̪əd͡ʒuːmiː
सिफ़र	s̪ɪfəɾ
लाजवाब	l̪äːd͡ʒəʋäːb
अठपहिया	əʈʰpəɦijäː
इम्तिहान	ɪ̃mt̪ɪɦä̃ːn̪
सुन्नत	s̪ʊ̃n̪n̪ət̪
अंतरराष्ट्रीयता	ə̃n̪t̪əɾɾäːʃʈɾiːjt̪äː
कथा	kət̪ʰäː
कन्दुक	kə̃n̪d̪ʊk
कितना	kɪt̪̚n̪äː
जिल्द	d͡ʒɪl̪d̪
फुलझड़ी	pʰʊl̪d͡ʒʱəɽiː
तग़ाफ़ुल	t̪əɣäːfʊl̪
संवहन	s̪ə̃mwɛɦɛ̃n̪
संपदा	s̪ə̃mpəd̪äː
बाख़ुदा	bäːxʊd̪äː
धातुकर्म	d̪ʱäːt̪ʊkəɾm
ज़ायक़ा	zäːjqäː
तला	t̪əl̪äː
मेहनत	meːɦn̪ət̪
बाल्यावस्था	bäːl̪jäːʋəs̪t̪ʰäː
पछताना	pət͡ʃʰt̪äːn̪äː
सदर	s̪əd̪əɾ
एकरूपता	eːkɾuːpt̪äː
सजावट	s̪əd͡ʒäːʋəʈ
बेज़बान	beːd͡ʒbä̃ːn̪
व्यवकलन	ʋjəʋkəl̪ə̃n̪
वापिस	ʋäːpɪs̪
भूरा	bʱuːɾäː
अविश्वास	əʋɪʃʋäːs̪
ख़राब	kʰəɾäːb
छलिया	t͡ʃʰəl̪ijäː
शिष्य	ʃɪʃjᵊ
सड़कछाप	s̪əɽəkt͡ʃʰäːp
बस्ती	bəs̪t̪iː
छात्रा	t͡ʃʰäːt̪ɾäː
मानक	mäːn̪ək
बख़्शना	bəxʃn̪äː
अफ़्साना	əpʰs̪äːn̪äː
अर्जुन	əɾd͡ʒʊ̃n̪
होशंगाबाद	ɦoːʃə̃ŋɡäːbäːd̪
आजाद	äːd͡ʒäːd̪
बग़ल	bəɡəl̪
हजामत	ɦəd͡ʒäːmət̪
छप्पन	t͡ʃʰəp̚pə̃n̪
अँगहीन	ə̃ŋɡʱĩːn̪
समारोह	s̪əmäːɾoːɦ
लाभ	l̪äːbʱ
अल्बानिया	əl̪bäːn̪ijäː
असैनिक	əs̪ɛːn̪ɪk
किस्म	kɪs̪m
कहानी	kəɦäːn̪iː
फूलो	pʰuːl̪oː
भंडाफोड़	bʱə̃ɳɖäːpʰoːɽ
वाकिफ	ʋäːqɪf
प्रतिज्ञा	pɾət̪ɪɡjäː
निकास	n̪ɪkäːs̪
दंगल	d̪ə̃ŋɡəl̪
पारगम्य	päːɾɡə̃mjᵊ
पोपला	poːpl̪äː
मझधार	məd͡ʒʱd̪ʱäːɾ
साठ	s̪äːʈʰ
कनाडा	kən̪äːɖäː
आत्मनिंदा	äːt̪mən̪ɪ̃n̪d̪äː
मिज़ाज	mɪzäːd͡ʒ
वासी	ʋäːs̪iː
यातायात	jäːt̪äːjäːt̪
निचला	n̪ɪt͡ʃl̪äː
सर्किल	s̪əɾkɪl̪
ख़ुशबूदार	kʰʊʃbuːd̪äːɾ
सौर्य	s̪ɔːɾjᵊ
फफोला	pʰəpʰoːl̪äː
उपहार	ʊpʰäːɾ
कराची	kəɾäːt͡ʃiː
नब्ज	n̪əbz
नतीजा	n̪ət̪iːd͡ʒäː
महाराष्ट्र	məɦäːɾäːʃʈɾᵊ
भोलेपन	bʱoːl̪eːpə̃n̪
गुठली	ɡʊʈʰl̪iː
चांसलर	t͡ʃä̃ːn̪s̪l̪əɾ
रक्तचाप	ɾəkt̪̚t͡ʃäːp
परीक्षा	pəɾiːkʃäː
संवैधानिक	s̪ə̃mwɛːd̪ʱäːn̪ɪk
जलसिंह	d͡ʒəl̪s̪ɪ̃ɦ
दांत	d̪ä̃ːn̪t̪
अंशकालिक	ə̃n̪ʃkäːl̪ɪk
मार्गदर्शन	mäːɾɡd̪əɾʃə̃n̪
फ़ेसबुक	feːs̪bʊk
इंतक़ाल	ɪ̃n̪t̪əqäːl̪
खतौनी	kʰət̪ɔːn̪iː
महापंडित	məɦäːpə̃ɳɖɪt̪
कार्यशाला	käːɾjəʃäːl̪äː
सराइकी	s̪əɾäːɪkiː
पापा	päːpäː
सनसनीख़ेज़	s̪ə̃n̪s̪ən̪iːkʰeːd͡ʒ
मरवाना	məɾʋäːn̪äː
शैतानी	ʃɛːt̪äːn̪iː
लोकगीत	l̪oːkɡiːt̪
आँत	ä̃ːt̪
आगमन	äːɡəmə̃n̪
स्वादु	s̪ʋäːd̪uː
द्वंद्व	d̪wə̃n̪d̪wə
अंगारा	ə̃ŋɡäːɾäː
संस्थापक	s̪ə̃n̪s̪t̪ʰäːpək
धारित	d̪ʱäːɾɪt̪
उपभाषा	ʊp̚bʱäːʃäː
शहरी	ʃɛɦɾiː
सही	s̪əɦiː
आर्मीनिया	äːɾmiːn̪ijäː
रक्तसंचार	ɾəkt̪s̪ə̃n̪t͡ʃäːɾ
हाजिरा	ɦäːd͡ʒɪɾäː
दुपहिया	d̪ʊpəiːjäː
अरक्तता	əɾəkt̪̚t̪äː
क़ानून	käːn̪ũːn̪
सिनेमाघर	s̪ɪn̪eːmäːɡʱəɾ
सफ़र	s̪əfəɾ
प्रसंग	pɾəs̪ə̃ŋɡ
जायज़	d͡ʒäːjəd͡ʒ
गाँडू	ɡä̃ːɳɖuː
बख़ील	bəkʰiːl̪
काठ	käːʈʰ
उतावला	ʊt̪äːʋl̪äː
भड़कना	bʱəɽəkn̪äː
लिख्टेंश्टाइन	l̪ɪkʰʈẽːn̪ʃʈäːɪ̃n̪
सौभाग्य	s̪ɔːbʱäːɡjᵊ
भविष्य	bʱəʋɪʃjə
स्मरणशक्ति	s̪məɾə̃ɳʃəkt̪iː
कुटिया	kʊʈijäː
सरफिरा	s̪əɾpʰɪɾäː
उम्रक़ैद	ʊ̃mɾəkɛːd̪
ग़रारा	ɣəɾäːɾäː
जज्बा	d͡ʒəzbäː
गुप्तांग	ɡʊpt̪ä̃ːŋɡ
लेटना	l̪eːʈn̪äː
यादगार	jäːd̪ɡäːɾ
साँई	s̪ä̃ːiː
जनवादी	d͡ʒə̃n̪wäːd̪iː
तंबोल	t̪ə̃mboːl̪
नस्लीय	n̪əs̪l̪iːjᵊ
उपाधि	ʊpäːd̪ʱiː
इज़हार	ɪzɦäːɾ
भद्दा	bʱəd̪̚d̪äː
उनतीस	ʊ̃n̪t̪iːs̪
खयालों	kʰəjäːl̪õː
उपयोगिता	ʊpjoːɡɪt̪äː
अपशकुन	əpʃəkʊ̃n̪
शख्स	ʃəxs̪
परमाणु	pəɾmäːɳuː
अधिवेशन	əd̪ʱɪʋeːʃə̃n̪
वक़्फ़ा	ʋəkpʰäː
इफ़्तिताह	ɪft̪ɪt̪äːɦ
क़ाबिलीयत	qäːbɪl̪iːjət̪
सादिक़ाबाद	s̪äːd̪ɪqäːbäːd̪
समधी	s̪ə̃md̪ʱiː
कीमिया	kiːmijäː
उबरना	ʊbəɾn̪äː
अफ़्ग़ानिस्तान	əfɣäːn̪ɪs̪t̪ä̃ːn̪
बुभुक्षा	bʊbʱʊkʃäː
फावड़ा	pʰäːʋɽäː
ताइवान	t̪äːɪʋä̃ːn̪
बिहारी	bɪɦäːɾiː
महान	məɦä̃ːn̪
बारिश	bäːɾɪʃ
द्रव्यमान	d̪ɾəʋjəmä̃ːn̪
फलन	pʰəl̪ə̃n̪
वातानुकूलन	ʋäːt̪äːn̪ʊkuːl̪ə̃n̪
अजान	əd͡ʒä̃ːn̪
प्रासुक	pɾäːs̪ʊk
पौष्टिक	pɔːʃʈɪk
मूली	muːl̪iː
विधायक	ʋɪd̪ʱäːjək
उलफ़त	ʊl̪fət̪
नवाब	n̪əʋäːb
धर्मस्थल	d̪ʱəɾms̪t̪ʰəl̪
पुर्तगाल	pʊɾt̪əɡäːl̪
कायको	käːjkoː
निराहार	n̪ɪɾäːɦäːɾ
शायराना	ʃäːjəɾäːn̪äː
कौमार्य	kɔːmäːɾjᵊ
आदा	äːd̪äː
सहभागी	s̪ɛɦbʱäːɡiː
तिरस्कार	t̪ɪɾəs̪käːɾ
नामंज़ूर	n̪äːmə̃zuːɾ
कैथल	kɛːt̪ʰəl̪
ऊँचा	ũːt͡ʃäː
ख़ाला	xäːl̪äː
अधोहस्ताक्षरी	əd̪ʱoːɦəs̪t̪äːkʃəɾiː
गलत	ɣəl̪ət̪
पयाम	pəjä̃ːm
दाएँ	d̪äːẽː
प्रबल	pɾəbəl̪
नशेड़ी	n̪əʃeːɽiː
करता	kəɾt̪äː
लातविया	l̪äːt̪wijäː
बल्ला	bəl̪l̪äː
कुल्हड़	kʊl̪ɦəɽ
प्रकार्यात्मक	pɾəkäːɾjäːt̪mək
घूर्णन	ɡʱuːɾɳə̃n̪
अम्लपित्त	ə̃ml̪ᵊpɪt̪t̪
ज़िलाधीश	zɪl̪äːd̪ʱiːʃ
तख़लिया	t̪əkʰl̪ijäː
ख़ूनी	kʰuːn̪iː
कारोबारी	käːɾoːbäːɾiː
ज़िंदगी	d͡ʒɪ̃n̪d̪əɡiː
अंतर्जाल	ə̃n̪t̪əɾd͡ʒäːl̪
प्रकीर्णन	pɾəkiːɾɳə̃n̪
ख़ानक़ाह	kʰä̃ːn̪käːɦ
रक्षण	ɾəkʃə̃ɳ
संक्रांति	s̪ə̃ŋkɾä̃ːn̪t̪iː
कूलॉम	kuːl̪ɔ̃m
चुंबन	t͡ʃʊ̃mbə̃n̪
पढ़ाई	pəɽʱäːiː
धमकी	d̪ʱə̃mkiː
राँझा	ɾä̃ːn̪d͡ʒʱäː
रेस्तराँ	ɾeːs̪t̪əɾä̃ː
घूरना	ɡʱuːɾn̪äː
इमारती	ɪmäːɾət̪iː
सूचना	s̪uːt͡ʃn̪äː
बाई	bäːiː
दर्शनीय	d̪əɾʃən̪iːjᵊ
अभिगम	əbʱɪɡə̃m
मुल्तान	mʊl̪t̪ä̃ːn̪
काँटा	kä̃ːʈäː
साम्राज्य	s̪ä̃ːmɾäːd͡ʒjᵊ
प्रायापिज़्म	pɾäːjäːpɪzm
विजेता	ʋɪd͡ʒeːt̪äː
पादरी	päːd̪ɾiː
बारह	bäːɾəɦ
घेराव	ɡʱeːɾäːʋ
कन्नड	kə̃n̪n̪əɖᵊ
लार	l̪äːɾ
नगरीकरण	n̪əɡəɾiːkəɾə̃ɳ
अड़तीस	əɽt̪iːs̪
मिल	mɪl̪
स्पष्टतः	s̪pəʃʈət̪əɦ
आशना	äːʃn̪äː
अनेकानेक	ən̪eːkäːn̪eːk
निष्कासन	n̪ɪʃkäːs̪ə̃n̪
क्षारातु	kʃäːɾäːt̪uː
असावधान	əs̪äːʋd̪ʱä̃ːn̪
ठूँसना	ʈʰũːs̪n̪äː
सांबर	s̪ä̃ːmbəɾ
नितंब	n̪ɪt̪ə̃mb
बटाटा	bəʈäːʈäː
हौसला	ɦɔːs̪l̪äː
मास	mäːs̪
कोतवाल	koːt̪wäːl̪
नाटा	n̪äːʈäː
जनाधार	d͡ʒən̪äːd̪ʱäːɾ
निहारना	n̪ɪɦäːɾn̪äː
आंदोलन	ä̃ːn̪d̪oːl̪ə̃n̪
धनाढ्य	d̪ʱən̪äːɖʱjᵊ
समतल	s̪ə̃mt̪əl̪
दुआ	d̪ʊäː
थानेदार	t̪ʰäːn̪eːd̪äːɾ
मैदा	mɛːd̪äː
किसानी	kɪs̪äːn̪iː
विस्मय	ʋɪs̪məj
अनुच्छेद	ən̪ʊt̚t͡ʃʰeːd̪
गगन	ɡəɡə̃n̪
नेकी	n̪eːkiː
तराना	t̪əɾäːn̪äː
पचपन	pət͡ʃpə̃n̪
आलम	äːl̪ə̃m
जोशीला	d͡ʒoːʃiːl̪äː
वेनेज़ुएला	ʋeːn̪eːzʊeːl̪äː
ओहायो	oːɦäːjoː
आख़िरकार	äːxɪɾkäːɾ
डाइनोसर	ɖäːɪn̪oːs̪əɾ
स्मरण	s̪məɾə̃ɳ
मसीही	məs̪iːɦiː
राय	ɾäːj
अनखिला	ə̃n̪kʰɪl̪äː
किनारा	kɪn̪äːɾäː
ख़ाला	kʰäːl̪äː
पापड़	päːpəɽ
छिन	t͡ʃʰɪ̃n̪
अवतार	əʋt̪äːɾ
हताश	ɦət̪äːʃ
नकारात्मक	n̪əkäːɾäːt̪mək
नेत्रिका	n̪eːt̪ɾɪkäː
खयाल	kʰəjäːl̪
जज़्बात	d͡ʒəzbäːt̪
ताज़ा	t̪äːd͡ʒäː
फ़रमाइश	pʰəɾmäːɪʃ
मंडलिका	mə̃ɳɖəl̪ɪkäː
कनिया	kən̪ijäː
पनामा	pən̪äːmäː
उचकना	ʊt͡ʃəkn̪äː
कशमकश	kəʃə̃mkəʃ
चांद	t͡ʃä̃ːn̪d̪
हल्दी	ɦəl̪d̪iː
तथापि	t̪ət̪ʰäːpiː
प्रिय	pɾijᵊ
निंदासा	n̪ɪ̃n̪d̪äːs̪äː
सियार	s̪ijäːɾ
सारांश	s̪äːɾä̃ːn̪ʃ
सबब	s̪əbəb
पार	päːɾ
भूमंडलीकरण	bʱuːmə̃ɳɖəl̪iːkəɾə̃ɳ
पर्युषण	pəɾjʊʃə̃ɳ
अनुमति	ən̪ʊmət̪iː
प्यादा	pjäːd̪äː
मनुष्य	mən̪ʊʃjə
खोया	kʰoːjäː
एकल	eːkəl̪
अरदली	əɾd̪əl̪iː
क़रीबन	kəɾiːbə̃n̪
नृत्य	n̪ɾɪt̪jə
ठठेरा	ʈʰəʈʰeːɾäː
पेचीदा	peːt͡ʃiːd̪äː
नाभिक	n̪äːbʱɪk
धन्यवाद	d̪ʱə̃n̪jəʋäːd̪
बादशाहत	bäːd̪ʃäːɦət̪
श्येन	ʃjẽːn̪
यशायाह	jəʃäːjäːɦ
तहलका	t̪ɛɦɛl̪käː
वाताद	ʋäːt̪äːd̪
घोटाला	ɡʱoːʈäːl̪äː
हिन्दवी	ɦɪ̃n̪d̪əʋiː
ब्रिटेन	bɾɪʈẽːn̪
क़ातिलाना	qäːt̪ɪl̪äːn̪äː
श्मशान	ʃməʃä̃ːn̪
मद्रासी	məd̪ɾäːs̪iː
पुल्लिंग	pʊl̪l̪ɪ̃ŋɡ
पुखराज	pʊkʰɾäːd͡ʒ
अभियुक्त	əbʱijʊkt̪
षड्यंत्र	ʃəɖjə̃n̪t̪ɾᵊ
ख़रीदार	kʰəɾiːd̪äːɾ
इराक़	ɪɾäːk
चरख़ा	t͡ʃəɾkʰäː
अछना	ət͡ʃʰn̪äː
अज्ञेयवाद	əɡjeːjʋäːd̪
प्रक्रिया	pɾəkɾijäː
निर्जन	n̪ɪɾd͡ʒə̃n̪
अँटना	ə̃ɳʈn̪äː
उसको	ʊs̪koː
रौज़न	ɾɔːzə̃n̪
पाप	päːp
पद्मावत	pəd̪mäːʋət̪
नाइनसाफ़ी	n̪äːɪ̃n̪s̪äːfiː
अंग्रेज़ियत	ə̃ŋɡɾeːd͡ʒijət̪
दफ़ा	d̪əfäː
क़ातिलाना	käːt̪ɪl̪äːn̪äː
स्खलन	s̪kʰəl̪ə̃n̪
अधीक्षण	əd̪ʱiːkʃə̃ɳ
बाप	bäːp
अरारोट	əɾäːɾoːʈ
गिनती	ɡɪ̃n̪t̪iː
उलझन	ʊl̪d͡ʒʱə̃n̪
तले	t̪əl̪eː
पूरा	puːɾäː
इटली	ɪʈəl̪iː
महत्त्व	mɛɦɛt̪̚t̪wᵊ
खोका	kʰoːkäː
रक्षाबंधन	ɾəkʃäːbə̃n̪d̪ʱə̃n̪
मलिका	məl̪ɪkäː
झारखण्ड	d͡ʒʱäːɾkʰə̃ɳɖ
अलगाववाद	əl̪ɡäːʋʋäːd̪
कृष्ण	kɾɪʃə̃ɳ
सट्टेबाज़ी	s̪əʈ̚ʈeːbäːziː
अंगहीन	ə̃ŋɡʱĩːn̪
लालटेन	l̪äːl̪ʈẽːn̪
लण्ड	l̪ə̃ɳɖ
अस्वस्थता	əs̪ʋəs̪t̪ʰət̪äː
लोल	l̪oːl̪
प्रश्न	pɾəʃə̃n̪
उस्मानाबाद	ʊs̪mäːn̪äːbäːd̪
असमर्थता	əs̪əməɾt̪ʰt̪äː
अफ़वाह	əfʋäːɦ
फ़रार	pʰəɾäːɾ
लमहा	l̪ə̃mɦäː
प्रायापिज़्म	pɾäːjäːpɪd͡ʒm
पहनावा	pɛɦn̪äːʋäː
विश्रामालय	ʋɪʃɾäːmäːl̪əj
तीव्रता	t̪iːʋɾət̪äː
भागवत	bʱäːɡʋət̪
नारंगी	n̪äːɾə̃ŋɡiː
मानसूनी	mä̃ːn̪s̪uːn̪iː
संगणक	s̪ə̃ŋɡəɳək
वर्दीधारी	ʋəɾd̪iːd̪ʱäːɾiː
बाजी	bäːd͡ʒiː
इसे	ɪs̪eː
सूखा	s̪uːkʰäː
बोहरान	boːɦɾä̃ːn̪
नवाज़ना	n̪əʋäːzn̪äː
शैवाल	ʃɛːʋäːl̪
सौगंद	s̪ɔːɡə̃n̪d̪
हथगोला	ɦət̪ʰɡoːl̪äː
चना	t͡ʃən̪äː
झूठा	d͡ʒʱuːʈʰäː
पंक्ति	pə̃ŋkt̪iː
मस्ताना	məs̪t̪äːn̪äː
लहंगा	l̪ɛːɦɛ̃ːŋɡäː
अंकुश	ə̃ŋkʊʃ
नशा	n̪əʃäː
ख़ाक़ान	kʰäːkä̃ːn̪
एकीकरण	eːkiːkəɾə̃ɳ
तंज़ीम	t̪ə̃d͡ʒĩːm
रीट्वीट	ɾiːʈwiːʈ
तादाद	t̪äːd̪äːd̪
जातिवादी	d͡ʒäːt̪iːʋäːd̪iː
विभीषिका	ʋɪbʱiːʃɪkäː
क़साई	kəs̪äːiː
महंगा	mɛɦɛ̃ŋɡäː
प्रोस्टेट	pɾoːs̪ʈeːʈ
छापा	t͡ʃʰäːpäː
मेंढ्र	mẽːɳɖʱɾᵊ
बदमाश	bəd̪mäːʃ
नरभक्षी	n̪əɾbʱəkʃiː
अप्रकाशित	əpɾəkäːʃɪt̪
जल्द	d͡ʒəl̪d̪
मशरूम	məʃɾũːm
ख़ुशक़िस्मत	kʰʊʃkɪs̪mət̪
अमेरिकन	əmeːɾɪkə̃n̪
हसीना	ɦəs̪iːn̪äː
बल्लेबाज़	bəl̪l̪eːbäːz
क़दीम	kəd̪ĩːm
देहरादून	d̪eːɦɾäːd̪ũːn̪
सुलाना	s̪ʊl̪äːn̪äː
पनस	pən̪əs̪
फ़ैसलाबाद	pʰɛːs̪l̪äːbäːd̪
अंतरिक्ष	ə̃n̪t̪əɾɪkʃ
खादन	kʰäːd̪ə̃n̪
भागीदार	bʱäːɡiːd̪äːɾ
कुंद	kʊ̃n̪d̪
संगठन	s̪ə̃ŋɡəʈʰə̃n̪
मेवा	meːʋäː
धनगढी	d̪ʱən̪əɡɖʱiː
कौंसिल	kɔ̃ːn̪s̪ɪl̪
मूर्छन	muːɾt͡ʃʰə̃n̪
फ़िरिश्ता	fɪɾɪʃt̪äː
सरफ़रोश	s̪əɾpʰəɾoːʃ
हुड़दंगबाज़	ɦʊɽd̪ə̃ŋɡbäːz
बाज़ारी	bäːd͡ʒäːɾiː
घबराहट	ɡʱəbɾäːɦəʈ
पराया	pəɾäːjäː
साक्षर	s̪äːkʃəɾ
दायर	d̪äːjəɾ
फर्नीचर	pʰəɾn̪iːt͡ʃəɾ
आवाज़	äːʋäːd͡ʒ
फ़ाख़्ता	pʰäːkʰt̪äː
छुपा	t͡ʃʰʊpäː
सूआ	s̪uːäː
बारात	bäːɾäːt̪
बेजान	beːd͡ʒä̃ːn̪
प्रचारिणी	pɾət͡ʃäːɾɪɳiː
रहीम	ɾəɦĩːm
इंतिफ़ादा	ɪ̃n̪t̪ɪfäːd̪äː
नज़रअंदाज़	n̪əzəɾə̃n̪d̪äːz
कृपया	kɾɪpjäː
निष्क्रियता	n̪ɪʃkɾɪjt̪äː
डीज़ल	ɖiːzəl̪
सूअर	s̪uːəɾ
शमशीर	ʃə̃mʃiːɾ
बाड़ी	bäːɽiː
जज़ा	d͡ʒəd͡ʒäː
सेल्फ़ी	s̪eːl̪fiː
मुरदा	mʊɾd̪äː
गुलूबंद	ɡʊl̪uːbə̃n̪d̪
नजर	n̪əzəɾ
इकरार	ɪkɾäːɾ
शरमिंदा	ʃəɾmɪ̃n̪d̪äː
ख़्वाब	kʰʋäːb
वर्णहीन	ʋəɾɳɦĩːn̪
उठना	ʊʈʰn̪äː
सर्जन	s̪əɾd͡ʒə̃n̪
ख़रीदवाना	kʰəɾiːd̪wäːn̪äː
हलक़	ɦəl̪k
बहरीन	bɛɦɾĩːn̪
मर्दाना	məɾd̪äːn̪äː
चौथाई	t͡ʃɔːt̪ʰäːiː
रोज़गार	ɾoːd͡ʒɡäːɾ
बदनाम	bəd̪̚n̪ä̃ːm
घाटी	ɡʱäːʈiː
सोता	s̪oːt̪äː
सहमत	s̪ɛɦmət̪
समाधान	s̪əmäːd̪ʱä̃ːn̪
ख़रीदना	kʰəɾiːd̪̚n̪äː
औक़ात	ɔːkäːt̪
भुट्टा	bʱʊʈ̚ʈäː
शेष	ʃeːʃ
कुंडली	kʊ̃ɳɖəl̪iː
गुजरात	ɡʊd͡ʒɾäːt̪
नासरत	n̪äːs̪əɾət̪
असार	əs̪äːɾ
खदान	kʰəd̪ä̃ːn̪
मज़ार	məzäːɾ
बेतहाशा	beːt̪əɦäːʃäː
नाटक	n̪äːʈək
हादसा	ɦäːd̪s̪äː
शख़्स	ʃəkʰs̪
मांसल	mä̃ːn̪s̪əl̪
नेम	n̪ẽːm
सहर	s̪ɛɦɛɾ
अवलोकन	əʋl̪oːkə̃n̪
जुटाना	d͡ʒʊʈäːn̪äː
पैमाना	pɛːmäːn̪äː
दायाँ	d̪äːjä̃ː
ढोना	ɖʱoːn̪äː
लाज़िम	l̪äːzɪ̃m
मेहमाननवाज़ी	meːɦmä̃ːn̪n̪əʋäːziː
सकर्मक	s̪əkəɾmək
कंप्यूटरीकरण	kə̃mpjuːʈɾiːkəɾə̃ɳ
कोरोनावायरस	koːɾoːn̪äːʋäːjɾəs̪
उद्योगीकरण	ʊd̪joːɡiːkəɾə̃ɳ
क्रिसमस	kɾɪs̪məs̪
थन	t̪ʰə̃n̪
झारखंड	d͡ʒʱäːɾkʰə̃ɳɖ
उछलना	ʊt͡ʃʰəl̪n̪äː
अफ़सोसजनक	əfs̪oːs̪d͡ʒən̪ək
ट्राइटियम	ʈɾäːɪʈijə̃m
झील	d͡ʒʱiːl̪
शकरकंद	ʃəkəɾkə̃n̪d̪
आपका	äːpkäː
जनसेवक	d͡ʒə̃n̪s̪eːʋək
इक्कीस	ɪk̚kiːs̪
दिल	d̪ɪl̪
बोतली	boːt̪l̪iː
झुकना	d͡ʒʱʊkn̪äː
गुज़श्ता	ɡʊd͡ʒəʃt̪äː
एस्केलेटर	eːs̪keːl̪eːʈəɾ
एजेंट	eːd͡ʒẽːɳʈ
बेबस	beːbəs̪
नीर	n̪iːɾ
गेरुआ	ɡeːɾʊäː
गुमनाम	ɡʊ̃mn̪ä̃ːm
होंठ	ɦõːɳʈʰ
माथा	mäːt̪ʰäː
अदहन	əd̪ɦə̃n̪
भटनागर	bʱəʈn̪äːɡəɾ
तनावपूर्ण	t̪ən̪äːʋpuːɾɳ
स्फटयातु	s̪pʰəʈjäːt̪uː
रोपाई	ɾoːpäːiː
जवान	d͡ʒəʋä̃ːn̪
उल्लेख	ʊl̪l̪eːkʰ
उगलना	ʊɡəl̪n̪äː
संचयन	s̪ə̃t͡ʃəjə̃n̪
उनतालीस	ʊ̃n̪t̪äːl̪iːs̪
चौवन	t͡ʃə̯uʋə̃n̪
कलावंत	kəl̪äːʋə̃n̪t̪
फ़िरिश्ता	pʰɪɾɪʃt̪äː
कचहरी	kət͡ʃɛɦɾiː
दाख़िला	d̪äːxɪl̪äː
पाषाण	päːʃä̃ːɳ
रतन	ɾət̪ə̃n̪
उन्नत	ʊ̃n̪n̪ət̪
रहा	ɾəɦäː
उत्तर	ʊt̪̚t̪əɾ
मजमून	məd͡ʒmũːn̪
दुर्भाग्य	d̪ʊɾbʱäːɡjᵊ
दाग़ना	d̪äːɡn̪äː
भिन्न	bʱɪ̃n̪n̪ᵊ
संकेत	s̪ə̃ŋkeːt̪
वर्मसरट	ʋəɾms̪əɾəʈ
ज़िला	d͡ʒɪl̪äː
ऊष्मा	uːʃmäː
भागे	bʱäːɡeː
कृष्णा	kɾɪʃɳäː
सतह	s̪ət̪əɦ
इंजील	ɪ̃n̪d͡ʒiːl̪
वास्तव	ʋäːs̪t̪əʋ
रणनीतिक	ɾə̃ɳn̪iːt̪ɪk
क़ाज़ी	käːd͡ʒiː
खोला	kʰoːl̪äː
जलवा	d͡ʒəl̪ʋäː
हस्तक्षेप	ɦəs̪t̪əkʃeːp
अभिनेता	əbʱɪn̪eːt̪äː
मैनचेस्टर	mɛ̃ːn̪t͡ʃeːs̪ʈəɾ
पंचायती	pə̃n̪t͡ʃäːjət̪iː
सर्वसम्मति	s̪əɾʋs̪ə̃mmət̪iː
छानना	t͡ʃʰä̃ːn̪n̪äː
नाज़ुकी	n̪äːzʊkiː
षष्ठी	ʃəʃʈʰiː
बाज़	bäːz
नाभि	n̪äːbʱiː
छापाशाला	t͡ʃʰäːpäːʃäːl̪äː
सुखपूर्वक	s̪ʊkʰpuːɾʋək
डील	ɖiːl̪
शिक्षाकर्मी	ʃɪkʃäːkəɾmiː
महायुद्ध	məɦäːjʊd̪d̪ʱ
बंध	bə̃n̪d̪ʱ
नुकसान	n̪ʊqs̪ä̃ːn̪
पड़ना	pəɽn̪äː
दक्षिणा	d̪əkʃɪɳäː
कोयंबतूर	koːjə̃mbət̪uːɾ
बघारना	bəɡʱäːɾn̪äː
लट्टू	l̪əʈ̚ʈuː
लालायित	l̪äːl̪äːjɪt̪
रिहाई	ɾɪɦäːiː
श्वसन	ʃʋəs̪ə̃n̪
शिगात्से	ʃɪɡäːt̪s̪eː
मुज़फ़्फ़राबाद	mʊd͡ʒəpʰpʰəɾäːbäːd̪
विलीन	ʋɪl̪ĩːn̪
कंकड़ीला	kə̃ŋkɽiːl̪äː
कार्डिफ़	käːɾɖɪf
सिचुआन	s̪ɪt͡ʃʊä̃ːn̪
सहस्र	s̪ɛɦɛs̪t̪ɾᵊ
लटकाना	l̪əʈkäːn̪äː
उत्पादक	ʊt̪päːd̪ək
हिक्का	ɦɪk̚käː
ग़ाज़ियाबाद	ɣäːzijäːbäːd̪
पतंग	pət̪ə̃ŋɡ
टट्टी	ʈəʈ̚ʈiː
लिहाज़ा	l̪ɪɦäːd͡ʒäː
दिलेरी	d̪ɪl̪eːɾiː
आफ़त	äːfət̪
उरुमची	ʊɾʊ̃mt͡ʃiː
इस्राइल	ɪs̪ɾäːɪl̪
बुल्ला	bʊl̪l̪äː
मानदेय	mä̃ːn̪d̪eːj
चूज़ा	t͡ʃuːzäː
जल्दबाज़ी	d͡ʒəl̪d̪bäːziː
भड़कीला	bʱəɽkiːl̪äː
प्रभावकारी	pɾəbʱäːʋkäːɾiː
फ़ील्मी	pʰiːl̪miː
अराजक	əɾäːd͡ʒək
बैंक	bɛ̃ːŋk
स्मृति	s̪mɾɪt̪iː
हल	ɦəl̪
प्रकाश	pɾəkäːʃ
ख़ावंद	xäːʋə̃n̪d̪
झगड़ना	d͡ʒʱəɡəɽn̪äː
हिम्मतवर	ɦɪ̃mmət̪wəɾ
कलात्मक	kəl̪äːt̪mək
प्रतीकात्मक	pɾət̪iːkäːt̪mək
अफ़्साना	əfs̪äːn̪äː
पाकिस्तान	päːkɪs̪t̪ä̃ːn̪
अवसर	əʋs̪əɾ
बर्फ़ीला	bəɾfiːl̪äː
सुमन	s̪ʊmə̃n̪
सहकर्मी	s̪ɛɦkəɾmiː
बनिज	bən̪ɪd͡ʒ
कौन	kɔ̃ːn̪
शेयरधारक	ʃeːjəɾd̪ʱäːɾək
दुर्गंध	d̪ʊɾɡə̃n̪d̪ʱ
जवानी	d͡ʒəʋäːn̪iː
ग़ुस्साना	ɣʊs̪s̪äːn̪äː
उदयकाल	ʊd̪əjkäːl̪
ग्रथन	ɡɾət̪ʰə̃n̪
कोटा	koːʈäː
संगमरमर	s̪ə̃ŋɡməɾməɾ
कुहरा	kɔɦɾäː
मस्त	məs̪t̪
नाप	n̪äːp
लानत	l̪äːn̪ət̪
बिंदी	bɪ̃n̪d̪iː
अभियन्ता	əbʱijə̃n̪t̪äː
पसंद	pəs̪ə̃n̪d̪
स्तंभन	s̪t̪ə̃mbʱə̃n̪
सजीवता	s̪əd͡ʒiːʋt̪äː
यूहन्ना	juːɦə̃n̪n̪äː
ख़ता	kʰət̪äː
लांछन	l̪ä̃ːn̪t͡ʃʰə̃n̪
फ़ेहरिस्त	pʰeːɦɾɪs̪t̪
पन्द्रह	pə̃n̪d̪ɾəɦ
पहिया	pəɦijäː
गिला	ɡɪl̪äː
लोकसाहित्य	l̪oːks̪äːɦɪt̪jᵊ
प्राथमिक	pɾäːt̪ʰmɪk
घोषित	ɡʱoːʃɪt̪
कालीन	käːl̪ĩːn̪
व्यवस्था	ʋjəʋəs̪t̪ʰäː
हरामख़ोर	ɦəɾä̃ːmxoːɾ
दिगंबर	d̪ɪɡə̃mbəɾ
वंदना	ʋə̃n̪d̪ən̪äː
प्रतिक्रमण	pɾət̪ɪkɾəmə̃ɳ
वंगन	ʋə̃ŋɡə̃n̪
संपादन	s̪ə̃mpäːd̪ə̃n̪
अविच्छिन्न	əʋɪt̚t͡ʃʰɪ̃n̪n̪ᵊ
सुईकार	s̪ʊiːkäːɾ
कंद	kə̃n̪d̪
दवात	d̪əʋäːt̪
घोंगा	ɡʱõːŋɡäː
मुलाक़ात	mʊl̪äːqäːt̪
झापड़	d͡ʒʱäːpəɽ
लग्न	l̪əɡn̪ᵊ
मसान	məs̪ä̃ːn̪
रजोदर्शन	ɾəd͡ʒoːd̪əɾʃə̃n̪
अरविंद	əɾʋɪ̃n̪d̪
युद्धनीति	jʊd̪̚d̪ʱn̪iːt̪iː
जनूबी	d͡ʒən̪uːbiː
ईमेल	iːmeːl̪
रस्म	ɾəs̪m
पीतसरा	piːt̪əs̪ɾäː
दौरा	d̪ɔːɾäː
बेवफ़ा	beːʋəfäː
संदूक़चा	s̪ə̃n̪d̪uːkt͡ʃäː
स्टार	s̪ʈäːɾ
अफ़सर	əpʰs̪əɾ
आर्द्र	äːɾd̪ɾᵊ
खिसकना	kʰɪs̪əkn̪äː
सहजात	s̪ɛɦd͡ʒäːt̪
छलाँगना	t͡ʃʰəl̪ä̃ːŋɡn̪äː
प्रथमतः	pɾət̪ʰə̃mt̪əɦ
बैलगाड़ी	bɛːl̪ɡäːɽiː
बाँधना	bä̃ːn̪d̪ʱn̪äː
लंगूर	l̪ə̃ŋɡuːɾ
अतिवादी	ət̪ɪʋäːd̪iː
शिकायत	ʃɪkäːjət̪
छद्मनाम	t͡ʃʰəd̪mən̪ä̃ːm
रसना	ɾəs̪n̪äː
नंगा	n̪ə̃ŋɡäː
अवसंरचना	əʋs̪ə̃ɾət͡ʃn̪äː
मकान	məkä̃ːn̪
अज़ान	əzä̃ːn̪
कलकत्ता	kəl̪kət̪̚t̪äː
अन्य	ə̃n̪jə
मोज़ा	moːzäː
स्लोवाकिया	s̪l̪oːʋäːkijäː
मूल्य	muːl̪jᵊ
निमय	n̪ɪməj
तमन्ना	t̪əmə̃n̪n̪äː
जाना	d͡ʒäːn̪äː
टहलना	ʈɛɦɛl̪n̪äː
जन्नत	d͡ʒə̃n̪n̪ət̪
दर्शन	d̪əɾʃə̃n̪
कदापि	kəd̪äːpiː
माँगना	mä̃ːŋɡn̪äː
सुनहरा	s̪ʊn̪ɛɦɾäː
नरसंहार	n̪əɾs̪ə̃ŋɦäːɾ
शब्दालंकार	ʃəbd̪äːl̪ə̃ŋkäːɾ
समाधि	s̪əmäːd̪ʱiː
चिलवन	t͡ʃɪl̪ʋə̃n̪
पुरातत्व	pʊɾäːt̪ət̪wᵊ
उभरना	ʊbʱəɾn̪äː
मिल्कियत	mɪl̪kijət̪
फाँसी	pʰä̃ːs̪iː
प्रचंड	pɾət͡ʃə̃ɳɖ
ख़ानसामाँ	kʰä̃ːn̪s̪äːmä̃ː
अन्यायी	ə̃n̪jäːjiː
अँगीठी	ə̃ŋɡiːʈʰiː
सफेद	s̪əfeːd̪
छन	t͡ʃʰə̃n̪
क्षेत्रफल	kʃeːt̪ɾəpʰəl̪
मार्गशीर्ष	mäːɾɡʃiːɾʃ
कोहिमा	koːɦɪmäː
आँच	ä̃ːt͡ʃ
इकपहिया	ɪkəpʰijäː
फैलाव	pʰɛːl̪äːʋ
उत्तम	ʊt̪̚t̪ə̃m
गुरुद्वारा	ɡʊɾʊd̪wäːɾäː
कनिष्ठा	kən̪ɪʃʈʰäː
कलमा	kəl̪mäː
इसबगोल	ɪs̪bəɡoːl̪
प्याऊ	pjäːuː
अंडोरा	ə̃ɳɖoːɾäː
विलक्षण	ʋɪl̪əkʃə̃ɳ
लोकाट	l̪oːkäːʈ
मक़सद	məks̪əd̪
बॉलीवुड	bɔl̪iːʋʊɖ
सादिक़ाबाद	s̪äːd̪ɪkäːbäːd̪
घेरा	ɡʱeːɾäː
सुबह	s̪ʊbɦᵊ
गायिका	ɡäːjɪkäː
ताबीर	t̪äːbiːɾ
घूस	ɡʱuːs̪
उमड़ना	ʊməɽn̪äː
आधार	äːd̪ʱäːɾ
उपस्थिति	ʊpəs̪t̪ʰɪt̪iː
क्यूबा	kjuːbäː
अविनय	əʋɪn̪əj
बत्तख़	bət̪̚t̪əx
बेकार	beːkäːɾ
सींग	s̪ĩːŋɡ
भोपाल	bʱoːpäːl̪
जीवाश्म	d͡ʒiːʋäːʃmᵊ
लायक़	l̪äːjək
काग़ज	käːɣəz
मिस	mɪs̪
जिन्हें	d͡ʒɪ̃n̪ɦẽː
लघ्वातु	l̪əɡʱʋäːt̪uː
शौक़ीन	ʃɔːqĩːn̪
लिखो	l̪ɪkʰoː
निगाह	n̪ɪɡäːɦ
हगना	ɦəɡn̪äː
होंठलाली	ɦõːɳʈʰl̪äːl̪iː
पगला	pəɡl̪äː
उड्डयन	ʊɖ̚ɖəjə̃n̪
मुआयना	mʊäːjn̪äː
रसायन	ɾəs̪äːjə̃n̪
कुम्हलाना	kʊ̃mɦl̪äːn̪äː
दिलासा	d̪ɪl̪äːs̪äː
अवक्षयण	əʋkʃəjə̃ɳ
हकलाना	ɦəkl̪äːn̪äː
हिमशैल	ɦɪ̃mʃɛːl̪
केंद्रित	kẽːn̪d̪ɾɪt̪
सन्	s̪ə̃n̪
आग़ाज़	äːɡäːd͡ʒ
मुग़ल	mʊɡəl̪
आग्नेय	äːɡn̪eːj
प्रारम्भिक	pɾäːɾə̃mbʱɪk
फ़िदायीन	pʰɪd̪äːjĩːn̪
शौरसेनी	ʃɔːɾs̪eːn̪iː
शोधना	ʃoːd̪ʱn̪äː
सुलेमान	s̪ʊl̪eːmä̃ːn̪
यमन	jəmə̃n̪
राही	ɾäːɦiː
क़लम	kəl̪ə̃m
बादल	bäːd̪əl̪
विक्रेता	ʋɪkɾeːt̪äː
जादू	d͡ʒäːd̪uː
सलीब	s̪əl̪iːb
कांग्रेस	kä̃ːŋɡɾeːs̪
अपवाद	əpwäːd̪
क्रम	kɾə̃m
गोपनीयता	ɡoːpn̪iːjt̪äː
ज्वालामुखी	d͡ʒʋäːl̪äːmʊkʰiː
धारणा	d̪ʱäːɾɳäː
प्रणाम	pɾəɳä̃ːm
अड़ना	əɽn̪äː
स्वर	s̪ʋəɾ
अख़बारवाला	əkʰbäːɾʋäːl̪äː
महादेव	məɦäːd̪eːʋ
अटकल	əʈkəl̪
सशंक	s̪əʃə̃ŋk
कबाड़	kəbäːɽ
गुब्बारा	ɣʊb̚bäːɾäː
कम्युनिज़म	kə̃mjʊn̪ɪzm
पादना	päːd̪̚n̪äː
वेल्ला	ʋeːl̪l̪äː
इख़्तियार	ɪkʰt̪ijäːɾ
शालीन	ʃäːl̪ĩːn̪
मुहर	mɔɦɔɾ
असह्य	əs̪ɛɦjᵊ
हास	ɦäːs̪
आतिशबाजी	äːt̪ɪʃbäːd͡ʒiː
तंग	t̪ə̃ŋɡ
पायलट	päːjl̪əʈ
दादस	d̪äːd̪əs̪
संयोगवश	s̪ə̃joːɡʋəʃ
ताकना	t̪äːkn̪äː
हज़ार	ɦəd͡ʒäːɾ
यवनिका	jəʋn̪ɪkäː
लिंगायत	l̪ɪ̃ŋɡäːjət̪
ख़ुशहाली	xʊʃɦäːl̪iː
वैगन	ʋɛːɡə̃n̪
क़ैंची	kɛ̃ːn̪t͡ʃiː
अनजाना	ə̃n̪d͡ʒäːn̪äː
फ़ुर्सत	fʊɾs̪ət̪
फ़र्रुख़ाबाद	fəɾɾʊxäːbäːd̪
अभिक्रिया	əbʱɪkɾijäː
राष्ट्रपति	ɾäːʃʈɾəpt̪iː
तलहटी	t̪əl̪ɛɦʈiː
कसर	kəs̪əɾ
स्वाध्याय	s̪ʋäːd̪ʱjäːj
उपवास	ʊpwäːs̪
पलाण्डु	pəl̪ä̃ːɳɖuː
नींबू	n̪ĩːmbuː
हास्यास्पद	ɦäːs̪jäːs̪pəd̪
स्वचालित	s̪ʋət͡ʃäːl̪ɪt̪
सीता	s̪iːt̪äː
सुगन्ध	s̪ʊɡə̃n̪d̪ʱ
कंडकटर	kə̃ɳɖəkʈəɾ
जंगल	d͡ʒə̃ŋɡəl̪
चढ़ाई	t͡ʃəɽʱäːiː
आशियाना	äːʃijäːn̪äː
आरक्षण	äːɾəkʃə̃ɳ
मिलीभगत	mɪl̪iːbʱəɡət̪
नज़रबंदी	n̪əd͡ʒəɾbə̃n̪d̪iː
वारक	ʋäːɾək
झाड़ू	d͡ʒʱäːɽuː
ख़राश	xəɾäːʃ
ह्वेल	ɦʋeːl̪
जशन	d͡ʒəʃə̃n̪
यांत्रिकी	jä̃ːn̪t̪ɾɪkiː
सूंस	s̪ũːn̪s̪
अस्थि	əs̪t̪ʰiː
अर्थात्	əɾt̪ʰäːt̪
किफ़ायत	kɪpʰäːjət̪
सूँघना	s̪ũːŋɡʱn̪äː
गुंजाइश	ɡʊ̃n̪d͡ʒäːɪʃ
अविवाहित	əʋɪʋäːɦɪt̪
धूलि	d̪ʱuːl̪iː
साँड़	s̪ä̃ːɽ
नीचा	n̪iːt͡ʃäː
म्यानमार	mjä̃ːn̪mäːɾ
आखेट	äːkʰeːʈ
पैना	pɛːn̪äː
आवश्यकता	äːʋəʃjəkt̪äː
छत्तीसगढ़	t͡ʃʰət̪̚t̪iːs̪ɡəɽʱ
ज्योतिरिंगण	d͡ʒjoːt̪ɪɾɪ̃ŋɡə̃ɳ
प्रॉसिक्यूटर	pɾɔs̪ɪkjuːʈəɾ
सूना	s̪uːn̪äː
यूक्रेन	juːkɾẽːn̪
प्राप्तिकर्ता	pɾäːpt̪ɪkəɾt̪äː
बसंत	bəs̪ə̃n̪t̪
मुख़्तसर	mʊxt̪əs̪əɾ
माप	mäːp
जलमार्ग	d͡ʒəl̪mäːɾɡ
अक्षम्य	əkʃə̃mjᵊ
माखन	mäːkʰə̃n̪
सप्ताह	s̪əpt̪äːɦ
अफ़्रीका	əfɾiːkäː
झुकाव	d͡ʒʱʊkäːʋ
ज्यादा	zjäːd̪äː
पड़ोस	pəɽoːs̪
मेल	meːl̪
सप्ताहांत	s̪əpt̪äːɦä̃ːn̪t̪
फ़सल	fəs̪əl̪
जबड़ा	d͡ʒəbɽäː
जनप्रतिनिधि	d͡ʒə̃n̪pɾət̪ɪn̪ɪd̪ʱiː
रुलाना	ɾʊl̪äːn̪äː
लिमिटेड	l̪ɪmɪʈeːɖ
परंतु	pəɾə̃n̪t̪uː
राशिफल	ɾäːʃɪpʰəl̪
डोला	ɖoːl̪äː
इशारा	ɪʃäːɾäː
न	n̪ə
बीघा	biːɡʱäː
फ़िरौन	fɪɾɔ̃ːn̪
ब्रह्माण्ड	bɾɛɦmä̃ːɳɖ
साहिल	s̪äːɦɪl̪
महापौर	məɦäːpɔːɾ
संन्यासी	s̪ə̃n̪n̪jäːs̪iː
पुराना	pʊɾäːn̪äː
चमत्कार	t͡ʃəmət̪käːɾ
आर्थिकी	äːɾt̪ʰɪkiː
चाहत	t͡ʃäːɦət̪
लोकोक्ति	l̪oːkoːkt̪iː
नक़ाब	n̪əqäːb
माओवाद	mäːoːʋäːd̪
मर्दुमशुमारी	məɾd̪ʊ̃mʃʊmäːɾiː
नायिका	n̪äːjɪkäː
दबाव	d̪əbäːʋ
सैलाब	s̪ɛːl̪äːb
कयामत	kəjäːmət̪
विस्फोट	ʋɪs̪pʰoːʈ
ताक़त	t̪äːkət̪
फ़िरंगी	fɪɾə̃ŋɡiː
नर्स	n̪əɾs̪
कतल	kət̪əl̪
कैलिफ़ोर्निया	kɛːl̪ɪpʰoːɾn̪ijäː
गुनाह	ɡʊn̪äːɦ
ख़ानदानी	xä̃ːn̪d̪äːn̪iː
समर्पण	s̪əməɾpə̃ɳ
नाईं	n̪äːĩː
उदजारेय	ʊd̪̚d͡ʒäːɾeːj
यम	jə̃m
आफ़ताब	äːpʰt̪äːb
सेटेलाईट	s̪eːʈeːl̪äːiːʈ
सावधानी	s̪äːʋd̪ʱäːn̪iː
सिकंदराबाद	s̪ɪkə̃n̪d̪əɾäːbäːd̪
अमानवीयता	əmäːn̪əʋiːjət̪äː
लोन	l̪õːn̪
मंशा	mə̃n̪ʃäː
संदूक़	s̪ə̃n̪d̪uːq
क़द्रदान	qəd̪ɾəd̪ä̃ːn̪
रावत	ɾäːʋət̪
स्त्रीलिंग	s̪t̪ɾiːl̪ɪ̃ŋɡ
क़िस्मत	qɪs̪mət̪
अंदाज़ा	ə̃n̪d̪äːzäː
लड़खड़ाना	l̪əɽkʰəɽäːn̪äː
सुरंग	s̪ʊɾə̃ŋɡ
रुकना	ɾʊkn̪äː
लुप्त	l̪ʊpt̪
नौ	n̪ɔː
हज़ार	ɦəzäːɾ
अलविदा	əl̪ʋɪd̪äː
अलमारी	əl̪mäːɾiː
नुसख़ा	n̪ʊs̪xäː
अँगड़ाई	ə̃ŋɡɽäːiː
झरोखा	d͡ʒʱəɾoːkʰäː
कलम	kəl̪ə̃m
यौवन	jə̯uʋə̃n̪
तोता	t̪oːt̪äː
नागालैण्ड	n̪äːɡäːl̪ɛ̃ːɳɖ
स्पष्ट	s̪pəʂʈ
कुट्टार	kʊʈ̚ʈäːɾ
पूर्वस्नातक	puːɾʋs̪n̪äːt̪ək
गात्र	ɡäːt̪ɾᵊ
मौसीक़ी	mɔːs̪iːqiː
नाश्ता	n̪äːʃt̪äː
तेलंगाना	t̪eːl̪ə̃ŋɡäːn̪äː
कृष्ण	kɾɪʃɳäː
राजदूत	ɾäːd͡ʒd̪uːt̪
ख्वाब	xʋäːb
ग़लती	ɣəl̪t̪iː
निर्मल	n̪ɪɾməl̪
ओखली	oːkʰl̪iː
तीरंदाज़	t̪iːɾə̃n̪d̪äːz
श्रीमती	ʃɾĩːmt̪iː
कैलगरी	kɛːl̪ɡəɾiː
सुर	s̪ʊɾ
तिरुवनंतपुरम	t̪ɪɾʊʋən̪ə̃n̪t̪əpʊɾə̃m
मुल्तानी	mʊl̪t̪äːn̪iː
प्रावृत्ति	pɾäːʋɾɪt̪̚t̪iː
सर्वहारा	s̪əɾʋɦäːɾäː
गुलज़ार	ɡʊl̪d͡ʒäːɾ
इकनाली	ɪkn̪äːl̪iː
आध	äːd̪ʱ
दास्तान	d̪äːs̪t̪ä̃ːn̪
प्रबन्ध	pɾəbə̃n̪d̪ʱ
पिपीलिका	pɪpiːl̪ɪkäː
नक़्क़ाशी	n̪əqqäːʃiː
पैरोकार	pɛːɾoːkäːɾ
चाभी	t͡ʃäːbʱiː
बेगुनाह	beːɡʊn̪äːɦ
ब्रह्मांड	bɾɛɦmä̃ːɳɖ
कूदना	kuːd̪̚n̪äː
स्वतंत्र	s̪ʋət̪ə̃n̪t̪ɾᵊ
एकवचन	eːkwət͡ʃə̃n̪
होली	ɦoːl̪iː
वचन	ʋət͡ʃə̃n̪
स्विट्ज़रलैंड	s̪ʋɪʈzəɾl̪ɛ̃ːɳɖ
प्राचीन	pɾäːt͡ʃĩːn̪
धूर्तता	d̪ʱuːɾt̪ət̪äː
चमगादड़	t͡ʃə̃mɡäːd̪əɽ
फ़लक	pʰəl̪ək
टैक्स	ʈɛːks̪
साधारणतः	s̪äːd̪ʱäːɾə̃ɳt̪əɦ
दख़ल	d̪əxəl̪
गतिमान	ɡət̪ɪmä̃ːn̪
क्षेत्र	kʃeːt̪ɾᵊ
मालिन	mäːl̪ɪ̃n̪
पहलवानी	pɛɦɛl̪ʋäːn̪iː
हैरान	ɦɛːɾä̃ːn̪
मुज़फ़्फ़राबाद	mʊzəffəɾäːbäːd̪
हलक़ा	ɦəl̪qäː
प्राप्ति	pɾäːpt̪iː
मलेशिया	məl̪eːʃijäː
बानवे	bä̃ːn̪weː
ठुकराना	ʈʰʊkɾäːn̪äː
नुमाइंदा	n̪ʊmäːɪ̃n̪d̪äː
आगज़नी	äːɡd͡ʒən̪iː
गिनना	ɡɪ̃n̪n̪äː
हस्तशिल्प	ɦəs̪t̪əʃɪl̪p
टिकाऊपन	ʈɪkäːuːpə̃n̪
क़बूल	qəbuːl̪
सुशासन	s̪ʊʃäːs̪ə̃n̪
न्यारा	n̪jäːɾäː
ख़्वाब	xʋäːb
सौदागर	s̪ɔːd̪äːɡəɾ
फ़िराक़	pʰɪɾäːk
मूर्धन्य	muːɾd̪ʱə̃n̪jᵊ
कोमोरोस	koːmoːɾoːs̪
आकाशवाणी	äːkäːʃʋäːɳiː
समझौता	s̪ə̃md͡ʒʱɔːt̪äː
पाउंड	päːʊ̃ɳɖ
नाला	n̪äːl̪äː
जिसने	d͡ʒɪs̪n̪eː
किफ़ायती	kɪpʰäːjət̪iː
सौगन्द	s̪ɔːɡə̃n̪d̪
हिंद	ɦɪ̃n̪d̪
फ़ंतासी	pʰə̃n̪t̪äːs̪iː
नदी	n̪əd̪iː
लैंगिक	l̪ɛ̃ːŋɡɪk
प्रगतिशील	pɾəɡət̪ɪʃiːl̪
पिस्तौल	pɪs̪t̪ɔːl̪
पदयात्रा	pəd̪jäːt̪ɾäː
मैना	mɛːn̪äː
व्युत्क्रम	ʋjʊt̪kɾə̃m
उजागर	ʊd͡ʒäːɡəɾ
गौशाला	ɡɔːʃäːl̪äː
स्थाई	s̪t̪ʰäːiː
आसवन	äːs̪əʋə̃n̪
मराठी	məɾäːʈʰiː
बारे	bäːɾeː
केरल	keːɾəl̪ᵊ
दंभ	d̪ə̃mbʱ
बिगड़ना	bɪɡəɽn̪äː
अंगोला	ə̃ŋɡoːl̪äː
तक़सीम	t̪əks̪ĩːm
सीखना	s̪iːkʰn̪äː
सेहरा	s̪eːɦɾäː
निवेश	n̪ɪʋeːʃ
आकृति	äːkɾɪt̪iː
तरोताज़ा	t̪əɾoːt̪äːzäː
गणना	ɡə̃ɳn̪äː
विलासिता	ʋɪl̪äːs̪ɪt̪äː
अंदाज़	ə̃n̪d̪äːd͡ʒ
गुवाहाटी	ɡʊʋäːɦäːʈiː
समयानुसार	s̪ə̃mjäːn̪ʊs̪äːɾ
नैचा	n̪ɛːt͡ʃäː
पंसारी	pə̃n̪s̪äːɾiː
जैतून	zɛːt̪ũːn̪
बर्मिंघम	bəɾmɪ̃ŋɡʱə̃m
लघुगणक	l̪əɡʱʊɡəɳək
पतला	pət̪l̪äː
तूने	t̪uːn̪eː
एकांत	eːkä̃ːn̪t̪
विनती	ʋɪ̃n̪t̪iː
छापेख़ाना	t͡ʃʰäːpeːkʰäːn̪äː
अंगसंग	ə̃ŋɡs̪ə̃ŋɡ
स्वामी	s̪ʋäːmiː
कन्या	kə̃n̪jäː
संक्रमण	s̪ə̃ŋkɾəmə̃ɳ
नाटककार	n̪äːʈək̚käːɾ
पत्थरबाज़	pət̪̚t̪ʰəɾbäːz
कामकाज	kä̃ːmkäːd͡ʒ
मुस्तक़बिल	mʊs̪t̪əqbɪl̪
शान	ʃä̃ːn̪
लापता	l̪äːpət̪äː
बरिशाल	bəɾɪʃäːl̪
ओशिआनिया	oːʃijäːn̪ijäː
गोलीबारी	ɡoːl̪iːbäːɾiː
स्त्री	s̪t̪ɾiː
याद	jäːd̪
अपर्याप्त	əpəɾjäːpt̪
अविलंब	əʋɪl̪ə̃mb
आदर्श	äːd̪əɾʃ
इश्तहार	ɪʃt̪əɦäːɾ
प्रभुत्व	pɾəbʱʊt̪wᵊ
जाँघ	d͡ʒä̃ːŋɡʱ
नामनिर्देशिती	n̪ä̃ːmn̪ɪɾd̪eːʃɪt̪iː
लिस्ट	l̪ɪs̪ʈ
ढलना	ɖʱəl̪n̪äː
प्रेक्षित	pɾeːkʃɪt̪
अड़ियल	əɽijəl̪
बहुचर्चित	bɔɦɔt͡ʃəɾt͡ʃɪt̪
नगरीकरण	n̪əɡɾiːkəɾə̃ɳ
पसली	pəs̪l̪iː
चूहा	t͡ʃuːɦäː
स्वीकृति	s̪ʋiːkɾɪt̪iː
ख़ुशबूदार	xʊʃbuːd̪äːɾ
साढ़े	s̪äːɽʱeː
समाजवाद	s̪əmäːd͡ʒʋäːd̪
आस	äːs̪
साबिक़	s̪äːbɪk
पहिया	pəiːjäː
दहलीज़	d̪ɛɦl̪iːz
बर्तन	bəɾt̪ə̃n̪
अलसाना	əl̪s̪äːn̪äː
टर्मिनल	ʈəɾmɪn̪əl̪
अस्वीकृति	əs̪ʋiːkɾɪt̪iː
अझ़दहा	əʒd̪əɦäː
गैंडा	ɡɛ̃ːɳɖäː
आप्रवासी	äːpɾəʋäːs̪iː
उत्तेजना	ʊt̪̚t̪eːd͡ʒn̪äː
ग़ुसल	ɡʊs̪əl̪
भेदना	bʱeːd̪̚n̪äː
लड़ाई	l̪əɽäːiː
स्मार्टफ़ोन	s̪mäːɾʈpʰõːn̪
पीतल	piːt̪əl̪
भटूरा	bʱəʈuːɾäː
साझा	s̪äːd͡ʒʱäː
अक्षर	əkʃəɾ
अनुमोदित	ən̪ʊmoːd̪ɪt̪
महानगर	məɦäːn̪əɡəɾ
अज़दहा	əd͡ʒd̪əɦäː
बूझना	buːd͡ʒʱn̪äː
गायब	ɣäːjb
पधारना	pəd̪ʱäːɾn̪äː
नाखुन	n̪äːxʊ̃n̪
क़िस्मत	kɪs̪mət̪
सत्याग्रह	s̪ət̪jäːɡɾəɦ
अलीगढ	əl̪iːɡəɽʱ
बदतमीज़	bəd̪̚t̪əmiːd͡ʒ
रूठा	ɾuːʈʰäː
जुमा	d͡ʒʊmäː
सेल	s̪eːl̪
परिक्रमा	pəɾɪkɾəmäː
थाना	t̪ʰäːn̪äː
आशिक़	äːʃɪk
दैत्य	d̪ɛːt̪jaː
ख़लक़	xəl̪q
इलज़ाम	ɪl̪d͡ʒä̃ːm
कुंजी	kʊ̃n̪d͡ʒiː
त्वचा	t̪wət͡ʃäː
सच	s̪ət͡ʃ
घूसख़ोरी	ɡʱuːs̪kʰoːɾiː
सौंफ	s̪ɔ̃ːf
नामवर	n̪ä̃ːmwəɾ
पाक	päːk
डेटा	ɖeːʈäː
सवाल	s̪əʋäːl̪
उपजाऊ	ʊpd͡ʒäːuː
ठेका	ʈʰeːkäː
हज़्म	ɦəd͡ʒə̃m
लूक़ा	l̪uːkäː
उत्पन्न	ʊt̪pə̃n̪n̪
अगला	əɡl̪äː
होना	ɦoːn̪äː
ग़म	ɣə̃m
खोलना	kʰoːl̪n̪äː
पत्रिका	pət̪ɾɪkäː
शक्तिशाली	ʃəkt̪ɪʃäːl̪iː
मड़ुआ	məɽʊäː
स्विट्ज़रलैण्ड	s̪ʋɪʈd͡ʒəɾl̪ɛ̃ːɳɖ
स्त्रोत	s̪t̪ɾoːt̪
ं	ə̃ɳ
इत्मीनान	ɪt̪miːn̪ä̃ːn̪
नमी	n̪əmiː
अबटाबाद	əbʈäːbäːd̪
गुल	ɡʊl̪
डबलिन	ɖəbl̪ɪ̃n̪
वयस्क	ʋəjəs̪k
लड़कपन	l̪əɽəkpə̃n̪
आफ़रीन	äːpʰɾĩːn̪
अंग्रेजी	ə̃ŋɡɾeːd͡ʒiː
बातचीत	bäːt̪̚t͡ʃiːt̪
दग़ाबाज़	d̪əɣäːbäːz
लुचपन	l̪ʊt͡ʃpə̃n̪
बाएँ	bäːẽː
शुक्रवार	ʃʊkɾəʋäːɾ
स्वेच्छा	s̪ʋeːt̚t͡ʃʰäː
पैग़ाम	pɛːɡä̃ːm
गहराई	ɡɛɦɾäːiː
तिलक	t̪ɪl̪ək
वृत्तांत	ʋɾɪt̪̚t̪ä̃ːn̪t̪
टमटम	ʈə̃mʈə̃m
निकालना	n̪ɪkäːl̪n̪äː
आत्मोद्धार	äːt̪moːd̪̚d̪ʱäːɾ
आत्मनिर्भरता	äːt̪mən̪ɪɾbʱəɾt̪äː
सर्वश्रेष्ठ	s̪əɾʋəʃɾeːʂʈʰ
तकलीफ़देह	t̪əkl̪iːfd̪eːɦ
गण	ɡə̃ɳ
श्वेता	ʃʋeːt̪äː
करारा	kəɾäːɾäː
बेस्वाद	beːs̪ʋäːd̪
चश्मा	t͡ʃəʃmäː
गुस्ताख़ी	ɡʊs̪t̪äːkʰiː
इंक़िलाब	ɪ̃ɴqɪl̪äːb
काँसा	kä̃ːs̪äː
बिताना	bɪt̪äːn̪äː
भँवरा	bʱə̃ʋɾäː
धर्मशास्त्र	d̪ʱəɾməʃäːs̪t̪ɾᵊ
घुड़सवार	ɡʱʊɽs̪əʋäːɾ
मूसलधार	muːs̪əl̪d̪ʱäːɾ
कड़वा	kəɽʋäː
बान	bä̃ːn̪
बाज़ू	bäːd͡ʒuː
क्रमशः	kɾə̃mʃəɦ
मारपीट	mäːɾpiːʈ
महात्मा	məɦäːt̪mäː
आयत	äːjət̪
अज्ञानपन	əɡjä̃ːn̪pə̃n̪
विश्लेषक	ʋɪʃl̪eːʃək
सीट	s̪iːʈ
सीस	s̪iːs̪
लुंबिनी	l̪ʊ̃mbɪn̪iː
रोज़ाना	ɾoːd͡ʒäːn̪äː
आई	äːiː
नीलम	n̪iːl̪ə̃m
वफ़ादार	ʋəfäːd̪äːɾ
प्रतिकर्षी	pɾət̪ɪkəɾʃiː
मकदूनिया	məkd̪uːn̪ijäː
अनिच्छा	ən̪ɪt̚t͡ʃʰäː
यादाश्त	jäːd̪äːʃt̪
ज्यादा	d͡ʒjäːd̪äː
नेस्तनाबूद	n̪eːs̪t̪ən̪äːbuːd̪
प्रसिद्धि	pɾəs̪ɪd̪̚d̪ʱiː
बीरगंज	biːɾɡə̃n̪d͡ʒ
विषय	ʋɪʃəj
अफ़ीमची	əfĩːmt͡ʃiː
संक्षिप्त	s̪ə̃ŋkʃɪpt̪
अंग्रेज	ə̃ŋɡɾeːd͡ʒ
फर्न	pʰəɾn̪
मलहम	məl̪ɦə̃m
उड़िया	ʊɽijäː
जातिगत	d͡ʒäːt̪ɪɡət̪
मशीन	məʃĩːn̪
हड़बड़ाना	ɦəɽbəɽäːn̪äː
अफ़साना	əfs̪äːn̪äː
प्रस्तुति	pɾəs̪t̪ʊt̪iː
ग्रामीण	ɡɾäːmĩːɳ
सुनाना	s̪ʊn̪äːn̪äː
अमन	əmə̃n̪
परियोजना	pəɾijoːd͡ʒn̪äː
सितारा	s̪ɪt̪äːɾäː
बंदूक़	bə̃n̪d̪uːk
फ़िरंग	fɪɾə̃ŋɡ
उनको	ʊ̃n̪koː
हलब	ɦəl̪əb
पलीता	pəl̪iːt̪äː
पाँच	pä̃ːt͡ʃ
आटा	äːʈäː
चन्द्रिका	t͡ʃə̃n̪d̪ɾɪkäː
लिखती	l̪ɪkʰt̪iː
अर्धकुशल	əɾd̪ʱkʊʃəl̪
तल	t̪əl̪
ख़ाना	xäːn̪äː
मिलनी	mɪl̪n̪iː
पहनाना	pɛɦn̪äːn̪äː
पाठ्यपुस्तक	päːʈʰjəpʊs̪t̪ək
कमेंट	kəmẽːɳʈ
हँसी	ɦə̃s̪iː
संसदीय	s̪ə̃n̪s̪əd̪iːj
सिद्ध	s̪ɪd̪d̪ʱ
पाहुना	päːɦʊn̪äː
हृदयाघात	ɦɾɪd̪əjäːɡʱäːt̪
आत्मविश्वास	äːt̪məʋɪʃʋäːs̪
हकीम	ɦəkĩːm
मानविकी	mä̃ːn̪wɪkiː
सर्बिया	s̪əɾbijäː
शाहाना	ʃäːɦäːn̪äː
ग़नीमत	ɡən̪iːmət̪
पूर्वाग्रह	puːɾʋäːɡɾəɦ
महिमा	məɦɪmäː
रक़म	ɾəkə̃m
लेखाकार	l̪eːkʰäːkäːɾ
लिप्यंतरण	l̪ɪpjə̃n̪t̪əɾə̃ɳ
साउथॉल	s̪äːʊt̪ʰɔl̪
आत्मसंतोष	äːt̪məs̪ə̃n̪t̪oːʃ
ऊसर	uːs̪əɾ
अनुनासिकता	ən̪ʊn̪äːs̪ɪkt̪äː
अंतरिम	ə̃n̪t̪ɾɪ̃m
अक़्ल	əkl̪ᵊ
बग़ीचा	bəɡiːt͡ʃäː
आदी	äːd̪iː
हिंदवी	ɦɪ̃n̪d̪əʋiː
नियुक्ति	n̪ijʊkt̪iː
तक़रीबन	t̪əqɾiːbə̃n̪
रिंच	ɾɪ̃n̪t͡ʃ
ज्ञानकोष	ɡjä̃ːn̪koːʃ
नेतन्याहू	n̪eːt̪ə̃n̪jäːɦuː
इटालियन	ɪʈäːl̪ijə̃n̪
प्राध्यापक	pɾäːd̪ʱjäːpək
संलिप्त	s̪ə̃l̪ɪpt̪
मृत्युदंड	mɾɪt̪jʊd̪ə̃ɳɖ
आसानी	äːs̪äːn̪iː
बहन	bɛɦɛ̃n̪
अधिकारी	əd̪ʱɪkäːɾiː
जुदा	d͡ʒʊd̪äː
भिषग्वर	bʱɪʃəɡʋəɾ
मट्टी	məʈ̚ʈiː
कार्त्तिक	käːɾt̪ɪk
टिड्डी	ʈɪɖ̚ɖiː
कीटाणु	kiːʈäːɳuː
काजल	käːd͡ʒəl̪
कार्तिक	käːɾt̪ɪk
ऊर्ध्वाधर	uːɾd̪ʱʋäːd̪ʱəɾ
टाँगना	ʈä̃ːŋɡn̪äː
भाव	bʱäːʋ
झाँसी	d͡ʒʱä̃ːs̪iː
रवांडा	ɾəʋä̃ːɳɖäː
लेकर	l̪eːkəɾ
खोटा	kʰoːʈaː
ग़ुस्साना	ɡʊs̪s̪äːn̪äː
खरोंचना	kʰəɾõːn̪t͡ʃn̪äː
प्रासंगिकता	pɾäːs̪ə̃ŋɡɪkt̪äː
ऐहतियातन	ɛːɦt̪ijäːt̪ə̃n̪
गुलाम	ɡʊl̪ä̃ːm
दुश्मन	d̪ʊʃmə̃n̪
शेख़ूपुरा	ʃeːxuːpʊɾäː
सुराख़	s̪ʊɾäːkʰ
तिंदिश	t̪ɪ̃n̪d̪ɪʃ
क़व्वाली	qəʋʋäːl̪iː
होटल	ɦoːʈəl̪
निर्बल	n̪ɪɾbəl̪
गायब	ɡäːjb
उपासक	ʊpäːs̪ək
वाष्पोत्सर्जन	ʋäːʃpoːt̪s̪əɾd͡ʒə̃n̪
साधना	s̪äːd̪ʱn̪äː
आदरपूर्वक	äːd̪əɾpuːɾʋək
सुभानअल्लाह	s̪ʊbʱä̃ːn̪‿əl̪l̪äːɦ
कहना	kɛɦn̪äː
तरंग	t̪əɾə̃ŋɡ
ख़िलाफ़	kʰɪl̪äːpʰ
संलक्षण	s̪ə̃l̪əkʃə̃ɳ
इबादत	ɪbäːd̪ət̪
हेलो	ɦeːl̪oː
नेतृत्व	n̪eːt̪ɾɪt̪wᵊ
रियाज़	ɾijäːz
दूल्हा	d̪uːl̪ɦäː
अनेक	ən̪eːk
पटेल	pəʈeːl̪
थाई	t̪ʰäːiː
आशुलिपि	äːʃʊl̪ɪpiː
चायदान	t͡ʃäːjd̪ä̃ːn̪
महफिल	mɛɦpʰɪl̪
ढाल	ɖʱäːl̪
तस्कर	t̪əs̪kəɾ
अविनीत	əʋɪn̪iːt̪
चन्द्रवार	t͡ʃə̃n̪d̪ɾəʋäːɾ
क्रमण	kɾəmə̃ɳ
सुर्ख़ाब	s̪ʊɾxäːb
द्विरेफ	d̪wɪɾeːpʰ
बयानबाज़ी	bəjä̃ːn̪bäːziː
थकना	t̪ʰəkn̪äː
पलस्तर	pəl̪əs̪t̪əɾ
प्रभाव	pɾəbʱäːʋ
छुपना	t͡ʃʰʊpn̪äː
फलस्वरूप	pʰəl̪əs̪ʋəɾuːp
फालतू	pʰäːl̪t̪uː
आक़ा	äːkäː
दूकान	d̪uːkä̃ːn̪
दोषी	d̪oːʃiː
वैतनिक	ʋɛːt̪ən̪ɪk
विधा	ʋɪd̪ʱäː
व्याधि	ʋjäːd̪ʱiː
श्रीनगर	ʃɾiːn̪əɡəɾ
बाँह	bä̃ːɦ
नपुंसकता	n̪əpʊ̃n̪s̪əkt̪äː
दिलचस्पी	d̪ɪl̪t͡ʃəs̪piː
अग्रिम	əɡɾɪ̃m
औपचारिक	ɔːpt͡ʃäːɾɪk
क़ालीन	qäːl̪ĩːn̪
आगज़नी	äːɡzən̪iː
पादावरण	päːd̪äːʋɾə̃ɳ
एहसास	eːɦs̪äːs̪
मार्फ़िया	mäːɾpʰijäː
रंजिश	ɾə̃n̪d͡ʒɪʃ
स्वाँग	s̪ʋä̃ːŋɡ
समेत	s̪əmeːt̪
चड्डी	t͡ʃəɖ̚ɖiː
दीवाना	d̪iːʋäːn̪äː
चोग़ा	t͡ʃoːɡäː
दांत	d̪ä̃ːt̪
दफ़न	d̪əpʰə̃n̪
प्रसव	pɾəs̪əʋ
बांह	bä̃ːɦ
कंपन	kə̃mpə̃n̪
शुभकामना	ʃʊbʱkä̃ːmn̪äː
हुआ	ɦʊäː
सकना	s̪əkn̪äː
घटना	ɡʱəʈn̪äː
मूँगफली	mũːŋɡpʰəl̪iː
महागुरु	məɦäːɡʊɾuː
हमलावर	ɦə̃ml̪äːʋəɾ
डाकू	ɖäːkuː
स्वर्णमंदिर	s̪ʋəɾɳmə̃n̪d̪ɪɾ
नल्ला	n̪əl̪l̪äː
नब्ज़	n̪əbd͡ʒ
संडास	s̪ə̃ɳɖäːs̪
ख़सरा	kʰəs̪ɾäː
हींग	ɦĩːŋɡ
क़दमताल	qəd̪ə̃mt̪äːl̪
जानकारी	d͡ʒä̃ːn̪käːɾiː
सहलाना	s̪ɛɦl̪äːn̪äː
चुनौती	t͡ʃʊn̪ɔːt̪iː
दक्षिणापथ	d̪əkʃɪɳäːpət̪ʰ
रियासत	ɾijäːs̪ət̪
नरवृषभ	n̪əɾʋɾɪʃəbʱ
विश्वासनीय	ʋɪʃʋäːs̪n̪iːjᵊ
हाथी	ɦäːt̪ʰiː
बाग	bäːɣ
जासूसी	d͡ʒäːs̪uːs̪iː
दरअसल	d̪əɾəs̪əl̪
तौहीन	t̪ɔːɦĩːn̪
खुदरा	kʰʊd̪ɾäː
वासना	ʋäːs̪n̪äː
निगमन	n̪ɪɡəmə̃n̪
बर्खा	bəɾkʰäː
ख़ातून	xäːt̪ũːn̪
स्थापना	s̪t̪ʰäːpn̪äː
ग्रीस	ɡɾiːs̪
भारा	bʱäːɾäː
वसन्त	ʋəs̪ə̃n̪t̪
नाक	n̪äːk
कोहराम	koːɦɾä̃ːm
ख़ुराफ़ात	xʊɾäːfäːt̪
गांभीर्य	ɡä̃ːmbʱiːɾjᵊ
कृतित्व	kɾɪt̪ɪt̪wᵊ
दामन	d̪äːmə̃n̪
पिघलना	pɪɡʱəl̪n̪äː
केतली	keːt̪l̪iː
प्रागितिहास	pɾäːɡɪt̪ɪɦäːs̪
राग	ɾäːɡ
बुढ़ापा	bʊɽʱäːpäː
उधार	ʊd̪ʱäːɾ
दादुर	d̪äːd̪ʊɾ
निकाह	n̪ɪkäːɦ
अध्यक्षता	əd̪ʱjəkʃt̪äː
विलायती	ʋɪl̪äːjət̪iː
परिमार्जित	pəɾɪmäːɾd͡ʒɪt̪
शनि	ʃən̪iː
शगूफ़ा	ʃəɡuːfäː
गमला	ɡə̃ml̪äː
अभाव	əbʱäːʋ
फ़रमाना	pʰəɾmäːn̪äː
मूँग	mũːŋɡ
ऐतराज़	ɛːt̪ɾäːz
झुठलाना	d͡ʒʱʊʈʰl̪äːn̪äː
दावत	d̪äːʋət̪
दिवाली	d̪ɪʋäːl̪iː
दिली	d̪ɪl̪iː
अंगदान	ə̃ŋɡd̪ä̃ːn̪
नियामक	n̪ijäːmək
अवक्षेपण	əʋkʃeːpə̃ɳ
पैंसठ	pɛ̃ːn̪s̪əʈʰ
अरस्तू	əɾəs̪t̪uː
तकल्लुफ़	t̪əkəl̪l̪ʊf
फ़रमाना	fəɾmäːn̪äː
दाताओ	d̪äːt̪äːoː
क़सम	qəs̪ə̃m
प्रतिच्छेद	pɾət̪ɪt̚t͡ʃʰeːd̪
अवांछित	əʋä̃ːn̪t͡ʃʰɪt̪
आत्मीयता	äːt̪miːjt̪äː
दोहा	d̪oːɦäː
वर्तमान	ʋəɾt̪əmä̃ːn̪
कटार	kəʈäːɾ
नाडु	n̪äːɖuː
गैलन	ɡɛːl̪ə̃n̪
अँग्रेज़	ə̃ŋɡɾeːd͡ʒ
अजनबियत	əd͡ʒn̪əbijət̪
राजकोट	ɾäːd͡ʒkoːʈ
नौटंकी	n̪ɔːʈə̃ŋkiː
प्रार्थना	pɾäːɾt̪ʰən̪äː
जलित	d͡ʒəl̪ɪt̪
ख़तम	xət̪ə̃m
इकबाल	ɪkbäːl̪
अनुवाद	ən̪ʊʋäːd̪
स्याह	s̪jäːɦ
कूल्हा	kuːl̪ɦäː
तसव्वुर	t̪əs̪əʋʋʊɾ
माले	mäːl̪eː
पुस्तिका	pʊs̪t̪ɪkäː
अटकना	əʈəkn̪äː
वैंकूवर	ʋɛ̃ːŋkuːʋəɾ
पटाका	pəʈäːkäː
सुकून	s̪ʊkũːn̪
राज्यवार	ɾäːd͡ʒjəʋäːɾ
जमाई	d͡ʒəmäːiː
सूजी	s̪uːd͡ʒiː
रसीद	ɾəs̪iːd̪
हिंसात्मक	ɦɪ̃n̪s̪äːt̪mək
छलना	t͡ʃʰəl̪n̪äː
रोहिंग्या	ɾoːɦɪ̃ŋɡjäː
पटाखा	pəʈäːkʰäː
रंभा	ɾə̃mbʱäː
स्याही	s̪jäːɦiː
पूनम	puːn̪ə̃m
आनुवंशिकी	äːn̪ʊʋə̃n̪ʃɪkiː
क़ैदख़ाना	qɛːd̪xäːn̪äː
बाबा	bäːbäː
मुंतज़िर	mʊ̃n̪t̪əzɪɾ
संदल	s̪ə̃n̪d̪əl̪
विश्वभाषा	ʋɪʃʋəbʱäːʃäː
तुक्का	t̪ʊk̚käː
गहना	ɡɛɦn̪äː
स्लाइस	s̪l̪äːɪs̪
भंग	bʱə̃ŋɡ
पढ़ना	pəɽʱn̪äː
पछाड़	pət͡ʃʰäːɽ
वीरान	ʋiːɾä̃ːn̪
अर्जेन्टीना	äːɾd͡ʒẽːɳʈiːn̪äː
अँगरेज़ी	ə̃ŋɡɾeːd͡ʒiː
चमड़ा	t͡ʃə̃mɽäː
सवेरे	s̪əʋeːɾeː
श्रावण	ʃɾäːʋə̃ɳ
मुलाज़िम	mʊl̪äːzɪ̃m
चुसकी	t͡ʃʊs̪kiː
बादाम	bäːd̪ä̃ːm
बाँध	bä̃ːn̪d̪ʱ
पेठा	peːʈʰäː
अंतर्कालीन	ə̃n̪t̪əɾkäːl̪ĩːn̪
मुनाफ़ा	mʊn̪äːpʰäː
अपसामान्य	əps̪äːmä̃ːn̪jᵊ
राजा	ɾäːd͡ʒäː
पनीर	pən̪iːɾ
अगाऊ	əɡäːuː
द्विपक्षीय	d̪wɪpəkʃiːjᵊ
क्षारीय	kʃäːɾiːjᵊ
मध्यांतर	məd̪ʱjä̃ːn̪t̪əɾ
बूढ़ा	buːɽʱäː
बाण	bä̃ːɳ
थाईलैंड	t̪ʰäːiːl̪ɛ̃ːɳɖ
जगमगाना	d͡ʒəɡməɡäːn̪äː
ससुराल	s̪əs̪ʊɾäːl̪
हितकारिणी	ɦɪt̪käːɾɪɳiː
चेहरा	t͡ʃeːɦɾäː
शाहीन	ʃäːɦĩːn̪
चंद्र	t͡ʃə̃n̪d̪ɾᵊ
भूचाल	bʱuːt͡ʃäːl̪
लूक़ा	l̪uːqäː
आलेख	äːl̪eːkʰ
तिब्बत	t̪ɪb̚bət̪
क़दम	qəd̪ə̃m
चॉकलेट	t͡ʃɔkəl̪eːʈ
सोशलिस्ट	s̪oːʃl̪ɪs̪ʈ
जेठानी	d͡ʒeːʈʰäːn̪iː
चंद्रग्रहण	t͡ʃə̃n̪d̪ɾəɡɾɛɦɛ̃ɳ
ग़ुस्सा	ɡʊs̪s̪äː
चेन्नई	t͡ʃẽːn̪n̪əiː
बोल	boːl̪
आर्मेनिया	äːɾmeːn̪ijäː
इकावन	ɪkäːʋə̃n̪
पंचशील	pə̃n̪t͡ʃʃiːl̪
क़ायदा	qäːjd̪äː
किरायेदार	kɪɾäːjeːd̪äːɾ
पसंदीदा	pəs̪ə̃n̪d̪iːd̪äː
खेला	kʰeːl̪äː
पुलिंदा	pʊl̪ɪ̃n̪d̪äː
पकोड़ा	pəkoːɽäː
संभोग	s̪ə̃mbʱoːɡ
जाला	d͡ʒäːl̪äː
अपेक्षित	əpeːkʃɪt̪
अध्ययन	əd̪ʱjə̃n̪
इंतकाल	ɪ̃n̪t̪əqäːl̪
टूथपेस्ट	ʈuːt̪ʰpeːs̪ʈ
अधिनायक	əd̪ʱɪn̪äːjək
कर्मशाला	kəɾməʃäːl̪äː
मूलाधार	muːl̪äːd̪ʱäːɾ
बकवास	bəkwäːs̪
परनानी	pəɾn̪äːn̪iː
नरगिस	n̪əɾɡɪs̪
हिलवाना	ɦɪl̪ʋäːn̪äː
कृदन्त	kɾɪd̪ə̃n̪t̪
संग्रथन	s̪ə̃ŋɡɾət̪ʰə̃n̪
देहली	d̪eːɦl̪iː
कुशल	kʊʃəl̪
झाग	d͡ʒʱäːɡ
चोखा	t͡ʃoːkʰäː
शोला	ʃoːl̪äː
बवासीर	bəʋäːs̪iːɾ
सरदार	s̪əɾd̪äːɾ
राजमा	ɾäːd͡ʒmäː
दवाख़ाना	d̪əʋäːxäːn̪äː
विक्षनरी	ʋɪkʃə̃n̪ɾiː
कारण	käːɾə̃ɳ
कमाई	kəmäːiː
प्रोत्साहित	pɾoːt̪s̪äːɦɪt̪
मचाना	mət͡ʃäːn̪äː
उपायुक्त	ʊpäːjʊkt̪
पंखावाला	pə̃ŋkʰäːʋäːl̪äː
झमेला	d͡ʒʱəmeːl̪äː
जा	d͡ʒäː
दालचीनी	d̪äːl̪t͡ʃiːn̪iː
गिनी	ɡɪn̪iː
टँगना	ʈə̃ŋɡn̪äː
सिडनी	s̪ɪɖn̪iː
मसिपात्र	məs̪ɪpäːt̪ɾᵊ
महफ़िल	mɛɦpʰɪl̪
राशि	ɾäːʃiː
क़दीम	qəd̪ĩːm
मनमाना	mə̃n̪mäːn̪äː
विद्यालय	ʋɪd̪jäːl̪əj
बायाँ	bäːjä̃ː
रियाज़	ɾijäːd͡ʒ
हिंसा	ɦɪ̃n̪s̪äː
अस्वीकृत	əs̪ʋiːkɾɪt̪
बहुपयोगी	bɔɦɔpjoːɡiː
मेक्सिको	meːks̪ɪkoː
बिकाऊ	bɪkäːuː
दाम	d̪ä̃ːm
मख़मल	məkʰməl̪
वेलिंग्टन	ʋeːl̪ɪ̃ŋɡʈə̃n̪
तारा	t̪äːɾäː
कागज	käːɡəd͡ʒ
हाफ़िज़ा	ɦäːfɪzäː
बंबैया	bə̃mbə̯ijäː
जोहानसबर्ग	d͡ʒoːɦäːn̪əs̪bəɾɡ
तैंतीस	t̪ɛ̃ːn̪t̪iːs̪
पेट्रोल	peːʈɾoːl̪
ज़लज़ला	d͡ʒəl̪d͡ʒəl̪äː
दराज़	d̪əɾäːd͡ʒ
कामचोर	kä̃ːmt͡ʃoːɾ
बराबर	bəɾäːbəɾ
क़ानून	qäːn̪ũːn̪
पीसना	piːs̪n̪äː
हैदराबाद	ɦɛːd̪ɾäːbäːd̪
मैलवेयर	mɛːl̪ʋeːjəɾ
वैकुण्ठ	ʋɛːkʊ̃ɳʈʰ
पसंदगी	pəs̪ə̃n̪d̪ɡiː
प्रागैतिहासिक	pɾäːɡɛːt̪ɪɦäːs̪ɪk
पोता	poːt̪äː
संशोधन	s̪ə̃n̪ʃoːd̪ʱə̃n̪
क्राइस्टचर्च	kɾäːɪs̪ʈt͡ʃəɾt͡ʃ
क्षेत्रीय	kʃeːt̪ɾiːjᵊ
मेवाड़	meːʋäːɽ
तर्कशास्त्र	t̪əɾkʃäːs̪t̪ɾᵊ
अबिवात्त	əbɪʋäːt̪t̪
नोनी	n̪oːn̪iː
ख़बरनवीस	kʰəbəɾn̪əʋiːs̪
प्रजा	pɾəd͡ʒäː
कम्युनिज़म	kə̃mjʊn̪ɪd͡ʒə̃m
फ़्रांसीसी	pʰɾä̃ːn̪s̪iːs̪iː
जिज्ञासा	d͡ʒɪɡjäːs̪äː
इल्तिजा	ɪl̪t̪ɪd͡ʒäː
अधीनता	əd̪ʱĩːn̪t̪äː
संगीन	s̪ə̃ŋɡĩːn̪
वादा	ʋäːd̪äː
तसल्ली	t̪əs̪əl̪l̪iː
किला	qɪl̪äː
टेलीफोन	ʈeːl̪iːfõːn̪
दिरम	d̪ɪɾə̃m
हवाला	ɦəʋäːl̪äː
मुक़दमा	mʊkəd̪mäː
संवेग	s̪ə̃mweːɡ
फ़र्रुख़ाबाद	pʰəɾɾʊkʰäːbäːd̪
छरहरा	t͡ʃʰəɾɛɦɾäː
भुवन	bʱʊʋə̃n̪
ताज़ा	t̪äːzäː
ज़ाया	d͡ʒäːjäː
आसमान	äːs̪mä̃ːn̪
सिफ़र	s̪ɪpʰəɾ
संत	s̪ə̃n̪t̪
कसौटी	kəs̪ɔːʈiː
परिकलित्र	pəɾɪkəl̪ɪt̪ɾᵊ
क़फ़स	qəfəs̪
तत्पश्चात्	t̪ət̪pəʃt͡ʃäːt̪
आजमाना	äːd͡ʒmäːn̪äː
मशीनीकरण	məʃiːn̪iːkəɾə̃ɳ
छली	t͡ʃʰəl̪iː
आदरणीय	äːd̪əɾɳiːjᵊ
जम्मू	d͡ʒə̃mmuː
भुगताना	bʱʊɡt̪äːn̪äː
सिफ़ारत	s̪ɪpʰäːɾət̪
कार्यकर्ता	käːɾjəkəɾt̪äː
परवाज़	pəɾʋäːz
दग़ा	d̪əɡäː
धरान	d̪ʱəɾä̃ːn̪
सौराष्ट्र	s̪ɔːɾäːʃʈɾᵊ
क़लम	qəl̪ə̃m
ऊन	ũːn̪
सर्वदलीय	s̪əɾʋd̪əl̪iːjᵊ
एडवायज़री	eːɖwäːjd͡ʒəɾiː
महीन	məɦĩːn̪
प्रांत	pɾä̃ːn̪t̪
ज़्यादती	zjäːd̪ət̪iː
चंद्रवार	t͡ʃə̃n̪d̪ɾəʋäːɾ
फेसबुक	feːs̪bʊk
मोबाइल	moːbäːɪl̪
किफ़ायत	kɪfäːjət̪
समक्ष	s̪əməkʃ
ज़र्रा	d͡ʒəɾɾäː
सहरा	s̪ɛɦɾäː
काग़ज़ात	käːɡd͡ʒäːt̪
दृढ़संकल्प	d̪ɾɪɽʱs̪ə̃ŋkəl̪p
गधा	ɡəd̪ʱäː
ताज	t̪äːd͡ʒ
संलग्न	s̪ə̃l̪əɡn̪ᵊ
अनुवांशिक	ən̪ʊʋä̃ːn̪ʃɪk
अंक	ə̃ŋk
अलार्म	əl̪ɑːɾəm
चरण	t͡ʃəɾə̃ɳ
रिक्शावाला	ɾɪkʃäːʋäːl̪äː
तिल	t̪ɪl̪
शिरोरेखा	ʃɪɾoːɾeːkʰäː
बजाय	bəd͡ʒäːj
ताड़	t̪äːɽ
अगवानी	əɡʋäːn̪iː
कूड़ा	kuːɽäː
दृष्टिपटल	d̪ɾɪʃʈɪpʈəl̪
हलाक	ɦəl̪äːk
ग़ोता	ɡoːt̪äː
नदियो	n̪əd̪ijoː
स्पेन	s̪pẽːn̪
उलझाना	ʊl̪d͡ʒʱäːn̪äː
आवृत्ति	äːʋɾɪt̪̚t̪iː
अवकलनीय	əʋkəl̪ən̪iːjᵊ
बिंदास	bɪ̃n̪d̪äːs̪
बर्लिन	bəɾl̪ɪ̃n̪
अंतरण	ə̃n̪t̪ɾə̃ɳ
अनुरक्षण	ən̪ʊɾəkʃə̃ɳ
अभ्यासवश	əbʱjäːs̪ʋəʃ
थूकना	t̪ʰuːkn̪äː
जवाब	d͡ʒəʋäːb
कला	kəl̪äː
दंदान	d̪ə̃n̪d̪ä̃ːn̪
मेहमान	meːɦmä̃ːn̪
कठिन	kəʈʰɪ̃n̪
ऋण	ɾɪ̃ɳ
लोटा	l̪oːʈäː
इसरार	ɪs̪ɾäːɾ
उलाहना	ʊl̪äːɦn̪äː
शिलांग	ʃɪl̪ä̃ːŋɡ
लौंडा	l̪ɔ̃ːɳɖäː
आत्मसात	äːt̪məs̪äːt̪
ऑस्ट्रेलिया	ɔs̪ʈɾeːl̪ijäː
पागलख़ाना	päːɡəl̪kʰäːn̪äː
होंडुरस	ɦõːɳɖʊɾəs̪
धन्य	d̪ʱə̃n̪jᵊ
क्रोएशिया	kɾoːeːʃijäː
ज़हरीली	d͡ʒɛɦɾiːl̪iː
बोली	boːl̪iː
समाज	s̪əmäːd͡ʒ
छाती	t͡ʃʰäːt̪iː
भुजा	bʱʊd͡ʒäː
तिलहन	t̪ɪl̪ɦə̃n̪
बेदख़ली	beːd̪əxl̪iː
पुतना	pʊt̪̚n̪äː
फिल्मी	fɪl̪miː
नुक़्ता	n̪ʊqt̪äː
दायी	d̪äːjiː
नारी	n̪äːɾiː
ख़ालिस	kʰäːl̪ɪs̪
तिलचट्टा	t̪ɪl̪t͡ʃəʈ̚ʈäː
यूनिवर्सिटी	juːn̪ɪʋəɾs̪ɪʈiː
तेईस	t̪eːiːs̪
भूसा	bʱuːs̪äː
नाग	n̪äːɡ
गुणसूत्रबिंदु	ɡʊ̃ɳs̪uːt̪ɾᵊbɪ̃n̪d̪uː
परिस्थिति	pəɾɪs̪t̪ʰɪt̪iː
सिंगापुर	s̪ɪ̃ŋɡäːpʊɾ
बम्बैया	bə̃mbə̯ijäː
रिश्तेदार	ɾɪʃt̪eːd̪äːɾ
बधिरता	bəd̪ʱɪɾt̪äː
अभ्यंग	əbʱjə̃ŋɡ
एस्पेरांतो	eːs̪peːɾä̃ːn̪t̪oː
पीपा	piːpäː
हमसफ़र	ɦə̃ms̪əfəɾ
फ़ना	pʰən̪äː
बेबाक़	beːbäːq
फक्कड़	pʰək̚kəɽ
बख़रा	bəkʰɾäː
तुल्य	t̪ʊl̪jᵊ
घमासान	ɡʱəmäːs̪ä̃ːn̪
वोल्गा	ʋoːl̪ɡäː
ग़ुसलख़ाना	ɡʊs̪əl̪kʰäːn̪äː
कामी	käːmiː
नहर	n̪ɛɦɛɾ
क़ाबिलीयत	käːbɪl̪iːjət̪
कनपटी	kə̃n̪pəʈiː
लेख	l̪eːkʰ
काल्पनिक	käːl̪pən̪ɪk
यतीमख़ाना	jət̪ĩːmkʰäːn̪äː
शहला	ʃɛɦl̪äː
सर्पिल	s̪əɾpɪl̪
आतमीयता	äːt̪miːjt̪äː
जीन	d͡ʒĩːn̪
फ़ौरन	pʰɔːɾə̃n̪
ब्याह	bjäːɦ
जानना	d͡ʒä̃ːn̪n̪äː
ग़ायब	ɣäːjəb
टुकड़ा	ʈʊkɽäː
सवाना	s̪əʋäːn̪äː
अंतर्देशीय	ə̃n̪t̪əɾd̪eːʃiːjᵊ
पेरिस	peːɾɪs̪
नंबर	n̪ə̃mbəɾ
मुंतज़िर	mʊ̃n̪t̪əd͡ʒɪɾ
अंग	ə̃ŋɡ
पूर्णबंदी	puːɾɳbə̃n̪d̪iː
संगठनात्मक	s̪ə̃ŋɡəʈʰən̪äːt̪mək
औजार	ɔːzäːɾ
ख़ानसामा	kʰä̃ːn̪s̪äːmäː
शुद्धगतिकी	ʃʊd̪̚d̪ʱəɡt̪ɪkiː
रासो	ɾäːs̪oː
सड़सठ	s̪əɽs̪əʈʰ
पादत्र	päːd̪ət̪ɾᵊ
नज़ारा	n̪əd͡ʒäːɾäː
साज़िश	s̪äːzɪʃ
प्याज	pjäːd͡ʒ
सूरिया	s̪uːɾijäː
राजकुमार	ɾäːd͡ʒkʊmäːɾ
बिस्तर	bɪs̪t̪əɾ
ने	n̪eː
शरियत	ʃəɾijət̪
ममनून	mə̃mn̪ũːn̪
अशान्ति	əʃä̃ːn̪t̪iː
हाउस	ɦäːʊs̪
सुग्गा	s̪ʊɡɡäː
ट्रंप	ʈɾə̃mp
ध्वनि	d̪ʱʋən̪iː
लहसुन	l̪ɛɦs̪ʊ̃n̪
अनूठा	ən̪uːʈʰäː
निशानेबाज़ी	n̪ɪʃäːn̪eːbäːd͡ʒiː
भीड़भाड़	bʱiːɽbʱäːɽ
ज़र्रा	zəɾɾäː
अनुनाद	ən̪ʊn̪äːd̪
ग़बन	ɡəbə̃n̪
प्रचारित	pɾət͡ʃäːɾɪt̪
एंड्रॉइड	ẽːɳɖɾɔɪɖ
उलझना	ʊl̪əd͡ʒʱn̪äː
पचासी	pət͡ʃäːs̪iː
चाप	t͡ʃäːp
छर्रा	t͡ʃʰəɾɾäː
शफ़ा	ʃəfäː
चीरना	t͡ʃiːɾn̪äː
समुदाय	s̪əmʊd̪äːj
छंद	t͡ʃʰə̃n̪d̪
नेकटाई	n̪eːkʈäːiː
असिस्टेंट	əs̪ɪs̪ʈẽːɳʈ
इम्तेहान	ɪ̃mt̪eːɦä̃ːn̪
विषकन्या	ʋɪʃkə̃n̪jäː
मूसा	muːs̪äː
ख़ुशमिज़ाज	kʰʊʃmɪd͡ʒäːd͡ʒ
व्यष्टि	ʋjəʃʈiː
अलंकृत	əl̪ə̃ŋkɾɪt̪
अक़्लमंद	əqəl̪mə̃n̪d̪
उम्मीदवार	ʊ̃mmiːd̪wäːɾ
भेषज	bʱeːʃəd͡ʒ
आषाढ़	äːʃäːɽʱ
दुकान	d̪ʊkä̃ːn̪
मनाना	mən̪äːn̪äː
निरंकुश	n̪ɪɾə̃ŋkʊʃ
उकसाना	ʊks̪äːn̪äː
आयुर्वेद	äːjʊɾʋeːd̪
तिरछा	t̪ɪɾt͡ʃʰäː
लैब	l̪ɛːb
विस्थापन	ʋɪs̪t̪ʰäːpə̃n̪
इंतज़ाम	ɪ̃n̪t̪əd͡ʒä̃ːm
शस्त्र	ʃəs̪t̪ɾᵊ
सफ़ेद	s̪əfeːd̪
ब्याज	bjäːd͡ʒ
साफ	s̪äːpʰ
सर्वेक्षण	s̪əɾʋeːkʃə̃ɳ
फिसलना	pʰɪs̪əl̪n̪äː
गुदा	ɡʊd̪äː
स्वदेशी	s̪ʋəd̪eːʃiː
वंशज	ʋə̃n̪ʃəd͡ʒ
फ़िनलैंड	fɪ̃n̪l̪ɛ̃ːɳɖ
जनाज़ा	d͡ʒən̪äːzäː
घुड़सवारी	ɡʱʊɽs̪əʋäːɾɪː
अयस्	əjəs̪
जज़ीरा	d͡ʒəd͡ʒiːɾäː
जनता	d͡ʒə̃n̪t̪äː
स्वार्थी	s̪ʋäːɾt̪ʰiː
चूतिया	t͡ʃuːt̪ijäː
बंटना	bə̃ɳʈn̪äː
युद्धकाल	jʊd̪̚d̪ʱkäːl̪
फायदा	pʰäːjd̪äː
कल्पनादर्श	kəl̪pən̪äːd̪əɾʃ
अभियोजक	əbʱijoːd͡ʒək
ज्वार	d͡ʒʋäːɾ
तकिया	t̪əkijäː
कैंची	qɛ̃ːn̪t͡ʃiː
गांव	ɡä̃ːmw
संहिता	s̪ə̃ɦɪt̪äː
क्रेमलिन	kɾẽːml̪ɪ̃n̪
आटिचोक	äːʈɪt͡ʃoːk
अंशतः	ə̃n̪ʃt̪əɦ
डोलना	ɖoːl̪n̪äː
याचिका	jäːt͡ʃɪkäː
सुनवाई	s̪ʊ̃n̪wäːiː
खटमल	kʰəʈməl̪
अन्दर	ə̃n̪d̪əɾ
चट्टान	t͡ʃəʈ̚ʈä̃ːn̪
टूर्नामेंट	ʈuːɾn̪äːmẽːɳʈ
शाबाशी	ʃäːbäːʃiː
बाक़ायदा	bäːkäːjd̪äː
सौम्य	s̪ɔ̃ːmjᵊ
चाकू	t͡ʃäːkuː
चिराग़	t͡ʃɪɾäːɣ
आसार	äːs̪äːɾ
बर्ख़ास्त	bəɾkʰäːs̪t̪
रंगीला	ɾə̃ŋɡiːl̪äː
ख़िताब	kʰɪt̪äːb
चरागाह	t͡ʃəɾäːɡäːɦ
नौका	n̪ɔːkäː
रज़ाकार	ɾəzäːkäːɾ
मारना	mäːɾn̪äː
आशिष	äːʃɪʃ
जमीन	d͡ʒəmĩːn̪
राजमार्ग	ɾäːd͡ʒmäːɾɡ
अनुसरण	ən̪ʊs̪əɾə̃ɳ
बेबाक़	beːbäːk
खलनायक	kʰəl̪n̪äːjək
संस्कृति	s̪ə̃n̪s̪kɾɪt̪iː
चबाना	t͡ʃəbäːn̪äː
अर्जेंटीना	əɾd͡ʒẽːɳʈiːn̪äː
रक़म	ɾəqə̃m
शयनागार	ʃəjn̪äːɡäːɾ
क़बूल	kəbuːl̪
परवल	pəɾʋəl̪
चमस	t͡ʃəməs̪
संन्यास	s̪ə̃n̪n̪jäːs̪
पेन्सिलवेनिया	pẽːn̪s̪ɪl̪ʋeːn̪ijäː
मज़लूम	məzl̪ũːm
उत्तोलन	ʊt̪̚t̪oːl̪ə̃n̪
बासठ	bäːs̪əʈʰ
रक़्क़ासा	ɾək̚käːs̪äː
आक्रमणकारी	äːkɾəmə̃ɳkäːɾiː
कर्ता	kəɾt̪äː
रईस	ɾəiːs̪
समसामयिक	s̪ə̃ms̪ä̃ːmjɪk
बरक़रार	bəɾkəɾäːɾ
कार्यकुशल	käːɾjəkʊʃəl̪
पालक	päːl̪ək
शाकाहारी	ʃäːkäːɦäːɾiː
दस्यु	d̪əs̪juː
अभिकारक	əbʱɪkäːɾək
सिलसिला	s̪ɪl̪s̪ɪl̪äː
चौराहा	t͡ʃɔːɾäːɦäː
इकहत्तर	ɪkɦət̪̚t̪əɾ
पतंगबाज़	pət̪ə̃ŋɡbäːd͡ʒ
माँस	mä̃ːs̪
माशूक़	mäːʃuːk
कज़ाख़स्तान	kəzäːxəs̪t̪ä̃ːn̪
स्थानीय	s̪t̪ʰäːn̪iːjᵊ
सलाउद्दीन	s̪əl̪äːʊd̪̚d̪ĩːn̪
लिफ़ाफ़ा	l̪ɪpʰäːpʰäː
अटपटा	əʈpəʈäː
वंशवाद	ʋə̃n̪ʃʋäːd̪
नाथ	n̪äːt̪ʰ
राजनयिक	ɾäːd͡ʒn̪əjɪk
परिसंपत्ति	pəɾɪs̪ə̃mpət̪̚t̪iː
उबालना	ʊbäːl̪n̪äː
सृजन	s̪ɾɪd͡ʒə̃n̪
मूल्यांकन	muːl̪jä̃ːkə̃n̪
मालिक	mäːl̪ɪk
अशुद्धि	əʃʊd̪̚d̪ʱiː
दूना	d̪uːn̪äː
कोपचा	koːpt͡ʃäː
बरसी	bəɾs̪iː
कसूर	kəs̪uːɾ
पदवी	pəd̪wiː
वार्ता	ʋäːɾt̪äː
दवाई	d̪əʋäːiː
नहीं	n̪əɦĩː
शब्दसूची	ʃəbd̪s̪uːt͡ʃiː
अख़बारवाला	əxbäːɾʋäːl̪äː
लथपथ	l̪ət̪ʰpət̪ʰ
कबड्डी	kəbəɖ̚ɖiː
महत्वाकांक्षा	mɛɦɛt̪wäːkä̃ːkʃäː
नापना	n̪äːpn̪äː
पीलापन	piːl̪äːpə̃n̪
सर्वोपरि	s̪əɾʋoːpəɾiː
नोट	n̪oːʈ
ख़ालिक़	xäːl̪ɪq
स्नानागार	s̪n̪äːn̪äːɡäːɾ
साथी	s̪äːt̪ʰiː
प्रतिध्वनि	pɾət̪ɪd̪ʱʋən̪iː
नवरत्न	n̪əʋɾət̪̚n̪ᵊ
ग्वालियर	ɡʋäːl̪ijəɾ
सेहतमंद	s̪eːɦət̪mə̃n̪d̪
मंगल	mə̃ŋɡəl̪
बखान	bəkʰä̃ːn̪
सतलुज	s̪ət̪l̪ʊd͡ʒ
गैस	ɡæs̪
प्रशासिक	pɾəʃäːs̪ɪk
पंजीकृत	pə̃n̪d͡ʒiːkɾɪt̪
सुप्रभात	s̪ʊpɾəbʱäːt̪
ख़फ़ा	xəfäː
थाली	t̪ʰäːl̪iː
फ़िराक़	fɪɾäːq
निरस्त	n̪ɪɾəs̪t̪
कलोर	kəl̪oːɾ
गुस्ताख़ी	ɡʊs̪t̪äːxiː
हाज़िरजवाबी	ɦäːd͡ʒɪɾd͡ʒəʋäːbiː
असुविधाजनक	əs̪ʊʋɪd̪ʱäːd͡ʒən̪ək
स्थित	s̪t̪ʰɪt̪
किरदार	kɪɾd̪äːɾ
लोग	l̪oːɡ
सम्पादक	s̪ə̃mpäːd̪ək
झोंपड़ा	d͡ʒʱõːmpɽäː
परिणामस्वरूप	pəɾɪɳä̃ːms̪ʋəɾuːp
आज़माइश	äːzmäːɪʃ
रूसी	ɾuːs̪iː
तस्वीर	t̪əs̪ʋiːɾ
आगार	äːɡäːɾ
औसतन	ɔːs̪t̪ə̃n̪
पौने	pɔːn̪eː
तक़ाज़ा	t̪əkäːd͡ʒäː
क़व्वाली	kəʋʋäːl̪iː
सम्मेलन	s̪ə̃mmeːl̪ə̃n̪
फ़ानी	fäːn̪iː
तकलीफ़	t̪əkl̪iːf
अत्याचार	ət̪jäːt͡ʃäːɾ
कॉपीराइट	kɔpiːɾäːɪʈ
छुरा	t͡ʃʰʊɾäː
चटगांव	t͡ʃəʈɡä̃ːmw
रसगुल्ला	ɾəs̪ɡʊl̪l̪äː
विशेषण	ʋɪʃeːʃə̃ɳ
मजमा	məd͡ʒmäː
स्यंदन	s̪jə̃n̪d̪ə̃n̪
सूडान	s̪uːɖä̃ːn̪
डीज़ल	ɖiːd͡ʒəl̪
छुपाना	t͡ʃʰʊpäːn̪äː
अनिश्चित	ən̪ɪʃt͡ʃɪt̪
पक्ष	pəkʃ
टेढ़ापन	ʈeːɽʱäːpə̃n̪
थैंक्स	t̪ʰɛ̃ːŋks̪
क्वार्टज़	kwäːɾʈz
चतुराई	t͡ʃət̪ʊɾäːiː
अपना	əpn̪äː
रेख़्ता	ɾeːkʰt̪äː
तनहाई	t̪ə̃n̪ɦäːiː
इंडस्ट्री	ɪ̃ɳɖəs̪ʈɾiː
निजी	n̪ɪd͡ʒiː
हर्षित	ɦəɾʃɪt̪
मुताबिक	mʊt̪äːbɪq
आँकड़ा	ä̃ːkɽäː
मसि	məs̪iː
मज़ा	məzäː
पीतस	piːt̪əs̪
पोलैंड	poːl̪ɛ̃ːɳɖ
ख़म	kʰə̃m
दिसंबर	d̪ɪs̪ə̃mbəɾ
कुकुरमुत्ता	kʊkʊɾmʊt̪̚t̪äː
कनपेड़	kə̃n̪peːɽ
तराज़ू	t̪əɾäːd͡ʒuː
मेला	meːl̪äː
कामुकता	käːmʊkt̪äː
निर्देशक	n̪ɪɾd̪eːʃək
बाहर	bäːɦəɾ
ख़याल	kʰəjäːl̪
मध्यावधि	məd̪ʱjäːʋəd̪ʱiː
दिशानिर्देश	d̪ɪʃäːn̪ɪɾd̪eːʃ
निहाई	n̪ɪɦäːiː
अक़्लमंद	əkəl̪mə̃n̪d̪
माँझी	mä̃ːn̪d͡ʒʱiː
गुलशन	ɡʊl̪ʃə̃n̪
कुतरना	kʊt̪əɾn̪äː
अँगूठी	ə̃ŋɡuːʈʰiː
सितम	s̪ɪt̪ə̃m
खँखड़	kʰə̃ŋkʰəɽ
चिपचिपा	t͡ʃɪpt͡ʃɪpäː
काठमांडू	käːʈʰmä̃ːɳɖuː
अंगना	ə̃ŋɡən̪äː
श्रामणेर	ʃɾä̃ːmɳeːɾ
फ़ीसद	fiːs̪əd̪
निरीक्षक	n̪ɪɾiːkʃək
लेकिन	l̪eːkɪ̃n̪
मरम्मत	məɾə̃mmət̪
दाहिने	d̪äːɦɪn̪eː
वाइटफ़ील्ड	ʋäːɪʈpʰiːl̪ɖ
कांति	kä̃ːn̪t̪iː
युवा	jʊʋäː
बिचला	bɪt͡ʃl̪äː
विकास	ʋɪkäːs̪
अँकवैया	ə̃ŋkwə̯ijäː
रोपना	ɾoːpn̪äː
मुस्तक़बिल	mʊs̪t̪əkbɪl̪
स्नेह	s̪n̪eːɦ
पछाँई	pət͡ʃʰä̃ːiː
नखलिस्तान	n̪əxl̪ɪs̪t̪ä̃ːn̪
बरतना	bəɾət̪̚n̪äː
ख़ैरात	xɛːɾäːt̪
धाकड़	d̪ʱäːkəɽ
दीवानगी	d̪iːʋä̃ːn̪ɡiː
पहचान	pɛɦt͡ʃä̃ːn̪
कूड़ेदान	kuːɽeːd̪ä̃ːn̪
लोकसभा	l̪oːkəs̪bʱäː
करनी	kəɾn̪iː
माफ़	mäːf
आयाम	äːjä̃ːm
वेदांत	ʋeːd̪ä̃ːn̪t̪
विज़ारत	ʋɪzäːɾət̪
इस्तक़बाल	ɪs̪t̪əkbäːl̪
विवाह	ʋɪʋäːɦ
समझदार	s̪əməd͡ʒʱd̪äːɾ
उमा	ʊmäː
अनुमेय	ən̪ʊmeːj
स्वजन	s̪ʋəd͡ʒə̃n̪
अलोना	əl̪oːn̪äː
सख़्ती	s̪əxt̪iː
तस्दीक़	t̪əs̪d̪iːq
कुत्ती	kʊt̪̚t̪iː
डाक	ɖäːk
नाख़ून	n̪äːkʰũːn̪
फ़्लोरिडा	fl̪oːɾɪɖäː
राष्ट्रीय	ɾäːʃʈɾiːjᵊ
प्रश्नोत्तर	pɾəʃn̪oːt̪̚t̪əɾ
वारदात	ʋäːɾd̪äːt̪
वली	ʋəl̪iː
भ्राता	bʱɾäːt̪äː
बेगम	beːɡə̃m
प्रधानाचार्य	pɾəd̪ʱäːn̪äːt͡ʃäːɾjᵊ
मूंग	mũːŋɡ
प्रतापी	pɾət̪äːpiː
ख्वाब	kʰʋäːb
नफ़रत	n̪əfɾət̪
डाक्टर	ɖäːkʈəɾ
इस्टाम	ɪs̪ʈä̃ːm
फ़ैज़ाबाद	fɛːzäːbäːd̪
गांसू	ɡä̃ːn̪s̪uː
श्रीफल	ʃɾiːpʰəl̪
उपसचिव	ʊpəs̪t͡ʃɪʋ
क़िला	qɪl̪äː
नुस्खा	n̪ʊs̪xäː
सुनाई	s̪ʊn̪äːiː
सिगार	s̪ɪɡäːɾ
राजत्व	ɾäːd͡ʒət̪wᵊ
आश्चर्य	äːʃt͡ʃəɾjᵊ
टिकना	ʈɪkn̪äː
तक़सीम	t̪əqs̪ĩːm
पुलिसकर्मी	pʊl̪ɪs̪kəɾmiː
अफ़्ग़ानिस्तान	əpʰɡäːn̪ɪs̪t̪ä̃ːn̪
महज़	mɛɦɛd͡ʒ
भावनगर	bʱäːʋn̪əɡəɾ
चमकदार	t͡ʃəməkd̪äːɾ
उत्साह	ʊt̪s̪äːɦ
हिमालय	ɦɪmɑːləj
पंख	pə̃ŋkʰ
कम	kə̃m
सहसंयोजक	s̪ɛɦs̪ə̃joːd͡ʒək
थमाना	t̪ʰəmäːn̪äː
प्रयोगशाला	pɾəjoːɡʃäːl̪äː
पादत्राण	päːd̪ət̪ɾä̃ːɳ
आत्मीय	äːt̪miːjᵊ
अज्ञात	əɡjäːt̪
सज़ा	s̪əzäː
निक़ाब	n̪ɪkäːb
उँडेलना	ʊ̃ɳɖeːl̪n̪äː
धूल	d̪ʱuːl̪
विकिमीडिया	ʋɪkɪmiːɖijäː
असुंदर	əsʊ̃n̪d̪əɾ
चायख़ाना	t͡ʃäːjxäːn̪äː
अलगाना	əl̪ɡäːn̪äː
इलाक़ा	ɪl̪äːqäː
आयोजन	äːjoːd͡ʒə̃n̪
पिस्ता	pɪs̪t̪äː
बोलिविया	boːl̪ɪʋijäː
जैसा	d͡ʒɛːs̪äː
गलसुआ	ɡəl̪s̪ʊäː
अर्पण	əɾpə̃ɳ
आक्रोश	äːkɾoːʃ
अनुशासन	ən̪ʊʃäːs̪ə̃n̪
कार्यसूची	käːɾjəs̪uːt͡ʃiː
हितकारी	ɦɪt̪käːɾiː
महाप्रभु	məɦäːpɾəbʱuː
आहिस्ता	äːɦɪs̪t̪äː
जड़त्व	d͡ʒəɽət̪wᵊ
कागज़	käːɡəd͡ʒ
यूनानी	juːn̪äːn̪iː
टापू	ʈäːpuː
मनस्विता	mən̪əs̪ʋɪt̪äː
अस्तित्व	əs̪t̪ɪt̪wᵊ
खाँसी	kʰä̃ːs̪iː
आघ	äːɡʱ
कालापन	käːl̪äːpə̃n̪
स्थिर	s̪t̪ʰɪɾ
चाइना	t͡ʃäːɪn̪äː
ढोटा	ɖʱoːʈäː
कैंची	kɛ̃ːn̪t͡ʃiː
अनियंत्रित	ən̪ijə̃n̪t̪ɾɪt̪
दादी	d̪äːd̪iː
खाँसना	kʰä̃ːs̪n̪äː
संस्था	s̪ə̃n̪s̪t̪ʰäː
आण्विक	ä̃ːɳwɪk
त्वरित	t̪wəɾɪt̪
ज़ेहन	d͡ʒɛɦɛ̃n̪
आफ़्रीदी	äːfɾiːd̪iː
निम्नलिखित	n̪ɪ̃mn̪əl̪ɪkʰɪt̪
भांजी	bʱä̃ːn̪d͡ʒiː
बेगाना	beːɡäːn̪äː
लौड़ा	l̪ɔːɽäː
पंगु	pə̃ŋɡuː
हाज़िर	ɦäːzɪɾ
चिलम	t͡ʃɪl̪ə̃m
आस्था	äːs̪t̪ʰäː
क़ातिल	qäːt̪ɪl̪
शिक्षा	ʃɪkʃäː
लिपि	l̪ɪpiː
फ़तवा	fət̪wäː
टंकण	ʈə̃ŋkə̃ɳ
कांसा	kä̃ːn̪s̪äː
लाड़काना	l̪äːɽkäːn̪äː
मिसरी	mɪs̪ɾiː
चोला	t͡ʃoːl̪äː
गाजर	ɡäːd͡ʒəɾ
महज़	mɛɦɛz
नस	n̪əs̪
तौलिया	t̪ɔːl̪ijäː
स्टेडियम	s̪ʈeːɖijə̃m
निराश	n̪ɪɾäːʃ
रावलपिंडी	ɾäːʋəl̪pɪ̃ɳɖiː
रेखा	ɾeːkʰäː
भिंडी	bʱɪ̃ɳɖiː
रुझान	ɾʊd͡ʒʱä̃ːn̪
क्रियाकलाप	kɾijäːkəl̪äːp
स्वकीया	s̪ʋəkiːjäː
अनियमितता	ən̪ijəmɪt̪̚t̪äː
चंद्रिका	t͡ʃə̃n̪d̪ɾɪkäː
ब्योंत	bjõːn̪t̪
तल्ख़	t̪əl̪x
असंवैधानिक	əs̪ə̃mwɛːd̪ʱäːn̪ɪk
हल्क़ा	ɦəl̪qäː
आवक	äːʋək
त्रिकोणमितीय	t̪ɾɪkõːɳmɪt̪iːjᵊ
रेज़गारी	ɾeːzɡäːɾiː
सूतिका	s̪uːt̪ɪkäː
सामान्यीकृत	s̪äːmä̃ːn̪jiːkɾɪt̪
प्राप्य	pɾäːpjᵊ
सरदी	s̪əɾd̪iː
औलाद	ɔːl̪äːd̪
पसार	pəs̪äːɾ
मक़बूल	məqbuːl̪
खलासी	xəl̪äːs̪iː
मांस	mä̃ːn̪s̪
सुलझा	s̪ʊl̪d͡ʒʱäː
डरबन	ɖəɾbə̃n̪
कलसा	kəl̪s̪äː
संवेदनशील	s̪ə̃mweːd̪ə̃n̪ʃiːl̪
समिति	s̪əmɪt̪iː
शौक़ीन	ʃɔːkĩːn̪
पृष्ठभूमि	pɾɪʃʈʰbʱuːmiː
चॉकलेट	t͡ʃɔkl̪eːʈ
घाट	ɡʱäːʈ
नेत्री	n̪eːt̪ɾiː
चिंगारी	t͡ʃɪ̃ŋɡäːɾiː
अंतरिक्ष	ə̃n̪t̪ɾɪkʃ
संगीत	s̪ə̃ŋɡiːt̪
खांसना	kʰä̃ːn̪s̪n̪äː
कर्तृत्व	kəɾt̪ɾɪt̪wᵊ
घुँघरू	ɡʱʊ̃ŋɡʱɾuː
सोवियत	s̪oːʋijət̪
उपधान	ʊpd̪ʱä̃ːn̪
ऑस्ट्रिया	ɔs̪ʈɾijäː
बेनतीजा	beːn̪ət̪iːd͡ʒäː
मुर्ग़ा	mʊɾɡäː
महा	məɦäː
बाप्तिस्मा	bäːpt̪ɪs̪mäː
ख़याल	xəjäːl̪
बालपन	bäːl̪pə̃n̪
अनुमोदन	ən̪ʊmoːd̪ə̃n̪
शून्य	ʃũːn̪jə
बगावत	bəɡäːʋət̪
सिरा	s̪ɪɾäː
शिफ़ा	ʃɪpʰäː
विहीन	ʋɪɦĩːn̪
ठहाका	ʈʰəɦäːkäː
था	t̪ʰäː
लाइसेंस	l̪äːɪs̪ẽːn̪s̪
बहादुर	bəɦäːd̪ʊɾ
जासूस	d͡ʒäːs̪uːs̪
जँभाई	d͡ʒə̃mbʱäːiː
विंदालू	ʋɪ̃n̪d̪äːl̪uː
उंडुक	ʊ̃ɳɖʊk
कामिल	käːmɪl̪
कटाक्ष	kəʈäːkʃ
ठाणे	ʈʰäːɳeː
मुखमैथुन	mʊkʰmɛːt̪ʰʊ̃n̪
रहनुमा	ɾɛɦn̪ʊmäː
सेना	s̪eːn̪äː
पुण्यतिथि	pʊ̃ɳjət̪ɪt̪ʰiː
साबिक़	s̪äːbɪq
स्वराक्षर	s̪ʋəɾäːkʃəɾ
घूँघट	ɡʱũːŋɡʱəʈ
तहरी	t̪ɛɦɾiː
विशाखपट्नम	ʋɪʃäːkʰpəʈn̪ə̃m
भंडा	bʱə̃ɳɖäː
आफ़रीन	äːfɾĩːn̪
नक़द	n̪əqəd̪
हिंदुस्तान	ɦɪ̃n̪d̪ʊs̪t̪ä̃ːn̪
नियंत्रित	n̪ijə̃n̪t̪ɾɪt̪
अंजाम	ə̃n̪d͡ʒä̃ːm
फीका	pʰiːkäː
नालायक	n̪äːl̪äːjək
लगे	l̪əɡeː
अनामिका	ən̪äːmɪkäː
असुविधा	əs̪ʊʋɪd̪ʱäː
कारख़ाना	käːɾkʰäːn̪äː
वर्ष	ʋəɾʃ
शिकारा	ʃɪkäːɾäː
विषयासक्त	ʋɪʃəjäːs̪əkt̪
आपूर्ति	äːpuːɾt̪iː
नीला	n̪iːl̪äː
अगुआ	əɡʊäː
दादरा	d̪äːd̪ɾäː
आकाश	äːkäːʃ
हीरा	ɦiːɾäː
ग़ुस्ल	ɡʊs̪l̪
कुलधर्म	kʊl̪d̪ʱəɾm
चायदानी	t͡ʃäːjd̪äːn̪iː
दूरीकरण	d̪uːɾiːkəɾə̃ɳ
ग़ायब	ɡäːjəb
कंधा	kə̃n̪d̪ʱäː
मीचना	miːt͡ʃn̪äː
ईजियन	iːd͡ʒijə̃n̪
खिलाना	kʰɪl̪äːn̪äː
निभाना	n̪ɪbʱäːn̪äː
अस्वाभाविक	əs̪ʋäːbʱäːʋɪk
ज़ख़ीरा	d͡ʒəkʰiːɾäː
आदि	äːd̪iː
आंसू	ä̃ːn̪s̪uː
टिंडा	ʈɪ̃ɳɖäː
ताल्लुक़	t̪äːl̪l̪ʊq
अध्याय	əd̪ʱjäːj
कठिनता	kəʈʰɪ̃n̪t̪äː
इंद्रनाथ	ɪ̃n̪d̪ɾən̪äːt̪ʰ
बुधवार	bʊd̪ʱʋäːɾ
मौसा	mɔːs̪äː
ज़कात	zəkäːt̪
संसाधन	s̪ə̃n̪s̪äːd̪ʱə̃n̪
अन्यायपूर्ण	ə̃n̪jäːjpuːɾɳ
पगली	pəɡl̪iː
मुहाफ़ज़ाह	mʊɦäːpʰd͡ʒäːɦ
दौड़ाना	d̪ɔːɽäːn̪äː
नयन	n̪əjə̃n̪
अंधड़	ə̃n̪d̪ʱəɽ
क़ाबिज़	qäːbɪz
अम्बर	ə̃mbəɾ
अँगरेज़	ə̃ŋɡɾeːd͡ʒ
भरोसा	bʱəɾoːs̪äː
प्रारंभिक	pɾäːɾə̃mbʱɪk
बढ़ाना	bəɽʱäːn̪äː
संदर्भ	s̪ə̃n̪d̪əɾbʱ
बंजारा	bə̃n̪d͡ʒäːɾäː
कहर	qɛɦɛɾ
सेविका	s̪eːʋɪkäː
सहेली	s̪əɦeːl̪iː
इंडिया	ɪ̃ɳɖijäː
पेंशन	pẽːn̪ʃə̃n̪
जिसको	d͡ʒɪs̪koː
घुंडी	ɡʱʊ̃ɳɖiː
बैठकबाज़	bɛːʈʰəkbäːd͡ʒ
गंभीर	ɡə̃mbʱiːɾ
प्लीज़	pl̪iːd͡ʒ
इफ़्तिताह	ɪpʰt̪ɪt̪äːɦ
अनशन	ə̃n̪ʃə̃n̪
मतदाता	mət̪̚d̪äːt̪äː
उन्माद	ʊ̃n̪mäːd̪
अंतर्वासी	ə̃n̪t̪əɾʋäːs̪iː
दम	d̪ə̃m
व्यापक	ʋjäːpək
सास	s̪äːs̪
छिलका	t͡ʃʰɪl̪käː
भूगोल	bʱuːɡoːl̪
ताक़तवर	t̪äːkət̪wəɾ
बजरंगबली	bəd͡ʒɾə̃ŋɡəbl̪iː
पहचानकर्ता	pɛɦt͡ʃä̃ːn̪kəɾt̪äː
मअनी	mäːn̪iː
मुख्यधारा	mʊkʰjəd̪ʱäːɾäː
अँतड़ी	ə̃n̪t̪ɽiː
मज़ा	məd͡ʒäː
ज़मीन	d͡ʒəmĩːn̪
ज्ञानी	ɡjäːn̪iː
बहराइच	bɛɦɾäːɪt͡ʃ
चुंबकीय	t͡ʃʊ̃mbəkiːjᵊ
एजेंसी	eːd͡ʒẽːn̪s̪iː
कमज़ोर	kə̃md͡ʒoːɾ
सराबोर	s̪əɾäːboːɾ
वाद्ययंत्र	ʋäːd̪jəjə̃n̪t̪ɾᵊ
दरवाज़ा	d̪əɾʋäːzäː
ब्राज़िल	bɾäːd͡ʒɪl̪
समर्थन	s̪əməɾt̪ʰə̃n̪
सिक्का	s̪ɪk̚käː
लौंग	l̪ɔ̃ːŋɡ
छाई	t͡ʃʰäːiː
क़ासिद	qäːs̪ɪd̪
सांडा	s̪ä̃ːɳɖäː
अंकगणित	ə̃ŋkɡəɳɪt̪
सजावटी	s̪əd͡ʒäːʋʈiː
बसेरा	bəs̪eːɾäː
भरोसेमंद	bʱəɾoːs̪eːmə̃n̪d̪
दफ़न	d̪əfn̪
सिंचाई	s̪ɪ̃n̪t͡ʃäːiː
राइफ़ल	ɾäːɪfəl̪
गांधीगिरी	ɡä̃ːn̪d̪ʱiːɡɪɾiː
अकादमिक	əkäːd̪mɪk
कुसूर	qʊs̪uːɾ
मजमून	məzmũːn̪
इमारत	ɪmäːɾət̪
हरिस	ɦəɾɪs̪
हर्ष	ɦəɾʃ
स्थगित	s̪t̪ʰəɡɪt̪
ठहरना	ʈʰɛɦɛɾn̪äː
छोग्याल	t͡ʃʰoːɡjäːl̪
सप्तक	s̪əpt̪ək
वरुण	ʋəɾʊ̃ɳ
पायदान	päːjd̪ä̃ːn̪
संरचना	s̪ə̃ɾət͡ʃn̪äː
आवाज	äːʋäːz
ताशकंद	t̪äːʃkə̃n̪d̪
माजरा	mäːd͡ʒɾäː
अन्तर्गत	ə̃n̪t̪əɾɡət̪
विभाजन	ʋɪbʱäːd͡ʒə̃n̪
हल्का	ɦəl̪käː
मुदाख़लत	mʊd̪äːkʰəl̪ət̪
काफ़ी	käːpʰiː
चकाचौंध	t͡ʃəkäːt͡ʃɔ̃ːn̪d̪ʱ
ज़ुकाम	d͡ʒʊkä̃ːm
होनेवाली	ɦoːn̪eːʋäːl̪iː
विद्यार्थी	ʋɪd̪jäːɾt̪ʰiː
जलचालित	d͡ʒəl̪t͡ʃäːl̪ɪt̪
नृत्त	n̪ɾɪt̪t̪
शख़्सियत	ʃəkʰs̪ijət̪
फाड़ी	pʰäːɽiː
अनुप्रास	ən̪ʊpɾäːs̪
बंबा	bə̃mbäː
इंच	ɪ̃n̪t͡ʃ
ग्रंथकार	ɡɾə̃n̪t̪ʰkäːɾ
रौशनी	ɾɔːʃn̪iː
अव्वल	əʋʋəl̪
अफगानिस्तान	əfɣäːn̪ɪs̪t̪ä̃ːn̪
उंचाई	ʊ̃n̪t͡ʃäːiː
मयस्सर	məjəs̪s̪əɾ
पारी	päːɾiː
कसरत	kəs̪ɾət̪
सरीसृप	s̪əɾiːs̪ɾɪp
शिकंजी	ʃɪkə̃n̪d͡ʒiː
पंचायत	pə̃n̪t͡ʃäːjət̪
तलब	t̪əl̪əb
सुबह	s̪ʊbʱə
आयोजित	äːjoːd͡ʒɪt̪
गली	ɡəl̪iː
सार्थक	s̪äːɾt̪ʰək
इनसाफ़	ɪ̃n̪s̪äːpʰ
माह	mäːɦ
जिनका	d͡ʒɪ̃n̪käː
बेड़ा	beːɽäː
उपभाषा	ʊpəbʱäːʃäː
आसन	äːs̪ə̃n̪
निहत्था	n̪ɪɦət̪̚t̪ʰäː
भूमंडल	bʱuːmə̃ɳɖəl̪
संवाददाता	s̪ə̃mwäːd̪̚d̪äːt̪äː
रक़्स	ɾəks̪
नाइनसाफ़ी	n̪äːɪ̃n̪s̪äːpʰiː
हिंदुस्तानी	ɦɪ̃n̪d̪ʊs̪t̪äːn̪iː
आधुनिकीकरण	äːd̪ʱʊn̪ɪkiːkəɾə̃ɳ
बाक़ी	bäːkiː
पचानवे	pət͡ʃä̃ːn̪weː
नवीन	n̪əviːn̪
मॉरीतानिया	mɔɾiːt̪äːn̪ijäː
अनाधिकारिक	ən̪äːd̪ʱɪkäːɾɪk
खलिहान	kʰəl̪ɪɦä̃ːn̪
ख़ूबसूरत	kʰuːbs̪uːɾət̪
दूरभाष	d̪uːɾbʱäːʃ
सीनेट	s̪iːn̪eːʈ
हेज़लनट	ɦeːd͡ʒəl̪n̪əʈ
अंबा	ə̃mbäː
चुलबुल	t͡ʃʊl̪bʊl̪
इज़ाफ़ा	ɪzäːfäː
अमरावती	ə̃mɾäːʋət̪iː
सकल	s̪əkəl̪
अखिल	əkʰɪl̪
उम्दा	ʊ̃md̪äː
मूर्खता	muːɾkʰət̪äː
सक्त	s̪əkt̪
शिनाख़्त	ʃɪn̪äːkʰt̪
नौसिखिया	n̪ɔːs̪ɪkʰijäː
इंतक़ाम	ɪ̃n̪t̪əqä̃ːm
तबाशीर	t̪əbäːʃiːɾ
उल्का	ʊl̪käː
भूस्खलन	bʱuːs̪kʰəl̪ə̃n̪
लोकनृत्य	l̪oːkn̪ɾɪt̪jᵊ
गाँधी	ɡä̃ːn̪d̪ʱiː
इस्पात	ɪs̪päːt̪
अवाम	əʋä̃ːm
भाषाविज्ञान	bʱäːʃäːʋɪɡjä̃ːn̪
अलापना	əl̪äːpn̪äː
इंक़लाब	ɪ̃n̪kəl̪äːb
सर	s̪əɾ
कायर	käːjəɾ
प्रतिमाह	pɾət̪ɪmäːɦ
आत्मिक	äːt̪mɪk
विनीत	ʋɪn̪iːt̪
धोखा	d̪ʱoːkʰäː
सहचर	s̪ɛɦt͡ʃəɾ
उसांस	ʊs̪ä̃ːs̪
अहिंसक	əɦɪ̃n̪s̪ək
सहायता	s̪əɦäːjt̪äː
अभियांत्रिकी	əbʱijä̃ːn̪t̪ɾɪkiː
मास्क	mäːs̪k
दुश्वार	d̪ʊʃʋäːɾ
खीसा	kʰiːs̪äː
एस्पेरान्तो	eːs̪peːɾä̃ːn̪t̪oː
रेल	ɾeːl̪
इकानवे	ɪkä̃ːn̪weː
नमश्कार	n̪əməʃkäːɾ
नमाज़	n̪əmäːz
सुंदरता	s̪ʊ̃n̪d̪əɾt̪äː
प्रतिफल	pɾət̪ɪpʰəl̪
संवत्सर	s̪ə̃mwət̪s̪əɾ
नेत्र	n̪eːt̪ɾ
जिना	zɪn̪äː
खुलकर	kʰʊl̪kəɾ
फलना	pʰəl̪n̪äː
आड़ा	äːɽäː
पाटन	päːʈə̃n̪
दुअन्नी	d̪ʊə̃n̪n̪iː
फ़िरंग	pʰɪɾə̃ŋɡ
प्रदूषण	pɾəd̪uːʃə̃ɳ
हिया	ɦijäː
क्लास	kl̪äːs̪
छिड़काव	t͡ʃʰɪɽkäːʋ
काबुल	käːbʊl̪
सुनार	s̪ʊn̪äːɾ
उपलब्धि	ʊpl̪əbd̪ʱiː
शुष्क	ʃʊʃk
बाख़ुदा	bäːkʰʊd̪äː
प्रेम	pɾẽːm
मस्जिद	məs̪d͡ʒɪd̪
बुझाना	bʊd͡ʒʱäːn̪äː
गिरजाघर	ɡɪɾd͡ʒäːɡʱəɾ
स्थापित	s̪t̪ʰäːpɪt̪
सरीखा	s̪əɾiːkʰäː
अज़ीम	əzĩːm
संदेश	s̪ə̃n̪d̪eːʃ
ख़ुशहाल	xʊʃɦäːl̪
धँसना	d̪ʱə̃s̪n̪äː
वासुदेव	ʋäːs̪ʊd̪eːʋ
जनकपुर	d͡ʒən̪əkpʊɾ
चाबी	t͡ʃäːbiː
अल्लाह	əl̪l̪äːɦ
तमग़ा	t̪ə̃mɡäː
बन्दूक़	bə̃n̪d̪uːq
आर्यन	äːɾjə̃n̪
ख़िदमतगार	xɪd̪mət̪ɡäːɾ
गोष्ठी	ɡoːʃʈʰiː
जनपद	d͡ʒə̃n̪pəd̪
अछूता	ət͡ʃʰuːt̪äː
नफ़रत	n̪əpʰɾət̪
साहूकार	s̪äːɦuːkäːɾ
पलक	pəl̪ək
एलची	eːl̪t͡ʃiː
डकार	ɖəkäːɾ
राजकुमारी	ɾäːd͡ʒkʊmäːɾiː
सलहज	s̪əl̪ɛɦɛd͡ʒ
सरसठ	s̪əɾs̪əʈʰ
ख़्वाजा	xʋäːd͡ʒäː
परेशानी	pəɾeːʃäːn̪iː
किन	kɪ̃n̪
जनजाति	d͡ʒə̃n̪d͡ʒäːt̪iː
गड़बड़झाला	ɡəɽbəɽd͡ʒʱäːl̪äː
पानी	päːn̪iː
अगरबत्ती	əɡəɾbət̪̚t̪iː
महताब	mɛɦt̪äːb
कार्यालय	käːɾjäːl̪əj
अलीगढ़	əl̪iːɡəɽʱ
पिसाई	pɪs̪äːiː
निषेचन	n̪ɪʃeːt͡ʃə̃n̪
उपनिर्देशक	ʊpn̪ɪɾd̪eːʃək
हिरासत	ɦɪɾäːs̪ət̪
पहर	pɛɦɛɾ
सरूर	s̪əɾuːɾ
शब्दावली	ʃəbd̪äːʋl̪iː
मंडप	mə̃ɳɖəp
फेंकना	pʰẽːŋkn̪äː
बख़ील	bəxiːl̪
कार्गो	käːɾɡoː
अज़रबैजान	əzəɾbɛːd͡ʒä̃ːn̪
फंदा	pʰə̃n̪d̪äː
स्टेटस	s̪ʈeːʈəs̪
चन्द्र	t͡ʃə̃n̪d̪ɾᵊ
लोभ	l̪oːbʱ
गोड़ना	ɡoːɽn̪äː
क्या	kjäː
नामांकन	n̪äːmä̃ːkə̃n̪
क़िस्त	kɪs̪t̪
जमाख़ोरी	d͡ʒəmäːkʰoːɾiː
यिर्मियाह	jɪɾmijäːɦ
जहाज	d͡ʒəɦäːz
इज़्ज़त	ɪd̚d͡ʒət̪
तेरह	t̪eːɾäː
तीरंदाज़ी	t̪iːɾə̃n̪d̪äːziː
जाँबाज़	d͡ʒä̃ːmbäːd͡ʒ
अगिन	əɡɪ̃n̪
बदतरीन	bəd̪̚t̪əɾĩːn̪
आरोप	äːɾoːp
क़स्बा	qəs̪bäː
हिमाक़त	ɦɪmäːqət̪
उपजना	ʊpəd͡ʒn̪äː
गर्म	ɡəɾə̃m
थर्राना	t̪ʰəɾɾäːn̪äː
रोज़गार	ɾoːzɡäːɾ
शहज़ादी	ʃɛɦd͡ʒäːd̪iː
स्वीकारना	s̪ʋiːkäːɾn̪äː
कठमुल्ला	kəʈʰmʊl̪l̪äː
बंदूक़	bə̃n̪d̪uːq
अश्लील	əʃl̪iːl̪
हितैषी	ɦɪt̪ɛːʃiː
उज़्बेकिस्तान	ʊzbeːkɪs̪t̪ä̃ːn̪
कुआँ	kʊä̃ː
रियायत	ɾijäːjət̪
छेना	t͡ʃʰeːn̪äː
नौसेना	n̪ɔːs̪eːn̪äː
अराजकवादी	əɾäːd͡ʒəkwäːd̪iː
वास्तु	ʋäːs̪t̪uː
व्हेल	ʋɦeːl̪
सवेरा	s̪əʋeːɾäː
सौर	s̪ɔːɾ
विराटनगर	ʋɪɾäːʈn̪əɡəɾ
नीड़ज	n̪iːɽəd͡ʒ
बन	bə̃n̪
पीन	pĩːn̪
संकल्प	s̪ə̃ŋkəl̪p
दूरबीन	d̪uːɾbĩːn̪
कितने	kɪt̪̚n̪eː
स्वकीय	s̪ʋəkiːjᵊ
दर्दनाक	d̪əɾd̪̚n̪äːk
मशीनरी	məʃĩːn̪ɾiː
डिमांड	ɖɪmä̃ːɳɖ
सेवक	s̪eːʋək
संतुलन	s̪ə̃n̪t̪ʊl̪ə̃n̪
लेनिनवाद	l̪eːn̪ɪ̃n̪wäːd̪
जैतून	d͡ʒɛːt̪ũːn̪
झा	d͡ʒʱäː
प्रोटीन	pɾoːʈĩːn̪
रस्सी	ɾəs̪s̪iː
व्याख्यान	ʋjäːkʰjä̃ːn̪
ख़मियाज़ा	kʰəmijäːd͡ʒäː
अवधारणा	əʋd̪ʱäːɾɳäː
स्तूप	s̪t̪uːp
शीर्ष	ʃiːɾʃ
लोकनायक	l̪oːkn̪äːjək
यथाक्रम	jət̪ʰäːkɾə̃m
बल्लेबाज़	bəl̪l̪eːbäːd͡ʒ
जलाऊ	d͡ʒəl̪äːuː
थापना	t̪ʰäːpn̪äː
नागरिक	n̪äːɡɾɪk
क़स्बा	kəs̪bäː
निसार	n̪ɪs̪äːɾ
समयसारिणी	s̪əməjs̪äːɾɪɳiː
साप्ताहिक	s̪äːpt̪äːɦɪk
अधिनियम	əd̪ʱɪn̪ijə̃m
बूंद	bũːn̪d̪
छोड़ना	t͡ʃʰoːɽn̪äː
रंगमंच	ɾə̃ŋɡmə̃n̪t͡ʃ
चव्वन	t͡ʃəʋʋə̃n̪
महल	mɛɦɛl̪
तंबाकु	t̪ə̃mbäːkuː
उमस	ʊməs̪
सभा	s̪əbʱäː
वंटन	ʋə̃ɳʈə̃n̪
मानसिक	mä̃ːn̪s̪ɪk
महमूद	mɛɦmuːd̪
अनाम	ən̪ä̃ːm
जमशेदपुर	d͡ʒə̃mʃeːd̪pʊɾ
शिल्प	ʃɪl̪p
कर्मचारी	kəɾmət͡ʃäːɾiː
ब्रह्म	bɾɛɦmᵊ
सब	s̪əb
छाछ	t͡ʃʰäːt͡ʃʰ
ख़िताब	xɪt̪äːb
ख़ानसामा	xä̃ːn̪s̪äːmäː
राजनीति	ɾäːd͡ʒn̪iːt̪iː
भाई	bʱäːiː
ख़ामी	kʰäːmiː
संवर्धन	s̪ə̃mwəɾd̪ʱə̃n̪
अकाज	əkäːd͡ʒ
बुलंद	bʊl̪ə̃n̪d̪
मचलना	mət͡ʃəl̪n̪äː
भीगा	bʱiːɡäː
सर्द	s̪əɾd̪
विना	ʋɪn̪äː
सौंफ	s̪ɔ̃ːmpʰ
ँ	ə̃
तमाचा	t̪əmäːt͡ʃäː
कुप्पी	kʊp̚piː
धर्मपरायण	d̪ʱəɾmpəɾäːjə̃ɳ
आग़ोश	äːɣoːʃ
रेज़गारी	ɾeːd͡ʒɡäːɾiː
छोले	t͡ʃʰoːl̪eː
पेशाब	peːʃäːb
पुट्ठा	pʊʈ̚ʈʰäː
ढेला	ɖʱeːl̪äː
नाच	n̪äːt͡ʃ
स्नेही	s̪n̪eːɦiː
कठघरा	kəʈʰɡʱəɾäː
जुताई	d͡ʒʊt̪äːiː
लाजवर्द	l̪äːd͡ʒʋəɾd̪
कक्ष	kəkʃ
अनुयायी	ən̪ʊjäːjiː
बिछना	bɪt͡ʃʰn̪äː
अभियंत्रण	əbʱijə̃n̪t̪ɾə̃ɳ
झेलना	d͡ʒʱeːl̪n̪äː
शासनहीनता	ʃäːs̪ə̃n̪ɦiːn̪ət̪äː
अधूरा	əd̪ʱuːɾäː
असहयोग	əs̪ɛɦjoːɡ
इंतख़ाब	ɪ̃n̪t̪əxäːb
टिण्डा	ʈɪ̃ɳɖäː
बत्तख	bət̪̚t̪əkʰ
नीति	n̪iːt̪iː
सामान	s̪äːmä̃ːn̪
घातीय	ɡʱäːt̪iːjᵊ
जोर्जिया	d͡ʒoːɾd͡ʒijäː
क़द्दावर	kəd̪̚d̪äːʋəɾ
छापामार	t͡ʃʰäːpäːmäːɾ
नानस	n̪äːn̪əs̪
अभिमानी	əbʱɪmäːn̪iː
बिस्मिल्ला	bɪs̪mɪl̪l̪äː
विक्रम	ʋɪkɾə̃m
नायब	n̪äːjəb
विशेषज्ञ	ʋɪʃeːʃəɡj
राष्ट्रवाद	ɾäːʃʈɾəʋäːd̪
आठ	äːʈʰ
केपटाउन	keːpʈäːʊ̃n̪
आग़ा	äːɡäː
बदतमीज़	bəd̪̚t̪əmiːz
निष्क्रिय	n̪ɪʃkɾɪj
घृणास्पद	ɡʱɾɪɳäːs̪pəd̪
मोमबत्ती	mõːmbət̪̚t̪iː
कल्पना	kəl̪pən̪äː
रक्तपात	ɾəkt̪päːt̪
मौसंबी	mɔːs̪ə̃mbiː
आपा	äːpäː
हाइपरटेक्स्ट	ɦäːɪpəɾʈeːks̪ʈ
सोचना	s̪oːt͡ʃn̪äː
जल	d͡ʒəl̪
नब्ज	n̪əbd͡ʒ
जीवन	d͡ʒiːʋə̃n̪
बर्दाश्त	bəɾd̪äːʃt̪
मोम	mõːm
संवेदना	s̪ə̃mweːd̪̚n̪äː
कुंजीपटल	kʊ̃n̪d͡ʒiːpəʈəl̪
रागमाला	ɾäːɡmäːl̪äː
सरकाना	s̪əɾkäːn̪äː
क़त्लेआम	qət̪l̪eːä̃ːm
शौचालय	ʃɔːt͡ʃäːl̪əj
हमसाया	ɦə̃ms̪äːjäː
प्रबंध	pɾəbə̃n̪d̪ʱ
सत्तर	s̪ət̪̚t̪əɾ
मादरचोद	mäːd̪əɾt͡ʃoːd̪
मॉड्यूल	mɔɖjuːl̪
उपचार	ʊpt͡ʃäːɾ
बिसरना	bɪs̪əɾn̪äː
जीरा	d͡ʒiːɾäː
अल्फ़ाज़	əl̪pʰäːd͡ʒ
अड़चन	əɽt͡ʃə̃n̪
अभ्यस्त	əbʱjəs̪t̪
अट्ठावन	əʈ̚ʈʰäːʋə̃n̪
गलबाँही	ɡəl̪bä̃ːɦiː
असहिष्णुता	əs̪əɦɪʃɳʊt̪äː
खंडशः	kʰə̃ɳɖʃəɦ
आयोग	äːjoːɡ
रेखाखंड	ɾeːkʰäːkʰə̃ɳɖ
चुदवाना	t͡ʃʊd̪wäːn̪äː
हिसाब	ɦɪs̪äːb
जावा	d͡ʒäːʋäː
नरक	n̪əɾək
निर्वाचित	n̪ɪɾʋäːt͡ʃɪt̪
इंटरव्यू	ɪ̃ɳʈəɾʋjuː
मुख़ालिफ़त	mʊxäːl̪ɪfət̪
स्टेशन	s̪ʈeːʃə̃n̪
अंताक्षरी	ə̃n̪t̪äːkʃəɾiː
सिपाही	s̪ɪpäːɦiː
लज्जा	l̪əd̚d͡ʒäː
बीतना	biːt̪̚n̪äː
दफ़न	d̪əfə̃n̪
डंठल	ɖə̃ɳʈʰəl̪
नस्तालीक़	n̪əs̪t̪äːl̪iːq
नाम	n̪ä̃ːm
गुरुकुल	ɡʊɾʊkʊl̪
पूर्वकथन	puːɾʋəkt̪ʰə̃n̪
जन्मदिन	d͡ʒən̪ə̃md̪ɪ̃n̪
ज़ाया	zäːjäː
ज़हरीली	zɛɦɾiːl̪iː
गंजी	ɡə̃n̪d͡ʒiː
दलित	d̪əl̪ɪt̪
नहाना	n̪əɦäːn̪äː
गंगई	ɡə̃ŋɡəiː
चंदा	t͡ʃə̃n̪d̪äː
व्याख्यायित	ʋjäːkʰjäːjɪt̪
पहरेदार	pɛɦɾeːd̪äːɾ
समान	s̪əmä̃ːn̪
समरूप	s̪ə̃mɾuːp
शिल्पकार	ʃɪl̪pkäːɾ
आमिक्षा	äːmɪkʃäː
हयात	ɦəjäːt̪
जटिल	d͡ʒəʈɪl̪
क्रीड़ा	kɾiːɽäː
अंधाधुंध	ə̃n̪d̪ʱäːd̪ʱʊ̃n̪d̪ʱ
सहस्रपाद	s̪ɛɦɛs̪ɾəpäːd̪
ध्रुवीकरण	d̪ʱɾʊʋiːkəɾə̃ɳ
योगदान	joːɡd̪ä̃ːn̪
संख्या	s̪ə̃ŋkʰjäː
रिवाज़	ɾɪʋäːz
सुधारक	s̪ʊd̪ʱäːɾək
दुनाली	d̪ʊn̪äːl̪iː
किरासन	kɪɾäːs̪ə̃n̪
चंद	t͡ʃə̃n̪d̪
सीमित	s̪iːmɪt̪
मुद्दई	mʊd̪̚d̪əiː
अटकाना	əʈkäːn̪äː
अलादीन	əl̪äːd̪ĩːn̪
मिज़ोरम	mɪd͡ʒoːɾə̃m
उगना	ʊɡn̪äː
इंकार	ɪ̃ŋkäːɾ
गुआम	ɡʊä̃ːm
मुन्ना	mʊ̃n̪n̪äː
अहेरन	əɦeːɾə̃n̪
किफ़ायती	kɪfäːjət̪iː
अकड़न	əkɽə̃n̪
भैंस	bʱɛ̃ːs̪
जानी	d͡ʒäːn̪iː
निष्ठा	n̪ɪʃʈʰäː
सायबान	s̪äːjbä̃ːn̪
गर्मागर्म	ɡəɾmäːɡəɾm
हैवान	ɦɛːʋä̃ːn̪
हिन्दी	ɦɪ̃n̪d̪iː
अठपहिया	əʈʰpəiːjäː
जलज	d͡ʒəl̪əd͡ʒ
शारजाह	ʃäːɾd͡ʒäːɦ
बरामद	bəɾäːməd̪
अध्यक्ष	əd̪ʱjəkʃ
सटीक	s̪əʈiːk
ख़िताबी	kʰɪt̪äːbiː
उच्चारण	ʊt̚t͡ʃäːɾə̃ɳ
ऋणमुक्त	ɾɪ̃ɳmʊkt̪
आधुनिक	äːd̪ʱʊn̪ɪk
सीमा	s̪iːmäː
पायस	päːjəs̪
राज्य	ɾäːd͡ʒjᵊ
इकाई	ɪkäːiː
उदासीन	ʊd̪äːs̪ĩːn̪
निरंकुशवाद	n̪ɪɾə̃ŋkʊʃʋäːd̪
पागलख़ाना	päːɡəl̪xäːn̪äː
फ़ौरन	fɔːɾə̃n̪
पुरस्कार	pʊɾəs̪käːɾ
सॉसेज	s̪ɔs̪eːd͡ʒ
पैदाइश	pɛːd̪äːɪʃ
अफ़ीम	əpʰĩːm
कापीराइट	käːpiːɾäːɪʈ
पराक्रमी	pəɾäːkɾəmiː
बुरक़ा	bʊɾkäː
बन्दूक़	bə̃n̪d̪uːk
सॉरी	s̪ɔɾiː
नज्द	n̪əd͡ʒd̪
उदाहरण	ʊd̪ʱäːɾə̃ɳ
काना	käːn̪äː
भाग्यवान	bʱäːɡjəʋä̃ːn̪
प्रकांड	pɾəkä̃ːɳɖ
बसना	bəs̪n̪äː
सॉकर	s̪ɔkəɾ
साँस	s̪ä̃ːs̪
कोरा	koːɾäː
बेसबॉल	beːs̪bɔl̪
नवंबर	n̪əʋə̃mbəɾ
जनाब	d͡ʒən̪äːb
मार्केट	mäːɾkeːʈ
शहज़ादी	ʃɛɦzäːd̪iː
प्रचारक	pɾət͡ʃäːɾək
अनुपस्थित	ən̪ʊpəs̪t̪ʰɪt̪
मौक़ा	mɔːqäː
अल्फ़ा	əl̪fäː
ॐ	õːm
दबदबा	d̪əbd̪əbäː
उपभोक्ता	ʊp̚bʱoːkt̪äː
ख़ूबसूरती	xuːbs̪uːɾt̪iː
जामन	d͡ʒäːmə̃n̪
बाज़ीचा	bäːziːt͡ʃäː
हिन्दुस्तानी	ɦɪ̃n̪d̪ʊs̪t̪äːn̪iː
क़दमताल	kəd̪ə̃mt̪äːl̪
अंतरा	ə̃n̪t̪əɾäː
झींगा	d͡ʒʱĩːŋɡäː
चन्द्रमा	t͡ʃə̃n̪d̪ɾəmäː
वातानुकूलित	ʋäːt̪äːn̪ʊkuːl̪ɪt̪
गहरा	ɡɛɦɾäː
चक्षुदान	t͡ʃəkʃʊd̪ä̃ːn̪
निष्फल	n̪ɪʃpʰəl̪
दलहन	d̪əl̪ɦə̃n̪
तराशा	t̪əɾäːʃäː
चौड़ा	t͡ʃɔːɽaː
टेलिफ़ोन	ʈeːl̪ɪpʰõːn̪
अधिकारिणी	əd̪ʱɪkäːɾɪɳiː
नगाड़ा	n̪əɡäːɽäː
कोस	koːs̪
खंडहर	kʰə̃ɳɖʱəɾ
अख़बार	əxbäːɾ
ननद	n̪ən̪əd̪
जनमतसंग्रह	d͡ʒə̃n̪mət̪s̪ə̃ŋɡɾəɦ
काज	käːd͡ʒ
माननीय	mä̃ːn̪n̪iːjᵊ
पहले	pɛɦl̪eː
भले	bʱəl̪eː
पतीला	pət̪iːl̪äː
रोका	ɾoːkäː
बुआई	bʊäːiː
कलक्टर	kəl̪əkʈəɾ
कारा	käːɾäː
अम्लता	ə̃ml̪ᵊt̪äː
कचनार	kət͡ʃn̪äːɾ
निर्माता	n̪ɪɾmäːt̪äː
कोठा	koːʈʰäː
साहिब	s̪äːb
हाफ़िज़ा	ɦäːpʰɪd͡ʒäː
वार	ʋäːɾ
ढोकला	ɖʱoːkl̪äː
आप	äːp
टनेल	ʈən̪eːl̪
दाँव	d̪ä̃ːʋ
ख़लक़	kʰəl̪k
स्वेदक	s̪ʋeːd̪ək
सांप्रदायिकता	s̪ä̃ːpɾəd̪äːjɪkt̪äː
शिक्षण	ʃɪkʃə̃ɳ
नाव	n̪äːʋ
आवर्त	äːʋəɾt̪
पुनश्च	pʊn̪əʃt͡ʃə
अटकाव	əʈkäːʋ
गोला	ɡoːl̪äː
गुहार	ɡʊɦäːɾ
सत्तारूढ़	s̪ət̪̚t̪äːɾuːɽʱ
मेरुदंड	meːɾʊd̪ə̃ɳɖ
चिड़वा	t͡ʃɪɽʋäː
पुजारी	pʊd͡ʒäːɾiː
सुझाना	s̪ʊd͡ʒʱäːn̪äː
लगावट	l̪əɡäːʋəʈ
उद्देशिका	ʊd̪̚d̪eːʃɪkäː
धरना	d̪ʱəɾn̪äː
इकबाल	ɪqbäːl̪
खंबा	kʰə̃mbäː
विश्वासपात्र	ʋɪʃʋäːs̪päːt̪ɾᵊ
ध्यानपूर्वक	d̪ʱjä̃ːn̪puːɾʋək
तर्जुमान	t̪əɾd͡ʒʊmä̃ːn̪
साक्ष्य	s̪äːkʃjᵊ
व्याख्यानदाता	ʋjäːkʰjä̃ːn̪d̪äːt̪äː
फ़्रेन्चाइज़	fɾẽːn̪t͡ʃäːɪz
दूतावास	d̪uːt̪äːʋäːs̪
अंकनी	ə̃ŋkn̪iː
गुफा	ɡʊpʰäː
ताल्लुक	t̪äːl̪l̪ʊk
दक्षिणपंथ	d̪əkʃɪ̃ɳpə̃n̪t̪ʰ
आर्जेंटीना	äːɾd͡ʒẽːɳʈiːn̪äː
परिणाम	pəɾɪɳä̃ːm
उपनिषद्	ʊpn̪ɪʃəd̪
हिमाद्रि	ɦɪmäːd̪ɾiː
सय्याद	s̪əjjäːd̪
फ़रात	pʰəɾäːt̪
स्निग्ध	s̪n̪ɪɡd̪ʱ
हीलियम	ɦiːl̪ijə̃m
पदक	pəd̪ək
पश्चात्	pəʃt͡ʃäːt̪
स्वच्छ	s̪ʋət̚t͡ʃʰ
मुक्तिवादी	mʊkt̪ɪʋäːd̪iː
साफ	s̪äːf
बहावलनगर	bəɦäːʋəl̪n̪əɡəɾ
मोज़ांबीक	moːzä̃ːmbiːk
समुद्र	s̪əmʊd̪ɾᵊ
लुत्फ़	l̪ʊt̪pʰ
वहशी	ʋɛɦʃiː
हस्तमैथुन	ɦəs̪t̪mɛːt̪ʰʊ̃n̪
मुक़दमा	mʊqəd̪mäː
इज़ाफ़ा	ɪd͡ʒäːpʰäː
पाठशाला	päːʈʰʃäːl̪äː
पुच्छल	pʊt̚t͡ʃʰəl̪
अंगुली	ə̃ŋɡʊl̪iː
लोक	l̪oːk
प्यासा	pjäːs̪äː
जायज़	d͡ʒäːjəz
वातावरण	ʋäːt̪äːʋəɾə̃ɳ
नमस्कार	n̪əməʃkäːɾ
चूमना	t͡ʃũːmn̪äː
आतंकवादी	äːt̪ə̃ŋkwäːd̪iː
डुलना	ɖʊl̪n̪äː
नक़ल	n̪əqəl̪
समुच्चय	s̪əmʊt̚t͡ʃəj
जानलेवा	d͡ʒä̃ːn̪l̪eːʋäː
निकम्मापन	n̪ɪkə̃mmäːpə̃n̪
लिखा	l̪ɪkʰäː
लीलना	l̪iːl̪n̪äː
खाप	kʰäːp
अनब्याहा	ə̃n̪bjäːɦäː
पदोन्नत	pəd̪õːn̪n̪ət̪
आग्रह	äːɡɾəɦ
व्याख्या	ʋjäːkʰjäː
प्राप्त	pɾäːpt̪
वफ़ा	ʋəpʰäː
चिनिया	t͡ʃɪn̪ijäː
इंगन	ɪ̃ŋɡə̃n̪
इलेक्ट्रॉन	ɪl̪eːkʈɾɔ̃n̪
हड़गिल्ला	ɦəɽɡɪl̪l̪äː
गुजरांवाला	ɡʊd͡ʒɾä̃ːmwäːl̪äː
कोशिका	koːʃɪkäː
जर्मन	d͡ʒəɾmə̃n̪
आफ़्रीदी	äːpʰɾiːd̪iː
नक्षत्र	n̪əkʃət̪ɾᵊ
असामाजिक	əs̪äːmäːd͡ʒɪk
पागल	päːɡəl̪
फ़र्ज़ंद	fəɾzə̃n̪d̪
पालकी	päːl̪kiː
लज़ीज़	l̪əziːz
तगड़ा	t̪əɡɽäː
बन्दीघर	bə̃n̪d̪iːɡʱəɾ
प्यास	pjäːs̪
अनुनय	ən̪ʊn̪əj
विनम्रता	ʋɪn̪ə̃mɾət̪äː
ग्यारह	ɡjäːɾɛː
मैनेजर	mɛːn̪eːd͡ʒəɾ
अनुज्ञप्ति	ən̪ʊɡjəpt̪iː
ममेरा	məmeːɾäː
नुस्खा	n̪ʊs̪kʰäː
न्याय	n̪jäːj
नीत	n̪iːt̪
गोलगप्पा	ɡoːl̪ɡəp̚päː
ख़ुशहाल	kʰʊʃɦäːl̪
भूयाति	bʱuːjäːt̪iː
जुगलबंदी	d͡ʒʊɡəl̪bə̃n̪d̪iː
ख़ाली	xäːl̪iː
अप्रत्याशित	əpɾət̪jäːʃɪt̪
धोबिन	d̪ʱoːbɪ̃n̪
अलबम	əl̪bə̃m
निवेदन	n̪ɪʋeːd̪ə̃n̪
आत्मनिर्णय	äːt̪mən̪ɪɾɳəj
थमना	t̪ʰə̃mn̪äː
हिन्दचीन	ɦɪ̃n̪d̪t͡ʃĩːn̪
प्रधान	pɾəd̪ʱä̃ːn̪
महकना	mɛɦɛkn̪äː
भूनना	bʱũːn̪n̪äː
आगे	äːɡeː
अरगनी	əɾəɡn̪iː
इंग्लिश	ɪ̃ŋɡl̪ɪʃ
जम्हूरियत	d͡ʒə̃mɦuːɾijət̪
बँटवारा	bə̃ɳʈwäːɾäː
बाँग	bä̃ːŋɡ
टीस	ʈiːs̪
बेलनाकार	beːl̪ə̃n̪äːkäːɾ
रोकड़िया	ɾoːkɽijäː
प्रेरणा	pɾeːɾɳäː
आलीशान	äːl̪iːʃä̃ːn̪
इंजीनियरी	ɪ̃n̪d͡ʒiːn̪ijəɾiː
लालसा	l̪äːl̪s̪äː
निर्देशांक	n̪ɪɾd̪eːʃä̃ːk
लुत्फ़	l̪ʊt̪f
ख़ान	xä̃ːn̪
लिखिए	l̪ɪkʰɪeː
भ्रामकता	bʱɾäːməkt̪äː
समझना	s̪əməd͡ʒʱn̪äː
खगोल	kʰəɡoːl̪
रूढ़िवाद	ɾuːɽʱɪʋäːd̪
फ़िनलैंड	pʰɪ̃n̪l̪ɛ̃ːɳɖ
निकोबार	n̪ɪkoːbäːɾ
दक्खिनी	d̪ək̚kʰɪn̪iː
सलीम	s̪əl̪ĩːm
ओगाज़्म	oːɡäːzm
ख़ानसामाँ	xä̃ːn̪s̪äːmä̃ː
आरा	äːɾäː
खुलापन	kʰʊl̪äːpə̃n̪
फ़्रांसीसी	fɾä̃ːn̪s̪iːs̪iː
इंगनी	ɪ̃ŋɡn̪iː
खयालो	xəjäːl̪oː
भाटक	bʱäːʈək
कोंपल	kõːmpəl̪
देहरा	d̪eːɦɾäː
थापा	t̪ʰäːpäː
जमाकर्ता	d͡ʒəmäːkəɾt̪äː
बलमटेर	bəl̪ə̃mʈeːɾ
महरूम	mɛɦɾũːm
अन्याय	ə̃n̪jäːj
पेय	peː
स्थूल	s̪t̪ʰuːl̪
आज़र्बैजान	äːzəɾbɛːd͡ʒä̃ːn̪
पेप्सी	peːps̪iː
तुग़लक़	t̪ʊɡl̪ək
युवावस्था	jʊʋäːʋəs̪t̪ʰäː
ठंडक	ʈʰə̃ɳɖək
अनुवादित	ən̪ʊʋäːd̪ɪt̪
दुनियाएँ	d̪ʊn̪ijäːẽː
भटकना	bʱəʈəkn̪äː
शिकारी	ʃɪkäːɾiː
ख़ुशक़िस्मत	xʊʃqɪs̪mət̪
कम्युनिज्म	kə̃mjʊn̪ɪzmᵊ
हंगामा	ɦə̃ŋɡäːmäː
लापरवाह	l̪äːpəɾʋäːɦ
जमाअत	d͡ʒəmäːət̪
महत्व	mɛɦɛt̪wᵊ
ठपना	ʈʰəpn̪äː
प्रजनन	pɾəd͡ʒən̪ə̃n̪
लोमड़ी	l̪õːmɽiː
चरमपंथी	t͡ʃəɾə̃mpə̃n̪t̪ʰiː
दोस्त	d̪oːs̪t̪
मुराद	mʊɾäːd̪
काफल	käːpʰəl̪
सेंटी	s̪ẽːɳʈiː
बिल्ला	bɪl̪l̪äː
वास्तविक	ʋäːs̪t̪əʋɪk
टांकण	ʈä̃ːkə̃ɳ
थाइलैंड	t̪ʰäːɪl̪ɛ̃ːɳɖ
मौलाना	mɔːl̪äːn̪äː
धन	d̪ʱə̃n̪
गायब	ɡäːjəb
परामर्श	pəɾäːməɾʃ
बग़ीचा	bəɣiːt͡ʃäː
वस्त्र	ʋəs̪t̪ɾᵊ
विंडसर	ʋɪ̃ɳɖs̪əɾ
उदास	ʊd̪äːs̪
उपदान	ʊpd̪ä̃ːn̪
प्रासाद	pɾäːs̪äːd̪
झुर्रियाँ	d͡ʒʱʊɾɾijä̃ː
कट्ठा	kəʈ̚ʈʰäː
वृद्धावस्था	ʋɾɪd̪̚d̪ʱäːʋəs̪t̪ʰäː
फ़ुटबॉल	fʊʈbɔl̪
फ़ीलपाँव	fiːl̪pä̃ːʋ
सब्ज़ीमंडी	s̪əbd͡ʒiːmə̃ɳɖiː
अल्फ़ा	əl̪pʰäː
भ्राजातु	bʱɾäːd͡ʒäːt̪uː
अनुपम	ən̪ʊpə̃m
ढाँचा	ɖʱä̃ːt͡ʃäː
मनु	mən̪uː
सूर्य	s̪uːɾjᵊ
कॉमेडियन	kɔmeːɖijə̃n̪
नक़ाबपोश	n̪əkäːb̚poːʃ
वतन	ʋət̪ə̃n̪
आरोग्य	äːɾoːɡjᵊ
असाध्य	əs̪äːd̪ʱjᵊ
वफ़ा	ʋəfäː
धंधा	d̪ʱə̃n̪d̪ʱäː
सूची	s̪uːt͡ʃiː
मार्ग	mäːɾɡ
कुल्ला	kʊl̪l̪äː
लिबास	l̪ɪbäːs̪
फ़ॉर्मूला	fɔɾmuːl̪äː
इकसिंगा	ɪks̪ɪ̃ŋɡäː
उपबोली	ʊp̚boːl̪iː
पुस्तक	pʊs̪t̪ək
मर्तबा	məɾt̪əbäː
समीर	s̪əmiːɾ
दलील	d̪əl̪iːl̪
लालची	l̪äːl̪t͡ʃiː
गोलमाल	ɡoːl̪mäːl̪
पिसना	pɪs̪n̪äː
निखारना	n̪ɪkʰäːɾn̪äː
रिज़ल्ट	ɾɪzəl̪ʈ
सवर्ण	s̪əʋəɾɳ
विमान	ʋɪmä̃ːn̪
गुड़िया	ɡʊɽijäː
शिनाख़्त	ʃɪn̪äːxt̪
केकड़ा	keːkɽaː
गोरक्षा	ɡoːɾəkʃäː
स्वीडन	s̪ʋiːɖə̃n̪
जन्मना	d͡ʒə̃n̪mn̪äː
अब्बा	əb̚bäː
ज़माना	zəmäːn̪äː
आज़माइश	äːd͡ʒmäːɪʃ
नामक	n̪äːmək
प्रविष्टि	pɾəʋɪʃʈiː
घाना	ɡʱäːn̪äː
व्लादिवोस्तोक	ʋl̪äːd̪ɪʋoːs̪t̪oːk
कोठारी	koːʈʰäːɾiː
धर्मस्थलो	d̪ʱəɾməs̪t̪ʰəl̪oː
ख़ास	xäːs̪
हत्यारा	ɦət̪jäːɾäː
पुत्रजया	pʊt̪ɾᵊd͡ʒəjäː
असभ्यता	əs̪əbʱjət̪äː
इंदौर	ɪ̃n̪d̪ɔːɾ
गर्भावस्था	ɡəɾbʱäːʋəs̪t̪ʰäː
तीरंदाज़ी	t̪iːɾə̃n̪d̪äːd͡ʒiː
वक्ष	ʋəkʃ
चालान	t͡ʃäːl̪ä̃ːn̪
आईना	aːiːnaː
सज़ा	s̪əd͡ʒäː
स्वर्ग	s̪ʋəɾɡ
सलाह	s̪əl̪äːɦ
नाख़ून	n̪äːxũːn̪
दुर्व्यवहार	d̪ʊɾʋjəʋɦäːɾ
बुलबुल	bʊl̪bʊl̪
बत्तीस	bət̪̚t̪iːs̪
लंबू	l̪ə̃mbuː
छुआछूत	t͡ʃʰʊäːt͡ʃʰuːt̪
किसान	kɪs̪ä̃ːn̪
तौबा	t̪ɔːbäː
चुदना	t͡ʃʊd̪̚n̪äː
कार्रवाई	käːɾɾəʋäːiː
प्रसन्नता	pɾəs̪ə̃n̪n̪ᵊt̪äː
असलियत	əs̪l̪ijət̪
आस्तिक	äːs̪t̪ɪk
सोणिया	s̪oːɳijäː
झंडा	d͡ʒʱə̃ɳɖäː
जुदाई	d͡ʒʊd̪äːiː
अग्रवाल	əɡɾᵊʋäːl̪
सहायक	s̪əɦäːjək
जानकार	d͡ʒä̃ːn̪käːɾ
विष	ʋɪʃ
लंभा	l̪ə̃mbʱäː
साद	s̪äːd̪
नगरीकृत	n̪əɡəɾiːkɾɪt̪
क़ाबिज़	käːbɪd͡ʒ
विपक्षी	ʋɪpəkʃiː
आहरण	äːɦɾə̃ɳ
गंतव्य	ɡə̃n̪t̪əʋjᵊ
दग़ाबाज़	d̪əɡäːbäːd͡ʒ
कच्छ	kət̚t͡ʃʰ
लद्दाख़	l̪əd̪̚d̪äːx
ज़ात	zäːt̪
किरणपुंज	kɪɾə̃ɳpʊ̃n̪d͡ʒ
सर्वथा	s̪əɾʋt̪ʰäː
बहलाना	bɛɦl̪äːn̪äː
बंदरिया	bə̃n̪d̪əɾijäː
विनय	ʋɪn̪əj
हलफ़नामा	ɦəl̪əfn̪äːmäː
रोमांचक	ɾoːmä̃ːt͡ʃək
सूरजमुखी	s̪uːɾəd͡ʒmʊkʰiː
तिहत्तर	t̪ɪɦət̪̚t̪əɾ
हल्क़ा	ɦəl̪käː
गुगल	ɡʊɡəl̪
बचपन	bət͡ʃpə̃n̪
पपनी	pəpn̪iː
मुसलमान	mʊs̪əl̪mä̃ːn̪
हेटौडा	ɦeːʈɔːɖäː
पुनर्जीवित	pʊn̪əɾd͡ʒiːʋɪt̪
अतिसार	ət̪ɪs̪äːɾ
न्यून	n̪jũːn̪
जहन्नम	d͡ʒɛɦɛ̃n̪n̪ə̃m
असभ्य	əs̪əbʱjᵊ
सम्मुख	s̪ə̃mmʊkʰ
लाचार	l̪äːt͡ʃäːɾ
उपकार	ʊpkäːɾ
पुकारना	pʊkäːɾn̪äː
माफ़ी	mäːfiː
चूज़ा	t͡ʃuːd͡ʒäː
पवन	pəʋə̃n̪
अतुलित	ət̪ʊl̪ɪt̪
बुनियाद	bʊn̪ijäːd̪
नाज़	n̪äːd͡ʒ
जावित्री	d͡ʒäːʋɪt̪ɾiː
भाजपा	bʱäːd͡ʒpäː
फ़ंतासी	fə̃n̪t̪äːs̪iː
पणजी	pə̃ɳd͡ʒiː
सुमात्रा	s̪ʊmäːt̪ɾäː
वेनेज़ुएला	ʋeːn̪eːd͡ʒʊeːl̪äː
अनुभूति	ən̪ʊbʱuːt̪iː
सल्तनत	s̪əl̪t̪ən̪ət̪
ख़ाली	kʰäːl̪iː
अंतरजाल	ə̃n̪t̪əɾd͡ʒäːl̪
इकतालीस	ɪkt̪äːl̪iːs̪
आहार	äːɦäːɾ
हरा	ɦəɾaː
काबीना	käːbiːn̪äː
रुपया	ɾʊpjäː
डसना	ɖəs̪n̪äː
आख़िरी	äːkʰɾiː
तारीफ़	t̪äːɾiːpʰ
कारक	käːɾək
जायदाद	d͡ʒäːjd̪äːd̪
भूलभुलैया	bʱuːl̪bʱʊl̪ə̯ijäː
प्रतिभा	pɾət̪ɪbʱäː
तवारीख़	t̪əʋäːɾiːkʰ
क्रियावाचक	kɾijäːʋäːt͡ʃək
जुड़ना	d͡ʒʊɽn̪äː
ओछा	oːt͡ʃʰäː
टखना	ʈəkʰn̪äː
झलना	d͡ʒʱəl̪n̪äː
मस्ती	məs̪t̪iː
इसमें	ɪs̪mẽː
दंग	d̪ə̃ŋɡ
सिफ़ारतख़ाना	s̪ɪpʰäːɾət̪kʰäːn̪äː
क्रांतिकारी	kɾä̃ːn̪t̪ɪkäːɾiː
बिटकॉइन	bɪʈkɔɪ̃n̪
जूझना	d͡ʒuːd͡ʒʱn̪äː
अनर्थ	ən̪əɾt̪ʰ
गुर्जिस्तान	ɡʊɾd͡ʒɪs̪t̪ä̃ːn̪
क़िस्म	qɪs̪m
दामाद	d̪äːmäːd̪
नियति	n̪ijət̪iː
शानदार	ʃä̃ːn̪d̪äːɾ
प्रिया	pɾijäː
न्यूज़ीलैंड	n̪juːziːl̪ɛ̃ːɳɖ
कार्यकाल	käːɾjəkäːl̪
वंशावली	ʋə̃n̪ʃäːʋəl̪iː
हड़ताल	ɦəɽt̪äːl̪
नपुंसक	n̪əpʊ̃n̪s̪ək
क्वथनांक	kwət̪ʰən̪ä̃ːk
बिल्कुल	bɪl̪kʊl̪
भाँग	bʱä̃ːŋɡ
तत्कालीन	t̪ət̪käːl̪ĩːn̪
लेबनॉन	l̪eːbn̪ɔ̃n̪
कटहल	kəʈʰəl̪
साध्वी	s̪äːd̪ʱʋiː
बाबू	bäːbuː
पुनःप्रवेश	pʊn̪əɦpɾəʋeːʃ
भूविज्ञान	bʱuːʋɪɡjä̃ːn̪
आपत्ति	äːpət̪̚t̪iː
मंसब	mə̃n̪s̪əb
बक्सा	bəks̪äː
अंगिया	ə̃ŋɡijäː
लवड़ा	l̪əʋɽäː
फुदकना	pʰʊd̪əkn̪äː
यादृच्छिक	jäːd̪ɾɪt̚t͡ʃʰɪk
तासीर	t̪äːs̪iːɾ
अनुप्रयुक्त	ən̪ʊpɾəjʊkt̪
पैंतीस	pɛ̃ːn̪t̪iːs̪
ताऊ	t̪äːuː
विश्वप्रसिद्ध	ʋɪʃʋəpɾəs̪ɪd̪d̪ʱ
पुश्तैनी	pʊʃt̪ɛːn̪iː
अनपच	ə̃n̪pət͡ʃ
फ़िलहाल	fɪl̪ɦäːl̪
उत्पीड़न	ʊt̪piːɽə̃n̪
दरियाई	d̪əɾijäːiː
उड़ीसा	ʊɽiːs̪äː
बांस	bä̃ːn̪s̪
आत्मघात	äːt̪məɡʱäːt̪
माइक	mäːɪk
उपभोज्य	ʊp̚bʱoːd͡ʒjᵊ
खरोंच	kʰəɾõːn̪t͡ʃ
क्रमादेशन	kɾəmäːd̪eːʃə̃n̪
इससे	ɪs̪s̪eː
का	käː
धनवान	d̪ʱə̃n̪wä̃ːn̪
अध्ययन	əd̪ʱjəjə̃n̪
तनाव	t̪ən̪äːʋ
मुंतज़िम	mʊ̃n̪t̪əd͡ʒɪ̃m
जागरूकता	d͡ʒäːɡɾuːkt̪äː
बयासी	bəjäːs̪iː
स्थायीकार	s̪t̪ʰäːjiːkäːɾ
अंगीकार	ə̃ŋɡiːkäːɾ
राकेट	ɾäːkeːʈ
क़ैंची	qɛ̃ːn̪t͡ʃiː
क्रीड़ास्थल	kɾiːɽäːs̪t̪ʰəl̪
पूंजी	pũːn̪d͡ʒiː
प्रकार	pɾəkäːɾ
रगड़न	ɾəɡɽə̃n̪
नाजायज़	n̪äːd͡ʒäːjəd͡ʒ
भागना	bʱäːɡn̪äː
हलचल	ɦəl̪t͡ʃəl̪
अवोकाडो	əʋoːkäːɖoː
शीशा	ʃiːʃäː
तेज़ाब	t̪eːd͡ʒäːb
ग़द्दार	ɡəd̪̚d̪äːɾ
कॅन्सर	kæ̃n̪s̪əɾ
त्रासद	t̪ɾäːs̪əd̪
लौहपथगामिनीसूचकदर्शकहरितताम्रलौहपट्टिका	l̪ɔːɦpət̪ʰɡäːmɪn̪iːs̪uːt͡ʃəkd̪əɾʃəkʰəɾɪt̪̚t̪ä̃ːmɾəl̪ɔːɦpəʈ̚ʈɪkäː
तिनसुकिया	t̪ɪ̃n̪s̪ʊkijäː
डमरू	ɖə̃mɾuː
किरकिला	kɪɾkɪl̪äː
कामुक	käːmʊk
गगनभेदी	ɡəɡə̃n̪bʱeːd̪iː
अंग्रेज	ə̃ŋɡɾeːz
रूबल	ɾuːbəl̪
अनुपस्थिति	ən̪ʊpəs̪t̪ʰɪt̪iː
कोरिया	koːɾijäː
साधारण	s̪äːd̪ʱäːɾə̃ɳ
वादसभा	ʋäːd̪s̪əbʱäː
पाद	päːd̪
जयकार	d͡ʒəjkäːɾ
बहनापा	bɛɦn̪äːpäː
नोचना	n̪oːt͡ʃn̪äː
दौरान	d̪ɔːɾä̃ːn̪
क्वार्टज़	kwäːɾʈd͡ʒ
नीवि	n̪iːʋiː
मुँहासा	mʊ̃ɦäːs̪äː
अत्फ़ाल	ət̪pʰäːl̪
नतीजतन	n̪ət̪iːd͡ʒt̪ə̃n̪
नज़रिया	n̪əd͡ʒəɾijäː
बग़ावत	bəɣäːʋət̪
घटनास्थल	ɡʱəʈn̪äːs̪t̪ʰəl̪
दारचीनी	d̪äːɾt͡ʃiːn̪iː
बरात	bəɾäːt̪
पाबंदी	päːbə̃n̪d̪iː
संलयन	s̪ə̃l̪əjə̃n̪
छियानवे	t͡ʃʰijä̃ːn̪weː
लगन	l̪əɡə̃n̪
दूसरा	d̪uːs̪ɾäː
हुड़दंगबाज़	ɦʊɽd̪ə̃ŋɡbäːd͡ʒ
लटकना	l̪əʈəkn̪äː
सिंदूर	s̪ɪ̃n̪d̪uːɾ
कटोरा	kəʈoːɾäː
फ्रांसीसी	fɾä̃ːn̪s̪iːs̪iː
सिगरेट	s̪ɪɡəɾeːʈ
सृष्टि	s̪ɾɪʃʈiː
अलम्	əl̪ə̃m
बोतल	boːt̪əl̪
कल्पित	kəl̪pɪt̪
चप्पल	t͡ʃəp̚pəl̪
कृष्ण	kɾɪʃɳ
चमची	t͡ʃə̃mt͡ʃiː
हज़ारहा	ɦəd͡ʒäːɾɦäː
गणराज्य	ɡə̃ɳɾäːd͡ʒjᵊ
पारसेक	päːɾs̪eːk
विपुल	ʋɪpʊl̪
हिन्दुस्तान	ɦɪ̃n̪d̪ʊs̪t̪ä̃ːn̪
आलिम	äːl̪ɪ̃m
टोरंटो	ʈoːɾə̃ɳʈoː
इरादा	ɪɾäːd̪äː
सर्वाधिक	s̪əɾʋäːd̪ʱɪk
कलन	kəl̪ə̃n̪
लुगाई	l̪ʊɡäːiː
संक्षिप्तीकरण	s̪ə̃ŋkʃɪpt̪iːkəɾə̃ɳ
आडंबर	äːɖə̃mbəɾ
लोगों	l̪oːɡõː
इच्छा	ɪt̚t͡ʃʰäː
प्रत्यक्षीकरण	pɾət̪jəkʃiːkəɾə̃ɳ
बालू	bäːl̪uː
तदुपरांत	t̪əd̪ʊpɾä̃ːn̪t̪
वसंत	ʋəs̪ə̃n̪t̪
चुकाना	t͡ʃʊkäːn̪äː
कोंकणी	kõːŋkɳiː
प्रभात	pɾəbʱäːt̪
वर्चुअल	ʋəɾt͡ʃʊəl̪
बडा	bəɽäː
छात्रावास	t͡ʃʰäːt̪ɾäːʋäːs̪
चीज़बस्त	t͡ʃiːd͡ʒbəs̪t̪
प्रतिबिंब	pɾət̪ɪbɪ̃mb
आतिशबाजी	äːt̪ɪʃbäːziː
केला	keːl̪äː
उन्नति	ʊ̃n̪n̪ət̪iː
तृण	t̪ɾɪ̃ɳ
हौवा	ɦə̯uʋäː
इटली	ɪʈl̪iː
ख़ासियत	kʰäːs̪ijət̪
पाठ्यक्रम	päːʈʰjəkɾə̃m
गुर्दा	ɡʊɾd̪äː
फ़िलिस्तीनी	fɪl̪ɪs̪t̪iːn̪iː
मक्कार	mək̚käːɾ
ज़ैतून	zɛːt̪ũːn̪
अर्थव्यवस्था	əɾt̪ʰəʋjəʋəs̪t̪ʰäː
फ़ीस	fiːs̪
अग्न्याशय	əɡn̪jäːʃəj
उपन्यासकार	ʊpə̃n̪jäːs̪käːɾ
गिराना	ɡɪɾäːn̪äː
जलना	d͡ʒəl̪n̪äː
रोकथाम	ɾoːkt̪ʰä̃ːm
सागर	s̪äːɡəɾ
टिप्पणी	ʈɪp̚pəɳiː
चाय	t͡ʃäːj
लेखिका	l̪eːkʰɪkäː
अपहरण	əpɦəɾə̃ɳ
नेपालगंज	n̪eːpäːl̪ɡə̃n̪d͡ʒ
सेटिंग	s̪eːʈɪ̃ŋɡ
प्रदाता	pɾəd̪äːt̪äː
सांस्कृतिक	s̪ä̃ːn̪s̪kɾɪt̪ɪk
हलाल	ɦəl̪äːl̪
नाखुन	n̪äːkʰʊ̃n̪
निर्मेघ	n̪ɪɾmeːɡʱ
अहाता	əɦäːt̪äː
शीर्षक	ʃiːɾʃək
नापसंद	n̪äːpəs̪ə̃n̪d̪
फ़्रान्सीसी	fɾä̃ːn̪s̪iːs̪iː
सुरत	s̪ʊɾət̪
वास्कट	ʋäːs̪kəʈ
गोवा	ɡoːʋäː
गंदा	ɡə̃n̪d̪äː
कहवा	qɛɦʋäː
क़साई	qəs̪äːiː
निर्धनता	n̪ɪɾd̪ʱə̃n̪t̪äː
सत्तावाद	s̪ət̪̚t̪äːʋäːd̪
सर्वांगसम	s̪əɾʋä̃ːŋɡs̪ə̃m
कैलिफ़ोर्निया	kɛːl̪ɪfoːɾn̪ijäː
इडली	ɪɖl̪iː
अहिर्बुश्न	əɦɪɾbʊʃn̪ᵊ
उलफ़त	ʊl̪pʰət̪
सगाई	s̪əɡäːiː
ख़म	xə̃m
सोग	s̪oːɡ
अधुना	əd̪ʱʊn̪äː
घमंड	ɡʱəmə̃ɳɖ
उच्छ्वास	ʊt̚t͡ʃʰʋäːs̪
जिसका	d͡ʒɪs̪käː
बाँस	bä̃ːs̪
देना	d̪eːn̪äː
नवासी	n̪əʋäːs̪iː
लुग़ात	l̪ʊɣäːt̪
ट्वीट	ʈwiːʈ
योज्यता	joːd͡ʒjət̪äː
वारिस	ʋäːɾɪs̪
रानी	ɾäːn̪iː
ग़ैरक़ानूनी	ɣɛːɾqäːn̪uːn̪iː
ओलंदेज़	oːl̪ə̃n̪d̪eːz
महाविद्यालय	məɦäːʋɪd̪jäːl̪əj
ख़लिश	xəl̪ɪʃ
तख़्तापलट	t̪əkʰt̪äːpəl̪əʈ
अनातोली	ən̪äːt̪oːl̪iː
बँधुआ	bə̃n̪d̪ʱʊäː
हल्ला	ɦəl̪l̪äː
नाभिकीय	n̪äːbʱɪkiːjᵊ
हिंदको	ɦɪ̃n̪d̪koː
पिया	pijäː
नर्मदा	n̪əɾməd̪äː
प्रचलित	pɾət͡ʃəl̪ɪt̪
जीतना	d͡ʒiːt̪̚n̪äː
क्षुब्ध	kʃʊbd̪ʱ
लोजबान	l̪oːd͡ʒbä̃ːn̪
सिंहला	s̪ɪ̃ŋɡʱəl̪äː
फ़ोन	fõːn̪
बयानबाज़ी	bəjä̃ːn̪bäːd͡ʒiː
चुसना	t͡ʃʊs̪n̪äː
मुश्ताक़	mʊʃt̪äːq
मम्मी	mə̃mmiː
भत्ता	bʱət̪̚t̪äː
बबूल	bəbuːl̪
दरबार	d̪əɾbäːɾ
बहुदलीय	bɔɦɔd̪əl̪iːjᵊ
मरहबा	məɾɦəbäː
संयम	s̪ə̃jə̃m
क्रांति	kɾä̃ːn̪t̪iː
साझेदारी	s̪äːd͡ʒʱeːd̪äːɾiː
मल	məl̪
संतोषी	s̪ə̃n̪t̪oːʃiː
पलंग	pəl̪ə̃ŋɡ
दुपहिया	d̪ʊpəɦijäː
कॅटलोनिया	kæʈl̪oːn̪ijäː
आवाज़	äːʋäːz
सो	s̪oː
ख़ूबानी	xuːbäːn̪iː
याजक	jäːd͡ʒək
परोपकार	pəɾoːpkäːɾ
जिन्होंने	d͡ʒɪ̃n̪ɦõːn̪n̪eː
नक्शा	n̪əkʃäː
छलाँग	t͡ʃʰəl̪ä̃ːŋɡ
चिंता	t͡ʃɪ̃n̪t̪äː
ज्ञात	ɡjäːt̪
गिनतारा	ɡɪ̃n̪t̪äːɾäː
विसर्जन	ʋɪs̪əɾd͡ʒə̃n̪
चौंकना	t͡ʃɔ̃ːŋkn̪äː
घाव	ɡʱäːʋ
गाँठ	ɡä̃ːʈʰ
अनंतपुर	ən̪ə̃n̪t̪pʊɾ
शतरंज	ʃət̪ɾə̃n̪d͡ʒ
मेमना	mẽːmn̪äː
नसबंदी	n̪əs̪bə̃n̪d̪iː
अनिवार्यतः	ən̪ɪʋäːɾjət̪əɦ
अंगच्छेद	ə̃ŋɡət̚t͡ʃʰeːd̪
अफ़सर	əfs̪əɾ
साझेदार	s̪äːd͡ʒʱeːd̪äːɾ
सिमटना	s̪ɪməʈn̪äː
नवाज़ना	n̪əʋäːd͡ʒn̪äː
आत्मसमर्पण	äːt̪mᵊs̪əməɾpə̃ɳ
मुक्केबाज़	mʊk̚keːbäːd͡ʒ
गंगाजल	ɡə̃ŋɡäːd͡ʒəl̪
कूटनीति	kuːʈn̪iːt̪iː
मालगुज़ारी	mäːl̪ɡʊd͡ʒäːɾiː
हिस्सेदार	ɦɪs̪s̪eːd̪äːɾ
संदिग्ध	s̪ə̃n̪d̪ɪɡd̪ʱ
पतंगबाज़	pət̪ə̃ŋɡbäːz
असीस	əs̪iːs̪
सूर	s̪uːɾ
रायता	ɾäːjt̪äː
सक्रिय	s̪əkɾɪj
भेलपूरी	bʱeːl̪puːɾiː
महासागर	məɦäːs̪äːɡəɾ
मगरमच्छ	məɡəɾmət̚t͡ʃʰ
हरामी	ɦəɾäːmiː
महाराजा	məɦäːɾäːd͡ʒäː
ख़ुदा	kʰʊd̪äː
फली	pʰəl̪iː
किंतु	kɪ̃n̪t̪uː
लॉकडाउन	l̪ɔkɖäːʊ̃n̪
स्विट्ज़रलैंड	s̪ʋɪʈd͡ʒəɾl̪ɛ̃ːɳɖ
तराशना	t̪əɾäːʃn̪äː
यंत्रीकृत	jə̃n̪t̪ɾiːkɾɪt̪
बुज़दिल	bʊzd̪ɪl̪
मुनाफ़ा	mʊn̪äːfäː
मेंढक	mẽːɳɖʱək
आरामदेह	äːɾä̃ːmd̪eːɦ
आज़र्बैजान	äːd͡ʒəɾbɛːd͡ʒä̃ːn̪
ओकाई	oːkäːiː
ब्रिस्बेन	bɾɪs̪bẽːn̪
रिश्ता	ɾɪʃt̪äː
सुबकना	s̪ʊbəkn̪äː
पिता	pɪt̪äː
एवं	eːʋə̃m
सांस	s̪ä̃ːn̪s̪
मारख़ोर	mäːɾkʰoːɾ
निकलना	n̪ɪkəl̪n̪äː
अस्पृश्य	əs̪pɾɪʃjᵊ
भूकंप	bʱuːkə̃mp
क्षण	kʃə̃ɳ
ऑक्सफ़ोर्ड	ɔks̪foːɾɖ
शतकवीर	ʃət̪əkwiːɾ
आशिक़ी	äːʃɪqiː
शाक	ʃäːk
गुलदान	ɡʊl̪d̪ä̃ːn̪
नाशपाती	n̪äːʃpäːt̪iː
पपीहा	pəpiːɦäː
दरख़ास्त	d̪əɾxäːs̪t̪
कतल	qət̪əl̪
गृहस्थ	ɡɾɪɦəs̪t̪ʰ
विरोधाभास	ʋɪɾoːd̪ʱäːbʱäːs̪
कबूल	qəbuːl̪
साम्यावस्था	s̪ä̃ːmjäːʋəs̪t̪ʰäː
अभ्यासक्रम	əbʱjäːs̪kɾə̃m
रुद्रवीणा	ɾʊd̪ɾəʋiːɳäː
जनसांख्यिकी	d͡ʒə̃n̪s̪ä̃ːkʰjɪkiː
ब्यौरा	bjɔːɾäː
बाकी	bäːkiː
सरोज	s̪əɾoːd͡ʒ
अस्पष्टता	əs̪pəʃʈət̪äː
परास्त	pəɾäːs̪t̪
दुष्परिणाम	d̪ʊʃpəɾɪɳä̃ːm
फ़ीता	fiːt̪äː
ग्रीष्म	ɡɾiːʃmᵊ
बेहतरीन	beːɦt̪əɾĩːn̪
रज़ामंदी	ɾəd͡ʒäːmə̃n̪d̪iː
मक्का	mək̚käː
अकारथ	əkäːɾət̪ʰ
ख़ूबसूरती	kʰuːbs̪uːɾt̪iː
आगजनी	äːɡd͡ʒən̪iː
ईंधन	ĩːn̪d̪ʱə̃n̪
सफ़ेद	s̪əpʰeːd̪
शयनकक्ष	ʃəjə̃n̪kəkʃ
प्रक्षेप्य	pɾəkʃeːpjᵊ
व्यक्तित्व	ʋjəkt̪ɪt̪wᵊ
मुस्लिम	mʊs̪l̪ɪ̃m
तिरासी	t̪ɪɾäːs̪iː
अलम	əl̪ə̃m
विलास	ʋɪl̪äːs̪
से	s̪eː
साजन	s̪äːd͡ʒə̃n̪
धनादेश	d̪ʱən̪äːd̪eːʃ
शंतनु	ʃə̃n̪t̪ən̪uː
ठंड	ʈʰə̃ɳɖ
जुआ	d͡ʒʊäː
पंद्रह	pə̃n̪d̪ɾəɦ
क़ाबिल	qäːbɪl̪
शवयात्रा	ʃəʋjäːt̪ɾäː
तारख़ाना	t̪äːɾxäːn̪äː
अनकटा	ə̃n̪kəʈäː
अधिकारिता	əd̪ʱɪkäːɾɪt̪äː
मक़सद	məqs̪əd̪
निष्कासित	n̪ɪʃkäːs̪ɪt̪
सीना	s̪iːn̪äː
जनाज़ा	d͡ʒən̪äːd͡ʒäː
चंकट	t͡ʃə̃ŋkəʈ
शलगम	ʃəl̪ɡə̃m
बत्ती	bət̪̚t̪iː
फ़लसफ़ा	fəl̪s̪əfäː
फ़रमान	pʰəɾmä̃ːn̪
आतुरता	äːt̪ʊɾt̪äː
समाकलन	s̪əmäːkl̪ə̃n̪
मूल्यवान	muːl̪jəʋä̃ːn̪
फिरना	pʰɪɾn̪äː
जानवरो	d͡ʒä̃ːn̪wəɾoː
ता	t̪äː
पाजामा	päːd͡ʒäːmäː
अचकन	ət͡ʃkə̃n̪
सोना	s̪oːn̪äː
नाविक	n̪äːʋɪk
इनकार	ɪ̃n̪käːɾ
सरहदी	s̪əɾɦəd̪iː
बल्कि	bəl̪kiː
गरेबान	ɡəɾeːbä̃ːn̪
दास	d̪äːs̪
ओणम	oːɳə̃m
कोयला	koːjl̪aː
खान	kʰä̃ːn̪
सम्यक्	s̪ə̃mjək
पथरीला	pət̪ʰɾiːl̪äː
मानवाधिकार	mäːn̪əʋäːd̪ʱɪkäːɾ
आधुनिकता	äːd̪ʱʊn̪ɪkt̪äː
आपेक्षिक	äːpeːkʃɪk
सनसनीख़ेज़	s̪ə̃n̪s̪ən̪iːxeːz
बोलना	boːl̪n̪äː
रोज़मर्रा	ɾoːzməɾɾäː
षाण्मासिक	ʃä̃ːɳmäːs̪ɪk
कपिलवस्तु	kəpɪl̪ʋəs̪t̪uː
निहारिका	n̪ɪɦäːɾɪkäː
नाज़ुकी	n̪äːd͡ʒʊkiː
नगरीकृत	n̪əɡɾiːkɾɪt̪
चर्चा	t͡ʃəɾt͡ʃäː
सैनिक	s̪ɛːn̪ɪk
यानी	jäːn̪iː
झोंकना	d͡ʒʱõːŋkn̪äː
ऊँचाई	ũːt͡ʃäːiː
तसमा	t̪əs̪mäː
नक़दी	n̪əkd̪iː
ओलंदेज़	oːl̪ə̃n̪d̪eːd͡ʒ
विज्ञान	ʋɪɡjä̃ːn̪
तटस्थीकरण	t̪əʈəs̪t̪ʰiːkəɾə̃ɳ
सधुक्कड़ी	s̪əd̪ʱʊk̚kəɽiː
जिन्न	d͡ʒɪ̃n̪n̪ᵊ
इकासी	ɪkäːs̪iː
खाई	kʰäːiː
फ़ासिला	fäːs̪ɪl̪äː
क़ायदा	käːjd̪äː
समयसारणी	s̪əməjs̪äːɾɳiː
छल	t͡ʃʰəl̪
शुभेच्छु	ʃʊbʱeːt̚t͡ʃʰuː
बिल्ली	bɪl̪l̪iː
तंबू	t̪ə̃mbuː
स्थलीय	s̪t̪ʰəl̪iːjᵊ
कुसूर	kʊs̪uːɾ
तावीज़	t̪äːʋiːz
आयन	äːjə̃n̪
इलाक़ा	ɪl̪äːkäː
आफत	äːpʰət̪
संध्या	s̪ə̃n̪d̪ʱjäː
सुरक्षाबल	s̪ʊɾəkʃäːbəl̪
उत्तराखंड	ʊt̪̚t̪əɾäːkʰə̃ɳɖ
चंद्रबिंदु	t͡ʃə̃n̪d̪ɾəbɪ̃n̪d̪uː
अदावत	əd̪äːʋət̪
अखरना	əkʰəɾn̪äː
भुजंग	bʱʊd͡ʒə̃ŋɡ
हमारा	ɦəmäːɾäː
पछाड़ना	pət͡ʃʰäːɽn̪äː
रंडी	ɾə̃ɳɖiː
आग्रहपूर्वक	äːɡɾɛɦpuːɾʋək
जवा	d͡ʒəʋäː
इज्जत	ɪd̚d͡ʒət̪
टाँग	ʈä̃ːŋɡ
विध्वंस	ʋɪd̪ʱʋə̃n̪s̪
गुफ़ा	ɡʊfäː
मैदान	mɛːd̪ä̃ːn̪
तुलित	t̪ʊl̪ɪt̪
रेख़ता	ɾeːxt̪äː
मारवाड़ी	mäːɾʋäːɽiː
अपमानजनक	əpmä̃ːn̪d͡ʒən̪ək
हैज़ा	ɦɛːd͡ʒäː
सूत	s̪uːt̪
हमको	ɦə̃mkoː
परिवारवाद	pəɾɪʋäːɾʋäːd̪
गुस्ताख़	ɡʊs̪t̪äːkʰ
आगंतुक	äːɡə̃n̪t̪ʊk
मंत्री	mə̃n̪t̪ɾiː
हिमांक	ɦɪmä̃ːk
बेदख़ली	beːd̪əkʰl̪iː
धमनी	d̪ʱə̃mn̪iː
गिरफ़्तार	ɡɪɾəft̪äːɾ
सीरत	s̪iːɾət̪
बालटी	bäːl̪ʈiː
क़हर	qɛɦɛɾ
क्वारंटीन	kwäːɾə̃ɳʈĩːn̪
ईरानी	iːɾäːn̪iː
संहार	s̪ə̃ɦäːɾ
पासपोर्ट	päːs̪poːɾʈ
उपाध्याय	ʊpäːd̪ʱjäːj
क़बीला	kəbiːl̪äː
हथियार	ɦət̪ʰijäːɾ
प्रभावी	pɾəbʱäːʋiː
दैनिक	d̪ɛːn̪ɪk
क़ब्रिस्तान	kəbɾɪs̪t̪ä̃ːn̪
खटखटाना	kʰəʈkʰəʈäːn̪äː
प्रशासकीय	pɾəʃäːs̪əkiːjᵊ
रखवाला	ɾəkʰʋäːl̪äː
देखनेवाला	d̪eːkʰn̪eːʋäːl̪äː
अटल	əʈəl̪
सांड	s̪ä̃ːɳɖ
अंग्रेज़ी	ə̃ŋɡɾeːziː
देवता	d̪eːʋt̪äː
टेलीविज़न	ʈeːl̪iːʋɪd͡ʒə̃n̪
मुक़ाम	mʊqä̃ːm
लगभग	l̪əɡbʱəɡ
सूरज	s̪uːɾəd͡ʒ
फ़ाश	pʰäːʃ
चावल	t͡ʃäːʋəl̪
ब्रूनेई	bɾuːn̪eːiː
चलवाना	t͡ʃəl̪ʋäːn̪äː
मद्धम	məd̪̚d̪ʱə̃m
उन्मूलन	ʊ̃n̪muːl̪ə̃n̪
खाड़ी	kʰäːɽiː
धड़ल्ला	d̪ʱəɽəl̪l̪äː
मिसाइल	mɪs̪äːɪl̪
सार्वभौमिक	s̪äːɾʋəbʱɔːmɪk
कंबल	kə̃mbəl̪
प्रतिश्याय	pɾət̪ɪʃjäːj
वड़ोदरा	ʋəɽoːd̪ɾäː
ट्यूनिशिया	ʈjuːn̪ɪʃijäː
विवेचन	ʋɪʋeːt͡ʃə̃n̪
अफ़लातून	əfl̪äːt̪ũːn̪
तुलसी	t̪ʊl̪s̪iː
खराई	kʰəɾäːiː
दुराघ्री	d̪ʊɾäːɡʱɾiː
क़रार	qəɾäːɾ
सहयोग	s̪ɛɦjoːɡ
अखंड	əkʰə̃ɳɖ
ख़ुदा	xʊd̪äː
काम	kä̃ːm
सीठा	s̪iːʈʰäː
सभ्यता	s̪əbʱjət̪äː
अराजकवाद	əɾäːd͡ʒəkwäːd̪
अधिकार	əd̪ʱɪkäːɾ
शंघाई	ʃə̃ŋɡʱäːiː
प्लाविका	pl̪äːʋɪkäː
स्वर्गवासी	s̪ʋəɾɡʋäːs̪iː
शरीफ़ा	ʃəɾiːpʰäː
दफ़्तरशाह	d̪əpʰt̪əɾʃäːɦ
संप्रदाय	s̪ə̃mpɾəd̪äːj
संदेह	s̪ə̃n̪d̪eːɦ
करना	kəɾn̪äː
जुस्तजू	d͡ʒʊs̪t̪əd͡ʒuː
अविस्मरणीय	əʋɪs̪məɾəɳiːjᵊ
समाजवादी	s̪əmäːd͡ʒʋäːd̪iː
अलाव	əl̪äːʋ
चिरस्थायित्व	t͡ʃɪɾs̪t̪ʰäːjɪt̪wᵊ
तंज़ानिया	t̪ə̃zäːn̪ijäː
म्लेच्छ	ml̪eːt̚t͡ʃʰ
निगरानी	n̪ɪɡɾäːn̪iː
आकृत	äːkɾɪt̪
सर्विस	s̪əɾʋɪs̪
दूरदर्शन	d̪uːɾd̪əɾʃə̃n̪
रामचंद्र	ɾä̃ːmt͡ʃə̃n̪d̪ɾᵊ
जस्ता	d͡ʒəs̪t̪äː
असत्याभास	əs̪ət̪jäːbʱäːs̪
सजल	s̪əd͡ʒəl̪
स्मार्टफ़ोन	s̪mäːɾʈfõːn̪
इसको	ɪs̪koː
खाने	kʰäːn̪eː
अतिवाद	ət̪ɪʋäːd̪
हटाना	ɦəʈäːn̪äː
सोनार	s̪oːn̪äːɾ
अंत	ə̃n̪t̪
चान्द्र	t͡ʃä̃ːn̪d̪ɾᵊ
प्रयत्न	pɾəjət̪̚n̪ᵊ
मातृसत्ता	mäːt̪ɾɪs̪ət̪̚t̪äː
पकाना	pəkäːn̪äː
आइंस्टीनियम	äːɪ̃n̪s̪ʈiːn̪ijə̃m
नाजायज़	n̪äːd͡ʒäːjəz
लाना	l̪äːn̪äː
अज़ीम	əd͡ʒĩːm
उक़ाब	ʊkäːb
ताकि	t̪äːkiː
ष	ʃə
आलय	äːl̪əj
इंडोनेशियन	ɪ̃ɳɖoːn̪eːʃijə̃n̪
मादा	mäːd̪äː
कमरबंद	kəməɾbə̃n̪d̪
इंद्रिय	ɪ̃n̪d̪ɾɪj
कनटोप	kə̃n̪ʈoːp
साथ	s̪äːt̪ʰ
त्वरण	t̪wəɾə̃ɳ
सार्थ	s̪äːɾt̪ʰ
दान	d̪ä̃ːn̪
चांद्र	t͡ʃä̃ːn̪d̪ɾᵊ
इब्तिदा	ɪbt̪ɪd̪äː
अलबता	əl̪bət̪äː
अहिच्छत्र	əɦɪt̚t͡ʃʰət̪ɾᵊ
मर्मघातक	məɾməɡʱäːt̪ək
मुग़लिया	mʊɣl̪ijäː
संरक्षित	s̪ə̃ɾəkʃɪt̪
संदूक़	s̪ə̃n̪d̪uːk
बावला	bäːʋl̪äː
कीड़ा	kiːɽaː
काबुकी	käːbʊkiː
साया	s̪äːjäː
शराब	ʃəɾäːb
लेखक	l̪eːkʰək
बीमारी	biːmäːɾiː
क़ुल्फ़ी	kʊl̪pʰiː
तर्जुमा	t̪əɾd͡ʒʊmäː
वैचारिक	ʋɛːt͡ʃäːɾɪk
चांदी	t͡ʃä̃ːn̪d̪iː
निकलवाना	n̪ɪkəl̪ʋäːn̪äː
सिर्फ	s̪ɪɾf
अभागा	əbʱäːɡäː
योगिनी	joːɡɪn̪iː
भाखा	bʱäːkʰäː
छूटना	t͡ʃʰuːʈn̪äː
चेना	t͡ʃeːn̪äː
पल्ला	pəl̪l̪äː
आसरा	äːs̪ɾäː
बंदी	bə̃n̪d̪iː
हिस्सेदारी	ɦɪs̪s̪eːd̪äːɾiː
काग़ज	käːɡəd͡ʒ
बेरौनक़	beːɾɔːn̪ək
सूई	s̪uːiː
तकलीफ़देह	t̪əkl̪iːpʰd̪eːɦ
टांग	ʈä̃ːŋɡ
बहरी	bɛɦɾiː
बोलो	boːl̪oː
पद्धति	pəd̪̚d̪ʱət̪iː
स्नातकोत्तर	s̪n̪äːt̪əkoːt̪̚t̪əɾ
टेकना	ʈeːkn̪äː
लहजा	l̪ɛɦd͡ʒäː
भावुकता	bʱäːʋʊkt̪äː
इंजीनियर	ɪ̃n̪d͡ʒiːn̪ijəɾ
ख़रीदना	xəɾiːd̪̚n̪äː
मोहरा	moːɦɾäː
यहेज़क़ेल	jəɦeːzqeːl̪
चित्रकला	t͡ʃɪt̪ɾᵊkəl̪äː
उपकरण	ʊpkəɾə̃ɳ
दोषमुक्ति	d̪oːʃmʊkt̪iː
जोखिम	d͡ʒoːkʰɪ̃m
तख़ल्लुस	t̪əxəl̪l̪ʊs̪
फेसबुक	pʰeːs̪bʊk
चलचित्र	t͡ʃəl̪t͡ʃɪt̪ɾᵊ
कहाँ	kəɦä̃ː
अभियंत्रिकी	əbʱijə̃n̪t̪ɾɪkiː
ख़ानाबदोश	kʰäːn̪äːbəd̪oːʃ
पल	pəl̪
खाद्य	kʰäːd̪jə
हाज़िर	ɦäːd͡ʒɪɾ
नसीब	n̪əs̪iːb
असफलता	əs̪əpʰəl̪t̪äː
नवनी	n̪əʋn̪iː
कुर्नूल	kʊɾn̪uːl̪
उदजन	ʊd̪̚d͡ʒə̃n̪
यत्न	jət̪̚n̪ᵊ
काँख	kä̃ːkʰ
कहानीकार	kəɦäːn̪iːkäːɾ
आधिपत्य	äːd̪ʱɪpət̪jᵊ
विषयवस्तु	ʋɪʃəjʋəs̪t̪uː
छियालीस	t͡ʃʰijäːl̪iːs̪
लिवरपूल	l̪ɪʋəɾpuːl̪
मूर्तिमान	muːɾt̪iːmä̃ːn̪
मूलतः	muːl̪t̪əɦ
फलालैन	pʰəl̪äːl̪ɛ̃ːn̪
अन्तरिक्ष	ə̃n̪t̪əɾɪkʃ
स्तर	s̪t̪əɾ
हाज़िरजवाब	ɦäːzɪɾd͡ʒəʋäːb
बरज़बान	bəɾəd͡ʒbä̃ːn̪
गुलाम	ɣʊl̪ä̃ːm
अर्थहीन	əɾt̪ʰɦĩːn̪
विनोद	ʋɪn̪oːd̪
मल्लाह	məl̪l̪äːɦ
हटना	ɦəʈn̪äː
भौकाल	bʱɔːkäːl̪
सन्निकटन	s̪ə̃n̪n̪ɪkəʈə̃n̪
अस्थिपंजर	əs̪t̪ʰɪpə̃n̪d͡ʒəɾ
नाफ़	n̪äːf
ज़िम्बाब्वे	zɪ̃mbäːbweː
निस्सार	n̪ɪs̪s̪äːɾ
आखिर	äːxɪɾ
जनक	d͡ʒən̪ək
धावा	d̪ʱäːʋäː
फिल्मी	pʰɪl̪miː
कपास	kəpäːs̪
असंतोषजनक	əs̪ə̃n̪t̪oːʃd͡ʒən̪ək
फ़्रेन्चाइज़	pʰɾẽːn̪t͡ʃäːɪd͡ʒ
धमाका	d̪ʱəmäːkäː
बहुवचन	bɔɦɔʋət͡ʃə̃n̪
नाल	n̪äːl̪
समिट	s̪əmɪʈ
पटरा	pəʈɾäː
सामना	s̪ä̃ːmn̪äː
एमएलए	ẽːm‿eːl̪‿eː
मुहाफ़ज़ाह	mʊɦäːfzäːɦ
उपचुनाव	ʊpt͡ʃʊn̪äːʋ
इसका	ɪs̪käː
फ़ील्मी	fiːl̪miː
सन्दूक़चा	s̪ə̃n̪d̪uːkt͡ʃäː
क़ायम	käːjə̃m
मूर्खतापूर्ण	muːɾkʰt̪äːpuːɾɳ
स्वयं	s̪ʋəjə̃m
ज़ायक़ा	d͡ʒäːjkäː
रहना	ɾɛɦn̪äː
कमल	kəməl̪
अंजन	ə̃n̪d͡ʒə̃n̪
ख़ून	xũːn̪
इकतारा	ɪkt̪äːɾäː
सलवार	s̪əl̪ʋäːɾ
प्रचार	pɾət͡ʃäːɾ
साम्राज्यवाद	s̪ä̃ːmɾäːd͡ʒjəʋäːd̪
कन्द	kə̃n̪d̪
बहरा	bɛɦɾäː
नवाना	n̪əʋäːn̪äː
अमूल्य	əmuːl̪jᵊ
डायरी	ɖäːjɾiː
उन्हें	ʊ̃n̪ɦẽː
ब्रुनेई	bɾʊn̪eːiː
मुद्रणालय	mʊd̪ɾəɳäːl̪əj
लश्करी	l̪əʃkəɾiː
गलियारा	ɡəl̪ijäːɾäː
सत्तावन	s̪ət̪̚t̪äːʋə̃n̪
चुदाना	t͡ʃʊd̪äːn̪äː
अयनांत	əjən̪ä̃ːn̪t̪
अनचखा	ə̃n̪t͡ʃəkʰäː
संयुक्त	s̪ə̃jʊkt̪
दहला	d̪ɛɦl̪äː
मालीद	mäːl̪iːd̪
ख़र्चा	kʰəɾt͡ʃäː
राशन	ɾäːʃə̃n̪
अफीम	əfĩːm
बीस	biːs̪
चपाती	t͡ʃəpäːt̪iː
अम्लपित्त	ə̃ml̪əpɪt̪t̪
अखंडता	əkʰə̃ɳɖt̪äː
वाद्य	ʋäːd̪jᵊ
फेंक	pʰẽːŋk
चौड़ाई	t͡ʃɔːɽäːiː
ब्राह्मी	bɾäːɦmiː
ज़रिया	d͡ʒəɾijäː
यक़ीनन	jəqiːn̪ə̃n̪
जंगी	d͡ʒə̃ŋɡiː
स्तनधारी	s̪t̪ə̃n̪d̪ʱäːɾiː
प्राधिकार	pɾäːd̪ʱɪkäːɾ
मौसीक़ी	mɔːs̪iːkiː
दम्पति	d̪ə̃mpət̪iː
ब्याहना	bjäːɦn̪äː
प्रावधान	pɾäːʋd̪ʱä̃ːn̪
महफ़िल	mɛɦfɪl̪
असंतोष	əs̪ə̃n̪t̪oːʃ
बंगला	bə̃ŋɡl̪äː
फ़लक	fəl̪ək
निरोध	n̪ɪɾoːd̪ʱ
पुड़िया	pʊɽijäː
मकड़ा	məkɽäː
चार	t͡ʃäːɾ
पारसी	päːɾs̪iː
श्लोक	ʃl̪oːk
कहनी	kɛɦn̪iː
मज़ार	məd͡ʒäːɾ
अक़्लमंद	əql̪ᵊmə̃n̪d̪
जुलना	d͡ʒʊl̪n̪äː
ज़मीन	zəmĩːn̪
पचाना	pət͡ʃäːn̪äː
लिखना	l̪ɪkʰn̪äː
प्रसारित	pɾəs̪äːɾɪt̪
यात्रा	jäːt̪ɾäː
समाचारपत्र	s̪əmäːt͡ʃäːɾpət̪ɾᵊ
श्वान	ʃʋä̃ːn̪
अक्षत	əkʃət̪
क़ब्ज़ा	qəbzäː
अकस्मात्	əkəs̪mäːt̪
युद्धप्रिय	jʊd̪̚d̪ʱpɾijᵊ
जून	d͡ʒũːn̪
हरियाणा	ɦəɾijäːɳäː
अस्वस्थ	əs̪ʋəs̪t̪ʰ
महारत	məɦäːɾət̪
आह	äːɦ
मछुआ	mət͡ʃʰʊäː
बोतलबंद	boːt̪əl̪bə̃n̪d̪
उदारता	ʊd̪äːɾt̪äː
राख	ɾäːkʰ
मूत्राशय	muːt̪ɾäːʃəj
लुच्चा	l̪ʊt̚t͡ʃäː
कलेवा	kəl̪eːʋäː
मुहब्बत	mɔɦɔb̚bət̪
आलुक	äːl̪ʊk
अगरतला	əɡəɾt̪əl̪äː
ख़ुशमिज़ाज	xʊʃmɪzäːd͡ʒ
धर्मनिरपेक्ष	d̪ʱəɾmn̪ɪɾpeːkʃ
ख़ज़ाना	kʰəd͡ʒäːn̪äː
मोज़ांबीक	moːd͡ʒä̃ːmbiːk
ठिंगना	ʈʰɪ̃ŋɡn̪äː
बनाऊंगी	bən̪äːũːŋɡiː
सियाह	s̪ijäːɦ
फायदा	fäːjd̪äː
फूलना	pʰuːl̪n̪äː
उलटी	ʊl̪ʈiː
बंजर	bə̃n̪d͡ʒəɾ
भिषग्माता	bʱɪʃəɡmäːt̪äː
बंदा	bə̃n̪d̪äː
घड़ियाल	ɡʱəɽijäːl̪
इस्लामाबाद	ɪs̪l̪äːmäːbäːd̪
ज़कात	d͡ʒəkäːt̪
इसबग़ोल	ɪs̪bəɣoːl̪
हिन्दू	ɦɪ̃n̪d̪uː
विज्ञापित	ʋɪɡjäːpɪt̪
बौड़म	bɔːɽə̃m
फाल्गुन	pʰäːl̪ɡʊ̃n̪
आदिवासी	äːd̪ɪʋäːs̪iː
बहत्तर	bɛɦɛt̪̚t̪əɾ
आराम	äːɾä̃ːm
व्यजन	ʋjəd͡ʒə̃n̪
रटना	ɾəʈn̪äː
अनुमान	ən̪ʊmä̃ːn̪
रामरज	ɾä̃ːmɾəd͡ʒ
क़सीदा	kəs̪iːd̪äː
टिड्डा	ʈɪɖ̚ɖäː
गला	ɡəl̪äː
एडवायज़री	eːɖwäːjzəɾiː
ईक्वाडोर	iːkwäːɖoːɾ
मेरा	meːɾäː
राष्ट्रगान	ɾäːʃʈɾəɡä̃ːn̪
बौना	bɔːn̪äː
लजाना	l̪əd͡ʒäːn̪äː
स्वायत्त	s̪ʋäːjət̪t̪
जिंस	d͡ʒɪ̃n̪s̪
अत्फ़ाल	ət̪fäːl̪
अड़ंगा	əɽə̃ŋɡäː
सार्वजनिक	s̪äːɾʋd͡ʒən̪ɪk
मलिन	məl̪ɪ̃n̪
अर्धतत्सम	əɾd̪ʱət̪ət̪s̪ə̃m
आउट	äːʊʈ
शगूफ़ा	ʃəɡuːpʰäː
आयु	äːjuː
निरभिमान	n̪ɪɾəbʱɪmä̃ːn̪
जर्राह	d͡ʒəɾɾäːɦ
उत्साहित	ʊt̪s̪äːɦɪt̪
नेवला	n̪eːʋl̪äː
डिजिटल	ɖɪd͡ʒɪʈəl̪
सत्यापनों	s̪ət̪jäːpn̪õː
अपमान	əpmä̃ːn̪
सुचारु	s̪ʊt͡ʃäːɾuː
अनेकता	ən̪eːkt̪äː
रशिया	ɾəʃijäː
आधारित	äːd̪ʱäːɾɪt̪
छाल	t͡ʃʰäːl̪
हाय	ɦäːj
बिना	bɪn̪äː
नब्ज़	n̪əbz
ज़मीनी	zəmiːn̪iː
कमाऊ	kəmäːuː
मधुमक्खी	məd̪ʱʊmək̚kʰiː
चिंगहई	t͡ʃɪ̃ŋɡʱəiː
वरीयता	ʋəɾiːjt̪äː
तनख़्वाह	t̪ə̃n̪kʰʋäːɦ
इजमाली	ɪd͡ʒmäːl̪iː
इलज़ाम	ɪl̪zä̃ːm
ख़ालिस्तान	kʰäːl̪ɪs̪t̪ä̃ːn̪
फ़ीसद	pʰiːs̪əd̪
गांगुली	ɡä̃ːŋɡʊl̪iː
कृदंत	kɾɪd̪ə̃n̪t̪
आइसलैंड	äːɪs̪l̪ɛ̃ːɳɖ
मेहरबानी	meːɦɾbäːn̪iː
लेखनी	l̪eːkʰən̪iː
अंकारा	ə̃ŋkäːɾäː
राजस्व	ɾäːd͡ʒəs̪ʋᵊ
ग़लतफ़हमी	ɡəl̪ət̪pʰɛɦmiː
जनवरी	d͡ʒə̃n̪wəɾiː
ज़िंदगी	zɪ̃n̪d̪əɡiː
डाकख़ाना	ɖäːk̚kʰäːn̪äː
आमाशय	äːmäːʃəj
प्यार	pjäːɾ
बुलाकर	bʊl̪äːkəɾ
मोनाको	moːn̪äːkoː
ब्राज़िल	bɾäːzɪl̪
नन्हा	n̪ə̃n̪ɦäː
ग़मज़दा	ɡəməd͡ʒd̪äː
संभावना	s̪ə̃mbʱäːʋn̪äː
सबक	s̪əbək
सत्यापन	s̪ət̪jäːpə̃n̪
अग्रहायण	əɡɾəɦäːjə̃ɳ
आख़िरत	äːxɪɾət̪
कैंडी	kɛ̃ːɳɖiː
भाना	bʱäːn̪äː
पिंजड़ा	pɪ̃n̪d͡ʒɽäː
तर्जनी	t̪əɾd͡ʒən̪iː
अहिनाह	əɦɪn̪äːɦ
कुल	kʊl̪
साबू	s̪äːbuː
अत्यन्त	ət̪jə̃n̪t̪
अक़्ल	əqəl̪
शाखा	ʃäːkʰäː
अलहदा	əl̪ɛɦd̪äː
अनुष्ठान	ən̪ʊʃʈʰä̃ːn̪
कुचलना	kʊt͡ʃəl̪n̪äː
ईर्ष्या	iːɾʃjäː
वस्तु	ʋəs̪t̪uː
वंचित	ʋə̃n̪t͡ʃɪt̪
छुट्टी	t͡ʃʰʊʈ̚ʈiː
रसायनज्ञ	ɾəs̪äːjən̪əɡj
तजना	t̪əd͡ʒn̪äː
शगुन	ʃəɡʊ̃n̪
अर्दली	əɾd̪əl̪iː
इलाही	ɪl̪äːɦiː
ज़िन्दगी	zɪ̃n̪d̪əɡiː
हीन	ɦĩːn̪
मुलाज़िम	mʊl̪äːd͡ʒɪ̃m
पेन	pẽːn̪
कान्हा	kä̃ːn̪ɦäː
कांदा	kä̃ːn̪d̪äː
पुल	pʊl̪
होता	ɦoːt̪äː
इकतीस	ɪkt̪iːs̪
जुलूस	d͡ʒʊl̪uːs̪
युद्धस्थल	jʊd̪d̪ʱs̪t̪ʰəl̪
सर्वोदय	s̪əɾʋoːd̪əj
मां	mä̃ː
निर्देशन	n̪ɪɾd̪eːʃə̃n̪
चषक	t͡ʃəʃək
बतलाना	bət̪l̪äːn̪äː
तेंदुआ	t̪eːn̪d̪ʊaː
अट्ठानवे	əʈ̚ʈʰä̃ːn̪weː
जेल	d͡ʒeːl̪
भीमसरट	bʱĩːms̪əɾəʈ
रेडॉन	ɾeːɖɔ̃n̪
शिक्षक	ʃɪkʃək
सुथरा	s̪ʊt̪ʰɾäː
गोली	ɡoːl̪iː
सफेद	s̪əpʰeːd̪
कारख़ाना	käːɾxäːn̪äː
अंगड़ाई	ə̃ŋɡɽäːiː
वर्तुल	ʋəɾt̪ʊl̪
किराँची	kɪɾä̃ːt͡ʃiː
कमीनापन	kəmiːn̪äːpə̃n̪
चुल्ल	t͡ʃʊl̪l̪
आख़िरी	äːxɪɾiː
रिसाला	ɾɪs̪äːl̪äː
भगफल	bʱəɡpʰəl̪
मानस	mäːn̪əs̪
अखबार	əxbäːɾ
होनहार	ɦõːn̪ɦäːɾ
सम्मान	s̪ə̃mmä̃ːn̪
लोकप्रिय	l̪oːkəpɾɪj
कफ़न	kəfə̃n̪
बौछार	bɔːt͡ʃʰäːɾ
दिवसीय	d̪ɪʋs̪iːjᵊ
ख़ुलासा	kʰʊl̪äːs̪äː
कार्टून	käːɾʈũːn̪
मनोनीत	mən̪oːn̪iːt̪
बेटा	beːʈäː
इंसानी	ɪ̃n̪s̪äːn̪iː
सहमति	s̪ɛɦmət̪iː
हलदी	ɦəl̪d̪iː
नुस्ख़ा	n̪ʊs̪xäː
आकलन	äːkəl̪ə̃n̪
कनीज़	kən̪iːd͡ʒ
सुर्ख़ी	s̪ʊɾxiː
कुंडली	kʊ̃ɳɖl̪iː
सलीक़ा	s̪əl̪iːqäː
प्रिंस	pɾɪ̃n̪s̪
फैलना	pʰɛːl̪n̪äː
मोड़ना	moːɽn̪äː
आज़ाद	äːd͡ʒäːd̪
प्राकृतिक	pɾäːkɾɪt̪ɪk
दवाख़ाना	d̪əʋäːkʰäːn̪äː
संस्थान	s̪ə̃n̪s̪t̪ʰä̃ːn̪
आत्मप्रशंसा	äːt̪məpɾəʃə̃n̪s̪äː
पेशा	peːʃäː
मतगणना	mət̪ɡə̃ɳn̪äː
शिद्दत	ʃɪd̪̚d̪ət̪
गायक	ɡäːjək
स्थिति	s̪t̪ʰɪt̪iː
समाजसेवा	s̪əmäːd͡ʒs̪eːʋäː
मौसी	mɔːs̪iː
खदेड़ना	kʰəd̪eːɽn̪äː
भाद्र	bʱäːd̪ɾᵊ
प्रतिमा	pɾət̪ɪmäː
बब्बर	bəb̚bəɾ
क़हवा	kɛɦʋäː
अकेला	əkeːl̪äː
मृगतृष्णा	mɾɪɡt̪ɾɪʃɳäː
नोएडा	n̪oːeːɖäː
स्वतः	s̪ʋət̪əɦ
रामायणी	ɾäːmäːjəɳiː
नक्शा	n̪əqʃäː
कम्प	kə̃mp
बंटाना	bə̃ɳʈäːn̪äː
आकांक्षी	äːkä̃ːkʃiː
बलग़म	bəl̪ɣə̃m
तरक़्क़ी	t̪əɾək̚kiː
गुस्सा	ɣʊs̪s̪äː
शांतिपूर्ण	ʃä̃ːn̪t̪ɪpuːɾɳ
आवर्धन	äːʋəɾd̪ʱə̃n̪
अक्खा	ək̚kʰäː
जांघ	d͡ʒä̃ːŋɡʱ
पाल	päːl̪
जानबूझकर	d͡ʒä̃ːn̪buːd͡ʒʱkəɾ
ख़ूबानी	kʰuːbäːn̪iː
खेलना	kʰeːl̪n̪äː
प्रोत्साहन	pɾoːt̪s̪äːɦə̃n̪
मरियल	məɾijəl̪
दाख़िल	d̪äːxɪl̪
बोत्सवाना	boːt̪s̪ʋäːn̪äː
संकट	s̪ə̃ŋkəʈ
आत्मस्तुति	äːt̪məs̪t̪ʊt̪iː
नम्रता	n̪ə̃mɾət̪äː
बाट	bäːʈ
मालूम	mäːl̪ũːm
आयरलैंड	äːjəɾl̪ɛ̃ːɳɖ
लंबाई	l̪ə̃mbäːiː
शर्माना	ʃəɾmäːn̪äː
सहयोगी	s̪ɛɦjoːɡiː
रकाबी	ɾəkäːbiː
पक्षपात	pəkʃpäːt̪
तत्त्व	t̪ət̪̚t̪wᵊ
फसल	pʰəs̪əl̪
वज़न	ʋəd͡ʒə̃n̪
समुच्चयबोधक	s̪əmʊt̚t͡ʃəjboːd̪ʱək
कार्य	käːɾjᵊ
शिश्नों	ʃɪʃn̪õː
गाय	ɡäːj
बुड्ढी	bʊɖ̚ɖʱiː
बाजा	bäːd͡ʒäː
शाबाश	ʃäːbäːʃ
अंग्रेज़	ə̃ŋɡɾeːd͡ʒ
नालायक	n̪äːl̪äːjəq
डोली	ɖoːl̪iː
हँस	ɦə̃s̪
तीन	t̪ĩːn̪
रोड़ा	ɾoːɽäː
सारस	s̪äːɾəs̪
आतिशबाज़ी	äːt̪ɪʃbäːziː
फुलका	pʰʊl̪käː
चरवाहा	t͡ʃəɾʋäːɦäː
वापसी	ʋäːps̪iː
प्राधिकारी	pɾäːd̪ʱɪkäːɾiː
साहिब	s̪äːɦb
असल	əs̪əl̪
परिमाप	pəɾɪmäːp
बीड़ा	biːɽäː
मुर्ग़ाबी	mʊɾɡäːbiː
अंटार्कटिका	ə̃ɳʈäːɾkʈɪkäː
विज़ारत	ʋɪd͡ʒäːɾət̪
जोंक	d͡ʒõːŋk
शर्मीला	ʃəɾmiːl̪äː
लब्धि	l̪əbd̪ʱiː
जनरल	d͡ʒə̃n̪ɾəl̪
अहमदाबाद	ɛɦməd̪äːbäːd̪
पत्ती	pət̪̚t̪iː
बिकवाल	bɪkwäːl̪
मँगनी	mə̃ŋɡn̪iː
लुग़त	l̪ʊɣət̪
दवाखाना	d̪əʋäːkʰäːn̪äː
मील	miːl̪
शिश्न	ʃɪʃn̪ᵊ
पालथी	päːl̪t̪ʰiː
अवशोषित	əʋʃoːʃɪt̪
प्रारम्भ	pɾäːɾə̃mbʱ
सूनू	s̪uːn̪uː
पर्याय	pəɾjäːj
बड़बड़ाना	bəɽbəɽäːn̪äː
रेख़्ता	ɾeːxt̪äː
बोना	boːn̪äː
गुज़रना	ɡʊzəɾn̪äː
लोबिया	l̪oːbijäː
तामील	t̪äːmiːl̪
ग़द्दार	ɣəd̪̚d̪äːɾ
फ़र्ज़न्द	pʰəɾd͡ʒə̃n̪d̪
न्यूज़ीलैण्ड	n̪juːziːl̪ɛ̃ːɳɖ
चाल	t͡ʃäːl̪
सम्बन्धी	s̪ə̃mbə̃n̪d̪ʱiː
कुशासन	kʊʃäːs̪ə̃n̪
पक्का	pək̚käː
जवार	d͡ʒəʋäːɾ
नरम	n̪əɾə̃m
रक़बा	ɾəqbäː
बनारस	bən̪äːɾəs̪
शहद	ʃɛɦɛd̪
उपरांत	ʊpɾä̃ːn̪t̪
फ़ेसबुक	pʰeːs̪bʊk
वितरण	ʋɪt̪ɾə̃ɳ
सूद	s̪uːd̪
ख़ाक	kʰäːk
असहमत	əs̪ɛɦmət̪
च्वॉइस	t͡ʃʋɔɪs̪
कार्डिफ़	käːɾɖɪpʰ
इग्ज़ाम	ɪɡzä̃ːm
श्यामदेश	ʃjä̃ːmd̪eːʃ
घबराना	ɡʱəbɾäːn̪äː
दिल्लीवाला	d̪ɪl̪l̪iːʋäːl̪äː
अनुपयोगी	ən̪ʊpjoːɡiː
भोगना	bʱoːɡn̪äː
पुण्य	pʊ̃ɳjᵊ
अड़तालीस	əɽt̪äːl̪iːs̪
अभिवादन	əbʱɪʋäːd̪ə̃n̪
सूंघना	s̪ũːŋɡʱn̪äː
तड़पना	t̪əɽəpn̪äː
क़तरा	kət̪ɾäː
मुखाभिगम	mʊkʰäːbʱɪɡə̃m
आपदा	äːpd̪äː
झूम	d͡ʒʱũːm
आसमानी	äːs̪mäːn̪iː
आदान	äːd̪ä̃ːn̪
तावीज़	t̪äːʋiːd͡ʒ
फाफड़ा	pʰäːpʰɽäː
तरीक़ा	t̪əɾiːkäː
वाष्प	ʋäːʃp
फ़रमान	fəɾmä̃ːn̪
होनेवाला	ɦoːn̪eːʋäːl̪äː
एतराज़	eːt̪ɾäːd͡ʒ
लपकना	l̪əpəkn̪äː
सहवास	s̪ɛɦʋäːs̪
असुरक्षित	əs̪ʊɾəkʃɪt̪
मुष्टि	mʊʃʈiː
फ़िलीपीन्स	fɪl̪iːpĩːn̪s̪
गुरुत्व	ɡʊɾʊt̪wə
फ़ॉलोअर	pʰɔl̪oːəɾ
लंगराई	l̪ə̃ŋɡɾäːiː
सफल	s̪əpʰəl̪
पिज़्ज़ा	pɪd̚d͡ʒäː
छटा	t͡ʃʰəʈäː
भूतकाल	bʱuːt̪käːl̪
मामू	mäːmuː
सूखना	s̪uːkʰn̪äː
शिक्षाशास्त्री	ʃɪkʃäːʃäːs̪t̪ɾiː
तुर्किस्तान	t̪ʊɾkɪs̪t̪ä̃ːn̪
जिताना	d͡ʒɪt̪äːn̪äː
मुक़द्दर	mʊqəd̪̚d̪əɾ
साख	s̪äːkʰ
परिवार	pəɾɪʋäːɾ
विकिरण	ʋɪkɪɾə̃ɳ
ललकारना	l̪əl̪käːɾn̪äː
निकम्मा	n̪ɪkə̃mmäː
कसम	kəs̪ə̃m
मौसमी	mɔːs̪miː
हराना	ɦəɾäːn̪äː
फ़लसफ़ा	pʰəl̪s̪əpʰäː
माँदा	mä̃ːn̪d̪äː
खाना	kʰäːn̪äː
अपाहिज	əpäːɦɪd͡ʒ
विद्वान	ʋɪd̪wä̃ːn̪
तरेरना	t̪əɾeːɾn̪äː
भाषण	bʱäːʃə̃ɳ
जूड़ा	d͡ʒuːɽäː
जूता	d͡ʒuːt̪äː
राजनैतिक	ɾäːd͡ʒn̪ɛːt̪ɪk
आक	äːk
बेक़ाबू	beːkäːbuː
उपस्थित	ʊpəs̪t̪ʰɪt̪
मिश्रधातु	mɪʃɾəd̪ʱäːt̪uː
धज्जी	d̪ʱəd̚d͡ʒiː
संबोधित	s̪ə̃mboːd̪ʱɪt̪
मराना	məɾäːn̪äː
निज़ामाबाद	n̪ɪd͡ʒäːmäːbäːd̪
ग़ुस्ल	ɣʊs̪l̪
घनत्व	ɡʱən̪ət̪wᵊ
नुमाइंदगी	n̪ʊmäːɪ̃d̪əɡiː
वाजिब	ʋäːd͡ʒɪb
उषा	ʊʃäː
मरना	məɾn̪äː
साहित्यिक	s̪äːɦɪt̪jɪk
कामक्रिया	käːməkɾijäː
फ़िरंगी	pʰɪɾə̃ŋɡiː
गर्भाशय	ɡəɾbʱäːʃəj
जनूब	d͡ʒən̪uːb
किराया	kɪɾäːjäː
गुमशुदा	ɡʊ̃mʃʊd̪äː
लिखनेवाली	l̪ɪkʰn̪eːʋäːl̪iː
दार	d̪äːɾ
ऊबना	uːbn̪äː
इंदु	ɪ̃n̪d̪uː
समर्थक	s̪əməɾt̪ʰək
ताई	t̪äːiː
आधुनिकतम	äːd̪ʱʊn̪ɪkt̪ə̃m
प्रांगार	pɾä̃ːŋɡäːɾ
काग़ज़ात	käːɣzäːt̪
अभिलाषा	əbʱɪl̪äːʃäː
कौवा	kə̯uʋäː
ऐसा	ɛːs̪äː
अल्फ़ाज़	əl̪fäːz
आशिक़मिज़ाज	äːʃɪkmɪd͡ʒäːd͡ʒ
जननी	d͡ʒə̃n̪n̪iː
फ़ालसा	pʰäːl̪s̪äː
कविता	kəʋɪt̪äː
अम्माँ	ə̃mmä̃ː
अल्बम	əl̪bə̃m
एसोसिएशन	eːs̪oːs̪ɪeːʃə̃n̪
चिथड़ा	t͡ʃɪt̪ʰɽäː
ऐतराज़	ɛːt̪ɾäːd͡ʒ
बालक	bäːl̪ək
मखीजा	məkʰiːd͡ʒäː
प्रशिक्षण	pɾəʃɪkʃə̃ɳ
नारीवाद	n̪äːɾiːʋäːd̪
अम्मी	ə̃mmiː
हँसली	ɦə̃s̪l̪iː
रचना	ɾət͡ʃn̪äː
गलना	ɡəl̪n̪äː
तरबूज़ा	t̪əɾbuːzäː
फ़ायदा	pʰäːjd̪äː
उच्छेदन	ʊt̚t͡ʃʰeːd̪ə̃n̪
पहुँचाना	pɔɦɔ̃n̪t͡ʃäːn̪äː
वायु	ʋäːjuː
लंगड़ा	l̪ə̃ŋɡɽäː
गठबंधन	ɡəʈʰbə̃n̪d̪ʱə̃n̪
गवाही	ɡəʋäːɦiː
लिखाई	l̪ɪkʰäːiː
अंतर्राष्ट्रीय	ə̃n̪t̪əɾɾäːʃʈɾiːjᵊ
कन्दरा	kə̃n̪d̪əɾäː
नैन	n̪ɛ̃ːn̪
जमाना	zəmäːn̪äː
भड़काना	bʱəɽkäːn̪äː
कन्नड़	kə̃n̪n̪əɽ
तड़का	t̪əɽkäː
ख़राब	xəɾäːb
आदिम	äːd̪ɪ̃m
अलक़तरा	əl̪kət̪ɾäː
माफ़िया	mäːfijäː
पन्ना	pə̃n̪n̪äː
इज़हार	ɪd͡ʒʱäːɾ
कँगनी	kə̃ŋɡn̪iː
कमीशन	kəmiːʃə̃n̪
इस्लाम	ɪs̪l̪ä̃ːm
तुम्हारा	t̪ʊ̃mɦäːɾäː
मुख्यालय	mʊkʰjäːl̪əj
ख़लासी	xəl̪äːs̪iː
ज़ीरा	ziːɾäː
गायकी	ɡäːjəkiː
पहनना	pɛɦɛ̃n̪n̪äː
मसीहा	məs̪iːɦäː
काका	käːkäː
असमान	əs̪mä̃ːn̪
राब्ता	ɾäːbt̪äː
कैलकुलेटर	kɛːl̪kʊl̪eːʈəɾ
वेंटिलेटर	ʋẽːɳʈɪl̪eːʈəɾ
क्षयरोग	kʃəjɾoːɡ
गाली	ɡäːl̪iː
कट्टर	kəʈ̚ʈəɾ
पूर्वानुमान	puːɾʋäːn̪ʊmä̃ːn̪
ऐतिहासिक	ɛːt̪ɪɦäːs̪ɪk
दंश	d̪ə̃n̪ʃ
आँसू	ä̃ːs̪uː
कैंसर	kæ̃n̪s̪əɾ
खाता	kʰäːt̪äː
मुहतरम	mɔɦɔt̪ɾə̃m
फ़ारिग़	fäːɾɪɣ
ख़ुफ़िया	kʰʊpʰijäː
छात्रवृत्ति	t͡ʃʰäːt̪ɾəʋɾɪt̪̚t̪iː
समीकरण	s̪əmiːkəɾə̃ɳ
सलामी	s̪əl̪äːmiː
कंप्यूटर	kə̃mpjuːʈəɾ
जानवर	d͡ʒä̃ːn̪wəɾ
मक्खनफल	mək̚kʰə̃n̪pʰəl̪
आगाही	äːɡäːɦiː
चोदना	t͡ʃoːd̪̚n̪äː
पार्क	päːɾk
शाब्दिक	ʃäːbd̪ɪk
फफकना	pʰəpʰəkn̪äː
अंगूर	ə̃ŋɡuːɾ
न्यायिक	n̪jäːjɪk
आजीवन	äːd͡ʒiːʋə̃n̪
तलना	t̪əl̪n̪äː
माटी	mäːʈiː
ख़ुदावंद	kʰʊd̪äːʋə̃n̪d̪
बृहस्पति	bɾɪɦəs̪pət̪iː
जेद्दा	d͡ʒeːd̪̚d̪äː
परिवर्तन	pəɾɪʋəɾt̪ə̃n̪
अलक़तरा	əl̪qət̪ɾäː
बंदगी	bə̃n̪d̪əɡiː
स्वेदन	s̪ʋeːd̪ə̃n̪
शहमात	ʃɛɦmäːt̪
मौलवी	mɔːl̪ʋiː
वायुजनित	ʋäːjʊd͡ʒən̪ɪt̪
सनसनी	s̪ə̃n̪s̪ən̪iː
सताना	s̪ət̪äːn̪äː
मिसाल	mɪs̪äːl̪
अभिनंदन	əbʱɪn̪ə̃n̪d̪ə̃n̪
जज़ा	d͡ʒəzäː
नींव	n̪ĩːmw
गुम	ɡʊ̃m
ख़ालिस्तान	xäːl̪ɪs̪t̪ä̃ːn̪
ज्ञानमीमांसा	ɡjä̃ːn̪miːmä̃ːn̪s̪äː
भीषण	bʱiːʃə̃ɳ
साहसी	s̪äːɦs̪iː
खयालें	xəjäːl̪ẽː
दुर्भाग्यवश	d̪ʊɾbʱäːɡjəʋəʃ
एहतजाज	eːɦt̪əd͡ʒäːd͡ʒ
आश्रम	äːʃɾə̃m
प्याज	pjäːz
ज़ोरदार	d͡ʒoːɾd̪äːɾ
हंगरी	ɦə̃ŋɡɾiː
चक्रवृद्धि	t͡ʃəkɾəʋɾɪd̪̚d̪ʱiː
चिरस्थायी	t͡ʃɪɾs̪t̪ʰäːjiː
मेहनत	mɛɦn̪ət̪
पैग़ाम	pɛːɣä̃ːm
नचाना	n̪ət͡ʃäːn̪äː
हलवा	ɦəl̪ʋäː
बाज़	bäːd͡ʒ
क़ातिल	käːt̪ɪl̪
ज़रिया	zəɾijäː
ब्रैंपटन	bɾɛ̃ːmpʈə̃n̪
पादप	päːd̪əp
वफ़ादार	ʋəpʰäːd̪äːɾ
पार्थिव	päːɾt̪ʰɪʋ
कल	kəl̪
यथा	jət̪ʰäː
इसबगोल	ɪs̪bəɣoːl̪
उजड़ना	ʊd͡ʒəɽn̪äː
हालिया	ɦäːl̪ijäː
शतावर	ʃət̪äːʋəɾ
प्रवक्ता	pɾəʋəkt̪äː
अमानवीय	əmäːn̪əʋiːjᵊ
परगना	pəɾɡən̪äː
इमदाद	ɪ̃md̪äːd̪
नमस्कार	n̪əməs̪käːɾ
चलना	t͡ʃəl̪n̪äː
कसाई	kəs̪äːiː
चौकीदार	t͡ʃɔːkiːd̪äːɾ
स्क्रीनिंग	s̪kɾiːn̪ɪ̃ŋɡ
हिस्सा	ɦɪs̪s̪äː
जुर्माना	d͡ʒʊɾmäːn̪äː
आइस्ड	äːɪs̪ɖ
तीरंदाज़	t̪iːɾə̃n̪d̪äːd͡ʒ
अज़ान	əd͡ʒä̃ːn̪
अंकन	ə̃ŋkə̃n̪
दफ़ा	d̪əpʰäː
छाप	t͡ʃʰäːp
शिशुशाला	ʃɪʃʊʃäːl̪äː
तल्ख़ी	t̪əl̪kʰiː
फ़ासला	fäːs̪l̪äː
औज़ार	ɔːd͡ʒäːɾ
स्मेरता	s̪meːɾt̪äː
भागी	bʱäːɡiː
युगल	jʊɡəl̪
मास्को	mäːs̪koː
अम्ल	ə̃ml̪ᵊ
प्रस्ताव	pɾəs̪t̪äːʋ
अंतर्गत	ə̃n̪t̪əɾɡət̪
इसलिए	ɪs̪l̪ɪeː
हवेली	ɦəʋeːl̪iː
सुलभ	s̪ʊl̪əbʱ
साँवला	s̪ä̃ːʋl̪äː
जाम	d͡ʒä̃ːm
भगवाकरण	bʱəɡʋäːkəɾə̃ɳ
कम्बल	kə̃mbəl̪
मनस्वी	mən̪əs̪ʋiː
अंदाज	ə̃n̪d̪äːd͡ʒ
सट्टा	s̪əʈ̚ʈäː
पीनस	piːn̪əs̪
अफसर	əfs̪əɾ
सिफ़ारिश	s̪ɪpʰäːɾɪʃ
वरियाली	ʋəɾijäːl̪iː
ओझा	oːd͡ʒʱäː
अनुस्वार	ən̪ʊs̪ʋäːɾ
चंद्रगुप्त	t͡ʃə̃n̪d̪ɾəɡʊpt̪
उंडुकपुच्छ	ʊ̃ɳɖʊkpʊt̚t͡ʃʰ
ससुर	s̪əs̪ʊɾ
ज़हर	zɛɦɛɾ
मिटना	mɪʈn̪äː
तारीख़	t̪äːɾiːx
कोरियन	koːɾijə̃n̪
सफ़ाई	s̪əfäːiː
सुझाव	s̪ʊd͡ʒʱäːʋ
इसीलिए	ɪs̪iːl̪ɪeː
रौशन	ɾɔːʃə̃n̪
कामयाब	kä̃ːmjäːb
चुंबक	t͡ʃʊ̃mbək
तीसरा	t̪iːs̪ɾäː
ज़हरीला	d͡ʒɛɦɾiːl̪äː
आपबीती	äːp̚biːt̪iː
टैक्सी	ʈɛːks̪iː
कटना	kəʈn̪äː
आबकारी	äːbkäːɾiː
जहर	d͡ʒɛɦɛɾ
काली	käːl̪iː
होगा	ɦoːɡäː
कदन	kəd̪ə̃n̪
लिखी	l̪ɪkʰiː
इतिहासकार	ɪt̪ɪɦäːs̪käːɾ
रंगोली	ɾə̃ŋɡoːl̪iː
कढ़ाई	kəɽʱäːiː
जातिवाद	d͡ʒäːt̪ɪʋäːd̪
गरिमा	ɡəɾɪmäː
लफ़्ज़	l̪əfz
यूरेनियम	juːɾeːn̪ijə̃m
चुक़न्दर	t͡ʃʊqə̃n̪d̪əɾ
बंबई	bə̃mbəiː
मथुरा	mət̪ʰʊɾäː
बाढ़	bäːɽʱ
पाना	päːn̪äː
फ़ैज़ाबाद	pʰɛːd͡ʒäːbäːd̪
न्यास	n̪jäːs̪
स्वाहिली	s̪ʋäːɦɪl̪iː
रागी	ɾäːɡiː
गठन	ɡəʈʰə̃n̪
खनाखन	kʰən̪äːkʰə̃n̪
विकासशील	ʋɪkäːs̪ʃiːl̪
महाशय	məɦäːʃəj
स्वस्तिक	s̪ʋəs̪t̪ɪk
औषध	ɔːʃəd̪ʱ
सदस्य	s̪əd̪əs̪jᵊ
पाबंद	päːbə̃n̪d̪
सरस्वती	s̪əɾəs̪ʋət̪iː
विषुव	ʋɪʃʊʋ
आशंका	äːʃə̃ŋkäː
फ्रांसीसी	pʰɾä̃ːn̪s̪iːs̪iː
जमीन	zəmĩːn̪
बैठकबाज़	bɛːʈʰəkbäːz
निशानेबाज़ी	n̪ɪʃäːn̪eːbäːziː
अख़बार	əkʰbäːɾ
आक्रमण	äːkɾəmə̃ɳ
अर्धायु	əɾd̪ʱäːjuː
सिसकना	s̪ɪs̪əkn̪äː
मांसपेशी	mä̃ːn̪s̪peːʃiː
ठेला	ʈʰeːl̪äː
जुगनू	d͡ʒʊɡn̪uː
पैंतालीस	pɛ̃ːn̪t̪äːl̪iːs̪
फलों	pʰəl̪õː
अक्खड़	ək̚kʰəɽ
मारवाड़	mäːɾʋäːɽ
ख़ुशआमदीद	kʰʊʃəä̃ːmd̪iːd̪
दलबदलू	d̪əl̪bəd̪l̪uː
रहस्य	ɾɛɦɛs̪jᵊ
लिए	l̪ɪeː
फ़ालतू	fäːl̪t̪uː
क़ब्रिस्तान	qəbɾɪs̪t̪ä̃ːn̪
हँसाना	ɦə̃s̪äːn̪äː
आतंकवाद	äːt̪ə̃ŋkwäːd̪
मौला	mɔːl̪äː
निकट	n̪ɪkəʈ
शर्करा	ʃəɾkəɾäː
दीनार	d̪iːn̪äːɾ
आभास	äːbʱäːs̪
अनगढ़	ə̃n̪ɡəɽʱ
नवरात्रि	n̪əʋɾäːt̪ɾiː
अत्यंत	ət̪jə̃n̪t̪
सहस्रिमान	s̪ɛɦɛs̪ɾɪmä̃ːn̪
न्यूज़ीलैण्ड	n̪juːd͡ʒiːl̪ɛ̃ːɳɖ
मुग़ालता	mʊɡäːl̪t̪äː
शहंशाह	ʃɛɦɛ̃n̪ʃäːɦ
अज़रबैजान	əd͡ʒəɾbɛːd͡ʒä̃ːn̪
थोपना	t̪ʰoːpn̪äː
स्लोवेनिया	s̪l̪oːʋeːn̪ijäː
मज़ाक़	məzäːq
ह्रस्व	ɦɾəs̪ʋᵊ
ग़रारा	ɡəɾäːɾäː
सांप	s̪ä̃ːp
खुबानी	kʰuːbäːn̪iː
ग़ैरक़ानूनी	ɡɛːɾkäːn̪uːn̪iː
मस्तानी	məs̪t̪äːn̪iː
पेड़ा	peːɽäː
शिथिराति	ʃɪt̪ʰɪɾäːt̪iː
असमानता	əs̪əmä̃ːn̪t̪äː
व्यतिक्रम	ʋjət̪ɪkɾə̃m
ऊर्णा	uːɾɳäː
मातृभाषा	mäːt̪ɾɪbʱäːʃäː
हैवानियत	ɦɛːʋäːn̪ijət̪
खेल	kʰeːl̪
तना	t̪ən̪äː
लद्दाख़	l̪əd̪̚d̪äːkʰ
चैन	t͡ʃɛ̃ːn̪
गड़गड़ाना	ɡəɽɡəɽäːn̪äː
दवा	d̪əʋäː
पाठक	päːʈʰək
कड़वापन	kəɽʋäːpə̃n̪
होबार्ट	ɦoːbäːɾʈ
सादगी	s̪äːd̪əɡiː
तबाही	t̪əbäːɦiː
इतालवी	ɪt̪äːl̪ʋiː
आवाहन	äːʋäːɦə̃n̪
गाहक	ɡäːɦək
बादशाह	bäːd̪ʃäːɦ
अमृतसर	ə̃mɾɪt̪s̪əɾ
अलिखित	əl̪ɪkʰɪt̪
हेलिकॉप्टर	ɦeːl̪ɪkɔpʈəɾ
दाक्षिण्य	d̪äːkʃɪ̃ɳjᵊ
धान्य	d̪ʱä̃ːn̪jə
कमबख़्त	kə̃mbəxt̪
आफताब	äːft̪äːb
नीहारिका	n̪iːɦäːɾɪkäː
पनाह	pən̪äːɦ
उलीचना	ʊl̪iːt͡ʃn̪äː
हरामख़ोर	ɦəɾä̃ːmkʰoːɾ
हथेली	ɦət̪ʰeːl̪iː
कमज़ोर	kə̃mzoːɾ
मिठाई	mɪʈʰäːiː
गोलबंदी	ɡoːl̪bə̃n̪d̪iː
कलीसिया	kəl̪iːs̪ijäː
माली	mäːl̪iː
चाशनी	t͡ʃäːʃn̪iː
करौंदा	kəɾɔ̃ːn̪d̪äː
सुस्सा	s̪ʊs̪s̪äː
ताश	t̪äːʃ
तरण	t̪əɾə̃ɳ
बिछाना	bɪt͡ʃʰäːn̪äː
प्रतिकर्षण	pɾət̪ɪkəɾʃə̃ɳ
शादीशुदा	ʃäːd̪iːʃʊd̪äː
खाट	kʰäːʈ
न्यूज़	n̪juːz
आफ़ताब	äːft̪äːb
डोनट	ɖoːn̪əʈ
माइक्रोप्रोसेसर	mäːɪkɾoːpɾoːs̪eːs̪əɾ
आग़ा	äːɣäː
अस्तव्यस्त	əs̪t̪wjəs̪t̪
गड़गड़ाहट	ɡəɽɡəɽäːɦəʈ
राजग	ɾäːd͡ʒəɡ
बाधा	bäːd̪ʱäː
एकाधिकार	eːkäːd̪ʱɪkäːɾ
काल	käːl̪
सारणी	s̪äːɾɳiː
मिश्रण	mɪʃɾə̃ɳ
प्रसववेदना	pɾəs̪əʋʋeːd̪̚n̪äː
मृतप्राय	mɾɪt̪pɾäːj
पछत्तर	pət͡ʃʰət̪̚t̪əɾ
चारपाई	t͡ʃäːɾpäːiː
सिफ़ारिश	s̪ɪfäːɾɪʃ
लीड्स	l̪iːɖs̪
बंदिनी	bə̃n̪d̪ɪn̪iː
अनुसंधान	ən̪ʊs̪ə̃n̪d̪ʱä̃ːn̪
प्रशासक	pɾəʃäːs̪ək
अश्विनी	əʃʋɪn̪iː
दौड़ाई	d̪ɔːɽäːiː
क़द्रदान	kəd̪ɾəd̪ä̃ːn̪
भगवान	bʱəɡʋä̃ːn̪
इक्यानवे	ɪkjä̃ːn̪weː
दक्षिण	d̪əkʃɪ̃ɳ
दरोग़ा	d̪əɾoːɣäː
अल्पसंख्यक	əl̪ps̪ə̃ŋkʰjək
वज़न	ʋəzə̃n̪
सम्मिलित	s̪ə̃mmɪl̪ɪt̪
कमबख़्त	kə̃mbəkʰt̪
निन्यानवे	n̪ɪ̃n̪jä̃ːn̪weː
अबिचल	əbɪt͡ʃəl̪
क़सूर	kəs̪uːɾ
रात	ɾäːt̪
हवलदार	ɦəʋəl̪d̪äːɾ
सिलाई	s̪ɪl̪äːiː
रोशनी	ɾoːʃn̪iː
अहवाल	ɛɦʋäːl̪
गमछा	ɡə̃mt͡ʃʰäː
नाकाम	n̪äːkä̃ːm
ऋणदाताओं	ɾɪ̃ɳd̪äːt̪äːõː
घूसख़ोरी	ɡʱuːs̪xoːɾiː
निमंत्रण	n̪ɪmə̃n̪t̪ɾə̃ɳ
तल्ख़ी	t̪əl̪xiː
राजद	ɾäːd͡ʒəd̪
छक्का	t͡ʃʰək̚käː
ढिशूम	ɖʱɪʃũːm
अनुग्रह	ən̪ʊɡɾəɦ
अत्युत्तम	ət̪jʊt̪̚t̪ə̃m
माँजा	mä̃ːn̪d͡ʒäː
सादा	s̪äːd̪äː
ख़ानदान	xä̃ːn̪d̪ä̃ːn̪
चवालीस	t͡ʃəʋäːl̪iːs̪
हनुमान	ɦən̪ʊmä̃ːn̪
सेठ	s̪eːʈʰ
तिब्बती	t̪ɪb̚bət̪iː
मर्यादा	məɾjäːd̪äː
वाइन	ʋäːɪ̃n̪
शादी	ʃäːd̪iː
बंधुत्व	bə̃n̪d̪ʱʊt̪wᵊ
किचन	kɪt͡ʃə̃n̪
भविष्यवाणी	bʱəʋɪʃjəʋäːɳiː
बंद	bə̃n̪d̪
मुख़्तसर	mʊkʰt̪əs̪əɾ
निद्र	n̪ɪd̪ɾᵊ
सजाना	s̪əd͡ʒäːn̪äː
त्रिपुरा	t̪ɾɪpʊɾäː
परीक्षण	pəɾiːkʃə̃ɳ
ग़ौरतलब	ɡɔːɾt̪əl̪əb
मसनवी	məs̪n̪əʋiː
सलोना	s̪əl̪oːn̪äː
परमाणविक	pəɾmä̃ːɳwɪk
राखी	ɾäːkʰiː
पंडिताई	pə̃ɳɖɪt̪äːiː
पचना	pət͡ʃn̪äː
संस्कृत	s̪ə̃n̪s̪kɾɪt̪
जलाना	d͡ʒəl̪äːn̪äː
मुंतज़िम	mʊ̃n̪t̪əzɪ̃m
खयालो	kʰəjäːl̪oː
याददाश्त	jäːd̪̚d̪äːʃt̪
बेलना	beːl̪n̪äː
सूत्र	s̪uːt̪ɾᵊ
विद्युतदर्शी	ʋɪd̪jʊt̪̚d̪əɾʃiː
रत्ती	ɾət̪̚t̪iː
ब्राह्मणेतर	bɾäːɦməɳeːt̪əɾ
गाँववाला	ɡä̃ːʋʋäːl̪äː
कप्तान	kəpt̪ä̃ːn̪
रोज़ा	ɾoːzäː
बिलोना	bɪl̪oːn̪äː
बिरादर	bɪɾäːd̪əɾ
मजलिस	məd͡ʒl̪ɪs̪
वर्मा	ʋəɾmäː
नवविवाहित	n̪əʋʋɪʋäːɦɪt̪
अंगार	ə̃ŋɡäːɾ
हरियाणवी	ɦəɾijä̃ːɳwiː
खयाल	xəjäːl̪
अदा	əd̪äː
फ्रांस	pʰɾä̃ːn̪s̪
बरज़बान	bəɾəzbä̃ːn̪
फ़र्ज़ंद	pʰəɾd͡ʒə̃n̪d̪
कारतूस	käːɾt̪uːs̪
चाकलेट	t͡ʃäːkl̪eːʈ
नष्ट	n̪əʂʈ
ग़ायब	ɡäːjb
आज	äːd͡ʒ
उद्यान	ʊd̪jä̃ːn̪
फूल	pʰuːl̪
विवादित	ʋɪʋäːd̪ɪt̪
विभिन्न	ʋɪbʱɪ̃n̪n̪ᵊ
मना	mən̪äː
पसीना	pəs̪iːn̪äː
ओडिशा	oːɖɪʃäː
आंगन	ä̃ːɡə̃n̪
चपरासी	t͡ʃəpɾäːs̪iː
केलि	keːl̪iː
तारीख़	t̪äːɾiːkʰ
ज़माना	d͡ʒəmäːn̪äː
देवदार	d̪eːʋd̪äːɾ
रामायण	ɾäːmäːjə̃ɳ
उड़ना	ʊɽn̪äː
आख़िरी	äːkʰɪɾiː
निजीकरण	n̪ɪd͡ʒiːkəɾə̃ɳ
पखवाड़ा	pəkʰʋäːɽäː
मनश्चिकित्सक	mən̪əʃt͡ʃɪkɪt̪s̪ək
महबूब	mɛɦbuːb
दाहिना	d̪äːɦɪn̪äː
अवस्था	əʋəs̪t̪ʰäː
ग़लत	ɡəl̪ət̪
आर्यमन	äːɾjəmə̃n̪
ख़त्म	xət̪ə̃m
दमन	d̪əmə̃n̪
लिखावट	l̪ɪkʰäːʋəʈ
तवारीख़	t̪əʋäːɾiːx
फ़ज़ूल	pʰəd͡ʒuːl̪
हँसिया	ɦə̃s̪ijäː
छौंक	t͡ʃʰɔ̃ːŋk
बद्दू	bəd̪̚d̪uː
कहवा	kɛɦʋäː
लसन	l̪əs̪ə̃n̪
प्योंगयांग	pjõːŋɡjä̃ːŋɡ
चाह	t͡ʃäːɦ
जामनी	d͡ʒä̃ːmn̪iː
अनचाहा	ə̃n̪t͡ʃäːɦäː
लघु	l̪əɡʱuː
सामन	s̪äːmə̃n̪
अवशोषण	əʋʃoːʃə̃ɳ
इकरार	ɪqɾäːɾ
आक्षेप	äːkʃeːp
डाउनलोड	ɖäːʊ̃n̪l̪oːɖ
गाम	ɡä̃ːm
परदादी	pəɾd̪äːd̪iː
खोदना	kʰoːd̪̚n̪äː
वलीअहद	ʋəl̪iːɛɦɛd̪
सज्जा	s̪əd̚d͡ʒäː
सिफ़ारत	s̪ɪfäːɾət̪
अहबाब	ɛɦbäːb
कहलाना	kɛɦl̪äːn̪äː
सराफ़ा	s̪əɾäːpʰäː
तलाश	t̪əl̪äːʃ
डंडा	ɖə̃ɳɖäː
कलाई	kəl̪äːiː
वर्णमाला	ʋəɾɳmäːl̪äː
मासिक	mäːs̪ɪk
हनीमून	ɦən̪iːmũːn̪
निष्ठुर	n̪ɪʃʈʰʊɾ
आतिश	äːt̪ɪʃ
शयन	ʃəjə̃n̪
लेखन	l̪eːkʰə̃n̪
घसियारा	ɡʱəs̪ijäːɾäː
कारावास	käːɾäːʋäːs̪
उत्पत्ति	ʊt̪pət̪̚t̪iː
प्रायः	pɾäːjəɦ
शृंग	ʃɾɪ̃ŋɡ
ख़ानदानी	kʰä̃ːn̪d̪äːn̪iː
समामेलक	s̪əmäːmeːl̪ək
सर्वोच्च	s̪əɾʋoːt̚t͡ʃ
फूलों	pʰuːl̪õː
उत्तरदायित्व	ʊt̪̚t̪əɾd̪äːjɪt̪wᵊ
हसीन	ɦəs̪ĩːn̪
खड़ा	kʰəɽäː
गुस्ताख़	ɡʊs̪t̪äːx
तक़रीबन	t̪əkɾiːbə̃n̪
घेरना	ɡʱeːɾn̪äː
पूंडरी	pũːɳɖɾiː
सालगिरह	s̪äːl̪ɡɪɾəɦ
तरकारी	t̪əɾkäːɾiː
अस्पृश्यता	əs̪pɾɪʃjət̪äː
जपना	d͡ʒəpn̪äː
उदयवर्ष	ʊd̪əjʋəɾʃ
छांटना	t͡ʃʰä̃ːʈn̪äː
मंज़िल	mə̃zɪl̪
भांग	bʱä̃ːŋɡ
इकसठ	ɪks̪əʈʰ
अरसा	əɾs̪äː
समर्थ	s̪əməɾt̪ʰ
गांडू	ɡä̃ːɳɖuː
आधिक	äːd̪ʱɪk
नुस्ख़ा	n̪ʊs̪kʰäː
सुसज्जित	s̪ʊs̪əd̚d͡ʒɪt̪
नमक	n̪əmək
जामाता	d͡ʒäːmäːt̪äː
जगाना	d͡ʒəɡäːn̪äː
ग्वार	ɡʋäːɾ
उपनगर	ʊpn̪əɡəɾ
वीरता	ʋiːɾt̪äː
सारा	s̪äːɾäː
धकेलना	d̪ʱəkeːl̪n̪äː
मनसूब	mə̃n̪s̪uːb
सैंतीस	s̪ɛ̃ːn̪t̪iːs̪
महफ़ूज़	mɛɦfuːz
नमाज़गाह	n̪əmäːd͡ʒɡäːɦ
सुनसान	s̪ʊ̃n̪s̪ä̃ːn̪
चुगना	t͡ʃʊɡn̪äː
तरबूज़ा	t̪əɾbuːd͡ʒäː
शाल	ʃäːl̪
कुँआ	kʊ̃äː
सुन्दर	s̪ʊ̃n̪d̪əɾ
कली	kəl̪iː
आश्रय	äːʃɾəj
तस्दीक़	t̪əs̪d̪iːk
भोजन	bʱoːd͡ʒə̃n̪
दाख़िला	d̪äːkʰɪl̪äː
लोटपोट	l̪oːʈpoːʈ
इतराना	ɪt̪ɾäːn̪äː
ख़्वाजा	kʰʋäːd͡ʒäː
चिकित्सक	t͡ʃɪkɪt̪s̪ək
टेलिफ़ोन	ʈeːl̪ɪfõːn̪
ख़ालिस	xäːl̪ɪs̪
सूक्ष्मदर्शी	s̪uːkʃməd̪əɾʃiː
रीता	ɾiːt̪äː
बहुजन	bɔɦɔd͡ʒə̃n̪
क़ाबिल	käːbɪl̪
झंझट	d͡ʒʱə̃n̪d͡ʒʱəʈ
मुआवज़ा	mʊäːʋzäː
बहुराष्ट्रीय	bɔɦɔɾäːʃʈɾiːjᵊ
संपादकीय	s̪ə̃mpäːd̪əkiːjᵊ
बांग्लादेश	bä̃ːŋɡl̪äːd̪eːʃ
स्थितिज	s̪t̪ʰɪt̪ɪd͡ʒ
तिपहिया	t̪ɪpəiːjäː
क़ासिद	käːs̪ɪd̪
नादिरशाही	n̪äːd̪ɪɾʃäːɦiː
निषेधन	n̪ɪʃeːd̪ʱə̃n̪
नेता	n̪eːt̪äː
सूर्योदय	s̪uːɾjoːd̪əj
रौंदना	ɾɔ̃ːn̪d̪n̪äː
भिड़ना	bʱɪɽn̪äː
सेवानिवृत्ति	s̪eːʋäːn̪ɪʋɾɪt̪̚t̪iː
फ़रीदाबाद	fəɾiːd̪äːbäːd̪
वाहिका	ʋäːɦɪkäː
अयस्क	əjəs̪k
बस्त	bəs̪t̪
झुलसना	d͡ʒʱʊl̪əs̪n̪äː
पुनर्जन्म	pʊn̪əɾd͡ʒən̪ə̃m
निस्संदेह	n̪ɪs̪s̪ə̃n̪d̪eːɦ
गोरिल्ला	ɡoːɾɪl̪äː
चोल	t͡ʃoːl̪
बारूदख़ाना	bäːɾuːd̪kʰäːn̪äː
अंकित	ə̃ŋkɪt̪
नियम	n̪ijə̃m
लडकी	l̪əɽkiː
शैली	ʃɛːl̪iː
अक़्ल	əkəl̪
क्षति	kʃət̪iː
टिंडिश	ʈɪ̃ɳɖɪʃ
चुभना	t͡ʃʊbʱn̪äː
अहंकार	ɛɦɛ̃ŋkäːɾ
तलाव	t̪əl̪äːʋ
कंबोडिया	kə̃mboːɖijäː
नासिक	n̪äːs̪ɪk
ज्योतिष	d͡ʒjoːt̪ɪʃ
पैराग्वे	pɛːɾäːɡʋeː
रसोई	ɾəs̪oːiː
नीदरलैण्ड	n̪iːd̪əɾl̪ɛ̃ːɳɖ
अभियान	əbʱijä̃ːn̪
अपेक्षाकृत	əpeːkʃäːkɾɪt̪
राज्यपाल	ɾäːd͡ʒjəpäːl̪
बहिन	bəɦɪ̃n̪
ऑफ़िस	ɔpʰɪs̪
चवन्नी	t͡ʃəʋə̃n̪n̪iː
अमरीका	ə̃mɾiːkäː
दक्षिणपंथी	d̪əkʃɪ̃ɳpə̃n̪t̪ʰiː
उपवन	ʊpwə̃n̪
चाटना	t͡ʃäːʈn̪äː
कालजयी	käːl̪d͡ʒəjiː
नत्थी	n̪ət̪̚t̪ʰiː
बालक्रीड़ा	bäːl̪əkɾiːɽäː
नाचना	n̪äːt͡ʃn̪äː
विशेषकर	ʋɪʃeːʃkəɾ
औसत	ɔːs̪ət̪
जैकबाबाद	d͡ʒɛːkbäːbäːd̪
मर्दुम	məɾd̪ʊ̃m
आखेटक	äːkʰeːʈək
संग्रन्थन	s̪ə̃ŋɡɾə̃n̪t̪ʰə̃n̪
निष्कर्ष	n̪ɪʃkəɾʃ
सियोल	s̪ijoːl̪
अकारण	əkäːɾə̃ɳ
इस्तेमाल	ɪs̪t̪eːmäːl̪
आक्रामकता	äːkɾäːməkt̪äː
शख्सियत	ʃəxs̪ijət̪
एकजुटता	eːkd͡ʒʊʈt̪äː
अभियोग	əbʱijoːɡ
फ़लस्तीनी	fəl̪əs̪t̪iːn̪iː
अँगिया	ə̃ŋɡijäː
बैल	bɛːl̪
धुंधला	d̪ʱʊ̃n̪d̪ʱl̪äː
दग़ा	d̪əɣäː
सोलह	s̪oːl̪äːɦ
न्यूनतम	n̪jũːn̪t̪ə̃m
परोसा	pəɾoːs̪äː
मदमाता	məd̪mäːt̪äː
टकराना	ʈəkɾäːn̪äː
बनावटी	bən̪äːʋəʈiː
मारतौल	mäːɾt̪ɔːl̪
नमस्ते	n̪əməs̪t̪eː
रामल्लाह	ɾäːməl̪l̪äːɦ
चालक	t͡ʃäːl̪ək
अलार्म	əl̪ɑːɾm
बर्फ़ीला	bəɾpʰiːl̪äː
तरस्विनी	t̪əɾəs̪ʋɪn̪iː
यथार्थता	jət̪ʰäːɾt̪ʰət̪äː
अनुचित	ən̪ʊt͡ʃɪt̪
केन्द्र	kẽːn̪d̪ɾᵊ
बेसन	beːs̪ə̃n̪
उससे	ʊs̪s̪eː
साही	s̪äːɦiː
आसंका	äːs̪ə̃ŋkäː
भगवा	bʱəɡʋäː
रूस	ɾuːs̪
रक्षित	ɾəkʃɪt̪
खिंचाव	kʰɪ̃n̪t͡ʃäːʋ
समन्वय	s̪əmə̃n̪wəj
अनुशीलन	ən̪ʊʃiːl̪ə̃n̪
रज़ामंद	ɾəd͡ʒäːmə̃n̪d̪
चुंबकत्व	t͡ʃʊ̃mbəkət̪wᵊ
प्रचारी	pɾət͡ʃäːɾiː
हालात	ɦäːl̪äːt̪
मॉल	mɔl̪
विश्वविद्यालय	ʋɪʃʋəʋɪd̪jäːl̪əj
ख़ुशाब	xʊʃäːb
अस्पताल	əs̪pət̪äːl̪
मिज़ोरम	mɪzoːɾə̃m
अकर्मण्यता	əkəɾmə̃ɳjət̪äː
ज़बान	d͡ʒəbä̃ːn̪
लपेटना	l̪əpeːʈn̪äː
दाढ़	d̪äːɽʱ
दिनांकित	d̪ɪn̪ä̃ːkɪt̪
आशावाद	äːʃäːʋäːd̪
नदियाँ	n̪əd̪ijä̃ː
सियालकोट	s̪ijäːl̪koːʈ
अर्यमा	əɾjəmäː
गुज़रना	ɡʊd͡ʒəɾn̪äː
चुक़ंदर	t͡ʃʊkə̃n̪d̪əɾ
आहत	äːɦət̪
अंग्रेज़ियत	ə̃ŋɡɾeːzijət̪
निज़ाम	n̪ɪd͡ʒä̃ːm
आठवाँ	äːʈʰʋä̃ː
मिस्र	mɪs̪ɾ
छिपकली	t͡ʃʰɪpkəl̪iː
पाजी	päːd͡ʒiː
न्यायोचित	n̪jäːjoːt͡ʃɪt̪
चलन	t͡ʃəl̪ə̃n̪
आकांक्षा	äːkä̃ːkʃäː
अंदाज़	ə̃n̪d̪äːz
फ़ोन	pʰõːn̪
धरातल	d̪ʱəɾäːt̪əl̪
कन्नौज	kə̃n̪n̪ɔːd͡ʒ
चरखा	t͡ʃəɾkʰäː
आत्मसंमान	äːt̪məs̪ə̃mmä̃ːn̪
अपेक्षा	əpeːkʃäː
गुणा	ɡʊɳäː
पौंड	pɔ̃ːɳɖ
इमला	ɪ̃ml̪äː
दाग़	d̪äːɡ
सुलवाना	s̪ʊl̪ʋäːn̪äː
चिली	t͡ʃɪl̪iː
जाल	d͡ʒäːl̪
बियाबान	bijäːbä̃ːn̪
निर्जीव	n̪ɪɾd͡ʒiːʋ
मद्देनज़र	məd̪̚d̪eːn̪əzəɾ
सम्पत्ति	s̪ə̃mpət̪̚t̪iː
रेतना	ɾeːt̪̚n̪äː
रज़ाकार	ɾəd͡ʒäːkäːɾ
ख़ाका	xäːkäː
सत्य	s̪ət̪jᵊ
फ़ेहरिस्त	feːɦɾɪs̪t̪
इजाजत	ɪd͡ʒäːd͡ʒət̪
घूसख़ोर	ɡʱuːs̪kʰoːɾ
इंक़िलाब	ɪ̃ŋkɪl̪äːb
पौधा	pɔːd̪ʱäː
दोष	d̪oːʃ
घर्षण	ɡʱəɾʃə̃ɳ
चीना	t͡ʃiːn̪äː
चरना	t͡ʃəɾn̪äː
नदियों	n̪əd̪ijõː
भ्रूण	bʱɾũːɳ
अफरना	əpʰəɾn̪äː
धनी	d̪ʱən̪iː
इनायत	ɪn̪äːjət̪
परिसर	pəɾɪs̪əɾ
सनक	s̪ən̪ək
शर्मिंदगी	ʃəɾmɪ̃n̪d̪ɡiː
निरोग	n̪ɪɾoːɡ
सलीक़ा	s̪əl̪iːkäː
बुढ़ाना	bʊɽʱäːn̪äː
वाष्पन	ʋäːʃpə̃n̪
तनख़्वाह	t̪ə̃n̪xäːɦ
स्वीकृत	s̪ʋiːkɾɪt̪
अठन्नी	əʈʰə̃n̪n̪iː
सर्ब	s̪əɾb
विष्णु	ʋɪʃɳuː
इसी	ɪs̪iː
महाभियोग	məɦäːbʱijoːɡ
परछाईं	pəɾt͡ʃʰäːĩː
नीतिगत	n̪iːt̪ɪɡət̪
जनेऊ	d͡ʒən̪eːuː
चीन	t͡ʃĩːn̪
धुलना	d̪ʱʊl̪n̪äː
पारिश्रमिक	päːɾɪʃɾəmɪk
कोहनी	koːɦn̪iː
गंध	ɡə̃n̪d̪ʱ
संन्यासिनी	s̪ə̃n̪n̪jäːs̪ɪn̪iː
कमली	kə̃ml̪iː
बंगाली	bə̃ŋɡäːl̪iː
क़फ़स	kəpʰəs̪
भूभाग	bʱuːbʱäːɡ
मुर्ग़ाबी	mʊɾɣäːbiː
एतराज़	eːt̪ɾäːz
मक़दूनिया	məkd̪uːn̪ijäː
फ़रात	fəɾäːt̪
उनासी	ʊn̪äːs̪iː
दवाखाना	d̪əʋäːxäːn̪äː
दाड़िम	d̪äːɽɪ̃m
अबाबील	əbäːbiːl̪
लगाना	l̪əɡäːn̪äː
कम्बोडिया	kə̃mboːɖijäː
नॉर्वे	n̪ɔɾʋeː
भेजना	bʱeːd͡ʒn̪äː
सकार	s̪əkäːɾ
ताप	t̪äːp
निम्न	n̪ɪ̃mn̪ᵊ
मुहर्रम	mɔɦɔɾɾə̃m
जीवनी	d͡ʒiːʋn̪iː
करेला	kəɾeːl̪äː
लफड़ा	l̪əpʰɽäː
निर्घोष	n̪ɪɾɡʱoːʃ
च्यवनप्राश	t͡ʃjəʋə̃n̪pɾäːʃ
ज़िंदाबाद	d͡ʒɪ̃n̪d̪äːbäːd̪
ख़ाक	xäːk
अंबु	ə̃mbuː
सालभर	s̪äːl̪bʱəɾ
मुलाक़ात	mʊl̪äːkäːt̪
जाति	d͡ʒäːt̪iː
नोटबंदी	n̪oːʈbə̃n̪d̪iː
खींचना	kʰĩːt͡ʃn̪äː
पंछी	pə̃n̪t͡ʃʰiː
टोस्ट	ʈoːs̪ʈ
दरगाह	d̪əɾɡäːɦ
पठान	pəʈʰä̃ːn̪
लेखाचित्र	l̪eːkʰäːt͡ʃɪt̪ɾᵊ
बेइज़्ज़ती	beːɪd̚d͡ʒət̪iː
लंगोटी	l̪ə̃ŋɡoːʈiː
छापाख़ाना	t͡ʃʰäːpäːxäːn̪äː
ताया	t̪äːjäː
नख़लिस्तान	n̪əxl̪ɪs̪t̪ä̃ːn̪
आशिक़ी	äːʃɪkiː
खुरपा	kʰʊɾpäː
लोचा	l̪oːt͡ʃäː
जहाज	d͡ʒəɦäːd͡ʒ
दिमाग़	d̪ɪmäːɡ
रणछोड़	ɾə̃ɳt͡ʃʰoːɽ
जानवरों	d͡ʒä̃ːn̪wəɾõː
गुदाद्वार	ɡʊd̪äːd̪wäːɾ
शर्म	ʃəɾə̃m
सरोरुह	s̪əɾoːɾʊɦ
पड़ोसिन	pəɽoːs̪ɪ̃n̪
उपपत्ति	ʊp̚pət̪̚t̪iː
वृद्धि	ʋɾɪd̪̚d̪ʱiː
कंदुक	kə̃n̪d̪ʊk
खनित्र	kʰən̪ɪt̪ɾᵊ
हिंदवी	ɦɪ̃n̪d̪wiː
नाता	n̪äːt̪äː
फ़ुर्सत	pʰʊɾs̪ət̪
द्राक्षिरा	d̪ɾäːkʃɪɾäː
तालाब	t̪äːl̪äːb
प्रक्रम	pɾəkɾə̃m
अधिसूचना	əd̪ʱɪs̪uːt͡ʃn̪äː
जलाशय	d͡ʒəl̪äːʃəj
दिनभर	d̪ɪ̃n̪bʱəɾ
छेड़छाड़	t͡ʃʰeːɽt͡ʃʰäːɽ
आध्यात्मिक	äːd̪ʱjäːt̪mɪk
गौरवान्वित	ɡɔːɾəʋä̃ːn̪wɪt̪
गहन	ɡɛɦɛ̃n̪
बटालियन	bəʈäːl̪ijə̃n̪
आक्रामक	äːkɾäːmək
पाँचवाँ	pä̃ːt͡ʃʋä̃ː
इसरो	ɪs̪ɾoː
सुधारवादी	s̪ʊd̪ʱäːɾʋäːd̪iː
कदाचित्	kəd̪äːt͡ʃɪt̪
व्याकुल	ʋjäːkʊl̪
पत्थर	pət̪̚t̪ʰəɾ
दगला	d̪əɡl̪äː
बुंदेलखंड	bʊ̃n̪d̪eːl̪kʰə̃ɳɖ
कार्यक्रम	käːɾjəkɾə̃m
विज्ञापन	ʋɪɡjäːpə̃n̪
शुक्रगुज़ार	ʃʊkɾəɡʊd͡ʒäːɾ
हरियाली	ɦəɾijäːl̪iː
इस्तीफ़ा	ɪs̪t̪iːfäː
गम्भीर	ɡə̃mbʱiːɾ
अंतराल	ə̃n̪t̪əɾäːl̪
व्युत्पत्ति	ʋjʊt̪pət̪̚t̪iː
निर्वाचन	n̪ɪɾʋäːt͡ʃə̃n̪
पुर्तगाली	pʊɾt̪əɡäːl̪iː
घटिया	ɡʱəʈijäː
अंत्र	ə̃n̪t̪ɾᵊ
तमंचा	t̪əmə̃n̪t͡ʃäː
सहकारी	s̪ɛɦkäːɾiː
बाध्य	bäːd̪ʱjᵊ
बख़्शना	bəkʰʃn̪äː
एहतियात	eːɦt̪ijäːt̪
शरमाना	ʃəɾmäːn̪äː
नियमावली	n̪ijəmäːʋəl̪iː
ऊर्ध्ववायु	uːɾd̪ʱʋəʋäːjuː
चूना	t͡ʃuːn̪äː
मह्ल	mɛɦl̪ᵊ
फ़िल्म	pʰɪl̪ə̃m
जाँचना	d͡ʒä̃ːt͡ʃn̪äː
नोटिस	n̪oːʈɪs̪
ढोका	ɖʱoːkäː
अमल	əməl̪
जमात	d͡ʒəmäːt̪
मालदार	mäːl̪d̪äːɾ
जूलाई	d͡ʒuːl̪äːiː
माल्टा	mäːl̪ʈäː
अनुपूरक	ən̪ʊpuːɾək
लुटेरा	l̪ʊʈeːɾäː
दलाल	d̪əl̪äːl̪
सहना	s̪ɛɦn̪äː
बात	bäːt̪
यहाँ	jəɦä̃ː
साफ़	s̪äːf
प्राच्यलवक	pɾäːt͡ʃjəl̪əʋək
आम	ä̃ːm
लौहपथगामिनी	l̪ɔːɦpət̪ʰɡäːmɪn̪iː
इंस्पेक्टर	ɪ̃n̪s̪peːkʈəɾ
मुझसे	mʊd͡ʒʱs̪eː
तबादला	t̪əbäːd̪l̪äː
अंगूठा	ə̃ŋɡuːʈʰäː
अग्नि	əɡn̪iː
मिन्नत	mɪ̃n̪n̪ət̪
संसार	s̪ə̃n̪s̪äːɾ
इंटेल	ɪ̃ɳʈeːl̪
दृढ़तापूर्वक	d̪ɾɪɽʱt̪äːpuːɾʋək
दाल	d̪äːl̪
अनुपजाऊ	ən̪ʊpd͡ʒäːuː
घायल	ɡʱäːjəl̪
दफ़नाना	d̪əfn̪äːn̪äː
आखिरी	äːkʰɪɾiː
लड्डू	l̪əɖ̚ɖuː
वेश्या	ʋeːʃjäː
युद्धक	jʊd̪̚d̪ʱək
स्वार्थ	s̪ʋäːɾt̪ʰ
भेदभाव	bʱeːd̪bʱäːʋ
प्रकाशन	pɾəkäːʃə̃n̪
ख़ंजर	xə̃n̪d͡ʒəɾ
अखबार	əkʰbäːɾ
कलह	kəl̪əɦ
भर्त्सना	bʱəɾt̪s̪ən̪äː
देहात	d̪eːɦäːt̪
थैला	t̪ʰɛːl̪äː
क़व्वाल	qəʋʋäːl̪
अर्थात	əɾt̪ʰäːt̪
देखभाल	d̪eːkʰbʱäːl̪
एल्युमिनियम	eːl̪jʊmɪn̪ijə̃m
क़ैदख़ाना	kɛːd̪kʰäːn̪äː
माजूफल	mäːd͡ʒuːpʰəl̪
न्यूज़ीलैंड	n̪juːd͡ʒiːl̪ɛ̃ːɳɖ
बस	bəs̪
नामंज़ूर	n̪äːmə̃d͡ʒuːɾ
इग्लू	ɪɡl̪uː
पक्षपातपूर्ण	pəkʃpäːt̪puːɾɳ
तारीफ	t̪äːɾiːf
सम्मिलन	s̪ə̃mmɪl̪ə̃n̪
जताना	d͡ʒət̪äːn̪äː
प्रत्यक्षदर्शी	pɾət̪jəkʃd̪əɾʃiː
कयामत	qəjäːmət̪
भरनी	bʱəɾn̪iː
इंतकाल	ɪ̃n̪t̪əkäːl̪
रसोइया	ɾəs̪oːijäː
भालू	bʱäːl̪uː
जनतंत्र	d͡ʒə̃n̪t̪ə̃n̪t̪ɾᵊ
कांसी	kä̃ːn̪s̪iː
ख़ता	xət̪äː
उतरवाना	ʊt̪əɾʋäːn̪äː
पीरियड	piːɾijəɖ
माँ	mä̃ː
दादा	d̪äːd̪äː
गायन	ɡäːjə̃n̪
सरल	s̪əɾəl̪
औद्योगीकरण	ɔːd̪joːɡiːkəɾə̃ɳ
कम्पित	kə̃mpɪt̪
भजन	bʱəd͡ʒə̃n̪
क़त्ल	kət̪l̪
आदमी	äːd̪miː
चाचा	t͡ʃäːt͡ʃäː
चोग़ा	t͡ʃoːɣäː
गगनचुंबी	ɡəɡə̃n̪t͡ʃʊ̃mbiː
बाहुबली	bäːɦʊbəl̪iː
इरादतन	ɪɾäːd̪̚t̪ə̃n̪
नक़ली	n̪əql̪iː
मलाल	məl̪äːl̪
बिटिया	bɪʈijäː
नुसख़ा	n̪ʊs̪kʰäː
स्वामित्व	s̪ʋäːmɪt̪wᵊ
रामबाण	ɾä̃ːmbä̃ːɳ
प्रशंसक	pɾəʃə̃n̪s̪ək
दावा	d̪äːʋäː
शक्तिहीन	ʃəkt̪ɪɦĩːn̪
निराशा	n̪ɪɾäːʃäː
तीस	t̪iːs̪
धनतेरस	d̪ʱə̃n̪t̪eːɾəs̪
क्षमा	kʃəmäː
बंधु	bə̃n̪d̪ʱuː
एकदम	eːkd̪ə̃m
जुड़वाँ	d͡ʒʊɽʋä̃ː
पारगम्यता	päːɾɡə̃mjət̪äː
डिंभ	ɖɪ̃mbʱ
प्रहार	pɾəɦäːɾ
आत्मबोध	äːt̪məboːd̪ʱ
आँचलिक	ä̃ːt͡ʃl̪ɪk
कगार	kəɡäːɾ
क़द्दावर	qəd̪̚d̪äːʋəɾ
ख़ज़ाना	xəzäːn̪äː
पतंगबाज़ी	pət̪ə̃ŋɡbäːd͡ʒiː
संवत्सरी	s̪ə̃mwət̪s̪əɾiː
आइज़ोल	äːɪd͡ʒoːl̪
पुस्तकालय	pʊs̪t̪əkäːl̪əj
स्मरणीय	s̪məɾɳiːjᵊ
दूधिया	d̪uːd̪ʱijäː
अँग्रेज़ी	ə̃ŋɡɾeːziː
शतपाद	ʃət̪päːd̪
बहनोई	bɛɦn̪oːiː
तकलीफ़	t̪əkl̪iːpʰ
एकतरफ़ा	eːkt̪əɾpʰäː
अनुपात	ən̪ʊpäːt̪
मदार	məd̪äːɾ
भूमंडलीय	bʱuːmə̃ɳɖəl̪iːjᵊ
छियासी	t͡ʃʰijäːs̪iː
बाल	bäːl̪
लाभदायक	l̪äːbʱd̪äːjək
इंजन	ɪ̃n̪d͡ʒə̃n̪
लंड	l̪ə̃ɳɖ
खयालों	xəjäːl̪õː
अठहत्तर	əʈʰɦət̪̚t̪əɾ
प्रतिबंधित	pɾət̪ɪbə̃n̪d̪ʱɪt̪
बैतनिय्याह	bɛːt̪ən̪ɪjjäːɦ
अकादमी	əkäːd̪miː
सलाख	s̪əl̪äːkʰ
तुग़लक़	t̪ʊɣl̪əq
संयंत्र	s̪ə̃jə̃n̪t̪ɾᵊ
असहाय	əs̪ɦäːj
अदालती	əd̪äːl̪ət̪iː
साहित्य	s̪äːɦɪt̪jᵊ
आडवाणी	äːɖwäːɳiː
आर्थिक	äːɾt̪ʰɪk
नाखून	n̪äːxũːn̪
कटाई	kəʈäːiː
उल्टी	ʊl̪ʈiː
पंखा	pə̃ŋkʰäː
उसे	ʊs̪eː
नैना	n̪ɛːn̪äː
छोटा	t͡ʃʰoːʈäː
शहादत	ʃəɦäːd̪ət̪
पत्थरबाज़ी	pət̪̚t̪ʰəɾbäːziː
आर्मेनियन	äːɾmeːn̪ijə̃n̪
शिक्षिका	ʃɪkʃɪkäː
सैंतालीस	s̪ɛ̃ːn̪t̪äːl̪iːs̪
बैसाखी	bɛːs̪äːkʰiː
लहज़ा	l̪ɛɦzäː
शासक	ʃäːs̪ək
परिषद	pəɾɪʃəd̪
बेदख़ल	beːd̪əxl̪ᵊ
उम्रक़ैद	ʊ̃mɾəqɛːd̪
आहुति	äːɦʊt̪iː
प्रश्न	pɾəʃn̪ᵊ
अधीक्षक	əd̪ʱiːkʃək
आँगन	ä̃ːɡə̃n̪
सानी	s̪äːn̪iː
माल	mäːl̪
ढूंढ	ɖʱũːɳɖʱ
जाँच	d͡ʒä̃ːt͡ʃ
लाड़	l̪äːɽ
स्तूप	s̪t̪uːpəᵊ
आहट	äːɦəʈ
विषम	ʋɪʃə̃m
सहोदर	s̪əɦoːd̪əɾ
गिरजा	ɡɪɾd͡ʒäː
ऋणदाता	ɾɪ̃ɳd̪äːt̪äː
ओमान	oːmä̃ːn̪
सदा	s̪əd̪äː
बर्ताव	bəɾt̪äːʋ
घमंडी	ɡʱəmə̃ɳɖiː
अंगोछा	ə̃ŋɡoːt͡ʃʰäː
झोंका	d͡ʒʱõːŋkäː
बोरियत	boːɾijət̪
तस्करी	t̪əs̪kəɾiː
बुद्धिजीवी	bʊd̪̚d̪ʱɪd͡ʒiːʋiː
लापरवाही	l̪äːpəɾʋäːɦiː
भोलानाथ	bʱoːl̪äːn̪äːt̪ʰ
गिरा	ɡɪɾäː
लहरा	l̪ɛɦɾäː
लुधियाना	l̪ʊd̪ʱijäːn̪äː
बहुभुज	bɔɦɔbʱʊd͡ʒ
तमाम	t̪əmä̃ːm
लाफा	l̪äːpʰäː
बेलफ़ास्ट	beːl̪pʰäːs̪ʈ
नियमित	n̪ijəmɪt̪
बालिश	bäːl̪ɪʃ
इम्तहान	ɪ̃mt̪əɦä̃ːn̪
आख़िर	äːxɪɾ
अभिभावक	əbʱɪbʱäːʋək
संयोजक	s̪ə̃joːd͡ʒək
मात्रक	mäːt̪ɾək
यौन	jɔ̃ːn̪
ज़बानी	d͡ʒəbäːn̪iː
अफ़साना	əpʰs̪äːn̪äː
रंगकर्म	ɾə̃ŋɡkəɾm
आखातीज	äːkʰäːt̪iːd͡ʒ
रक़्स	ɾəqs̪
शिक्षार्थी	ʃɪkʃäːɾt̪ʰiː
ज़मानत	d͡ʒəmäːn̪ət̪
ं	ə̃n
अवज्ञा	əʋəɡjäː
तूफ़ान	t̪uːfä̃ːn̪
अस्थायी	əs̪t̪ʰäːjiː
माचिस	mäːt͡ʃɪs̪
जिसे	d͡ʒɪs̪eː
दुर्भावना	d̪ʊɾbʱäːʋn̪äː
अधिकता	əd̪ʱɪkt̪äː
यानाति	jäːn̪äːt̪iː
दुर्मना	d̪ʊɾmən̪äː
भुगतान	bʱʊɡt̪ä̃ːn̪
अस्तर	əs̪t̪əɾ
चंद्रमा	t͡ʃə̃n̪d̪ɾəmäː
अंगन	ə̃ŋɡə̃n̪
छियासठ	t͡ʃʰijäːs̪əʈʰ
उदारतावाद	ʊd̪äːɾt̪äːʋäːd̪
उल्लंघन	ʊl̪l̪ə̃ŋɡʱə̃n̪
रिहा	ɾɪɦäː
तानना	t̪ä̃ːn̪n̪äː
ज़ेहन	zɛɦɛ̃n̪
लिखता	l̪ɪkʰt̪äː
अराजकता	əɾäːd͡ʒəkt̪äː
ज़ख़ीरा	zəxiːɾäː
सिंह	s̪ɪ̃ŋɡʱ
भूतनी	bʱuːt̪̚n̪iː
सिरदर्द	s̪ɪɾd̪əɾd̪
मटका	məʈkäː
गुलाब	ɡʊl̪äːb
ख़ाना	kʰäːn̪äː
गृहमंत्री	ɡɾɪɦmə̃n̪t̪ɾiː
बिच्छू	bɪt̚t͡ʃʰuː
निजात	n̪ɪd͡ʒäːt̪
प्रलय	pɾəl̪əj
पुनर्निर्माण	pʊn̪əɾn̪ɪɾmä̃ːɳ
पसरना	pəs̪əɾn̪äː
परिभाषित	pəɾɪbʱäːʃɪt̪
बाशिंदा	bäːʃɪ̃n̪d̪äː
ग्राम	ɡɾä̃ːm
मंगवाना	mə̃ŋɡʋäːn̪äː
आवाज	äːʋäːd͡ʒ
गुरबानी	ɡʊɾbäːn̪iː
राष्ट्रपिता	ɾäːʃʈɾəpɪt̪äː
चाव	t͡ʃäːʋ
ख़ानगी	kʰä̃ːn̪ɡiː
आलस	äːl̪əs̪
वहम	ʋɛɦɛ̃m
मँगवाना	mə̃ŋɡʋäːn̪äː
खील	kʰiːl̪
मंज़िल	mə̃d͡ʒɪl̪
तंदुरुस्त	t̪ə̃n̪d̪ʊɾʊs̪t̪
पिपासा	pɪpäːs̪äː
नागवार	n̪äːɡəʋäːɾ
दफ़्तरशाह	d̪əft̪əɾʃäːɦ
दिखाना	d̪ɪkʰäːn̪äː
सामग्री	s̪äːməɡɾiː
प्योंगचांग	pjõːŋɡt͡ʃä̃ːŋɡ
जर्मनी	d͡ʒəɾmən̪iː
स्थान	s̪t̪ʰä̃ːn̪
वर्गीकरण	ʋəɾɡiːkəɾə̃ɳ
चुक़ंदर	t͡ʃʊqə̃n̪d̪əɾ
फ़ालतू	pʰäːl̪t̪uː
मेहनती	meːɦə̃n̪t̪iː
चिपकना	t͡ʃɪpəkn̪äː
गुच्छा	ɡʊt̚t͡ʃʰäː
शरणागत	ʃəɾɳäːɡət̪
दोषपूर्ण	d̪oːʃpuːɾɳ
अरंडी	əɾə̃ɳɖiː
व्यस्त	ʋjəs̪t̪
भूराजनीति	bʱuːɾäːd͡ʒn̪iːt̪iː
भवन	bʱəʋə̃n̪
किर्गिज़स्तान	kɪɾɡɪzəs̪t̪ä̃ːn̪
पुरा	pʊɾäː
दिक्पात	d̪ɪkpäːt̪
कापी	käːpiː
असबाब	əs̪bäːb
सराहना	s̪əɾäːɦn̪äː
सर्दी	s̪əɾd̪iː
वहमी	ʋɛɦmiː
रुपया	ɾʊpəjäː
पटवारी	pəʈwäːɾiː
सिकोड़ना	s̪ɪkoːɽn̪äː
अक़्ल	əql̪ᵊ
ढाई	ɖʱäːiː
गिरना	ɡɪɾn̪äː
उतारना	ʊt̪äːɾn̪äː
बोलिए	boːl̪ɪeː
कोहेनूर	koːɦeːn̪uːɾ
परचम	pəɾt͡ʃə̃m
पेंसिल	pẽːn̪s̪ɪl̪
हमाम	ɦəmä̃ːm
उच्चायोग	ʊt̚t͡ʃäːjoːɡ
मंत्रालय	mə̃n̪t̪ɾäːl̪əj
ज़ीना	ziːn̪äː
प्रेस	pɾeːs̪
बमवर्षक	bə̃mwəɾʃək
निखरना	n̪ɪkʰəɾn̪äː
ख़ासियत	xäːs̪ijət̪
अवाक्	əʋäːk
क्वेटा	kweːʈäː
मौसमीपन	mɔːs̪miːpə̃n̪
इजाज़त	ɪd͡ʒäːd͡ʒət̪
असावधानता	əs̪äːʋd̪ʱä̃ːn̪t̪äː
ऐच्छिक	ɛːt̚t͡ʃʰɪk
कांग्रेसी	kä̃ːŋɡɾeːs̪iː
आबला	äːbl̪äː
दाताओं	d̪äːt̪äːõː
सुनीत	s̪ʊn̪iːt̪
ध्वंसावशेष	d̪ʱʋə̃n̪s̪äːʋʃeːʃ
प्रतिक्रिया	pɾət̪ɪkɾijäː
ईराक	iːɾäːk
साज़	s̪äːz
समूह	s̪əmuːɦ
हरिजन	ɦəɾɪd͡ʒə̃n̪
क़दम	kəd̪ə̃m
कुख्याति	kʊkʰjäːt̪iː
सर्वत्र	s̪əɾʋət̪ɾᵊ
मुकुट	mʊkʊʈ
फ़िलहाल	pʰɪl̪ɦäːl̪
निर्माण	n̪ɪɾmä̃ːɳ
बकरा	bəkɾäː
वीडियो	ʋiːɖijoː
अम्लीय	ə̃ml̪iːjᵊ
मान्यताप्राप्त	mä̃ːn̪jət̪äːpɾäːpt̪
बैंगन	bɛ̃ːŋɡə̃n̪
रिक्तिका	ɾɪkt̪ɪkäː
अमाशय	əmäːʃəj
मांजा	mä̃ːn̪d͡ʒäː
शिकंजा	ʃɪkə̃n̪d͡ʒäː
मानवशास्त्र	mäːn̪əʋʃäːs̪t̪ɾᵊ
बहनचोद	bɛɦɛ̃n̪t͡ʃoːd̪
प्रकाशक	pɾəkäːʃək
टिक्का	ʈɪk̚käː
स्वांग	s̪ʋä̃ːŋɡ
मुरादाबाद	mʊɾäːd̪äːbäːd̪
अनुकरण	ən̪ʊkəɾə̃ɳ
सहबद्ध	s̪ɛɦbəd̪d̪ʱ
तिपहिया	t̪ɪpəɦijäː
काफी	käːfiː
पुष्टीकरण	pʊʃʈiːkəɾə̃ɳ
सकत	s̪əkət̪
नहला	n̪ɛɦl̪äː
इन	ɪ̃n̪
लड़का	l̪əɽkäː
वंश	ʋə̃n̪ʃ
आसंद	äːs̪ə̃n̪d̪
ज्ञातृत्व	ɡjäːt̪ɾɪt̪wᵊ
अनिद्रा	ən̪ɪd̪ɾäː
दिव्यांग	d̪ɪʋjä̃ːŋɡ
ख़लीफ़ा	kʰəl̪iːpʰäː
स्थानांतरण	s̪t̪ʰäːn̪ä̃ːn̪t̪ɾə̃ɳ
शावक	ʃäːʋək
बयालीस	bəjäːl̪iːs̪
बावजूद	bäːʋd͡ʒuːd̪
वाइटफ़ील्ड	ʋäːɪʈfiːl̪ɖ
साबूदाना	s̪äːbuːd̪äːn̪äː
फसल	fəs̪əl̪
अहिंदी	əɦɪ̃n̪d̪iː
औषधी	ɔːʃd̪ʱiː
सीनेटर	s̪iːn̪eːʈəɾ
प्रायिकता	pɾäːjɪkt̪äː
बहुसंख्या	bɔɦɔs̪ə̃ŋkʰjäː
एड्स	eːɖs̪
भोसड़ी	bʱoːs̪ɽiː
उत्तेजित	ʊt̪̚t̪eːd͡ʒɪt̪
पहाड़ी	pəɦäːɽiː
भात	bʱäːt̪
निर्धन	n̪ɪɾd̪ʱə̃n̪
मोज़ा	moːd͡ʒäː
जज्बा	d͡ʒəd͡ʒbäː
क्लर्क	kl̪əɾk
उत्तरी	ʊt̪̚t̪əɾiː
क्षुद्र	kʃʊd̪ɾᵊ
बहावलपुर	bəɦäːʋəl̪pʊɾ
जलाल	d͡ʒəl̪äːl̪
एशिया	eːʃijäː
बाग़	bäːɡ
लंकिलाट	l̪ə̃ŋkɪl̪äːʈ
निकर	n̪ɪkəɾ
औषधि	ɔːʃd̪ʱiː
पोखरा	poːkʰɾäː
भिया	bʱijäː
निज़ामाबाद	n̪ɪzäːmäːbäːd̪
सांद्रता	s̪ä̃ːn̪d̪ɾət̪äː
खादी	kʰäːd̪iː
दिया	d̪ijäː
कोलकाता	koːl̪käːt̪äː
बुद्धि	bʊd̪̚d̪ʱiː
आक़ा	äːqäː
नया	n̪əjaː
हिंडोला	ɦɪ̃ɳɖoːl̪äː
आत्मनिर्भर	äːt̪mən̪ɪɾbʱəɾ
उमरा	ʊ̃mɾäː
वेटिकन	ʋeːʈɪkə̃n̪
मँगेतर	mə̃ŋɡeːt̪əɾ
हलक़ा	ɦəl̪käː
यतीमख़ाना	jət̪ĩːmxäːn̪äː
नेकदिल	n̪eːkd̪ɪl̪
मौलिक	mɔːl̪ɪk
दायित्वशील	d̪äːjɪt̪wəʃiːl̪
थप्पड़	t̪ʰəp̚pəɽ
आधारभूत	äːd̪ʱäːɾbʱuːt̪
किलोमीटर	kɪl̪oːmiːʈəɾ
मुजस्समा	mʊd͡ʒəs̪s̪əmäː
सुगंध	s̪ʊɡə̃n̪d̪ʱ
ऊटपटांग	uːʈəpʈä̃ːŋɡ
शहर	ʃɛɦɛɾ
चीनिया	t͡ʃiːn̪ijäː
नीयत	n̪iːjət̪
रास्ता	ɾäːs̪t̪äː
ख़राश	kʰəɾäːʃ
दशहरा	d̪əʃɛɦɾäː
पुदीना	pʊd̪iːn̪äː
खड़िया	kʰəɽijäː
मुग़लिया	mʊɡl̪ijäː
नज़र	n̪əd͡ʒəɾ
प्रभावित	pɾəbʱäːʋɪt̪
बेलारूस	beːl̪äːɾuːs̪
ई	iː
सामरिक	s̪ä̃ːmɾɪk
संतोष	s̪ə̃n̪t̪oːʃ
परजन	pəɾd͡ʒə̃n̪
पूर्णिमा	puːɾɳɪmäː
नयी	n̪əjiː
ख़्याल	kʰjäːl̪
ताल्लुक	t̪äːl̪l̪ʊq
टेलिविज़न	ʈeːl̪ɪʋɪd͡ʒə̃n̪
हुक्म	ɦʊkʊ̃m
मोल	moːl̪
रसूल	ɾəs̪uːl̪
उत्पाद	ʊt̪päːd̪
तबेला	t̪əbeːl̪äː
सामूहिक	s̪äːmuːɦɪk
साबित	s̪äːbɪt̪
बत्तख	bət̪̚t̪əx
नौजवान	n̪ɔːd͡ʒəʋä̃ːn̪
कज़ाख़स्तान	kəd͡ʒäːkʰəs̪t̪ä̃ːn̪
औजार	ɔːd͡ʒäːɾ
बाक़ायदा	bäːqäːjd̪äː
भार	bʱäːɾ
गुमसुम	ɡʊ̃ms̪ʊ̃m
तूफ़ान	t̪uːpʰä̃ːn̪
शूटिंग	ʃuːʈɪ̃ŋɡ
ताँबा	t̪ä̃ːmbäː
मुहिम	mʊɦɪ̃m
बलूच	bəl̪uːt͡ʃ
ख़िताबी	xɪt̪äːbiː
आनंददायी	äːn̪ə̃n̪d̪d̪äːjiː
आपसदारी	äːpəs̪d̪äːɾiː
गुब्बारा	ɡʊb̚bäːɾäː
स्वीकारात्मक	s̪ʋiːkäːɾäːt̪mək
तेज़ाब	t̪eːzäːb
अँग्रेज़	ə̃ŋɡɾeːz
अस्वीकार	əs̪ʋiːkäːɾ
आग़ोश	äːɡoːʃ
मुंसिफ़ाना	mʊ̃n̪s̪ɪfäːn̪äː
घाटा	ɡʱäːʈäː
अँग्रेज़ी	ə̃ŋɡɾeːd͡ʒiː
सेज	s̪eːd͡ʒ
ख़िदमतगार	kʰɪd̪mət̪ɡäːɾ
इंट्यूबेशन	ɪ̃ɳʈjuːbeːʃə̃n̪
संतरा	s̪ə̃n̪t̪ɾäː
लाठ	l̪äːʈʰ
झटका	d͡ʒʱəʈkäː
एडिलेड	eːɖɪl̪eːɖ
आन	ä̃ːn̪
रवाना	ɾəʋäːn̪äː
उद्देश्य	ʊd̪̚d̪eːʃjᵊ
हरामज़ादा	ɦəɾä̃ːmzäːd̪äː
अवार्ड	əʋäːɾɖ
स्त्रीत्व	s̪t̪ɾiːt̪wᵊ
प्रातः	pɾäːt̪əɦ
पिलाना	pɪl̪äːn̪äː
सातवाहन	s̪äːt̪wäːɦə̃n̪
एकघातीय	eːkɡʱäːt̪iːjᵊ
डालना	ɖäːl̪n̪äː
छटपटाना	t͡ʃʰəʈpəʈäːn̪äː
पक्षधर	pəkʃd̪ʱəɾ
अल्जीरिया	əl̪d͡ʒiːɾijäː
प्राप्यक	pɾäːpjək
मूत्रमार्ग	muːt̪ɾəmäːɾɡ
बारिक	bäːɾɪk
शैतान	ʃɛːt̪ä̃ːn̪
क़िला	kɪl̪äː
कुत्ता	kʊt̪̚t̪äː
अवकलज	əʋkəl̪əd͡ʒ
चौहत्तर	t͡ʃɔːɦət̪̚t̪əɾ
चिमनी	t͡ʃɪ̃mn̪iː
पागलपन	päːɡəl̪pə̃n̪
दोगुना	d̪oːɡʊn̪äː
बाद	bäːd̪
भूकम्प	bʱuːkə̃mp
साँप	s̪ä̃ːp
कर्नाटक	kəɾn̪äːʈək
हथौड़ा	ɦət̪ʰɔːɽäː
इंक़लाब	ɪ̃n̪qəl̪äːb
मध्यावकाश	məd̪ʱjäːʋkäːʃ
रस्सा	ɾəs̪s̪äː
नाना	n̪äːn̪äː
लेखा	l̪eːkʰäː
लांछित	l̪ä̃ːn̪t͡ʃʰɪt̪
यहेज़क़ेल	jəɦeːd͡ʒkeːl̪
तोहफ़ा	t̪oːɦpʰäː
खेना	kʰeːn̪äː
काफ़ी	käːfiː
तुकांत	t̪ʊkä̃ːn̪t̪
कुमुदिनी	kʊmʊd̪ɪn̪iː
ख़ुशाब	kʰʊʃäːb
प्रशासन	pɾəʃäːs̪ə̃n̪
सर्षप	s̪əɾʃəp
पुख़्ता	pʊkʰt̪äː
नेत्रोपम	n̪eːt̪ɾoːpə̃m
शालीनता	ʃäːl̪ĩːn̪t̪äː
नवाज़	n̪əʋäːz
घात	ɡʱäːt̪
सहज	s̪ɛɦɛd͡ʒ
बतियाना	bət̪ijäːn̪äː
टिमटिमाना	ʈɪ̃mʈɪmäːn̪äː
अधीन	əd̪ʱĩːn̪
पल्लव	pəl̪l̪əʋ
केंद्रीकरण	kẽːn̪d̪ɾiːkəɾə̃ɳ
गदा	ɡəd̪äː
साबिक	s̪äːbɪq
ग़ोताख़ोर	ɡoːt̪äːkʰoːɾ
स्पर्श	s̪pəɾʃ
अनुमानित	ən̪ʊmäːn̪ɪt̪
देवल	d̪eːʋəl̪
फलक	pʰəl̪ək
बटोरना	bəʈoːɾn̪äː
कुँआरी	kʊ̃äːɾiː
उदासी	ʊd̪äːs̪iː
लौआ	l̪ɔːäː
ईसा	iːs̪äː
बगीचा	bəɡiːt͡ʃäː
उस्मानी	ʊs̪mäːn̪iː
ना	n̪äː
बिस्कुट	bɪs̪kʊʈ
अनजाने	ə̃n̪d͡ʒäːn̪eː
बरसात	bəɾs̪äːt̪
समस्या	s̪əməs̪jäː
कैनबरा	kɛːn̪əbɾäː
तल्ख़	t̪əl̪kʰ
क्रीम	kɾĩːm
साल	s̪äːl̪
दादसरा	d̪äːd̪əs̪ɾäː
अनारदाना	ən̪äːɾd̪äːn̪äː
टंकक	ʈə̃ŋkək
लोहिया	l̪oːɦijäː
त्यागपत्र	t̪jäːɡpət̪ɾᵊ
ख़रबूज़ा	kʰəɾbuːd͡ʒäː
हस्ती	ɦəs̪t̪iː
हेलीकॉप्टर	ɦeːl̪iːkɔpʈəɾ
अहसास	ɛɦs̪äːs̪
मुताबिक	mʊt̪äːbɪk
गुमना	ɡʊ̃mn̪äː
अंधा	ə̃n̪d̪ʱäː
परवाना	pəɾʋäːn̪äː
तत्वज्ञान	t̪ət̪wəɡjä̃ːn̪
महासचिव	məɦäːs̪ət͡ʃɪʋ
आंधी	ä̃ːn̪d̪ʱiː
अश्लीलता	əʃl̪iːl̪t̪äː
चेताना	t͡ʃeːt̪äːn̪äː
शांति	ʃä̃ːn̪t̪iː
ख़ावंद	kʰäːʋə̃n̪d̪
चुटकुला	t͡ʃʊʈkʊl̪äː
ज़ालिम	zäːl̪ɪ̃m
सौत	s̪ɔːt̪
गंवाना	ɡə̃mwäːn̪äː
सेवानिवृत्त	s̪eːʋäːn̪ɪʋɾɪt̪t̪
अत्यावश्यक	ət̪jäːʋəʃjək
उन्मुक्त	ʊ̃n̪mʊkt̪
एतबार	eːt̪bäːɾ
पौना	pɔːn̪äː
गत्ता	ɡət̪̚t̪äː
स्वर्णकार	s̪ʋəɾɳəkäːɾ
रवानी	ɾəʋäːn̪iː
स्वीकार	s̪ʋiːkäːɾ
उत्पादको	ʊt̪päːd̪əkoː
फुसफुसाना	pʰʊs̪pʰʊs̪äːn̪äː
बारहखड़ी	bäːɾɛɦkʰəɽiː
पदाधिकारी	pəd̪äːd̪ʱɪkäːɾiː
खोजना	kʰoːd͡ʒn̪äː
वास्तुकला	ʋäːs̪t̪ʊkəl̪äː
औत्सुक्य	ɔːt̪s̪ʊkjᵊ
तंदुरुस्ती	t̪ə̃n̪d̪ʊɾʊs̪t̪iː
उत्तरकाशी	ʊt̪̚t̪əɾkäːʃiː
पश्चिम	pəʃt͡ʃɪ̃m
कायांतरण	käːjä̃ːn̪t̪əɾə̃ɳ
इत्तेला	ɪt̪̚t̪eːl̪äː
इसबग़ोल	ɪs̪bəɡoːl̪
देन	d̪ẽːn̪
तमिल	t̪əmɪl̪
श्याम	ʃjä̃ːm
ग्यारह	ɡjäːɾəɦ
उत्पल	ʊt̪pəl̪
झरना	d͡ʒʱəɾn̪äː
मिट्टी	mɪʈ̚ʈiː
इंतक़ाम	ɪ̃n̪t̪əkä̃ːm
संहार	s̪ə̃ŋɦäːɾ
सुस्वादु	s̪ʊs̪ʋäːd̪uː
ख़ुशहाली	kʰʊʃɦäːl̪iː
शमशेर	ʃə̃mʃeːɾ
टेलीविज़न	ʈeːl̪iːʋɪzə̃n̪
बाजरा	bäːd͡ʒɾäː
सज्जन	s̪əd̚d͡ʒə̃n̪
हासिल	ɦäːs̪ɪl̪
बहन	bəɦɪ̃n̪
वेश्यावृत्ति	ʋeːʃjäːʋɾɪt̪̚t̪iː
बन्दूक	bə̃n̪d̪uːq
सदैव	s̪əd̪ɛːʋ
छब्बीस	t͡ʃʰəb̚biːs̪
कंठ्य	kə̃ɳʈʰjə
पकड़ना	pəkəɽn̪äː
दया	d̪əjäː
विश्वविख्यात	ʋɪʃʋəʋɪkʰjäːt̪
यात्री	jäːt̪ɾiː
धोखेबाज़	d̪ʱoːkʰeːbäːz
छापेख़ाना	t͡ʃʰäːpeːxäːn̪äː
फ्रेन्चाइज़	fɾẽːn̪t͡ʃäːɪz
मुसीबत	mʊs̪iːbət̪
उढ़काना	ʊɽʱkäːn̪äː
रखना	ɾəkʰn̪äː
बासमती	bäːs̪mət̪iː
घोलना	ɡʱoːl̪n̪äː
जनसंख्या	d͡ʒə̃n̪s̪ə̃ŋkʰjäː
एकसदनीय	eːks̪əd̪ən̪iːjᵊ
महत्त्वपूर्ण	mɛɦɛt̪̚t̪wəpuːɾɳ
कुरता	kʊɾt̪äː
रान	ɾä̃ːn̪
उसाँस	ʊs̪ä̃ːs̪
जकार्ता	d͡ʒəkäːɾt̪äː
ठेकुआ	ʈʰeːkʊäː
कूटनीतिज्ञ	kuːʈn̪iːt̪ɪɡj
समाना	s̪əmäːn̪äː
कुत्रापि	kʊt̪ɾäːpiː
बीमार	biːmäːɾ
मसीह	məs̪iːɦ
रेंगना	ɾẽːŋɡn̪äː
निर्जलित	n̪ɪɾd͡ʒəl̪ɪt̪
मुकम्मल	mʊkə̃mməl̪
लगना	l̪əɡn̪äː
छोरा	t͡ʃʰoːɾäː
गुण	ɡʊ̃ɳ
भारतीय	bʱäːɾt̪iːjᵊ
बिल	bɪl̪
आदर	äːd̪əɾ
असमीकरण	əs̪əmiːkəɾə̃ɳ
नियत	n̪ijət̪
अंतरा	ə̃n̪t̪ɾäː
साज़	s̪äːd͡ʒ
योद्धा	joːd̪̚d̪ʱäː
विनियम	ʋɪn̪ijə̃m
कायान्तरण	käːjä̃ːn̪t̪əɾə̃ɳ
क़ुरान	kʊɾä̃ːn̪
लिहाज़ा	l̪ɪɦäːzäː
रियाद	ɾijäːd̪
अनुरोध	ən̪ʊɾoːd̪ʱ
मिसेज़	mɪs̪eːz
पैदाइशी	pɛːd̪äːɪʃiː
रसोईया	ɾəs̪oːiːjäː
अविकारी	əʋɪkäːɾiː
मामला	mä̃ːml̪äː
शब्दार्थ	ʃəbd̪äːɾt̪ʰ
दावेदार	d̪äːʋeːd̪äːɾ
आखरी	äːxɾiː
सुसंस्कृत	s̪ʊs̪ə̃n̪s̪kɾɪt̪
इस	ɪs̪
लगी	l̪əɡiː
तुफ़ंग	t̪ʊfə̃ŋɡ
साइप्रस	s̪äːɪpɾəs̪
बेतवा	beːt̪wäː
अजूबा	əd͡ʒuːbäː
बलूची	bəl̪uːt͡ʃiː
योकोहामा	joːkoːɦäːmäː
वाष्पीकरण	ʋäːʃpiːkəɾə̃ɳ
निर्भर	n̪ɪɾbʱəɾ
उन्यासी	ʊ̃n̪jäːs̪iː
क्रीड़िका	kɾiːɽɪkäː
खेलकूद	kʰeːl̪kuːd̪
पैसा	pɛːs̪äː
मांग	mä̃ːŋɡ
नारीत्व	n̪äːɾiːt̪wᵊ
उज़्बेकिस्तान	ʊd͡ʒbeːkɪs̪t̪ä̃ːn̪
यौनाकर्षण	jɔːn̪äːkəɾʃə̃ɳ
अथाह	ət̪ʰäːɦ
जगह	d͡ʒəɡäː
समयादेश	s̪əməjäːd̪eːʃ
अल्बानियन	əl̪bäːn̪ijə̃n̪
सचित्र	s̪ət͡ʃɪt̪ɾᵊ
अट्टालिका	əʈ̚ʈäːl̪ɪkäː
बेवफ़ा	beːʋəpʰäː
पूजना	puːd͡ʒn̪äː
न्यायशास्त्र	n̪jäːjʃäːs̪t̪ɾᵊ
फ़्राँस	fɾä̃ːs̪
लचकना	l̪ət͡ʃəkn̪äː
व्यंग	ʋjə̃ŋɡ
लाँघना	l̪ä̃ːŋɡʱn̪äː
आंत	ä̃ːn̪t̪
गिरफ़्तारी	ɡɪɾəpʰt̪äːɾiː
सोची	s̪oːt͡ʃiː
लातीनी	l̪äːt̪iːn̪iː
पतलू	pət̪l̪uː
पाथना	päːt̪ʰn̪äː
स्तनपायी	s̪t̪ə̃n̪päːjiː
पोशाक	poːʃäːk
उत्सुकता	ʊt̪s̪ʊkt̪äː
सहन	s̪əɦn̪
महाराज	məɦäːɾäːd͡ʒ
मुर्दा	mʊɾd̪äː
कैंब्रिज	kɛ̃ːmbɾɪd͡ʒ
मार्गाभिगमन	mäːɾɡäːbʱɪɡəmə̃n̪
ढोंग	ɖʱõːŋɡ
चूकना	t͡ʃuːkn̪äː
इग्ज़ाम	ɪɡd͡ʒä̃ːm
चौरासी	t͡ʃɔːɾäːs̪iː
रवा	ɾəʋäː
फड़फड़ाना	pʰəɽpʰəɽäːn̪äː
कबाब	kəbäːb
बगावत	bəɣäːʋət̪
गोल	ɡoːl̪
अंडकोष	ə̃ɳɖkoːʃ
नखलिस्तान	n̪əkʰl̪ɪs̪t̪ä̃ːn̪
बनाना	bən̪äːn̪äː
नंगापन	n̪ə̃ŋɡäːpə̃n̪
सम	s̪ə̃m
लवण	l̪əʋə̃ɳ
द्विध्रुव	d̪wɪd̪ʱɾʊʋ
दुर्घटनाग्रस्त	d̪ʊɾɡʱəʈn̪äːɡɾəs̪t̪
कछारी	kət͡ʃʰäːɾiː
ज़िंदाबाद	zɪ̃n̪d̪äːbäːd̪
उपभोग	ʊp̚bʱoːɡ
श्रद्धालु	ʃɾəd̪̚d̪ʱäːl̪uː
वैज्ञानिक	ʋɛːɡjäːn̪ɪk
अजनबी	əd͡ʒn̪əbiː
मण्डलिका	mə̃ɳɖəl̪ɪkäː
गनी	ɡən̪iː
अद्यापि	əd̪jäːpiː
प्याज़	pjäːz
भावनात्मक	bʱäːʋn̪äːt̪mək
जारक	d͡ʒäːɾək
सस्ता	s̪əs̪t̪äː
गन्दा	ɡə̃n̪d̪äː
लाट	l̪äːʈ
समंदर	s̪əmə̃n̪d̪əɾ
फ़रिश्ता	pʰəɾɪʃt̪äː
अशांत	əʃä̃ːn̪t̪
कांटा	kä̃ːʈäː
हंटर	ɦə̃ɳʈəɾ
नेत्रदान	n̪eːt̪ɾəd̪ä̃ːn̪
फ़ॉलोअर	fɔl̪oːəɾ
बलपूर्वक	bəl̪puːɾʋək
हवस	ɦəʋəs̪
खरा	kʰəɾäː
जन	d͡ʒə̃n̪
कोंकण	kõːŋkə̃ɳ
दंपती	d̪ə̃mpət̪iː
नुमाइश	n̪ʊmäːɪʃ
अंतर्निहित	ə̃n̪t̪əɾn̪ɪɦɪt̪
परावर्तन	pəɾäːʋəɾt̪ə̃n̪
टपकना	ʈəpəkn̪äː
डॉलर	ɖɔl̪əɾ
पटोल	pəʈoːl̪
जाएगा	d͡ʒäːeːɡäː
बेचैन	beːt͡ʃɛ̃ːn̪
भिखारी	bʱɪkʰäːɾiː
ईटानगर	iːʈäːn̪əɡəɾ
लिख	l̪ɪkʰ
सीधा	s̪iːd̪ʱäː
कच्छा	kət̚t͡ʃʰäː
सम्पूर्ण	s̪ə̃mpuːɾɳ
आवेश	äːʋeːʃ
प्रमाण	pɾəmä̃ːɳ
किरण	kɪɾə̃ɳ
मावा	mäːʋäː
माण्डलिक	mä̃ːɳɖəl̪ɪk
मुखड़ा	mʊkʰɽäː
कुहनी	kɔɦn̪iː
चुपड़ना	t͡ʃʊpəɽn̪äː
निर्धारिती	n̪ɪɾd̪ʱäːɾɪt̪iː
अधीरता	əd̪ʱiːɾt̪äː
साम्य	s̪ä̃ːmjᵊ
फ़रीदाबाद	pʰəɾiːd̪äːbäːd̪
सुई	s̪uːiː
लिथुआनिया	l̪ɪt̪ʰʊäːn̪ijäː
मानसून	mä̃ːn̪s̪ũːn̪
फिल्म	fɪl̪m
पात्र	päːt̪ɾᵊ
गुंडा	ɡʊ̃ɳɖäː
दृष्टि	d̪ɾɪʃʈiː
वेदना	ʋeːd̪̚n̪äː
अष्टकोण	əʂʈkõːɳ
प्राप्तिका	pɾäːpt̪ɪkäː
दंतकथा	d̪ə̃n̪t̪kət̪ʰäː
लाभकारक	l̪äːbʱkäːɾək
मोर्चा	moːɾt͡ʃäː
विविधता	ʋɪʋɪd̪ʱt̪äː
जामुन	d͡ʒäːmʊ̃n̪
अजायबघर	əd͡ʒäːjəbɡʱəɾ
मात्रा	mäːt̪ɾäː
ख़लासी	kʰəl̪äːs̪iː
हवाई	ɦəʋäːiː
असम्भव	əs̪ə̃mbʱəʋ
गॉर्डन	ɡɔɾɖə̃n̪
रोज़मर्रा	ɾoːd͡ʒməɾɾäː
असली	əs̪l̪iː
उम्मीद्वार	ʊ̃mmiːd̪wäːɾ
अर्जन	əɾd͡ʒə̃n̪
सुर्ख़ी	s̪ʊɾkʰiː
ग्रंथालय	ɡɾə̃n̪t̪ʰäːl̪ɛː
मैसूर	mɛːs̪uːɾ
न्यूयॉर्क	n̪juːjɔɾk
साक्षात्कार	s̪äːkʃäːt̪käːɾ
क्रिया	kɾijäː
मोंटेनीगरो	mõːɳʈeːn̪iːɡɾoː
असेंबली	əs̪ẽːmbl̪iː
क़सम	kəs̪ə̃m
ठुमकना	ʈʰʊməkn̪äː
पसेरी	pəs̪eːɾiː
थामना	t̪ʰä̃ːmn̪äː
अग्निशामक	əɡn̪ɪʃäːmək
शिनकानसेन	ʃɪ̃n̪kä̃ːn̪s̪ẽːn̪
घूर्णवायु	ɡʱuːɾɳəʋäːjuː
पुष्कलावती	pʊʃkəl̪äːʋət̪iː
आख़िरत	äːkʰɪɾət̪
बाईस	bäːiːs̪
क़व्वाल	kəʋʋäːl̪
अवलंब	əʋl̪ə̃mb
उसी	ʊs̪iː
समामेलन	s̪əmäːmeːl̪ə̃n̪
देहाती	d̪eːɦäːt̪iː
चुप्पी	t͡ʃʊp̚piː
निरीक्षण	n̪ɪɾiːkʃə̃ɳ
सेवा	s̪eːʋäː
चौबीस	t͡ʃɔːbiːs̪
असंगत	əs̪ə̃ŋɡət̪
सदिश	s̪əd̪ɪʃ
ग़ौरतलब	ɣɔːɾt̪əl̪əb
अशिष्टता	əʃɪʃʈt̪äː
डुबोना	ɖʊboːn̪äː
सामने	s̪ä̃ːmn̪eː
फ़्राँस	pʰɾä̃ːs̪
बगला	bəɡl̪äː
टेढ़ा	ʈeːɽʱäː
पाँव	pä̃ːʋ
सममिति	s̪ə̃mmɪt̪iː
स्कर्ट	s̪kəɾʈ
उंगली	ʊ̃ŋɡl̪iː
ऐनक	ɛːn̪ək
विफलता	ʋɪpʰəl̪t̪äː
आचार	äːt͡ʃäːɾ
ढांचा	ɖʱä̃ːt͡ʃäː
वैवाहिक	ʋɛːʋäːɦɪk
एहसान	ɛɦs̪ä̃ːn̪
क्षत्रिय	kʃət̪ɾijə
शरारत	ʃəɾäːɾət̪
समीक्षा	s̪əmiːkʃäː
शब्दांश	ʃəbd̪ä̃ːn̪ʃ
अधिभार	əd̪ʱɪbʱäːɾ
प्रवीण	pɾəʋĩːɳ
वन्य	ʋə̃n̪jᵊ
सब्ज़ी	s̪əbziː
गन्ना	ɡə̃n̪n̪äː
अंतःक्षेप	ə̃n̪t̪əɦkʃeːp
उपसर्ग	ʊps̪əɾɡ
सिर्फ	s̪ɪɾpʰ
सम्पादन	s̪ə̃mpäːd̪ə̃n̪
रत्न	ɾət̪ə̃n̪
जोखना	d͡ʒoːkʰn̪äː
अवपंक	əʋpə̃ŋk
सिनेमा	s̪ɪn̪eːmäː
अभियोक्ता	əbʱijoːkt̪äː
खण्ड	kʰə̃ɳɖ
अस्थिर	əs̪t̪ʰɪɾ
भयाक्रांत	bʱəjäːkɾä̃ːn̪t̪
उखाड़ना	ʊkʰäːɽn̪äː
मशीनी	məʃiːn̪iː
मोहना	moːɦn̪äː
अनुकूल	ən̪ʊkuːl̪
भेजा	bʱeːd͡ʒäː
पत्ता	pət̪̚t̪äː
अंगूरी	ə̃ŋɡuːɾiː
जिस	d͡ʒɪs̪
लायक	l̪äːjək
लिंगानुपात	l̪ɪ̃ŋɡäːn̪ʊpäːt̪
बेगार	beːɡäːɾ
इनसाफ़	ɪ̃n̪s̪äːf
बेमेल	beːmeːl̪
कंगाल	kə̃ŋɡäːl̪
राँची	ɾä̃ːt͡ʃiː
हताहत	ɦət̪äːɦət̪
बाज़ारी	bäːzäːɾiː
अंदर	ə̃n̪d̪əɾ
इंतहा	ɪ̃n̪t̪əɦäː
परन्दा	pəɾə̃n̪d̪äː
बनियान	bən̪ijä̃ːn̪
मिलाप	mɪl̪äːp
शारीरिक	ʃäːɾiːɾɪk
अज्ञेयवादी	əɡjeːjʋäːd̪iː
तक़ाज़ा	t̪əqäːzäː
ताक़तवर	t̪äːqət̪wəɾ
हिंग्लिश	ɦɪ̃ŋɡl̪ɪʃ
हाज़िरजवाबी	ɦäːzɪɾd͡ʒəʋäːbiː
अंदाज	ə̃n̪d̪äːz
बुलंदशहर	bʊl̪ə̃n̪d̪ʃɛɦɛɾ
अक्स	əks̪
ग़नीमत	ɣən̪iːmət̪
मुतअल्लिक़	mʊt̪əəl̪l̪ɪk
लखनऊ	l̪əkʰn̪əuː
डेरा	ɖeːɾäː
जुमेरात	d͡ʒʊmeːɾäːt̪
जुआरी	d͡ʒʊäːɾiː
अनिवार्य	ən̪ɪʋäːɾjᵊ
कनिष्ठ	kən̪ɪʂʈʰ
सिंहासन	s̪ɪ̃ŋɡʱäːs̪ə̃n̪
बावरची	bäːʋəɾt͡ʃiː
कालेज	käːl̪eːd͡ʒ
गांजा	ɡä̃ːn̪d͡ʒäː
सवा	s̪əʋäː
तबाह	t̪əbäːɦ
उपनायिका	ʊpn̪äːjɪkäː
गान	ɡä̃ːn̪
घोल	ɡʱoːl̪
धर्मशाला	d̪ʱəɾmʃäːl̪äː
वैराग्य	ʋɛːɾäːɡjᵊ
खसरा	kʰəs̪ɾäː
नवशास्त्रीय	n̪əʋʃäːs̪t̪ɾiːjᵊ
बंदर	bə̃n̪d̪əɾ
बरमा	bəɾmäː
समबाहु	s̪ə̃mbäːɦuː
ढालना	ɖʱäːl̪n̪äː
आंतरिक	ä̃ːn̪t̪ɾɪk
जायज़ा	d͡ʒäːjd͡ʒäː
त्रिज्या	t̪ɾɪd͡ʒjäː
उपनाम	ʊpn̪ä̃ːm
निज़ाम	n̪ɪzä̃ːm
वाली	ʋäːl̪iː
अपलक	əpəl̪ək
अक़्लमंद	əkl̪ᵊmə̃n̪d̪
बरस	bəɾəs̪
पहल	pɛɦɛl̪
घटाना	ɡʱəʈäːn̪äː
हुम्मुस	ɦʊ̃mmʊs̪
परदादा	pəɾd̪äːd̪äː
टेलिविजन	ʈeːl̪ɪʋɪzə̃n̪
नरसिंह	n̪əɾs̪ɪ̃ŋɡʱ
ज़ंजीर	d͡ʒə̃n̪d͡ʒiːɾ
सियाही	s̪ijäːɦiː
अनावश्यक	ən̪äːʋəʃjək
छाया	t͡ʃʰäːjäː
स्थापत्य	s̪t̪ʰäːpət̪jᵊ
धर्मनिरपेक्षता	d̪ʱəɾmn̪ɪɾpeːkʃt̪äː
लीला	l̪iːl̪äː
टैंकर	ʈɛ̃ːŋkəɾ
दुष्चक्र	d̪ʊʃt͡ʃəkɾᵊ
केंद्रक	kẽːn̪d̪ɾək
एकता	eːkt̪äː
जायफल	d͡ʒäːjpʰəl̪
आगरा	äːɡɾäː
तोहफ़ा	t̪oːɦfäː
दशमलव	d̪əʃə̃ml̪əʋ
ज़ोरदार	zoːɾd̪äːɾ
मद्यपान	məd̪jəpä̃ːn̪
प्योंगचैंग	pjõːŋɡt͡ʃɛ̃ːŋɡ
सदाबहार	s̪əd̪äːbəɦäːɾ
जनना	d͡ʒə̃n̪n̪äː
नक़ली	n̪əkl̪iː
प्रिटोरिया	pɾɪʈoːɾijäː
कारखाना	käːɾkʰäːn̪äː
लात	l̪äːt̪
चौताल	t͡ʃɔːt̪äːl̪
कागज	käːɣəz
उपला	ʊpl̪äː
व्यवसाय	ʋjəʋs̪äːj
वाकिफ	ʋäːkɪpʰ
भगवान्	bʱəɡʋä̃ːn̪
हदीस	ɦəd̪iːs̪
अफ़ीमची	əpʰĩːmt͡ʃiː
तरणताल	t̪əɾə̃ɳt̪äːl̪
ग़बन	ɣəbə̃n̪
नक़्क़ाशी	n̪ək̚käːʃiː
अलगाव	əl̪ɡäːʋ
तलाशी	t̪əl̪äːʃiː
आंग्ल	ä̃ːŋɡl̪ᵊ
ग्रामचर्या	ɡɾä̃ːmt͡ʃəɾjäː
निःशब्द	n̪ɪɦʃəbd̪
गाढ़ा	ɡäːɽʱäː
संसद	s̪ə̃n̪s̪əd̪
कजरारा	kəd͡ʒɾäːɾäː
कमरा	kə̃mɾäː
वसूल	ʋəs̪uːl̪
प्रदर्शन	pɾəd̪əɾʃə̃n̪
दीदार	d̪iːd̪äːɾ
युद्धबंदी	jʊd̪d̪ʱbə̃n̪d̪iː
फ़िदा	pʰɪd̪äː
क़ाहिरा	käːɦɪɾäː
धीरा	d̪ʱiːɾäː
खपरैल	kʰəpɾɛːl̪
ज़हरीला	zɛɦɾiːl̪äː
रोमानिया	ɾoːmäːn̪ijäː
अंश	ə̃n̪ʃ
तत्व	t̪ət̪wᵊ
स्वशिक्षा	s̪ʋəʃɪkʃäː
झामुमो	d͡ʒʱäːmʊmoː
पिंजरा	pɪ̃n̪d͡ʒɾäː
शायरा	ʃäːjɾäː
दिनेश	d̪ɪn̪eːʃ
समृद्धिकरण	s̪ə̃mɾɪd̪̚d̪ʱɪkəɾə̃ɳ
मांगना	mä̃ːŋɡn̪äː
उत्तोलक	ʊt̪̚t̪oːl̪ək
यूनान	juːn̪ä̃ːn̪
पुनर्दर्शनाय	pʊn̪əɾd̪əɾʃən̪äːj
फ़्राँसीसी	fɾä̃ːs̪iːs̪iː
शिश्नो	ʃɪʃn̪oː
बैतलहम	bɛːt̪l̪ɛɦɛ̃m
पाकिस्तानी	päːkɪs̪t̪äːn̪iː
बुटवल	bʊʈwəl̪
कंक्रीट	kə̃ŋkɾiːʈ
अल्टीमेटम	əl̪ʈiːmeːʈə̃m
झूलना	d͡ʒʱuːl̪n̪äː
पपीता	pəpiːt̪äː
अफ़ीम	əfĩːm
दिन	d̪ɪ̃n̪
निर्यात	n̪ɪɾjäːt̪
एटीएम	eːʈiːẽːm
चिढ़ाना	t͡ʃɪɽʱäːn̪äː
पुनर्जन्म	pʊn̪əɾd͡ʒə̃n̪m
इजाजत	ɪd͡ʒäːzət̪
अहिंसात्मक	əɦɪ̃n̪s̪äːt̪mək
दुग्धाग्र	d̪ʊɡd̪ʱäːɡɾᵊ
प्रेयसी	pɾeːjs̪iː
भारत	bʱäːɾət̪
बेशक़ीमती	beːʃkĩːmt̪iː
जमैका	d͡ʒəmɛːkäː
मानवीय	mäːn̪əʋiːjᵊ
जान	d͡ʒä̃ːn̪
नीच	n̪iːt͡ʃ
निहित	n̪ɪɦɪt̪
चिड़िया	t͡ʃɪɽijäː
प्रसाद	pɾəs̪äːd̪
पैदावार	pɛːd̪äːʋäːɾ
गुफ़्तार	ɡʊpʰt̪äːɾ
परिच्छेद	pəɾɪt̚t͡ʃʰeːd̪
फ़ासिला	pʰäːs̪ɪl̪äː
अंतिम	ə̃n̪t̪ɪ̃m
ज़ुल्म	zʊl̪m
मुहम्मद	mɔɦɔ̃mməd̪
अर्जेण्टीना	əɾd͡ʒẽːɳʈiːn̪äː
बच्चन	bət̚t͡ʃə̃n̪
हस्तत्राण	ɦəs̪t̪ət̪ɾä̃ːɳ
ख़ाका	kʰäːkäː
पुच्छ	pʊt̚t͡ʃʰ
लादना	l̪äːd̪̚n̪äː
ऑक्सफ़ोर्ड	ɔks̪pʰoːɾɖ
इथियोपिया	ɪt̪ʰijoːpijäː
सुखमय	s̪ʊkʰməj
समेकन	s̪əmeːkə̃n̪
सचमुच	s̪ət͡ʃmʊt͡ʃ
ऑफ़िस	ɔfɪs̪
गुणांक	ɡʊɳä̃ːk
ख़ाक़ान	xäːqä̃ːn̪
सुक़रात	s̪ʊkɾäːt̪
धूम	d̪ʱũːm
सब्ज़ीमंडी	s̪əbziːmə̃ɳɖiː
ख़ूनी	xuːn̪iː
अवाई	əʋäːiː
सरलीकृत	s̪əɾl̪iːkɾɪt̪
शान्ति	ʃä̃ːn̪t̪iː
प्रण	pɾə̃ɳ
आज़माना	äːzmäːn̪äː
नाराज़	n̪äːɾäːz
अज़दहा	əzd̪əɦäː
जज़ीरा	d͡ʒəziːɾäː
नामीबिया	n̪äːmiːbijäː
संजाल	s̪ə̃n̪d͡ʒäːl̪
सुनामी	s̪ʊn̪äːmiː
पुरातात्विक	pʊɾäːt̪äːt̪wɪk
लँगड़ाना	l̪ə̃ŋɡɽäːn̪äː
तकल्लुफ़	t̪əkəl̪l̪ʊpʰ
अप्रैल	əpɾɛːl̪
त्रासदी	t̪ɾäːs̪d̪iː
जलजनित	d͡ʒəl̪d͡ʒən̪ɪt̪
कंपनी	kə̃mpn̪iː
विमाननगर	ʋɪmä̃ːn̪n̪əɡəɾ
संरचनात्मक	s̪ə̃ɾət͡ʃn̪äːt̪mək
महसूस	mɛɦs̪uːs̪
वसीयत	ʋəs̪iːjət̪
नमाज़	n̪əmäːd͡ʒ
ज़िलाधीश	d͡ʒɪl̪äːd̪ʱiːʃ
सॉफ़्टवेयर	s̪ɔpʰʈəʋeːjəɾ
भ्रूणता	bʱɾũːɳt̪äː
बदौलत	bəd̪ɔːl̪ət̪
कुमारी	kʊmäːɾiː
जादूगरनी	d͡ʒäːd̪uːɡəɾn̪iː
घुटना	ɡʱʊʈn̪äː
निक़ाब	n̪ɪqäːb
असंगति	əs̪ə̃ŋɡət̪iː
ज़िला	zɪl̪äː
हाल	ɦäːl̪
राज़ी	ɾäːziː
तपना	t̪əpn̪äː
छिटकना	t͡ʃʰɪʈəkn̪äː
तुफ़ंग	t̪ʊpʰə̃ŋɡ
ख़तम	kʰət̪ə̃m
गिरफ़्तारी	ɡɪɾəft̪äːɾiː
मुक़ाम	mʊkä̃ːm
प्राणवायु	pɾä̃ːɳwäːjuː
प्रारंभ	pɾäːɾə̃mbʱ
बहाल	bəɦäːl̪
संशोधित	s̪ə̃n̪ʃoːd̪ʱɪt̪
सिरहाना	s̪ɪɾɦäːn̪äː
कबूल	kəbuːl̪
भाईचारा	bʱäːiːt͡ʃäːɾäː
नज़ारा	n̪əzäːɾäː
लडका	l̪əɽkäː
साइकिल	s̪äːɪkɪl̪
मलाई	məl̪äːiː
द्वार	d̪wäːɾ
बहकाना	bɛɦkäːn̪äː
व्याकरण	ʋjäːkəɾə̃ɳ
चमकना	t͡ʃəməkn̪äː
कार्यभार	käːɾjəbʱäːɾ
अनहोनी	ə̃n̪ɦoːn̪iː
योनि	joːn̪iː
अपकार	əpkäːɾ
कफ़न	kəpʰə̃n̪
हत्या	ɦət̪jäː
विधवा	ʋɪd̪ʱʋäː
इकलौता	ɪkl̪ɔːt̪äː
गोरखा	ɡoːɾkʰäː
सामर्थ्य	s̪äːməɾt̪ʰjə
माया	mäːjäː
तोंदी	t̪õːn̪d̪iː
स्वतंत्रता	s̪ʋət̪ə̃n̪t̪ɾət̪äː
लीची	l̪iːt͡ʃiː
कासा	käːs̪äː
विश्वमारी	ʋɪʃʋəmäːɾiː
कोलाहल	koːl̪äːɦəl̪
ग्राहक	ɡɾäːɦək
इंतज़ार	ɪ̃n̪t̪əd͡ʒäːɾ
शहरवासी	ʃɛɦɛɾʋäːs̪iː
धब्बा	d̪ʱəb̚bäː
चाहे	t͡ʃäːɦeː
ज्ञानवर्धन	ɡjä̃ːn̪wəɾd̪ʱə̃n̪
कंदरा	kə̃n̪d̪əɾäː
व्यावहारिक	ʋjäːʋɦäːɾɪk
शिमला	ʃɪ̃ml̪äː
प्राणी	pɾäːɳiː
सितंबर	s̪ɪt̪ə̃mbəɾ
प्राकृत	pɾäːkɾɪt̪
शालीनतापूर्वक	ʃäːl̪ĩːn̪t̪äːpuːɾʋək
नसीहत	n̪əs̪iːɦət̪
विधानसभा	ʋɪd̪ʱä̃ːn̪s̪əbʱäː
रसभरी	ɾəs̪bʱəɾiː
ठोस	ʈʰoːs̪
अट्ठासी	əʈ̚ʈʰäːs̪iː
राजनीतिज्ञ	ɾäːd͡ʒn̪iːt̪ɪɡj
घोषक	ɡʱoːʃək
भाग्यशाली	bʱäːɡjəʃäːl̪iː
निवास	n̪ɪʋäːs̪
पीला	piːl̪äː
भतीजा	bʱət̪iːd͡ʒäː
ख़लीफ़ा	xəl̪iːfäː
शार्क	ʃäːɾk
सनकना	s̪ən̪əkn̪äː
ऐसे	ɛːs̪eː
जमाना	d͡ʒəmäːn̪äː
दुक्की	d̪ʊk̚kiː
व्यंजनाक्षर	ʋjə̃n̪d͡ʒən̪äːkʃəɾ
स्विट्ज़रलैण्ड	s̪ʋɪʈzəɾl̪ɛ̃ːɳɖ
आछा	äːt͡ʃʰäː
ओष्ठ्य	oːʃʈʰjə
आखरी	äːkʰɾiː
उलटा	ʊl̪ʈäː
यरुशलम	jəɾʊʃəl̪ə̃m
बवाल	bəʋäːl̪
फ़ज़ूल	fəzuːl̪
गुहा	ɡʊɦäː
कुनबा	kʊ̃n̪bäː
कतार	kət̪äːɾ
ख़ुशामद	kʰʊʃäːməd̪
सुबह	s̪ʊbəɦ
तरक्की	t̪əɾək̚kiː
भाषाबोध	bʱäːʃäːboːd̪ʱ
औक़ात	ɔːqäːt̪
उच्चायुक्त	ʊt̚t͡ʃäːjʊkt̪
सौंदर्यशास्त्र	s̪ɔ̃ːn̪d̪əɾjəʃäːs̪t̪ɾᵊ
चटनी	t͡ʃəʈn̪iː
अमानती	əmäːn̪ət̪iː
ख़ालिक़	kʰäːl̪ɪk
लफ़्ज़	l̪əpʰd͡ʒ
नौबत	n̪ɔːbət̪
सैकंड	s̪ɛːkə̃ɳɖ
सटकना	s̪əʈəkn̪äː
यार	jäːɾ
कद्दू	kəd̪̚d̪uː
घूम	ɡʱũːm
फ़ारसी	fäːɾs̪iː
अप्रसन्न	əpɾəs̪ə̃n̪n̪ᵊ
मुंशी	mʊ̃n̪ʃiː
सघोष	s̪əɡʱoːʃ
मुआहिदा	mʊäːɦɪd̪äː
भ्रष्टाचार	bʱɾəʃʈäːt͡ʃäːɾ
भजमन	bʱəd͡ʒmə̃n̪
द्रुतगामी	d̪ɾʊt̪ɡäːmiː
सौंफ	s̪ɔ̃ːpʰ
निराला	n̪ɪɾäːl̪äː
समकोण	s̪ə̃mkõːɳ
नज़रअंदाज़	n̪əd͡ʒəɾə̃n̪d̪äːd͡ʒ
मैं	məɪ̯
दायित्ववान	d̪äːjɪt̪wəʋä̃ːn̪
हज्ज	ɦəd̚d͡ʒ
मीडिया	miːɖijäː
नित्य	n̪ɪt̪jᵊ
तहज़ीब	t̪ɛɦziːb
बयान	bəjä̃ːn̪
लिंग	l̪ɪ̃ŋɡ
मरुस्थल	məɾʊs̪t̪ʰəl̪
लीबिया	l̪iːbijäː
बग़दाद	bəɣd̪äːd̪
अनदेखा	ə̃n̪d̪eːkʰäː
रक्खना	ɾək̚kʰn̪äː
पार्श्वसरट	päːɾʃʋᵊs̪əɾəʈ
रक़बा	ɾəkbäː
वक़्फ़ा	ʋəqfäː
लट	l̪əʈ
काटना	käːʈn̪äː
निलंबित	n̪ɪl̪ə̃mbɪt̪
फ़रमाइश	fəɾmäːɪʃ
अहमियत	ɛɦmijət̪
कहर	kɛɦɛɾ
आयतन	äːjt̪ə̃n̪
बिंदु	bɪ̃n̪d̪uː
बाटना	bäːʈn̪äː
झालर	d͡ʒʱäːl̪əɾ
अंग्रेज़	ə̃ŋɡɾeːz
सुराख़	s̪ʊɾäːx
अफीम	əpʰĩːm
लोकप्रियता	l̪oːkəpɾɪjt̪äː
वृक्ष	ʋɾɪkʃ
असाढ़	əs̪äːɽʱ
हाँगर	ɦä̃ːŋɡəɾ
रूपरेखा	ɾuːpɾeːkʰäː
जैगुआर	d͡ʒɛːɡʊäːɾ
सुहावना	s̪ʊɦäːʋn̪äː
बद्दुआ	bəd̪̚d̪ʊäː
रेख़ता	ɾeːkʰt̪äː
छठवाँ	t͡ʃʰəʈʰʋä̃ː
बाती	bäːt̪iː
वियतनाम	ʋijət̪̚n̪ä̃ːm
प्रवचन	pɾəʋət͡ʃə̃n̪
जन्मदिन	d͡ʒə̃n̪md̪ɪ̃n̪
वतनपरस्त	ʋət̪ə̃n̪pəɾəs̪t̪
अंतड़ी	ə̃n̪t̪ɽiː
कौआ	kə̯uʋäː
सौंपना	s̪ɔ̃ːmpn̪äː
असंवेदनशील	əs̪ə̃mweːd̪ə̃n̪ʃiːl̪
संग्रह	s̪ə̃ŋɡɾəɦ
घिरना	ɡʱɪɾn̪äː
बेताब	beːt̪äːb
सामवेद	s̪ä̃ːmweːd̪
मालगुज़ारी	mäːl̪ɡʊzäːɾiː
दोआब	d̪oːäːb
ख़ामी	xäːmiː
तरीक़ा	t̪əɾiːqäː
सुखाना	s̪ʊkʰäːn̪äː
गुलेल	ɡʊl̪eːl̪
सस्यविज्ञान	s̪əs̪jəʋɪɡjä̃ːn̪
ढाका	ɖʱäːkäː
खोआ	kʰoːäː
वाक़ई	ʋäːqəiː
ऊफ़ा	uːpʰäː
अंकुरित	ə̃ŋkʊɾɪt̪
क्रियापद	kɾijäːpəd̪
पंजाबी	pə̃n̪d͡ʒäːbiː
राजहंस	ɾäːd͡ʒʱə̃n̪s̪
बेशक़ीमती	beːʃqĩːmt̪iː
मियाँ	mijä̃ː
खड़ूस	kʰəɽuːs̪
सुर्ख़ाब	s̪ʊɾkʰäːb
वेबसाइट	ʋeːbs̪äːɪʈ
सेवँई	s̪eːʋə̃iː
चित्ताकर्षक	t͡ʃɪt̪̚t̪äːkəɾʃək
डाकघर	ɖäːkɡʱəɾ
भिन्नता	bʱɪ̃n̪n̪t̪äː
