já	jauː
gormur	kɔrmʏr
tæla	tʰaiːla
tegrun	tʰɛɣrʏn
einhjól	einçouːl
tætingur	tʰaiːtiŋkʏr
flagasóley	flaːɣasouːleiː
nýra	niːra
korpa	kʰɔr̥pa
blámaður	plauːmaːðʏr
gröf	krœːv
grænspæta	krainspaiːta
hljómur	l̥jouːmʏr
stífla	stipla
kynhvöt	cʰɪːnkʰvœːt
sót	souːt
kennarasleikja	cʰɛnːarastleiːca
lúðalegur	luːðalɛːɣʏr
serða	sɛrða
kaffivél	kʰafːɪvjɛːl
flugslóði	flʏxstlouːðɪ
rithöfundur	rɪːthœːvʏntʏr
garðasól	karðasouːl
nafnliður	napnlɪːðʏr
ættingi	aihtiɲcɪ
regn	rɛkn
forma	fɔrma
torf	tʰɔrv
kveisa	kʰveiːsa
gráðugur	krauːðʏːɣʏr
framleiðandi	framleiːðantɪ
ökkli	œhklɪ
pissa	pʰɪsːa
friggjargras	frɪcːarkraːs
ekkjumaður	ɛhcʏmaːðʏr
gal	kaːl
herkinn	hɛr̥cɪnː
þinn	θɪnː
skotvopn	skɔːtvɔhpn
án	aunðɛs
hræ	r̥aiː
hermannaskáli	hɛrmanːaskauːlɪ
sannlega	sanːlɛːɣa
alþingi	alθiŋcɪ
hrekkja	r̥ɛhca
afbökun	avpœːkʏn
blátoppastör	plauːtʰɔhpastœːr
harðlífi	harðliːvɪ
vanda	vanta
lundi	lʏntɪ
einfaldlega	einfaltlɛːɣa
hem	hɛːm
breytni	preihtnɪ
helvískur	hɛlviskʏr
liþín	lɪːθiːn
kaupmaður	kʰøypmaːðʏr
hampjurt	ham̥pjʏr̥t
valköstur	valkʰœstʏr
frægur	fraiːɣʏr
aðalhaf	aːðalhaːv
krap	kʰraːp
hjólastóll	çouːlastoutl
vindmylla	vɪntmɪlːa
tyrkjasól	tʰɪr̥casouːl
salvadori	salvatɔːrɪ
ungur	uŋkʏr
flugfélag	flʏːɣfjɛːlaːɣ
nárú	nauːruː
bílaleiga	piːlaleiːɣa
dómstóll	toumstoutl
hefna	hɛpna
hringlaga	r̥iŋklaːɣa
hýðishrísgrjón	hiːðɪsr̥iːskrjouːn
held	hɛlt
rell	rɛtl
geðklofi	cɛðkʰlɔːvɪ
flæði	flaiːðɪ
þó	θouː
barna	partna
eplabaka	ɛhplapaːka
þorgeir	θɔrkeiːr
þriðjudagur	θrɪðjʏtaːɣʏr
hæfa	haiːva
fas	faːs
flytja	flɪːtja
kyrr	cʰʏːr
liðhlaupi	lɪðl̥øyːpɪ
heilabólga	heiːlapoulka
montinn	mɔn̥tɪnː
fis	fɪːs
heimta	heim̥ta
altaristafla	al̥taːrɪstʰapla
svartburkni	svar̥tpʏr̥knɪ
pensill	pʰɛnsɪtl
kapari	kʰaːparɪ
sverrína	svɛrːiːna
minnka	miŋ̊ka
dimmur	tɪmːʏr
gull	kʏtl
dömubindi	tœːmʏpɪntɪ
slésvík	stljɛːsviːk
miðnætti	mɪðnaihtɪ
matreiðsla	maːtreiðstla
fyrirtæki	fɪːrɪrtʰaiːcɪ
jakkaföt	jahkafœːt
kæra	cʰaiːra
nettóþyngd	nɛhtouːθiŋt
lofðungur	lɔvðuŋkʏr
kökukefli	kʰœːkʏcʰɛplɪ
plokka	pʰlɔhka
dís	tiːs
mjólkurferna	mjoul̥kʏrfɛrtna
strompur	strɔm̥pʏr
bik	pɪːk
notandi	nɔːtantɪ
efnaskipti	ɛpnascɪftɪ
anna	anːa
eldhús	ɛlthuːs
flærð	flairð
strokka	strɔhka
vissa	vɪsːa
hamborg	hampɔrk
þýfi	θiːvɪ
munnskol	mʏnːskɔːl
þýfður	θivðʏr
kvíga	kʰviːɣa
samvist	samvɪst
skræla	skraiːla
skima	scɪːma
aðgangur	aðkauŋkʏr
víður	viːðʏr
felix	fɛːlɪks
alvarlega	alvarlɛːɣa
áræðinn	auːraiːðɪnː
nýtt	niht
marxískur	mar̥ksiskʏr
sjálfsmynd	sjaulvsmɪnt
aðskilinn	aðscɪːlɪnː
háaloft	hauːalɔft
thoroddsen	tʰouːrɔtːsɛnː
þruma	θrʏːma
steinbrjótur	steinprjouːtʏr
skýra	sciːra
afturbatapíka	aftʰʏrpaːtʰapʰiːkʰa
manntal	manːtʰaːl
öfl	œpl
morð	mɔrð
hýrna	hirtna
skýr	sciːr
balsamedik	palsaːmɛːtik
mötun	mœːtʏn
olnbogi	ɔlnpɔːjɪ
taíland	tʰaiːlant
bakki	pahcɪ
nepal	nɛːpʰaːl
málmey	maulmeiː
stálull	stauːlʏtl
þíða	θiːða
prettvísi	pʰrɛhtviːsɪ
tónlist	tʰounlɪst
martröð	mar̥tʰrœːð
droplaug	trɔːpløyːɣ
verulegur	vɛːrʏlɛːɣʏr
jóakim	jouːacʰɪm
forréttur	fɔrrjɛhtʏr
mekka	mɛhka
þvarga	θvarka
sigríður	sɪɣriːðʏr
kjóll	cʰoutl
rómaborg	rouːmapɔrk
húm	huːm
dökkur	tœhkʏr
þorvaldína	θɔrvaltiːna
þögull	θœːɣʏtl
hárgreiðsla	haurkreiðstla
heimsyfirráð	heimsɪːvɪrrauːð
reykháfur	reiːkhauːvʏr
gamansemi	kaːmansɛːmɪ
búretta	puːrɛhta
brúsi	prusɪ
hrjóta	r̥jouːta
hrönn	r̥œnː
eldlilja	ɛltlɪlja
ragnar	raknaːr
dylgjur	tɪlcʏr
hangikjöt	hauŋcɪcʰœːt
hakakross	haːkakʰrɔsː
bóla	pouːla
gyðja	cɪðja
skrifstofa	skrɪfstɔːva
ætla	aihtla
ómögulegur	ouːmœːɣʏlɛːɣʏr
nafarsrauf	naːvar̥srøyːv
ei	eiː
veigra	veiɣra
samanburður	saːmanpʏrðʏr
ávallt	auːval̥t
silja	sɪlja
lófi	louːvɪ
boltaíþrótt	pɔl̥taiːθrouht
þynna	θɪnːa
útbreiðsla	uːtpreiðstla
ártíð	auːrtʰiːð
ei	ɛːɪ
aðeins	aːðeins
troða	tʰrɔːða
netla	nɛhtla
goti	kɔːtɪ
smyrsl	smɪr̥stl
flámæli	flauːmaiːlɪ
málafærslumaður	mauːlafair̥stlʏmaːðʏr
eldgos	ɛltkɔːs
notkun	nɔhtkʏn
stelpa	stɛl̥pa
blóðormur	plouːðɔrmʏr
forheimskun	fɔːrheimskʏn
útsaumur	uːtsøyːmʏr
karsi	kʰar̥sɪ
vera	vɛːra
jensína	jɛnsiːna
yrkja	ɪr̥ca
blæja	plaiːja
veikja	veiːca
finka	fiŋ̊ka
meðtaka	mɛːðtʰaːka
bleyða	pleiːða
garg	kark
menntastofnun	mɛn̥tastɔpnʏn
hafliðína	havlɪːðiːna
betla	pɛhtla
erla	ɛrtla
beiða	peiːða
fjallaljón	fjatlaljouːn
peðra	pʰɛðra
tálvon	tʰaulvɔːn
bjó	pjouː
dýna	tiːna
gjóður	couːðʏr
fita	fɪːta
bank	pauŋ̊k
fjórðapartsnóta	fjourðapʰar̥tsnouːta
kvöl	kʰvœːl
þess	θɛsː
atarna	atʰartna
joð	jɔːð
agúrka	aːkur̥ka
fingurbjargarblóm	fiŋkʏrpjarkarplouːm
forvitni	fɔrvɪhtnɪ
máltíð	maultʰiːð
öryggi	œːrɪcːɪ
prag	pʰraːɣ
kattardýr	kʰahtartiːr
perú	pʰɛːruː
ýta	iːta
vá	vauː
gerð	cɛrð
sími	siːmɪ
skiljanlega	scɪljanlɛːɣa
efli	ɛplɪ
mótherji	mouːthɛrjɪ
kverkar	kʰvɛr̥kar
líftími	liːvtʰiːmɪ
léttúðugur	ljɛhtuːðʏːɣʏr
riftun	rɪftʏn
minjagripur	mɪnjakrɪːpʏr
múta	muːta
davíð	taːviːð
vel	vɛːl
tilviljunarkenndur	tʰɪlvɪljʏnarcʰɛntʏr
lánsþýðing	launsθiːðiŋk
patríarki	pʰaːtʰrijar̥cɪ
barrfinka	parːfiŋ̊ka
gjalla	catla
formkaka	fɔrmkʰaːka
steikarhnífur	steiːkarn̥iːvʏr
borgari	pɔrkaːrɪ
gnýja	kniːja
kast	kʰast
reisa	reiːsa
fyrirliði	fɪːrɪrlɪːðɪ
krimmi	kʰrɪmːɪ
hæfni	haipnɪ
brenninetla	prɛnːɪnɛhtla
einir	eiːnɪr
venjur	vɛnjʏr
bakari	paːkaːrɪ
kóf	kʰouːv
slóvenska	stlouːvɛnska
þjófnaður	θjoupnaːðʏr
tillit	tʰɪllɪːt
hervör	hɛrvœːr
hirð	hɪrð
dyrgja	tɪrca
hrókur	r̥ouːkʏr
klæðaskápur	kʰlaiːðaskauːpʏr
tignarlegur	tʰɪknarlɛːɣʏr
sykurpúði	sɪːkʏrpʰuːðɪ
umbrot	ʏmprɔːt
hátalari	hauːtʰaːlarɪ
torfi	tʰɔrvɪ
frá	frauː
stjörnuspá	stjœrtnʏspauː
göltur	kœl̥tʏr
marbendill	marpɛntɪtl
jótland	jouːtlant
mas	maːs
fresta	frɛsta
vilhjálmía	vɪlçaulmiːja
hreyfill	r̥eiːvɪtl
kröggur	kʰrœkːʏr
leikmaður	leiːkmaːðʏr
tí	tʰiː
estragon	ɛstrakɔːn
skjaldburkni	scaltpʏr̥knɪ
greind	kreint
motta	mɔhta
hýði	hiːðɪ
telma	tʰɛlma
erill	ɛːrɪtl
múkki	muhcɪ
heyrn	heirtn
tegra	tʰɛɣra
jónína	jouːniːna
efnilegur	ɛpnɪlɛːɣʏr
kjörfursti	cʰœr̥fʏr̥stɪ
wathne	vahtnɛː
ver	vɛːr
trésmiður	tʰrjɛːsmɪːðʏr
hjörtur	çœr̥tʏr
kara	kʰaːra
nál	nauːl
sjón	sjouːn
pamfíll	pʰamfitl
flipi	flɪːpɪ
sníða	sniːða
túr	tʰuːr
slíta	stliːta
hanna	hanːa
hagsæld	haxsailt
svindl	svɪntl
pöntun	pʰœn̥tʏn
smurostur	smʏːrɔstʏr
aftursæti	aftʏrsaiːtɪ
skurðgröftur	skʏrðkrœftʏr
aðferðafræði	aðfɛrðafraiːðɪ
rósakál	rouːsakʰauːl
trésmiðja	tʰrjɛːsmɪðja
blygðun	plɪɣðʏn
malajíska	maːlaiːjiska
áskrifandi	auːskrɪːvantɪ
sófi	souːfɪ
melda	mɛlta
auga	øyːɣa
ábóti	auːpouːtɪ
gata	kaːta
þind	θɪnt
svæði	svaiːðɪ
kvenhatur	kʰvɛnhaːtʏr
áreiðanlegur	auːreiːðanlɛːɣʏr
bragliður	praɣlɪːðʏr
blóðappelsína	plouːðahpʰɛlsina
hávella	hauːvɛtla
guðmundína	kvʏðmʏntiːna
regnvatn	rɛknvahtn
pípetta	pʰiːpɛhta
innan	ɪnːan
sagreb	saːkrɛːp
passa	pʰasːa
rangur	rauŋkʏr
kría	kʰriːja
hress	r̥ɛsː
vitlaus	vɪhtløyːs
staður	staːðʏr
sinnuma	sɪnːʏma
ökuleyfi	œːkʏleiːvɪ
framreiða	framreiːða
menntaskóli	mɛn̥taskouːlɪ
forritari	fɔrːɪtaːrɪ
rífast	riːvast
tígull	tʰiːɣʏtl
gljá	kljauː
jólagjöf	jouːlacœːv
fokk	fɔhk
fræðimaður	fraiːðɪmaːðʏr
sannfærandi	sanːfaiːrantɪ
bú	puː
eyrugla	eiːrʏkla
smáorð	smauːɔrð
jöklasóley	jœhklasouːleiː
góðæri	kouːðaiːrɪ
koli	kʰɔːlɪ
gróf	krouːv
maggi	macːɪ
afmælisdagur	amːaiːlɪstaːɣʏr
samfélag	samfjɛːlaːɣ
drengur	treiŋkʏr
bretti	prɛhtɪ
mysu	mɪːsʏ
héla	çɛːla
bjarmi	pjarmɪ
ösp	œsp
knús	kʰnuːs
samtenging	samtʰeiɲciŋk
kólibrífugl	kʰouːlɪpriːfʏkl
haka	haːka
uppspretta	ʏhpsprɛhta
njáll	njautl
aðalfylking	aːðalfɪl̥ciŋk
sarí	saːriː
samningur	samniŋkʏr
björg	pjœrk
hrókera	r̥ouːkɛːra
hlekkur	l̥ɛhkʏr
opinberun	ɔːpɪnpɛːrʏn
feðraveldi	fɛðravɛltɪ
sykur	sɪːkʏr
leysigeisli	leiːsɪceistlɪ
heimsmet	heimsmɛːt
heimsálfa	heimsaulva
hver	xʷɛːr
hiti	hɪːtɪ
málsgrein	maulskreiːn
svarðmosi	svarðmɔːsɪ
lamb	lamp
sjóari	sjouːaːrɪ
regnbogi	rɛknpɔːjɪ
fíladelfía	fiːlatɛlfiːja
ertni	ɛr̥tnɪ
lævís	laiːviːs
púls	pʰuls
geil	ceiːl
ellingsen	ɛlːiŋksɛn
teygjustökk	tʰeiːjʏstœhk
dyr	tɪːr
klóna	kʰlouːna
ræðari	raiːðarɪ
ingólfur	iŋkoulvʏr
hvítá	kʰviːtauː
endir	ɛntɪr
andvarp	antvar̥p
kína	cʰiːna
nýlega	niːlɛːɣa
kaþólskur	kaːθoulskʏr
fasani	faːsaːnɪ
vélinda	vjɛːlɪnta
heimskaut	heimskøyːt
manna	manːa
hjá	çauː
kyrkingur	cʰɪr̥ciŋkʏr
svertingi	svɛr̥tiɲcɪ
nirfill	nɪrvɪtl
svefn	svɛpn
stimpill	stɪm̥pɪtl
dýrmundur	tirmʏntʏr
gimbur	cɪmpʏr
lómur	louːmʏr
hárbursti	haurpʏr̥stɪ
kalsít	kʰalsiːt
tyrkískur	tʰɪr̥ciskʏr
verpa	vɛr̥pa
þrisvar	θrɪːsvaːr
þrá	θrauː
sótt	souht
arða	arða
speki	spɛːcɪ
loftslag	lɔftslaːɣ
frakkneskur	frahknɛskʏr
man	man
pera	pʰɛːra
bárður	paurðʏr
geð	cɛːð
forsetning	fɔr̥sɛhtniŋk
þvættingur	θvaihtiŋkʏr
fær	faiːr
kynnir	cʰɪnːɪr
seiva	seiːva
íslenskur	iːslɛnskʏr
disketta	tɪskɛhta
dill	tɪlː
esóp	ɛːsouːp
lenda	lɛnta
aftaka	avtʰaːka
af	aːv
gleðikona	klɛːðɪkʰɔːna
fjallastör	fjatlastœːr
áflog	auːflɔːɣ
gleðja	klɛðja
læknir	laihknɪr
gulmaðra	kʏlmaðra
lengur	leiŋkʏr
síra	siːra
nafni	napnɪ
veski	vɛscɪ
dilkur	tɪl̥kʏr
fax	faxs
mótgerð	mouːtcɛrð
própan	pʰrouːpʰan
kvarki	kʰvar̥cɪ
þrakía	θraːcʰiːja
mýrastör	miːrastœːr
andrés	antrjɛːs
geit	ceiːt
jarðarbúi	jarðarpuːɪ
grýla	kriːla
eggleg	ɛkːlɛːɣ
opnun	ɔhpnʏn
lipur	lɪːpʏr
hreindýramosi	r̥eintiːramɔːsɪ
dóni	touːnɪ
ferskur	fɛr̥skʏr
hrafntinna	r̥apntʰɪnːa
pedall	pʰɛːtatl
útskolun	uːtskɔːlʏn
skoppa	skɔhpa
ólga	oulka
brauðrist	prøyðrɪst
þrunginn	θruɲcɪnː
sveipa	sveiːpa
hylur	hɪːlʏr
reiðubúinn	reiːðʏpuːɪnː
öl	œːl
gáleysi	kauːleiːsɪ
grænukorn	kraiːnʏkʰɔrtn
akrein	aːkreiːn
norðvestur	nɔrðvɛstʏr
heilaþvottur	heiːlaθvɔhtʏr
melding	mɛltiŋk
aðalsögn	aːðalsœkn
álandseyjar	auːlantseiːjar
bjáni	pjauːnɪ
fremja	frɛmja
átti	auhtɪ
beila	peiːla
klukkustund	kʰlʏhkʏstʏnt
hæfur	haiːvʏr
litháíska	lɪːthauːiska
líffræðilegur	liffraiːðɪlɛːɣʏr
söluskattur	sœːlʏskahtʏr
rín	riːn
klarínett	kʰlaːriːnɛht
linka	liŋ̊ka
miða	mɪːða
bergþrúður	pɛrkθruːðʏr
vé	vjɛː
mikilmenni	mɪːcɪlmɛnːɪ
skerða	scɛrða
pokadýr	pʰɔːkatiːr
kristþyrnir	kʰrɪstθɪrtnɪr
sporðdreki	spɔrðtrɛːcɪ
sút	suːt
afar	aːvar
par	pʰaːr
tefja	tʰɛvja
flak	flaːk
dama	taːma
verkefni	vɛr̥kɛpnɪ
þorskur	θɔr̥skʏr
heilalömun	heiːlalœːmʏn
tilfinning	tʰɪlfɪnːiŋk
kökkur	kʰœhkʏr
túba	tʰuːpa
refsing	rɛfsiŋk
smjörhnífur	smjœrn̥iːvʏr
göfuglyndur	kœːvʏɣlɪntʏr
yngja	iɲca
sonardóttir	sɔːnartouhtɪr
nauðgun	nøyðkʏn
staukur	støyːkʏr
stærð	stairð
vör	vœːr
ívar	iːvaːr
vilma	vɪlma
geldingalauf	cɛltiŋkaløyːv
bernharðína	pɛrnharðiːna
postulín	pʰɔstʏːliːn
kafa	kʰaːva
landnemi	lantnɛːmɪ
vigfúsína	vɪxfuːsiːna
lara	laːra
lóð	louːð
skjóða	scouːða
hurð	hʏrð
fagurblár	faːɣʏrplauːr
máta	mauːta
stika	stɪːka
aðskilnaður	aðscɪlnaːðʏr
rafgas	ravkaːs
spónn	spoutn
statistík	staːtɪstiːk
hemill	hɛːmɪtl
hlána	l̥auːna
sverfa	svɛrva
dreifilykill	treiːvɪlɪːcɪtl
hálfnóta	haulvnouːta
demba	tɛmpa
öreindafræði	œːreintafraiːðɪ
landráð	lantrauːð
messa	mɛsːa
grímur	kriːmʏr
mjálm	mjaulm
eþíópía	ɛːθjouːpʰiːja
pappír	pʰahpiːr
ræða	raiːða
kaffibrauð	kʰafːɪprøyːð
hlér	l̥jɛːr
hnupla	n̥ʏhpla
fes	fɛːs
kontrabassi	kʰɔn̥trapasːɪ
vasaorðabók	vaːsaɔrðapouːk
látbragðsleikur	lauːtpraɣðsleiːkʏr
mæri	maiːrɪ
stirðna	stɪrtna
akurarfi	aːkʏrarvɪ
klekkja	kʰlɛhca
gruna	krʏːna
gengismunur	ceiɲcɪsmʏːnʏr
ket	cʰɛːt
guðmunda	kvʏðmʏnta
keyta	cʰeiːta
raftur	raftʏr
laggóður	laɣkouːðʏr
namibía	naːmɪpiːja
negri	nɛɣrɪ
flói	flouːɪ
ninja	nɪnja
glanni	klanːɪ
handtaka	hanttʰaːka
hefill	hɛːvɪtl
prestastefna	pʰrɛstastɛpna
hvarmur	xʷarmʏr
hverflyndi	kʰvɛrvlɪntɪ
kössóttur	kʰœsːouhtʏr
tin	tʰɪːn
öryggisflokkur	œːrɪcːɪsflɔhkʏr
súld	sult
stofna	stɔpna
sálmabók	saulmapouːk
frestun	frɛstʏn
breskur	prɛskʏr
eftirlíking	ɛftɪrliːciŋk
týna	tʰiːna
yndi	ɪntɪ
seðja	sɛðja
kúla	kʰuːla
kalsín	kʰalsiːn
séní	sjɛːniː
bauja	pøyːja
bugt	pʏxt
ríkjafræði	riːcafraiːðɪ
þristur	θrɪstʏr
jafnaldri	japnaltrɪ
sól	souːl
hitamælir	hɪːtamaiːlɪr
vasadiskó	vaːsatɪskouː
minnisgóður	mɪnːɪskouːðʏr
naggrís	naɣkriːs
gráhvalur	krauːkʰvaːlʏr
fjárdráttur	fjaurtrauhtʏr
búr	puːr
villa	vɪlːa
þú	θu
skriðdreki	skrɪðtrɛːcɪ
dagbók	taɣpouːk
fíkill	fiːcɪtl
vís	viːs
spergill	spɛrcɪtl
hrynja	r̥ɪnja
lærdómur	lairtouːmʏr
norðaustur	nɔrðøystʏr
auðveldur	øyðvɛltʏr
durgur	tʏrkʏr
bekkur	pɛhkʏr
sjoppa	sjɔhpa
styrmir	stɪrmɪr
blár	plauːr
tívar	tʰiːvar
morgunn	mɔrkʏnː
klippur	kʰlɪhpʏr
bólstraberg	poulstrapɛrk
fjöldamorð	fjœltamɔrð
íhvolfur	iːkʰvɔlvʏr
föðurland	fœːðʏrlant
annáll	anːautl
hafa	haːva
slétta	stljɛhta
hrífa	r̥iːva
öðruvísi	œðrʏviːsɪ
tylla	tʰɪtla
hvirfilvindur	xʷɪrvɪlvɪntʏr
kalkúnn	kʰal̥kutn
höfgi	hœvcɪ
skapgerð	skaːpcɛrð
staðaratviksorð	staːðaraːtvɪksɔrð
gneggja	knɛcːa
kítti	cʰihtɪ
skjal	scaːl
griffill	krɪfːɪtl
beisla	peistla
kleina	kʰleiːna
heyrnartól	heirtnartʰouːl
hrækja	r̥aiːca
hugur	hʏːɣʏr
stækja	staiːca
spínat	spiːnaːt
bilun	pɪːlʏn
míga	miːɣa
banka	pauŋ̊ka
ánægður	auːnaiɣðʏr
tugabrot	tʰʏːɣaprɔːt
karen	kʰaːrɛːn
hallur	hatlʏr
gunnólfur	kʏnːoulvʏr
lest	lɛst
loga	lɔːɣa
fang	fauŋk
rein	reiːn
ögmundína	œɣmʏntiːna
karli	kʰartlɪ
sjöfn	sjœpn
persóna	pʰɛr̥souːna
ágætur	auːcaiːtʰʏr
hlaup	l̥øyːp
auglýsa	øyɣliːsa
lúta	luːta
skipaskurður	scɪːpaskʏrðʏr
kúlulega	kʰuːlʏlɛːɣa
prentduft	pʰrɛn̥ttʏft
eðja	ɛðja
biskupsdæmi	pɪskʏpstaiːmɪ
hiksti	hɪxstɪ
skoða	skɔːða
branda	pranta
skordýr	skɔrtiːr
h	hauː
heimsvísa	heimsviːsa
hrekja	r̥ɛːca
frímerkjasafnari	friːmɛr̥casapnaːrɪ
háttaratviksorð	hauhtaraːtvɪksɔrð
fulltingi	fʏtl̥tʰiɲcɪ
túnvingull	tʰunviŋkʏtl
nýting	niːtiŋk
tötralegur	tʰœːtralɛːɣʏr
þinur	θɪːnʏr
fjón	fjouːn
draumur	trøyːmʏr̥
fiskur	fɪskʏr
þakklæti	θahklaiːtɪ
hríðarbylur	r̥iːðar̥pɪːlʏr̥
þérun	θjɛːrʏn
rotnun	rɔhtnʏn
rot	rɔːt
pækill	pʰaiːcɪtl
laukur	løyːkʏr
geislabaugur	ceistlapøyːɣʏr
bossi	pɔsːɪ
fuglakjöt	fʏklacʰœːt
brýna	priːna
framleiðsla	framleiðstla
dyntur	tɪn̥tʏr
portúgalska	pɔr̥tuːkalska
rósmarín	rouːsmariːn
brugg	prʏkː
lífefnafræði	liːvɛpnafraiːðɪ
pakkhús	pʰahkhuːs
vernda	vɛrnta
blaðra	plaðra
kirja	cʰɪrja
veðurtungl	vɛːðʏrtʰuŋl
grynna	krɪnːa
gröftur	krœftʏr
særa	saiːra
fursti	fʏr̥stɪ
þroti	θrɔːtɪ
deigur	teiːɣʏr
bræði	praiːðɪ
kirkja	cʰɪr̥ca
bekkjarfélagi	pɛhcarfjɛːlaːjɪ
læra	laiːra
rokk	rɔhk
tíðni	tʰiðnɪ
fimma	fɪmːa
dregill	treiːjɪtl
svín	sviːn
óáreiðanleiki	ouːauːreiːðanleiːcɪ
svunta	svʏn̥ta
harma	harma
hamborgari	hampɔrkarɪ
þraut	θrøyːt
fegurð	fɛːɣʏrð
stinnastör	stɪnːastœːr
ákefð	auːcɛvð
giska	cɪska
spritt	sprɪht
kirkjubær	cʰɪr̥cʏpaiːr
viðar	vɪːðaːr
yppa	ɪhpa
færeyska	faiːreiska
fórn	fourtn
ildi	ɪltɪ
lygn	lɪkn
paxblað	pʰaxsplaːð
ekta	ɛxta
búkur	puːkʏr
forvöð	fɔrvœːð
sífelldur	siːfɛltʏr
saurugur	søyːrʏːɣʏr
eignarfornafn	eiknarfɔrnapn
kajak	kʰaiːjaːk
schram	skraːm
hellir	hɛtlɪr
áburður	auːpʏrðʏr
hrun	r̥ʏːn
þjóð	θjouːð
leirburður	leirpʏrðʏr
múrbrjótur	murprjouːtʏr
lausnarhraði	løystnarr̥aːðɪ
alvara	alvaːra
geldingahnappur	cɛltiŋkan̥ahpʏr
muldra	mʏltra
kyn	cʰɪːn
þegn	θɛkn
val	vaːl
hvítasunna	xʷiːtasʏnːa
dómpápi	toumpʰauːpɪ
frumskógur	frʏmskouːʏr
hamar	haːmar
járning	jaurtniŋk
hnútur	n̥uːtʏr
hraða	r̥aːða
afi	aːvɪ
lyst	lɪst
skelkur	scɛl̥kʏr
belti	pɛl̥tɪ
fagott	faːkɔht
börkur	pœr̥kʏr
gálgi	kaulcɪ
fágaður	fauːaðʏr
skiptavinur	skɪftavɪːnʏr
rúmföt	rumfœːt
brennsla	prɛnstla
fálma	faulma
anga	auŋka
ítalía	iːtʰaːliːja
kúld	kʰult
ingi	iɲcɪ
dvelja	tvɛlja
stofn	stɔpn
ól	ouːl
dvína	tviːna
kol	kʰɔːl
íkorni	iːkʰɔrtnɪ
skjaldbaka	scaltpaːka
mitti	mɪhtɪ
selkjöt	sɛlcʰœːt
lausn	lœistn
skunkur	skuŋ̊kʏr
kúlupenni	kʰuːlʏpʰɛnːɪ
mestur	mɛstʏr
hind	hɪnt
mylja	mɪlja
hvar	xʷaːr
hauskúpa	høyːskʰuːpa
vænta	vain̥ta
strit	strɪːt
samkennd	samcʰɛnt
dótturdóttir	touhtʏrtouhtɪr
sólarlag	souːlarlaːɣ
skulu	skʏːlʏ
fúga	fuːka
miðeyra	mɪːðeiːra
derringur	tɛrːiŋkʏr
þjark	θjar̥k
flygilhorn	flɪjɪlhɔrtn
hrynjandi	r̥ɪnjantɪ
dulargervi	tʏːlarcɛrvɪ
græðgi	kraiðcɪ
greiðslukort	kreiðstlʏkʰɔr̥t
akkur	ahkʏr
rönd	rœnt
títt	tʰiht
veiði	veiːðɪ
rjómaostur	rjouːmaɔstʏr
vatnalilja	vahtnalɪlja
kefla	cʰɛpla
jóskur	jouskʏr
fáviti	fauːvɪːtɪ
ræpa	raiːpa
kjötæta	cʰœːtaiːta
löngun	løyŋkʏn
þurrkur	θʏr̥kʏr
hróný	r̥ouːniː
niðji	nɪðjɪ
handleggur	hantlɛkːʏr
neita	neiːta
grúbba	krupːa
flinkur	fliŋ̊kʏr
írónía	iːrouːniːja
byssukúla	pɪsːʏkʰuːla
stytting	stɪhtiŋk
söl	sœːl
skita	scɪːta
aþeningur	aːθɛːniŋkʏr
kafald	kʰaːvalt
blók	plouːk
afklæða	avkʰlaiːða
múr	muːr
sinfóníuhljómsveit	sɪnfouːniːjʏl̥joumsveiːt
stjörnufræði	stjœrtnʏfraiːðɪ
gæludýr	caiːlʏtiːr
mýrdalína	mirtaːliːna
lauslátur	løyːslauːtʏr
fórnarlamb	fourtnarlamp
þak	θaːk
naumur	nøyːmʏr
mannvit	manːvɪːt
undirheiti	ʏntɪrheiːtɪ
birta	pɪr̥ta
lita	lɪːta
sulla	sʏtla
hlýðinn	l̥iːðɪnː
farði	farðɪ
lagður	laɣðʏr
neptúnus	nɛptʰuːnʏs
saltsýra	sal̥tsiːra
moskítófluga	mɔsciːtouːflʏːɣa
öfga	œvka
duttlungafullur	tʏhtluŋkafʏtlʏr
askur	askʏr
þumalputti	θʏːmalpʰʏhtɪ
grávíðir	krauːviːðɪr
uggur	ʏkːʏr
heill	heitl
borg	pɔrk
áreynsla	auːreinstla
hót	houːt
þrúður	θruːðʏr
guðvaldína	kvʏðvaltiːna
nefdýr	nɛvtiːr
unnar	ʏnːaːr
burst	pʏr̥st
ilmur	ɪlmʏr
hnýta	n̥iːta
hnerri	n̥ɛrːɪ
jensen	jɛnsɛnː
slanga	stlauŋka
stirður	stɪrðʏr
sif	sɪːv
latína	laːtʰiːna
eyrnapinni	eirtnapʰɪnːɪ
eignarhaldsfélag	eiknarhaltsfjɛːlaːɣ
prótín	pʰrouːtiːn
norska	nɔr̥ska
pýþagóras	pʰiːθakouːraːs
gróður	krouːðʏr
fága	fauːa
svaladrykkur	svaːlatrɪhkʏr
ingibjörg	iɲcɪpjœrk
romm	rɔmː
hraðbraut	r̥aðprøyːt
fugl	fʏkl
eldast	ɛltast
bóndabær	pountapaiːr
tannhvalur	tʰanːkʰvaːlʏr
flónskur	flounskʏr
tungumál	tʰuŋkʏmauːl
klumpur	kʰlʏm̥pʏr
ráðgáta	rauðkauːta
evrópa	ɛvrouːpa
teningur	tʰɛːniŋkʏr
eyra	eira
tölvuspil	tʰœlvʏspɪːl
teppa	tʰɛhpa
ölgerðarhús	œlcɛrðarhuːs
gjaldmiðill	caltmɪːðɪtl
frjór	frjouːr
nafli	naplɪ
höggormur	hœkːɔrmʏr
visk	vɪsk
húsnæði	huːsnaiːðɪ
kveikur	kʰveiːkʏr
aðalheiður	aːðalheiːðʏr
gulna	kʏlna
frónskur	frounskʏr
litningur	lɪhtniŋkʏr
árósar	auːrouːsar
hjarna	çartna
jen	jɛːn
ýja	iːja
skaft	skaft
gredda	krɛtːa
sexa	sɛksa
lærleggur	lairlɛkːʏr
eintal	eintʰaːl
rostungur	rɔstuŋkʏr
undirfylking	ʏntɪr̥fɪl̥ciŋk
bursta	pʏr̥sta
doktor	tɔxtɔr
hengill	heiɲcɪtl
kornbretaland	kʰɔrtnprɛːtalant
nafnið	napnɪð
lögur	lœːɣʏr
fró	frouː
þúbróðir	θuːprouːðɪr
gagnagrunnur	kaknakrʏnːʏr
skaðlegur	skaðlɛːɣʏr
kjálki	cʰaul̥cɪ
segulljós	sɛːɣʏlljouːs
gráði	krauːðɪ
ræfill	raiːvɪtl
alvarlegur	alvarlɛːɣʏr
fimmti	fɪm̥tɪ
tollskýrsla	tʰɔtl̥scir̥stla
vettugi	vɛhtʏjɪ
benda	pɛnta
kalka	kʰal̥ka
loppa	lɔhpa
lýsingarháttur	liːsiŋkarhauhtʏr
blóðbogi	plouːðpɔːjɪ
arsen	ar̥sɛn
ástríður	austriːðʏr
kalifornía	kʰaːlɪfɔrnija
dúfa	tuːva
kryppa	kʰrɪhpa
skata	skaːta
aðaláhugamál	aːðaːlauːhʏːɣamauːl
íslenskur	istlɛnskʏr
asetón	aːsɛːtʰouːn
afríka	aːfriːka
hamagangur	haːmakauŋkʏr
fífl	fipl
prófun	pʰrouːvʏn
lauf	løyːv
gosi	kɔːsɪ
járnbrautarlest	jaurtnprøyːtarlɛst
þrjóska	θrjouska
trúss	tʰrusː
þumlungur	θʏmluŋkʏr
ofbeldi	ɔvpɛltɪ
dreki	trɛːcɪ
tyggjó	tʰɪcːouː
leiðarstef	leiːðarstɛːv
fákur	fauːkʏr
landafræði	lantafraiːðɪ
klunnalegur	kʰlʏnːalɛːɣʏr
haga	haːɣa
knútur	kʰnuːtʏr
syrgja	sɪrca
gusa	kʏːsa
páskalilja	pʰauskalɪlja
kjarr	cʰarː
vanrækja	vanraiːca
alklæddur	aːlkʰlaitːʏr
hópkynlíf	houːpcʰɪnliːv
bára	pauːra
klápur	kʰlauːpʏr
guðlaug	kvʏðløyːɣ
hvolpur	kʰvɔl̥pʏr
eyðilegging	eiːðɪlɛcːiŋk
hreppur	r̥ɛhpʏr
kríli	kʰriːlɪ
hólmfríður	houlmfriːðʏr
innræting	ɪnːraiːtiŋk
kamelljón	kʰaːmɛlljouːn
velja	vɛlja
víðfrægur	viðfraiːɣʏr
afsökun	afsœːkʏn
þiggja	θɪcːa
garðyrkjumaður	karðɪr̥cʏmaːðʏr
sólmyrkvi	soulmɪr̥kvɪ
megin	meiːjɪn
sifjar	sɪvjar
drit	trɪːt
mosajafni	mɔːsajapnɪ
vara	vaːra
beiti	peiːtɪ
faggi	facːɪ
bjarga	pjarka
þið	θɪð
gnarr	knarː
prúðmenni	pʰruðmɛnːɪ
norðurland	nɔrðʏrlant
gulvíðir	kʏlviːðɪr
lærisveinn	laiːrɪsveitn
rjúpa	rjuːpa
tófa	tʰouːva
fjarvera	fjarvɛːra
japan	jaːpʰaːn
grípa	kriːpa
ljóstýra	ljouːstʰiːra
arfi	arvɪ
töfrasproti	tʰœvrasprɔːtɪ
nýsilfur	niːsɪlvʏr
drift	trɪft
háttarökfræði	hauhtarœkfraiːðɪ
hjúkrunarheimili	çuːkrʏnarheiːmɪlɪ
kengúra	cʰeiŋkuːra
slíður	stliːðʏr
hamla	hamla
erilsamur	ɛːrɪlsaːmʏr
kórea	kʰouːrɛːa
málstol	maulstɔːl
eigra	eiɣra
brúður	pruːðʏr
hryssingur	r̥ɪsːiŋkʏr
apalhraun	aːpalr̥øyːn
dauðakippur	tøyːðacʰɪhpʏr
langamma	lauŋkamːa
samhengi	samheiɲcɪ
fönikía	fœːnɪcʰiːja
hús	huːs
nopi	nɔːpɪ
orfa	ɔrva
undarlega	ʏntarlɛːɣa
skæla	scaiːla
timburmaður	tʰɪmpʏrmaːðʏr
fæðing	faiːðiŋk
blæðari	plaiːðarɪ
flug	flʏːɣ
knattspyrnukona	kʰnahtspɪrtnʏkʰɔːna
ræðismannsbústaður	raiːðɪsmanspuːstaːðʏr
ráðning	rauðniŋk
þorsti	θɔr̥stɪ
nesti	nɛstɪ
basl	pastl
ufsi	ʏfsɪ
aría	aːriːja
meri	mɛːrɪ
dragt	traxt
þykkja	θɪhca
blóðflaga	plouðflaːɣa
senda	sɛnta
goðafræði	kɔːðafraiːðɪ
orðsifjabók	ɔrðsɪvjapouːk
fimm	fɪmː
árni	autnɪ
rækt	raixt
plógur	pʰlouːʏr
skríll	skritl
hjáleið	çauːleiːð
gengi	ceiɲcɪ
móanóra	mouːanouːra
bergsóley	pɛrksouːleiː
spánska	spaunska
krol	kʰrɔːl
vinstur	vɪnstʏr
frétt	frjɛht
indland	ɪntlant
hreindís	r̥eintiːs
þorn	θɔrtn
börn	pœrtn
fælni	failnɪ
fótbolti	fouːtpɔl̥tɪ
hali	haːlɪ
hvítblæði	xʷiːtplaiːðɪ
spil	spɪːl
fingur	fiŋkʏr
knega	kʰnɛːɣa
syrja	sɪrja
riðill	rɪːðɪtl
spurnarfornafn	spʏrtnarfɔrnapn
nepja	nɛːpja
nes	nɛːs
greining	kreiːniŋk
rauðrófa	røyðrouːva
aðventa	aðvɛn̥ta
þvegill	θveiːjɪtl
býr	piːr̥
bras	praːs
áhugamál	auːhʏːɣamauːl
lykkja	lɪhca
origami	ɔːrɪkamɪ
snúður	stnuːðʏr
safnið	sapnɪð
okra	ɔːkra
hrjúfur	r̥juːvʏr
gripur	krɪːpʏr
öld	œlt
eftirsókn	ɛftɪrsouhkn
vömb	vœmp
moldvarpa	mɔltvar̥pa
heyrnarlaus	heirtnarløyːs
forhúð	fɔːrhuːð
lágmynd	lauɣmɪnt
klauf	kʰløyːv
tröllkona	tʰrœtlkʰɔːna
hvaða	kʰvaːða
blossi	plɔsːɪ
ljósvaki	ljouːsvaːcɪ
dæla	taiːla
sá	sauː
skari	skaːrɪ
næstur	naistʏr
hamur	haːmʏr
hvass	kʰvasː
jarma	jarma
bretland	prɛːtlant
dílaskóf	tiːlaskouːv
miltisbrandur	mɪl̥tɪsprantʏr
albínói	alpiːnouːɪ
haldinn	haltɪnː
gorta	kɔr̥ta
íslenska	istlɛnska
skítugur	sciːtʏːɣʏr
skarfur	skarvʏr
bústinn	pustɪnː
jarðúlfur	jarðulvʏr
hélumosi	çɛːlʏmɔːsɪ
jarðsvín	jarðsviːn
pólland	poullant
kleif	kʰleiːv
tak	tʰaːk
jarðarberjasulta	jarðarpɛːrjasʏl̥ta
forstjóri	fɔr̥stjouːrɪ
banna	panːa
töf	tʰœːv
rekald	rɛːkalt
snið	stnɪːð
greiða	kreiːða
jurt	jʏr̥t
misjafn	mɪːsjapn
skelfa	scɛlva
bjartsýni	pjar̥tsiːnɪ
kal	kʰaːl
pálmar	pʰaulmar
baugfingur	pøyxfiŋkʏr
drangi	trauɲcɪ
maur	møyːr
gjóla	couːla
stuðull	stʏːðʏtl
jólabókaflóð	jouːlapouːkaflouːð
kið	cʰɪːð
riflás	rɪvlauːs
áfall	auːfatl
gat	kaːt
jaðarrokk	jaːðarrɔhk
undirlendi	ʏntɪrlɛntɪ
miðmyndarsögn	mɪðmɪntarsœkn
svali	svaːlɪ
mí	miː
lukt	lʏxt
búðarþjófur	puːðarθjouːvʏr
finna	fɪnːa
þjóta	θjouːta
beyki	peiːcɪ
plampa	pʰlam̥pa
gljúfur	kljuːvʏr
katrín	kʰaːtriːn
lykill	lɪːcɪtl
blómstra	ploumstra
skella	scɛtla
fljótur	fljouːtʏr
sófókles	souːfouːkʰlɛːs
nefnilega	nɛpnɪlɛɣa
knörr	kʰnœrː
mjallhvít	mjahtlkvit
ameríka	aːmɛːriːka
nikkel	nɪhkɛl
breidd	preitː
evklíð	ɛvkʰliːð
káfa	kʰauːva
knall	kʰnalː
krúna	kʰruna
megra	mɛɣra
stormur	stɔrmʏr
vígður	viɣðʏr
saumavél	søyːmavjɛːl
líffræði	liffraiːðɪ
prófa	pʰrouːva
mjókka	mjouhka
gjöfull	cœːvʏtl
gestgjafi	cɛstcaːvɪ
páfagaukur	pʰauːvakøyːkʏr
hérmeð	çɛrmɛːð
þyrnóttur	θɪrtnouhtʏr
áhugasamur	auhʏːɣasaːmʏr
hemja	hɛmja
neyða	neiːða
yfirgefa	ɪːvɪrcɛːva
málmur	maulmʏr
bæ	paiː
glæta	klaiːta
laugasef	løyːɣasɛːv
sögumaður	sœːɣʏmaːðʏr
sykra	sɪːkra
túli	tʰuːlɪ
kantata	kʰan̥taːta
melaskóli	mɛːlaskouːlɪ
þig	θɪːɣ
slóvakía	stlouːvacʰiːja
skúfur	skuːvʏr
krakk	kʰrahk
netjuský	nɛːtjʏsciː
aftur	aftʏr
gönguferð	køyŋkʏfɛrð
hárlýja	haurliːja
sveigja	sveiːja
kyrking	cʰɪr̥ciŋk
álaborg	auːlapɔrk
arnheiður	artnheiːðʏr
álma	aulma
eplasafi	ɛhplasaːvɪ
galdur	kaltʏr
krukka	kʰrʏhka
dalalilja	taːlalɪlja
rækta	raixta
kjarnakorn	cʰartnakʰɔrtn
málmblanda	maulmplanta
sinfónía	sɪnfouːniːja
listmálari	lɪstmauːlarɪ
kvöldmatur	kʰvœltmaːtʏr
bæla	paiːla
lottó	lɔhtouː
hjallur	çatlʏr
mannréttindi	manːrjɛhtɪntɪ
brekkusnigill	prɛhkʏstnɪːjɪtl
hálfviti	haulvvɪːtɪ
varkár	var̥kʰauːr
ís	iːs
hjálmtýr	çaulmtʰiːr
erlendur	ɛtlɪntʏr
fyrirgjöra	fɪːrɪrcœːra
ós	ouːs
hræðilega	r̥aiːðɪlɛːɣa
hark	har̥k
tólúen	tʰouːluːɛːn
vinur	vɪːnʏr
líra	liːra
gjamma	camːa
þátttaka	θauhttʰaːka
berja	pɛrja
snarka	snar̥ka
einkalykill	eiŋkalɪːcɪtl
hjúkra	çuːkra
hirða	hɪrða
spegill	speiːjɪtl
gala	kaːla
lyftutónlist	lɪftʏtʰounlɪst
rándýr	rauntiːr
júní	juːniː
djók	tjouːk
þurfa	θʏrva
gallalaus	katlaløyːs
prammi	pʰramːɪ
úldna	ultna
orðsending	ɔrðsɛntiŋk
hraði	r̥aːðɪ
vínviður	vinvɪːðʏr
kanadagæs	kʰaːnatacaiːs
há	hauː
sepi	sɛːpɪ
lettneska	lɛhtnɛska
sardinía	sartɪniːja
smyrja	smʏrja
dílaburkni	tiːlapʏr̥knɪ
vegarfi	vɛːɣarvɪ
fleki	flɛːcɪ
svínakjöt	sviːnacʰœːt
lestrarbók	lɛstrarpouːk
beitilyng	peiːtɪliŋk
grána	krauːna
fornkirkjuslavneska	fɔrtncʰɪr̥cʏslaːvnɛska
blekbytta	plɛːkpɪhta
orgel	ɔrkɛːl
guðfræðingur	kvʏðfraiðiŋkʏr
álfadrottning	aulvatrɔhtniŋk
skessa	scɛsːa
fjarlægja	fjarlaiːja
más	mauːs
nýta	niːta
eva	ɛːva
írland	irlant
namm	namː
meddi	mɛtːɪ
áreiðanleiki	auːreiːðanleiːcɪ
háband	hauːpant
áhyggja	auːhɪcːa
kví	kʰviː
igla	ɪkla
ræll	raitl
guðlegur	kvʏðlɛːɣʏr
fótsnyrting	fouːtsnɪr̥tiŋk
endaþarmsmök	ɛntaθarmsmœːk
bakuggi	paːkʏcːɪ
smiðja	smɪðja
tagl	tʰakl
frjóþráður	frjouːθrauːðʏr
gleðispillir	klɛːðɪspɪtlɪr
riffill	rɪfːɪtl
evklíðskur	ɛvkʰliðskʏr
legging	lɛcːiŋk
púpa	pʰuːpa
mólýbden	mouːliptɛːn
rafeind	raːveint
meðlimur	mɛðlɪːmʏr
frakki	frahcɪ
þræla	θraiːla
menga	meiŋka
belja	pɛlja
markalína	mar̥kaliːna
eruð	ɛːrʏð
stífna	stipna
vagn	vakn
mæðgur	maiðkʏr
gauð	køyːð
þvag	θvaːɣ
speli	spɛːlɪ
nauð	nøyːð
ráp	rauːp
adda	atːa
flákaský	flauːkasciː
happdrætti	hahptraihtɪ
raup	røyːp
gleypa	kleiːpa
getnaður	cɛhtnaːðʏr
búralegur	puːralɛːɣʏr
pantur	pʰan̥tʏr
neysla	neistla
kreppa	kʰrɛhpa
svæfill	svaiːvɪtl
sakna	sahkna
lénharður	ljɛːnharðʏr
ferðamaður	fɛrðamaːðʏr
árstíð	aurstʰiːð
jiddíska	jɪtːiska
linur	lɪːnʏr
viðbragð	vɪðpraɣð
hlíð	l̥iːð
strá	strauː
rani	raːnɪ
klæða	kʰlaiːða
heimild	heiːmɪlt
kínverska	cʰinvɛr̥ska
rör	rœːr
svangur	svauŋkʏr
setja	sɛːtja
forjaxl	fɔːrjakstl
hlera	l̥ɛːra
glymur	klɪːmʏr
samheitaorðabók	samheiːtaɔrðapouːk
hugi	hʏːjɪ
vaða	vaːða
læti	laiːtɪ
nytsamur	nɪːtsaːmʏr
drama	traːma
þorna	θɔrtna
dagskrá	taxskrauː
frostpinni	frɔstpʰɪnːɪ
pempía	pʰɛm̥piːja
dreyri	treiːrɪ
jafnoki	japnɔːcɪ
sexa	sɛxsa
hagfræði	haxfraiːðɪ
jeppi	jɛhpɪ
e	ɛː
lögregla	lœɣrɛkla
lén	ljɛːn
samþykkt	samθɪxt
snæfríður	stnaiːfriːðʏr
skurn	skʏrtn
austur	øystʏr
vígvöllur	viɣvœtlʏr
vekja	vɛːca
greina	kreiːna
hvatur	kʰvaːtʏr
sinni	sɪnːɪ
guðdís	kvʏðtiːs
byrstur	pɪr̥stʏr
falur	faːlʏr
rafsvið	ravsvɪːð
leikrit	leiːkrɪːt
vifta	vɪfta
blágresi	plauːkrɛːsɪ
útlenskur	uːtlɛnskʏr
snilli	stnɪlːɪ
innbrot	ɪnːprɔːt
lógresi	louːkrɛːsɪ
fern	fɛrtn
munnharpa	mʏnːhar̥pa
færa	faiːra
var	vaːr
beygja	peiːja
póstmódernismi	poustmouːtɛrnɪsmɪ
fornafn	fɔrnapn
brak	praːk
hæða	haiːða
kúrdíska	kʰurtiska
telpa	tʰɛl̥pa
kraftur	kʰraftʏr
gíslína	cistliːna
gyrðir	cɪrðɪr
á	auː
juða	jʏːða
blóðleysi	plouðleiːsɪ
kálfi	kʰaulvɪ
röskun	rœskʏn
eimskip	eimscɪːp
hnífasmiður	n̥iːvasmɪːðʏr
pota	pʰɔːta
duld	tʏlt
spanjóli	spanjouːlɪ
andvari	antvaːrɪ
eir	eiːr
föl	fœːl
spekt	spɛxt
emja	ɛmja
saggi	sacːɪ
sneddí	stnɛtːi
slátur	stlauːtʏr
snjór	snjouːr
sýkja	siːca
buga	pʏːɣa
stjórnpallur	stjourtnpʰatlʏr
ger	cɛːr
herða	hɛrða
veturliði	vɛːtʏrlɪːðɪ
legunautur	lɛːɣʏnøyːtʏr
bardagi	partaːjɪ
þaðan	θaːðan
vasahnífur	vaːsan̥iːvʏr
blöðruselur	plœðrʏsɛːlʏr
fólínsýra	fouːliːnsiːra
skírlífi	scirliːvɪ
skriðsóley	skrɪðsouːleiː
andlit	antlɪːt
þurrka	θʏr̥ka
sópur	souːpʏr
krossfiskur	kʰrɔsːfɪskʏr
appelsína	ahpɛlsiːna
horn	hɔrtn
þróa	θrouːa
klukka	kʰlʏhka
skila	scɪːla
sekvensa	sɛːkʰvɛnsa
blíða	pliːða
slægur	slaiːɣʏr
eðlisfræði	ɛðlɪsfraiːðɪ
lesandabréf	lɛːsantaprjɛːv
örva	œrva
ólífa	ouːliːva
tumi	tʰʏːmɪ
ferna	fɛrtna
atgervi	aːtcɛrvɪ
ábyrgur	auːpɪrkʏr
pálína	pʰauːliːna
andúð	antuːð
rétta	rjɛhta
þingmaður	θiŋkmaːðʏr
snurðulaus	stnʏrðʏløyːs
blettatígur	plɛhtatʰiːɣʏr
hnífasmíði	n̥iːvasmiːðɪ
hnappstör	n̥ahpstœːr
sitjandi	sɪːtjantɪ
kóða	kʰouːða
kroppa	kʰrɔhpa
síma	siːma
deita	teiːta
spakur	spaːkʏr
skjól	scouːl
krumla	kʰrʏmla
snilli	stnɪtlɪ
erfingi	ɛrviɲcɪ
trimma	tʰrɪmːa
flækja	flaiːca
árabátur	auːrapauːtʏr
væskill	vaiscɪtl
mýmargur	miːmarkʏr
týtulíngresi	tʰiːtʏlinkrɛːsɪ
skruma	skrʏːma
gáski	kauscɪ
völva	vœlva
lotukerfi	lɔːtʏcʰɛrvɪ
svívirða	sviːvɪrða
eggjaskurn	ɛcːaskʏrtn
appelsínugulur	ahpɛlsiːnʏkʏːlʏr
aðalból	aːðalpouːl
þyrsta	θɪr̥sta
hinn	hɪnː
ferskja	fɛr̥sca
verður	vɛrðʏr
búðareigandi	puːðareiːɣantɪ
dalía	taːliːja
kvikmyndahús	kʰvɪːkmɪntahuːs
minnisgripur	mɪnːiskrɪːpʏr
umskera	ʏmscɛːra
prestur	pʰrɛstʏr
haft	haft
deyfð	teivð
erlendína	ɛrlɛntiːna
liðfætla	lɪðfaihtla
indriði	ɪntrɪːðɪ
sinna	sɪnːa
æringi	aiːriɲcɪ
hér	çɛːr
þyngdarsvið	θiŋtarsvɪːð
rás	rauːs
forsæla	fɔr̥saiːla
innyfli	ɪnːɪplɪ
plast	pʰlast
kastali	kʰastaːlɪ
einasti	eiːnastɪ
rasssæri	rassaiːrɪ
breytilegur	preiːtɪlɛːɣʏr
nægja	naiːja
haugarfi	høyːɣarvɪ
kljúfa	kʰljuːva
dý	tiː
sturlína	stʏrtliːna
fiðla	fɪðla
gjörð	cœrð
færiband	faiːrɪpant
óvarkárni	ouːvar̥kʰaurtnɪ
elli	ɛlːɪ
alvitur	alvɪːtʏr
lygi	lɪiːjɪ
lötra	lœːtra
karp	kʰar̥p
frelsingi	frɛlsiɲcɪ
minkur	miŋ̊kʏr
áræði	auːraiːðɪ
ingólfína	iŋkoulviːna
hárleggjastör	haurlɛcːastœːr
hagl	hakl
virkja	vɪr̥ca
forsetningarliður	fɔr̥sɛhtniŋkarlɪːðʏr
hindra	hɪntra
stöng	støyŋk
stífur	stiːvʏr
gvatemala	kvaːtʰɛːmaːla
krakkaskömm	kʰrahkaskœmː
prósenta	pʰrouːsɛn̥ta
leiðari	leiːðaːrɪ
uppgjör	ʏhpcœːr
herðatré	hɛrðatrjɛː
blekking	plɛhkiŋk
smíða	smiːða
fregn	frɛkn
pása	pʰauːsa
grimmur	krɪmːʏr
hótel	houːtɛl
snupra	snʏːpra
minn	mɪnː
laug	løyːɣ
pelíkani	pʰɛliːkaːnɪ
skaut	skøyːt
kattarjurt	kʰahtarjʏr̥t
náttúrulegur	nauhtuːrʏlɛɣʏr
ex	ɛxs
brynjólfur	prɪnjoulvʏr
bensínstöð	pɛnsinstœːð
sjónauki	sjouːnøyːcɪ
stýri	stiːrɪ
hríspappír	r̥iːspʰahpiːr
skemmtilegur	skɛm̥tɪlɛːɣʏr
móðurmál	mouːðʏrmauːl
skuldari	skʏltaːrɪ
bel	pɛːl
tvíburi	tʰviːpʏːrɪ
snjallsími	stnjatlsiːmɪ
brennisteinn	prɛnːɪsteitn
gefa	cɛːva
norrænn	nɔrrain
patt	pʰaht
holtasóley	hɔl̥tasouːleiː
traf	tʰraːv
pepperóní	pʰɛhpɛrouːniː
afhenda	afhɛnta
stóðgarður	stouðkarðʏr
rekkja	rɛhca
handknattleiksþjálfari	hantkʰnahtleiksθjaulvarɪ
meðferð	mɛðfɛrð
öndun	œntʏn
lending	lɛntiŋk
sperðileitrun	spɛrðɪleiːtrʏn
tugur	tʰʏːɣʏr
barki	par̥cɪ
ríbónúkleasi	riːpouːnuːkʰlɛːaːsɪ
fiskifræði	fɪscɪfraiːðɪ
hrotti	r̥ɔhtɪ
þröng	θrøyŋk
ofurhetja	ɔːvʏrhɛːtja
sópa	souːpa
menntun	mɛn̥tʏn
hreysa	r̥eiːsa
mála	mauːla
blika	plɪːka
glóðarauga	klouːðarøyːɣa
mispill	mɪspɪtl
nagladekk	naklatɛhk
ká	kʰauː
rámur	rauːmʏr
lýsingarorð	liːsiŋkaːrɔrð
troga	tʰrɔːɣa
sómalía	souːmaliːja
gunndís	kʏnːtiːs
grúpa	kruːpa
forskaut	fɔr̥skøyːt
fjólmundur	fjoulmʏntʏr
ferming	fɛrmiŋk
snæland	snaiːlant
móta	mouːta
eldjárn	ɛltjaurtn
hrís	r̥iːs
íverufall	iːvɛːrʏfatl
óður	ouːðʏr
olía	ɔːliːja
gestur	cɛstʏr
hendni	hɛntnɪ
klak	kʰlaːk
dymbildagavika	tɪmpɪltaːɣavɪːka
draumlaus	trøymløyːs
brandugla	prantʏkla
skriða	skrɪːða
hreysiköttur	r̥eiːsɪkʰœhtʏr
þáttur	θauhtʏr
pasta	pʰasta
bruggun	prʏkːʏn
starfa	starva
freisting	freistiŋk
ess	ɛsː
frystir	frɪstɪr
ljósabekkur	ljouːsapɛhkʏr
keila	cʰeiːla
atferli	aːtfɛrtlɪ
kennd	cʰɛnt
roð	rɔːð
sámsey	saumseiː
búðarþjófnaður	puːðarθjoupnaːðʏr
liðveisla	lɪðveistla
bófi	pouːvɪ
latur	laːtʏr
pennavinur	pʰɛnːavɪːnʏr
undirflokkur	ʏntɪr̥flɔhkʏr
tól	tʰouːl
blómkál	ploumkʰauːl
svalur	svaːlʏr
korr	kʰɔrː
síbería	siːpɛriːja
gallblaðra	katlplaðra
herstígvél	hɛr̥stiɣvjɛːl
kiðlingur	cʰɪðliŋkʏr
viss	vɪsː
hnoða	n̥ɔːða
flautuleikari	fløyːtʏleiːkaːrɪ
lensutungljurt	lɛnsʏtʰuŋljʏr̥t
hvolf	kʰvɔlv
tísta	tʰista
skál	skauːl
byrgja	pɪrca
þröngur	θrøyŋkʏr
læmingi	laiːmiɲcɪ
grameðla	kraːmɛðla
hálfkák	haulvkʰauːk
strjálingur	strjauːliŋkʏr
ef	ɛːv
stjórnborð	stjourtnpɔrð
breiddargráða	preitːarkrauːða
hjólbörur	çouːlpœːrʏr
hver	kʰvɛːr
nám	nauːm
núa	nuːa
moska	mɔska
smánetla	smauːnɛhtla
kúbein	kʰuːpeiːn
vigt	vɪxt
sölvi	sœlvɪ
jóhann	jouːhanː
boðháttur	pɔːðhauhtʏr
sölt	sœl̥t
tölvumús	tʰœlvʏmuːs
ganga	kauŋka
póll	pʰoutl
afríkanska	aːfriːkʰanska
hönnun	hœnːʏn
hjúpa	çuːpa
labb	lapː
diljá	tɪljauː
fyrirgefning	fɪːrɪrcɛpniŋk
lögreglukona	lœɣrɛklʏkɔːna
ökumaður	œːkʏmaːðʏr
snerra	snɛrːa
edrú	ɛːtruː
duglegur	tʏɣlɛːɣʏr
trjóna	tʰrjouːna
bandingi	pantiɲcɪ
múrmeldýr	murmɛltiːr
smjúga	smjuːa
tvisvar	tʰvɪːsvaːr
biðukolla	pɪːðʏkʰɔtla
ættkvísl	aihtkʰvistl
blífa	pliːva
elli	ɛtlɪ
oföndun	ɔːvœntʏn
spenntur	spɛn̥tʏr
andstyggilega	antstɪcːɪlɛːɣa
tvinni	tvɪnːɪ
ljár	ljauːr
sandlægja	santlaiːja
melanóra	mɛːlanouːra
barátta	paːrauhta
aðalmundur	aːðalmʏntʏr
myndavél	mɪntavjɛːl
vinnumaður	vɪnːʏmaːðʏr
skap	skaːp
skartgripur	skar̥tkrɪːpʏr
aldeilis	alteiːlɪs
skartgripasali	skar̥tkrɪːpasaːlɪ
rappa	rahpa
skammkrækill	skamːkʰraiːcɪtl
lauma	løyːma
órans	ouːrans
vínber	vinpɛːr
pólska	pʰoulska
sjal	sjaːl
reyta	reiːta
jarmur	jarmʏr
níelsína	niːjɛlsiːna
gedda	kɛtːa
pynting	pʰɪn̥tiŋk
hera	hɛːra
trélitur	tʰrjɛːlɪːtʏr
kóngur	kʰouŋkʏr
fara	faːra
þrútna	θruhtna
kúpa	kʰuːpa
þ	θ
landamæri	lantamaiːrɪ
gifting	cɪftiŋk
skaða	skaːða
rita	rɪːta
strita	strɪːta
nærverufall	nairvɛːrʏfatl
nyt	nɪːt
laugaskarð	løyːɣaskarð
bifreið	pɪvreiːð
rugga	rʏkːa
maður	maːðʏr
flengja	fleiɲca
blóraböggull	plouːrapœkːʏtl
júdea	juːtɛːa
hreyfing	r̥eiːviŋk
tenging	tʰeiɲciŋk
hné	n̥jɛː
afli	aplɪ
glögg	klœkː
edinborg	ɛːtɪnpɔrk
hornhraði	hɔrtnr̥aːðɪ
óðinsvé	ouːðɪnsvjɛː
stríð	striːð
laða	laːða
draumsóley	trøymsouːleiː
spánskur	spaunskʏr
vöxtur	vœkstʏr
endurreisn	ɛntʏrreistn
steinunn	steiːnʏnː
vélfræðingur	vjɛːlfraiːðiŋkʏr
efna	ɛpna
galdra	kaltra
standa	stanta
snifsi	stnɪfsɪ
höfuðbúnaður	hœːvʏðpuːnaːðʏr
tungl	tʰuŋl
reyfi	reiːvɪ
miði	mɪːðɪ
kofaþorp	kʰɔːvaθɔr̥p
skíra	sciːra
nökkvi	nœhkvɪ
kommúna	kʰɔmːuːna
dynur	tɪːnʏr
vallarsveifgras	vatlarsveivkraːs
bilbugur	pɪlpʏːɣʏr
tif	tʰɪːv
sýrena	siːrɛːna
gráhegri	krauːhɛɣrɪ
eldiviður	ɛltɪvɪːðʏr
sýkna	sihkna
hnökri	n̥œːkrɪ
sigdís	sɪɣtiːs
rúta	ruːta
gautaborg	køyːtapɔrk
uppsalir	ʏhpsaːlɪr
sæl	sail̥
klósett	kʰlouːsɛht
aðalmerki	aːðalmɛr̥cɪ
hæka	haiːka
guðbjörg	kvʏðpjœrk
sótthreinsa	souhtr̥einsa
svo	sɔː
náungi	nauːuɲcɪ
framherji	framhɛrjɪ
kíkir	cʰiːcɪr
jæja	jaiːja
biskupskápa	pɪskʏpskʰauːpa
kvelja	kʰvɛlja
vinkona	viŋkʰɔːna
skær	scaiːr
risaeðla	rɪːsaɛðla
skil	scɪːl
föðursystir	fœːðʏrsɪstɪr
kaggi	kʰacːɪ
innlendur	ɪnːlɛntʏr
sökkva	sœhkva
málverk	maulvɛr̥k
bolti	pɔl̥tɪ
frímúrari	friːmuːraːrɪ
púður	pʰuːðʏr
ólafur	ouːlaːvʏr
hófur	houːvʏr
englahorn	eiŋlahɔrtn
október	ɔxtouːpɛːr
glundra	klʏntra
barnabarn	partnapartn
þörf	θœrv
krydd	kʰrɪtː
glóra	klouːra
aðfangadagur	aðfauŋkataːɣʏr
rór	rouːr
sala	saːla
básúnuleikari	pauːsuːnʏleiːkaːrɪ
kögur	kʰœːɣʏr
réttur	rjɛhtʏr
flibbi	flɪpːɪ
svik	svɪːk
gjald	calt
bensín	pɛnsiːn
dýrabúð	tiːrapuːð
sigmundur	sɪɣmʏntʏr
vetur	vɛːtʏr
sveindís	sveintiːs
fríða	friːða
orðskviður	ɔrðskʰvɪːðʏr
þjóðsöngur	θjouðsøyŋkʏr
kristjana	krɪstjaːna
hjúkrunarkona	çuːkrʏnarkʰɔːna
rigning	rɪkniŋk
afturfótur	aftʏrfouːtʏr
eðalsteinn	ɛːðalsteitn
gætinn	caiːtɪnː
þarna	θartna
tíðka	tʰiθka
byrkningur	pɪr̥kniŋkʏr
kyrr	cʰɪrː
þjáður	θjauːðʏr
þýskaland	θiskalant
ex	ɛks
flyksa	flɪxsa
mosagrænn	mɔːsakraitn
vaff	vafː
hraðall	r̥aːðatl
smokkar	smɔhkar
hirðulaus	hɪrðʏløyːs
sleipur	stleiːpʏr
niðurgangur	nɪːðʏrkauŋkʏr
krossfeldi	kʰrɔsːfɛltɪ
stórhertogi	stouːrhɛr̥tʰɔjɪ
grænland	krainlant
bagall	paːɣatl
görn	kœrtn
fjöltyngdur	fjœltʰiŋtʏr
saumur	søyːmʏr
lútur	luːtʏr
pat	pʰaːt
kind	cʰɪnt
flóra	flouːra
svigi	svɪːjɪ
deyða	teiːða
skakkur	skahkʏr
langreyður	lauŋkreiːðʏr
seiður	seiːðʏr
óhreinn	ouːr̥eitn
vordís	vɔrtiːs
organisti	ɔrkanɪstɪ
tað	tʰaːð
sáttmáli	sauhtmauːlɪ
æpa	aiːpa
rauðvingull	røyðviŋkʏtl
sónatína	souːnatʰiːna
óléttur	ouːljɛhtʏr
gáta	kauːta
aðsjáll	aðsjautl
vitur	vɪːtʏr
blóðmura	plouðmʏːra
hálendi	hauːlɛntɪ
elíasína	ɛːlijaːsiːna
spænskur	spainskʏr
ríkharður	riːkharðʏr
öglir	œklɪːr
roðna	rɔðna
hirðir	hɪrðɪr
hranalegur	r̥aːnalɛːɣʏr
njálgur	njaulkʏr
lesblinda	lɛːsplɪnta
flík	fliːk
legnám	lɛɣnauːm
firring	fɪrːiŋk
smurður	smʏrðʏr
sýgill	siːjɪtl
jólakúla	jouːlakʰuːla
vakna	vahkna
pissuskál	pʰɪsːʏskauːl
draumleysi	trøymleiːsɪ
aðsókn	aðsouhkn
endurvekja	ɛntʏrvɛːca
lofa	lɔːva
númera	nuːmɛːra
viðtal	vɪðtʰaːl
bikkja	pɪhca
lúða	luːða
deyfa	teiːva
hraðahindrun	r̥aːðahɪntrʏn
hávaði	hauːvaːðɪ
skilaboð	scɪːlapɔːð
eldstöð	ɛltstœːð
garmur	karmʏr
flóajurt	flouːajʏr̥t
hik	hɪːk
gelt	cɛl̥t
japanskur	jaːpʰanskʏr
horfur	hɔrvʏr
fitfugl	fɪtfʏkl
aukafallsliður	øyːkafalslɪːðʏr
tognun	tʰɔknʏn
áslaug	auːsløyːɣ
síga	siːɣa
raf	raːv
trúarjátning	tʰruːarjauhtniŋk
smásjá	smauːsjauː
svilkona	svɪlkʰɔːna
svíri	sviːrɪ
gullkorn	kʏtlkʰɔrtn
ernir	ɛrtnɪr
þoka	θɔːka
hnefahögg	n̥ɛːvahœkː
býli	piːlɪ
föggur	fœkːʏr
undirforrit	ʏːntɪrfɔrrɪːt
kanill	kʰaːnɪtl
meðfram	mɛðfraːm
feðgin	fɛðcɪːn
undra	ʏntra
trommari	tʰrɔmːaːrɪ
stak	staːk
skynjun	scɪnjʏn
pía	pʰiːja
forritun	fɔrːɪːtʏn
not	nɔːt
fúx	fuxs
grasnykra	kraːsnɪːkra
hásveifgras	hauːsveivkraːs
pípa	pʰiːpa
dvergkráka	tvɛrkkʰrauːka
hjólreiðabraut	çoulreiːðaprøyːt
lungnakrabbamein	luŋknakʰrapːameiːn
skali	skaːlɪ
félag	fjɛːlaːɣ
ellefu	ɛtlɛvʏ
snær	snaiːr
líkamsrækt	liːkʰamsraixt
villa	vɪtla
örk	œr̥k
bringa	priŋka
sker	scɛːr
dauðafræði	tøyːðafraiːðɪ
græta	kraiːta
sammiðja	sammɪðja
sirkill	sɪr̥cɪtl
umdeildur	ʏmteiltʏr
karlfugl	kʰartlfʏkl
forsætisráðherra	fɔr̥saiːtɪsrauːðhɛrːa
viðskiptavinur	vɪðskɪftavɪːnʏr
flauelsblóm	fløyːjɛlsplouːm
jóhannes	jouːhanːɛːs
plús	pʰluːs
skeljamura	scɛljamʏːra
klisja	kʰlɪːsja
muldur	mʏltʏr
fjallavíðir	fjatlaviːðɪr
virka	vɪr̥ka
örðugleiki	œrðʏkleiːcɪ
frjáls	frjauls
dekka	tɛhka
sveifgras	sveivkraːs
þágufall	θauːʏfatl
skilningur	scɪlniŋkʏr
geðshræring	cɛðsr̥aiːriŋk
þökk	θœhk
dúkka	tuhka
sígaretta	siːɣarɛhta
hugsanlegur	hʏxsanlɛːɣʏr
nykra	nɪːkra
ingimundur	iɲcɪmʏntʏr
innfeldi	ɪnːfɛltɪ
pé	pʰjɛː
mánudagur	mauːnʏtaːɣʏr
þankastrik	θauŋ̊kastrɪːk
roða	rɔːða
safamikill	saːvamɪːcɪtl
búi	puːɪ
hjálpa	çaul̥pa
orð	ɔrð
garn	kartn
japanska	jaːpʰanska
el	ɛːl
lávarður	lauːvarðʏr
makki	mahcɪ
sniðill	snɪːðɪtl
dreitill	treiːtɪtl
leyna	leiːna
tvíbaka	tʰviːpaːka
bali	paːlɪ
arinn	aːrɪnː
kerra	cʰɛrːa
kerling	cʰɛtliŋk
framkvæmdastjóri	framkʰvaimtastjouːrɪ
fangelsi	fauŋcɛlsɪ
líkskurður	liːkskʏrðʏr
pardusdýr	pʰartʏstiːr
próf	pʰrouːv
heili	heiːlɪ
ada	aːta
freta	frɛːta
milta	mɪl̥ta
velgengni	vɛlceiŋknɪ
virginía	vɪrcɪniːja
skurðpunktur	skʏrðpʰuŋ̊ktʏr
felix	fɛːlɪxs
flikki	flɪhcɪ
útför	uːtfœːr
happ	hahp
síður	siːðʏr
þungur	θuŋkʏr
mýbit	miːpɪːt
afkvæmi	avkʰvaiːmɪ
kunta	kʰʏn̥ta
fjölga	fjœlka
þyngd	θiŋt
ölvun	œlvʏn
blettur	plɛhtʏr
reynir	reiːnɪr
oddur	ɔtːʏr
predika	pʰrɛːtɪːka
fís	fiːs
bílstjóri	pilstjouːrɪ
súrmjólk	surmjoul̥k
grefill	krɛːvɪtl
skítt	sciht
kvistur	kʰvɪstʏr
feldur	fɛltʏr
deiling	teiːliŋk
ísis	iːsɪs
flesk	flɛsk
miðjumaður	mɪðjʏmaːðʏr
aukatenging	øyːkatʰeiɲciŋk
fjölær	fjœːlaiːr
kleppur	kʰlɛhpʏr
blóðfruma	plouðfrʏːma
stjarneðlisfræðingur	stjartnɛðlɪsfraiːðiŋkʏr
píra	pʰiːra
kergja	cʰɛrca
lyngjafni	liŋkjapnɪ
klár	kʰlauːr
thorarensen	tʰouːraːrɛnsɛnː
kuðungur	kʰʏːðuŋkʏr
linna	lɪnːa
matarprjónn	maːtarpʰrjoutn
nálægur	nauːlaiːɣʏr
synda	sɪnta
eldur	ɛltʏr
konar	kʰɔːnar
bragur	praːɣʏr
vörn	vœrtn
kvikmynd	kʰvɪːkmɪnt
gorma	kɔrma
lungnabláæð	luŋknaplauːaiːð
furða	fʏrða
vilhjálmína	vɪlçaulmiːna
björn	pjœtn
suddi	sʏtːɪ
kylfa	cʰɪlva
ala	aːla
mjólka	mjoul̥ka
pí	pʰiː
félagaskiptagluggi	fjɛːlaːɣascɪftaklʏcːɪ
klór	kʰlouːr
fæll	faitl
fok	fɔːk
radísa	raːtiːsa
skadda	skatːa
fáránlegur	fauːraunlɛːɣʏr
himnaríki	hɪmnariːcɪ
punda	pʰʏnta
grjón	krjouːn
lás	lauːs
svæfi	svaiːvɪ
sýnishorn	siːnɪshɔrtn
fjandi	fjantɪ
byrjun	pɪrjʏn
löpp	lœhp
ákafir	auːkaːvɪr
buski	pʏscɪ
tröð	tʰrœːð
markspyrna	mar̥kspɪrtna
sálmur	saulmʏr
ómþýður	oumθiːðʏr
melasól	mɛːlasouːl
ermi	ɛrmɪ
bravó	praːvouː
sjálfur	sjaulvʏr
þrykkja	θrɪhca
fræfill	fraiːvɪtl
vilhjálmur	vɪlçaulmʏr
urð	ʏrð
rindill	rɪntɪtl
slím	stliːm
hlass	l̥asː
frelsari	frɛlsaːrɪ
jafna	japna
me	mɛː
naflagras	naplakraːs
langur	laŋkʏr
gangur	kauŋkʏr
malli	malːɪ
teygja	tʰeiːja
hreyfa	r̥eiːva
hylli	hɪtlɪ
nú	nuː
téténía	tʰjɛtʰjɛːniːja
flugbraut	flʏɣprøyːt
hildigunnur	hɪltɪkʏnːʏr
samviskusemi	samvɪskʏsɛːmɪ
kakkalakki	kʰahkalahcɪ
kýr	cʰiːr
rykfalla	rɪːkfatla
jólaeyja	jouːlaeiːja
annríki	anːriːcɪ
strítkar	striːtkʰaːr
anemóna	aːnɛmouːna
safn	sapn
auðæfi	øyːðaiːvɪ
vegna	vɛkna
tyrkneska	tʰɪr̥knɛska
rúm	ruːm
drekkja	trɛhca
réttlæti	rjɛhtlaiːtɪ
bambus	pampʏs
náttúra	nauhtuːra
ástralía	australiːja
lágarfi	lauːɣarvɪ
fordrykkur	fɔrtrɪhkʏr
vetni	vɛhtnɪ
gauti	køyːtɪ
deigja	teiːja
kúga	kuːa
perlumóðir	pʰɛrtlʏmouːðɪr
hríð	r̥iːð
ljón	ljouːn
graslendi	kraːslɛntɪ
fylling	fɪtliŋk
hjör	çœːr
stórólfur	stouːroulvʏr
brynjólfína	prɪnjoulviːna
trójuhestur	tʰrouːjʏhɛstʏr
offita	ɔffɪːta
margæs	marcaiːs
franskur	franskʏr
sönnun	sœnːʏn
gæsa	caiːsa
aggi	acːɪ
kúrbítur	kʰurpiːtʏr
kvíði	kʰviːðɪ
kíló	cʰiːlouː
drykkur	trɪhkʏr
bé	pjɛː
hönd	hœnt
hugsa	hʏxsa
nánd	naunt
líkindi	liːcɪntɪ
jarþrúður	jar̥θruːðʏr
kynsjúkdómur	cʰɪnsjuːktouːmʏr
sauðlaukur	søyðløyːkʏr
strákur	strauːkʏr
mús	muːs
kyrr	cʰɪːr
herðar	hɛrðar
deild	teilt
hrinda	r̥ɪnta
spítt	spiht
frauð	frøyːð
matseðill	maːtsɛːðɪtl
hjartanykra	çar̥tanɪːkra
týndur	tʰintʏr
kompa	kʰɔm̥pa
tarfur	tʰarvʏr
reigja	reiːja
magur	maːɣʏr
þiðna	θɪðna
bora	pɔːra
hungur	huŋkʏr
efnahvarf	ɛpnakʰvarv
hljóðeind	l̥jouːðeint
aðili	aːðɪːlɪ
eydís	eiːtiːs
svigna	svɪkna
bjarma	pjarma
landi	lantɪ
einteymingur	eintʰeiːmiŋkʏr
lúga	luːa
pex	pɛks
nokkur	nɔhkʏr
dúskur	tuskʏr
ekkert	ɛhcɛr̥t
ríkisfang	riːcɪsfauŋk
salerni	saːlɛrtnɪ
nýrun	niːrʏn
je	jɛː
námskeið	naumsceiːð
samræmi	samraiːmɪ
slagsmál	stlaxsmauːl
bauk	pøyːk
vélfræði	vjɛlfraiːðɪ
mysuostur	mɪːsʏɔstʏr
jötunuxi	jœːtʰʏnʏxsɪ
haltra	hal̥tra
gísl	cistl
fetta	fɛhta
styrkur	stɪr̥kʏr
skinna	skɪnːa
stelkur	stɛl̥kʏr
sónata	souːnaːta
þrýstilína	θristɪliːna
tvíær	tʰviːaiːr
skynsemi	scɪnsɛːmɪ
dagatal	taːɣatʰaːl
leyfa	leiːva
kaka	kʰaːka
póstkort	pʰoustkʰɔr̥t
setningafræði	sɛhtniŋkafraiːðɪ
jú	juː
ausa	øyːsa
borgaralegur	pɔrkaːralɛːɣʏr
smiður	smɪːðʏr
myndarlegur	mɪntarlɛːɣʏr
bati	paːtɪ
karakter	kʰaraxtɛːr
snoppufríður	stnɔhpʏfriːðʏr
miðja	mɪðja
eiginmaður	eiːjɪnmaːðʏr
leysa	leiːsa
nögl	nœkl
miðbaugur	mɪðpøyːɣʏr
ey	eiː
vettlingur	vɛhtliŋkʏr
hræsnari	r̥aistnarɪ
guðjohnsen	kvʏðjounsɛːnː
nýsnævi	niːsnaiːvɪ
skyn	scɪːn
magnús	maknuːs
fylki	fɪl̥cɪ
bollur	pɔlːʏr
einvaldur	einvaltʏr
nefnd	nɛmt
arabía	aːrapiːja
blað	plaːð
stofa	stɔːva
fram	framː
gola	kɔːla
kvaran	kʰvaːran
hegna	hɛkna
friðmundur	frɪðmʏntʏr
api	aːpɪ
agalega	aːɣalɛːɣa
forðafræði	fɔrðafraiːðɪ
prúður	pʰruːðʏr
fallegur	fatlɛːɣʏr
gíraffi	ciːrafːɪ
beygla	peikla
lunti	lʏn̥tɪ
venda	vɛnta
randa	ranta
dofinn	tɔːvɪnː
hrukka	r̥ʏhka
net	nɛːt
pungbindi	pʰuŋkpɪntɪ
bindi	pɪntɪ
klinka	kʰliŋ̊ka
rismál	rɪːsmauːl
kollhnís	kʰɔtln̥iːs
loðna	lɔðna
stíll	stitl
popp	pʰɔhp
ræðismaður	raiːðɪsmaːðʏr
predikari	pʰrɛːtɪkarɪ
trúarlegur	tʰruːarlɛːɣʏr
ásýnd	auːsint
aðdáun	aðtauːʏn
söngur	søyŋkʏr
fet	fɛːt
flas	flaːs
kamar	kʰaːmar
dreyma	treiːma
varta	var̥ta
anddyri	anttɪːrɪ
liður	lɪːðʏr
ísmael	iːsmaːɛːl
vistvænn	vɪstvaitn
margföldun	markfœltʏn
settaug	sɛːttʰøyːɣ
hlutur	l̥ʏːtʏr
bauð	pøiːð
hjarta	çar̥ta
glott	klɔht
álmur	aulmʏr
læknisfræðilegur	laihknɪsfraiːðɪlɛːɣʏr
skjaldarmerki	scaltarmɛr̥kɪ
eðlisfræðingur	ɛðlɪsfraiːðiŋkʏr
benjamín	pɛnjamiːn
bikar	pɪːkar
sólbað	soulpaːð
tollera	tʰɔlːɛːra
páldís	paultiːs
fenómen	fɛːnouːmɛːn
spæll	spaitl
böllur	pœtlʏr
hnykill	n̥ɪːcɪtl
slitna	stlɪhtna
hagga	hakːa
hlýri	l̥iːrɪ
stóll	stoutl
tilfinningalaus	tʰɪlfɪnːiŋkaløyːs
erítrea	ɛːriːtʰrɛːa
kista	cʰɪsta
bliða	plɪːða
riðla	rɪðla
meta	mɛːta
grænkál	krainkʰauːl
emm	ɛmː
sofir	sɔːvɪr
mega	meiːɣa
steðji	stɛðjɪ
mærð	mairð
brautryðjandi	prøyːtrɪðjantɪ
sorti	sɔr̥tɪ
umsókn	ʏmsouhkn
nýmjólk	niːmjoul̥k
hnappur	n̥ahpʏr
melting	mɛl̥tiŋk
geðlæknir	cɛðlaihknɪr
burnirót	pʏrtnɪrouːt
nebbi	nɛpːɪ
bógur	pouːʏr
sútun	suːtʏn
uml	ʏml
mjólk	mjoul̥k
frumufræði	frʏːmʏfraiːðɪ
sítróna	siːtʰrouːna
flæmskur	flaimskʏr
afstæði	afstaiːðɪ
andefni	antɛpnɪ
hjal	çaːl
hnupl	n̥ʏhpl
yfirtónn	ɪːvɪrtʰoutn
úlpa	ul̥pa
glufa	klʏːva
endurreisnarstefna	ɛntʏrreistnarstɛpna
hrafndís	r̥apntiːs
solla	sɔːla
ferðaáætlun	fɛrðaauːaihtlʏn
drengskapur	treiŋkskaːpʏr
hvelfing	kʰvɛlviŋk
böðull	pœːðʏtl
vit	vɪːt
köfnun	kʰœpnʏn
títra	tʰiːtra
bjóða	pjouːða
alin	aːlɪn
treysta	tʰreista
gimbill	cɪmpɪtl
fótasár	fouːtasauːr
gautelfur	køyːtɛlvʏr
sæða	saiːða
vinalegur	vɪːnalɛːɣʏr
unnusta	ʏnːʏsta
andeind	anteint
blýantur	pliːantʏr
eistalyppa	eistalɪhpa
brauðmylsna	prøyðmɪlstna
vígi	viːjɪ
meitla	meihtla
lífga	livka
hlið	l̥ɪːð
stunda	stʏnta
þuríður	θʏːriːðʏr
innkast	ɪnːkʰast
ólafssúra	ouːlafssuːra
líka	liːka
jarðarber	jarðarpɛːr
hérna	çɛrtna
ker	cʰɛːr
hálsbindi	haulspɪntɪ
kapp	kʰahp
löm	lœːm
önugur	œːnʏːɣʏr
luma	lʏːma
sæmundína	saiːmʏntiːna
stelling	stɛtliŋk
daufur	tøyːvʏr
dýrslegur	tir̥slɛːɣʏr
indverji	ɪntvɛrjɪ
órækja	ouːraiːca
stríðni	striðnɪ
partí	pʰar̥ti
þega	θɛːɣa
snækobbi	snaiːkʰɔpːɪ
skvetta	skvɛhta
bílaflutningabíll	piːlaflʏhtniŋkapitl
burkni	pʏr̥knɪ
drottinn	trɔhtɪn
konur	kʰɔːnʏr
klöpp	kʰlœhp
skíri	sciːrɪ
föndra	fœntra
hrafnastör	r̥apnastœːr
einar	eiːnar
mörgæs	mœrcaiːs
rit	rɪːt
stytta	stɪhta
gætni	caihtnɪ
soldill	sɔltɪtl
maðra	maðra
selja	sɛlja
nagdýr	naɣtiːr
túrmerik	tʰurmɛːrɪk
aðskilja	aðscɪlja
bað	paːð
skynja	scɪnja
skreppa	skrɛhpa
gríska	kriska
konungshöll	kʰɔːnuŋkshœtl
fljót	fljouːt
fræða	fraiːða
kím	cʰiːm
sía	siːja
húfa	huːva
garðakornblóm	karðakʰɔrtnplouːm
bílalest	piːlalɛst
skelkaður	scɛl̥kaðʏr
fönn	fœnː
hnúður	n̥uːðʏr
spauga	spøyːɣa
aðferð	aðfɛrð
sandfok	santfɔːk
spenna	spɛnːa
kynskiptingur	cʰɪːnscɪftiŋkʏr
ásamt	auːsam̥t
léttmjólk	ljɛhtmjoul̥k
útibú	uːtɪpuː
nývirki	niːvɪr̥cɪ
krít	kʰriːt
kyrtill	cʰɪr̥tɪtl
keisaraviður	cʰeiːsaːravɪːðʏr
hengi	heiɲcɪ
dreifa	treiːva
danskur	tanskʏr
bákn	pauhkn
jörgensen	jœrkɛnsɛːnː
fallbyssa	fatlpɪsːa
vesturland	vɛstʏrlant
samför	samfœːr
netfang	nɛːtfauŋk
siða	sɪːða
lok	lɔːk
sívalur	siːvaːlʏr
heimsmethafi	heimsmɛːthaːvɪ
rúmfræði	rumfraiːðɪ
símonía	siːmɔːniːja
leggöng	lɛɣkøyŋk
píta	pʰiːta
magi	maːjɪ
ölkelduvatn	œlcʰɛltʏvahtn
gagnlegur	kaknlɛɣʏr
hlymja	l̥ɪmja
jafntefli	japntʰɛplɪ
austurríki	øystʏrriːcɪ
beisli	peistlɪ
nafnorð	napnɔrð
peð	pʰɛːð
trekt	tʰrɛxt
þýska	θiska
tónn	tʰoutn
vindverskur	vɪntvɛr̥skʏr
mói	mouːɪ
feikn	feihkn
númer	nuːmɛːr
hreinskilinn	r̥einscɪːlɪnː
fals	fals
ljóðskáld	ljouðskault
líkur	liːkʏr
umkringja	ʏmkʰriɲca
flag	flaːɣ
garðaprjón	karðapʰrjouːn
og	ɔːɣ
norðdahl	nɔrðtaːl
nestisbox	nɛstɪspɔxs
nasismi	naːsɪsmɪ
slefa	stlɛːva
rakhnífur	raːkn̥iːvʏr
einrækta	einraixta
lesblindur	lɛːsplɪntʏr
veita	veiːta
hjara	çaːra
prís	pʰriːs
letur	lɛːtʏr
róla	rouːla
gúlrotta	kulrɔhta
ásmundur	auːsmʏntʏr
djarfur	tjarvʏr
sjáland	sjauːlant
jarlsfrú	jartlsfruː
skapari	skaːparɪ
systkin	sɪstkɪːn
bein	peiːn
leturborð	lɛːtʏrpɔrð
umfang	ʏmfauŋk
dreymandi	treiːmantɪ
natrín	naːtriːn
ágirnd	auːcɪrnt
stjörnuspekingur	stjœrtnʏspɛːciŋkʏr
miðaftann	mɪːðaftanː
krossfari	kʰrɔsːfaːrɪ
brjóstamjólk	prjoustamjoul̥k
storkur	stɔr̥kʏr
hróarskelda	r̥ouːar̥scʰɛlta
einhver	einxʷɛːr
rúða	ruːða
álfheiður	aulvheiːðʏr
disklingur	tɪskliŋkʏr
eign	eikn
stóð	stouːð
nashyrningur	naːshɪrtniŋkʏr
bendill	pɛntɪtl
bitur	pɪːtʏr
botnlanganám	pɔhtnlauŋkanauːm
atvikssaga	aːtvɪxssaːɣa
buna	pʏːna
andlangur	antlauŋkʏr
mandla	mantla
styðja	stɪðja
dans	tans
sleppa	stlɛhpa
sæll	saitl̥
lakkrís	lahkriːs
mátun	mauːtʏn
mislingar	mɪstliŋkar
lag	laːɣ
karkari	kʰar̥karɪ
vængur	vaiŋkʏr
járnbraut	jaurtnprøyːt
álka	aul̥ka
láð	lauːð
ljóseind	ljouːseint
góa	kouːa
glæða	klaiːða
kjuði	cʰʏːðɪ
þýskur	θiskʏr
kjölfar	cʰœlfaːr
andheiti	antheiːtɪ
bálkur	paul̥kʏr
visna	vɪstna
mannkyn	manːcʰɪːn
lána	lauːna
niðurlæging	nɪːðʏrlaiːjiŋk
ríkisborgari	riːcɪspɔrkarɪ
bræðsla	praiðstla
steinn	steitn
sefa	sɛːva
tæfa	tʰaiːva
ást	aust
sveipur	sveiːpʏr
fræði	fraiːðɪ
fjórðungur	fjourðuŋkʏr
haustlegur	høystlɛːɣʏr
blóðarfi	plouːðarvɪ
júnímánuður	juːniːmauːnʏðʏr
kveðja	kʰvɛðja
spíra	spiːra
skekkja	scɛhca
hvala	xʷaːla
eggjastokkur	ɛcːastɔhkʏr
brotna	prɔhtna
ferja	fɛrja
textavarp	tʰɛxstavar̥p
glepja	klɛːpja
kóróna	kʰouːrouːna
skáli	skauːlɪ
mjaldur	mjaltʏr
snilld	stnɪlt
vog	vɔːɣ
háseti	hauːsɛːtɪ
hittni	hɪhtnɪ
þras	θraːs
seiða	seiːða
aldinborg	altɪnpɔrk
svella	svɛtla
viskí	vɪsciː
fimbulvetur	fɪmpʏlvɛːtʏr
hyrna	hɪrtna
dugleysi	tʏɣleiːsɪ
móberg	mouːpɛrk
vindur	vɪntʏr
fífill	fiːvɪtl
tjón	tʰjouːn
rauðleitur	røyðleiːtʏr
dagblaðapappír	taɣplaːðapahpiːr
oddviti	ɔtːvɪtɪ
opnunartími	ɔhpnʏːnaːrtʰiːmɪ
símaskrá	siːmaskrauː
rennibekkur	rɛnːɪpɛhkʏr
sitkagreni	sɪːtkakrɛːnɪ
as	aːs
asi	aːsɪ
japani	jaːpʰaːnɪ
rakur	raːkʏr
úlfur	ulvʏr
baskamál	paskamauːl
brjóstvasi	prjoustvaːsɪ
hugsun	hʏxsʏn
hirðuleysi	hɪrðʏleiːsɪ
dýrka	tir̥ka
kræklóttur	kʰraihklouhtʏr
sprunga	spruŋka
hryggja	r̥ɪcːa
fingurbjörg	fiŋkʏrpjœrk
stansa	stansa
nifl	nɪpl
hvalveiði	kʰvalveiːðɪ
ákafi	auːkʰaːvɪ
hrímblaðka	r̥implaðka
hryðjuverkamaður	r̥ɪðjʏvɛr̥kamaːðʏr
men	mɛːn
hæ	haiː
dvergsóley	tvɛrksouːleiː
einarína	eiːnaːriːna
sýki	siːcɪ
hjartafífill	çar̥tafiːvɪtl
glerungur	klɛːruŋkʏr
faraldur	faːraltʏr
séra	sjɛːra
sofa	sɔːva
rögnvaldína	rœknvaltiːna
torveldur	tʰɔrvɛltʏr
háttur	hauhtʏr
kynstur	cʰɪnstʏr
gína	ciːna
holur	hɔːlʏr
bíta	piːta
eintyngdur	eintiŋtʏr
hedda	hɛtːa
seinn	seitn
skjár	scauːr
imbi	ɪmpɪ
höggva	hœkːva
gaukur	køyːkʏr
ingvarsson	iŋkvar̥ssɔːn
kitl	cʰɪhtl
skepna	scɛhpna
m	ɛmː
þynnka	θiŋ̊ka
jakobsfífill	jaːkʰɔpsfiːvɪtl
pokabjörn	pʰɔːkapjœrtn
kóngsriddari	kouŋksrɪtːarɪ
kapítuli	kʰaːpitʰʏːlɪ
dagblað	taɣplaːð
sykurreyr	sɪːkʏrreiːr
æskja	aisca
geysa	ceiːsa
glær	klaiːr
brandari	prantarɪ
eyjaálfa	eiːjaaulva
stranda	stranta
ös	œːs
tilraun	tɪlrøyːn
niðurstaða	nɪːðʏrstaːða
þykja	θɪːca
hóruhús	houːrʏhuːs
kyndill	cʰɪntɪtl
reikningur	reihkniŋkʏr
þráðlaus	θrauðløyːs
risna	rɪstna
hvirfill	xʷɪrvɪtl
múli	muːlɪ
verk	vɛr̥k
tækling	tʰaihkliŋk
ráðabrugg	rauːðaprʏkː
borgundarhólmur	pɔrkʏntarhoulmʏr
hóll	houtl
hæla	haiːla
hafald	haːvalt
snarl	stnartl
frumulíffæri	frʏːmʏliffaiːrɪ
kjörgengur	cʰœrceiŋkʏr
fyrirgangur	fɪːrɪrkauŋkʏr
óbó	ouːpouː
fargjald	farcalt
tæta	tʰaiːta
flauel	fløyːjɛːl
reipi	reiːpɪ
heiðagæs	heiːðacaiːs
kúluvarp	kʰuːlʏvar̥p
viðbrögð	vɪðprœɣð
gróp	krouːp
afríkanskur	aːfriːkʰanskʏr
búfé	puːfjɛː
konsúll	kʰɔnsutl
gulur	kʏːlʏr
kindakjöt	cʰɪntacʰœːt
netja	nɛːtja
framleiða	framleiːða
vasatölva	vaːsatʰœlva
kónguló	kʰouŋkʏlouː
veill	veitl
stafla	stapla
akkeri	ahkɛːrɪ
rjátl	rjauhtl
kæla	cʰaiːla
hornafall	hɔrtnafatl
örvamælir	œrvamaiːlɪr
milt	mɪl̥t
alexander	aːlɛksantɛːr
beitieski	peiːtɪɛscɪ
þorvarðína	θɔrvarðiːna
vestra	vɛstra
yfirtaka	ɪːvɪrtʰaːka
frí	friː
tjákn	tʰjauhkn
kaffi	kʰafːɪ
nágranni	nauːkranːɪ
rusl	rʏstl
fart	far̥t
hanga	hauŋka
mjálma	mjaulma
vansi	vansɪ
virkni	vɪr̥knɪ
útiloka	uːtɪlɔːka
áhugi	auːhʏjɪ
hörfinka	hœrfiŋka
pýroxen	pʰiːrɔksɛːn
kollur	kʰɔtlʏr
gómfilla	koumfɪtla
vöndull	vœntʏtl
mey	meiː
tóbak	tʰouːpaːk
broddkúmen	prɔtːkʰuːmɛːn
maki	maːcɪ
aðalritning	aːðalrɪhtniŋk
nörd	nœrt
orðfræði	ɔrðfraiːðɪ
víns	vins
þórunn	θouːrʏnː
strekkja	strɛhca
verja	vɛrja
tækni	tʰaihkn̥ɪ
hrogn	r̥ɔkn
falla	fatla
iða	ɪːða
stulta	stʏl̥ta
orðatiltæki	ɔrðatʰɪl̥tʰaiːcɪ
frekna	frɛhkna
dramb	tramp
tómur	tʰouːmʏr
rasismi	raːsɪsmɪ
hrææta	r̥aiːjaiːta
kál	kʰauːl
handavinna	hantavɪnːa
tónsproti	tʰounsprɔːtɪ
kjarnavopn	cʰartnavɔhpn
sprikla	sprɪhkla
tremmi	tʰrɛmːɪ
kremja	kʰrɛmja
lautinant	løyːtʰɪnan̥t
luri	lʏːrɪ
kænn	cʰaitn
dráttarvél	trauhtarvjɛːl
sigurdís	sɪːɣʏrtiːs
tylft	tɪl̥ft
samfélagsmiðill	samfjɛːlaːɣsmɪːðɪtl
körfuknattleikur	kʰœrvʏkʰnahtleiːkʏr
kosta	kʰɔsta
sóley	souːleiː
lesta	lɛsta
gisti	cɪstɪ
prenta	pʰrɛn̥ta
pæla	pʰaiːla
serótónín	sɛːrouːtʰouːniːn
forrita	fɔrːɪːta
atgeir	aːtkeiːr
herfi	hɛrvɪ
mosi	mɔːsɪ
kort	kʰɔr̥t
dvergur	tvɛrkʏr
heimsfriður	heimsfrɪːðʏr
glissa	klɪsːa
vax	vaxs
greni	krɛːnɪ
slarkfenginn	stlar̥kfeiŋkɪnː
hóffífill	houvfiːvɪtl
tíundi	tʰiːjʏntɪ
flauta	fløyːta
ákaflega	auːkʰavlɛːɣa
njóta	njouːta
möppudýr	mœhpʏtiːr
óvandaður	ouːvantaːðʏr
flagasef	flaːɣasɛːv
kópur	kʰouːpʏr
laxerolía	laxsɛrɔːlija
hvalur	xʷaːlʏr
skart	skar̥t
lortur	lɔr̥tʏr
eistneska	eistnɛska
greipa	kreiːpa
obláta	ɔplauːta
kerúb	cʰɛːruːp
orðaleikur	ɔrðaleiːkʏr
naust	nøyst
heilbrigður	heilprɪɣðʏr
iðulega	ɪːðʏlɛːɣa
plebbi	pʰlɛpːɪ
úff	ufː
kossa	kʰɔsːa
æja	aiːja
púki	pʰuːcɪ
sull	sʏtl
kjarrsveifgras	cʰarːsveivkraːs
spaug	spøyːɣ
víngarður	vinkarðʏr
framsöguháttur	framsœːɣʏhauhtʏr
bogga	pɔkːa
símgreiðsla	simkreiðstla
dónalega	touːnalɛːɣa
fuglafræði	fʏklafraiːðɪ
húsfrú	huːsfruː
júlíus	juːliːjʏs
hlýja	l̥iːja
málsháttur	maulshauhtʏr
dylja	tɪlja
vita	vɪːta
mæðgin	maiðcɪːn
lækjasef	laiːcasɛːv
þorbjörg	θɔrpjœrk
greipaldin	kreiːpaltɪn
vefja	vɛvja
þrjóta	θrjouːta
saltfiskur	sal̥tfɪskʏr
fullnusta	fʏtlnʏsta
sóldís	soultiːs
málning	maulniŋk
gáfaður	kauːvaðʏr
trefjasóley	tʰrɛvjasouːleiː
einhentur	eiːnhɛn̥tʏr
stía	stiːja
rangeygður	rauŋkeiɣðʏr
kæpa	cʰaiːpa
flórída	flouːrita
dagmál	taɣmauːl
alaska	aːlaska
kaup	kʰøyːp
svífa	sviːva
þjónustustúlka	θjouːnʏstʏstul̥ka
kjörlendi	cʰœrlɛntɪ
linnur	lɪnːʏr
sólveig	soulveiːɣ
kanslari	kʰanstlarɪ
óþekkt	ouːθɛxt
fjandmaður	fjantmaːðʏr
jakuxi	jaːkʏksɪ
fljúga	fljuːa
sumar	sʏːmaːr
mjúkur	mjuːkʏr
öxl	œxstl
palestína	pʰaːlɛstiːna
aumingi	øyːmiɲcɪ
hártoppur	haurtʰɔhpʏr
koffín	kʰɔfːiːn
hestaleiga	hɛstaleiːɣa
dörslag	tœrstlaːɣ
tau	tʰøyː
nötra	nœːtra
fíkinn	fiːcɪnː
bókastoð	pouːkastɔːð
skóli	skouːlɪ
arnór	artnouːr
gluggatjald	klʏkːatʰjalt
fasismi	faːsɪsmɪ
finnungur	fɪnːuŋkʏr
þerna	θɛrtna
aðdragandi	aðtraːɣantɪ
eiturlyfjasali	eiːtʏrlɪvjasaːlɪ
feill	feitl
sigra	sɪɣra
gjögur	cœːɣʏr
þvæla	θvaiːla
frjóhnappur	frjouːn̥ahpʏr
p	pʰjɛː
meik	meiːk
hjakka	çahka
umdæmi	ʏmtaiːmɪ
óhlýðni	ouːl̥iðnɪ
vögguvísa	vœkːʏviːsa
siður	sɪːðʏr
fjárhundur	fjaurhʏntʏr
jórdanía	jourtaːniːja
sítrónusafi	siːtʰrouːnʏsaːvɪ
sendinn	sɛntɪnː
hermikráka	hɛrmɪkʰrauːka
löskur	lœskʏr
févíti	fjɛːviːtɪ
höfuðborgarsvæðið	hœːvʏθpɔrkarsvaiːðɪð
sviði	svɪːðɪ
sjálf	sjaulv
girðing	cɪrðiŋk
þórfríður	θour̥friːðʏr
gler	klɛːr
gaffall	kafːatl
laga	laːɣa
sérhljóð	sjɛːrl̥jouːð
hleypa	l̥eiːpa
þari	θaːrɪ
hrak	r̥aːk
sveinn	sveitn
tvísykra	tʰviːsɪːkra
brokka	prɔhka
frilla	frɪtla
æla	aiːla
útland	uːtlant
afleiðing	avleiːðiŋk
sjá	sjauː
hryssa	r̥ɪsːa
dvergtungljurt	tvɛrktʰuŋljʏr̥t
rakafullur	raːkafʏtlʏr
kúfur	kʰuːvʏr
getnaðarlimur	cɛhtnaːðarlɪːmʏr
hlé	l̥jɛː
bólivía	pouːlɪviːja
innheimta	ɪnːheim̥ta
grímkell	krimcʰɛtl
kaðlari	kʰaðlarɪ
almennur	almɛnːʏr
skrímsli	skrimstlɪ
raul	røyːl
smjör	smjœːr
mýrasauðlaukur	miːrasøyðløyːkʏr
þórshöfn	θour̥shœpn
hneta	n̥ɛːta
óætur	ouːaiːtʏr
hagi	haːjɪ
posi	pʰɔːsɪ
ára	auːra
spark	spar̥k
kragi	kʰraiːjɪ
ræna	raiːna
atburður	aːtpʏrðʏr
klúbbur	kʰlupːʏr
basla	pastla
ólöglegur	ouːlœɣlɛːɣʏr
mold	mɔlt
meðstjórnendur	mɛðstjourtnɛntʏr
sög	sœːɣ
stilkur	stɪl̥kʏr
klettafrú	kʰlɛhtafruː
otur	ɔːtʏr
lyf	lɪːv
erja	ɛrja
tág	tʰauː
dabbi	tapːɪ
bandalag	pantalaːɣ
flokkur	flɔhkʏr
miður	mɪːðʏr
hvæs	kʰvaiːs
þolandi	θɔːlantɪ
upptrekktur	ʏhptʰrɛxtʏr
tónleikar	tʰounleiːkar
stýra	stiːra
lýðnet	liðnɛːt
harpa	har̥pa
kjöt	kʰjœːt
ráðherra	rauːðhɛrːa
rof	rɔːv
kerti	cʰɛr̥tɪ
besefi	pɛːsɛːvɪ
óhapp	ouːhahp
mulningur	mʏlniŋkʏr
stökkva	stœhkva
ú	uː
hakka	hakka
þrasa	θraːsa
ari	aːrɪ
klængur	kʰlaiŋkʏr
georgína	cɛːɔrciːna
tyrkneskur	tʰɪr̥knɛskʏr
þykkur	θɪhkʏr
hryðjuverk	r̥ɪðjʏvɛr̥k
daldís	taltiːs
hefndarþorsti	hɛmtarθɔr̥stɪ
smygill	smɪːjɪtl
hlutverk	l̥ʏːtvɛr̥k
vináttuleikur	vɪːnauhtʏleiːkʏr
tjarnablaðka	tʰjartnaplaðka
blogg	plɔkː
gylta	cɪl̥ta
fura	fʏːra
neðri	neðrɪ
grunnskóli	krʏnːskouːlɪ
augnlok	øyknlɔːk
ógn	oukn
jóndís	jountiːs
spaði	spaːðɪ
drykkja	trɪhca
bliki	plɪːcɪ
bragðskyn	praɣðscɪːn
brúðkaup	pruðkʰøyːp
svo	svɔː
brandönd	prantœnt
feluleikur	fɛːlʏleiːkʏr
mannvitsbrekka	manːvɪtsprɛhka
sekta	sɛxta
fésbók	fjɛːspouːk
viðeigandi	vɪːðeiːɣantɪ
jórdan	jourtaːn
stafafura	staːvafʏːra
úkraína	uːkʰraːiːna
þema	θɛːma
sjóher	sjouːhɛːr
tæki	tʰaiːcɪ
hveitikím	kʰveiːtɪkʰiːm
tuskulegur	tʰʏskʏlɛːɣʏr
mótmæla	mouːtmaiːla
gleði	klɛːðɪ
rasskinn	rasːcʰɪnː
saffran	safːran
fyrirgera	fɪːrɪrcɛːra
jakob	jaːkʰɔːp
lyklaborð	lɪhklapɔrð
kantur	kʰan̥tʏr
nafnháttur	napnhauhtʏr
elía	ɛːliːja
krækla	kʰraihkla
kalsi	kʰalsɪ
legkaka	lɛɣkʰaːka
bróðir	prouːðɪr
rólega	rouːlɛːɣa
helluhnoðri	hɛtlʏn̥ɔðrɪ
stíga	stiːɣa
skema	scɛːma
lemmun	lɛmːʏn
skánn	skautn
kínín	cʰiːniːn
rassgat	rasːkaːt
mesópótamía	mɛːsouːpʰouːtamiːja
stykkja	stɪhca
hræsnistár	r̥aistnɪstʰauːr
beina	peiːna
hrafn	r̥apn
áskrift	auːskrɪft
gras	kraːs
algyðistrú	alcɪðɪstʰru
sakaskrá	saːkaskrauː
kvísl	kʰvistl
stöðvun	stœðvʏn
kappi	kʰahpɪ
bljúgur	pljuːʏr
músareyra	muːsareiːra
einmanaleiki	einmaːnaleiːcɪ
hækill	haicːɪtl
kirkjugarður	cʰɪr̥cʏkarðʏr
bakstur	paxstʏr
hökull	hœːkʏtl
hreinsunareldur	r̥einsʏːnaːrɛltʏr
óhuggulegur	ouːhʏkːʏlɛːɣʏr
daníel	taːnijɛːl
kífa	cʰiːva
hattari	hahtaːrɪ
nafnbót	napnpouːt
fæla	faiːla
kalksteinn	kʰal̥ksteitn
túnsúra	tʰunsuːra
meiðsl	meiðstl
hengja	heiɲca
múgur	muːʏr
gagnrýni	kaknriːnɪ
harður	harðʏr
frækinn	fraiːcɪnː
fjórði	fjourðɪ
aðstoðarforstjóri	aðstɔːðarfɔr̥stjouːrɪ
peningaseðill	pʰɛːniŋkasɛːðɪtl
kló	kʰlouː
afmælisdagur	avmaiːlɪstaːɣʏr
gagnauga	kaknøyːɣa
banga	pauŋka
gátt	kauht
drjúgur	trjuːʏr
handfylli	hantfɪtlɪ
éta	jɛːta
áræða	auːraiːða
grallari	kratlaːrɪ
stjórn	stjourtn
rák	rauːk
náma	nauːma
vanur	vaːnʏr
pund	pʰʏnt
morthens	mɔr̥tɛns
barein	paːreiːn
mör	mœːr
gæfur	caiːvʏr
lón	louːn
sléttur	stljɛhtʏr
stæði	staiːðɪ
fartölva	far̥tʰœlva
þráðnykra	θrauðnɪːkra
rápa	rauːpa
mærskur	mair̥skʏr
klókur	kʰlouːkʏr
djúp	tjuːp
kára	kʰauːra
bunga	puŋka
dauðarefsing	tøyːðarɛfsiŋk
alþjóðlegur	alθjouðlɛːɣʏr
sálfræðilegur	saulfraiːðilɛːɣʏr
fantur	fan̥tʏr
leir	leiːr
rotna	rɔhtna
flugur	flʏːɣʏr
valhneta	valn̥ɛːta
mynddiskur	mɪnttɪskʏr
álftalaukur	aul̥taløyːkʏr
æfing	aiːviŋk
stjúpdóttir	stjuːptouhtɪr
kafna	kʰapna
fýluferð	fiːlʏfɛrð
fosfór	fɔsfouːr
fíkn	fihkn
grið	krɪːð
dyggur	tɪkːʏr
gæfa	caiːva
völlur	vœtlʏr
hilmir	hɪlmɪːr
brass	prasː
komma	kʰɔmːa
ístra	istra
venja	vɛnja
hreyta	r̥eiːta
kös	kʰœːs
óska	ouska
hampur	ham̥pʏr
bolli	pɔtlɪ
grýttur	krihtʏr
laski	lascɪ
hestur	hɛstʏr
búrma	purma
hortugur	hɔr̥tʏːɣʏr
millipils	mɪtlɪpʰɪls
straumur	strœyːmʏr̥
svar	svaːr
litháen	lɪːthauːɛːn
brauð	prøyːð
kapella	kʰaːpɛtla
fógeti	fouːcɛːtɪ
reyr	reiːr
bekkjarlalli	pɛhcarlatlɪ
girða	cɪrða
dúkkuhús	tuhkʏhuːs
týr	tʰiːr
skegg	scɛkː
skjaldarmerkjafræði	scaltaːrmɛr̥cafraiːðɪ
nafna	nappa
landfræði	lantfraiːðɪ
hjóm	çouːm
hýjungur	hiːjuŋkʏr
dráttartaug	trauhtartʰøyːɣ
nýsjálenskur	niːsjauːlɛnskʏr
dymbilvika	tɪmpɪlvɪːka
ansa	ansa
galli	kalːɪ
bréf	prjɛːv
flekkur	flɛhkʏr
ógna	oukna
rispa	rɪspa
stígvél	stiɣvjɛːl
keðja	cʰɛðja
freista	freista
kaupstefna	kʰøypstɛpna
selma	sɛlma
dröngull	trøyŋkʏtl
markvörður	mar̥kvœrðʏr
sökkull	sœhkʏtl
djákni	tjauhknɪ
glymja	klɪmja
rafali	raːvaːlɪ
afskrá	afskrauː
brómber	proumpɛːr
brimill	prɪːmɪtl
slagharpa	stlaːɣhar̥pa
skriðnablóm	skrɪðnaplouːm
kameldýr	kʰaːmɛltiːr
sannleikur	sanːleiːkʏr
öðlast	œðlast
geisladiskur	ceistlatɪskʏr
kærulaus	cʰaiːrʏløyːs
formáli	fɔrmauːlɪ
abbadís	apːatiːs
pynta	pʰɪn̥ta
grænmetisæta	krainmɛːtɪsaiːta
hjálmar	çaulmar
ósk	ousk
enskur	ɛnskʏr
áheyrn	auːheirtn̥
friðarbogi	frɪːðarpɔːjɪ
slímugur	stliːmʏːɣʏr
rennilás	rɛnːɪlauːs
kok	kʰɔːk
kaaber	kʰɔːpɛr
matarborð	maːtarpɔrð
lélegur	ljɛːlɛːɣʏr
tvívetni	tʰviːvɛhtnɪ
þvarg	θvark
gott	kɔht
bernharður	pɛrnharðʏr
bleyði	pleiːðɪ
bjórvömb	pjourvœmp
fótleggur	fouːtlɛkːʏr
svíi	sviːɪ
reitur	reiːtʏr
veikleiki	veiːkleiːcɪ
villimaður	vɪtlɪmaːðʏr
trefill	tʰrɛːvɪtl
enginn	eiŋcɪnː
slóvenía	stlouːvɛːniːja
dútl	tuhtl
farmur	farmʏr
kyrrþeyr	cʰɪrθeiːr
flauta	fløyːtʰa
rauðkál	røyðkʰauːl
hanskahólf	hanskahoulv
staur	støyːr
blik	plɪːk
flækingur	flaiːciŋkʏr
sauma	søyːma
kolla	kʰɔtla
verkfæri	vɛr̥kfaiːrɪ
bókaútgáfa	pouːkauːtkauːva
hitna	hɪhtna
vinátta	vɪːnauhta
lækjasóley	laiːcasouːleiː
tjakkur	tʰjahkʏr
hrímtittlingur	r̥imtʰɪhtliŋkʏr
merkúr	mɛr̥kʰuːr
suðaustur	sʏːðøystʏr
lögg	lœkː
dádýr	tauːtiːr
vafagepill	vaːvacɛːpɪtl
angóla	aŋkouːla
hnoð	n̥ɔːð
malbik	malpɪːk
andstæðingur	antstaiːðiŋkʏr
vasaþjófur	vaːsaθjouːvʏr
pressa	pʰrɛsːa
banani	paːnanɪ
félagi	fjɛːlaːjɪ
einn	eitn
hviklyndi	kʰvɪːklɪntɪ
sigla	sɪkla
gúrka	kur̥ka
saltur	sal̥tʏr
albanska	alpanska
krossfesting	kʰrɔsːfɛstiŋk
dynja	tɪnja
aðaláhrif	aːðaːlauːr̥ɪːv
launahækkun	løyːnahaihkʏn
rauf	røyːv
hólf	houlv
ákveðinn	auːkʰvɛːðɪnː
gunnlaug	kʏnːløyːɣ
gisting	cɪstiŋk
öryggisgirðing	œːrɪcːɪscɪrðiŋk
rjómakaka	rjouːmakʰaːka
kærasta	cʰaiːrasta
dropi	trɔːpɪ
persneska	pʰɛr̥snɛska
stinnasef	stɪnːasɛːv
ráða	rauːða
ristill	rɪstɪtl
vista	vɪsta
bjúgstör	pjuɣstœːr
brons	prɔns
gissurína	cɪsːʏriːna
gerla	cɛrtla
svikull	svɪːkʏtl
tauta	tʰøyːta
klósettpappír	kʰlouːsɛhtpʰahpiːr
durtur	tʏr̥tʏr
hafdís	havtiːs
sameina	saːmeiːna
hrúður	r̥uːðʏr
fréttablað	frjɛhtaplaːð
konráð	kʰɔnrauːð
tindur	tʰɪntʏr
þurr	θʏrː
skarifífill	skaːrɪfiːvɪtl
eintala	eintʰaːla
allsgáður	alskauːðʏr
bjóst	pjouːst
hegðun	hɛɣðʏn
hugsun	hʏksʏn
heildi	heiltɪ
eyðsla	eiðstla
kennitala	cʰɛnːɪtʰaːla
drjóli	trjouːlɪ
æta	aiːta
bruggari	prʏkːaːrɪ
háhyrningur	hauhɪrtniŋkʏr
þola	θɔːla
hjálparsögn	çaul̥parsœkn
vænn	vaitn
fölur	fœːlʏr
titrari	tʰɪːtrarɪ
farteski	far̥tʰɛscɪ
hlébarði	l̥ɛːparðɪ
tagga	tʰakːa
baðkar	paðkʰaːr
fræðigrein	fraiːðɪkreiːn
grafít	kraːfiːt
rót	rouːt
bæti	paiːtɪ
þríeinn	θriːeitn
hræla	r̥aiːla
hertogi	hɛr̥tʰɔjɪ
hola	hɔːla
pipar	pʰɪːpar
innihalda	ɪnːɪhalta
teðja	tʰɛðja
mítur	miːtʏr
vilja	vɪlja
torkenna	tʰɔr̥cʰɛnːa
kviðslit	kʰvɪðstlɪːt
glódís	klouːtiːs
prentun	pʰrɛn̥tʏn
pússa	pʰusːa
sending	sɛntiŋk
eftir	ɛftɪr
daggarmark	takːarmar̥k
iðunn	ɪːðʏnː
þjóðerni	θjouːðɛrtnɪ
albanía	alpaːniːja
móðir	mouːðɪr
sálfræði	saulfraiːðɪ
högg	hœkː
leiga	leiːɣa
skelfing	scɛlviŋk
afmæli	ammaiːlɪ
austurland	øystʏrlant
sýra	siːra
arngunnur	artnkʏnːʏr
deila	teiːla
sæunn	saiːjʏnː
fjölbreytni	fjœlpreihtnɪ
sitja	sɪːtja
hveiti	kʰveiːtɪ
pínulítill	pʰiːnʏliːtɪtl
styrkja	stɪr̥ca
herðablað	hɛrðaplaːð
biggi	pɪcːɪ
fyl	fɪːl
allsber	alspɛːr
bloti	plɔːtɪ
línuleiki	liːnʏleiːcɪ
blendingur	plɛntiŋkʏr
hnefaleikar	n̥ɛːvaleiːkar
harmóníum	harmouːniːjʏm
þeytari	θeiːtarɪ
dyntóttur	tɪn̥touhtʏr
grágæs	krauːcaiːs
ímynd	iːmɪnt
markúsartorg	mar̥kuːsartʰɔrk
öskur	œskʏr
styggð	stɪɣð
markmaður	mar̥kmaːðʏr
breiða	preiːða
göndull	kœntʏtl
glópagull	klouːpakʏtl
minnihluti	mɪnːɪl̥ʏːtɪ
dæsa	taiːsa
byggð	pɪɣð
gramm	kramː
hylling	hɪtliŋk
reiði	reiːðɪ
aur	øyːr
ónáða	ouːnauːða
rökfræði	rœːkfraiːðɪ
bil	pɪːl
flugmaður	flʏɣmaːðʏr
blekkja	plɛhca
stuttur	stʏhtʏr
mát	mauːt
jafnvægi	japnvaiːjɪ
fjölröddun	fjœlrœtːʏn
út	uːt
strigi	strɪːjɪ
stöðugur	stœːðʏɣʏr
nátthrafn	nauhtr̥apn
orðflokkur	ɔrðflɔhkʏr
framferði	framfɛrðɪ
met	mɛːt
spergilkál	spɛrcɪlkʰauːl
eyðni	eiðnɪ
svara	svaːra
smokkur	smɔhkʏr
gervigras	cɛrvɪkraːs
marsering	mar̥sɛːriŋk
prins	pʰrɪns
lettland	lɛhtlant
lefsa	lɛfsa
fyllirí	fɪtlɪri
þúa	θuːa
göng	køyŋk
pétur	pjɛːtʏr
þorleifína	θɔrleiːviːna
leggja	lɛcːa
þyrping	θɪr̥piŋk
atriði	aːtrɪːðɪ
rafstöð	ravstœːð
álfur	aulvʏr
hvítur	kʰviːtʏr
brum	prʏːm
svili	svɪːlɪ
múrhúð	muːrhuːð
þyrma	θɪrma
dúr	tuːr
hlekkja	l̥ɛhca
skapa	skaːpa
bar	paːr
fílsbein	filspeiːn
forstöðumaður	fɔr̥stœðʏmaːðʏr
stefna	stɛpna
vega	vɛːɣa
lofttæmi	lɔfttʰaiːmɪ
tepra	tʰɛːpra
svíta	sviːta
markslá	mar̥kstlauː
síki	siːcɪ
jakuxi	jaːkʏxsɪ
þrauka	θrøyːka
ægilegur	aiːjɪlɛːɣʏr
fylgifiskur	fɪlcɪfɪskʏr
ýla	iːla
hljómplata	l̥joumpʰlaːta
strengja	streiɲca
hilla	hɪtla
þefa	θɛːva
matreiðslubók	maːtreiðstlʏpouːk
tríósónata	tʰriːjouːsouːnaːta
vínberjalögur	vinpɛrjalœːɣʏr
metan	mɛːtʰaːn
hamra	hamra
tæra	tʰaiːra
hröngl	r̥øyŋl
þunglamalegur	θuŋklaːmalɛːɣʏr
hnallur	n̥atlʏr
afturbeygður	aftʏrpeiɣðʏr
kvöð	kʰvœːð
grúi	kruːɪ
strand	strant
togi	tʰɔːjɪ
þorgilsína	θɔrcɪlsiːna
spakmæli	spaːkmaiːlɪ
sníkja	sniːca
stjörnufræðingur	stjœrtnʏfraiːðiŋkʏr
jöstur	jœstʏr
sérstakur	sjɛr̥staːkʏr
leyniskytta	leiːnɪscɪhta
skrun	skrʏːn
persónulega	pʰɛr̥souːnʏlɛːɣa
argentína	arkɛntʰiːna
tuldur	tʰʏltʏr
búlgarska	pulkar̥ska
skvísa	skviːsa
tætla	tʰaihtla
slag	stlaːɣ
munkahetta	muŋ̊kahɛhta
gaul	køyːl
nautakjöt	nøyːtacʰœːt
misþyrming	mɪːsθɪrmiŋk
kenjar	cʰɛnjar
stjórnmál	stjourtnmauːl
efnasamband	ɛpnasampant
tötrar	tʰœːtrar
víkingur	viːciŋkʏr
símon	siːmɔːn
búð	puːð
afbaka	avpaːka
barnalæknir	partnalaihknɪr
lyfjagras	lɪvjakraːs
flaggskip	flakːscɪːp
hrökkva	r̥œhkva
hvap	kʰvaːp
kör	kʰœːr
múslimi	mustlɪːmɪ
ferstrendingur	fɛr̥strɛntiŋkʏr
lopapeysa	lɔːpapʰeiːsa
smekkur	smɛhkʏr
lægð	laiɣð
eyvindína	eiːvɪntiːna
skrá	skrauː
mistúlka	mɪːstʰul̥ka
alúðlegur	aːluðlɛːɣʏr
ymja	ɪmja
hnoðafræhyrna	n̥ɔːðafraiːhɪrtna
halli	hatlɪ
myrkur	mɪr̥kʏr
kynhvöt	cʰɪːnxʷœːt
tregi	tʰreiːjɪ
þil	θɪːl
langatöng	lauŋkatʰøyŋk
salat	saːlaːt
knippi	kʰnɪhpɪ
láfi	lauːvɪ
surtur	sʏr̥tʏr
kussari	kʰʏsːarɪ
gandur	kantʏr
lím	liːm
afæta	aːvaiːta
krónprinsessa	kʰrounprɪnsɛsːa
hvítlaukspressa	kʰviːtløykspʰrɛsːa
röð	rœːð
ljósastör	ljouːsastœːr
gikkja	cɪhca
aspas	aspas
hringur	r̥iŋkʏr
volga	vɔlka
minnismerki	mɪnːɪsmɛr̥cɪ
ringulreið	riŋkʏlreiːð
skóf	skouːv
leyndarmál	leintarmauːl
vatnsmelóna	vasːmɛːlouːna
einbjörg	einpjœrk
drottnari	trɔhtnarɪ
nói	nouːɪ
núna	nuːna
fróðný	frouðniː
þorsteinína	θɔr̥steiːniːna
vignir	vɪknɪr
beinmergur	peiːnmɛrkʏr
klefi	kʰlɛːvɪ
þar	θaːr
hljóða	l̥jouːða
zoëga	souːɛːkaː
túndra	tʰuntra
björn	pjœrtn
rígur	riːɣʏr
lús	luːs
refur	rɛːvʏr
grófur	krouːvʏr
helvíti	hɛlviːtɪ
blóðmaur	plouːðmøyːr
frekur	frɛːkʏr
ý	iː
sjö	sjø
liðþjálfi	lɪθθjaulvɪ
jöklaklukka	jœhklakʰlʏhka
snjallur	stnjatlʏr
þóroddur	θouːrɔtːʏr
samkeppni	samcʰɛhpnɪ
afturhaldsstefna	aftʏrhaltsstɛpna
hnísa	n̥iːsa
krampi	kʰram̥pɪ
bryggja	prɪcːa
tækla	tʰaihkla
lyng	liŋk
heilla	heitla
svelta	svɛl̥ta
ekkill	ɛhcɪtl
hlunkur	l̥uŋ̊kʏr
sigþrúður	sɪxθruːðʏr
ungi	uŋkɪ
elfa	ɛlva
víti	viːtɪ
skrín	skriːn
limafjörður	lɪːmafjœrðʏr
snotur	stnɔːtʏr
hreindýr	r̥eintiːr
munur	mʏːnʏr
úthaf	uːthaːv
fjörfiskur	fjœrfɪskʏr
flónska	flounska
augljós	øyɣljouːs
matskeið	maːtsceiːð
hnúðurbakur	n̥uːðʏrpaːkʏr
sauðvingull	søyðviŋkʏtl
vindill	vɪntɪtl
syrjóttur	sɪrjouhtʏr
villtur	vɪl̥tʏr
óreiða	ouːreiːða
húfur	huːvʏr
össur	œsːʏr
púma	pʰuːma
þórmundur	θourmʏntʏr
þór	θouːr
gaur	køyːr
hvíld	xʷilt
handbremsubeygja	hantprɛmsʏpeiːja
klukkutími	kʰlʏhkʏtʰiːmɪ
biblía	pɪpliːja
snjóa	snjouːa
kettlingur	cʰɛhtliŋkʏr
kvörn	kʰvœrtn
smóking	smouːcʰiŋk
til	tʰɪːl
mannasiður	manːasɪːðʏr
kviður	kʰvɪːðʏr
rist	rɪst
floti	flɔːtɪ
kynna	cʰɪnːa
festing	fɛstiŋk
nót	nouːt
jarðsaga	jarðsaːɣa
bruma	prʏːma
æðri	aiðrɪ
birna	pɪrtna
dýpt	tift
innihald	ɪnːɪhalt
símtal	simtʰaːl
næla	naiːla
sáning	sauːniŋk
kindugur	cʰɪntʏːɣʏr
tímabelti	tʰiːmapɛl̥tɪ
mýrasef	miːrasɛːv
stoppa	stɔhpa
stuttermabolur	stʏhtɛrmapɔːlʏr
áhrif	auːr̥ɪːv
ýlda	ilta
íkornabygg	iːkʰɔrtnapɪkː
leikritaskáld	leiːkrɪːtaskault
fjöldi	fjœltɪ
tafla	tʰapla
ryðja	rɪðja
hverfill	kʰvɛrvɪtl
kósínus	kʰouːsiːnʏs
amerískur	aːmɛːriskʏr
hyggja	hɪcːa
depla	tɛhpla
lítri	liːtrɪ
geirdís	ceirtiːs
her	hɛːr
prófastur	pʰrouːvastʏr
varða	varða
mata	maːta
efa	ɛːva
galdramaður	kaltramaːðʏr
þrítyngdur	θriːtʰiŋtʏr
fálki	faul̥cɪ
höfnun	hœpnʏn
afbrigðilegur	avprɪɣðɪlɛːɣʏr
jafningi	japniɲcɪ
seifur	seiːvʏr
njóli	njouːlɪ
sveigur	sveiːɣʏr
eðlismunur	ɛðlɪsmʏːnʏr
blekpenni	plɛːkpʰɛnːɪ
völ	vœːl
hugrekki	hʏɣrɛhkɪ
svið	svɪːð
hagnaður	haknaðʏr
kveina	kʰveiːna
ananas	aːnaːnas
blakkneskur	plahknɛskʏr
havaí	haːvaiː
trumba	tʰrʏmpa
hálmur	haulmʏr
stýrikerfi	stiːrɪcʰɛrvɪ
leikhús	leiːkhuːs
vefstóll	vɛfstoutl
ár	auːr̥
bleðill	plɛːðɪtl
pönnukaka	pʰœnːʏkʰaːka
leðja	lɛðja
verðmæti	vɛrðmaiːtɪ
liðamót	lɪːðamouːt
finnast	fɪnːast
norðurljós	nɔrðʏrljouːs
sæti	saiːtɪ
beltisstaður	pɛl̥tɪsstaːðʏr
meirihluti	meiːrɪl̥ʏːtɪ
þórður	θourðʏr
dáti	tauːtɪ
kenning	cʰɛnːiŋk
afvopna	avvɔhpna
sjúkrahús	sjuːkrahuːs
stígur	stiːɣʏr
kaf	kʰaːv
viðtengingarháttur	vɪtʰeiɲciŋkarhauhtʏr
gólf	koulv
orðabók	ɔrðapouːk
haf	haːv
stein	steiːn
nekt	nɛxt
hlátur	l̥auːtʏr
skinn	scɪnː
funa	fʏːna
drösull	trœːsʏtl
glæruvængur	klaiːrʏvaiŋkʏr
sjúkdómafræði	sjuːktouːmafraiːðɪ
hégilja	çɛːkɪlja
stama	staːma
rúbín	ruːpiːn
læða	laiːða
gel	cɛːl
basi	paːsɪ
gera	cɛːra
nyrðra	nɪrðra
vartappi	vaːrtʰahpɪ
laugardagur	løyːɣartaːɣʏr
frádráttur	frautrauhtʏr
ilskór	ɪlskouːr
bakvörður	paːkvœrðʏr
sólsetur	soulsɛːtʏr
slitur	stlɪːtʏr
geimfar	ceimfaːr
bagi	paiːjɪ
mynd	mɪnt
lög	lœːɣ
masa	maːsa
kempa	cʰɛm̥pa
mýrdalur	mirtaːlʏr
tattú	tʰahtuː
flogaveiki	flɔːɣaveiːcɪ
páskabróðir	pʰauskaprouːðɪr
stemma	stɛmːa
viður	vɪːðʏr
aldís	altiːs
sigurðína	sɪːɣʏrðiːna
kelta	cʰɛl̥ta
framkvæmd	framkʰvaimt
breti	prɛːtɪ
ótrúr	ouːtruːr
löggjafarþing	lœɣcaːvarθiŋk
þrettán	θrɛhtauːn
tré	tʰrjɛː
ell	ɛtl
ský	sciː
kofa	kʰɔːva
kalín	kʰaːliːn
ekill	ɛːcɪtl
sjáumst	sjaːuʏm̥st
læri	laiːrɪ
afkomandi	avkʰɔːmantɪ
nóg	nouː
brennivín	prɛnːɪviːn
dund	tʏnt
samkynhneigð	samcʰɪnn̥eiɣð
belgur	pɛlkʏr
laginn	laiːjɪnː
strigaskór	strɪːɣaskouːr
tegund	tʰɛːɣʏnt
engiferöl	eiɲcɪfɛːrœːl
bátsferð	pautsfɛrð
knæpa	kʰnaiːpa
eiður	eiːðʏr
mokka	mɔhka
hundshaus	hʏntshøyːs
paufa	pʰøyːva
bæjar	paiːjar̥
háll	hautl
hræðilegur	r̥aiːðɪlɛːɣʏr
lindi	lɪntɪ
símaklefi	siːmakʰlɛːvɪ
leikbrúða	leiːkpruːða
fasteign	fasteikn
kynni	cʰɪnːɪ
logn	lɔkn
hvel	kʰvɛːl
merkingarþróun	mɛr̥ciŋkarθrouːʏn
orkuver	ɔr̥kʏvɛːr
vætla	vaihtla
klipping	kʰlɪhpiŋk
hrossafluga	r̥ɔsːaflʏːɣa
skark	skar̥k
skytta	scɪhta
kjörbúð	cʰœrpuːð
krafa	kʰraːva
hettupeysa	hɛhtʏpʰeiːsa
kvendýr	kʰvɛntiːr
hyr	hɪːr
glitfífill	klɪːtfiːvɪtl
gatari	kaːtaːrɪ
unglingur	uŋkliŋkʏr
æviágrip	aiːvɪauːkrɪːp
inngrip	ɪnːkrɪːp
belgía	pɛlcija
varpasveifgras	var̥pasveivkraːs
forlát	fɔrlauːt
hádegi	hauːteiːjɪ
miltu	mɪl̥tʏ
rúmur	ruːmʏr
píla	pʰiːla
karmur	kʰarmʏr
orða	ɔrða
lík	liːk
sýna	siːna
söngvari	søyŋkvaːrɪ
sofi	sɔːvɪ
hvikull	kʰvɪːkʏtl
marka	mar̥ka
þrýsta	θrista
valtýr	valtʰiːr
formæling	fɔrmaiːliŋk
hámark	hauːmar̥k
kyrravika	cʰɪrːavɪːka
þrándheimur	θrauntheiːmʏr
lágur	lauːɣʏr̥
óhlýðinn	ouːl̥iːðɪnː
lestarstjóri	lɛstarstjouːrɪ
konungsríki	kʰɔːnuŋksriːcɪ
sigð	sɪɣð
hnefaleikari	n̥ɛːvaleiːkarɪ
kelfa	cʰɛlva
líkami	liːkʰaːmɪ
tökuþýðing	tʰœːkʏθiːðiŋk
kaupa	kʰøyːpa
fótur	fouːtʏr
lyndi	lɪntɪ
hula	hʏːla
róm	rouːm
brjóstsviði	prjoustsvɪːðɪ
kútur	kʰuːtʏr
maís	maːiːs
þeba	θɛːpa
skafl	skapl
urt	ʏr̥t
stöngull	støyŋkʏtl
greniköngull	krɛːnɪkʰøyŋkʏtl
axlabönd	axstlapœnt
sjaldgæfur	sjaltcaiːvʏr
rúgur	ruːʏr
flétta	fljɛhta
vasabók	vaːsapouːk
sjaldan	sjaltan
frumbyggi	frʏmpɪcːɪ
handboltaþjálfari	hantpɔl̥taθjaulvarɪ
næring	naiːriŋk
hornblendi	hɔrtnplɛntɪ
efi	ɛːvɪ
blóðnasir	plouðnaːsɪr
klessa	kʰlɛsːa
lýsing	liːsiŋk
andfélagslega	antfjɛːlaxslɛːɣa
jöfnun	jœpnʏn
systur	sɪstʏr
niðurlægjandi	nɪːðʏrlaiːjantɪ
korkur	kʰɔr̥kʏr
bókaskápur	pouːkaskauːpʏr
ásdís	auːstiːs
armur	armʏr
upp	ʏhp
lensa	lɛnsa
app	ahp
lyklabarn	lɪhklapartn
putta	pʰʏhta
duggönd	tʏkːœnt
bláhrafn	plauːr̥apn
kaldhæðni	kʰalthaiðnɪ
pollagalli	pʰɔtlakalːɪ
orðsifjar	ɔrðsɪvjaːr
slappur	stlahpʏr
sjár	sjauːr
flóð	flouːð
skækill	scaiːcɪtl
ósannindi	ouːsanːɪntɪ
forsíða	fɔr̥siːða
nákvæmlega	nauːkʰvaimlɛːɣa
tá	tʰauː
hvítlauksgeiri	kʰviːtløyksceiːrɪ
fjöldamorðingi	fjœltamɔrðiŋcɪ
pílári	pʰiːlauːrɪ
egg	ɛkː
fallorð	fatlɔrð
hylja	hɪlja
dökkna	tœhkna
nema	nɛːma
máltækni	maultaihknɪ
baða	paːða
horaður	hɔːraðʏr
eyland	eiːlant
mótorhjól	mouːtɔrçouːl
fortíð	fɔr̥tʰiːð
pípuhattur	pʰiːpʏhahtʏr
tamur	tʰaːmʏr
slóvakíska	stlouːvacʰiska
handklæði	hantkʰlaiːðɪ
bugur	pʏːɣʏr
jeminn	jɛːmɪnː
gríð	kriːð
rúnar	ruːnaːr
skrýða	skriːða
smala	smaːla
gráða	krauːða
rekill	rɛːcɪtl
saga	saːɣa
ójafn	ouːjapn
barón	paːrouːn
anda	anta
tröll	tʰrœtl
sorta	sɔr̥ta
friðill	frɪːðɪtl
heimspeki	heimspɛːcɪ
þamba	θampa
þriðji	θrɪðjɪ
von	vɔːn
könguló	kʰøyŋkʏlouː
aldursmunur	altʏrsmʏːnʏr
skemill	scɛːmɪtl
krakki	kʰrahcɪ
karate	kʰaːratɛː
skrifa	skrɪːva
kaffihús	kʰafːɪhuːs
yðar	ɪːðar
orf	ɔrv
hnúfubakur	n̥uːvʏpaːkʏr
pottur	pʰɔhtʏr
koks	kʰɔxs
skírisskógur	sciːrɪsskouːʏr
framhlaðningur	framl̥aðniŋkʏr
ofbirta	ɔvpɪr̥ta
trippi	tʰrɪhpɪ
fjallafræhyrna	fjatlafraiːhɪrtna
suðvestur	sʏːðvɛstʏr
ræma	raiːma
hýr	çiːr
hjáguð	çaukvʏːð
lýður	liːðʏr
karpa	kʰar̥pa
mella	mɛtla
forjaxl	fɔːrjaxstl
trú	tʰr̥uː
farsæld	far̥sailt
silfur	sɪlvʏr
hansína	hansiːna
auðvelda	øyðvɛlta
klemma	kʰlɛmːa
dyggð	tɪɣð
úr	uːr
boð	pɔːð
dóná	touːnauː
markstöng	mar̥kstøyŋk
heiði	heiːðɪ
scheving	scɛːviŋ
neðanjarðarbraut	nɛːðanjarðarprøyːt
reka	rɛːka
bómull	pouːmʏtl
svipta	svɪfta
sögn	sœkn
safírblár	saːfiːrplauːr
meðal	mɛːðal
drungi	truɲcɪ
þingkona	θiŋkʰɔːna
flekkaður	flɛhkaðʏr
hjaltína	çal̥tiːna
tengill	tʰeiɲcɪtl
rólegur	rouːlɛːɣʏr
kvilli	kʰvɪtlɪ
einhyrningur	einhɪrtniŋkʏr
heiðingi	heiːðiɲcɪ
guðríður	kvʏðriːðʏr
heildun	heiltʏn
fylgsni	fɪlkstnɪ
mjólkursúkkulaði	mjoul̥kʏrsuhkʏlaːðɪ
flissa	flɪsːa
skemmta	scɛm̥ta
skötuhjú	skœːtʏçuː
spennandi	spɛnːantɪ
snillingur	stnɪtliŋkʏr
friðlýsa	frɪðliːsa
saft	saft
skutla	skʏhtla
þroski	θrɔscɪ
atorka	aːtɔr̥ka
pardus	pʰartʏs
manni	manːɪ
læknisskoðun	laihknɪsskɔːðʏn
gíbraltar	ciːpral̥taːr
vasaljós	vaːsaljouːs
reykja	reiːca
gamall	kaːmatl
gluggakarmur	klʏkːakʰarmʏr
brautargengi	prøyːtarceiɲcɪ
geimfari	ceimfaːrɪ
kjarkmikill	cʰar̥kmɪːcɪtl
lóga	louːa
leifar	leiːvar
geisla	ceistla
fölna	fœlna
kaplamjólk	kʰahplamjoul̥k
löstur	lœstʏr
lögregluþjónn	lœɣrɛklʏθjoutn
tjull	tʰjʏlː
tokkata	tʰɔhkaːta
hafna	hapna
lesandi	lɛːsantɪ
etýða	ɛːtʰiːða
þverskurður	θvɛrskʏrðʏr
æki	aiːcɪ
morkill	mɔr̥cɪtl
afhending	afhɛntiŋk
heimsendir	heimsɛntɪr
díll	titl
áfangaskýrsla	auːfauŋcascir̥stla
vitrun	vɪːtrʏn
syrta	sɪr̥ta
lúka	luːka
samþykkja	samθɪhca
varpi	var̥pɪ
klórópren	kʰlouːrouːpʰrɛːn
trymbill	tʰrɪmpɪtl
almannatengsl	almannatʰeiŋkstl
mön	mœːn
kóngsbiskup	kʰouŋkspɪskʏp
meðlæti	mɛðlaiːtɪ
eldfimur	ɛltfɪːmʏr
birgir	pɪrcɪr
rúrik	ruːrɪk
medína	mɛːtiːna
augljóslega	øyɣljouːslɛːɣa
táldraga	taultraːɣa
hættulegur	haihtʏlɛːɣʏr
hví	xʷiː
hnjúkur	n̥juːkʏr
orðsifjafræði	ɔrðsɪvjafraiːðɪ
sellerí	sɛlːɛːriː
jól	jouːl
ítrekað	iːtʰrɛːkað
pysja	pʰɪːsja
nevada	nɛːvata
pistill	pʰɪstɪtl
ljósakróna	ljouːsakʰrouːna
gæra	caiːra
sekt	sɛxt
eyrnalokkur	eirtnalɔhkʏr
aukasetning	øyːkasɛhtniŋk
tófa	tʰouːa
sálumessa	sauːlʏmɛsːa
lifur	lɪːvʏr
folald	fɔːlalt
rauðgreni	røyðkrɛːnɪ
hoppa	hɔhpa
erlendur	ɛrlɛntʏr
klúr	kʰluːr
haförn	haːvœrtn
ómega	ouːmɛːka
rola	rɔːla
asía	aːsiːja
réttindi	rjɛhtɪntɪ
ríki	riːcɪ
gil	cɪːl
mágur	mauːʏr
aþena	aːθɛːna
númers	nuːmɛrs
býsn	pistn
tvíhliða	tʰviːl̥ɪːða
raula	røyːla
lega	lɛːɣa
leikmynd	leiːkmɪnt
gála	kauːla
hneisulegur	n̥eiːsʏlɛːɣʏr
hróðný	r̥ouðniː
spæta	spaiːta
snóker	stnouːkɛr
maurasýra	møyːrasiːra
bátur	pauːtʏr
fjöl	fjœːl
morðingi	mɔrðiɲcɪ
slarksamur	stlar̥ksaːmʏr
stjórnvölur	stjourtnvœːlʏr
krókus	kʰrouːkʏs
bráð	prauːð
forskot	fɔr̥skɔːt
dýfa	tiːva
noregur	nɔːrɛːɣʏr
sinn	sɪnː
nagli	naklɪ
orgía	ɔrciːja
húsdýr	huːstiːr
marta	mar̥ta
mustarður	mʏstarðʏr
elías	ɛːliːjas
gerill	cɛːrɪtl
leigubíll	leiːɣʏpitl
stundum	stʏntʏm
gjóstur	coustʏr
horfa	hɔrva
flaustur	fløystʏr
rjómaís	rjouːmaiːs
næturgali	naiːtʏrkaːlɪ
boli	pɔːlɪ
konráðína	kʰɔnrauːðiːna
þeir	θeiːr
uppsetning	ʏhpsɛhtniŋk
finnskur	fɪnskʏr
tík	tʰiːk
klofna	kʰlɔpna
kjánaskapur	cʰauːnaskaːpʏr
jana	jaːna
þorgerður	θɔrcɛrðʏr
ítalska	iːtʰalska
þota	θɔːta
teigur	tʰeiːɣʏr
blá	plauː
pósthús	pʰousthuːs
huglaus	hʏɣløyːs
blý	pliː
hálfleiðari	haulvleiːðarɪ
ofan	ɔːvan
togna	tʰɔkna
móeiður	mouːeiːðʏr
framreiðsla	framreiðstla
víxl	vixstl
verulega	vɛːrʏlɛːɣa
samsæta	samsaiːta
skáti	skauːtɪ
naðurtunga	naːðʏrtʰuŋka
barrtré	parːtrjɛː
stoða	stɔːða
óþægindi	ouːθaiːjɪntɪ
rupla	rʏhpla
óperuhús	ouːpʰɛːrʏhuːs
sjóntaug	sjountʰøyːɣ
jór	jouːr
tréspíri	tʰrjɛːspiːrɪ
þúsundblaðarós	θuːsʏntplaːðarouːs
höll	hœtl
kvikur	kʰvɪːkʏr
vakt	vaxt
sár	sauːr
hóta	houːta
bjúgaldin	pjuːɣaltɪn
þangað	θauŋkaːð
kotra	kʰɔːtra
fæ	faiː
gæla	caiːla
hefla	hɛpla
framburður	frampʏrðʏr
goggur	kɔkːʏr
skála	skauːla
mig	mɪːɣ
vottur	vɔhtʏr
logi	lɔiːjɪ
melta	mɛl̥ta
sinnuleysi	sɪnːʏleiːsɪ
handa	hanta
klarínetta	kʰlaːriːnɛhta
krossmaðra	kʰrɔsːmaðra
verndari	vɛrntaːrɪ
soð	sɔːð
vín	viːn
már	mauːr
rjóður	rjouːðʏr
krossfífill	kʰrɔsːfiːvɪtl
teikna	tʰeihkna
níundi	niːjʏntɪ
kné	kʰnjɛː
gómsætur	koumsaiːtʏr
elja	ɛlja
mastur	mastʏr
agi	aːjɪ
götun	kœːtʏn
hósti	houstɪ
sebrabraut	sɛpraprøyːt
furðuhlutur	fʏrðʏl̥ʏːtʏr
hóf	houːv
göfugur	kœːvʏɣʏr
boðberi	pɔðpɛːrɪ
bólstraský	poulstrasciː
rými	riːmɪ
athöfn	aːthœpn
vörumerki	vœːrʏmɛr̥cɪ
mauraæta	møyːraaiːta
sveppafræði	svɛhpafraiːðɪ
maría	maːriːja
zóphonías	souːfɔːniːjas
bryti	prɪːtɪ
lesbía	lɛspiːja
sparta	spar̥ta
almennilegur	almɛnːɪlɛːɣʏr
spekja	spɛːca
heift	heift
án	aun
klerkur	kʰlɛr̥kʏr
grunnendurlífgun	krʏnːɛntʏrlivkʏn
þrjóskur	θrjouskʏr
svíða	sviːða
lögreglumaður	lœɣrɛklʏmaːðʏr
erfiði	ɛrvɪːðɪ
hátíð	hauːtʰiːð
himbrimi	hɪmprɪːmɪ
grand	krant
gersemi	cɛrsɛːmɪ
slit	stlɪːt
sessa	sɛsːa
kjör	cʰœːr
handbolti	hantpɔl̥tɪ
margrét	markrjɛːt
lömun	lœːmʏn
viðja	vɪðja
frumstig	frʏmstɪːɣ
lengja	leiɲca
nafn	napn
áhrifsfall	auːr̥ɪfsfatl
heiti	heiːtɪ
stífa	stiːva
reyður	reiːðʏr
rökhenda	rœːkhɛnta
miðasala	mɪːðasaːla
oxíð	ɔksiːð
skrið	skrɪːð
eygja	eiːja
blindhæð	plɪnthaiːð
njósnari	njoustnaːrɪ
perla	pʰɛrtla
olga	ɔlka
bróm	prouːm
sippuband	sɪhpʏpant
finsen	fɪnsɛːnː
vildís	vɪltiːs
fána	fauːna
gegna	cɛkna
eisa	eiːsa
tölvuleikur	tʰœlvʏleiːkʏr
ástmundur	austmʏntʏr
sagnfræðingur	saknfraiːðiŋkʏr
hrár	r̥auːr
halastjarna	haːlastjartna
nafnfræði	napnfraiːðɪ
spjótkast	spjouːtkʰast
innstunga	ɪnstuŋka
krepja	kʰrɛːpja
járn	jaurtn
kvaðratrót	kʰvaðraːtrouːt
eldmóður	ɛltmouːðʏr
andvaka	antvaːka
hrafnaklukka	r̥apnakʰlʏhka
sandur	santʏr
náæta	nauːaiːta
glyrna	klɪrtna
margþættur	markθaihtʏr
skak	skaːk
gort	kɔr̥t
aðalsetning	aːðalsɛhtniŋk
marsbúi	mar̥spuːɪ
hnútafræði	n̥uːtafraiːðɪ
hafri	havrɪ
átt	auht
kraká	kʰraːkauː
frumlag	frʏmlaːɣ
óheflaður	ouːhɛplaːðʏr
athæfi	aːthaiːvɪ
dauðlegur	tøyðlɛːɣʏr
luralegur	lʏːralɛːɣʏr
afrit	avrɪːt
blóð	plouːð
lettneskur	lɛhtnɛskʏr
byggja	pɪcːa
fíkja	fiːca
æs	aiːs
tafl	tʰapl
efni	ɛpnɪ
þræta	θraiːta
daglega	taɣlɛːɣa
kristján	kʰrɪstjauːn
héðan	çɛːðan
vafra	vavra
gerjun	cɛrjʏn
jóhannesína	jouːhanːɛːsiːna
bassi	pasːɪ
þarmur	θarmʏr
munnþurrka	mʏnːθʏr̥ka
leður	lɛːðʏr
einhver	eihkvɛːr
leppur	lɛhpʏr
bíti	piːtɪ
flæmingi	flaiːmiɲcɪ
marsmánuður	mar̥smauːnʏːðʏr
jaxl	jaxstl
önn	œnː
hvergi	kʰvɛrcɪ
baðherbergi	paːðhɛrpɛrcɪ
elta	ɛl̥ta
ég	jɛɣ
snarpur	snar̥pʏr
pöbb	pʰœpː
moppa	mɔhpa
kjólföt	kʰjoulfœːt
þyrnir	θɪrtnɪr
tign	tʰɪkn
jórunn	jouːrʏnː
moli	mɔːlɪ
botnlangabólga	pɔhtnlauŋkapoulka
mettun	mɛhtʏn
andri	antrɪ
skauti	skøyːtɪ
tungljurt	tʰuŋljʏr̥t
heyja	heiːja
vafur	vaːvʏr
jónas	jouːnaːs
frelsisstyttan	frɛlsɪsstɪhtan
snekkja	snɛhca
kúmen	kʰuːmɛːn
hollenskur	hɔllɛnskʏr
móða	mouːða
án	auːn
óvild	ouːvɪlt
dripla	trɪhpla
finnland	fɪnːlant
krummi	kr̥ʏmːɪ
stuðlun	stʏðlʏn
meistaraverk	meistaːravɛr̥k
kyrkja	cʰɪr̥ca
finnur	fɪnːʏr
aðalkirkja	aːðalcʰɪr̥ca
port	pʰɔr̥t
rofi	rɔːvɪ
vanöndun	vaːnœntʏn
sanskrít	sanskriːt
fiseind	fɪːseint
mót	mouːt
orðhluti	ɔrðl̥ʏːtɪ
typpi	tʰɪhpɪ
kristí	kʰrɪstiː
auðveldlega	øyðvɛltlɛːɣa
þrugl	θrʏkl
ingimundína	iŋcɪmʏntiːna
grínisti	kriːnɪstɪ
dúkönd	tuːkœnt
gæi	kaiːjɪ
gyða	cɪːða
slarkfær	stlar̥kfaiːr
deyja	teiːja
endurtaka	ɛntʏrtʰaːka
kyssa	cʰɪsːa
miski	mɪscɪ
málfar	maulfaːr
feðgar	fɛðkar
dýptarleit	tiftarleiːt
glaður	klaːðʏr
heygja	heiːja
hljóðkerfisfræði	l̥jouːðcʰɛrvɪsfraiːðɪ
grámosi	krauːmɔːsɪ
fjúka	fjuːka
biðstöð	pɪðstœːð
sjóli	sjouːlɪ
spyrja	spʏrja
freyðivín	freiːðɪviːn
sýkn	sihkn
melkorka	mɛlkʰɔr̥ka
slakna	stlahkna
sagnorð	saknɔrð
blautur	pløyːtʏr
þórgunnur	θourkʏnːʏr
fýra	fiːra
meiðsli	meiðstlɪ
vígja	viːja
jósebína	jouːsɛːpiːna
ófreskja	ouːfrɛsca
nátíð	nauːtʰiːð
kynleysi	cʰɪnleiːsɪ
hvaða	xʷaːða
blóðfræði	plouðfraiːðɪ
voffi	vɔfːɪ
afburður	avpʏrðʏr
kvika	kʰvɪːka
krydda	kʰrɪtːa
prússland	pʰrustlant
servíetta	sɛrvjɛhta
hlíðaburkni	l̥iːðapʏr̥knɪ
pollur	pʰɔtlʏr
brestur	prɛstʏr
moldavía	mɔltaviːja
löggjafarvald	lœɣcaːvarvalt
planta	pʰlan̥ta
gæsahúð	caiːsahuːð
virkur	vɪr̥kʏr
smá	smauː
tregur	tʰrɛːɣʏr
hallarvirki	hatlarvɪr̥cɪ
hvæsa	xʷaiːsa
gyðingur	cɪːðiŋkʏr
klakkur	kʰlahkʏr
klæði	kʰlaiːðɪ
tankur	tʰaŋ̊kʏr
hégómi	çɛːkouːmɪ
elí	ɛːliː
varkárni	var̥kʰaurtnɪ
sjóða	sjouːða
aldingarður	altɪnkarðʏr
kjáni	cʰauːnɪ
ætt	aiht
vöðvi	vœðvɪ
panna	pʰanːa
köldugras	kʰœltʏkraːs
dverglilja	tvɛrklɪlja
skjór	scouːr
rýna	riːna
margfaldur	markfaltʏr
flagahnoðri	flaːɣan̥ɔðrɪ
krækill	kʰraiːcɪtl
sníkill	stniːcɪtl
einkum	ein̥kʏm
sverðfiskur	svɛrðfɪskʏr
glósa	klouːsa
íþrótt	iːθrouht
nógur	nouːʏr
kynbundinn	cʰɪnpʏntɪnː
grávorblóm	krauːvɔrplouːm
hann	hanː
tiggi	tʰɪcːɪ
níl	niːl
rússneskur	rusːtnɛskʏr
hálsfesti	haulsfɛstɪ
mauka	møyːka
dýralæknir	tiːralaihknɪr
vilji	vɪljɪ
daðra	taðra
játa	jauːta
frumefni	frʏːmɛpnɪ
brúðkaupsnótt	pruðkʰøypsnouht
barti	par̥tɪ
súta	suːta
hempa	hɛm̥pa
derhúfa	tɛrhuːva
flasa	flaːsa
hetja	hɛːtja
græja	kraiːja
svæfing	svaiːviŋk
ljóska	ljouska
sparð	sparð
heimilisfang	heiːmɪlɪsfauŋk
örn	œrtn
bumbubúi	pʏmpʏpuːɪ
hommi	hɔmːɪ
ráðríkur	rauðriːkʏr
klám	kʰlauːm
lífvörður	livvœrðʏr
þrílaufungur	θriːløyːvʏŋkʏr
veikur	veiːkʏr
mállýska	maulliska
samlyndi	samlɪntɪ
húsfreyja	huːsfreiːja
kápa	kʰauːpa
fitjasef	fɪːtjasɛːv
verð	vɛrð
afturbati	aftʏrpaːtɪ
ískra	iːskra
hvolpur	xʷɔl̥pʏr
hljóta	l̥jouːta
eyrún	eiːrun
strauja	strøyːja
dreyra	treiːra
skortur	skɔr̥tʏr
djóka	tjouːka
nák	nauːk
goð	kɔːð
ritgerð	rɪːtcɛrð
eingöngu	einkøyŋkʏ
raust	røyst
mongólska	mɔŋkoulska
heimula	heiːmʏːla
hlaðborð	l̥aðpɔrð
vopn	vɔhpn
ná	nauː
kelda	cʰɛlta
teygjudýr	tʰeiːjʏtiːr
andstæður	antstaiðʏr
sambland	samplant
fóstur	foustʏr
jóna	jouːna
eftirmynd	ɛftɪrmɪnt
stökkull	stœhkʏtl
hvelatengsl	xʷɛːlatʰeiŋstl
hverfi	kʰvɛrvɪ
bý	piː
taumur	tʰøyːmʏr
sólber	soulpɛːr
skúlína	skuːliːna
einasta	eiːnasta
mykja	mɪːca
kæliskápur	cʰaiːlɪskaːpʏr
málvísindi	maulviːsɪntɪ
dúkur	tuːkʏr
sparnaður	spartnaːðʏr
lítt	liht
fiður	fɪːðʏr
rafmagn	raːmakn
panta	pʰan̥ta
brennisóley	prɛnːɪsouːleiː
dráttur	trauhtʏr
dekkja	tɛhca
orðasafn	ɔrðasapn
bakborði	paːkpɔrðɪ
móheiður	mouːheiːðʏr
mynt	mɪn̥t
líffæri	liffaiːrɪ
snörla	snœrtla
jafnt	jaft
verkur	vɛr̥kʏr
prísund	pʰriːsʏnt
leiðni	leiðnɪ
lotsveifgras	lɔːtsveivkraːs
tæring	tʰaiːriŋk
olnbogabót	ɔlnpɔːɣapouːt
kvæði	kʰvaiːðɪ
þverhníptur	θvɛrn̥iftʏr
páll	pʰautl
andfélagslegur	antfjɛːlaxslɛːɣʏr
jón	jouːn
skófla	skoupla
nauðsynlegur	nøyðsɪnlɛːɣʏr
þeta	θɛːta
gát	kauːt
guðrún	kvʏðruːn
hertogadæmi	hɛr̥tʰɔːɣataiːmɪ
heiður	heiːðʏr
strengur	streiŋkʏr
streyma	streiːma
hristingur	r̥ɪstiŋkʏr
hvorttveggja	xʷɔr̥ttʰvɛcːa
fullkominn	fʏtl̥kʰɔːmɪnː
þerra	θɛrːa
leif	leiːv
forsjá	fɔr̥sjauː
seyta	seiːta
stafur	staːvʏr
þrældómur	θrailtouːmʏr
möl	mœːl
hermundur	hɛrmʏntʏr
spæla	spaiːla
aðalakkeri	aːðalahkɛːrɪ
foringi	fɔːriɲcɪ
ábyrgð	auːpɪrɣð
f	ɛfː
dökkbrúnn	tœhkprutn
vika	vɪːka
tómstundagaman	tʰoumstʏntakaːman
mjór	mjouːr
flengur	fleiŋkʏr
fúga	fuːa
te	tʰɛː
túvalú	tʰuːvaluː
hjólasæti	çouːlasaiːtɪ
veila	veiːla
eís	ɛːiːs
smári	smauːrɪ
núll	nulː
hnésbót	n̥jɛːspouːt
afmæli	avmaiːlɪ
innganga	ɪnːkauŋka
tigl	tʰɪkl
léttvatn	ljɛhtvahtn
greinarmunur	kreiːnarmʏːnʏr
afbrýði	avpriːðɪ
bruni	prʏːnɪ
stef	stɛːv
hrufla	r̥ʏpla
barrspæta	parːspaiːta
hönk	hœŋ̊k
aðalendir	aːðalɛntɪr
frjókorn	frjouːkʰɔrtn
þorkell	θɔr̥cʰɛtl
mosadýr	mɔːsatiːr
þögn	θœkn
ólmur	oulmʏr
é	jɛː
frank	fraŋ̊k
teikning	tʰeihkniŋk
köllun	kʰœtlʏn
damjan	tamjan
hrísgrjón	r̥iːskrjouːn
hrumur	r̥ʏːmʏr
lögreglustjóri	lœɣrɛklʏstjouːrɪ
hjálpari	çaul̥parɪ
tilgangsfall	tʰɪlkauŋksfatl
les	lɛːs
erfa	ɛrva
endaþarmsop	ɛntaθarmsɔːp
ríkur	riːkʏr
ær	aiːr
björt	pjœr̥t
egyptaland	ɛːcɪftalant
aga	aːɣa
tveir	tʰveiːr
eggjárn	ɛkːjaurtn
lund	lʏnt
hræra	r̥aiːra
mýramaðra	miːramaðra
skemmd	scɛmt
lækjagrýta	laiːcakriːta
unna	ʏnːa
grýta	kriːta
lísa	liːsa
krókódíll	kʰrouːkoutitl
lýja	liːja
fley	fleiː
albanskur	alpanskʏr
rupl	rʏhpl
grunnli	krʏnːlɪ
ofursti	ɔːfʏr̥stɪ
skaf	skaːv
repja	rɛːpja
rafgreining	ravkreiːniŋk
hrísla	r̥istla
kringumstæður	kʰriŋkʏmstaiːðʏr
internet	ɪn̥tɛrnɛːt
gagn	kakn
tæma	tʰaiːma
hilmir	hɪlmɪr
rýtingur	riːtiŋkʏr
minningargripur	mɪnːiŋkarkrɪːpʏr
líta	liːta
barmmerki	parmmɛr̥cɪ
kreditkort	kʰrɛːtɪtkʰɔr̥t
sannarlega	sanːarlɛːɣa
þrái	θrauːɪ
skýrsla	scir̥stla
samúelína	saːmuːɛːliːna
afbrot	avprɔːt
strý	striː
clausen	kʰlauːsɛːnː
blek	plɛːk
tjara	tʰjaːra
lyfjabúð	lɪvjapuːð
fríðleiki	friːðleiːcɪ
tækisfall	taiːkɪsfatl
lífrænn	livraitn
ferðataska	fɛrðatʰaska
enni	ɛnːɪ
trega	tʰrɛːɣa
apa	aːpa
hryggur	r̥ɪkːʏr
nýjabrum	niːjaprʏːm
bygging	pɪcːiŋk
kirsuber	cʰɪr̥sʏpɛːr
sprengja	spreiɲca
fjallasveifgras	fjatlasveivkraːs
skrafa	skraːva
kúptur	kʰuftʏr
tó	tʰouː
ávísun	auːviːsʏn
stigi	stɪiːjɪ
lóða	louːða
mjölnir	mjœlnɪr
valdimaría	valtɪmaːriːja
glæpur	klaiːpʏr
aðalbygging	aːðalpɪcːiŋk
forliður	fɔrlɪːðʏr
brauðhnífur	prøyðn̥iːvʏr
hófskegg	houvscɛkː
bókasafnsfræðingur	pouːkasapnsfraiːðiŋkʏr
páskar	pauskar
edik	ɛːtɪk
redda	rɛtːa
boðflenna	pɔðflɛnːa
vofa	vɔːva
staðarfall	staːðarfatl
hækja	haiːca
kalk	kʰal̥k
fjarki	fjar̥cɪ
nýyrði	niːɪrðɪ
alda	alta
skurfa	skʏrva
claessen	kʰlasːɛn
lóðleit	louðleiːt
droll	trɔtl
eiði	eiːðɪ
geisa	ceiːsa
lágmark	lauɣmar̥k
gjaldþrot	caltθrɔːt
spjalla	spjatla
vistfræði	vɪstfraiːðɪ
hnúskakrækill	n̥uskakʰraiːcɪtl
hátterni	hauhtɛrtnɪ
virði	vɪrðɪ
runólfína	rʏːnoulviːna
jódís	jouːtiːs
þrymskviða	θrɪmskʰvɪːða
gúrkutíð	kur̥kʏtʰiːð
notkun	nɔːtkʏn
samviskusamur	samvɪskʏsaːmʏr
aðstoðarmaður	aðstɔːðarmaːðʏr
broddfura	prɔtːfʏːra
augnablik	øyknaplɪːk
elda	ɛlta
lundúnir	lʏntuːnɪr
kærasti	cʰaiːrastɪ
nota	nɔːta
úran	uːraːn
handaband	hantapant
vigdís	vɪɣtiːs
nitur	nɪːtʏr
knéfiðla	kʰnjɛːfɪðla
krisma	kʰrɪsma
flugdreki	flʏɣtrɛːcɪ
hveðn	xʷɛðn
skeið	sceiːð
árstími	aurstʰiːmɪ
latínuskóli	laːtʰiːnʏskouːlɪ
gullfiskur	kʏtlfɪskʏr
þverra	θvɛrːa
lexía	lɛksiːja
fit	fɪːt
varmi	varmɪ
gljávíðir	kljauːviːðɪr
óafturkræfur	ouːaftʏrkʰraiːvʏr
eftirlaun	ɛftɪrløyːn
léttur	ljɛhtʏr
skúli	skuːlɪ
húðflúr	huðfluːr
fjall	fjatl
alba	alpa
bresta	prɛsta
skaplyndi	skaːplɪntɪ
lónasóley	louːnasouːleiː
aukastafur	øyːkastaːvʏr
kvap	kʰvaːp
naut	nøyːt
snjall	stnjatl
grín	kriːn
einbirni	einpɪrtnɪ
buxnavasi	pʏxsnavaːsɪ
þunnur	θʏnːʏr
a	aː
tyrðill	tʰɪrðɪtl
vigfús	vɪxfuːs
nígería	niːkɛːriːja
kaðlín	kʰaðliːn
astat	astaːt
óákveðinn	ouːauːkʰvɛːðɪnː
veifa	veiːva
sveifla	sveipla
teygjubyssa	tʰeiːjʏpɪsːa
safír	saːfiːr
kerling	cʰɛrtliŋk
hreðka	r̥ɛθka
herra	hɛrːa
olla	ɔlːa
fríspark	friːspar̥k
poppa	pʰɔhpa
tunga	tʰuŋka
temja	tʰɛmja
sog	sɔːɣ
fénaður	fjɛːnaːðʏr
háðung	hauːðuŋk
saxland	saxslant
afturbeyging	aftʏrpeiːjiŋk
kræklingur	kʰraihkliŋkʏr
egna	ɛkna
voff	vɔfː
dáð	tauːð
sál	sauːl
blindur	plɪntʏr
dúkahnífur	tuːkan̥iːvʏr
efnafræði	ɛpnafraiːðɪ
dimma	tɪmːa
hald	halt
dýragarður	tiːrakarðʏr
miðill	mɪːðɪtl
bjarnheiður	pjartnheiːðʏr
nei	neiː
hálsmen	haulsmɛːn
lögreglustöð	lœɣrɛklʏstœːð
kviða	kʰvɪːða
lengjast	leiɲcast
aðaltenging	aːðaltʰeiɲciŋk
tíðaratviksorð	tʰiːðaraːtvɪksɔrð
drýgja	triːja
haltur	hal̥tʏr
arndís	artntiːs
skæni	scaiːnɪ
genf	kɛnf
eik	eiːk
fylja	fɪlja
eiga	eiːɣa
leysir	leiːsɪr
skógarsóley	skouːarsouːleiː
ax	aks
jósefína	jouːsɛːfiːna
hviða	kʰvɪːða
kvikasilfur	kʰvɪːkasɪlvʏr
ella	ɛtla
grákráka	krauːkʰrauːka
prímtala	pʰrimtʰaːla
filma	fɪlma
tryggvína	tʰrɪkviːna
fastur	fastʏr
fjör	fjœːr
mýri	miːrɪ
hjóla	çouːla
baun	pøyːn
tipla	tʰɪhpla
hórus	houːrʏs
bolla	pɔlːa
tap	tʰaːp
tígur	tʰiːɣʏr
króm	kʰrouːm
sáðrás	sauðraus
áhrifaríkur	auːr̥ɪːvariːkʏr
rakki	rahcɪ
varla	vartla
afsláttur	afstlauhtʏr
ofn	ɔpn
fólk	foul̥k
óvinátta	ouːvɪːnauhta
lífdagar	livtaːɣar
aukafall	øyːkafatl
fúi	fuːɪ
tilvísunarfornafn	tʰɪlviːsʏːnarfɔrnapn
eignarfall	eiknarfatl
flæmska	flaimska
vélbúnaður	vjɛlpuːnaːðʏr
sköddun	skœtːʏn
valmynd	valmɪnt
hver	kʰvœːr
næpa	naiːpa
reikistjarna	reiːcɪstjartna
útlit	uːtlɪːt
serbneskur	sɛrpnɛskʏr
hindrun	hɪntrʏn
hita	hɪːta
tíðahvörf	tʰiːðaxʷœrv
níð	niːð
básúna	pauːsuːna
sútari	suːtarɪ
túpa	tʰuːpa
maltur	mal̥tʏr
lasna	lastna
fjallakobbi	fjatlakʰɔpːɪ
rymja	rɪmja
heild	heilt
kóreska	kʰouːrɛska
verndun	vɛrntʏn
gustur	kʏstʏr
útdauði	uːttøyːðɪ
alli	atlɪ
hóra	houːra
spað	spaːð
útskýra	uːtsciːra
hnakkur	n̥ahkʏr
funi	fʏːnɪ
bolur	pɔːlʏr
dómur	touːmʏr
félagshyggja	fjɛːlaxshɪcːa
apótekari	aːpouːtʰɛːkaːrɪ
festa	fɛsta
nútími	nuːtʰiːmɪ
nútíð	nuːtʰiːð
fylgjari	fɪlcarɪ
karlfauskur	kʰartlføyskʏr
svindla	svɪntla
aldrei	altreiː
botna	pɔhtna
greypa	kreiːpa
leyni	leiːnɪ
athuga	aːthʏːɣa
sifjarsóley	sɪvjarsouːleiː
kveðskapur	kʰvɛðskaːpʏr
borða	pɔrða
regnhlíf	rɛknl̥iːv
broddur	prɔtːʏr
ótti	ouhtɪ
tárakirtill	tʰauːrakʰɪr̥tɪtl
hneykja	n̥eiːca
töfra	tʰœvra
brokk	prɔhk
hraun	r̥øyːn
gjarn	cartn
tiltaka	tʰɪːltʰaːka
bóka	pouːka
halldór	haltouːr
korn	kʰɔrtn
lífvera	livvɛːra
torveldi	tʰɔrvɛltɪ
brundur	prʏntʏr
fitna	fɪhtna
aldinbori	altɪnpɔːrɪ
tilviljun	tʰɪlvɪljʏn
eistland	eistlant
blýglans	pliːklans
svartsýnn	svar̥tsitn
einveldi	einvɛltɪ
gráelri	krauːɛlrɪ
kyrrlæti	cʰɪrlaiːtɪ
reður	rɛːðʏr
rassvasi	rasːvaːsɪ
laus	løyːs
ógnarúlfur	ouknarulvʏr
ostsneið	ɔststneiːð
létta	ljɛhta
þorláksmessa	θɔrlauksmɛsːa
steik	steiːk
rannur	ranːʏr
grikkland	krɪhklant
bryðja	prɪðja
veiðimaður	veiːðɪmaːðʏr
tvistur	tʰvɪstʏr
tangi	tʰauɲcɪ
söguríkur	sœːɣʏriːkʏr
fanga	fauŋka
slokkna	stlɔhkna
sigfús	sɪxfuːs
vax	vaks
sykurmoli	sɪːkʏrmɔːlɪ
eyjafjallajökull	eiːjafjatlajœːkʏtl
dalmatía	talmatʰiːja
frónsk	frounsk
tjaldur	tʰjaltʏr
fabúla	faːpuːla
flúr	fluːr
hvæsa	kʰvaiːsa
milli	mɪlːɪ
ydda	ɪtːa
forði	fɔrðɪ
hlaði	l̥aːðɪ
þverflauta	θvɛr̥fløyːta
fótboltafélag	fouːtpɔl̥tafjɛːlaːɣ
hákarl	hauːkartl
grind	krɪnt
líking	liːciŋk
bygg	pɪkː
rúðuborg	ruːðʏpɔrk
skelmir	scɛlmɪr
angi	auɲcɪ
hræða	r̥aiːða
hildimundur	hɪltɪmʏntʏr
leiðindi	leiːðɪntɪ
dofna	tɔpna
marr	marː
júði	juːðɪ
buxnavasi	pʏksnavaːsɪ
leikvöllur	leiːkvœtlʏr
snark	stnar̥k
orsök	ɔr̥sœːk
gigt	cɪxt
ferhyrningur	fɛrhɪrtniŋkʏr
móðurbróðir	mouːðʏrprouːðɪr
matareitrun	maːtaːreiːtrʏn
þrenningarmaðra	θrɛnːiŋkarmaðra
retta	rɛhta
móttaka	mouːttʰaːka
vestari	vɛstaːrɪ
mismunur	mɪsmʏːnʏr
bjarki	pjar̥cɪ
saur	søyːr
búnaður	puːnaːðʏr
prinsipissa	pʰrɪnsɪpʰɪsːa
barnæska	partnaiska
höfðingi	hœvðiɲcɪ
miskunna	mɪskʏnːa
ljóstillífun	ljouːstɪlliːvʏn
miðvikudagur	mɪðvɪːkʰʏtaːɣʏr
krækja	kʰraiːca
prúðmennska	pʰruðmɛnska
ekki	ɪcːɪ
sæmundur	saiːmʏntʏr
jónheiður	jouːnheiːðʏr
kóríander	kʰouːriːjantɛːr
list	lɪst
gjósa	couːsa
sproti	sprɔːtɪ
treyja	tʰreiːja
sullur	sʏtlʏr
kenna	cʰɛnːa
eggertína	ɛcːɛr̥tiːna
hlíta	l̥iːta
hafur	haːvʏr
skorpa	skɔr̥pa
slys	stlɪːs
veður	vɛːðʏr
borðtölva	pɔrðtʰœlva
bóknám	pouːknauːm
hani	haːnɪ
rúsína	ruːsiːna
skína	sciːna
kæti	cʰaiːtɪ
snar	stnaːr
brasilía	praːsɪliːja
bogi	pɔːjɪ
skyssa	scɪsːa
loki	lɔːcɪ
beinn	peitn
djúpur	tjuːpʏr
gambri	kamprɪ
tíu	tiːʏ
klæindi	kʰlaiːjɪntɪ
dæmi	taiːmɪ
móðurborð	mouːðʏrpɔrð
leiðsögn	leiðsœkn
uppi	ʏhpɪ
svefnpoki	svɛpnpʰɔːcɪ
bretónska	prɛːtʰounska
bjálki	pjaul̥kɪ
sjór	sjouːr
valmúi	valmuːɪ
gikkur	cɪhkʏr
vallhæra	vatlhaiːra
hörn	hœrtn
akur	aːkʰʏr
eingetinn	eincɛːtɪn
narta	nar̥ta
umtalsverður	ʏmtʰalsvɛrðʏr
vanræksla	vanraikstla
hebreska	hɛːprɛska
krikket	kʰrɪhcɛt
erta	ɛr̥ta
lífhimna	livhɪmna
kambur	kʰampʏr
dugur	tʏːɣʏr
líkamlegur	liːkʰamlɛːɣʏr
spjald	spjalt
leifa	leiːva
sólon	souːlɔn
leysingi	leiːsiɲcɪ
hes	hɛːs
sáðfruma	sauðfrʏːma
gráðostur	krauːðɔstʏr
rím	riːm
sekkur	sɛhkʏr
biðminni	pɪðmɪnːɪ
indverskur	ɪntvɛr̥skʏr
gaman	kaːmaːn
hryðja	r̥ɪðja
klífa	kʰliːva
snökta	snœxta
niður	nɪːðʏr
ólund	ouːlʏnt
barkakýli	par̥kacʰiːlɪ
skuggi	skʏcːɪ
serbókróatíska	sɛrpoukʰrouːatʰiska
tölvupóstur	tʰœlvʏpʰoustʏr
sköp	skœːp
tón	tʰouːn
kóngshrókur	kouŋksr̥ouːkʏr
finnska	fɪnska
sýnn	sitn
upphaf	ʏhphaːv
partur	pʰar̥tʏr
kengur	cʰeiŋkʏr
stell	stɛtl
smásaga	smauːsaːɣa
hanski	hanscɪ
þybbinn	θɪpːɪnː
slátra	stlauːtra
biti	pɪːtɪ
tælenska	tʰaiːlɛnska
þátíð	θauːtʰiːð
stefanía	stɛːfaːniːja
þakka	θahka
fyðill	fɪːðɪtl
aukning	øyhkniŋk
lygna	lɪkna
fínn	fitn
ekkja	ɛhca
hraukur	r̥øyːkʏr
dollari	tɔlːarɪ
fyrirsæta	fɪːrɪrsaiːta
kornblóm	kʰɔrtnplouːm
skera	scɛːra
lykja	lɪːca
minni	mɪnːɪ
alheimur	aːlheiːmʏr
hvika	kʰvɪːka
grýlukerti	kriːlʏcʰɛr̥tɪ
þyrstur	θɪr̥stʏr
láland	lauːlant
heimasími	heiːmasiːmɪ
ísakína	iːsaːkiːna
dreggjar	trɛcːar
hófsóley	houvsouːleiː
grikkur	krɪhkʏr
bókasafn	pouːkasapn
bót	pouːt
viftureim	vɪftʏreiːm
rannsóknarstofa	ranːsouhknarstɔːva
ríkisborgararéttur	riːcɪspɔrkararjɛhtʏr
hegning	hɛkniŋk
milli	mɪtlɪ
uxi	ʏksɪ
kampavín	kʰam̥paviːn
hnefi	n̥ɛːvɪ
hálfleikur	haulvleiːkʏr
atkvæði	aːtkʰvaiːðɪ
lemja	lɛmja
fjara	fjaːra
kennslubók	cʰɛnstlʏpouːk
hindartré	hɪntartrjɛː
bogna	pɔkna
smalamaður	smaːlamaːðʏr
vökva	vœːkva
gnoð	knɔːð
eplamús	ɛhplamuːs
leiðrétting	leiðrjɛhtiŋk
hlykkur	l̥ɪhkʏr
baldur	paltʏr
pistasía	pʰɪstasiːja
járningamaður	jaurtniŋkamaːðʏr
hjaltalín	çal̥taliːn
páfi	pʰauːvɪ
frægð	fraiɣð
heppni	hɛhpnɪ
höfuðsmaður	hœːvʏðsmaːðʏr
óvarkár	ouːvar̥kʰaur
herramaður	hɛrːamaːðʏr
forrit	fɔrrɪːt
járna	jaurtna
borgarstjóri	pɔrkarstjouːrɪ
sjóður	sjouːðʏr
gæs	caiːs
sandali	santalɪ
fallvatn	fatlvahtn
skræfa	skraiːva
mauraþúfa	møyːraθuːva
föðurlandsvinur	fœːðʏrlansvɪːnʏr
óendanleiki	ouːɛntanleiːcɪ
fell	fɛtl
haukur	høyːkʏr
ólöf	ouːlœːv
sagnbót	saknpouːt
gotland	kɔːtlant
milljón	mɪljouːn
lyfta	lɪfta
hluti	l̥ʏːtɪ
undrun	ʏntrʏn
tönn	tʰœnː
spúa	spuːa
blotna	plɔhtna
ólafína	ouːlaːviːna
hvítmaðra	kʰviːtmaðra
sameind	saːmeint
kynkirtill	cʰɪːncʰɪr̥tɪtl
hjaðna	çaðna
mosasteinbrjótur	mɔːsasteinprjouːtʏr
silkibygg	sɪl̥cɪpɪkː
rök	rœːk
olsen	oulsɛnː
kufl	kʰʏpl
hljómsveit	l̥joumsveiːt
fælast	faiːlast
gjóta	couːta
ríkja	riːca
toddi	tʰɔtːɪ
jarðlag	jarðlaːɣ
okfruma	ɔːkfrʏːma
klunni	kʰlʏnːɪ
litur	lɪːtʏr
kar	kʰaːr
gráblika	krauplɪːka
sigg	sɪkː
dunkur	tuŋ̊kʏr
fylgd	fɪlt
djass	tjasː
fluga	flʏːɣa
té	tʰjɛː
spítta	spihta
renta	rɛn̥ta
fjarstýra	fjar̥stiːra
fjallgarður	fjatlkarðʏr
tvenna	tʰvɛnːa
ótt	ouht
sesín	sɛːsiːn
kurteisi	kʰʏr̥teiːsɪ
mánajurt	mauːnajʏr̥t
merking	mɛr̥ciŋk
kaupandi	kʰøyːpantɪ
kyrrð	cʰɪrð
metfé	mɛːtfjɛː
ásjálegur	auːsjauːlɛːɣʏr
naga	naːɣa
kjartan	cʰar̥tan
gæta	caiːta
portúgali	pʰɔr̥tukaːlɪ
siglutoppur	sɪklʏtʰɔhpʏr
laska	laska
bjartur	pjar̥tʏr
axhæra	axshaiːra
sannindi	sanːɪntɪ
klára	kʰlauːra
loftárás	lɔftauːrauːs
sandbylur	santpɪːlʏr
óra	ouːra
beitukóngur	peiːtʏkʰouŋkʏr
leit	leiːt
mildur	mɪltʏr
aðdáandi	aðtauːantɪ
meinsæri	meinsaiːrɪ
und	ʏnt
búðingur	puːðiŋkʏr
blaðamaður	plaːðamaːðʏr
rosti	rɔstɪ
sag	saːɣ
blágrænn	plauːkraitn
bananahýði	paːnanahiːðɪ
hjaltested	çal̥tɛːstɛːð
sokkur	sɔhkʏr
fés	fjɛːs
flaggdúkur	flakːtuːkʏr
hjálmur	çaulmʏr
eldsvoði	ɛltsvɔːðɪ
ánægja	auːnaiːja
íferðarfall	iːfɛrðarfatl
kumbaraland	kʰʏmpaːralant
trygging	tʰrɪcːiŋk
farangur	faːrauŋkʏr
hrísgrjónavín	r̥iːskrjouːnaviːn
gylla	cɪtla
ómur	ouːmʏr
orkídea	ɔr̥ciːtɛːa
goggi	kɔcːɪ
fátækur	fauːtʰaiːkʏr
krista	kʰrɪsta
garðrækt	karðraixt
tefla	tʰɛpla
jarða	jarða
cís	siːs
ruðningur	rʏðniŋkʏr
leppalúði	lɛhpaluːðɪ
pylsa	pʰɪlsa
jólaköttur	jouːlakʰœhtʏr
salka	sal̥ka
skeyti	sceiːtɪ
rafeindasmásjá	raːveintasmauːsjauː
petrína	pɛːtriːna
hroki	r̥ɔːcɪ
kísill	cʰiːsɪtl
skjall	scatl
hnoðri	n̥ɔðrɪ
tryggvi	tʰrɪkvɪ
kalla	kʰatla
makedónía	maːkʰɛːtouːniːja
lófi	louːɪ
larfur	larvʏr
handrið	hantrɪːð
plóma	pʰlouːma
seytla	seihtla
loftpúði	lɔftpʰuːðɪ
hrygla	r̥ɪkla
kvars	kʰvar̥s
ás	auːs
karbónat	kʰarpouːnaːt
bull	pʏtl
ómblíður	oumpliːðʏr
hjól	çouːl
jaki	jaːcɪ
náhvalur	nauːkʰvaːlʏr
hjalti	çal̥tɪ
hás	hauːs
dirfska	tɪrvska
gervitunglamynd	cɛrvɪtʰuŋlamɪnt
lífsandi	lifsantɪ
raddblær	ratːplaiːr
tabú	tʰaːpuː
krossgáta	kʰrɔsːkauːta
náttmál	nauhtmauːl
keipa	cʰeiːpa
möller	mœlːɛr
hrelling	r̥ɛtliŋk
morgunfrú	mɔrkʏnfruː
kopar	kʰɔːpar
bakkus	pahkʏs
bræla	praiːla
skýring	sciːriŋk
lífsmark	lifsmar̥k
saltkjöt	sal̥tcʰœːt
trúfélag	tʰruːfjɛːlaːɣ
stynja	stɪnja
vodka	vɔtkʰa
tossi	tʰɔsːɪ
geislaspilari	ceistlaspɪːlaːrɪ
hetta	hɛhta
spendýr	spɛntiːr
anúbis	aːnuːpɪs
fjöllaufungur	fjœlløyːvuŋkʏr
serbi	sɛrpɪ
asni	astnɪ
einingarfylki	eiːniŋkarfɪl̥cɪ
silki	sɪl̥cɪ
kyndugur	cʰɪntʏːɣʏr
blásveifgras	plauːsveivkraːs
lítill	liːtɪtl
sterkur	stɛr̥kʏr
ósannur	ouːsanːʏr
helta	hɛl̥ta
fangaklefi	fauŋkakʰlɛːvɪ
hámundur	hauːmʏntʏr
kaupunautur	kʰøyːpʏnøyːtʏr
krýna	kʰriːna
friggjarlykill	frɪcːarlɪːcɪtl
steikja	steiːca
dýjamosi	tiːjamɔːsɪ
forritunarmál	fɔrːɪːtʏnarmauːl
körfuknattleiksþjálfari	kʰœrvʏkʰnahtleiksθjaulvarɪ
þarna	θatna
aðall	aːðatl
hvalkjöt	xʷalcʰœːt
töframaður	tʰœvramaːðʏr
mosaburkni	mɔːsapʏr̥knɪ
ýsa	iːsa
fall	fatl
metta	mɛhta
barð	parð
víðir	viːðɪr
klafi	kʰlaːvɪ
járna	jautna
grasasni	kraːsastnɪ
þjöl	θjœːl
kýli	cʰiːlɪ
myndband	mɪntpant
drjúpa	trjuːpa
hjarðmaður	çarðmaːðʏr
err	ɛrː
hæsi	haiːsɪ
nautgripur	nøyːtkrɪːpʏr
rökkur	rœhkʏr
breyta	preiːta
rógur	rouːʏr
kála	kʰauːla
skíðaþjálfari	sciːðaθjaulvaːrɪ
fótboltaþjálfari	fouːtpɔl̥taθjaulvaːrɪ
ástþrúður	austθruːðʏr
mæla	maiːla
stilling	stɪtliŋk
kvos	kʰvɔːs
páka	pʰauːka
skurðgrafa	skʏrðkraːva
flaka	flaːka
hjördís	çœrtiːs
vangi	vauɲcɪ
vist	vɪst
kontrapunktur	kʰɔn̥trapʰʏn̥ktʏr
eitrun	eiːtrʏn
bugða	pʏɣða
króati	kʰrouːaːtɪ
skynugur	scɪːnʏːɣʏr
angan	auŋkan
kastari	kʰastaːrɪ
rafhlaða	ravl̥aːða
ægir	aiːjɪr
freyja	freiːja
una	ʏːna
bæta	paiːta
frýgískur	friːciskʏr
hugsjónamaður	hʏxsjouːnamaːðʏr
heiðni	heiðnɪ
erkiengill	ɛr̥cɪeiɲcɪtl
teista	tʰeista
brúðgumi	pruðkʏːmɪ
kóraltoppur	kʰouːraltʰɔhpʏr
tákn	tʰauhkn
skírteini	scir̥teiːnɪ
henda	hɛnta
síróp	siːrouːp
hvítabjörn	xʷiːtapjœrtn
sykurrófa	sɪːkʏrrouːva
kanarífugl	kʰaːnariːfʏkl
klútur	kʰluːtʏr
sætur	saiːtʏr
ríkisráð	riːcɪsrauːð
hjálparsagnorð	çaul̥parsaknɔrð
gervill	cɛrvɪtl
blóðmör	plouðmœːr
spegla	speikla
páskavika	pʰauskavɪːka
þvengur	θveiŋkʏr
hlýna	l̥iːna
greifingi	kreiːviɲcɪ
sviti	svɪːtɪ
bæli	paiːlɪ
lestun	lɛstʏn
blússa	plusːa
barþjónn	parθjoutn
mínúta	miːnuːta
orka	ɔr̥ka
sveif	sveiːv
fæða	faiːða
sláttur	stlauhtʏr
afkáralegur	avkʰauːralɛːɣʏr
hörpudiskur	hœr̥pʏtɪskʏr
skylda	scɪlta
búlgaría	pulkariːja
auðmjúkur	øyðmjuːkʏr
tækifæri	taiːcɪfaiːrɪ
augnfró	øyknfrouː
tilfinninganæmur	tʰɪlfɪnːiŋkanaiːmʏr
mór	mouːr
lappi	lahpɪ
tryggð	tʰrɪɣð
kjói	cʰouːɪ
leið	leiːð
hlutgrúpa	l̥ʏːtkruːpa
mörður	mœrðʏr
kukl	kʰʏhkl
nýnorska	niːnɔr̥ska
tröllavíðir	tʰrœtlaviːðɪr
ergja	ɛrca
dóri	touːrɪ
tappi	tʰahpɪ
kjaga	cʰaːɣa
fleygja	fleiːja
stjörnuarfi	stjœrtnʏarvɪ
kekkur	cʰɛhkʏr
hávaðamaður	hauːvaːðamaːðʏr
skel	scɛːl
stórfenglegur	stour̥feiŋklɛːɣʏr
hornspyrna	hɔrtnspɪrtna
geir	keiːr
heimferð	heimfɛrð
ostagerð	ɔstacɛrð
leví	lɛːviː
gifta	cɪfta
sigurðsson	sɪːɣʏrðssɔːn
algjörlega	alcœrlɛːɣa
beltisdýr	pɛl̥tɪstiːr
suðurljós	sʏːðʏrljouːs
eiginkona	eiːjɪnkʰɔːna
fimur	fɪːmʏr
kokka	kʰɔhka
dá	tauː
dyngja	tiɲca
þagna	θakna
ásta	austa
elri	ɛlrɪ
háfur	hauːvʏr
gæluverkefni	caiːlʏvɛr̥kɛpnɪ
snuð	stnʏːð
vafri	vavrɪ
bjarndís	pjartntiːs
pönkari	pʰøyŋ̊kaːrɪ
gullintoppa	kʏtlɪntʰɔhpa
eðlilegur	ɛðlɪlɛːɣʏr
lauftré	løyvtrjɛː
hræll	r̥aitl
vana	vaːna
frænka	frainka
fellafífill	fɛtlafiːvɪtl
vanilla	vaːnɪlːa
einlægni	einlaiknɪ
kveif	kʰveiːv
herpingur	hɛr̥piŋkʏr
línuskauti	liːnʏskøyːtɪ
kökuhnífur	kʰœːkʏn̥iːvʏr
dvergtré	tvɛrktrjɛː
baul	pøyːl
límóna	liːmouːna
bjúga	pjuːa
júdit	juːtɪːt
ostahnífur	ɔstan̥iːvʏr
kyrja	cʰɪrja
súra	suːra
þrír	θriːr
grænlenska	krainlɛnska
strumpur	strʏm̥pʏr
fjarski	fjar̥scɪ
pennahnífur	pʰɛnːan̥iːvʏr
bið	pɪːð
kjalta	cʰal̥ta
verða	vɛrða
ax	axs
hakk	hahk
morgunhani	mɔrkʏnhaːnɪ
borðstofa	pɔrðstɔːva
bók	pouːk
smíð	smiːð
skaði	skaːðɪ
hrista	r̥ɪsta
hrjúfra	r̥juvra
tilgangur	tʰɪlkauŋkʏr
far	faːr
sannfæra	sanːfaiːra
hreinlæti	r̥einlaiːtɪ
væla	vaiːla
laufblað	løyvplaːð
prússneskur	pʰrusːtnɛskʏr
skriðsund	skrɪðsʏnt
vein	veiːn
mark	mar̥k
stýfa	stiːva
kunna	kʰʏnːa
varnaður	vartnaːðʏr
hávær	hauːvaiːr
grund	krʏnt
raggeit	raɣceiːt
dufl	tʏpl
árós	auːrouːs
blanda	planta
sina	sɪːna
talmynd	tʰalmɪnt
járnöld	jaurtnœlt
skoskur	skɔskʏr
sleikur	stleiːkʏr
heilalaus	heiːlaløyːs
hvorttveggja	kʰvɔr̥ttʰvɛcːa
guðlast	kvʏðlast
munu	mʏːnʏ
skinka	sciŋ̊ka
laun	løyːn
söngkona	søyŋkkʰɔːna
örgjörvi	œrcœrvɪ
finni	fɪnːɪ
át	auːt
tyggja	tʰɪcːa
frat	fraːt
x	xs
sporður	spɔrðʏr
eyjólfína	eiːjoulviːna
regla	rɛkla
litunarjafni	lɪːtʏnarjapnɪ
d	tjɛː
klof	kʰlɔːv
golf	kɔlv
hótfyndni	houːtfɪntnɪ
renín	rɛːniːn
mismikill	mɪːsmɪːcɪtl
kiljan	cʰɪljan
hunangsfluga	hʏːnauŋksflʏːɣa
endi	ɛntɪ
brugghús	prʏkːhuːs
búðarborð	puːðarpɔrð
augnlæknir	øyknlaihknɪr
lotning	lɔhtniŋk
höfðaborg	hœvðapɔrk
flón	flouːn
germynd	cɛrmɪnt
ögn	œkn
aldin	altɪn
hollur	hɔtlʏr
fylgi	fɪlcɪ
káka	kʰauːka
nit	nɪːt
stát	stauːt
skeri	scɛːrɪ
námsbraut	naumsprøyːt
innkaup	ɪnːkʰøyːp
vinna	vɪnːa
bylgja	pɪlca
frú	fruː
ísópren	iːsouːpʰrɛːn
hof	hɔːv
bleia	pleiːja
skór	skouːr
helgarferð	hɛlkarfɛrð
reiður	reiːðʏr
héðinn	çɛːðɪnː
halla	hatla
eftirminnilegur	ɛftɪrmɪnːɪlɛːɣʏr
forn	fɔrtn
bandaríkin	pantariːcɪn
kortér	kʰɔr̥tjɛr
rúmenía	ruːmɛːniːja
blinda	plɪnta
talsmaður	tʰalsmaːðʏr
örlítill	œrliːtɪtl
þíður	θiːðʏr
farsi	far̥sɪ
patína	pʰaːtʰiːna
búa	puːa
skipasmíði	scɪːpasmiːðɪ
ásþrúður	auːsθruːðʏr
aldur	altʏr
reglugerð	rɛklʏcɛrð
lán	lauːn
dansa	tansa
jafn	japn
fjas	fjaːs
leiðbeining	leiðpeiːniŋk
píanó	pʰiːjaːnouː
fjallhæra	fjatlhaiːra
vonbrigði	vɔnprɪɣðɪ
glópur	klouːpʏr
kantmaður	kʰan̥tmaːðʏr
hlífa	l̥iːva
feitur	feiːtʏr
maríutása	maːriːjʏtʰauːsa
holtsetaland	hɔl̥tsɛːtalant
hallgrímína	hatlkriːmiːna
rán	rauːn
nálgunarbann	naulkʏnarpanː
kvittun	kʰvɪhtʏn
ökutæki	œːkʏtʰaiːcɪ
skapvondur	skaːpvɔntʏr
skýla	sciːla
lauslæti	løyːslaiːtɪ
þrennur	θrɛnːʏr
aðallega	aːðallɛːɣa
kækur	cʰaiːkʏr
voga	vɔːɣa
renna	rɛnːa
fýla	fiːla
sylgja	sɪlca
lukka	lʏhka
hlýr	l̥iːr
hugleysingi	hʏɣleiːsiɲcɪ
garður	karðʏr
unndór	ʏntouːr
töng	tʰøyŋk
munstur	mʏnstʏr
iðnaður	ɪðnaːðʏr
dvali	tvaːlɪ
þing	θiŋk
trésmíði	tʰrjɛːsmiːðɪ
skjóla	scouːla
framhaldsskóli	framhalsskouːlɪ
hvíla	kʰviːla
hvað	xʷaːð
rugl	rʏkl
taut	tʰøyːt
ratleikur	raːtleiːkʏr
skarfakál	skarvakʰauːl
elding	ɛltiŋk
koma	kʰɔːma
skolli	skɔtlɪ
baks	paks
bavían	paːviːan
peyi	pʰeiːjɪ
klekja	kʰlɛːca
danalög	taːnalœːɣ
geimferð	ceimfɛrð
kolsýra	kʰɔlsiːra
orsaka	ɔr̥saːka
málband	maulpant
hrúga	r̥uːa
pungur	pʰuŋkʏr
rann	ranː
augabrún	øyːɣapruːn
hviklyndur	kʰvɪːklɪntʏr
sæfífill	saiːfiːvɪtl
veiða	veiːða
fjallaþinur	fjatlaθɪːnʏr
hryggbrjóta	r̥ɪkːprjouːta
sigurður	sɪːɣʏrðʏr
dé	tjɛː
sunnan	sʏnːan
brottfall	prɔhtfatl
rúmenska	ruːmɛnska
gnægð	knaiɣð
baksa	paksa
ísland	istlant
prjón	pʰrjouːn
hlægja	l̥aiːja
bergmundur	pɛrkmʏntʏr
útskýring	uːtsciːriŋk
borðhnífur	pɔrðn̥iːvʏr
tregða	tʰrɛɣða
rölt	rœl̥t
gubba	kʏpːa
gjall	catl
farsími	far̥siːmɪ
aðaltré	aːðaltʰrjɛː
svartur	svar̥tʏr
blóðbað	plouðpaːð
skaka	skaːka
grimmd	krɪmt
bland	plant
bylgjulengd	pɪlcʏleiŋkt
depra	tɛːpra
gustuk	kʏstʏk
hjólabretti	çouːlaprɛhtɪ
hrekkjalómur	r̥ɛhcalouːmʏr
minnkun	miŋ̊kʏn
kynning	cʰɪnːiŋk
áhöfn	auːhœpn
ljá	ljauː
stétt	stjɛht
aðgerðaáætlun	aðcɛrðaːuaitlʏn
iðn	ɪðn
færi	faiːrɪ
húðsjúkdómafræðingur	huːðsjuktouːmafraiːðiŋkʏr
trúlegur	truːlɛːɣʏr
keppinautur	cʰɛhpɪnøyːtʏr
ryk	rɪːk
leigja	leiːja
hagskælingur	haxscailiŋkʏr
járn	jautn
fella	fɛtla
maríustakkur	maːriːjʏstahkʏr
lugt	lʏxt
setja	sɛːta
hugmynd	hʏɣmɪnt
leysibóla	leiːsɪpouːla
jónasína	jouːnaːsiːna
legbólga	lɛɣpoulka
alkul	alkʰʏːl
misræmi	mɪːsraiːmɪ
líkn	lihkn
kasta	kʰasta
hann	anː
gálaus	kauːløyːs
votur	vɔːtʏr
grípari	kriːpaːrɪ
fóðrun	fouðrʏn
danmörk	tanmœr̥k
svanur	svaːnʏr
kvartil	kʰvar̥tɪl
handsprengja	hantspreiɲca
marteinn	mar̥teitn
mjólkurmatur	mjoul̥kʏrmaːtʏr
taugafræði	tʰøyːɣafraiːðɪ
kveikjari	kʰveiːcarɪ
bútur	puːtʏr
öryggisbelti	œːrɪcːɪspɛl̥tɪ
svikari	svɪːkaːrɪ
hjartastillir	çar̥tastɪtlɪr
sekur	sɛːkʏr
hækka	haihka
sýrland	sirlant
ediksýra	ɛːtɪksiːra
bæjarstjóri	paiːjarstjouːrɪ
umferð	ʏmfɛrð
fylgirit	fɪlcɪrɪːt
gangráður	kauŋkrauːðʏr
klappa	klahpa
ölur	œːlʏr
kynkvísl	cʰɪːnkʰvistl
helgisiður	hɛlcɪsɪːðʏr
þjóðbraut	θjouðprøyːt
svampur	svam̥pʏr
bræða	praiːða
hedd	hɛtː
loðinn	lɔːðɪnː
gleðilegur	klɛːðɪlɛːɣʏr
froskdýr	frɔsktiːr
handahóf	hantahouːv
prakt	pʰraxt
undirlag	ʏntɪrlaːɣ
slakur	stlaːkʏr
dósent	touːsɛnt
sendiherra	sɛntɪhɛrːa
klökkur	kʰlœhkʏr
rotta	rɔhta
argur	arkʏr
háls	hauls
einhver	ein̥kvɛːr
þrímynd	θriːmɪnt
duga	tʏːɣa
runni	rʏnːɪ
púla	pʰuːla
krefja	kʰrɛvja
koddi	kʰɔtːɪ
rata	raːta
fagottleikari	faːkɔhtleiːkaːrɪ
ísbjörn	iːspjœrtn
heita	heiːta
kvað	kʰvaːð
ryksuga	rɪksʏːɣa
víma	viːma
auðmýkt	øyðmixt
streð	strɛːð
skissa	scɪsːa
talenta	tʰalɛn̥ta
mær	maiːr
sýnishorn	siːnɪshɔtn
gætt	kaɪht
haddur	hatːʏr
grafa	kraːva
hæð	haiːð
amper	am̥pɛːr
hulduefni	hʏltʏɛpnɪ
stór	stouːr
rampur	ram̥pʏr
fullkomlega	fʏtl̥kʰɔmlɛːɣa
vikur	vɪːkʏr
stjórnmálamaður	stjourtnmauːlamaːðʏr
persónufornafn	pʰɛr̥souːnʏfɔrnapn
spjót	spjouːt
valkostur	valkʰɔstʏr
prentari	pʰrɛn̥tarɪ
eining	eiːniŋk
grenja	krɛnja
klausa	kʰløyːsa
klaufi	kʰløyːvɪ
kommúnismi	kʰɔmːuːnɪsmɪ
durgslegur	tʏrkslɛːɣʏr
keifa	cʰeiːva
róteind	rouːteint
loðvíðir	lɔðviːðɪr
kuti	kʰʏːtɪ
gé	cɛː
mætur	maiːtʏr
stjarneðlisfræði	stjartnɛðlɪsfraiːðɪ
panda	pʰanta
stó	stouː
efla	ɛpla
einræða	einraiːða
böggull	pœkːʏtl
póstur	pʰoustʏr
lífstykki	lifstɪhcɪ
mosavaxinn	mɔːsavaxsɪnː
malurt	maːlʏr̥t
jóðla	jouðla
kragi	kʰraːjɪ
ull	ʏlː
tékkland	tjɛhklant
bosnía	pɔstniːja
lotugræðgi	lɔːtʏkraiðcɪ
afturkræfur	aftʏrkʰraiːvʏr
bringubein	priŋkʏpeiːn
björgmundur	pjœrkmʏntʏr
gís	ciːs
fordæmi	fɔrtaiːmɪ
kvein	kʰveiːn
höstugur	hœstʏːɣʏr
sirkus	sɪr̥kʏs
kornhæna	kʰɔrtnhaiːna
körfuboltaþjálfari	kʰœrvʏpɔl̥taθjaulvarɪ
nauðgari	nøyðkaːrɪ
hryssingslegur	r̥ɪsːiŋkslɛːɣʏr
torg	tʰɔrk
þarfur	θarvʏr
naðra	naðra
hlaða	l̥aːða
greiðsla	kreiðstla
nælon	naiːlɔːn
myrða	mɪrða
hvala	kʰvaːla
jónmundur	jounmʏntʏr
hneisa	n̥eiːsa
púði	pʰuːðɪ
ljósmynd	ljouːsmɪnt
nýyrðasmíð	niːɪrðasmiːð
ísrael	iːsraːɛːl
hverfi	xʷɛrvɪ
danska	tanska
blístra	plistra
nudd	nʏtː
grunnsævi	krʏnːsaiːvɪ
broddmjólk	prɔtːmjoul̥k
megn	mɛkn
plága	pʰlauːa
þekkja	θɛhca
vafsúra	vavsuːra
jafnt	jam̥t
dýrgripur	tirkrɪːpʏr
granni	kranːɪ
dúx	tuxs
ull	ʏtl
vefur	vɛːvʏr
mólendi	mouːlɛntɪ
uxi	ʏxsɪ
hækkun	haihkʏn
bragfræði	praxfraiːðɪ
spá	spauː
maðkur	maθkʏr
minna	mɪnːa
beð	pɛːð
smána	smauːna
traustur	tʰrøystʏr
fjalldrapi	fjatltraːpɪ
gremja	krɛmja
bylgjufall	pɪlcʏfatl
leka	lɛːka
kæna	cʰaiːna
lipurð	lɪːpʏrð
dingl	tiŋl
poka	pʰɔːka
pólskur	pʰoulskʏr
aðalhending	aːðalhɛntiŋk
undirbúa	ʏntɪrpuːa
þengill	θeiɲcɪtl
fengur	feiŋkʏr
músvákur	muːsvauːkʏr
broddgöltur	prɔtːkœl̥tʏr
guðjónína	kvʏðjouːniːna
berg	pɛrk
hrygna	r̥ɪkna
grobba	krɔpːa
skola	skɔːla
rabb	rapː
toppur	tʰɔhpʏr
fræðsla	fraiðstla
greinargerð	kreiːnarcɛrð
fífa	fiːva
hvað	kʰvaːð
arameíska	aːramɛːiska
brengla	preiŋla
skáldsaga	skaultsaːɣa
gerður	cɛrðʏr
kári	kʰauːrɪ
pyttur	pʰɪhtʏr
kjölur	cʰœːlʏr
hálfnótuþögn	haulvnouːtʏθœkn
indónesía	ɪntouːnɛːsiːja
turn	tʰʏrtn
klettaburkni	kʰlɛhtapʏr̥knɪ
fela	fɛːla
massi	masːɪ
smánykra	smauːnɪːkra
herbergi	hɛrpɛrcɪ
rotinn	rɔːtɪnː
hryggð	r̥ɪɣð
tvístra	tʰvistra
iðja	ɪðja
laktasi	laxtaːsɪ
töluorð	tʰœːlʏɔrð
marxismi	mar̥ksɪsmɪ
kaldi	kʰaltɪ
miðjarðarhaf	mɪðjarðarhaːv
hraustur	r̥øystʏr
skjóttur	scouhtʏr
faðir	faːðɪr
flensa	flɛnsa
mardís	martiːs
körfuvíðir	kʰœrvʏviːðɪr
andi	antɪ
vöndur	vœntʏr
svekkja	svɛhca
mikael	mɪːkʰaːɛːl
ánamaðkur	auːnamaθkʏr
lúði	luːðɪ
díler	tiːlɛr
gjalda	calta
helsingjaborg	hɛlsiɲcapɔrk
garpur	kar̥pʏr
dægurlag	taiːɣʏrlaːɣ
safna	sapna
vínarborg	viːnarpɔrk
stella	stɛlːa
vargur	varkʏr
hrollur	r̥ɔtlʏr
nár	nauːr
kynþáttur	cɪnθauhtʏr
athygli	aːthɪklɪ
ið	ɪːð
kveikja	kʰveiːca
imbakassi	ɪmpakʰasːɪ
þylja	θɪlja
munnvatn	mʏnːvahtn
runnur	rʏnːʏr
smella	smɛtla
sverta	svɛr̥ta
fræ	fraiː
köngull	kʰøyŋkʏtl
píning	pʰiːniŋk
ríkisdalur	riːcɪstaːlʏr
málefni	mauːlɛpnɪ
sikiley	sɪːcɪleiː
reim	reiːm
blokkflauta	plɔhkfløyːta
hvarfstig	xʷarfstɪːɣ
veldissproti	vɛltɪssprɔːtɪ
frauðplast	frøyːðpʰlast
geispi	ceispɪ
heimavinna	heiːmavɪnːa
líffræðingur	liffraiːðiŋkʏr
nauða	nøyːða
ógeðslegur	ouːcɛðslɛːɣʏr
árna	aurtna
krossferð	kʰrɔsːfɛrð
einkavæðing	eiŋkavaiːðiŋk
peningamarkaðssjóður	pʰɛːniŋkamar̥kaðssjouːðʏr
brúnn	prutn
andvirði	antvɪrðɪ
brokkolí	prɔhkɔli
þvottur	θvɔhtʏr
meiða	meiːða
auli	øyːlɪ
hjónaband	çouːnapant
fangi	fauɲcɪ
bor	pɔːr
vænir	vaiːnɪr
slúður	stluːðʏr
geirmundur	ceirmʏntʏr
pirra	pʰɪrːa
þang	θauŋk
hvöt	kʰvœːt
rafall	raːvatl
línarfi	liːnarvɪ
leiðsla	leiðstla
engi	eiɲcɪ
kvenmaður	kʰvɛnmaːðʏr
græða	kraiːða
kólna	kʰoulna
fleyta	fleiːta
meyjarhaft	meiːjarhaft
tása	tʰauːsa
glóbrystingur	klouːprɪstiŋkʏr
löggjöf	lœɣcœːv
kross	kʰrɔsː
vegasalt	vɛːɣasal̥t
skír	sciːr
fýldur	filtʏr
baksa	paxsa
rakna	rahkna
keppni	cʰɛhpnɪ
klúðra	kʰluðra
trog	tʰrɔːɣ
kanna	kʰanːa
bjuggu	pjʏɣʏ
klapp	kʰlahp
kex	cʰɛks
skýli	sciːlɪ
leiði	leiːðɪ
húfur	huːʏr
grey	kreiː
loða	lɔːða
gamburmosi	kampʏrmɔːsɪ
markteigur	mar̥ktʰeiːɣʏr
greinir	kreiːnɪr
hylki	hɪl̥cɪ
vasaúr	vaːsauːr
boðskapur	pɔðskaːpʏr
smergill	smɛrcɪtl
skora	skɔːra
innflytjandi	ɪnːflɪːtjantɪ
haarde	hɔrtɛː
nætur	naiːtʏr
vorkenna	vɔr̥cʰɛnːa
frysta	frɪsta
framvinda	framvɪnta
gráölur	krauːœːlʏr
maídís	maiːtiːs
óttast	ouhtast
óskhyggja	ouskhɪcːa
aron	aːrɔːn
goshver	kɔːskʰvɛːr
bárujárn	pauːrʏjaurtn
maskari	maskaːri
metorð	mɛːtɔrð
stjúpsonur	stjuːpsɔːnʏr
verma	vɛrma
kvöldverður	kʰvœltvɛrðʏr
sortulyng	sɔr̥tʏliŋk
kráka	kʰrauːka
sannur	sanːʏr
blöndal	plœntaːl
mari	maːrɪ
reykur	reiːkʏr
ákafur	auːkaːvʏr
sippa	sɪhpa
greinilegur	kreiːnɪlɛːɣʏr
sletta	stlɛhta
víða	viːða
druna	trʏːna
dingla	tiŋla
tittur	tʰɪhtʏr
flundra	flʏntra
bragð	praɣð
prakkarastrik	pʰrahkarastrɪːk
ekla	ɛhkla
dindill	tɪntɪtl
verðlaun	vɛrðløyːn
einkenni	eincʰɛnːɪ
dauðadómur	tøyːðatouːmʏr
eitilfruma	eiːtɪlfrʏːma
þægindi	θaiːjɪntɪ
fegra	fɛɣra
orðrómur	ɔrðrouːmʏr
dýrafræði	tiːrafraiːðɪ
mysa	mɪːsa
hálfur	haulvʏr
leynd	leint
drottningarbiskup	trɔhtniŋkarpɪskʏp
tjalli	tʰjalːɪ
prentsmiðja	pʰrɛn̥tsmɪðja
alaskaösp	aːlaskaœsp
alvöruleysi	alvœːrʏleiːsɪ
sveðja	svɛðja
svaf	svaːv
strimill	strɪːmɪtl
þreyta	θreiːta
helgur	hɛlkʏr
mögulegur	mœːɣʏlɛːɣʏr
þúfutittlingur	θuːvʏtʰɪhtliŋkʏr
hís	çiːs
afgreiðsla	avkreiðstla
ending	ɛntiŋk
kvittur	kʰvɪhtʏr
illska	ɪlska
riis	riːs
hörðaland	hœrðalant
falda	falta
keisari	cʰeiːsaːrɪ
styggur	stɪkːʏr
eldvarpa	ɛltvar̥pa
rabarbari	raːparpaːrɪ
ykkur	ɪhkʏr
hylla	hɪtla
gjarna	cartna
sítrónusýra	siːtʰrouːnʏsiːra
uppkast	ʏhpkʰast
heiðarlegur	heiːðarlɛːɣʏr
nálarauga	nauːlarøyːɣa
gunnlaugur	kʏnːløyːɣʏr
smyrja	smɪrja
hissa	hɪsːa
svalir	svaːlɪr
spretta	sprɛhta
fús	fuːs
tengja	tʰeiɲca
sporvagn	spɔrvakn
strjúka	strjuːka
mál	mauːl
hætta	haihta
kvabb	kʰvapː
brúða	pruːða
stampur	stam̥pʏr
vagga	vakːa
holt	hɔl̥t
flagg	flakː
ofurþungur	ɔːvʏrθuŋkʏr
júpíter	juːpiːtʰɛːr
mínus	miːnʏs
tilkynning	tʰɪlcʰɪnːiŋk
padda	pʰatːa
raun	røyːn
krókur	kʰrouːkʏr
leg	lɛːɣ
bjöggi	pjœcːɪ
diskótek	tɪskouːtʰɛːk
skriðuhnoðri	skrɪːðʏn̥ɔðrɪ
poppkorn	pʰɔhpkʰɔrtn
gá	kauː
ökuskírteini	œːkʏscir̥teiːnɪ
ris	rɪːs
synjun	sɪnjʏn
jarðvegur	jarðvɛːɣʏr
mögur	mœːɣʏr
ljóðlist	ljouðlɪst
forða	fɔrða
íslenska	iːslɛnska
búningur	puːniŋkʏr
sendill	sɛntɪtl
þröstur	θrœstʏr
orkugjafi	ɔr̥kʏcaːvɪ
víf	viːv
foreldri	fɔːrɛltrɪ
þýða	θiːða
sverrir	svɛrːɪr
hnetubrjótur	n̥ɛːtʏprjouːtʏr
spánverji	spaunvɛrjɪ
klaufalegur	kʰløyːvalɛːɣʏr
vegur	vɛːɣʏr
gleraugu	klɛːrøyːɣʏ
kreista	kʰreista
ginning	cɪnːiŋk
hláka	l̥auːka
ástfanginn	austfauɲcɪnː
lýðræði	liðraiːðɪ
rokkur	rɔhkʏr
missa	mɪsːa
dafna	tapna
lagni	laknɪ
op	ɔp
sítar	siːtʰaːr
ríða	riːða
karlremba	kʰartlrɛmpa
kokkteill	kʰɔhktʰeitl
stjórnarbylting	stjourtnarpɪl̥tiŋk
systir	sɪstɪr
orðasamband	ɔrðasampant
baga	paːɣa
nóta	nouːta
ugla	ʏkla
ólafía	ouːlaviːja
þreifa	θreiːva
sér	sɛːr
lúkk	luhk
erkibiskup	ɛr̥cɪpɪskʏp
hersveit	hɛr̥sveit
stækka	staihka
svandís	svantiːs
höfði	hœvðɪ
líkkista	liːkcʰɪsta
skjöldur	scœltʏr
lágþrýstingur	lauɣθristiŋkʏr
lýðveldi	liðvɛltɪ
erlendur	ɛtlɛntʏr
hór	houːr
last	last
klínískur	kʰliːniskʏr
stjaki	stjaːcɪ
virða	vɪrða
sagnbeyging	saknpeiːjiŋk
æruprís	aiːrʏpʰriːs
atvinna	aːtvɪnːa
bregða	prɛɣða
ölgerð	œlcɛrð
rabítur	raːpiːtʏr
ferill	fɛːrɪtl
gletta	klɛhta
sturla	stʏrtla
júlí	juːliː
öryggisráð	œːrɪcːɪsrauːð
pynda	pʰɪnta
klepri	kʰlɛːprɪ
fruma	frʏːma
fitusýra	fɪːtʏsiːra
bólstur	poulstʏr
kanada	kʰaːnaːta
fletja	flɛːtja
funda	fʏnta
hundur	hʏntʏr
flotaforingi	flɔːtafɔːriɲcɪ
samheiti	saːmheiːtɪ
páhæna	pʰauːhaiːna
kvikna	kʰvɪhkna
tannhvalur	tʰanːxʷaːlʏr
krossför	kʰrɔsːfœːr
undrabarn	ʏntrapartn
enn	ɛnː
samur	saːmʏr
detta	tɛhta
páskadagur	pʰauskataːɣʏr
skítur	sciːtʏr
kennsla	cʰɛnstla
hrópa	r̥ouːpa
tafnið	tʰapnɪð
leikfélag	leiːkfjɛːlaːɣ
íslam	iːstlaːm
lóa	louːa
haglabyssa	haklapɪsːa
hrognamál	r̥ɔknamauːl
meinbugur	meinpʏːɣʏr
stöðva	stœðva
svöfn	svœpn
sýking	siːciŋk
fríður	friːðʏr
raska	raska
bendir	pɛntɪr
tryggja	tʰrɪcːa
strekkingur	strɛhciŋkʏr
breki	prɛːcɪ
jarðarför	jarðarfœːr
okkarína	ɔhkariːna
kirjálaland	cʰɪrjauːlalant
hnefafylli	n̥ɛːvafɪtlɪ
frestur	frɛstʏr
mári	mauːrɪ
hluttekning	l̥ʏːttɛhkniŋk
ferfætlingur	fɛrfaihtliŋkʏr
júgur	juːʏr
kínaskák	cʰiːnaskauːk
arnþrúður	artnθruːðʏr
helgi	hɛlcɪ
handarkriki	hantarkʰrɪːcɪ
afskráning	afskrauːniŋk
hljómlist	l̥joumlɪst
bifa	pɪːva
hvor	xʷɔːr
veggur	vɛkːʏr
skin	scɪːn
óaðlaðandi	ouːaðlaːðantɪ
hræring	r̥aiːriŋk
ósló	ouːstlouː
sláttarstöðvun	stlauhtarstœðvʏn
biðja	pɪðja
teikn	tʰeihkn
vestur	vɛstʏr
traktor	tʰraxtɔr
skómakari	skouːmaːkaːrɪ
butur	pʏːtʏr
holurt	hɔːlʏr̥t
jess	jɛsː
hundafangari	hʏntafauŋkaːrɪ
bastarður	pastarðʏr
klettur	kʰlɛhtʏr
verðmætur	vɛrðmaiːtʏr
tittlingur	tʰɪhtliŋkʏr
þorkelína	θɔr̥cʰɛːliːna
frímannía	friːmanːiːja
sjúga	sjuːa
för	fœːr
eftirför	ɛftɪrfœːr
prettur	pʰrɛhtʏr
lagga	lakːa
vær	vaiːr
síberíulerki	siːpɛːriːjʏlɛr̥cɪ
gula	kʏːla
grá	krauː
kjúklingur	cʰuhkliŋkʏr
glaumgosi	kløymkɔːsɪ
raða	raːða
strangi	strauɲcɪ
heimspekingur	heimspɛːciŋkʏr
óratóría	ouːratʰouːriːja
kornbreskur	kʰɔrtnprɛskʏr
barmur	parmʏr
stakur	staːkʏr
biskup	pɪskʏp
flýja	fliːja
nostalgía	nɔstalcija
hettumáfur	hɛhtamauːvʏr
atvinnumaður	aːtvɪnːʏmaːðʏr
aðild	aːðɪlt
nón	nouːn
mótetta	mouːtʰɛhta
virkjun	vɪr̥cʏn
miga	mɪːɣa
gári	kauːrɪ
forseti	fɔr̥sɛːtɪ
sandkassi	santkʰasːɪ
heimskautsnótt	heimskøytsnouht
vafi	vaːvɪ
gullmura	kʏtlmʏːra
átthyrningur	auhthɪrtniŋkʏr
hross	r̥ɔsː
stappa	stahpa
ysta	ɪsta
einvígi	einviːjɪ
kringja	kʰriɲca
samhaldssamur	samhaltssaːmʏr
tía	tʰiːja
heimili	heiːmɪlɪ
munnmök	mʏnːmœːk
mylsna	mɪlstna
miðstig	mɪðstɪːɣ
naður	naːðʏr
greindur	kreintʏr
langnykra	lauŋknɪːkra
algerlega	alcɛrlɛːɣa
fjölskylda	fjœlscɪlta
viðskeyti	vɪðsceiːtɪ
negull	nɛːɣʏtl
hæna	haiːna
hlemmur	l̥ɛmːʏr
fennikka	fɛnːɪhka
æður	aiːðʏr
gunnþórunn	kʏnθouːrʏnː
melóna	mɛːlouːna
stafróf	stavrouːv
skemma	scɛmːa
hvor	kʰvɔːr
sirkon	sɪr̥kɔːn
karþagó	kʰar̥θakouː
sjóveiki	sjouːveiːcɪ
aðlaðandi	aðlaːðantɪ
guðleysingi	kvʏðleiːsiɲcɪ
hátign	hauːtʰɪkn
aðdráttarafl	aðtrauhtarapl
rithönd	rɪːthœnt
fyrirlestur	fɪːrɪrlɛstʏr
gotneskur	kɔhtnɛskʏr
lafði	lavðɪ
dýraspítali	tiːraspiːtaːlɪ
buxur	pʏxsʏr
diskur	tɪskʏr
regndropi	rɛkntrɔːpɪ
rengla	reiŋla
göngutúr	køyŋkʏtʰuːr
iðngrein	ɪðnkreiːn
botn	pɔhtn
hjólbarði	çoulparðɪ
bylting	pɪl̥tiŋk
skurðstofa	skʏrðstɔːva
platónskur	pʰlaːtʰounskʏr
neitunarvald	neiːtʏnarvalt
penni	pʰɛnːɪ
skjóta	scouːta
jerúsalem	jɛːruːsaːlɛːm
storma	stɔrma
þrýstihópur	θristɪhouːpʏr
brottvísun	prɔhtviːsʏn
spýja	spiːja
orðaforði	ɔrðafɔrðɪ
guða	kvʏːða
smit	smɪːt
samhljóð	saml̥jouːð
orma	ɔrma
sökka	sœhka
stóla	stouːla
þrymja	θrɪmja
miskunn	mɪskʏnː
mjög	mjœːɣ
samband	sampant
snöggur	stnœkːʏr
hvert	xʷɛr̥t
trúa	tʰruːa
tágamura	tʰauːɣamʏːra
feykja	feiːca
heimill	heiːmɪtl
endur	ɛntʏr
dissa	tɪsːa
gjörla	cœrtla
smaragður	smaːraɣðʏr
hika	hɪːka
heiðdís	heiðtiːs
hólkur	houl̥kʏr
helsingjaeyri	hɛlsɪɲcaeiːrɪ
bagi	paːjɪ
kollekta	kʰɔlːɛxta
bros	prɔːs
klæðnaður	kʰlaiðnaːðʏr
prinsessa	pʰrɪnsɛsːa
atvinnuleysi	atvɪnːʏlœyːsɪ
skrúðganga	skruðkauŋka
fortíðarþrá	fɔr̥tʰiːðarθrauː
táningur	tʰauːniŋkʏr
nautahakk	nøyːtahahk
eggfruma	ɛkːfrʏːma
hrái	r̥auːɪ
spyrja	spɪrja
trikk	tʰrɪhk
hjarn	çartn
skilja	scɪlja
sig	sɪːɣ
nábrók	nauːprouːk
skulda	skʏlta
vasapeningar	vaːsapʰɛːniŋkar
króna	kʰrouna
lágur	lauːr̥
herklæði	hɛr̥kʰlaiːðɪ
ríkidæmi	riːcɪtaiːmɪ
fjölveri	fjœlvɛːrɪ
knattspyrna	kʰnahtspɪrtna
knattspyrnumaður	kʰnahtspɪrtnʏmaːðʏr
lambagras	lampakraːs
garðar	karðar
eykt	eixt
nautn	nœihtn
ketill	cʰɛːtɪtl
skógarkerfill	skouːarcʰɛrvɪtl
aðdróttun	aðtrouhtʏn
koss	kʰɔsː
valhnappur	valn̥ahpʏr
valhöll	vaːlhœtl̥
öfund	œːvʏnt
boðorð	pɔːðɔrð
vél	vjɛːl
vor	vɔːr
drepa	trɛːpa
berklar	pɛr̥klar
ljós	ljouːs
ruggustóll	rʏkːʏstoutl
hrólfur	r̥oulvʏr
innrita	ɪnːrɪːta
bergkvika	pɛrkkʰvɪːka
skott	skɔht
kíghósti	kʰiːɣhoustɪ
lögfræði	lœɣfraiːðɪ
hulda	hʏlta
eiturlyfjanotandi	eiːtʏrlɪvjanɔːtantɪ
kínakál	cʰiːnakʰauːl
fastmæli	fastmaiːlɪ
skilnaður	scɪlnaːðʏr
stóriburkni	stouːrɪpʏr̥knɪ
unnusti	ʏnːʏstɪ
galílea	kaːliːlɛːa
frímerki	friːmɛr̥cɪ
blöðruhálskirtill	plœðrʏhaulscʰɪr̥tɪtl
kyngja	cʰiɲca
íri	iːrɪ
hýena	hiːɛna
þistill	θɪstɪtl
frábærlega	frauːpairlɛːɣa
oj	ɔiː
taka	tʰaːka
hamingjusamur	haːmiɲcʏsaːmʏr
þessalía	θɛsːaliːja
ragnarök	raknarœːk
leyndó	leintouː
bílaverkstæði	piːlavɛr̥kstaiːðɪ
æ	ai
jökull	jœːkʏtl
fletta	flɛhta
frón	frouːn
ófullnægjandi	ouːfʏtlnaiːjantɪ
starf	starv
framkoma	framkʰɔːma
asna	astna
margur	markʏr
rangstaða	rauŋkstaːða
sakleysi	saːkleiːsɪ
rafmagn	ravmakn
strápils	strauːpʰɪls
dust	tʏst
veikla	veihkla
kúl	kʰuːl
sjálfsfróun	sjaulvsfrouːʏn
halldís	haltiːs
firð	fɪrð
frystiskápur	frɪstɪskauːpʏr
hjúfra	çuvra
ávalur	auːvaːlʏr
snjótittlingur	snjouːtʰɪhtliŋkʏr
sulta	sʏl̥ta
skyrpa	scɪr̥pa
leika	leiːka
friður	frɪːðʏr
þekja	θɛːca
hvalaskoðun	kʰvaːlaskɔːðʏn
fönix	fœːnɪxs
málfræði	maulfraːiðɪ
baðmullarsvunta	paðmʏtlarsvʏn̥ta
bakka	pahka
lappland	lahplant
fata	faːta
dreifing	treiːviŋk
kjassa	cʰasːa
nifteind	nɪfteint
binda	pɪnta
sífellt	siːfɛl̥t
áhætta	auːhaihta
hafnabolti	hapnapɔl̥tɪ
gómur	kouːmʏr
mýfluga	miːflʏːɣa
kefja	cɛvja
byssuhlaup	pɪsːʏl̥øyːp
skattur	skahtʏr
spurning	spʏrtniŋk
föðurbróðir	fœːðʏrprouːðɪr
valur	vaːlʏr
bíldrusla	piltrʏstla
jesús	jɛːsuːs
reið	reiːð
frelsishetja	frɛlsɪshɛːtja
tossa	tʰɔsːa
myrkvi	mɪr̥kvɪ
elgur	ɛlkʏr
kúfa	kʰuːva
tölt	tʰœl̥t
glæra	klaiːra
sök	sœːk
hélunjóli	çɛːlʏnjouːlɪ
flatbaka	flatpaːka
reiðufé	reiːðʏfjɛː
bani	paːnɪ
sviss	svɪsː
fló	flouː
boða	pɔːða
fjandskapur	fjantskaːpʏr
dyflinn	tɪplɪnː
lokkur	lɔhkʏr
karlkyn	kʰartl̥cʰɪːn
auðvald	øyðvalt
lófatölva	louːvatʰœlva
frjósemi	frjouːsɛːmɪ
undanfarinn	ʏntanfaːrɪnː
skömm	skœmː
baldursbrá	paltʏr̥sprauː
heilindi	heiːlɪntɪ
flæða	flaiːða
rölta	rœl̥ta
náða	nauːða
nudda	nʏtːa
hastur	hastʏr
dórískur	touːriskʏr
þórdís	θourtiːs
hæra	haiːra
kverk	kʰvɛr̥k
fljóta	fljouːta
hliðarvasi	l̥ɪːðarvaːsɪ
óraddaður	ouːratːaːðʏr
náladofi	nauːlatɔːvɪ
bjalla	pjatla
vaxa	vaxsa
barónett	paːrouːnɛht
gálma	kaulma
ferhyrndur	fɛːrhɪrntʏr
ý	ʏfsɪlɔniː
bardagalist	partaːɣalɪst
hey	heiː
erfðamengi	ɛrvðameiɲcɪ
ágjarn	auːcartn
sæta	saiːta
ávinningur	auːvɪnːiŋkʏr
silfurlitaður	sɪlvʏrlɪːtaðʏr
rif	rɪːv
sparka	spar̥ka
beiðni	peiðnɪ
snefill	stnɛːvɪtl
runnamura	rʏnːamʏːra
mamma	mamːa
hyskni	hɪsknɪ
þrugla	θrʏkla
gestína	cɛstiːna
kolefni	kʰɔːlɛpnɪ
slóð	stlouːð
alþýðlegur	alθiðlɛːɣʏr
leki	lɛːcɪ
rafpóstur	ravpʰoustʏr
kristín	kʰrɪstiːn
drómedari	trouːmɛːtaːrɪ
málbein	maulpeiːn
prjónn	pʰrjoutn
fjötra	fjœːtra
staðall	staːðatl
urra	ʏrːa
krá	kʰrauː
kelfing	cʰɛlviŋk
dráp	trauːp
frár	frauːr
prakkari	pʰrahkaːrɪ
venus	vɛːnʏs
lea	lɛːa
hérað	çɛːrað
bergmann	pɛrkmanː
skeiðklukka	sceiðkʰlʏhka
es	ɛːs
postuli	pʰɔstʏːlɪ
standpína	stantpʰiːna
birgja	pɪrca
hrókering	r̥ouːcɛriŋk
tónlistarskóli	tʰounlɪstarskouːlɪ
missir	mɪsːɪr
spindill	spɪntɪtl
maurígull	møyːriːɣʏtl
reynd	reint
mylla	mɪlːa
afdrep	avtrɛːp
kvenkyn	kʰvɛncʰɪːn
steindór	steintouːr
ölva	œlva
kvef	kʰvɛːv
tölusetja	tʰœːlʏsɛːtja
vinkona	vɪŋkʰɔːna
uppgerð	ʏhpcɛrð
skíma	sciːma
kroppur	kʰrɔhpʏr
dólgur	toulkʏr
ívera	iːvɛːra
gepill	cɛːpɪtl
kristur	kʰrɪstʏr
blaðsíða	plaðsiːða
bringusund	priŋkʏsʏnt
tún	tʰuːn
þrístrendingur	θriːstrɛntiŋkʏr
auðna	øyðna
núningur	nuːniŋkʏr
stikla	stɪhkla
rægja	raiːja
beðja	pɛðja
mjólkursýra	mjoul̥kʏrsiːra
huggulegur	hʏkːʏlɛːɣʏr
sleggja	stlɛcːa
fjóla	fjouːla
lögbrot	lœːɣprɔːt
mórauður	mouːrøyːðʏr
færni	fairtnɪ
mongólía	mɔŋkouːliːja
kaldur	kʰaltʏr
meitill	meiːtɪtl
karrí	kʰarːiː
skyggn	scɪkn
eigandi	eiːɣantɪ
nippill	nɪhpɪtl
stuðningur	stʏðniŋkʏr
sunnudagur	sʏnːʏtaːɣʏr
prýði	pʰriːðɪ
vingull	viŋkʏtl
dugfús	tʏxfuːs
sverja	svɛrja
tékkneskur	tʰjɛhknɛskʏr
flensborg	flɛnspɔrk
kræla	kʰraiːla
rýra	riːra
grassnákur	kraːssnauːkʏr
magndís	makntiːs
ör	œːr
forstaða	fɔr̥staːða
klóra	kʰlouːra
bólgna	poulna
snertill	snɛr̥tɪtl
kláði	kʰlauːðɪ
úrferðarfall	ur̥fɛrðarfatl
kveða	kʰvɛːða
blóðvökvi	plouðvœːkvɪ
klíka	kʰliːka
fyrirlitning	fɪːrɪrlɪhtniŋk
hrani	r̥aːnɪ
hippi	hɪhpɪ
röskur	rœskʏr
enda	ɛnta
hjónaskilnaður	çouːnascɪlnaːðʏr
keipur	cʰeiːpʏr
forinta	fɔːrɪn̥ta
millibil	mɪtlɪpɪːl
einelti	eiːnɛl̥tɪ
hlésey	l̥jɛːseiː
il	ɪːl
mala	maːla
þol	θɔːl
skán	skauːn
fjölkynngi	fjœlcʰiɲcɪ
burður	pʏrðʏr
veisla	veistla
svindlari	svɪntlaːrɪ
réttritun	rjɛhtrɪːtʏn
hjala	çaːla
tímarit	tʰiːmarɪːt
kjammi	cʰamːɪ
brún	pruːn
teppi	tʰɛhpɪ
villigöltur	vɪtlɪkœl̥tʏr
samúel	saːmuːɛːl
húsbóndi	huspountɪ
heigull	heiːɣʏtl
tomma	tʰɔmːa
súr	suːr
framsaga	framsaːɣa
dísa	tiːsa
rakari	raːkaːrɪ
moll	mɔlː
kamfóra	kʰamfouːra
aristóteles	aːrɪstouːtʰɛːlɛːs
for	fɔːr
aðalatriði	aːðalaːtrɪːðɪ
heit	heiːt
kokhlust	kʰɔːkl̥ʏst
trýni	tʰriːnɪ
lesminni	lɛːsmɪnːɪ
sin	sɪːn
blæösp	plaiːœsp
biðlari	pɪðlaːrɪ
frost	frɔst
purpuraþistill	pʰʏr̥pʏːraθɪstɪtl
jarðskorpa	jarðskɔr̥pa
blóm	plouːm
ábendingarfornafn	auːpɛntiŋkarfɔrnapn
inngangur	ɪnːkauŋkʏr
fjalldalafífill	fjatltaːlafiːvɪtl
semja	sɛmja
önd	œnt
skrök	skrœːk
bolla	pɔtla
rykkja	rɪhca
brjánn	prjautn
lumma	lʏmːa
sær	saiːr
ný	niː
hjátrú	çauːtʰruː
tékkneska	tʰjɛhknɛska
armbandsúr	armpantsuːr
stressa	strɛsːa
sigmar	sɪɣmaːr
viða	vɪːða
niðurlægja	nɪːðʏrlaiːja
hrína	r̥iːna
grein	kreiːn
marksúla	mar̥ksuːla
briem	priːm
saltaður	sal̥taːðʏr
burstajafni	pʏr̥stajapnɪ
lúður	luːðʏr
krani	kʰraːnɪ
frjósa	frjouːsa
hundasúra	hʏntasuːra
nös	nœːs
léttúð	ljɛhtuːð
kaðall	kʰaːðatl
múgæsing	muːaiːsiŋk
sjónvarp	sjounvar̥p
farseðill	far̥sɛːðɪtl
járnsmiður	jaurtnsmɪːðʏr
fön	fœːn
hilling	hɪtliŋk
síst	sist
betlari	pɛhtlaːrɪ
skáldskapur	skaultskaːpʏr̥
tíður	tʰiːðʏr
pára	pʰauːra
hvatning	xʷahtniŋk
fjallafura	fjatlafʏːra
munkur	muŋ̊kʏr
strjáll	strjautl
lækur	laiːkʏr
samkomulag	samkʰɔːmʏlaːɣ
næmi	naiːmɪ
lilja	lɪlja
ljóð	ljouːð
ryðfrír	rɪðfriːr
líkamur	liːkʰaːmʏr
gifs	cɪfs
þorlákína	θɔrlauːciːna
okkur	ɔhkʏr
lykta	lɪxta
rjúka	rjuːka
box	pɔxs
klara	kʰlaːra
glata	klaːta
auður	øyːðʏr
jakki	jahcɪ
vaka	vaːka
hegða	hɛɣða
úð	uːð
safnari	sapnaːrɪ
pallur	pʰatlʏr
buxnaklauf	pʏxsnakløyːv
rúnna	runːa
úrvinnsla	urvɪnstla
skiljanlegur	scɪljanlɛːɣʏr
lífsþróttur	lifsθrouhtʏr
drekka	trɛhka
arkitekt	ar̥cɪtʰɛxt
agalegur	aːɣalɛɣʏr
gelta	cɛl̥ta
stikill	stɪːcɪtl
drumbur	trʏmpʏr
drottningarriddari	trɔhtniŋkarrɪtːarɪ
guð	kvʏːð
efasemd	ɛːvasɛmt
bón	pouːn
ágóði	auːkouːðɪ
laugamaðra	løyːɣamaðra
slitinn	stlɪːtinː
yfirheiti	ɪːvɪrheiːtɪ
þessi	θɛsːɪ
hægur	haiːɣʏr
afturhald	aftʏrhalt
má	mauː
kæruleysi	cʰaiːrʏleiːsɪ
sóli	souːlɪ
karta	kʰar̥ta
eymsli	eimstlɪ
hýdrat	çiːtraːt
refill	rɛːvɪtl
kúrín	kʰuːriːn
víg	viːɣ
seyði	seiːðɪ
týsfjóla	tʰiːsfjouːla
snúðugur	stnuːðʏːʏr
hænsn	hainstn
bláber	plauːpɛːr
brauðmoli	prøyðmɔːlɪ
móðga	mouðka
svefnherbergi	svɛpnhɛrpɛrcɪ
harmur	harmʏr
segja	seiːja
brjóst	prjoust
máni	mauːnɪ
jarðsprengja	jarðspreiɲca
kær	cʰaiːr
vöxtur	vœxstʏr
grænmeti	krainmɛːtɪ
piparsveinn	pʰɪːparsveitn
frymi	frɪːmɪ
saddur	satːʏr
slydda	stlɪtːa
gatnamót	kahtnamouːt
limgerði	lɪmcɛrðɪ
djörfung	tjœrvuŋk
glampi	klam̥pɪ
flygill	flɪːjɪtl
haraldína	haːraltiːna
víóla	viːjouːla
biðstofa	pɪðstɔːva
flakka	flahka
túlkur	tʰul̥kʏr
samhljóði	saml̥jouːðɪ
aðdráttur	aðtrauhtʏr
tappatogari	tʰahpatʰɔːɣarɪ
heiladingull	heiːlatiŋkʏtl
nína	niːna
baugur	pøyːɣʏr
hvörf	kʰvœrv
formatta	fɔrmahta
glöggur	klœkːʏr
grafall	kraːvatl
knattspyrnuþjálfari	kʰnahtspɪrtnʏθjaulvarɪ
blævængur	plaiːvaiŋkʏr
plata	pʰlaːta
steinselja	steinsɛlja
faraó	faːraouː
alls	als
föstudagur	fœstʰʏtaːɣʏr
liðugur	lɪːðʏːɣʏr
hamstur	hamstʏr
nærvera	nairvɛːra
dirfð	tɪrvð
skara	skaːra
biðill	pɪːðɪtl
streita	streiːta
sjampó	sjam̥pouː
ýrar	iːraːr
hængur	haiŋkʏr
sleikja	stleiːca
lakka	lahka
grunur	krʏːnʏr
mía	miːja
ber	pɛːr
ók	ouːk
hníga	n̥iːɣa
rýja	riːja
sóun	souːʏn
þefur	θɛːvʏr
öngull	øyŋkʏtl
rauðíkorni	røyːðiːkʰɔrtnɪ
hvass	xʷasː
snökt	snœxt
baula	pøyːla
sund	sʏnt
toga	tʰɔːɣa
krefjast	kʰrɛvjast
forngríska	fɔrtnkriska
galdrakerling	kaltracʰɛrtliŋk
umla	ʏmla
flórens	flouːrɛns
hörfræ	hœrfraiː
frakkland	frahklant
nýr	niːr
aðalskáli	aːðalskauːlɪ
blálilja	plauːlɪlja
beittur	peihtʏr
tinda	tʰɪnta
stoppun	stɔhpʏn
brátt	prauht
markaður	mar̥kaðʏr
gíll	citl
sveiti	sveiːtɪ
dýrð	tirð
efnisyfirlit	ɛpnɪsɪːvɪrlɪːt
fjós	fjouːs
skandall	skantatl
bartar	par̥tar
járnbrautarstöð	jaurtnprøyːtarstœːð
snurða	stnʏrða
púrtvín	pʰur̥tviːn
zeta	sɛːta
sálarfræði	sauːlarfraiːðɪ
stroff	strɔfː
glápa	klauːpa
votta	vɔhta
stress	strɛsː
nammi	namːɪ
flís	fliːs
feiti	feiːtɪ
tigna	tʰɪkna
handknattleikur	hantkʰnahtleiːkʏr
teygjulak	tʰeiːjʏlaːk
tíkarsonur	tʰiːkarsɔːnʏr
flyksa	flɪksa
botnlangatota	pɔhtnlauŋkatʰɔːta
kynda	cʰɪnta
ljósberi	ljouːspɛːrɪ
melludólgur	mɛtlʏtoulkʏr
áminna	auːmɪnːa
búðarkassi	puːðarkʰasːɪ
hörður	hœrðʏr
puð	pʰʏːð
tuska	tʰʏska
slúta	stluːta
alvörulaus	alvœːrʏløyːs
merja	mɛrja
ávarpsfall	auːvar̥psfatl
bæt	paiːt
óhreinindi	ouːr̥eiːnɪntɪ
glundur	klʏntʏr
gap	kaːp
karst	kʰar̥st
sifjaspell	sɪvjaspɛtl
spítali	spiːtʰaːlɪ
trunta	trʏn̥ta
ári	auːrɪ
buxnadragt	pʏxsnatraxt
hrafnkell	r̥apncʰɛtl
gagnsemi	kaknsɛːmɪ
heitur	heiːtʏr
bulla	pʏtla
varmur	varmʏr
útbreiddur	uːtpreitːʏr
vonandi	vɔːnantɪ
fljóð	fljouːð
álit	auːlɪːt
næs	naiːs
tími	tʰiːmɪ
rass	rasː
lystarstol	lɪstarstɔːl
ekki	ɛhcɪ
silfraður	sɪlvraːðʏr
lerki	lɛr̥cɪ
flaski	flascɪ
fagurfræði	faːɣʏrfraiːðɪ
bókstafur	pouːkstaːvʏr
mýta	miːta
stjarfur	stjarvʏr
barnamosi	partnamɔːsɪ
sléttlendi	stljɛhtlɛntɪ
íhaldssamur	iːhaltssaːmʏr
óvína	ouːviːna
tíð	tʰiːð
æð	aiːð
stjarfi	stjarvɪ
varp	var̥p
stakket	stahkɛːt
hljóðhimna	l̥jouðhɪmna
fagurgæs	faːɣʏrcaiːs
stökk	stœhk
hrekkur	r̥ɛhkʏr
stína	stiːna
apótek	aːpouːtʰɛːk
framrúða	framruːða
róðukross	rouːðʏkʰrɔsː
gluggi	klʏcːɪ
labba	lapːa
blóðþrýstingur	plouðθristiŋkʏr
traust	tʰrøyst
vitni	vɪhtnɪ
hæstiréttur	haistɪrjɛhtʏr
smjatt	smjaht
smetti	smɛhtɪ
malí	maːliː
predikun	pʰrɛːtɪkʏn
fuglahræða	fʏklar̥aiːða
atviksorð	aːtvɪksɔrð
ljómi	ljouːmɪ
senna	sɛnːa
munaðarleysingi	mʏːnaːðarleiːsiɲcɪ
kjartanía	cʰar̥taniːja
bang	pauŋk
of	ɔːv
hnjóðsyrði	n̥jouðsɪrðɪ
botnlangi	pɔhtnlauŋcɪ
gríma	kriːma
ljótunn	ljouːtʏnː
bábilja	pauːpɪlja
sólarljós	souːlarljouːs
aumur	øyːmʏr
legill	leiːjɪtl
bjúgur	pjuːʏr
morgunkorn	mɔrkʏnkʰɔrtn
gönguleið	køyŋkʏleiːð
þorlákur	θɔrlauːkʏr
allteins	al̥teins
ljótur	ljouːtʏr
ál	auːl
skíði	sciːðɪ
spuni	spʏːnɪ
aís	aːiːs
stél	stjɛːl
indriðína	ɪntrɪːðiːna
þorsteinn	θɔr̥steitn
hólmur	houlmʏr
gegnvirkur	cɛknvɪr̥kʏr
blómsef	ploumsɛːv
duttlungur	tʏhtluŋkʏr
mikið	mɪːcɪð
hnífur	n̥iːvʏr
brynjúlfur	prɪnjulvʏr
sifji	sɪvjɪ
hneigð	n̥eiɣð
lesa	lɛːsa
poki	pʰɔːcɪ
siggi	sɪcːɪ
kórall	kʰouːratl
hákarl	haːkartl
nærmynd	nairmɪnt
aðskilnaðarstefna	aðscɪlnaːðarstɛpna
b	pjɛː
möndull	mœntʏtl
flóðhestur	flouːðhɛstʏr
framan	fraːman
stefni	stɛpnɪ
dagdraumur	taɣtrøyːmʏr
trufla	tʰrʏpla
mótbára	mouːtpauːra
blífur	pliːvʏr
heimsvaldastefna	heimsvaltastɛpna
stjórnklefi	stjourtnkʰlɛːvɪ
umræða	ʏmraiːða
grön	krœːn
ávarpa	auːvar̥pa
dæld	tailt
jarðskjálfti	jarðscaul̥tɪ
æti	aiːtɪ
dauður	tøyːðʏr
blóðfrumnamyndun	plouðfrʏmnamɪntʏn
prófessor	pʰrouːfɛsːɔr
tiltekt	tʰɪːltʰɛxt
hægðatregða	haiɣðatʰrɛɣða
málfrelsi	maulfrɛlsɪ
hnaus	n̥øyːs
knýja	kʰniːja
rissa	rɪsːa
átelja	auːtʰɛlja
ár	auːr
heimska	heimska
næsta	naista
sumarhnoðri	sʏːmarn̥ɔðrɪ
ærsl	airstl
þarna	θarna
sagnfylling	saknfɪtliŋk
appelsínusafi	ahpɛlsiːnʏsaːvɪ
magnúsína	maknuːsiːna
klettasalat	kʰlɛhtasaːlat
hnýfill	n̥iːvɪtl
brenna	prɛnːa
gríður	kriːðʏr
riða	rɪːða
fóstra	foustra
seðill	sɛːðɪtl
hyski	hɪscɪ
hryndi	r̥ɪntɪ
auðn	øyðn
bogi	pɔiːjɪ
eplatré	ɛhplatrjɛː
hörund	hœːrʏnt
nytsemi	nɪːtsɛːmɪ
reyndar	reintar
krissa	kʰrɪsːa
þrívegis	θriːveiːjɪs
sprettur	sprɛhtʏr
húð	huːð
uppspuni	ʏhpspʏːnɪ
liðsforingi	lɪðsfɔːriɲcɪ
mjöll	mjœtl
forstofa	fɔr̥stɔːva
bensínsala	pɛnsinsaːla
árdís	aurtiːs
strútur	struːtʏr
velmegun	vɛlmɛːɣʏn
sjöundi	sjœːʏntɪ
gráta	krauːta
æfa	aiːva
ferð	fɛrð
rauður	røyːðʏr
hvolfa	kʰvɔlva
hreiður	r̥eiːðʏr
hana	haːna
sjófugl	sjouːfʏkl
n	ɛnː
glóð	klouːð
hugmyndafræði	hʏɣmɪntafraiːðɪ
eftirmiðdagur	ɛftɪrmɪðtaːɣʏr
ingunn	iŋkʏnː
strangur	strauŋkʏr
radar	raːtar
dalla	tatla
hagsbót	haxspouːt
hviða	xʷɪːða
yfirráð	ɪːvɪrrauːð
meðstjórnandi	mɛðstjourtnantɪ
slarka	stlar̥ka
tögl	tʰœkl
einfaldur	einfaltʏr
andaglas	antaklaːs
haraldur	haːraltʏr
tjarnastör	tʰjartnastœːr
vigur	vɪːɣʏr
kænska	cʰainska
líf	liːv
gýgur	ciːɣʏr
glampa	klam̥pa
fiski	fɪscɪ
teinóttur	tʰeiːnouhtʏr
snækrækill	snaiːkʰraiːcɪtl
heiðindómur	heiːðɪntouːmʏr
lampi	lam̥pɪ
vindugur	vɪntʏːɣʏr
rauðvín	røyðviːn
plana	pʰlaːna
brýni	priːnɪ
steinefni	steiːnɛpnɪ
hjalli	çatlɪ
brekkusóley	prɛhkʏsouːleiː
tætari	tʰaiːtaːrɪ
drottning	trɔhtniŋk
múrhúða	muːrhuːða
samlandi	samlantɪ
rassa	rasːa
þokki	θɔhcɪ
gerandi	cɛːrantɪ
naddur	natːʏr
nábúi	nauːpuːɪ
sjötti	sjœhtɪ
íhald	iːhalt
almætti	almaihtɪ
áfir	auːvɪr
agn	akn
dökkvíðir	tœhkviːðɪr
baggi	pacːɪ
lífeðlisfræði	liːvɛðlɪsfraiːðɪ
aðvörun	aðvœːrʏn
yllir	ɪtlɪr
broddkrækill	prɔtːkʰraiːcɪtl
hár	hauːr
pláneta	pʰlauːnɛːta
mettur	mɛhtʏr
sortna	sɔr̥tna
flass	flasː
kröfuganga	kʰrœːvʏkauŋka
trúlofa	tʰruːlɔva
flýtir	fliːtɪr
gígja	ciːja
fjölgyðistrú	fjœlkɪːðɪstruː
bötnun	pœhtnʏn
frunti	frʏn̥tɪ
leggur	lɛkːʏr
heima	heiːma
bæjasvala	paiːjasvaːla
héri	çɛːrɪ
marxisti	mar̥ksɪstɪ
védís	vjɛːtiːs
filla	fɪtla
rifa	rɪːva
hnúðkál	n̥uðkʰauːl
geimur	ceiːmʏr
hershöfðingi	hɛr̥shœvðiɲcɪ
fjór	fjouːr
mergur	mɛrkʏr
frískur	friskʏr
hávarðína	hauːvarðiːna
njósna	njoustna
rimlagirðing	rɪːmlacɪrðiŋk
þumbaralegur	θʏmparalɛːɣʏr
jarðyrkja	jarðɪr̥ca
fjarverufall	fjarvɛːrʏfatl
meðan	mɛːðan
leiðtogi	leiðtʰɔːjɪ
þor	θɔːr
plástur	pʰlaustʏr
kristjánssandur	kʰrɪstjaunssantʏr
leiftur	leiftʏr
mynstur	mɪnstʏr
hatur	haːtʏr
klína	kʰliːna
höfuðverkur	hœːvʏðvɛr̥kʏr
djöfull	tjœːvʏtl
fónem	fouːnɛːm
matvara	maːtvaːra
ástfríður	austfriːðʏr
frásögn	frauːsœkn
skyrta	scɪr̥ta
gírstöng	ciːr̥støyŋk
órólegur	ouːrouːlɛːɣʏr
jörundína	jœːrʏntiːna
gelding	cɛltiŋk
krýning	kʰriːniŋk
þrár	θrauːr
ilmvatn	ɪlmvahtn
óreglulegur	ouːrɛklʏlɛːɣʏr
mar	maːr
léreft	ljɛːrɛft
blundur	plʏntʏr
vinka	viŋ̊ka
árásarmaður	auːrauːsarmaːðʏr
bróðursonur	prouːðʏr̥sɔːnʏr
kvak	kʰvaːk
múhameð	muːhamɛːð
trissa	tʰrɪsːa
þána	θauːna
áætlun	auːaihtlʏn
melablóm	mɛːlaplouːm
kunnátta	kʰʏnːauhta
slatti	stlahtɪ
holland	hɔllant
kippa	cʰɪhpa
rófubein	rouːvʏpeiːn
langhlið	lauŋkl̥ɪːð
ostefni	ɔstɛpnɪ
rogaland	rɔːɣalant
ísmoli	iːsmɔːlɪ
lufsa	lʏfsa
höfuð	hœːvʏθ
kapall	kʰaːpatl
gláka	klauːka
þrennd	θrɛnt
hvítmosi	kʰviːtmɔːsɪ
nábítur	nauːpiːtʏr
skurðlæknir	skʏrðlaihknɪr
óstöðugur	ouːstœːðʏɣʏr
barr	parː
kýrauga	cʰiːrøyːɣa
góla	kouːla
skjótur	scouːtʏr
hvatning	kʰvahtniŋk
lárus	lauːrʏs
franskbrauð	franskprøyːð
geitungur	keiːtuŋkʏr
bókfinka	pouːkfiŋ̊ka
armband	armpant
smyrill	smɪːrɪtl
pinni	pʰɪnːɪ
sæði	saiːðɪ
langur	lauŋkʏr
tjarga	tʰjarka
hártogun	haur̥tʰɔːɣʏn
víxl	vikstl
skíða	sciːða
eitill	eiːtɪtl
hör	hœːr
rannsókn	ranːsouhkn
nískur	niskʏr
brydding	prɪtːiŋk
guðfræði	kvʏðfraiːðɪ
kíví	kʰiːvi
klabb	kʰlapː
skeina	sceiːna
veðurtunglamynd	vɛːðʏrtʰuŋlamɪnt
aska	aska
ráð	rauːð
fá	fauː
muna	mʏːna
bifhjól	pɪfçouːl
grasafræði	kraːsafraiːðɪ
fjölbýlishús	fjœlpiːlɪshuːs
hliðarlína	l̥ɪːðarliːna
tötur	tʰœːtʏr
keyra	cʰeiːra
hor	hɔːr
höfuðborgarsvæði	hœːvʏθpɔrkarsvaiːðɪ
reyrgresi	reirkrɛːsɪ
ráðgjafi	rauðcaːvɪ
bóg	pouː
heimskingi	heimsciɲcɪ
jörð	jœrð
lepja	lɛːpja
veina	veiːna
sef	sɛːv
ropi	rɔːpɪ
geimskip	ceimscɪːp
hví	kʰviː
saurblað	søyrplaːð
úkraínska	uːkʰrainska
jafnaðarstefna	japnaːðarstɛpna
samkoma	samkʰɔːma
lykt	lɪxt
ungverska	uŋkvɛr̥ska
vol	vɔːl
hrjósa	r̥jouːsa
tál	tʰauːl
þyrluvöllur	θɪrtlʏvœtlʏr
nemi	nɛːmɪ
hadda	hatːa
hersegóvína	hɛr̥sɛːkouːviːna
hriki	r̥ɪːcɪ
doðrantur	tɔðran̥tʏr
ofvæni	ɔvvaiːnɪ
kokkur	kʰɔhkʏr
snerta	snɛr̥ta
kennari	cʰɛnːaːrɪ
briskirtill	prɪːscʰɪr̥tɪtl
skrúðhús	skruːðhuːs
pláss	pʰlausː
svarthol	svar̥thɔːl
milljónamæringur	mɪljouːnamaiːriŋkʏr
knöttur	kʰnœhtʏr
drynja	trɪnja
fyrirferðarmikill	fɪːrɪrfɛrðarmɪːcɪtl
hornabolti	hɔrtnapɔl̥tɪ
sænska	sainska
framlag	framlaːɣ
þrýstinn	θristɪnː
mennt	mɛn̥t
kosning	kʰɔstniŋk
fórinta	fouːrɪn̥ta
úlfaldi	ulvaltɪ
kantaraborg	kʰan̥tarapɔrk
vasareiknir	vaːsareihknɪr
hægð	haiɣð
schiöth	scœht
rúmteppi	rumtʰɛhpɪ
bernhöft	pɛrnhœft
ryðönd	rɪːðœnt
samvinna	samvɪnːa
kvarta	kʰvar̥ta
mannvirðing	manːvɪrðiŋk
sonur	sɔːnʏr
sessunautur	sɛsːʏnøyːtʏr
skratti	skrahtɪ
amöba	aːmœːpa
yfirlit	ɪːvɪrlɪːt
leðurblaka	lɛːðʏrplaːka
jarðhiti	jarðhɪːtɪ
kenjóttur	cʰɛnjouhtʏr
loforð	lɔːvɔrð
þenja	θɛnja
gum	kʏːm
lessa	lɛsːa
hrat	r̥aːt
kefli	cʰɛplɪ
snepill	stnɛːpɪtl
hornafall	hɔtnafatl
hafmey	havmeiː
kalkspat	kʰal̥kspaːt
brekka	prɛhka
spói	spouːɪ
dagsetning	taxsɛhtniŋk
hráki	r̥auːcɪ
stofnfélagi	stɔpnfjɛːlaːjɪ
fægja	faiːja
gæruskinn	caiːrʏscɪnː
konungsveldi	kʰɔːnuŋksvɛltɪ
afrískur	aːfriskʏr
nemandi	nɛːmantɪ
sjöa	sjœːa
kúpull	kʰuːpʏtl
hallgerður	hatlcɛrðʏr
sviftifall	svɪftɪfatl
riddari	rɪtːarɪ
guðleysi	kvʏðleiːsɪ
methafi	mɛːthaːvɪ
afgangur	avkauŋkʏr
skoti	skɔːtɪ
þegja	θeiːja
lúi	luːɪ
bátaskýli	pauːtasciːlɪ
hrefna	r̥ɛpna
bál	pauːl
metri	mɛːtrɪ
puða	pʰʏːða
miðmynd	mɪðmɪnt
línulega	liːnʏlɛːɣa
ísaumur	iːsøyːmʏr
spánarkerfill	spauːnarcʰɛrvɪtl
fylgja	fɪlca
gengur	ceiŋkʏr
fjallafinka	fjatlafiŋ̊ka
farsakenndur	far̥sacʰɛntʏr
gjöf	cœːv
eiturlyf	eiːtʏrlɪːv
andlagsfall	antlaxsfatl
bakpoki	paːkpʰɔːcɪ
grænlenskur	krainlɛnskʏr
værð	vairð
skógur	skouːʏr
skipting	scɪftiŋk
rýr	riːr
kúnni	kʰunːɪ
þrífa	θriːva
majór	majouːr
gissunn	cɪsːʏnː
réna	rjɛːna
hverfa	kʰvɛrva
skran	skraːn
rið	rɪːð
stutt	stʏht
pjatla	pʰjahtla
innsog	ɪnːsɔːk
dýr	tiːr
risi	rɪːsɪ
ríta	riːta
greifi	kreiːvɪ
gervitungl	cɛrvɪtʰuŋl
bílskúr	pilskuːr
hönk	høyŋ̊k
lára	lauːra
fræva	fraiːva
útlönd	uːtlœnt
ljósbjalla	ljouːspjatla
eyja	eiːja
blessa	plɛsːa
grunnur	krʏnːʏr
tara	tʰaːra
kisa	cʰɪːsa
aragrúi	aːrakruːɪ
siðvenja	sɪðvɛnja
illska	ilska
breiddarleit	preitːarleiːt
svipur	svɪːpʏr
hjúkrunarfræði	çuːkrʏnarfraiːðɪ
tónkvísl	tʰounkʰvistl
gryfja	krɪvja
embætti	ɛmpaihtɪ
hundrað	hʏntraːð
litningsendi	lɪhtniŋksɛntɪ
língresi	linkrɛːsɪ
gamansamur	kaːmansaːmʏr
ryð	rɪːð
hleri	l̥ɛːrɪ
frændhygli	frainthɪklɪ
gildi	cɪltɪ
áður	auːðʏr
íþróttahús	iːθrouhtahuːs
jarl	jartl
lífsgleði	lifsklɛːðɪ
netafræði	nɛːtafraiːðɪ
hvert	kʰvɛr̥t
eldspýta	ɛltspiːta
sem	sɛm
ljósmyndavél	ljouːsmɪntavjɛːl
hórdómur	hourtouːmʏr
sverð	svɛrð
flugvöllur	flʏɣvœtlʏr
hálmgresi	haulmkrɛːsɪ
rún	ruːn
bleikja	pleiːca
ljúka	ljuːka
minning	mɪnːiŋk
dúdúfugl	tuːtuːfʏkl
frumeind	frʏːmeint
dýrahringur	tiːrar̥iŋkʏr
hjólhýsi	çoulhiːsɪ
sáta	sauːta
ætur	aiːtʏr
koffort	kʰɔfːɔr̥t
pels	pʰɛls
lasinn	laːsɪnː
skelfiskur	scɛːlfɪskʏr
drykkjarvatn	trɪhcarvahtn
landsvæði	lantsvaiːðɪ
bjargmundur	pjarkmʏntʏr
demantur	tɛːman̥tʏr
ske	scɛː
fyrirferð	fɪːrɪrfɛrð
daunn	tøytn
kertastjaki	cʰɛr̥tastjaːcɪ
þrábiðja	θrauːpɪðja
skjáborð	scauːpɔrð
atlot	aːtlɔːt
rífa	riːva
heimþrá	heimθrauː
dólgslegur	toulkslɛːɣʏr
kynhneigð	cʰɪnn̥eiɣð
galli	katlɪ
trompet	tʰrɔm̥pɛːt
hljóðfæri	l̥jouðfaiːrɪ
tóm	tʰouːm
ugga	ʏkːa
spinna	spɪnːa
liggja	lɪcːa
káeta	kʰauːɛːta
ódýr	ouːtiːr
þolfall	θɔlfatl
sigur	sɪːɣʏr
egglos	ɛkːlɔːs
málari	mauːlaːrɪ
kústur	kʰustʏr
mars	mar̥s
netkorn	nɛːtkʰɔrtn
þríhliða	θriːl̥ɪːða
bíða	piːða
gerði	cɛrðɪ
uppblástur	ʏhpplaustʏr
regnþykkni	rɛknθɪhknɪ
kryfja	kʰrɪvja
höfrungur	hœvruŋkʏr
orðstír	ɔrðstʰiːr
þrefa	θrɛːva
hvatur	xʷaːtʏr
spöng	spøyŋk
þumall	θʏːmatl
ról	rouːl
amba	ampa
undur	ʏntʏr
efja	ɛvja
bera	pɛːra
stífkrampi	stivkʰram̥pɪ
láta	lauːta
bær	paiːr
unnur	ʏnːʏr
óþarflega	ouːθarvlɛːɣa
hnegg	n̥ɛkː
duglaus	tʏɣløyːs
tennis	tʰɛnːɪs
áki	auːcɪ
sýkill	siːcɪtl
hrynji	r̥ɪnjɪ
bráður	prauːðʏr
lambaklukka	lampakʰlʏhka
fleirtala	fleir̥taːla
hlýða	l̥iːða
bak	paːk
nágrenni	nauːkrɛnːɪ
vísifingur	viːsɪfiŋkʏr
munnur	mʏnːʏr
valda	valta
pönk	pʰøyŋ̊k
tröllatré	tʰrœtlatʰrjɛː
kraftaverk	kʰraftavɛr̥k
afla	apla
förðun	fœrðʏn
töluverður	tʰœːlʏvɛrðʏr
býfur	piːvʏr
túrbína	tʰurpiːna
laf	laːv
kasheitur	kaːsheiːtʏr
krappur	kʰrahpʏr
fagur	faːɣʏr
aðstæður	aðstaiːðʏr
tískupallur	tʰɪskʏpʰatlʏr
ævi	aiːvɪ
þjóðverji	θjouðvɛrjɪ
hópferð	houːpfɛrð
minnimáttarkennd	mɪnːɪmauhtarcʰɛnt
budda	pʏtːa
skellihlæja	scɛtlɪl̥aiːja
rota	rɔːta
sýr	siːr
merkur	mɛr̥kʏr
velta	vɛl̥ta
streða	strɛːða
sögusögn	sœːɣʏsœkn
ritill	rɪːtɪtl
æstur	aistʏr
einvetni	einvɛhtnɪ
arabískur	aːrapiskʏr
flugvél	flʏɣvjɛːl
hormón	hɔrmouːn
mistilteinn	mɪstɪltʰeitn
gæði	caiːðɪ
bremsa	prɛmsa
borð	pɔrð
híbýli	hiːpiːlɪ
bjór	pjouːr
húðsjúkdómafræði	huːðsjuktouːmafraiːðɪ
lambakjöt	lampacʰœːt
dey	teiː
flaska	flaska
hlað	l̥aːð
kornsúra	kʰɔrtnsuːra
strætisvagn	straiːtɪsvakn
skagi	skaːjɪ
jóhanna	jouːhanːa
dunda	tʏnta
nef	nɛːv
kjökur	cʰœːkʏr
grautur	krøyːtʏr
fornenska	fɔrtnɛnska
eyða	eiːða
vettvangur	vɛhtvauŋkʏr
vík	viːk
bæheimskur	paiːheimskʏr
þrenning	θrɛnːiŋk
beður	pɛːðʏr
herdís	hɛrtiːs
núpur	nuːpʏr
spíri	spiːrɪ
annar	anːar
hnúi	n̥uːɪ
lygari	lɪːɣaːrɪ
humar	hʏːmar
knattspyrnufélag	kʰnahtspɪrtnʏfjɛːlaːɣ
nauðsyn	nøyðsɪːn
helluhraun	hɛtlʏr̥øyːn
hræðsla	r̥aiðstla
gelda	cɛlta
granda	kranta
landakort	lantakʰɔr̥t
eldhúshnífur	ɛlthuːsn̥iːvʏr
rista	rɪsta
fleygur	fleiːɣʏr
taska	tʰaska
heilbrigði	heilprɪɣðɪ
víst	vist
ostakaka	ɔstakʰaːka
smakka	smahka
bylur	pɪːlʏr
hvá	xʷauː
háþrýstingur	hauːθristiŋkʏr
duft	tʏft
búrka	pur̥ka
ölmusa	œlmʏːsa
hel	hɛːl
sögur	sœːɣʏr
reigingur	reiːjiŋkʏr
polli	pʰɔlːɪ
framræsla	framraistla
vella	vɛtla
áhersla	auːhɛr̥stla
lífsspursmál	lifsspʏr̥smauːl
tár	tʰauːr
hlýðni	l̥iðnɪ
simpansi	sɪm̥pansɪ
sauðnaut	søyðnøyːt
lengd	leiŋkt
hæfileiki	haiːvɪleiːcɪ
kafari	kʰaːvarɪ
kundur	kʰʏntʏr
mæta	maiːta
fullyrðing	fʏtlɪrðiŋk
raðtala	raðtʰaːla
komutími	kʰɔːmʏtʰiːmɪ
niðjatal	nɪðjatʰaːl
brunahani	prʏːnahaːnɪ
svað	svaːð
jáeind	jauːeint
servíetta	sɛrviːjɛhta
sleggjukast	stlɛcːʏkʰast
meyr	meiːr
láki	lauːcɪ
trekkja	tʰrɛhca
hrapa	r̥aːpa
gró	krouː
hljóð	l̥jouːð
smók	smouːk
látbragð	lauːtpraɣð
peysa	pʰeiːsa
grár	krauːr
brjóstbein	prjoustpeiːn
stephensen	stɛːfɛnsɛn
sjónskertur	sjounscɛr̥tʏr
bæra	paiːra
þórey	θouːreiː
eðlilega	ɛðlɪlɛːɣa
tréblásturshljóðfæri	tʰrjɛːplaustʏr̥sl̥jouðfaiːrɪ
stríða	striːða
inséníör	ɪnsjɛːnijœːr
össuría	œsːʏriːja
kall	kʰatl
hirðingi	hɪrðiɲcɪ
hverfull	kʰvɛrvʏtl
veif	veiːv
sís	siːs
skyndilegur	scɪntɪlɛːɣʏr
tristan	tʰrɪstan
morgunverður	mɔrkʏnvɛrðʏr
hefti	hɛftɪ
lirfa	lɪrva
skot	skɔːt
beyging	peiːjiŋk
skriðlíngresi	skrɪðlinkrɛːsɪ
synd	sɪnt
hálfvirði	haulvvɪrðɪ
gjaldkeri	caltcʰɛːrɪ
leikur	leiːkʏr
plaga	pʰlaːɣa
fangelsa	fauŋcɛlsa
amaba	aːmaːpa
tvinna	tvɪnːa
auglýsing	øyɣliːsiŋk
þvinga	θviŋka
hjúkrun	çuːkrʏn
lúxus	luksʏs
soffía	sɔfːiːja
parís	pʰaːriːs
friða	frɪːða
kirtill	cʰɪr̥tɪtl
hvítá	xʷiːtauː
auðnutittlingur	øyðnʏtʰɪhtliŋkʏr
innritun	ɪnːrɪːtʏn
hlæja	l̥aiːja
agða	aɣða
bráðna	prauðna
erfiðisvinna	ɛrvɪːðɪsvɪnːa
handbók	hantpouːk
hvar	kʰvaːr
keppa	cʰɛhpa
hnúskur	n̥uskʏr
fjarstýring	fjar̥stiːriŋk
skreyta	skreiːta
hjörtína	çœr̥tiːna
þvottabjörn	θvɔhtapjœrtn
gista	cɪsta
undirbúningur	ʏntɪrpuːniŋkʏr
stör	stœːr
hálfendir	haulvɛntɪr
gumi	kʏːmɪ
kristindómur	kʰrɪstɪntouːmʏr
afríkufíll	aːfriːkʏfitl
þarfaþing	θarvaθiŋk
búmaður	puːmaːðʏr
fulltrúi	fʏtl̥tʰruːɪ
mosagróinn	mɔːsakrouːɪnː
kyrrsetning	cʰɪrsɛhtniŋk
fótur	fouːtʰʏr
mötunautur	mœːtʏnøyːtʏr
byrði	pɪrðɪ
augnhár	øyknhauːr
rakvél	raːkvjɛːl
kátur	kʰauːtʏr
illmæli	ɪtlmaiːlɪ
snös	snœːs
marra	marːa
hýsill	hiːsɪtl
lekur	lɛːkʏr
mjöður	mjœːðʏr
verkaskipting	vɛr̥kascɪftiŋk
ómerkilegur	oumɛr̥cɪlɛːɣʏr
bassetthorn	pasːɛhthɔrtn
goði	kɔːðɪ
keisaraskurður	cʰeiːsaːraskʏrðʏr
alræði	alraiːðɪ
jarðskjálftafræði	jarðscaul̥tafraiːðɪ
loðfíll	lɔðfitl
dílaskarfur	tiːlaskarvʏr
blæjuber	plaiːjʏpɛːr
eplamauk	ɛhplamøyːk
slæða	sl̥aiːða
hringl	r̥iŋl
heimalið	heiːmalɪːð
skoðun	skɔːðʏn
svona	svɔːna
munaðarleysingjahæli	mʏːnaːðarleiːsiɲcahaiːlɪ
blóðskömm	plouðskœmː
meistari	meistaːrɪ
lind	lɪnt
eftirmáli	ɛftɪrmauːlɪ
styrkleiki	stɪr̥kleiːcɪ
séríslenskur	sjɛːristlɛnskʏr
túnvorblóm	tʰunvɔrplouːm
mannvirki	manːvɪr̥cɪ
reyna	reiːna
kafbátur	kʰavpauːtʏr
herkúles	hɛr̥kuːlɛːs
gella	cɛlːa
tölva	tʰœlva
blunda	plʏnta
kjallari	cʰatlaːrɪ
veð	vɛːð
alaskavíðir	aːlaskaviːðɪr
kássa	kʰausːa
íspinni	iːspʰɪnːɪ
guma	kʏːma
kringla	kʰriŋla
laut	løyːt
gestrisni	cɛstrɪstnɪ
fataskápur	faːtaskauːpʏr
skeggburkni	scɛkːpʏr̥knɪ
einglyrni	einklɪrtnɪ
kartafla	kar̥tapla
biðtími	pɪðtʰiːmɪ
stofnun	stɔpnʏn
geðveikur	cɛðveiːkʏr
lauga	løyːɣa
útgáfa	uːtkauːva
kringlóttur	kʰriŋlouhtʏr
foreldrar	fɔːrɛltrar
ló	louː
stig	stɪːɣ
engill	eiɲcɪtl
ragnheiður	raknheiːðʏr
humall	hʏːmatl
litín	lɪːtʰiːn
koddaver	kʰɔtːavɛːr
aðstoð	aðstɔːð
kex	cʰɛxs
stjörnuspeki	stjœrtnʏspɛːcɪ
skipasmiður	scɪːpasmɪːðʏr
móður	mouːðʏr
hopp	hɔhp
kala	kʰaːla
skíta	sciːta
rætur	raiːtʏr
bleyta	pleiːta
knipla	kʰnɪhpla
beitiland	peiːtɪlant
breiðþota	preiðθɔːta
valdína	valtiːna
áhrifssögn	auːr̥ifssœkn̥
hrútur	r̥uːtʏr
snákur	stnauːkʏr
orki	ɔr̥cɪ
grjóni	krjouːnɪ
gælunafn	caiːlʏnapn
skokka	skɔhka
fylgdarmaður	fɪltarmaːðʏr
þráðsef	θrauðsɛːv
þakkagjörð	θahkacœrð
gretta	krɛhta
fordómur	fɔrtouːmʏr
staðhæfing	staðhaiːviŋk
þrengja	θreiɲca
segð	sɛɣð
eldpipar	ɛltpɪːpar
þjá	θjauː
rísa	riːsa
stjórnborði	stjourtnpɔrðɪ
svíkja	sviːca
skarð	skarð
böl	pœːl
uppskurður	ʏhpskʏrðʏr
manngera	manːcɛːra
lúterskur	luːtʰɛr̥skʏr
ögmunda	œɣmʏnta
gaupa	køyːpa
kölkun	kʰœl̥kʏn
rúm	rumː
slíkur	stliːkʏr
dökkasef	tœhkasɛːv
tilfinningaleysi	tʰɪlfɪnːiŋkaleiːsɪ
hlust	l̥ʏst
ritari	rɪːtarɪ
slútta	stluhta
eiginhandaráritun	eiːjɪnhantarauːrɪːtʏn
dugnaður	tʏɣnaːðʏr
klossi	kʰlɔsːɪ
arnmundur	artnmʏntʏr
sídd	sitː
rósemi	rouːsɛːmɪ
tankur	tʰauŋ̊kʏr
kolkrabbi	kʰɔlkʰrapːɪ
lunga	luŋka
stefnuljós	stɛpnʏljouːs
gildur	cɪltʏr
börur	pœːrʏr
borga	pɔrka
leira	leiːra
hansen	hansɛnː
fjötur	fjœːtʏr
legvatn	lɛɣvahtn
líða	liːða
logri	lɔɣrɪ
falstur	falstʏr
sturta	stʏr̥ta
stokkhólmur	stɔhkhoulmʏr
vefa	vɛːva
tala	tʰaːla
sökk	sœhk
rammi	ramːɪ
geisli	ceistlɪ
þjónusta	θjouːnʏsta
kjúka	cʰuːka
húsgagn	huːskakn
augntönn	øykntʰœnː
lystauki	lɪstøyːcɪ
kynngi	cʰiɲcɪ
bæklingur	paihkliŋkʏr
tríóla	tʰriːjouːla
geta	cɛːta
kaktus	kʰaxtʏs
frumvarp	frʏmvar̥p
erfiða	ɛrvɪːða
gargönd	karkœnt
bágur	pauːʏr
öryggisstig	œːrɪcːɪsstɪːɣ
langkrækill	lauŋkkʰraiːcɪtl
eftirlit	ɛftɪrlɪːt
vilmundur	vɪlmʏntʏr
árangur	auːrauŋkʏr
undanfari	ʏntanfaːrɪ
þumalputtaregla	θʏːmalpʰʏhtarɛkla
garðyrkja	karðɪr̥ca
páskaegg	pʰauskaɛkː
tyrkland	tɪr̥klant
andlag	antlaːɣ
ball	palː
kór	kʰouːr
leikari	leiːkaːrɪ
staðhæfa	staðhaiːva
stæra	staiːra
þáttaskil	θauhtaskɪːl
framtíðarfræði	framtiːðarfraiːðɪ
dauðadá	tøyːðatauː
lundur	lʏntʏr
blástur	plaustʏr
bjartsýnn	pjar̥tsitn
fregna	frɛkna
ambaga	ampaːɣa
nielsen	nilsɛnː
kímblað	cʰimplaːð
hrörnun	r̥œrtnʏn
þumbari	θʏmparɪ
tína	tʰiːna
þræll	θraitl
karlmaður	kʰartlmaːðʏr
afráða	avrauːða
lægja	laiːja
hvorugkyn	xʷɔːrʏɣcʰɪːn
kyssilegur	cʰɪsːɪlɛːɣʏr
dýflissa	tiplɪsːa
gunnarína	kʏnːaːriːna
kafli	kʰaplɪ
hneggja	n̥ɛcːa
hnykkur	n̥ɪhkʏr
þrenna	θrɛnːa
stæla	staiːla
andrésína	antrjɛːsiːna
saðning	saðniŋk
rusla	rʏstla
pakki	pʰahcɪ
hornabolti	hɔtnapɔl̥tɪ
gróði	krouːðɪ
rigna	rɪkna
metanól	mɛːtʰaːnouːl
afgreiða	avkreiːða
hafragrautur	havrakrøyːtʏr
gráðubogi	krauːðʏpɔːjɪ
bylja	pɪlja
handbremsa	hantprɛmsa
roðasteinn	rɔːðasteitn
kýpur	cʰiːpʏr
veiklun	veihklʏn
eiginleiki	eiːjɪnleiːcɪ
fat	faːt
erfðafræði	ɛrvðafraiːðɪ
yfirdrepsskapur	ɪːvɪrtrɛpsskaːpʏr
reglulegur	rɛklʏlɛːɣʏr
gistihús	cɪstɪhuːs
hnéskel	n̥jɛːscɛːl
karfa	kʰarva
þeyr	θeiːr
haus	høyːs
vestri	vɛstrɪ
úði	uːðɪ
sigmundína	sɪɣmʏntiːna
litaröð	lɪːtarœːð
beinagrind	peiːnakrɪnt
eymundur	eiːmʏntʏr
þörungur	θœːruŋkʏr
deig	teiːɣ
tær	tʰaiːr
sí	siː
gjóska	couska
kjarkur	cʰar̥kʏr
sleipa	stleiːpa
gnótt	knouht
bruna	prʏːna
látún	lauːtuːn
tárvotur	tʰaurvɔːtʏr
dýpi	tiːpɪ
sorg	sɔrk
aðfella	aðfɛtla
rækja	raiːca
platína	pʰlaːtʰiːna
smokks	smɔhks
ládauður	lauːtøyːðʏr
vasapeli	vaːsapʰɛːlɪ
hörpuskel	hœr̥pʏscɛːl
mánuður	mauːnʏːðʏr
hrossanál	r̥ɔsːanauːl
styrja	stɪrja
hefta	hɛfta
guðspjallamaður	kvʏðspjatlamaːðʏr
minnisspil	mɪnːɪsspɪːl
dökkhæra	tœhkhaiːra
tog	tʰɔːɣ
ómstríður	oumstriːðʏr
þríleikur	θriːleiːkʏr
johnsen	jounsɛːnː
konunglegur	kʰɔːnuŋklɛːɣʏr
hálfbróðir	haulvprouːðɪr
matur	maːtʏr
sjávarfugl	sjauːvarfʏkl
kilja	cʰɪlja
piss	pʰɪsː
landbúnaður	lantpuːnaːðʏr
ofviðri	ɔvvɪðrɪ
gimsteinn	cɪmsteitn
svæla	svaiːla
glötun	klœːtʏn
bónus	pouːnʏs
drepsótt	trɛːpsouht
jarðfræði	jarðfraiːðɪ
fýsn	fistn
breiður	preiːðʏr
korpönd	kʰɔr̥pœnt
skurður	skʏrðʏr
móasef	mouːasɛːv
ýmis	iːmɪs
leyfi	leiːvɪ
sjúkur	sjuːkʏr
góður	kouːðʏr
búnt	pun̥t
rykkilín	rɪhcɪliːn
tígrisdýr	tʰiːkrɪstiːr
pétti	pʰjɛhtɪ
ánægjulegur	auːnaijʏlɛːɣʏr
kíf	cʰiːv
hálskirtill	haulscɪrtɪtl
kjötkveðjuhátíð	cʰœtkʰvɛðjʏhauːtʰiːð
metnaður	mɛhtnaːðʏr̥
glæpamaður	klaiːpamaːðʏr
stafa	staːva
heftivír	hɛftɪviːr
hata	haːta
áhersluatviksorð	auːhɛr̥stlʏaːtvɪksɔrð
jaðar	jaːðar
einær	eiːnaiːr
kálfur	kʰaulvʏr
biðvarsla	pɪðvarstla
þannig	θanːɪɣ
rimma	rɪmːa
hneigja	n̥eiːja
botnfall	pɔhtnfatl
wiium	viːjʏm
lúxus	luxsʏs
norðmaður	nɔrðmaːðʏr
þeyja	θeiːja
ok	ɔːk
klaki	kʰlaːcɪ
teskeið	tʰɛːskeiːð
kommúnisti	kʰɔmːuːnɪstɪ
vídd	vitː
álft	aulft
skeyta	sceiːta
æska	aiska
ljósta	ljousta
brúskur	pruskʏr
skikkja	skɪhca
kýta	cʰiːta
waage	vɔːɣɛː
ljósfræði	ljouːsfraiːðɪ
kippur	cʰɪhpʏr
rófa	rouːva
ferjumaður	fɛrjʏmaːðʏr
stirfinn	stɪrvɪnː
gana	kaːna
kvíða	kʰviːða
eystra	eistra
reykvískur	reiːkviskʏr
rimill	rɪːmɪtl
íslendingur	istlɛntiŋkʏr
skárri	skaurːɪ
etja	ɛːtja
sandstormur	santstɔrmʏr
rússland	rustlant
ljúfra	ljuvra
stjórnleysi	stjourtnleiːsɪ
titringur	tʰɪːtriŋkʏr
skíðhvalur	sciðxʷaːlʏr
bréfaklemma	prjɛːvakʰlɛmːa
sæla	saiːla
orðhlutafræði	ɔrðl̥ʏːtafraiːðɪ
þorn	θɔtn
regnkápa	rɛknkʰauːpa
kvæna	kʰvaiːna
sveit	sveiːt
alúðlega	aːluðlɛːɣa
beikon	peiːkʰɔn
kæfa	cʰaiːva
hómófóbía	houːmouːfouːpiːja
glúmur	kluːmʏr
korsíka	kʰɔr̥siːka
flokka	flɔhka
blessun	plɛsːʏn
hárkolla	hauːrkʰɔtla
marglytta	marklɪhta
hnigna	n̥ɪkna
aðalbraut	aːðalprøyːt
dós	touːs
flá	flauː
regnskógur	rɛknskouːʏr
torfa	tʰɔrva
tíska	tʰiska
klípa	kʰliːpa
bavíani	paːviːaːnɪ
finnbogi	fɪnpɔjɪ
körfubolti	kʰœrvʏpɔl̥tɪ
óáreiðanlegur	ouːauːreiːðanlɛːɣʏr
neópren	nɛːouːpʰrɛːn
franska	franska
millimetri	mɪlːɪmɛːtrɪ
brottför	prɔhtfœːr
grugg	krʏkː
kistill	cʰɪstɪtl
símasamband	siːmasampant
fréttastofa	frjɛhtastɔːva
móðursystir	mouːðʏrsɪstɪr
aukaspyrna	øyːkaspɪrtna
lýra	liːra
einræði	einraiːðɪ
neptúnus	nɛftʰuːnʏs
svitna	svɪhtna
lín	liːn
mjólkurkýr	mjoul̥kʏrcʰiːr
ilma	ɪlma
máfur	mauːvʏr
gervigígur	cɛrvɪciːɣʏr
braggi	pracːɪ
tékki	tʰjɛhcɪ
fjallganga	fjatl̥kauŋka
kerfill	cʰɛrvɪtl
framkvæma	framkʰvaiːma
þykkni	θɪhknɪ
stafli	staplɪ
gjaldeyrir	calteiːrɪr
árás	auːrauːs
jóný	jouːniː
georgía	cɛːɔrciːja
gulstör	kʏlstœːr
bogastrengur	pɔːɣastreiŋkʏr
beygingardæmi	peiːjiŋkartaiːmɪ
rustikus	rʏstɪkʰʏs
mínípils	miːnipʰɪls
þúsund	θuːsʏnt
eind	eint
ákavíti	auːkaviːtɪ
fen	fɛːn
stara	staːra
brynja	prɪnja
þys	θɪːs
hveiti	xʷeiːtɪ
spjör	spjœːr
rifrildi	rɪvrɪltɪ
skógarfura	skouːarfʏːra
fimleikar	fɪmleiːkar
atvik	aːtvɪːk
kerfi	cʰɛrvɪ
kjöltutölva	cʰœl̥tʏtʰœlva
faðirvor	faːðɪrvɔːr
tryggur	tʰrɪkːʏr
baka	paːka
dvöl	tvœːl
rós	rouːs
hornafræði	hɔrtnafraiːðɪ
vatt	vaht
hnykkja	n̥ɪhca
lýsi	liːsɪ
orðtak	ɔrðtʰaːk
dorma	tɔrma
skeggsandi	scɛkːsantɪ
vinda	vɪnta
silungur	sɪːluŋkʏr
dauði	tøyːðɪ
spilling	spɪtliŋk
hróp	r̥ouːp
við	vɪð
freðinn	frɛːðɪnː
fretta	frɛhta
ástand	auːstant
dósahnífur	touːsan̥iːvʏr
mana	maːna
þrábeiðni	θrauːpeiðnɪ
bolsi	pɔlsɪ
kínasi	cʰiːnaːsɪ
akarn	aːkʰartn
putti	pʰʏhtɪ
háspil	hauːspɪːl
andlát	antlauːt
spurnaratviksorð	spʏrtnaraːtvɪksɔrð
maí	maiː
refsa	rɛfsa
drottningarhrókur	trɔhtniŋkarr̥ouːkʏr
slá	stlauː
linditré	lɪntɪtʰrjɛː
frygð	frɪɣð
depill	tɛːpɪtl
ferilskrá	fɛːrɪlskrauː
dys	tɪːs
indriðason	ɪntrɪːðasɔːn
bylta	pɪl̥ta
melgresi	mɛlkrɛːsɪ
ginna	cɪnːa
duna	tʏːna
píka	pʰiːka
arabíska	aːrapiska
hefð	hɛvð
skollakambur	skɔtlakʰampʏr
þingforseti	θiŋkfɔr̥sɛːtɪ
prófsumma	pʰroufsʏmːa
útvarp	uːtvar̥p
eðla	ɛðla
ges	cɛːs
tæpur	tʰaiːpʏr
mynda	mɪnta
himinn	hɪːmɪnː
skóglaus	skouɣløyːs
kusa	kʰʏːsa
veldi	vɛltɪ
hvatberi	kʰvatpɛːrɪ
festi	fɛstɪ
undirskrift	ʏntɪrskrɪft
þúfa	θuːva
ósíris	ouːsiːrɪs
geirþrúður	ceir̥θruːðʏr
safi	saːvɪ
geirfríður	ceir̥friːðʏr
hausta	høysta
sáð	sauːð
rjómi	rjouːmɪ
jarðhneta	jarðn̥ɛːta
hnetusmjör	n̥ɛːtʏsmjœːr
hljóðbók	l̥ouðpouːk
ha	haː
bann	panː
tiltekinn	tʰɪːltʰɛːcɪnː
byssustingur	pɪsːʏstiŋkʏr
dreypa	treiːpa
hreinsun	r̥einsʏn
hermd	hɛrmt
manneskja	manːɛsca
flaust	fløyst
klemens	kʰlɛːmɛns
strik	strɪːk
hugaræsing	hʏːɣaraiːsiŋk
nafar	naːvar
markgreifi	mar̥kkreiːvɪ
lýðræðisríki	liðraiːðɪsriːcɪ
gjamm	camː
látæði	lauːtaiːðɪ
auka	øyːka
vörður	vœrðʏr
faðmur	faðmʏr
hnappaborð	n̥ahpapɔrð
hlessa	l̥ɛsːa
janúar	jaːnuːaːr
erindi	ɛːrɪntɪ
höfn	hœpn
pendúll	pʰɛntʏtl
ofnæmi	ɔvnaiːmɪ
teygjanleiki	tʰeiːjanleiːcɪ
mænudeyfing	maiːnʏteiːviŋk
leikkona	leiːkkʰɔːna
salvi	salvɪ
bolludagur	pɔlːʏtaːɣʏr
miðaldalatína	mɪːðaltalaːtiːna
endurlífgun	ɛntʏrlivkʏn
bjarnharður	pjartnharðʏr
rekja	rɛːca
færeyskur	faiːreiskʏr
rjúfa	rjuːva
nýfæddur	niːfaitːʏr
silfursóley	sɪlvʏrsouːleiː
aðgát	aðkauːt
galgopi	kalkɔːpɪ
smjörlauf	smjœrløyːv
ferma	fɛrma
lifandi	lɪːvantɪ
uppdatera	ʏhptatʰɛːra
hópur	houːpʏr
altari	al̥tarɪ
ljúga	ljuːa
vepja	vɛːpja
fappa	fahpa
herri	hɛrːɪ
endurskoðandi	ɛntʏrskɔːðantɪ
örvun	œrvʏn
hvirfilbylur	kʰvɪrvɪlpɪːlʏr
drusla	trʏstla
lifa	lɪːva
efedrín	ɛːfɛːtriːn
smali	smaːlɪ
kvennabósi	kʰvɛnːapouːsɪ
kolvetni	kʰɔlvɛhtnɪ
hyrni	hɪrtnɪ
áll	autl
hekk	hɛhk
þel	θɛːl
bankaútibú	pauŋ̊kauːtɪpuː
örlög	œrlœːɣ
sárasótt	sauːrasouht
klúður	kʰluːðʏr
steinþór	steinθouːr
braut	prøyːt
össurína	œsːʏriːna
blíður	pliːðʏr
gæfumunur	caiːvʏmʏːnʏr
cé	sjɛː
bór	pouːr
hreysi	r̥eiːsɪ
hvöt	xʷœːt
flýta	fliːta
skurðaðgerð	skʏrðaðcɛrð
vök	vœːk
hyrnd	hɪrnt
hrella	r̥ɛtla
kona	kʰɔːna
sýning	siːniŋk
mosalyng	mɔːsaliŋk
styggja	stɪcːa
loka	lɔːka
göldróttur	kœltrouhtʏr
siga	sɪːɣa
mosafræði	mɔːsafraiːðɪ
eggjarauða	ɛcːarøyːða
bólga	poulka
gas	kaːs
lexía	lɛxsiːja
narfi	narvɪ
haki	haːcɪ
reiða	reiːða
lundir	lʏntɪr
heilsa	heilsa
meingjörð	meincœrð
banabeður	paːnapɛːðʏr
pexa	pʰɛxsa
jóð	jouːð
slarkari	stlar̥karɪ
vondur	vɔntʏr
eyrnamergur	eirtnamɛrkʏr
sæma	saiːma
léttir	ljɛhtɪr
mund	mʏnt
hamingja	haːmiɲca
draga	traːɣa
veira	veiːra
hlíf	l̥iːv
frjó	frjouː
hjúpur	çuːpʏr
gilitrutt	cɪːlɪtʰrʏht
guðlaugur	kvʏðløyːɣʏr
rusti	rʏstɪ
brjóstkassi	prjoustkʰasːɪ
hráolía	r̥auːɔːlija
synja	sɪnja
hringvöðvi	r̥iŋkvœðvɪ
dingull	tiŋkʏtl
árlegur	auːrlɛɣʏr
spila	spɪːla
snigill	snɪːjɪtl
aðalskrifstofa	aːðalskrifstɔːva
rjátla	rjauhtla
starfsemi	starvsɛːmɪ
reynsla	reinstla
vandi	vantɪ
tordýfill	tʰɔrtiːvɪl̥
stjóri	stjouːrɪ
loft	lɔft
júlímánuður	juːliːmauːnʏðʏr
næringarfræðingur	naiːriŋkarfraiːðiŋkʏr
gapa	kaːpa
stöð	stœːð
ásókn	auːsouhkn
dylgja	tɪlca
hrasa	r̥aːsa
býfluga	piːflʏːɣa
girnd	cɪrnt
seiði	seiːðɪ
amma	amːa
flísatöng	fliːsatʰøyŋk
rödd	rœtː
helgidagur	hɛlcɪtaːɣʏr
nöldur	nœltʏr
lakk	lahk
óbeinn	ouːpeitn
freknóttur	frɛhknouhtʏr
leiða	leiːða
mengun	meiŋkʏn
land	lant
hvítlaukur	xʷiːtløyːkʏr
eilífð	eiːlivð
ástaróbó	austarouːpouː
krem	kʰrɛːm
náðhús	nauðhuːs
rella	rɛtla
auðmýking	øyðmiːciŋk
tapa	tʰaːpa
herfugl	hɛːrfʏkl
geislamaðra	ceistlamaðra
hvati	kʰvaːtɪ
búri	puːrɪ
hver	kʰvʏːr
blálanga	plauːlauŋka
efnahagur	ɛpnahaːɣʏr
grasvíðir	kraːsviːðɪr
indæll	ɪntaitl
rabba	rapːa
né	njɛː
tjá	tʰjauː
brydda	prɪtːa
froskur	frɔskʏr
nefnari	nɛpnaːrɪ
breiðnefur	preiðnɛːvʏr
blána	plauːna
kunnur	kʰʏnːʏr
kristinn	kʰrɪstɪnː
næra	naiːra
karma	kʰarma
úti	uːtɪ
rangla	rauŋla
fjölmiðlasaga	fjœlmɪðlasaːɣa
pétursborg	pʰjɛːtʏr̥spɔrk
vinabær	vɪːnapaiːr
hjú	çuː
flenna	flɛnːa
fjölkvæni	fjœlkʰvaiːnɪ
kassi	kʰasːɪ
rugla	rʏkla
slóra	stlouːra
sælgæti	sailcaiːtɪ
lát	lauːt
guðmundur	kvʏðmʏntʏr
péttneska	pʰjɛhtnɛska
stál	stauːl
bergdís	pɛrktiːs
hollenska	hɔllɛnska
klósigi	kʰlouːsɪːjɪ
hræsni	r̥aistnɪ
halldórsdóttir	haltour̥stouhtɪr
hyggjuvit	hɪcːʏvɪːt
herkvaðning	hɛr̥kʰvaðniŋk
stari	staːrɪ
dýrkun	tir̥kʏn
brautarstöð	prøyːtarstœːð
kíll	cʰitl
þjálfa	θjaulva
mæna	maiːna
yfirlæti	ɪːvɪrlaiːtɪ
afbrigði	avprɪɣðɪ
sveppur	svɛhpʏr
brunnur	prʏnːʏr
bræt	praiːt
erfiður	ɛrvɪːðʏr
fár	fauːr
neitun	neiːtʏn
skriflegur	skrɪvlɛːɣʏr
safnheiti	sapnheiːtɪ
miðlari	mɪðlaːrɪ
hvetja	xʷɛːtja
hvítkál	xʷiːtkʰauːl
öryggisfyrirtæki	œːrɪcːɪsfɪːrɪrtʰaiːcɪ
kjarnahvarf	cʰartnakʰvarv
daus	tøyːs
prímus	pʰriːmʏs
syndga	sɪntka
barín	paːriːn
systursonur	sɪstʏr̥sɔːnʏr
graður	kraːðʏr
stjúpmóðir	stjuːpmouːðɪr
illur	ɪtlʏr
mannorð	manːɔrð
lager	laːɣɛr
einstaklingur	einstakliŋkʏr
heimasæta	heiːmasaiːta
miðaldir	mɪːðaltɪr
meðleikur	mɛðleiːkʏr
vökvi	vœːkvɪ
eta	ɛːta
sem	sɛːm
grennd	krɛnt
forskeyti	fɔr̥sceiːtɪ
viti	vɪːtɪ
mura	mʏːra
galsi	kalsɪ
skammur	skamːʏr
spænska	spainska
þekking	θɛhciŋk
barnabarn	patnapatn
höfuðborg	hœːvʏðpɔrk
hleifur	l̥eiːvʏr
hveitiklíð	xʷeiːtɪkʰliːð
hefja	hɛvja
hvína	xʷiːna
lemúr	lɛːmuːr
sori	sɔːrɪ
kinka	cʰiŋ̊ka
láglendi	lauɣlɛntɪ
afganistan	avkaːnɪstaːn
páfugl	pʰauːfʏkl
kyrrseta	cʰɪrsɛːta
lögga	lœkːa
skraddari	skratːarɪ
kommi	kʰɔmːɪ
spik	spɪːk
læknisfræði	laihknɪsfraiːðɪ
postullegur	pʰɔstʏllɛːɣʏr
handsnyrting	hantstnɪr̥tiŋk
samhljómur	saml̥jouːmʏr
hobbiti	hɔpːɪːtɪ
heiðarleiki	heiːðarleiːcɪ
söðull	sœːðʏtl
bölvun	pœlvʏn
kynlaus	cʰɪnløyːs
ferskjutré	fɛr̥scʏtrjɛː
hagur	haːɣʏr
samvistarfall	samvɪstarfatl
aronsvöndur	aːrɔnsvœntʏr
stjarna	stjartna
graðhestur	kraːðhɛstʏr
hlykkja	l̥ɪhca
salt	sal̥t
petersen	pʰɛːtɛr̥sɛnː
ræðinn	raiːðɪn
sólskin	soulskɪːn
sínus	siːnʏs
afl	apl
sagnfræði	saknfraiːðɪ
tvístirni	tʰviːstɪrtnɪ
akbraut	aːkprøyːt
magapína	maːɣapʰiːna
reima	reiːma
vísigreifi	viːsɪkreiːvɪ
skauta	skøyːta
dýri	tiːrɪ
hjarni	çartnɪ
hella	hɛtla
dreyrasýki	treiːrasiːcɪ
bur	pʏːr
kvoða	kʰvɔːða
sýn	siːn
hjón	çouːn
sess	sɛsː
einstefnugata	einstɛpnʏkaːta
hinstur	hɪnstʏr
suðurland	sʏðʏrlant
tengdadóttir	tʰeiŋtatouhtɪr
skipun	scɪːpʏn
auðmýkja	øyðmiːca
skurðarborð	skʏrðarpɔrð
skógartoppur	skouːartʰɔhpʏr
hak	haːk
bismút	pɪsmuːt
vefsíða	vɛfsiːða
v	vafː
beita	peiːta
meina	meiːna
kaleikur	kʰaːleiːkʏr
mótun	mouːtʏn
fjallanóra	fjatlanouːra
púsluspil	pʰustlʏspɪːl̥
mæðraveldi	maiðravɛltɪ
niðurskurður	nɪːðʏrskʏrðʏr
rís	riːs
steytill	steiːtɪtl
vin	vɪːn
magnea	maknɛːa
smæra	smaiːra
laslegur	laːslɛːɣʏr
skólaár	skouːlaauːr
bronsöld	prɔnsœlt
næði	naiːðɪ
klökkna	kʰlœhkna
snípur	stniːpʏr
morfín	mɔr̥fiːn
elfur	ɛlvʏr
ægja	aiːja
grikki	krɪhcɪ
bæn	paiːn
bika	pɪːka
samþykki	samθɪhcɪ
kynslóð	cʰɪnstlouːð
piparúði	pʰɪːparuːðɪ
hádegisverður	hauːteiːjɪsvɛrðʏr
skyr	scɪːr
auðmundur	øyðmʏntʏr
blæðing	plaiːðiŋk
lækjafræhyrna	laiːcafraiːhɪrtna
mýrasóley	miːrasouːleiː
sæng	saiŋk
megna	mɛkna
úldinn	ultɪnː
hjartarfi	çar̥tarvɪ
hrappur	r̥ahpʏr
víkja	viːca
himna	hɪmna
barbari	parpaːrɪ
kampur	kʰam̥pʏr
eipa	eiːpa
hengistör	heiɲcɪstœːr
útdráttur	uːttrauhtʏr
horvatn	hɔrvahtn
mexíkó	mɛksiːkʰouː
ofkæling	ɔːvcaiːlɪŋk
kók	kʰouːk
guðspjall	kvʏðspjatl
krónprins	kʰrounpʰrɪns
síða	siːða
skref	skrɛːv
slegill	stleiːjɪtl
testósterón	tʰɛstouːstɛːrouːn
brandur	prantʏr
rennibraut	rɛnːɪprøyːt
ratsjá	raːtsjauː
spámaður	spauːmaːðʏr
húfa	huːa
heflaður	hɛplaːðʏr
kennaratyggjó	cʰɛnːaːratʰɪcːouː
meiddur	meitːʏr
virki	vɪr̥cɪ
lafa	laːva
kytra	cʰɪːtra
merki	mɛr̥cɪ
vaf	vaːv
daðla	taðla
velkomandaminni	vɛlkʰɔːmantamɪnːɪ
mengjafræði	meiɲcafraiːðɪ
flaga	flaːɣa
lífljómun	livljouːmʏn
formaður	fɔrmaːðʏr
árekstur	auːrɛxstʏr
piltur	pʰɪl̥tʏr
rifta	rɪfta
mölur	mœːlʏr
brot	prɔːt
ormur	ɔrmʏr
fylli	fɪtlɪ
teygjanlegur	tʰeiːjanlɛːɣʏr
óþekkur	ouːθɛhkʏr
rafgeymir	ravceiːmɪr
andersen	antɛrsɛnː
diskó	tɪskouː
þeytingur	θeiːtiŋkʏr
málmblásturshljóðfæri	maulmplaustʏr̥sl̥jouðfaiːrɪ
strikamerki	strɪːkamɛr̥cɪ
bifhjól	pɪvçouːl
tilfinningalegur	tʰɪlfɪnːiŋkalɛːɣʏr
svæfa	svaiːva
ljósmóðir	ljouːsmouːðɪr
öryggisgler	œːrɪcːɪsklɛːr
tálkn	tʰaul̥kn
freygerður	freiːcɛrðʏr
stirðlegur	stɪrðlɛːɣʏr
bjakk	pjahk
vaskur	vaskʏr
hrap	r̥aːp
fornnorræna	fɔrtnnɔrraiːna
bróðurdóttir	prouːðʏrtouhtɪr
háskóli	hauːskouːlɪ
geirfugl	ceirfʏkl
hvítur	xʷiːtʏr
endurræsa	ɛntʏrraiːsa
peli	pʰɛːlɪ
skop	skɔp
ljóður	ljouːðʏr
segulsvið	sɛːɣʏlsvɪːð
unndís	ʏnːtiːs
bókrolla	pouːkrɔtla
fiðrildi	fɪðrɪltɪ
húnn	hutn
staða	staːða
hænuegg	haiːnʏɛkː
landslag	lanslaːɣ
geispa	ceispa
föndur	fœntʏr
hálíngresi	hauːlinkrɛːsɪ
landsvala	lantsvaːla
lýsa	liːsa
únsa	unsa
kvöld	kʰvœlt
vald	valt
mikilvægi	mɪːcɪlvaiːjɪ
svil	svɪːl
hökutoppur	hœːkʏtʰɔhpʏr
vinnukona	vɪnːʏkʰɔːna
þórólfur	θouːroulvʏr
síld	silt
orkudrykkur	ɔr̥kʏtrɪhkʏr
faldur	faltʏr
sáttur	sauhtʏr
vanalega	vaːnalɛːɣa
tíra	tʰiːra
folafluga	fɔːlaflʏːɣa
ferningur	fɛrtniŋkʏr
freydís	freiːtiːs
skorningur	skɔrtniŋkʏr
forneskja	fɔrtnɛsca
kirsuberjatré	cʰɪr̥sʏpɛrjatʰrjɛː
skruna	skrʏːna
bifur	pɪːvʏr
heimur	heiːmʏr
eyðimörk	eiːðɪmœr̥k
helín	hɛːliːn
múskat	muskaːt
efnajafna	ɛpnajapna
fróður	frouːðʏr
púl	pʰuːl
stærðfræði	stairðfraiːðɪ
þakklátur	θahklauːtʏr
pils	pʰɪls
blómvöndur	ploumvœntʏr
ruddalegur	rʏtːalɛːɣʏr
fjallkrækill	fjatlkʰraiːcɪtl
forsprakki	fɔr̥sprahcɪ
aðgætni	aðcaihtnɪ
lá	lauː
níðingur	niːðiŋkʏr
drífa	triːva
glyðra	klɪðra
lumpa	lʏm̥pa
neitunarháttur	neiːtʏnarhauhtʏr
skjálfa	scaulva
kvaka	kʰvaːka
illmælgi	ɪtlmailcɪ
prik	pʰrɪːk
tónfræði	tʰounfraiːðɪ
þrátta	θrauhta
raki	raːcɪ
rekaviður	rɛːkavɪːðʏr
heimsókn	heimsouhkn
fræni	fraiːnɪ
mannlegur	manːlɛːɣʏr
veðja	vɛðja
frábending	frauːpɛntiŋk
digur	tɪːɣʏr
speni	spɛːnɪ
æmta	aim̥ta
litúrgískur	lɪːtʰurciskʏr
belgi	pɛlcɪ
thorlacius	tʰɔrlasiːjʏs
hrútspungur	r̥utspʰuŋkʏr
krabbamein	kʰrapːameiːn
geirvarta	ceirvar̥ta
hjörð	çœrð
tröllaukinn	tʰrœtløyːcɪn
flog	flɔːɣ
tvímynd	tʰviːmɪnt
sónötuform	souːnœːtʏfɔrm
fundur	fʏntʏr
músarrindill	muːsarrɪntɪtl
hirsla	hɪr̥stla
skána	skauːna
skotland	skɔːtlant
útsýni	uːtsiːnɪ
þvo	θvɔː
oktan	ɔxtaːn
haframjöl	havramjœːl
mjalli	mjatlɪ
freri	frɛːrɪ
hefnd	hɛmt
hokkí	hɔhciː
tromp	tʰrɔm̥p
inna	ɪnːa
flekklaus	flɛhkløyːs
stáss	stausː
leikfang	leiːkfauŋk
gos	kɔːs
dæma	taiːma
samfundur	samfʏntʏr
lasanja	lasanja
belgja	pɛlca
skírnarfontur	scirtnarfɔn̥tʏr
fóarn	fouːartn
monta	mɔn̥ta
hellingur	hɛtliŋkʏr
genf	cɛnf
glas	klaːs
knapi	kʰnaːpɪ
varalitur	vaːralɪːtʏr
mæði	maiːðɪ
sólblóm	soulplouːm
tjald	tʰjalt
hespa	hɛspa
eldstæði	ɛltstaiːðɪ
kjaftur	cʰaftʏr
hnjóta	n̥jouːta
kanína	kʰaːniːna
leikvangur	leiːkvauŋkʏr
umskurður	ʏmskʏrðʏr
syndur	sɪntʏr
hagi	haiːjɪ
norn	nɔrtn
merkja	mɛr̥ca
vetrarbraut	vɛːtrarprøyːt
tinna	tʰɪnːa
lindasef	lɪntasɛːv
spánn	spautn
föt	fœːt
tjása	tʰjauːsa
ostaskeri	ɔstascɛːrɪ
tilboð	tʰɪlpɔːð
leiðangur	leiːðauŋkʏr
felling	fɛtliŋk
óásjálegur	ouːauːsjauːlɛːɣʏr
hrukkunjóli	r̥ʏhkʏnjouːlɪ
þorvaldur	θɔrvaltʏr
þjálfun	θjaulvʏn
mappa	mahpa
ljósapera	ljouːsapʰɛːra
litarefni	lɪːtarɛpnɪ
fastanefnd	fastanɛmt
elska	ɛlska
auki	øyːcɪ
breyting	preiːtiŋk
mjöðm	mjœðm
björk	pjœr̥k
ákveða	auːkʰvɛːða
ljónslappi	ljounstlahpɪ
selur	sɛːlʏr
gljúfra	kl̥juvra
amharíska	aːmhariska
bruðl	prʏðl
gufa	kʏːva
annars	anːar̥s
þýður	θiːðʏr
byrja	pɪrja
skríða	skriːða
ístað	iːstaːð
vernd	vɛrnt
girni	cɪrtnɪ
ró	rouː
hringa	r̥iŋka
stífni	stipnɪ
brjálæði	prjauːlaiːðɪ
helsingi	hɛlsiɲcɪ
kúka	kʰuːka
sundgleraugu	sʏntklɛːrøyːɣʏ
gunga	kuŋka
þrýstiloft	θristɪlɔft
væta	vaiːta
ara	aːra
stinga	stiŋka
míkrófónn	miːkrouːfoutn
sólhattur	soulhahtʏr
furðulegur	fʏrðʏlɛːɣʏr
eða	ɛːða
sérstaklega	sjɛr̥staːklɛːɣa
g	cɛː
orkneyjar	ɔr̥kneiːjar
tal	tʰaːl
mýkt	mixt
hallmundur	hatlmʏntʏr
stúlka	stul̥ka
skjálfti	scaul̥tɪ
árni	aurtnɪ
michelsen	mɪhkɛlsɛnː
mjónefur	mjouːnɛːvʏr
sveittur	sveihtʏr
geirharður	ceiːrharðʏr
sundlaug	sʏntløyːɣ
týra	tʰiːra
hrossakjöt	r̥ɔsːacʰœːt
snjallúr	snjatluːr
nenni	nɛnːɪ
fergin	fɛrcɪn
útbreiða	uːtpreiːða
hringtorg	r̥iŋktʰɔrk
hneppi	n̥ɛhpɪ
æra	aiːra
