ajornor	ad͡ʒornɔr
equilibrati	ekvilibrati
manjar	manʒaɾ
yuro	juro
vehilo	vɛhilo
citanta	t͡sitanta
puero	pu̯ero
cesiginti	t͡sesiɡinti
bakate	bakate
konsequo	konsekvo
vortoludo	vortoludo
koquanta	kokwanta
molekulo	molekulo
saturar	saturar
placi	plat͡si
botanizanta	botanizanta
teraso	teraso
kolibrio	kolibri̯o
predicite	predit͡site
orkestrala	orkestrala
lor	lor
alejis	aled͡ʒis
hauo	hau̯o
substanco	substant͡so
supresar	supɾesaɾ
adjektivi	add͡ʒektivi
organizite	orɡanizite
datumari	datumari
cis	t͡sis
bolius	boli̯us
oficiis	ofit͡siis
mento	mento
kromosomo	kromosomo
augmentor	au̯ɡmentɔr
triumfar	triumfar
depozas	depozas
koram	koram
citato	t͡sitato
evolucionas	evolut͡si̯onas
komandar	komandar
akompanonte	akompanonte
helpite	helpite
anjeli	anʒeli
refraktir	refraktir
tormentar	tormentar
humuro	humuro
skribanti	skribanti
odiata	odi̯ata
permisor	permisɔr
abandononte	abandononte
rezumite	rezumite
abatinto	abatinto
informez	informɛz
festininte	festininte
pupo	pupo
abatanto	abatanto
universo	univɛɾsɔ
favoroti	favoroti
spleno	spleno
desorganizar	desorɡanizar
kulturi	kulturi
seglo	seɡlo
pedfingro	pedfinɡro
aplikos	aplikɔs
indulgema	indulɡema
universitati	universitati
bolios	boli̯ɔs
urso	urso
akordo	akordo
plumostroki	plumostroki
abatonta	abatonta
aceptonti	at͡septonti
certena	t͡sertena
granda	ɡranda
lexiko	leksiko
lauditi	lau̯diti
vadis	vadis
akuzita	akuzita
numeralo	numeralo
armei	armei
adpozez	adpozɛs
esante	esante
quakero	ku̯akero
fortigote	fortiɡote
aceptiti	at͡septiti
vadanti	vadanti
votar	votar
avantajo	avantad͡ʒo
fresha	freʃa
equilibror	ekvilibrɔr
bielorusia	biɛlɔɾusia
origani	oriɡani
gluagar	ɡluaɡar
restaurato	restau̯rato
elefanti	elefanti
floro	floro
perturbez	perturbɛz
likos	likɔs
koquinto	kokwinto
koquus	kokvus
atingante	atinɡante
spanielo	spani̯elo
akuzinta	akuzinta
skreno	skreno
jupeto	d͡ʒupeto
bandajizoti	bandad͡ʒizoti
sisez	sisɛs
kantonta	kantonta
ek	ɛk
vintro	vintro
koquir	kokvir
helpez	helpɛs
frigorizilo	friɡorizilo
piono	piono
koquanti	kokwanti
pozeso	pozeso
akompananta	akompananta
tormentas	tormentas
agnoskonte	aɡnoskonte
oraklo	oraklo
kuratar	kuratar
botanizonta	botanizonta
poke	poke
fraponta	fraponta
rospo	ɾospo
gracio	ɡrat͡sio
skikuronti	skikuronti
havar	havar
atentir	atentir
gravito	ɡravito
adoptonti	adoptonti
pekunioza	pekunioza
gravitor	ɡravitɔr
sulfo	sulfo
oficiinti	ofit͡siinti
enkorpigate	enkorpiɡate
akompanas	akompanas
sorgito	sorɡito
dicati	dit͡sati
enswichar	enswit͡ʃar
infama	infama
se	sɛ
atentato	atentato
sublimate	sublimate
striki	striki
lageto	laɡeto
frontiero	fronti̯ero
fotografanto	fotoɡrafanto
gimnazio	ɡimnazio
bramo	bramo
borgezi	borɡezi
kuntara	kuntara
grucho	ɡrut͡ʃo
cilindro	t͡silindrɔ
suno	suno
deputor	deputɔr
foso	foso
demonstrez	demonstrɛs
cavespere	t͡savespere
dormetanti	dormetanti
loklo	loklo
oktano	oktano
oranjo	orand͡ʒo
ezoko	ezoko
sisus	sisus
frakasar	frakasar
subisar	subisar
explikir	eksplikir
akuzati	akuzati
jaspo	d͡ʒaspo
perturbata	perturbata
rasponti	rasponti
difuzar	difuzar
laborar	laborar
abatonte	abatonte
abatati	abatati
generala	ɡenerala
je	ʒe
akuzoto	akuzoto
fricionar	frit͡sjonar
chanjas	t͡ʃand͡ʒas
ilua	ilua
incendiate	int͡sendi̯ate
kristnasko	kristnasko
agnoskez	aɡnoskɛz
dissolvar	dissolvar
organizanti	orɡanizanti
venez	venɛz
chanjar	t͡ʃand͡ʒar
ekliptiko	ekliptiko
exasperonto	eɡzasperonto
kontributar	kontributar
brizoza	brizoza
atentanti	atentanti
trahizinto	trahizinto
chereskez	t͡ʃereskɛs
yes	jes
indikativo	indikativo
insultata	insultata
enterigeyo	enteriɡejo
judikero	ʒudikero
incendior	int͡sendi̯ɔr
soldato	soldato
amorar	amorar
iracigar	irat͡siɡar
sarko	sarko
momento	momento
apta	apta
exkuzo	ekskuzo
lingoti	linɡoti
adjektivo	adʒektivo
skikuris	skikuris
esanto	esanto
videbla	videbla
rezumanta	rezumanta
quantesi	kvantesi
filtranto	filtranto
skarsa	skarsa
qua	kwa
exekuti	eɡzekuti
equilibranta	eku̯ilibranta
skribas	skribas
vadez	vadɛs
merkuro	merkuro
abatir	abatir
recepcionas	ret͡sept͡si̯onas
forjetar	forʒetar
imaginanti	imaɡinanti
favorez	favorɛs
akompano	akompano
exekutebla	eksekutebla
kruro	kruro
puerala	pwerala
bandajizate	bandad͡ʒizate
bela	bela
ledro	ledro
demonstrar	demonstrar
decimalo	det͡simalo
sorganta	sorɡanta
admirar	admirar
sisir	sisir
adio	adiɔ
japoniano	d͡ʒaponi̯ano
bakanta	bakanta
kafeerio	kafeerio
fero	fero
charmanto	t͡ʃarmanto
olda	olda
enkorpiganti	enkorpiɡanti
bigama	biɡama
balzamo	balzamo
orgenisto	orɡenisto
forteso	forteso
akuzanto	akuzanto
prurito	prurito
adoptito	adoptito
novembro	novembro
saturota	saturota
litigiti	litiɡiti
citote	t͡sitote
dissolvas	dissolvas
sorginta	sorɡinta
centriolo	t͡sentri̯olo
amoroti	amoroti
laxigir	laksiɡir
silko	silko
saturita	saturita
studios	studi̯ɔs
filtrite	filtrite
turkia	turki̯a
cilio	t͡sili̯o
medikala	medikala
exasperota	eksasperota
frapata	frapata
konsolo	konsolo
utensilo	utensilo
atingata	atinɡata
stroko	strɔkɔ
labiobarbo	labi̯obarbo
trahizis	trahizis
litigoto	litiɡoto
origino	oriɡino
fantomo	fantomo
koldeskar	koldeskar
lugar	luɡar
probez	probɛz
decidigar	det͡sidiɡar
defensato	defensato
persequar	pɛrsɛkwar
stufiti	stufiti
deziregar	dezireɡar
diftongo	diftonɡo
citonta	t͡sitonta
raspito	raspito
atinganti	atinɡanti
dami	dami
saveskar	saveskar
nervo	nervo
refraktis	refraktis
agnoskanta	aɡnoskanta
dormetinti	dormetinti
mizero	mizero
organizati	orɡanizati
axoloto	aksoloto
desklozar	desklozar
agnoskus	aɡnoskus
horlojo	horlod͡ʒo
equilibronta	ekvilibronta
exasperate	eksasperate
ingrediento	inɡredi̯ɛnto
modo	mɔdɔ
persekutar	persekutar
stufoto	stufoto
abandonir	abandonir
gramo	ɡramo
partisi	partisi
signifiki	siɡnifiki
boliis	boliis
teorbi	teorbi
atentante	atentante
equilibronte	ekvilibronte
granizir	ɡranizir
globeto	ɡlobeto
enkorpigito	enkorpiɡito
sisos	sisɔs
agnoskote	aɡnoskote
kurato	kurato
dekano	dekano
kustumo	kustumo
abordar	abɔrdar
bico	bit͡so
exasperote	eksasperote
stadio	stadio
jornar	ʒornar
fluktuar	fluktuar
chanjinti	t͡ʃanʒinti
artokarpo	artokarpo
transitiva	transitiva
cernar	t͡sernar
abrikoto	abrikoto
etikala	etikala
fromajo	fromaʒo
legiono	leɡjono
standardo	standardo
helico	helit͡so
ipsa	ipsa
rivereti	rivereti
shamigos	ʃamiɡɔs
akompananti	akompananti
alejas	aleʒas
hiere	hiere
apertanti	apertanti
tentite	tentite
espisto	ɛspisto
jonko	ʒonko
t	t
explikus	eksplikus
dorsi	dorsi
nomo	nɔmɔ
faciligar	fat͡siliɡar
praktikala	praktikala
exuduro	eɡzuduro
mencionote	ment͡si̯onote
fotografinte	fotoɡrafinte
artificala	artifit͡sala
agavo	aɡavo
aplikoti	aplikoti
vivoza	vivoza
cesigonti	t͡sesiɡonti
abatinte	abatinte
monumenti	monumenti
nomo	nomo
sulfido	sulfido
nazi	nazi
arjenti	ard͡ʒenti
trompar	trompar
enoyar	enojar
dezirar	dezirar
balono	balono
fotografis	fotoɡrafis
subordinita	subordinita
banano	bananɔ
teritorio	teritori̯o
agnoskati	aɡnoskati
koncerne	kont͡serne
quik	kwik
laxigez	laksiɡɛz
homardi	homardi
abatonti	abatonti
kakao	kakao
babilachez	babilat͡ʃɛs
animas	animas
sorgonti	sorɡonti
monopolo	monopolo
tradukala	tradukala
predicar	predit͡sar
helpote	helpote
pupi	pupi
sponjo	sponʒo
projetato	proʒetato
acioni	at͡sjoni
abatanti	abatanti
personalizar	personalizar
boko	boko
kodexo	kodekso
mencioniti	ment͡si̯oniti
vakuo	vakuo
izobaro	izobaro
modo	modo
aceptus	at͡septus
kabaneto	kabaneto
pronuncebla	pronunt͡sebla
atingota	atinɡota
pendar	pɛndaɾ
abandonoti	abandonoti
temporalo	tɛmporalo
mondolinguala	mondolinɡwala
te	tɛ
aranjos	aranʒɔs
jetito	ʒetito
tormentor	tormentɔr
organizante	orɡanizante
enkorpigonti	enkorpiɡonti
kunvivebla	kunvivebla
developar	developar
fotografinti	fotoɡrafinti
ofensanta	ofensanta
lakrimifar	lakrimifar
apelis	apelis
linguistiko	linɡuwistiko
desklozez	desklozɛs
stufar	stufar
kontonti	kontonti
aceptante	at͡septante
musketo	musketo
biomekanismo	biomekanismo
kontanti	kontanti
pacema	pat͡sema
kunlaboranti	kunlaboranti
derivar	derivar
muziki	muziki
ajornez	ad͡ʒornɛs
citata	t͡sitata
nuco	nut͡so
agnoskoto	aɡnoskoto
ilu	ilu
manipular	manipular
tentanta	tentanta
aceptinta	at͡septinta
sublimis	sublimis
sinkar	siŋkar
nukleolo	nukleolo
parolar	parɔlar
exasperonti	eksasperonti
degenerar	deɡenerar
objekti	obd͡ʒekti
regenerante	reɡenerante
maxim	maɡzim
kunlaboronte	kunlaboronte
tentus	tentus
kaviaro	kaviaro
perturbez	perturbɛs
diferar	diferar
exasperati	eksasperati
donajo	donaʒo
legiono	leɡiono
koquante	kokvante
repudiis	repudiis
usa	usa
surpozez	surpozɛs
precipua	pret͡sipua
mineralo	mineralo
koquas	kokvas
je	ʒɛ
palio	pali̯o
b	b
agnoskas	aɡnoskas
radio	radio
buletini	buletini
akuzato	akuzato
apartamenti	apartamenti
kreskigar	krɛskiɡar
favorinta	favorinta
helpate	helpate
charioto	t͡ʃaɾiɔtɔ
pensez	pensɛs
mieltempo	mi̯ɛltɛmpo
saturez	saturɛz
eroris	eroris
dizastri	dizastri
grelar	ɡrelar
agnoskinti	aɡnoskinti
prejudiko	preʒudiko
partoprenar	partoprenar
lektar	lektar
evolucionez	evolut͡si̯onɛz
celerio	t͡seleri̯o
kantar	kantar
enkorpigis	enkorpiɡis
festinanti	festinanti
enkorpigati	enkorpiɡati
komprar	komprar
mustar	mustar
separis	separis
tormentata	tormentata
helpus	helpus
kunlaboror	kunlaborɔr
senci	sent͡si
mano	mano
stufonto	stufonto
arjento	arʒento
se	se
shildo	ʃildo
gracioza	ɡrat͡sioza
esinto	esinto
papaveri	papaveri
superba	superba
kand	kand
helpota	helpota
feto	feto
aplikati	aplikati
vertuo	vertuo
jornomezi	ʒornomezi
litiganti	litiɡanti
mencionante	ment͡si̯onante
enkorpigato	enkorpiɡato
de	de
enkorpigor	enkorpiɡɔr
chanjanti	t͡ʃand͡ʒanti
quantesala	kwantesala
sandalo	sandalo
filtrir	filtrir
equilibrinti	ekvilibrinti
cirkumaji	t͡sirkumad͡ʒi
kantez	kantɛz
rozea	rozea
favorar	favorar
koquati	kokvati
projetonte	proʒetonte
skikuronte	skikuronte
saturanto	saturanto
humida	humida
skrachar	skrat͡ʃar
skrubturnili	skrubturnili
sika	sika
festinir	festinir
bonveno	bonveno
jornomezo	d͡ʒornomezo
atentor	atentɔr
saciar	sat͡si̯ar
fabriki	fabriki
raspus	raspus
akompanir	akompanir
kilometro	kilometro
dop	dop
disciplinonti	dist͡siplinonti
frapite	frapite
nodo	nodo
tamtamo	tamtamo
judiko	d͡ʒudiko
vespereskinta	vespereskinta
unionar	unionar
gravitar	ɡravitar
lezar	lezar
oficios	ofit͡si̯ɔs
probar	probar
ponto	ponto
inicio	init͡sjo
pekunioza	pekunjoza
manjaji	manʒaʒi
helpar	helpar
abrejar	abreʒar
turbano	turbano
bestio	bestjo
darfas	darfas
stufite	stufite
evaluar	ɛvaluaɾ
imaginanta	imaɡinanta
prezidos	prezidɔs
nivelo	nivelo
plubeligar	plubeliɡar
koncesi	kont͡sesi
gravitis	ɡravitis
ordinara	ordinara
anticipez	antit͡sipɛz
kunlaborez	kunlaborɛz
monteto	monteto
promenite	promenite
asfalto	asfalto
tentonti	tentonti
adoptota	adoptota
atentate	atentate
interviuvar	intervjuvar
cirkumskribor	t͡sirkumskribɔr
shaminda	ʃaminda
kantus	kantus
produktar	pɾɔduktaɾ
stadio	stadiɔ
babilachar	babilat͡ʃar
insultar	insultar
datumo	datumo
faligar	faliɡar
sorgante	sorɡante
trahizonto	trahizonto
intermixi	intermiɡzi
litigonta	litiɡonta
delegiti	deleɡiti
jetonto	d͡ʒetonto
boliigos	boliiɡɔs
apologiar	apoloɡjar
demonstranti	demonstranti
kreskigar	kreskiɡar
naturi	naturi
vestono	vestono
regresis	reɡresis
magnezio	maɡnezi̯o
adoptoto	adoptoto
binoklo	binoklo
memorus	memorus
analoga	analoɡa
bastonagar	bastonaɡar
periodo	periodo
juntos	ʒuntɔs
ne	nɛ
indukto	indukto
filtras	filtras
judikoti	d͡ʒudikoti
apartamento	apartamento
mencioninti	ment͡si̯oninti
oficiar	ofit͡si̯ar
ajornor	aʒornɔr
dicanti	dit͡santi
apertas	apertas
akuzis	akuzis
hueto	hueto
komplezema	komplezema
favorato	favorato
apelante	apelante
aquirar	akvirar
il	il
voluntez	voluntɛs
perkutas	perkutas
gravitonta	ɡravitonta
vildo	vildo
juveli	ʒuveli
equilibranto	ekvilibranto
mencioninte	ment͡si̯oninte
laudanti	lau̯danti
bakanti	bakanti
laboristo	laboristo
stufota	stufota
atingus	atinɡus
projetinte	prod͡ʒetinte
rezistiva	rezistiva
printempo	pɾintɛmpɔ
boliigis	boliiɡis
bakota	bakota
koquonto	kokwonto
stufonti	stufonti
adpozez	adpozɛz
honesta	honesta
fabrikir	fabrikir
equilibrata	ekvilibrata
pozez	pozɛz
mokado	mokado
joyo	ʒojo
organizonto	orɡanizonto
deskovrar	deskovrar
deputinti	deputinti
raspinti	raspinti
inicio	init͡sio
kauciono	kau̯t͡si̯ono
weldar	weldar
frapote	frapote
imaginonto	imaɡinonto
granizor	ɡranizɔr
poniardo	poni̯ardo
figuro	fiɡuɾɔ
fabrikis	fabrikis
guidas	ɡvidas
fortiganti	fortiɡanti
urbestro	urbestro
abandonoto	abandonoto
v	v
likonte	likonte
monto	monto
apelez	apelɛs
trovebla	trovebla
kantinto	kantinto
monako	monako
parko	parko
saturanti	saturanti
shamigar	ʃamiɡar
refraktor	refraktɔr
umbiliko	umbiliko
exasperanti	eɡzasperanti
exteraji	eɡzterad͡ʒi
juntos	d͡ʒuntɔs
miligrami	miliɡrami
jetanto	ʒetanto
perturbis	perturbis
naskar	naskar
pasinta	pasinta
maligna	maliɡna
docar	dot͡sar
adopto	adopto
aranjez	arand͡ʒɛs
exasperite	eɡzasperite
frivoleso	frivoleso
pensonti	pensonti
fola	fola
abundanto	abundanto
indikilo	indikilo
equilibronte	eku̯ilibronte
likito	likito
konsilar	konsilar
brido	brido
vidar	vidar
delicio	delit͡sio
potato	potato
censurez	t͡sensurɛs
fanfaronado	fanfaronado
nomi	nomi
stufato	stufato
natar	natar
bandajizonte	bandaʒizonte
bakoti	bakoti
rezumis	rezumis
fortigez	fortiɡɛz
polo	polo
jokar	d͡ʒokar
ego	eɡo
frapez	frapɛs
atingi	atinɡi
abandononti	abandononti
juntar	d͡ʒuntar
quante	kwantɛ
kontante	kontante
koquero	kokvero
leonini	leonini
adoros	adorɔs
eceptar	et͡septar
fortiginti	fortiɡinti
skribez	skribɛs
plantacar	plantat͡sar
judikanto	d͡ʒudikanto
hefo	hefo
citez	t͡sitɛz
mencionanta	ment͡si̯onanta
sociologo	sot͡si̯oloɡo
mondumala	mɔndumala
abolisati	abolisati
tombeyo	tombeyo
bisquito	biskvito
deputati	deputati
prezidanta	prezidanta
fantazias	fantazi̯as
kapro	kapro
abrikoto	abrikɔtɔ
sat	sat
venti	venti
me	me
konceso	kont͡seso
aceptati	at͡septati
saloni	saloni
puritani	puritani
juvelisto	ʒuvelisto
glavi	ɡlavi
trahizote	trahizote
bastoneto	bastoneto
equilibrar	ekvilibrar
sisar	sisar
buxo	buɡzo
envolvos	envolvɔs
fundamentisti	fundamentisti
rideto	rideto
fanatikeso	fanatikeso
festinonte	festinonte
kalkular	kalkular
herdo	hɛɾdɔ
proletario	proletarjo
festininto	festininto
arjenti	arʒenti
ludar	ludar
kunlaborinte	kunlaborinte
moruo	moruo
kreitaro	kreitaro
liki	liki
tostar	tostar
algebro	alɡebro
grafika	ɡrafika
arjenta	ard͡ʒenta
laktumo	laktumo
gratitudo	ɡratitudo
exasperor	eɡzasperɔr
repugnar	repuŋɡar
ajornar	aʒornar
europa	ɛwɾɔpa
aceptita	at͡septita
apen	apen
arkitekto	arkitɛkto
memoroto	memoroto
datumi	datumi
judiciar	d͡ʒudit͡si̯ar
ca	tsa
mamuto	mamuto
lonchi	lont͡ʃi
explikez	eɡzplikɛs
alejis	aleʒis
fotografanta	fotoɡrafanta
junipero	d͡ʒunipero
sisez	sisɛz
bandajizonti	bandaʒizonti
idioto	idioto
susteno	susteno
sisinti	sisinti
saturoti	saturoti
dio	dio
desorganizor	desorɡanizɔr
strokar	strokar
termo	tɛɾmɔ
plumolito	plumolito
gramatiki	ɡramatiki
amortisar	amɔrtisar
exutorio	eksutori̯o
aktorulo	aktorulo
equilibros	eku̯ilibrɔs
refraktos	refraktɔs
transiro	transiro
judikanto	ʒudikanto
atingito	atinɡito
uzenda	uzenda
jenjivo	d͡ʒend͡ʒivo
morui	morui
alelo	alelo
akompanota	akompanota
fairo	fairo
fervoyi	fervoji
regenerinti	reɡenerinti
verki	verki
genuo	ɡenwo
kloko	kloko
strandar	strandar
aktiva	aktiva
desorganizonte	desorɡanizonte
m	m
adherar	adherar
kantinta	kantinta
iras	iras
bakonti	bakonti
skio	skio
senkapigar	senkapiɡar
akuzanti	akuzanti
bonvolo	bonvolo
adicionar	adit͡si̯onar
atingoto	atinɡoto
promulgar	promulɡar
festinanta	festinanta
puteo	puteo
ociar	ot͡si̯ar
vidar	vidaɾ
rodez	rodɛs
anticipus	antit͡sipus
ebonito	ebonito
aparos	aparɔs
per	pɛɾ
vaporo	vaporo
abandononta	abandononta
c	tse
desorganizato	desorɡanizato
litigate	litiɡate
frajila	fraʒila
bisquiti	bisku̯iti
balzamino	balzamino
mondumo	mɔndumɔ
vortolibro	vɔrtolibro
amoratino	amoratino
koquati	kokwati
seciono	set͡sjono
bandajizonta	bandaʒizonta
kuto	kuto
apertor	apertɔr
fendar	fendar
enemika	enemika
citoti	t͡sitoti
nektarini	nektarini
forjas	ford͡ʒas
cirkumiroti	t͡sirkumiroti
segun	seɡun
europa	ewropa
verdajo	verdaʒo
pesimisto	pesimisto
aceptato	at͡septato
organizonta	orɡanizonta
litigota	litiɡota
citruso	t͡sitruso
anticipoti	antit͡sipoti
prezidez	prezidɛz
koquito	kokvito
ido	ido
abatez	abatɛs
festinez	festinɛs
iraco	iɾat͡so
anticipiti	antit͡sipiti
quankam	kvankam
projetanto	proʒetanto
prosternus	prosternus
anso	anso
aceptas	at͡septas
alkoholo	alkoholo
nektarino	nektarino
abnegar	abneɡar
utensilo	utɛnsilɔ
fortigonte	fortiɡonte
remediacho	remedjat͡ʃo
fatigar	fatiɡar
jeristo	ʒeristo
organismo	orɡanismo
dizastro	dizastro
likanti	likanti
guidus	ɡvidus
atentanto	atentanto
raspanta	raspanta
blezar	blezar
akuzez	akuzɛz
persuadar	persuadar
incendiato	int͡sendi̯ato
forprenar	forprenar
pamfleto	pamfleto
sama	sama
adoptoti	adoptoti
judikinto	d͡ʒudikinto
kontito	kontito
fastar	fastar
atentonte	atentonte
fantaziar	fantaziar
derivajo	derivaʒo
trahizonte	trahizonte
donajo	donad͡ʒo
kreuro	kreu̯ro
konseque	konsekve
restauranti	restau̯ranti
avantaji	avantaʒi
adoranto	adoranto
frato	frato
orkestrala	ɔrkɛstrala
specala	spet͡sala
oficianti	ofit͡si̯anti
extirpar	eɡztirpar
projetoti	prod͡ʒetoti
atentote	atentote
projetiti	prod͡ʒetiti
explikez	eksplikɛz
marto	marto
skikurinta	skikurinta
stimular	stimular
rani	rani
purpura	purpura
direktado	direktado
projetas	prod͡ʒetas
giganta	ɡiɡanta
lojar	loʒar
supo	supo
prezidonto	prezidonto
mestiero	mestjero
botanizati	botanizati
kaseri	kaseri
kruelaji	kruelaʒi
cinemo	t͡sinemo
plani	plani
albumeno	albumeno
atentati	atentati
fortigar	fortiɡar
decidonto	det͡sidonto
likir	likir
bakati	bakati
defensati	defensati
kambiar	kambjar
kansono	kansono
bona	bona
kreskar	kreskar
akompanante	akompanante
optimisto	optimisto
respektar	respektar
depos	depos
glacio	ɡlatsjo
kurar	kurar
violacar	viɔlat͡saɾ
kultelo	kultelo
venez	venɛs
tapiso	tapiso
perplexa	perpleksa
bandajizinti	bandaʒizinti
boxar	boɡzar
sisas	sisas
dispozeso	dispozeso
neopreno	neopreno
bankisto	bankisto
insultinti	insultinti
aceptanto	at͡septanto
skribate	skribate
arto	arto
nevi	nevi
latvia	latvi̯a
chanjas	t͡ʃanʒas
akompaninte	akompaninte
sundio	sundiɔ
insultante	insultante
adoptato	adoptato
haltez	haltɛz
kontota	kontota
abreviez	abrevi̯ɛz
decidos	det͡sidɔs
saturor	saturɔr
idiotismo	idiotismo
shovinismo	ʃovinismo
linguala	linɡuala
movas	movas
akompanor	akompanɔr
krucho	krut͡ʃo
parasuni	parasuni
fe	fɛ
abrevio	abrevi̯o
augmentos	au̯ɡmentɔs
adoptiti	adoptiti
evolucionigar	evolut͡si̯oniɡar
nova	nova
equilibrite	eku̯ilibrite
botanizita	botanizita
sisonta	sisonta
akompanato	akompanato
folii	folii
fotografinto	fotoɡrafinto
panoramo	panoramo
homeosexualo	homeoseksualo
jemelo	ʒemelo
palpebragar	palpebraɡar
ruro	ruro
exasperanto	eɡzasperanto
laudor	lau̯dɔr
operaco	operat͡so
kreskar	krɛskar
literaturajo	literaturaʒo
libreti	libreti
q	kwe
polemiko	polemiko
dicito	dit͡sito
memorar	memorar
tentanto	tentanto
peizajo	pei̯zaʒo
kuniklo	kuniklo
kapricema	kaprit͡sema
amiki	amiki
no	no
sublimez	sublimɛz
torto	torto
superbeso	superbeso
atingoti	atinɡoti
kultelo	kultɛlɔ
forjar	ford͡ʒar
citanto	t͡sitanto
voluntar	voluntar
krono	krono
faro	faro
konsentar	konsentar
koquoti	kokwoti
envolvis	envolvis
rezistema	rezistema
rurani	rurani
pasajar	pasad͡ʒar
paroko	paroko
dina	dina
televiziono	televiziono
elefantini	elefantini
depose	dɛpɔsɛ
ofensas	ofensas
likinta	likinta
sonji	sond͡ʒi
skribinta	skribinta
egala	eɡala
pruritar	pɾuɾitaɾ
neglijar	neɡliʒar
prejudiki	preʒudiki
lamentar	lamentar
renkontrar	renkontrar
atenti	atenti
cesigati	t͡sesiɡati
komputar	komputar
favoranto	favoranto
leonino	leonino
atentita	atentita
figo	fiɡo
desorganizote	desorɡanizote
adorinti	adorinti
nubi	nubi
espado	espado
fiancitino	fiant͡sitinɔ
ofensez	ofensɛs
xe	kse
deputir	deputir
cititi	t͡sititi
projetato	prod͡ʒetato
pikniko	pikniko
chanjiti	t͡ʃanʒiti
perturbante	perturbante
extensar	ɛkstɛnsar
oficianto	ofit͡si̯anto
oceano	ot͡seano
disimulos	disimulɔs
rezumas	rezumas
atentoto	atentoto
sorgata	sorɡata
jacar	d͡ʒat͡sar
magiisto	maɡiisto
harpuno	harpuno
recenso	ret͡sɛnso
komo	komo
likus	likus
filtrez	filtrɛz
exasperinte	eɡzasperinte
odiati	odi̯ati
violentema	violentema
adjacanta	add͡ʒat͡santa
bandajizinto	bandad͡ʒizinto
flegar	fleɡar
aperto	aperto
trahizota	trahizota
defensanto	defensanto
koquiti	kokviti
akuta	akuta
n	n
insertir	insertir
tradukenda	tradukenda
praktikez	praktikɛz
citrusfrukto	t͡sitrusfrukto
simetreso	simetreso
vidas	vidas
enkorpiganto	enkorpiɡanto
justa	d͡ʒusta
kartono	kartono
projetis	proʒetis
enkorpigiti	enkorpiɡiti
extere	ekstere
sistemo	sistemo
exasperos	eɡzasperɔs
turnir	turnir
projetar	prod͡ʒetar
exasperinta	eksasperinta
chera	t͡ʃera
dissolvo	dissolvɔ
tisuo	tisu̯o
damnis	damnis
bandajizanto	bandaʒizanto
chanjati	t͡ʃanʒati
latero	latero
distrikto	distrikto
ofico	ofit͡so
desfacilajo	desfat͡silaʒo
oficionte	ofit͡si̯onte
roko	roko
neposibla	neposibla
urano	urano
inundar	inundar
augmentas	au̯ɡmentas
superesar	superesar
feko	feko
pupei	pupei
eskadrono	eskadrono
kruelajo	kruelad͡ʒo
akutigar	akutiɡar
moderna	mɔdɛɾna
unajo	unad͡ʒo
bruiso	brui̯so
ekswichar	ekswit͡ʃar
tormentez	tormentɛs
raspita	raspita
nemediate	nemedi̯ate
tuno	tuno
desorganizota	desorɡanizota
imaginita	imaɡinita
incendios	int͡sendi̯ɔs
grozelo	ɡrozelo
retroirar	retroirar
eviero	evi̯ero
exhortar	eɡzhortar
kaulo	kau̯lo
atencar	atent͡sar
fervoroza	fervoroza
questioni	ku̯esti̯oni
liberpensisto	liberpensisto
likez	likɛs
interlukti	interlukti
bici	bit͡si
litigote	litiɡote
fatala	fatala
bordo	bordo
promulgate	promulɡate
aniono	ani̯ono
kantiti	kantiti
esinta	esinta
extera	ekstera
skribato	skribato
koquota	kokvota
linguisto	linɡuisto
desorganizita	desorɡanizita
agnoskanto	aɡnoskanto
sundio	sundio
recepcionis	ret͡sept͡si̯onis
exasperonta	eksasperonta
enkorpigos	enkorpiɡɔs
exkavar	ɛɡzkavar
sisate	sisate
vejetar	ved͡ʒetar
fotografota	fotoɡrafota
botanizanto	botanizanto
jermifar	ʒermifar
quankam	ku̯ankam
akompaniti	akompaniti
agnoskoti	aɡnoskoti
solvuri	solvuri
abrikoti	abrikoti
jenerozeso	d͡ʒenerozeso
stufajo	stufaʒo
bokotuko	bokotuko
vovar	vovar
kunlaboranto	kunlaboranto
armoro	aɾmɔɾɔ
obstino	obstino
sublimante	sublimante
abandonas	abandonas
venir	venir
projetota	proʒetota
viro	viro
laudoti	lau̯doti
bulteni	bulteni
cirkumajo	t͡sirkumaʒo
jari	ʒari
vespereskanti	vespereskanti
apertez	apertɛz
atentez	atentɛs
per	per
cedrato	t͡sedrato
pasiva	pasiva
memoranto	memoranto
voyeti	vojeti
exekuto	eksekuto
likato	likato
aspektar	aspektar
pensor	pensɔr
japonia	d͡ʒaponi̯a
recensar	ret͡sɛnsar
garnizono	ɡarnizono
skrubagar	skrubaɡar
napo	napo
glatigez	ɡlatiɡɛz
g	ɡe
kunlaboronti	kunlaboronti
adjektiva	adʒektiva
lavendo	lavendo
skribite	skribite
ofensir	ofensir
konocar	kɔnɔcar
recepcionez	ret͡sept͡si̯onɛs
ancestro	ant͡sestro
remedio	remedjo
mondolinguo	mondolinɡuo
garantii	ɡarantii
ecepte	et͡septe
fotografonti	fotoɡrafonti
mitro	mitro
kastelo	kastelo
shamigez	ʃamiɡɛs
diocezo	di̯ot͡sezo
kunlaborar	kunlaborar
komputero	komputero
bonvenigar	bonveniɡar
ofensonta	ofensonta
kustar	kustar
arkitekturi	arkitekturi
perkutus	perkutus
organizas	orɡanizas
quanto	kwanto
antiheroo	antiheroo
idolo	idolo
trahizita	trahizita
bastonagis	bastonaɡis
invitar	invitar
litigita	litiɡita
lernar	lernar
konstrukturo	kɔnstrukturo
dio	diɔ
koquinta	kokwinta
ablativi	ablativi
nutrivo	nutrivo
projetar	proʒetar
fushar	fuʃar
prosternir	prosternir
pardono	pardono
helponta	helponta
insertus	insertus
guvernantaro	ɡuvernantaro
liechtenstein	liktɛnstai̯n
lektebla	lektebla
abundas	abundas
sendar	sendar
koherar	koherar
asortar	asortar
adepto	adepto
koldeskar	kɔldɛskar
normala	normala
enkorpigante	enkorpiɡante
defensar	defensar
apelir	apelir
adoris	adoris
kantati	kantati
tranchar	trant͡ʃar
nudisti	nudisti
komencar	koment͡sar
bakterio	bakterjo
interago	interaɡo
gravitez	ɡravitɛz
kontinti	kontinti
audaceskez	au̯dat͡seskɛz
jenerozeso	ʒenerozeso
cienco	t͡sient͡so
chanjez	t͡ʃanʒɛz
frapinto	frapinto
atingis	atinɡis
repudios	repudi̯ɔs
fortigita	fortiɡita
video	videjo
mencionos	ment͡si̯onɔs
mielaquo	mi̯elaku̯o
kordio	kordio
projetonto	prod͡ʒetonto
okulo	okulo
radii	radii
konsideresar	konsideresar
haltar	haltar
heredar	heredar
frigoro	friɡoro
nesto	nesto
ofensante	ofensante
licencar	lit͡sent͡sar
mestieristo	mestieristo
irinti	irinti
evito	evito
lanjo	land͡ʒo
milimetri	milimetri
lakto	laktɔ
bandajizoti	bandaʒizoti
aceptez	at͡septɛz
extrema	ekstrema
deshonesta	dɛshonɛsta
advokato	advokato
perturbas	perturbas
festinonti	festinonti
fortigiti	fortiɡiti
abandonote	abandonote
karno	karno
deceptar	det͡septar
foresto	foresto
konocata	konot͡sata
disciplinar	dist͡siplinar
jonko	d͡ʒonko
kauzigar	kau̯ziɡar
equilibrato	ekvilibrato
fraciono	frat͡sjono
mitologio	mitoloɡi̯o
vasalo	vasalo
nokteskar	nokteskar
brakio	brakjo
sanigar	saniɡar
sigareti	siɡareti
jupeti	d͡ʒupeti
unionesar	unijonesar
frapar	frapar
aplikir	aplikir
universala	universala
bideto	bidɛtɔ
klozez	klozɛs
primara	primara
jurnalo	ʒurnalo
ve	ve
brodos	brodɔs
prezidanto	prezidanto
atingote	atinɡote
defensanti	defensanti
enkorpiginte	enkorpiɡinte
judikar	d͡ʒudikar
adoror	adorɔr
mencionati	ment͡si̯onati
a	a
somero	sɔmɛɾɔ
shakar	ʃakar
saturati	saturati
ma	ma
putrar	putrar
grandeskar	ɡrandeskar
agnoskinto	aɡnoskinto
desskrubagar	dɛsskrubaɡar
citas	t͡sitas
juntas	d͡ʒuntas
equilibronta	eku̯ilibronta
quitigar	kwitiɡar
aquofalo	akwofalo
bakinta	bakinta
zeloza	zeloza
entraprezo	entraprezo
jurnali	d͡ʒurnali
internaciona	internat͡sjona
festinis	festinis
bazolinei	bazolinei
bubulo	bubulo
muzeo	muzeo
plubonigar	pluboniɡar
vakua	vakua
helpita	helpita
dicez	dit͡sɛs
joyema	ʒojema
adorir	adorir
botanizoti	botanizoti
akuzonti	akuzonti
nek	nek
atinginte	atinɡinte
chaso	t͡ʃaso
likanto	likanto
noktar	noktar
hufofero	hufofero
sisinta	sisinta
selektar	sɛlɛktaɾ
simii	simii
kolokez	kolokɛz
bandajizata	bandad͡ʒizata
biciklo	bit͡siklɔ
prosternar	prosternar
procenti	prot͡senti
sokurso	sokurso
lauso	lau̯so
myelo	mjelo
strado	stɾadɔ
kalzumo	kalzumo
raspor	raspɔr
palpebro	palpebro
sive	sive
abortigar	abɔrtiɡar
exasperar	eɡzasperar
sequanta	sekvanta
raspoto	raspoto
quantesma	ku̯antɛsma
chipa	t͡ʃipa
equilibroto	ekvilibroto
k	ke
kad	kad
subsumir	subsumir
kontributaji	kontributad͡ʒi
pipo	pipo
legacario	leɡat͡sari̯o
frapir	frapir
adio	adio
regeneror	reɡenerɔr
litigonte	litiɡonte
drinkebla	drinkebla
adoptanta	adoptanta
advokati	advokati
lingoto	linɡoto
similesar	similesar
chanjus	t͡ʃanʒus
remonstrar	rɛmɔnstrar
abandonati	abandonati
nur	nur
papero	papero
organizo	orɡanizo
esenco	esent͡so
mondolingui	mondolinɡu̯i
exasperanto	eksasperanto
koquoto	kokvoto
aceptez	at͡septɛs
adianti	adi̯anti
permisus	permisus
monumento	monumento
y	je
cirkumiriti	t͡sirkumiriti
parasuno	parasuno
mencionota	ment͡si̯onota
rezumor	rezumɔr
tarda	tarda
teorbo	teorbo
tala	tala
adoriti	adoriti
atentiti	atentiti
jupitero	ʒupitero
equilibrota	ekvilibrota
organizita	orɡanizita
bandajizez	bandaʒizɛz
demonstror	demonstrɔr
kabineto	kabinɛtɔ
selo	selo
aceptanta	at͡septanta
equilibrus	eku̯ilibrus
disimulir	disimulir
botanizate	botanizate
praktikesar	praktikesar
borgezo	borɡezo
korodar	korodar
organizir	orɡanizir
aktorulo	aktɔɾulɔ
pensi	pensi
mencionito	ment͡si̯onito
adicionis	adit͡si̯onis
mancho	mant͡ʃo
tentas	tentas
bandajo	bandad͡ʒo
aplikor	aplikɔr
unikeso	unikeso
imaginir	imaɡinir
religioza	reliɡjoza
bovulo	bovulo
saturinto	saturinto
boliez	boli̯ɛs
usana	usana
equilibroto	eku̯ilibroto
fervoyo	fervojo
restaurata	restau̯rata
faraono	faraono
jetoto	d͡ʒetoto
pregar	preɡar
genui	ɡenui
extrema	eɡztrema
adoptata	adoptata
porteo	pɔrteo
forjas	forʒas
internacione	internat͡sione
litro	litro
irinte	irinte
permisis	permisis
axo	akso
equilibrate	ekvilibrate
akuzonta	akuzonta
koncesar	kont͡sesar
fontolinguo	fɔntolinɡu̯o
normo	normo
ito	ito
potencialo	potent͡si̯alo
kordio	kɔɾdiɔ
fotografante	fotoɡrafante
agnoskor	aɡnoskɔr
fortigoti	fortiɡoti
retopagino	ɾɛtɔpaɡinɔ
akademio	akademjo
akuzonto	akuzonto
esenci	esent͡si
probos	probɔs
nektari	nektari
repasto	repasto
iracez	irat͡sɛs
esinti	esinti
helpinte	helpinte
dinamo	dinamo
restaurante	restau̯rante
lu	lu
sublimor	sublimɔr
charmar	t͡ʃarmar
exasperate	eɡzasperate
batas	batas
brodar	brodar
samideani	samideani
pavonumo	pavonumo
kantito	kantito
ludo	ludo
decidinte	det͡sidinte
oportar	oportar
cirkum	t͡sirkum
fanatika	fanatika
konglomerateso	konɡlomerateso
abatante	abatante
joyigar	ʒojiɡar
apertante	apertante
parafalo	parafalo
citar	t͡sitaɾ
likoti	likoti
exasperinto	eɡzasperinto
adoptar	adoptar
komitato	komitato
quar	kwar
brechizabez	bret͡ʃizabɛz
fixigesar	fiksiɡesar
polico	polit͡so
glutinar	ɡlutinar
boki	boki
agnoskate	aɡnoskate
direktiva	direktiva
v	ve
protektar	pɾɔtɛktaɾ
merkurdio	mɛɾkuɾdiɔ
equilibroti	ekvilibroti
teologio	teoloɡi̯o
dop	dɔp
figuro	fiɡuro
esperanto	esperanto
atentar	atentar
proxim	prɔksim
r	ɾ
bisquiti	biskviti
stacar	stat͡sar
inflami	inflami
ilua	ilwa
tormentis	tormentis
kantonte	kantonte
facileskar	fat͡sileskar
kayero	kajero
refraktus	refraktus
pazar	pazar
citor	t͡sitɔr
alejus	aleʒus
dentifrici	dentifrit͡si
ofensez	ofensɛz
busolo	busolo
grandioza	ɡrandi̯oza
sidilo	sidilɔ
helpolinguo	hɛlpolinɡuwo
insultus	insultus
boliigus	boliiɡus
brakiumo	brakiumo
projetite	prod͡ʒetite
nazego	nazeɡo
filtroti	filtroti
animir	animir
suciar	sut͡sjar
desorganizez	desorɡanizɛs
citate	t͡sitate
popo	popo
santeso	santeso
celiba	t͡seliba
substitucar	substitut͡saɾ
likante	likante
legi	leɡi
saturos	saturɔs
exasperato	eɡzasperato
reklamo	reklamo
submisar	submisar
bakito	bakito
kuntexto	kunteksto
virgino	virɡino
dispozez	dispozɛs
expresar	ekspresar
helponto	helponto
noktomezo	noktomezo
naufrajo	nau̯fraʒo
merkurio	meɾkuɾio
amuzar	amuzar
deputez	deputɛz
projetite	proʒetite
abrejas	abreʒas
konsequar	konsekwar
brechiziti	bret͡ʃiziti
skikuror	skikurɔr
likar	likar
pamfleti	pamfleti
alejar	aleʒar
su	su
segli	seɡli
aganti	aɡanti
subtileso	subtileso
adresi	adresi
marshi	marʃi
saliko	saliko
regenerato	reɡenerato
agnoskonto	aɡnoskonto
laboratorio	laboratorjo
nevo	nevo
frapi	frapi
cedema	t͡sedema
dicionario	dit͡si̯onari̯o
exasperas	eɡzasperas
laboruri	laboruri
helpanti	helpanti
adoptanto	adoptanto
apogar	apoɡar
jako	ʒako
kuseno	kuseno
biokemio	biokemio
aden	aden
kauzo	kau̯zo
votez	votɛs
disimular	disimular
lago	laɡo
horizonto	horizonto
le	lɛ
sutar	sutaɾ
cediti	t͡sediti
likite	likite
rezumante	rezumante
stufanta	stufanta
explikos	eksplikɔs
tirkesti	tirkesti
kleriki	kleriki
adoptir	adoptir
skolo	skolo
guvernerio	ɡuvernerjo
evar	evar
signifikar	siɡnifikaɾ
memoronte	memoronte
plumatra	plumatra
radios	radi̯ɔs
mekanismo	mekanismo
sisota	sisota
necesajo	net͡sesad͡ʒo
adjektiva	add͡ʒektiva
traurar	trau̯rar
extra	ekstra
turdo	turdo
konseque	konseku̯e
boliigir	boliiɡir
vicar	vit͡sar
paperachi	paperat͡ʃi
votas	votas
muono	muono
kantote	kantote
abandonabis	abandonabis
plumo	plumɔ
bonvenar	bonvenar
hola	hola
nutrar	nutrar
taxio	taksi̯o
meritoza	meritoza
litigati	litiɡati
arkitekturo	arkitɛkturo
litiginto	litiɡinto
exasperis	eksasperis
cherpar	t͡ʃɛɾpaɾ
avancar	avant͡sar
quinino	ku̯inino
judikonto	ʒudikonto
indijar	indid͡ʒar
entratenar	entratennar
prosternis	prosternis
deputus	deputus
disimulez	disimulɛs
piktis	piktis
regresus	reɡresus
adicionor	adit͡si̯onɔr
fiziko	fiziko
kontonto	kontonto
equilibro	eku̯ilibro
exasperonte	eɡzasperonte
milio	miljɔ
brechizez	bret͡ʃizɛs
korno	korno
notar	notar
literaturaji	literaturaʒi
metro	metro
debilinterago	debilinteraɡo
regretar	reɡretar
abandonabez	abandonabɛs
stufata	stufata
piktez	piktɛz
suedia	swedja
exasperonto	eksasperonto
rodez	rodɛz
koquata	kokwata
indikili	indikili
rezumonta	rezumonta
equilibror	eku̯ilibrɔr
plufortigar	plufɔrtiɡar
mentioza	mentjoza
aristokrati	aristokrati
fiancitulo	fiant͡situlo
judiciar	ʒudit͡si̯ar
gravitanta	ɡravitanta
suciar	sut͡siar
saturate	saturate
uniono	unjono
kalsoneto	kalsoneto
generale	ɡenerale
semano	sɛmanɔ
arbustaro	arbustarɔ
sisoti	sisoti
alfabeto	alfabeto
figi	fiɡi
deo	deo
rezumir	rezumir
raspez	raspɛz
decendanto	det͡sendanto
persuadir	persuadir
projetonta	proʒetonta
digo	diɡo
heme	heme
exasperito	eksasperito
filtroto	filtroto
skikuros	skikurɔs
exajeranti	eɡzad͡ʒeranti
vespereskos	vespereskɔs
koquanto	kokvanto
agema	aɡema
akompanoti	akompanoti
koqueyo	kokwejo
imaginor	imaɡinɔr
abandonabos	abandonabɔs
multiplikar	multiplikar
odoro	odoro
tormentar	tɔɾmɛntaɾ
dormar	dormar
kanti	kanti
trahizez	trahizɛz
neutroni	neu̯troni
karear	karear
aparir	aparir
insultoto	insultoto
partio	parti̯o
kalzo	kalzo
kalico	kalit͡so
prosternez	prosternɛz
derivaji	derivad͡ʒi
dezirinda	dezirinda
pensanti	pensanti
berenjeno	berend͡ʒeno
jermifar	d͡ʒermifar
stufoti	stufoti
mokadi	mokadi
olim	olim
sejornar	seʒornar
komplikez	komplikɛz
lancieri	lant͡si̯eri
indikesar	indikesar
koliar	koliar
ventir	ventir
aceptata	at͡septata
stroki	stroki
vers	vɛrs
pavono	pavɔnɔ
koquonte	kokvonte
saturiti	saturiti
tentonto	tentonto
papriko	papriko
tosto	tosto
striizar	striizar
skribinti	skribinti
favorate	favorate
exekuto	eɡzekuto
frivolo	frivolo
redemti	redemti
diminutar	diminutaɾ
akompanonto	akompanonto
naufrajo	nau̯frad͡ʒo
kantero	kantero
angulo	anɡulo
f	f
kaloro	kaloro
cinematografilo	t͡sinɛmatɔɡɾafilɔ
exasperinte	eksasperinte
quanteso	kwanteso
sizar	sizar
citota	t͡sitota
laudus	lau̯dus
melodio	melodi̯o
granizez	ɡranizɛs
bovo	bovo
verdaji	verdaʒi
negociar	neɡot͡si̯ar
charioto	t͡ʃarioto
cizo	t͡sizo
laute	lau̯te
kolumo	kɔlumɔ
fotografonto	fotoɡrafonto
biblioteko	biblioteko
dum	dum
deshonoro	deshonoro
pertinacia	peɾtinaθja
arogar	aroɡar
anhelar	anhelar
permutar	permutar
grado	ɡrado
memorante	memorante
decendar	det͡sendar
jirafo	d͡ʒirafo
subtilaji	subtilaʒi
juntita	d͡ʒuntita
ocido	ot͡sido
elaborar	ɛlabɔɾaɾ
jurnalo	d͡ʒurnalo
adoptez	adoptɛz
prezidus	prezidus
decembro	det͡sembro
atolo	atolo
detektivo	detektivo
odianto	odi̯anto
bagajo	baɡaʒo
abandonabez	abandonabɛz
irgu	irɡu
litri	litri
helpati	helpati
legendo	leɡendo
rezumata	rezumata
polara	polara
sisoto	sisoto
fortigato	fortiɡato
swabragar	swabraɡar
horlojeto	horlod͡ʒeto
guidas	ɡu̯idas
desorganiziti	desorɡaniziti
printempe	printempe
edro	edro
prezidez	prezidɛs
skikurir	skikurir
verko	verko
tauro	tawro
explikas	eɡzplikas
skreni	skreni
centimetri	t͡sentimetri
memoranta	memoranta
kulturo	kulturo
favorinti	favorinti
invadir	invadir
prosternas	prosternas
biplano	biplano
botanizonto	botanizonto
arachar	arat͡ʃar
agnoskito	aɡnoskito
memorez	memorɛs
ministi	ministi
kelkafoye	kelkafoje
alejor	aleʒɔr
repozar	ɾɛpɔzaɾ
emersar	emersar
antiqua	antikwa
nomado	nomado
sociso	sot͡siso
bankroto	bankroto
tu	tu
linguisto	linɡwisto
kunlaboronto	kunlaboronto
vere	vɛrɛ
fonto	fonto
membrani	membrani
kontributaji	kontributaʒi
raspiti	raspiti
coexistir	t͡soeɡzistir
projetito	proʒetito
cinematografilo	t͡sinematoɡrafilo
foseto	foso
jetar	ʒetar
frapita	frapita
trahizinta	trahizinta
dekani	dekani
mencionite	ment͡si̯onite
p	p
abolisar	abolisaɾ
judikonti	ʒudikonti
manipulas	manipulas
guvernerio	ɡuvernerio
literaturala	literaturala
favoranti	favoranti
matrico	matrit͡so
c	ts
uzabez	uzabɛz
hego	heɡo
decar	det͡sar
arjenta	arʒenta
aqua	akva
posdineo	pɔsdinɛo
damo	damo
legifado	leɡifado
sisito	sisito
komplezajo	komplezaʒo
exhortar	ekshortar
konjelar	kɔnʒɛlaɾ
toro	toro
herbo	hɛrbɔ
putrinta	putrinta
shikani	ʃikani
revuo	revu̯o
origini	oriɡini
bronzo	bronzo
memorinta	memorinta
insertis	insertis
malediki	malediki
obelisko	obelisko
parapluvi	parapluvi
liquida	liku̯ida
baso	basɔ
kompozar	kɔmpozar
demono	demono
atingos	atinɡɔs
aceptota	at͡septota
astmo	astmo
yogurto	joɡurto
bari	bari
fortuno	fɔrtuno
be	bɛ
benko	benko
raspinto	raspinto
imaginoti	imaɡinoti
equilibras	eku̯ilibras
trezori	trezori
upupo	upupo
vador	vadɔr
anticipanto	antit͡sipanto
papiliono	papiljono
insultita	insultita
cesiganti	t͡sesiɡanti
lokomoco	lokomot͡so
damnos	damnɔs
exasperez	eɡzasperɛs
bandajizinta	bandad͡ʒizinta
herdo	herdo
torono	torono
basamento	basamɛntɔ
agnoskar	aɡnoskar
laxigar	laksiɡar
refraktanta	refraktanta
beja	beʒa
lumo	lumo
kambio	kambjo
vados	vadɔs
yarale	jarale
decidanti	det͡sidanti
refutar	refutar
koquinta	kokvinta
konsoli	konsoli
tentinti	tentinti
fabrikor	fabrikɔr
ventor	ventɔr
exasperas	eksasperas
danko	danko
helpir	helpir
organizoto	orɡanizoto
kordo	kordo
prezenta	prezenta
equilibris	eku̯ilibris
refraktar	refraktar
aceptonto	at͡septonto
citus	t͡situs
oficianta	ofit͡si̯anta
insultiti	insultiti
planko	plaŋko
likis	likis
bandajizonti	bandad͡ʒizonti
suflar	suflar
vera	vera
signifikar	siɡnifikar
eroranta	eroranta
bolias	boli̯as
stufita	stufita
insulano	insulano
pijamo	piʒamo
makulizar	makulizar
precipitar	pret͡sipitar
koquar	kokwar
muso	muso
ofensos	ofensɔs
boliigar	boliiɡar
karpo	karpo
legacez	leɡat͡sɛs
extingar	eɡztinɡar
exajeranto	eɡzad͡ʒeranto
haltez	haltɛs
frapos	frapɔs
plumaro	plumaro
entraprezi	entraprezi
fotografonte	fotoɡrafonte
sigaruyo	siɡarujo
ico	itso
jurnali	ʒurnali
tirar	tirar
evolucionar	evolut͡si̯onar
apliko	apliko
aboyar	abojar
veturo	veturo
artokarpofrukto	artokarpofrukto
aparez	aparɛs
grelo	ɡrelo
koquanto	kokwanto
rurala	rurala
irir	irir
pako	pako
ofensinta	ofensinta
strikos	strikɔs
imaginus	imaɡinus
spricar	spritsar
agrokultivo	aɡrokultivo
adorite	adorite
mikrobi	mikrobi
kompetenta	kompetenta
bandajizinte	bandad͡ʒizinte
projetinti	prod͡ʒetinti
desfidemeso	desfidemeso
funcionar	funt͡si̯onar
granizis	ɡranizis
kationo	kati̯ono
anado	anado
hiperligar	hiperliɡar
timida	timida
til	til
kunlaborinta	kunlaborinta
adiate	adi̯ate
bandajizinti	bandad͡ʒizinti
apertus	apertus
magra	maɡra
alejus	aled͡ʒus
iluziono	iluzjono
spatulo	spatulo
futbalo	futbalo
helpoto	helpoto
jornomezo	ʒornomezo
agato	aɡato
tentez	tentɛz
fotografati	fotoɡrafati
ecelar	et͡selar
mediano	medi̯ano
agnoskez	aɡnoskɛs
pasajar	pasaʒar
peruko	peruko
anticipos	antit͡sipɔs
molestar	molestar
w	w
briocho	bɾiɔt͡ʃɔ
operacar	operat͡sar
organiziti	orɡaniziti
ti	ti
abandonanti	abandonanti
chereskez	t͡ʃereskɛz
ofensonte	ofensonte
insultanti	insultanti
acento	at͡sɛnto
tondrar	tɔndrar
montenegro	monteneɡro
vespereskanto	vespereskanto
skikurinto	skikurinto
jorneskar	ʒorneskar
restaurati	restau̯rati
demonstrati	demonstrati
festinez	festinɛz
adoptas	adoptas
abatate	abatate
mungar	muŋɡar
disciplinanti	dist͡siplinanti
rostro	rostro
atentas	atentas
adoptis	adoptis
menciononto	ment͡si̯ononto
troni	troni
prezidero	prezidero
decidato	det͡sidato
gondolo	ɡondolo
judikati	d͡ʒudikati
bakoto	bakoto
balistiko	balistiko
enzimo	enzimo
helpos	helpɔs
lanceto	lant͡seto
jokar	ʒokar
likez	likɛz
aplikas	aplikas
klara	klara
likinto	likinto
tentonta	tentonta
desorganizinto	desorɡanizinto
domestika	domestika
quinino	kvinino
projetinta	proʒetinta
decidonta	det͡sidonta
maestrala	maestrala
bakterii	bakterii
audaceskez	au̯dat͡seskɛs
striizez	striizɛz
exasperoto	eksasperoto
hungro	hunɡro
glatigez	ɡlatiɡɛs
organizinto	orɡanizinto
charmante	t͡ʃarmante
hundo	hundo
bastonagez	bastonaɡɛz
desorganizite	desorɡanizite
equilibrinte	eku̯ilibrinte
gaya	ɡaja
disciplinir	dist͡siplinir
movar	movar
apliki	apliki
dormez	dormɛs
kontas	kontas
donacar	donat͡sar
kontir	kontir
jovdio	ʒovdio
equilibrinto	eku̯ilibrinto
akuzez	akuzɛs
restaurez	restau̯rɛs
pasto	pasto
varmega	varmeɡa
gasagar	ɡasaɡar
burjono	burd͡ʒono
pensis	pensis
bandajizoto	bandad͡ʒizoto
divorcar	divort͡sar
projetonti	proʒetonti
lanciero	lant͡si̯ero
kunlaborinti	kunlaborinti
oficiro	ofit͡siro
depozinto	depozinto
judikar	ʒudikar
montoza	montoza
mencionita	ment͡si̯onita
purpurea	purpurea
equilibrez	ekvilibrɛs
jacanta	d͡ʒat͡santa
judikeri	ʒudikeri
ofici	ofit͡si
exekutebla	eɡzekutebla
koquez	koku̯ɛz
ganto	ɡanto
tote	tote
le	le
axoloto	akzoloto
ante	ante
nacionala	nat͡sionala
skribez	skribɛz
siluri	siluri
sindikato	sindikato
nervika	nervika
atentinti	atentinti
entuziasmigar	entuzijasmiɡar
planaji	planad͡ʒi
jentila	ʒentila
kruela	kruela
kontonte	kontonte
dicate	dit͡sate
nudismo	nudismo
molusko	molusko
sorgar	sɔrɡar
questioni	kvesti̯oni
fricionar	fɾit͡sjɔnaɾ
yuna	juna
esanti	esanti
autoro	au̯toro
perturbato	perturbato
izomeri	izomeri
marchez	mart͡ʃɛz
bruli	bruli
biblo	biblo
koquanta	kokvanta
papi	papi
silka	silka
evolucionos	evolut͡si̯onɔs
protektar	protektar
pensoti	pensoti
dubitema	dubitema
jupeti	ʒupeti
braceleto	brat͡seleto
giganto	ɡiɡanto
juvelisto	d͡ʒuvelisto
petiolo	peti̯olo
yaro	jaro
euro	ɛu̯ro
proximeskar	proksimeskar
probas	probas
projetito	prod͡ʒetito
chanjanti	t͡ʃanʒanti
asno	asno
bandajizinta	bandaʒizinta
reciproka	ret͡siproka
inko	inko
enkorpigonte	enkorpiɡonte
helpar	hɛlpar
solstico	solstit͡so
falar	falar
adjuntar	ad͡ʒuntar
izraelido	izɾaɛlidɔ
envolvir	envolvir
apogilo	apoɡilo
manjesar	manʒesar
gorilo	ɡɔrilɔ
pruvar	pruvar
sisante	sisante
skribonte	skribonte
genro	ɡenro
chanjabez	t͡ʃanʒabɛz
procesema	prot͡sesema
armarko	armarko
amorato	amorato
exasperar	eksasperar
plajo	plad͡ʒo
pavonumo	pavɔnumɔ
stufanto	stufanto
litigante	litiɡante
l	le
perturbar	perturbar
cienco	t͡siɛnt͡sɔ
orgenisti	orɡenisti
latrino	latrino
adpozar	adpozar
nun	nun
papilioni	papili̯oni
rezumita	rezumita
ofensota	ofensota
likiti	likiti
konfesar	kɔnfesar
evaluar	evaluar
citati	t͡sitati
nervi	nervi
vino	vino
situesi	situesi
patro	patro
plantacerio	plantat͡serio
chereskar	t͡ʃereskar
japono	ʒapono
dicez	dit͡sɛz
glatigati	ɡlatiɡati
sublimanto	sublimanto
navigado	naviɡado
exulcero	eksult͡sero
dialogizar	di̯aloɡizar
hodie	hodi̯e
mediko	mediko
charmonti	t͡ʃarmonti
borar	borar
nokteskar	nɔktɛskar
butiko	butiko
sugar	suɡar
sublima	sublima
okazioni	okazi̯oni
iranta	iranta
revolucionema	revolut͡sionema
asidua	asiduwa
adorati	adorati
susteni	susteni
suedia	swɛdja
ami	ami
tormentato	tormentato
alejez	aleʒɛz
helpato	helpato
filtris	filtris
plumieri	plumi̯eri
tentanti	tentanti
bandajizote	bandaʒizote
stufante	stufante
abrejas	abred͡ʒas
mencionoto	ment͡si̯onoto
krugo	kruɡo
regeneras	reɡeneras
citinto	t͡sitinto
abandoninta	abandoninta
exasperinto	eksasperinto
prezenta	pɾɛzɛnta
championo	t͡ʃampiono
patruli	patruli
skopo	skɔpɔ
tro	tro
speco	spet͡so
botanizato	botanizato
ondego	ondeɡo
tormentati	tormentati
bakiti	bakiti
preco	pret͡so
organeto	orɡaneto
vidati	vidati
bramis	bramis
konceptar	kont͡septar
evolucionor	evolut͡si̯onɔr
weldos	weldɔs
meteoro	meteoro
aranjar	arand͡ʒar
hipo	hipo
leciono	let͡si̯ono
haringo	harinɡo
kultivar	kultivar
pinguino	pinɡvino
cerizo	t͡serizo
arki	arki
skribar	skribar
seruristo	seruristo
chanjez	t͡ʃand͡ʒɛs
koquato	kokwato
urjar	urd͡ʒar
animalo	animalo
trahizas	trahizas
incendiir	int͡sendiir
bicoko	bit͡soko
bruto	bruto
favorez	favorɛz
laudonti	lau̯donti
lamento	lamento
tirez	tirɛz
explikir	eɡzplikir
koquota	kokwota
filtrito	filtrito
fortigis	fortiɡis
akompanez	akompanɛz
organizate	orɡanizate
insultato	insultato
sequar	seku̯ar
raspanto	raspanto
briko	briko
mencionato	ment͡si̯onato
mencionez	ment͡si̯onɛz
frapato	frapato
farbo	farbo
incendiar	int͡sendi̯ar
organizote	orɡanizote
perturbanto	perturbanto
kantinte	kantinte
sacerdoti	sat͡serdoti
moblo	mɔblɔ
diafana	di̯afana
guyavo	ɡujavo
agnoskanti	aɡnoskanti
flecho	flet͡ʃo
akompanonti	akompanonti
joko	d͡ʒoko
verdaji	verdad͡ʒi
abandonez	abandonɛs
jeneroza	d͡ʒeneroza
metri	metri
anticipor	antit͡sipɔr
abandonos	abandonɔs
atingonti	atinɡonti
helponti	helponti
adsub	adsub
proximesko	proksimesko
apertis	apertis
saturonta	saturonta
kontis	kontis
charminto	t͡ʃarminto
gravida	ɡravida
tarto	taɾtɔ
evolucionis	evolut͡si̯onis
lamentonto	lamentonto
expektar	eɡzpektar
askoltar	askɔltar
ofensata	ofensata
perkutos	perkutɔs
kolokar	kolokar
profetala	prɔfɛtala
polemikus	polemikus
dicanto	dit͡santo
denti	denti
komprenende	komprenende
imaginonta	imaɡinonta
ivoro	ivoro
decidata	det͡sidata
legumo	leɡumo
arko	arko
kontinta	kontinta
jorni	d͡ʒorni
projetez	proʒetɛz
inflamar	inflamar
futurala	futurala
ube	ubɛ
explikar	eɡzplikar
komplikez	komplikɛs
propulsar	propulsar
vizar	vizar
chanjoti	t͡ʃand͡ʒoti
turnez	turnɛz
metala	metala
tombo	tombo
animar	animar
statuto	statuto
kuriero	kuriero
bubi	bubi
laboratorio	laboratorio
menciono	ment͡si̯ono
glatigor	ɡlatiɡɔr
kantor	kantɔr
ajornar	ad͡ʒornar
exasperos	eksasperɔs
shovinismi	ʃovinismi
anciena	ant͡sjena
abandonota	abandonota
mirakli	mirakli
championeso	t͡ʃampi̯oneso
erorez	erorɛs
induktar	induktar
tentate	tentate
nucoruptilo	nut͡soruptilo
agnoskir	aɡnoskir
laudinti	lau̯dinti
esperonto	esperonto
aceptos	at͡septɔs
bastonagor	bastonaɡɔr
grafiko	ɡrafiko
solena	solena
tomato	tomato
skribis	skribis
projetati	prod͡ʒetati
laxigir	laɡziɡir
decidema	det͡sidema
un	un
abandoninti	abandoninti
deputis	deputis
akompanus	akompanus
lamentanto	lamentanto
tentato	tentato
elu	elu
akompanonta	akompanonta
kerlo	kɛrlo
imaginito	imaɡinito
barilo	barilo
retrotirar	retrotirar
fotografiti	fotoɡrafiti
laveyo	lavejo
kunlaboros	kunlaborɔs
sisonto	sisonto
erorir	erorir
botanizoto	botanizoto
peizajo	peizaʒo
citinte	t͡sitinte
quale	kwale
lernolibro	lernolibro
censurez	t͡sensurɛz
merkurdio	merkurdio
recepciono	ret͡sept͡si̯ono
domajo	domaʒo
produktar	produktar
bagajo	baɡad͡ʒo
sisis	sisis
mati	mati
fonteni	fonteni
pronta	prɔnta
esperas	esperas
arkiduko	arkiduko
juvelo	ʒuvelo
projetati	proʒetati
trahizite	trahizite
spontana	spontana
aceptate	at͡septate
projetota	prod͡ʒetota
tota	tota
formala	fɔrmala
pregeyi	preɡeji
cintilo	t͡sintilo
trotuaro	trotwaro
ampla	ampla
universitato	universitato
aviaco	aviat͡so
elefantuli	elefantuli
fotografoti	fotoɡrafoti
famoza	famoza
equilibrir	ekvilibrir
drinkeyo	drinkejo
bujio	buʒi̯o
blazono	blazono
mencionoti	ment͡si̯onoti
klauno	klau̯no
kondutar	kondutar
bandajizoto	bandaʒizoto
kompatinda	kompatinda
skribinto	skribinto
rezuminta	rezuminta
bandajizita	bandaʒizita
aparar	aparar
kleriko	kleriko
dorso	dorso
kunlaboronta	kunlaboronta
championo	t͡ʃampjono
optimisti	optimisti
helpinti	helpinti
ofensite	ofensite
memorato	memorato
servar	servar
glitveturo	ɡlitveturo
flatuema	flatuema
naturale	naturale
siejar	sjɛʒar
dementerio	dementerio
pektoro	pektoro
raspas	raspas
helpata	helpata
tenebroza	tenebroza
evaluate	evaluate
idoli	idoli
chasar	t͡ʃasaɾ
h	h
an	an
equilibranti	ekvilibranti
konsiderar	konsiderar
recepcionor	ret͡sept͡si̯onɔr
eroro	ɛɾɔɾɔ
adoptite	adoptite
chanjir	t͡ʃanʒir
autuno	au̯tuno
insultate	insultate
jentila	d͡ʒentila
ajornir	aʒornir
uzar	uzar
imaginiti	imaɡiniti
aquovortico	akvovortit͡so
enlanjigar	enlanʒiɡar
lando	lando
prezidar	prezidar
mencionate	ment͡si̯onate
sorgos	sorɡɔs
acensar	at͡sensar
projetote	proʒetote
habila	habila
mencionis	ment͡si̯onis
imaginar	imaɡinar
ge	ɡe
traduki	traduki
perturbanti	perturbanti
koquonto	kokvonto
judiki	ʒudiki
jamaika	d͡ʒamaika
trahizanto	trahizanto
altaji	altaʒi
metar	metar
solvar	solvar
ce	t͡se
tormentate	tormentate
deciditi	det͡siditi
apelos	apelɔs
desorganizos	desorɡanizɔs
adoptus	adoptus
eklezio	eklezio
sitelo	sitelo
kandio	kandi̯o
paro	paro
enkorpiginti	enkorpiɡinti
arogema	aroɡema
bideti	bideti
traktar	traktar
muzikar	muzikar
partikulo	partikulo
projetus	proʒetus
nova	nɔva
prosternor	prosternɔr
inversigo	inversiɡo
kontite	kontite
bakar	bakar
lamentanti	lamentanti
disciplinez	dist͡siplinɛz
densa	densa
laxa	laksa
kontiti	kontiti
laxigos	laksiɡɔs
judikonto	d͡ʒudikonto
matro	matro
kardinala	kardinala
predicante	predit͡sante
interviuvo	intervjuvo
monstro	monstro
mencioninta	ment͡si̯oninta
flajoleti	flad͡ʒoleti
reputeso	reputeso
litiganta	litiɡanta
frajila	frad͡ʒila
ja	ʒa
koquate	kokwate
prurito	pɾuɾitɔ
koquinti	kokwinti
trista	trista
gravitanto	ɡravitanto
ligar	liɡar
sisite	sisite
krimini	krimini
kompreneble	kompreneble
organo	orɡano
koluzionar	koluzi̯onar
ventas	ventas
koquar	kokvar
paroki	paroki
vabo	vabo
augmentar	au̯ɡmentar
botanizite	botanizite
memorata	memorata
koquite	kokwite
memoror	memorɔr
aranjis	arand͡ʒis
tropiko	tropiko
cesar	t͡sesar
komitati	komitati
koquinte	kokwinte
mencionez	ment͡si̯onɛs
haro	haro
boliez	boli̯ɛz
pastinako	pastinako
aerostati	aerostati
citar	t͡sitar
punto	punto
exasperiti	eksasperiti
striizas	striizas
evolucionus	evolut͡si̯onus
terminaro	terminaro
exasperinta	eɡzasperinta
dupo	dupo
koquote	kokwote
tegar	teɡar
festinanto	festinanto
poltrona	poltrona
sed	sed
stufonta	stufonta
likonto	likonto
sajesi	sad͡ʒesi
mencionanto	ment͡si̯onanto
vito	vito
enkorpiganta	enkorpiɡanta
temerara	temerara
enkorpigas	enkorpiɡas
gorilo	ɡorilo
guidis	ɡvidis
vadas	vadas
piro	piro
plucherigar	plut͡ʃeriɡar
parei	parei
nukleoli	nukleoli
bubo	bubo
festinor	festinɔr
fotografonta	fotoɡrafonta
koquito	kokwito
gardeno	ɡardɛnɔ
judiko	ʒudiko
homo	homo
likinte	likinte
moyeno	mojeno
sofismo	sofismo
abandonata	abandonata
atentinta	atentinta
memoroti	memoroti
swichar	swit͡ʃar
regeneranti	reɡeneranti
arjento	ard͡ʒento
dusenceso	dusent͡seso
terciara	tert͡si̯ara
projetanti	proʒetanti
ajornis	ad͡ʒornis
likas	likas
neutra	neu̯tra
hodie	hodie
argumenti	arɡumenti
sinonimi	sinonimi
kriar	kriar
adjuntar	adʒuntar
mortar	mɔrtar
fabrikerio	fabrikerio
tarto	tarto
abatonto	abatonto
mandolino	mandolino
stoterar	stoterar
anticipinti	antit͡sipinti
busto	busto
glaciera	ɡlat͡si̯era
autori	au̯tori
gratez	ɡratɛz
spiki	spiki
mardio	mardi̯o
mikroskopo	mikroskopo
dronar	dronar
imaginota	imaɡinota
aranjus	arand͡ʒus
ibe	ibɛ
atingor	atinɡɔr
saturite	saturite
gravitos	ɡravitɔs
abase	abase
lano	lano
polemikar	polemikar
adoroti	adoroti
akuzus	akuzus
sur	sur
equilibronti	ekvilibronti
judikonti	d͡ʒudikonti
tormentos	tormentɔs
linguo	linɡu̯o
plufermigar	plufɛrmiɡar
skribati	skribati
chanjati	t͡ʃand͡ʒati
akompanote	akompanote
raspez	raspɛs
hakilo	hakilo
simio	simio
vivozigar	vivoziɡar
kreuri	kreu̯ri
litigonto	litiɡonto
komti	komti
mikrobo	mikrobo
leopardo	leopardo
explikor	eksplikɔr
obskura	obskura
regresas	reɡresas
elektar	elektar
lamentonta	lamentonta
piktus	piktus
cirkumklozar	t͡sirkumklozar
ceramikala	t͡seramikala
sisor	sisɔr
ube	ube
legifar	leɡifar
fontenoplumi	fontenoplumi
plumiero	plumi̯ero
helpanta	helpanta
minuto	minuto
pensos	pensɔs
exasperito	eɡzasperito
absolute	absolute
fortigonta	fortiɡonta
jetato	ʒetato
savurar	savurar
ozono	ozono
floso	floso
agnoskinte	aɡnoskinte
skikuranti	skikuranti
sana	sana
biliardo	bili̯ardo
desorganizito	desorɡanizito
stufote	stufote
prezidinta	prezidinta
ekirar	ekirar
dozo	dozo
rezumonte	rezumonte
promenar	promenar
oficiez	ofit͡si̯ɛs
tablo	tablo
adminime	adminime
decidanta	det͡sidanta
bolior	boli̯ɔr
burjono	burʒono
agrafo	aɡrafo
arbusto	arbusto
algebrala	alɡebrala
judikiti	ʒudikiti
vorticar	vortit͡sar
fortigez	fortiɡɛs
re	re
juntas	ʒuntas
avalancho	avalant͡ʃɔ
laxigar	laɡziɡar
jacanta	ʒat͡santa
rezumate	rezumate
plufreshigar	plufreʃiɡar
koquiti	kokwiti
operi	operi
projetonte	prod͡ʒetonte
equilibrote	eku̯ilibrote
agnoskato	aɡnoskato
kilogramo	kiloɡramo
polemikos	polemikɔs
celar	t͡selar
aranjar	aranʒar
rezumota	rezumota
decidante	det͡sidante
avalanchar	avalant͡ʃaɾ
arjentinia	arʒentinia
religio	reliɡi̯o
laudar	lau̯dar
skrubturnilo	skrubturnilo
pioniri	pi̯oniri
neuroni	neu̯roni
intencar	intent͡sar
tentata	tentata
litigite	litiɡite
pazo	pazo
trahizos	trahizɔs
frontieri	fronti̯eri
kaptar	kaptar
duriti	duriti
inflamuro	inflamuro
apertata	apertata
ocitar	ɔt͡sitaɾ
projetonto	proʒetonto
tondro	tɔndro
frapis	frapis
organizi	orɡanizi
turnor	turnɔr
altru	altru
transformar	transformar
aparor	aparɔr
pasinto	pasinto
klukar	klukar
dormez	dormɛz
kirko	kirko
aranjez	aranʒɛz
onklini	onklini
vorto	vɔrto
obtuza	obtuza
adorinta	adorinta
donaji	donaʒi
proletario	proletario
preter	pretɛr
vejetarar	ved͡ʒetarar
civila	t͡sivila
indiferenta	indiferenta
kantante	kantante
burjonifar	burʒonifar
junipero	ʒunipero
europana	eu̯ropana
pludensigar	pludɛnsiɡar
interviuvo	intɛɾvjuvɔ
frukto	frukto
projetor	prod͡ʒetɔr
sabla	sabla
brakiumo	brakjumo
kortico	kɔɾtit͡sɔ
sorgato	sorɡato
adoptinta	adoptinta
pludolcigar	pludɔlt͡siɡar
organizota	orɡanizota
kartochuyo	kartot͡ʃujo
organizoti	orɡanizoti
akompanito	akompanito
saturonte	saturonte
valo	valo
exasperiti	eɡzasperiti
armoro	armoro
akuzonte	akuzonte
glacar	ɡlat͡sar
adjektivi	adʒektivi
certa	t͡serta
abatoto	abatoto
silenco	silɛnt͡so
projetanto	prod͡ʒetanto
saturez	saturɛs
sorgati	sorɡati
sidilo	sidilo
jorneskar	d͡ʒorneskar
decidoti	det͡sidoti
cirkumklozez	t͡sirkumklozɛz
kafeo	kafeo
anagramo	anaɡramo
kancelereyo	kant͡selerejo
audacez	au̯dat͡sɛs
staco	stat͡so
adoptinti	adoptinti
adoronti	adoronti
stufinta	stufinta
situeso	situeso
milimetro	milimetro
secioni	set͡si̯oni
mielkuko	mi̯ɛlkuko
mezepokala	mezepokala
kasiso	kasiso
prezidonte	prezidonte
nutro	nutro
depose	depose
desorganizonta	desorɡanizonta
tero	tero
cirkondar	t͡sirkondar
episkopo	episkopo
varo	varo
autuno	au̯tunɔ
filtrata	filtrata
tuerta	tuerta
hidrogeno	hidroɡeno
fiancito	fiant͡sitɔ
partikulara	partikulara
kalva	kalva
mashino	maʃino
onu	onu
abatanta	abatanta
abatota	abatota
buletino	buletino
prejudiki	pred͡ʒudiki
ocio	ot͡si̯o
semano	semano
kombatala	kombatala
morfemo	morfemo
abundegar	abundeɡar
tentante	tentante
mikologio	mikoloɡi̯o
disciplinas	dist͡siplinas
chanjonti	t͡ʃand͡ʒonti
defensar	dɛfɛnsaɾ
aranjir	arand͡ʒir
citinta	t͡sitinta
stonagar	stonaɡar
on	ɔn
irez	irɛs
exasperoti	eksasperoti
cirkumklozez	t͡sirkumklozɛs
abasar	abasar
y	j
agitar	aɡitar
exasperata	eksasperata
iranto	iranto
dementa	dementa
bakata	bakata
enemiko	enemiko
decidota	det͡sidota
distingo	distinɡo
donar	donar
questiono	ku̯esti̯ono
querar	kwerar
guidos	ɡu̯idɔs
banko	banko
hezito	hezito
iror	irɔr
punto	puntɔ
charmonto	t͡ʃarmonto
ica	itsa
biomekaniko	biomekaniko
depozoto	depozoto
repudius	repudi̯us
logikala	loɡikala
kantos	kantɔs
memorati	memorati
atingar	atinɡar
re	ɾɛ
frapinte	frapinte
rurano	rurano
zinko	zinko
mizerikordio	mizerikordijo
altagrade	altaɡrade
domi	domi
shamigita	ʃamiɡita
proletarii	proletarii
promulgus	promulɡus
vicio	vit͡si̯o
domajo	domad͡ʒo
vomar	vomar
abandononto	abandononto
glatiganti	ɡlatiɡanti
gravitante	ɡravitante
sisinte	sisinte
dentifrico	dentifrit͡so
filtrita	filtrita
koquis	kokvis
kontinte	kontinte
noktomezi	noktomezi
raspata	raspata
insertez	insertɛz
abandonez	abandonɛz
kunlaboris	kunlaboris
fonteno	fonteno
griza	ɡriza
revolucionema	revolut͡sjonema
falo	falo
bandajiziti	bandad͡ʒiziti
planajo	planaʒo
huo	huo
saturinti	saturinti
equilibranti	eku̯ilibranti
funerala	funerala
insertez	insertɛs
citito	t͡sitito
racionala	rat͡si̯onala
adicionus	adit͡si̯onus
geno	ɡeno
gento	ɡɛnto
pacoza	pat͡soza
bandajizonte	bandad͡ʒizonte
equilibronto	ekvilibronto
amasigar	amasiɡar
erste	ɛɾste
trezoro	trezoro
fotografir	fotoɡrafir
autarkeso	au̯tarkeso
espelar	espelar
konto	konto
abundar	abundar
nedecidema	nedet͡sidema
tentiti	tentiti
progreso	proɡreso
damnez	damnɛz
lansar	lansar
boliigor	boliiɡɔr
organizar	orɡanizar
ajila	aʒila
apelonte	apelonte
exajeranto	eksaʒeranto
ovo	ovo
dinosauro	dinosawro
januaro	d͡ʒanuaro
oficiinte	ofit͡siinte
trahizate	trahizate
decidis	det͡sidis
frapor	frapɔr
sisato	sisato
gratez	ɡratɛs
frapate	frapate
es	ɛs
vadinti	vadinti
arakido	arakido
mentonumo	mɛntonumo
jetinto	d͡ʒetinto
rivo	rivo
borato	borato
anticiponti	antit͡siponti
ventus	ventus
ajornos	ad͡ʒornɔs
kontate	kontate
festinonto	festinonto
stifa	stifa
imaginato	imaɡinato
adorante	adorante
brular	brular
sparesar	sparesar
portuo	portwo
akompaninta	akompaninta
audacez	au̯dat͡sɛz
zefiro	zefiro
tiranatra	tiranatra
la	la
laxigos	laɡziɡɔs
spontaneso	spontaneso
kupo	kupo
koquos	kokvɔs
polvo	polvo
sikeskar	sikeskar
desorganizinti	desorɡanizinti
citoto	t͡sitoto
armeo	armeo
gravitinte	ɡravitinte
kunlabori	kunlabori
ironta	ironta
odiato	odi̯ato
ol	ol
oficiante	ofit͡si̯ante
favorita	favorita
praktiko	praktiko
fortigas	fortiɡas
disipar	disipar
mondumala	mondumala
litiganto	litiɡanto
augmentir	au̯ɡmentir
posto	posto
imaginite	imaɡinite
disciplinis	dist͡siplinis
adulto	adulto
kordono	kordono
glatigar	ɡlatiɡar
demonstranto	demonstranto
stufinti	stufinti
ironto	ironto
fortigonto	fortiɡonto
praktikar	praktikar
koquonte	kokwonte
quartermastro	kvartermastro
jacar	ʒat͡sar
persiko	persiko
okaziono	okazi̯ono
supernatura	supernatura
parapluvo	parapluvo
adoptonta	adoptonta
sorganto	sorɡanto
stativo	stativo
plajo	plaʒo
spanieleti	spani̯eleti
projetonti	prod͡ʒetonti
afliktar	afliktar
recepcionar	ret͡sept͡si̯onar
fondesar	fondesar
trahizinte	trahizinte
nomar	nɔmaɾ
apud	apud
aquiros	akwirɔs
projetata	prod͡ʒetata
exterajo	eksteraʒo
turnez	turnɛs
helpas	helpas
agonti	aɡonti
joyanta	d͡ʒojanta
iracar	irat͡sar
julio	ʒuli̯o
salono	salono
equilibrante	eku̯ilibrante
prezidinto	prezidinto
esinte	esinte
ganas	ɡanas
erorez	erorɛz
botaniziti	botaniziti
posdimezo	posdimezo
votos	votɔs
bonbono	bɔnbono
glezar	ɡlezar
fristo	fristo
amperi	amperi
mencionar	ment͡si̯onar
we	we
raspante	raspante
sanesar	sanesar
seciono	set͡siono
projetus	prod͡ʒetus
invadas	invadas
decidus	det͡sidus
diligenta	diliɡenta
glaciero	ɡlat͡si̯ero
genitivi	ɡenitivi
ocitar	ot͡sitar
stufajo	stufad͡ʒo
bersilo	bersilo
skikurez	skikurɛs
hano	hano
eternigar	eterniɡar
figuri	fiɡuri
desorganizez	desorɡanizɛz
flarar	flarar
livar	livar
objecionar	ɔbʒɛt͡sjɔnaɾ
turnar	turnar
frambo	frambo
akompanite	akompanite
adorito	adorito
materio	materio
rizomo	rizomo
kaverno	kaverno
cervo	t͡servo
lanco	lant͡so
dorsosako	dɔrsosako
derivaji	derivaʒi
enkorpigite	enkorpiɡite
obstakli	obstakli
nematodo	nematodo
kunlaborar	kunlabɔɾaɾ
akuzote	akuzote
dupigar	dupiɡar
alumeto	alumeto
promulgez	promulɡɛs
nordo	nordo
domeno	domeno
exasperir	eɡzasperir
insultoti	insultoti
akuzito	akuzito
adiante	adi̯ante
aeroliti	aeroliti
adorez	adorɛz
gravitas	ɡravitas
gravitonto	ɡravitonto
laxigis	laksiɡis
abatis	abatis
uno	uno
alterar	alterar
aceptor	at͡septɔr
demonstrato	demonstrato
floko	floko
lauta	lau̯ta
rinsar	rinsar
revoluciono	revolut͡sjono
guidis	ɡu̯idis
yarmili	jarmili
anguli	anɡuli
bandajizanta	bandaʒizanta
fingro	finɡro
junio	d͡ʒuni̯o
petrolo	petrolo
kamaradi	kamaradi
chanjis	t͡ʃanʒis
insultinta	insultinta
hachar	hat͡ʃar
nokti	nokti
explikas	eksplikas
adorez	adorɛs
cirkumskribir	t͡sirkumskribir
kelo	kelo
favorir	favorir
verketo	verketo
mestieristo	mestjeristo
buchar	but͡ʃar
filtranta	filtranta
neorganika	neorɡanika
atinganto	atinɡanto
tabulo	tabulo
exekutar	eksekutar
urbo	urbo
invadis	invadis
lore	lɔɾɛ
plura	plura
apertato	apertato
trahizante	trahizante
l	l
h	he
kantoti	kantoti
koquez	kokvɛs
agulo	aɡulo
ye	je
imagininta	imaɡininta
programo	proɡramo
vortico	vortit͡so
kamarado	kamarado
metas	metas
berenjeno	berenʒeno
dolca	dɔlt͡sa
admisar	admisar
promulgis	promulɡis
ajornir	ad͡ʒornir
inter	inter
akompanoto	akompanoto
vespereskonta	vespereskonta
akupunturo	akupunturɔ
laxigus	laɡziɡus
bakato	bakato
sisote	sisote
pensinti	pensinti
minaco	minat͡so
anticipis	antit͡sipis
oreli	oreli
projetanta	prod͡ʒetanta
helponte	helponte
kontoto	kontoto
teorio	teori̯o
amo	amo
kulturlinguo	kulturlinɡuwo
adoptinte	adoptinte
motivo	motivo
joko	ʒoko
cent	t͡sɛnt
aceptinti	at͡septinti
insertar	insertar
k	k
adicionos	adit͡si̯onɔs
bandajizante	bandad͡ʒizante
loko	loko
volfi	volfi
regresez	reɡresɛz
taso	taso
frapito	frapito
projetinto	proʒetinto
sonjo	sonʒo
projetante	proʒetante
rezumus	rezumus
raspinte	raspinte
temo	temo
aplikis	aplikis
p	pe
nikotino	nikotino
amoriti	amoriti
turmo	tuɾmɔ
kantite	kantite
miraklatra	miraklatra
stelaro	stelaro
insultote	insultote
disciplininti	dist͡siplininti
damnas	damnas
joyoza	d͡ʒojoza
jamaika	ʒamaika
cimbalo	t͡simbalo
kontar	kontar
loncho	lont͡ʃo
forjar	forʒar
deskovresar	deskovresar
neglijar	neɡlid͡ʒar
rafto	ɾaftɔ
uniono	uniono
aeroplano	aeroplano
portugal	portuɡal
mineralogio	mineraloɡi̯o
incendiati	int͡sendi̯ati
mondolinguala	mondolinɡuala
apelas	apelas
projetez	prod͡ʒetɛs
depozanto	depozanto
bramar	bramar
prezidinti	prezidinti
tirante	tirante
instruktar	instruktar
samlandano	samlandano
kontata	kontata
tentar	tentar
orkestro	orkestro
armo	armo
kantanta	kantanta
glaso	ɡlaso
favorinte	favorinte
babili	babili
ajustar	ad͡ʒustar
irga	irɡa
jornomezi	d͡ʒornomezi
adoptonte	adoptonte
fusilo	fusilɔ
opero	opero
te	te
bastono	bastono
alfabeti	alfabeti
frapus	frapus
formiko	formiko
lamentinto	lamentinto
avana	avana
permisas	permisas
eroro	eroro
organizinta	orɡanizinta
nukleala	nukleala
u	u
skribota	skribota
equilibrir	eku̯ilibrir
vespereskonte	vespereskonte
adoptor	adoptɔr
botanizinti	botanizinti
uzabez	uzabɛs
preterirar	preterirar
terpomo	terpomo
konsequar	konsekvar
lageti	laɡeti
organizonti	orɡanizonti
sudoro	sudoro
koquos	koku̯ɔs
imaginez	imaɡinɛz
adoptonto	adoptonto
ke	kɛ
atentota	atentota
gravitinti	ɡravitinti
quartermastro	ku̯artermastro
tensar	tensar
skarabeo	skarabeo
skikuronta	skikuronta
inflameso	inflameso
abatote	abatote
tuni	tuni
stroko	stroko
ke	ke
kara	kara
vespereskar	vespereskar
drinkerio	drinkerio
espo	ɛspo
peskar	pɛskar
projetonta	prod͡ʒetonta
literaturo	literaturo
greletar	ɡreletar
metalo	metalo
subtera	subtera
citrono	t͡sitrono
subtila	subtila
botanizota	botanizota
expektar	ekspektar
chanjir	t͡ʃand͡ʒir
trahizus	trahizus
intermixi	intermiksi
balbutar	balbutar
tentonte	tentonte
axi	aksi
favorota	favorota
solvuro	solvuro
sisiti	sisiti
ed	ɛd
prizar	prizar
esonte	esonte
elua	elwa
dezinenco	dezinɛnco
tentito	tentito
koliar	koljar
necesajo	net͡sesaʒo
banano	banano
kontez	kontɛz
bone	bone
imaginis	imaɡinis
gnomo	ɡnomo
predicato	predit͡sato
filtrinte	filtrinte
favorati	favorati
charmanti	t͡ʃarmanti
insultito	insultito
desaranjar	desarand͡ʒar
korespondo	korespondo
jorno	ʒorno
imaginonti	imaɡinonti
vetero	vetero
frumento	frumento
pavonumar	pavɔnumar
acendilo	at͡sendilo
axoloto	aɡzoloto
avo	avo
glata	ɡlata
vicero	vit͡sero
ofensinte	ofensinte
vespereskinto	vespereskinto
brodis	brodis
teplico	tɛplit͡so
krusto	krusto
votez	votɛz
jupo	d͡ʒupo
spiritalismo	spiritalismo
raptar	raptar
turnis	turnis
rano	rano
babilachabez	babilat͡ʃabɛs
simio	simjo
erektar	erektar
adoptinto	adoptinto
adoptote	adoptote
spano	spano
helpinto	helpinto
ofensor	ofensɔr
iranti	iranti
engajar	enɡad͡ʒar
lamentis	lamentis
abono	abono
brakio	brakio
truo	truo
organizanta	orɡanizanta
lua	lua
sajeso	sad͡ʒeso
vicina	vit͡sina
cherpar	t͡ʃerpar
grenado	ɡrenado
brodus	brodus
granizus	ɡranizus
chambro	t͡ʃambro
oficias	ofit͡si̯as
sorgita	sorɡita
abandonis	abandonis
bretelo	bretelo
abreviar	abrevi̯ar
memorita	memorita
we	wɛ
exasperata	eɡzasperata
fotografata	fotoɡrafata
prezidis	prezidis
eroror	erorɔr
filtrinti	filtrinti
abatite	abatite
tendo	tendo
nepotismo	nepotismo
jenjivo	ʒenʒivo
kontredicar	kontredit͡sar
acioniero	at͡sjonjeɾo
piktez	piktɛs
almonar	almonar
mentio	menti̯o
axi	aɡzi
guidos	ɡvidɔs
juntita	ʒuntita
projetir	proʒetir
shikano	ʃikano
surfacala	surfat͡sala
fumar	fumar
envolvas	envolvas
filtronti	filtronti
materio	matɛɾiɔ
laudos	lau̯dɔs
animor	animɔr
kontanta	kontanta
miraklo	miraklo
fotografinta	fotoɡrafinta
domo	domo
streta	streta
kolonii	kolonii
sauco	sau̯t͡so
memoranti	memoranti
citos	t͡sitɔs
mesajo	mesad͡ʒo
lakto	lakto
pe	pɛ
plafono	plafɔnɔ
praktikas	praktikas
sekar	sekar
ventez	ventɛs
decidinta	det͡sidinta
permisos	permisɔs
regresos	reɡresɔs
skribote	skribote
pozar	pozar
tisui	tisui
koquero	kokwero
fortigata	fortiɡata
sondar	sɔndar
citis	t͡sitis
aginti	aɡinti
imaginanto	imaɡinanto
pensati	pensati
sublimati	sublimati
desklozez	desklozɛz
elua	elua
domeni	domeni
naciono	nat͡siono
kandeliero	kandeli̯ero
slovakia	slovaki̯a
joyala	d͡ʒojala
formacar	fɔrmat͡sar
organizor	orɡanizɔr
abatito	abatito
spumifor	spumifɔr
centro	t͡sentro
defensante	defensante
maristo	maristo
desfaciligar	desfat͡siliɡar
disimulez	disimulɛz
atinginta	atinɡinta
festinus	festinus
uzi	uzi
totmonda	totmonda
samlandani	samlandani
brechizonti	bret͡ʃizonti
naciono	nat͡sjono
cirkumiranti	t͡sirkumiranti
koquante	kokwante
regenerata	reɡenerata
orkestro	ɔrkɛstrɔ
vespereskor	vespereskɔr
adicionez	adit͡si̯onɛz
recevar	ret͡sevar
tentir	tentir
skribus	skribus
tentos	tentɔs
chanjor	t͡ʃand͡ʒɔr
aceptote	at͡septote
flajoleto	flad͡ʒoleto
anticipata	antit͡sipata
fortigos	fortiɡɔs
sako	sako
filtrate	filtrate
desorganizanti	desorɡanizanti
ridetar	ridɛtaɾ
iracez	irat͡sɛz
enkorpigonta	enkorpiɡonta
artisto	artisto
maro	maro
filozofio	filozofjo
civito	t͡sivito
manjajo	mand͡ʒad͡ʒo
bandajo	bandaʒo
po	po
decidas	det͡sidas
sidar	sidaɾ
libro	libro
paviliono	paviliono
kapitalo	kapitalo
judikoti	ʒudikoti
bandajizanta	bandad͡ʒizanta
augurar	au̯ɡurar
saturote	saturote
frapas	frapas
blöf	bløf
kuliero	kuli̯ero
vespereskinti	vespereskinti
ondo	ondo
ge	ɡɛ
balnar	balnar
exasperita	eɡzasperita
favoroto	favoroto
fe	fe
sublimar	sublimar
romanala	romanala
aktuala	aktuala
spozo	spozo
dicir	dit͡sir
senco	sent͡so
standar	standar
chanjoti	t͡ʃanʒoti
kamiono	kamiono
desorganizinte	desorɡanizinte
litigas	litiɡas
sublimez	sublimɛs
extingar	ekstinɡar
experimento	eksperimento
ventro	ventro
manipulo	manipulo
babiladar	babiladar
abatajaro	abataʒarɔ
anjeli	and͡ʒeli
rezumez	rezumɛz
bergamoto	berɡamoto
kabano	kabano
que	kwe
damnar	damnar
sovaja	sovaʒa
venerdio	venerdio
favoranta	favoranta
repteri	repteri
desorganizoto	desorɡanizoto
equilibrite	ekvilibrite
vitro	vitro
akompananto	akompananto
abrejar	abred͡ʒar
ulular	ulular
auskultar	au̯skultar
futbalo	futbalɔ
plezar	plezar
julio	d͡ʒuli̯o
alejos	aleʒɔs
insultonti	insultonti
strando	strando
membrano	membrano
permisez	permisɛs
sisonti	sisonti
tribuo	tribuwo
equilibrinta	ekvilibrinta
signi	siɡni
insultez	insultɛs
pruritar	pruritar
exasperante	eɡzasperante
religiala	reliɡiala
pendar	pendar
faliar	fali̯ar
aplikus	aplikus
karikaturo	karikaturo
abatas	abatas
yarmilo	jarmilo
lejera	leʒera
oficionti	ofit͡si̯onti
nuanco	nuant͡so
helpinta	helpinta
likote	likote
aquo	akwo
spanieli	spani̯eli
saturir	saturir
omnibuso	omnibuso
detale	detale
selektar	selektar
max	maks
nemediata	nemedi̯ata
kam	kam
debato	debato
sekundara	sekundara
pistolo	pistolo
incendiata	int͡sendi̯ata
bakinti	bakinti
litigor	litiɡɔr
chaso	t͡ʃasɔ
skultar	skultar
separar	separar
likati	likati
perturbor	perturbɔr
foliaro	foli̯aro
papavero	papavero
dicus	dit͡sus
substanci	substant͡si
sinonimo	sinonimo
lipogramo	lipoɡramo
musho	muʃo
taxio	taɡzi̯o
dieto	di̯eto
adoptita	adoptita
organizez	orɡanizɛz
populo	populo
kolokez	kolokɛs
likoto	likoto
mencioninto	ment͡si̯oninto
absinto	absinto
aparez	aparɛz
ventez	ventɛz
enkorpigar	enkorpiɡar
nicho	nit͡ʃo
aquiros	akvirɔs
sanigas	saniɡas
juar	ʒuar
fasado	fasado
amebo	amebo
forta	forta
saturdio	saturdi̯o
artificale	artifit͡sale
bandajizonto	bandad͡ʒizonto
baseno	baseno
dinosaurio	dinosawrio
altajo	altad͡ʒo
likor	likɔr
caro	t͡saro
dinamito	dinamito
striizos	striizɔs
fotografito	fotoɡrafito
exasperus	eksasperus
siejo	sjɛʒɔ
lego	leɡo
milio	miljo
docar	dɔt͡saɾ
fabriko	fabriko
restauranto	restau̯ranto
parenta	parenta
bandajizez	bandad͡ʒizɛs
beligar	beliɡar
konsakrar	konsakrar
ofensita	ofensita
prenar	prenar
regenerez	reɡenerɛs
avalanchar	avalant͡ʃar
imaginati	imaɡinati
jetinto	ʒetinto
dolorar	dolorar
basamento	basamento
kontredici	kontredit͡si
uneso	uneso
kodexo	kodeɡzo
koloniano	koloniano
separir	separir
nuva	nuva
vera	vɛra
stufonte	stufonte
kolumo	kolumo
geologo	ɡeoloɡo
akompanate	akompanate
adoptate	adoptate
aceptis	at͡septis
busoli	busoli
sorgir	sorɡir
medikala	mɛdikala
perplexa	perpleɡza
plumo	plumo
abatez	abatɛz
kolizioni	kolizi̯oni
ajornos	aʒornɔs
respirez	respirɛs
videbla	vidɛbla
judikinti	d͡ʒudikinti
lineo	lineo
fiancito	fiant͡sito
akuzante	akuzante
citita	t͡sitita
ci	tsi
aspirar	aspirar
favorata	favorata
kantate	kantate
remarkar	remarkar
iesu	i̯esu
egorjar	ɛɡorʒar
raupi	rau̯pi
depozor	depozɔr
olua	olua
skikuranto	skikuranto
desplezuro	dɛsplezuro
projetos	prod͡ʒetɔs
adoroto	adoroto
briocho	briot͡ʃo
desorganizi	desorɡanizi
lamentanta	lamentanta
mencioninda	ment͡sioninda
saturinta	saturinta
yari	jari
filtronte	filtronte
skribante	skribante
gastigar	ɡastiɡar
equilibranto	eku̯ilibranto
skikurus	skikurus
ajornus	aʒornus
tranchar	tɾant͡ʃaɾ
jupo	ʒupo
fotografoto	fotoɡrafoto
meza	meza
wiskio	wiski̯o
senmezura	senmezura
regresor	reɡresɔr
furtos	furtɔs
ajornas	aʒornas
akompanez	akompanɛs
kato	kato
transfigurar	transfiɡurar
amorala	amorala
elaborar	elaborar
exasperinti	eɡzasperinti
disciplinati	dist͡siplinati
genevi	ɡenevi
februaro	februaro
ananasi	ananasi
sukoza	sukoza
pe	pe
reptero	reptero
akompanos	akompanɔs
glebo	ɡleba
exasperir	eksasperir
objekto	obd͡ʒekto
filtrote	filtrote
lamentas	lamentas
dicos	dit͡sɔs
joyoza	ʒojoza
discipliniti	dist͡sipliniti
depozario	depozari̯o
mentono	mentono
pilo	pilo
or	ɔr
blua	blua
komprenesar	komprenesar
paviliono	paviljono
abortar	abortar
memorito	memorito
modemo	modemo
favoronto	favoronto
durstar	durstar
liechtenstein	liktɛnʃtai̯n
gravitinto	ɡravitinto
adibe	adibe
aranjor	arand͡ʒɔr
equilibras	ekvilibras
belgia	belɡja
gravitir	ɡravitir
exasperonti	eɡzasperonti
decidinti	det͡sidinti
kruda	kruda
shako	ʃako
disciplinus	dist͡siplinus
aristokrato	aristokrato
serbia	serbi̯a
aquirez	akwirɛz
aplikez	aplikɛs
atentos	atentɔs
sigaro	siɡaro
quale	kwalɛ
projetoti	proʒetoti
jetoto	ʒetoto
shamigor	ʃamiɡɔr
cindro	t͡sindro
moyeni	mojeni
profetala	profetala
decembri	det͡sembri
likota	likota
kasrolo	kasrolo
genero	ɡenero
regenerez	reɡenerɛz
insultonte	insultonte
energio	enerɡi̯o
mani	mani
sorginti	sorɡinti
eroros	erorɔs
litigonti	litiɡonti
fresheskar	freʃeskar
komprenebla	komprenebla
formikumo	fɔrmikumo
amaso	amaso
aquirar	akwirar
chasohundo	t͡ʃasohundo
visar	visar
irgo	irɡo
padelo	padelo
sinonima	sinonima
furio	furi̯o
exutorio	eɡzutori̯o
jus	ʒus
decidar	det͡sidar
restauris	restau̯ris
shamigonta	ʃamiɡonta
he	hɛ
filtrinta	filtrinta
perturbus	perturbus
pozez	pozɛs
aptesar	aptesar
ajornez	aʒornɛz
mem	mem
insultinte	insultinte
lamentonte	lamentonte
antibiotiko	antibi̯otiko
trahizez	trahizɛs
bubono	bubono
filmo	filmo
jetar	d͡ʒetar
biomaso	biomaso
koquata	kokvata
konglomerato	konɡlomerato
sisati	sisati
manipulado	manipulado
glano	ɡlano
bakonta	bakonta
frapinta	frapinta
agi	aɡi
genio	ɡenijo
video	vidɛjɔ
glacieskar	ɡlat͡sjeskar
batar	batar
fotografita	fotoɡrafita
repentar	repentar
vespereskonto	vespereskonto
nuklea	nuklea
viciozeso	vit͡si̯ozeso
devancar	devant͡sar
kamizo	kamizo
insertos	insertɔs
barbuliar	barbuli̯ar
imagininte	imaɡininte
x	kse
alejor	aled͡ʒɔr
idiotismoza	idiotismoza
joyar	ʒojar
kontote	kontote
ita	ita
envolvus	envolvus
equilibrez	eku̯ilibrɛz
pomo	pɔmɔ
juez	ʒuɛz
energioza	enerɡi̯oza
ofensis	ofensis
vejetar	veʒetar
origano	oriɡano
statistiko	statistiko
etiko	etiko
volvar	vɔlvar
iracus	irat͡sus
yarala	jarala
fotografanti	fotoɡrafanti
kuglo	kuɡlo
agar	aɡar
citite	t͡sitite
krespo	krespo
bakanto	bakanto
citante	t͡sitante
oficior	ofit͡si̯ɔr
mariajar	mari̯aʒar
evolucionez	evolut͡si̯onɛs
frago	fraɡo
bigami	biɡami
stufati	stufati
linguala	linɡwala
peninsulo	peninsulo
decidanto	det͡sidanto
devorar	devorar
mentioza	mentioza
d	d
ne	ne
jeneroza	ʒeneroza
anciena	ant͡sjɛna
insultos	insultɔs
mentiar	mentjar
esvanar	ɛsvanar
aceptonta	at͡septonta
bastonagos	bastonaɡɔs
importanto	importanto
pluvo	pluvɔ
co	tso
kontredico	kontredit͡so
abandonate	abandonate
supernatura	supɛrnatura
tardigar	tardiɡar
quantesi	ku̯antesi
apertar	apertar
bucheyo	but͡ʃejo
vidato	vidato
desorganizonto	desorɡanizonto
charminti	t͡ʃarminti
termino	termino
kandelo	kandelo
engajar	enɡaʒar
organizez	orɡanizɛs
moskito	moskito
strikas	strikas
depozito	depozito
rezumos	rezumɔs
genitoro	ɡenitoro
instrukto	instrukto
hipar	hipar
atinginto	atinɡinto
fantaziir	fantaziir
ito	itɔ
digi	diɡi
rikomencar	rikoment͡sar
glacierala	ɡlat͡si̯erala
bordi	bordi
ajustez	ad͡ʒustɛs
gratitudar	ɡratitudar
paperacho	paperat͡ʃo
recepcionir	ret͡sept͡si̯onir
organizinte	orɡanizinte
mondo	mondo
jemelo	d͡ʒemelo
inflamo	inflamo
vulgara	vulɡara
kupolo	kupolo
sisinto	sisinto
tekto	tɛkto
imposti	imposti
filtronta	filtronta
venor	venɔr
spinato	spinato
amiko	amiko
sanigez	saniɡɛs
anticipita	antit͡sipita
charjar	t͡ʃarʒar
esamifar	esamifar
fortiganto	fortiɡanto
el	el
licenco	lit͡sent͡so
liro	liro
imperiestri	imperi̯estri
adoronta	adoronta
ministo	ministo
introduktar	introduktar
alejas	aled͡ʒas
filtrus	filtrus
monakeyo	monakejo
nederlandana	nederlandana
aktorino	aktorino
specaligar	spet͡saliɡar
sorginte	sorɡinte
pavonumar	pavonumar
portuo	pɔɾtwɔ
amebi	amebi
disciplinez	dist͡siplinɛs
enkorpigote	enkorpiɡote
chanjos	t͡ʃanʒɔs
mitralioso	mitralioso
mencionor	ment͡si̯onɔr
santa	santa
abandonar	abandonar
pensus	pensus
surda	surda
abandonite	abandonite
enkorpigota	enkorpiɡota
deputoti	deputoti
deputez	deputɛs
botanizonte	botanizonte
brechizabez	bret͡ʃizabɛs
ciencala	t͡sient͡sala
mandolini	mandolini
transito	tɾansito
skikurinti	skikurinti
biciklo	bit͡siklo
frivoli	frivoli
pluri	pluri
quante	kwante
embracar	embrat͡sar
lukto	lukto
litigato	litiɡato
regenerir	reɡenerir
drinkar	drinkar
sentir	sentir
peniso	peniso
kremo	kremo
sambuko	sambuko
exasperinti	eksasperinti
motivi	motivi
damo	damɔ
bandajizito	bandaʒizito
kobro	kobro
bandajizite	bandaʒizite
iono	i̯ono
furiero	furi̯ero
sublimos	sublimɔs
fusilo	fusilo
on	on
agrokultivi	aɡrokultivi
botanizinta	botanizinta
graviti	ɡraviti
agnoskos	aɡnoskɔs
pomo	pomo
agnoskis	aɡnoskis
equilibrato	eku̯ilibrato
festinas	festinas
aranjor	aranʒɔr
ekliptiki	ekliptiki
imputar	imputar
adverso	adverso
sfero	sfero
iracego	irat͡seɡo
helpez	helpɛz
skribinte	skribinte
kunlaborante	kunlaborante
exasperis	eɡzasperis
glikoso	ɡlikoso
tormentez	tormentɛz
rodar	rodar
objecionar	obʒet͡sjonar
exasperati	eɡzasperati
probez	probɛs
intrigar	intriɡar
instanto	instanto
sudo	sudo
brodas	brodas
stuvagar	stuvaɡar
abdikar	abdikar
x	ks
rozea	ɾɔzɛa
trahizir	trahizir
glitveturi	ɡlitveturi
komplikas	komplikas
arbustaro	arbustaro
polemikis	polemikis
intermixo	intermikso
saturata	saturata
biblioteko	bibljoteko
satisfacar	satisfat͡sar
skriboti	skriboti
venos	venɔs
dormetonti	dormetonti
jirafo	ʒirafo
glacieri	ɡlat͡si̯eri
aquoza	akwoza
sorgoto	sorɡoto
aceptinte	at͡septinte
o	o
insultanta	insultanta
helpor	helpɔr
bandajizanto	bandad͡ʒizanto
skribonta	skribonta
chanjor	t͡ʃanʒɔr
juez	d͡ʒuɛs
vitobero	vitobero
sucesar	sut͡sesar
aceptoto	at͡septoto
regeneroti	reɡeneroti
disciplinos	dist͡siplinɔs
diminutar	diminutar
equilibrinta	eku̯ilibrinta
mencionas	ment͡si̯onas
mungar	munɡar
decidita	det͡sidita
turnas	turnas
predicati	predit͡sati
teo	teo
burjoni	burd͡ʒoni
shamigis	ʃamiɡis
agnoskante	aɡnoskante
hundino	hundino
subtilajo	subtilaʒo
imaginate	imaɡinate
precize	pret͡size
exasperonta	eɡzasperonta
votis	votis
imaginos	imaɡinɔs
mencionata	ment͡si̯onata
tirez	tirɛs
spiko	spiko
fortigante	fortiɡante
sisonte	sisonte
korpi	korpi
fotografite	fotoɡrafite
raspanti	raspanti
esonti	esonti
chipro	t͡ʃipro
donacario	donat͡sario
exasperoti	eɡzasperoti
kamizolo	kamizolo
imposto	imposto
atingonta	atinɡonta
de	dɛ
hela	hela
algoritmi	alɡoritmi
projetir	prod͡ʒetir
nukumo	nukumo
lupo	lupɔ
varsar	varsar
kanapeo	kanapeo
ironte	ironte
koqueyi	kokweji
aranjir	aranʒir
mil	mil
avantaji	avantad͡ʒi
arto	aɾtɔ
pos	pos
koquus	koku̯us
revolucioni	revolut͡si̯oni
volkano	volkano
akonito	akonito
fortiganta	fortiɡanta
adoranti	adoranti
sukro	sukro
raspite	raspite
raspos	raspɔs
remediachi	remedi̯at͡ʃi
trahizonta	trahizonta
memoro	memoro
originala	oriɡinala
helpiti	helpiti
saturito	saturito
moneto	moneto
linguistikala	linɡuwistikala
aflikto	aflikto
insertas	insertas
judikito	ʒudikito
qui	kwi
judikato	ʒudikato
koquonti	kokvonti
extirpar	ekstirpar
lumar	lumar
stati	stati
vizajo	vizaʒo
projetinta	prod͡ʒetinta
mediko	mɛdikɔ
interruptar	interuptar
vicino	vit͡sino
orfani	orfani
equilibris	ekvilibris
japoniano	ʒaponi̯ano
ce	t͡sɛ
chanjos	t͡ʃand͡ʒɔs
emfazar	emfazar
tuberkloso	tuberkloso
dicar	dit͡saɾ
fortigoto	fortiɡoto
strucho	strut͡ʃo
depozonto	depozonto
judiki	d͡ʒudiki
genitiva	ɡenitiva
muziko	muziko
granizar	ɡranizar
sudorifar	sudorifar
raspir	raspir
dicar	dit͡sar
labiobarbi	labi̯obarbi
pensiti	pensiti
menciononte	ment͡si̯ononte
fotografote	fotoɡrafote
morto	mɔrto
pozor	pozɔr
irinta	irinta
skribonto	skribonto
konsequo	konseku̯o
tam	tam
internacione	internat͡sjone
esforcar	ɛsfɔrt͡sar
vinkar	vinkar
desorganizinta	desorɡanizinta
oficala	ofit͡sala
jetito	d͡ʒetito
nekonocata	nekonot͡sata
modi	modi
mariajar	mari̯ad͡ʒar
prezidonta	prezidonta
ovi	ovi
aerostato	aerostato
vortaro	vɔrtaro
e	e
imaginas	imaɡinas
probis	probis
sangifar	sanɡifar
glatigoti	ɡlatiɡoti
diminutos	diminutɔs
sorgus	sorɡus
mestiero	mestiero
fantazios	fantazi̯ɔs
depozar	depozar
bandajizato	bandaʒizato
procedo	prot͡sedo
geologio	ɡeoloɡjo
strado	strado
promulgez	promulɡɛz
kolino	kolino
tentinto	tentinto
likita	likita
gravitado	ɡravitado
decidate	det͡sidate
hezitema	hezitema
prezidanti	prezidanti
odiar	odi̯ar
skisar	skisar
rumania	rumani̯a
adianta	adi̯anta
bandajizinte	bandaʒizinte
plafono	plafono
servar	sɛɾvaɾ
kunlaborinto	kunlaborinto
trahizanta	trahizanta
infektar	infektar
koliziono	koloziono
adiar	adi̯ar
equilibrinti	eku̯ilibrinti
urjar	urʒar
adorota	adorota
advere	advere
exekutar	eɡzekutar
nihiligar	nihiliɡar
nedrinkebla	nedrinkebla
decimala	det͡simala
voluntez	voluntɛz
koquir	kokwir
skribiti	skribiti
vereso	vereso
hiperligilo	hiperliɡilɔ
konjedar	kond͡ʒedar
vatikano	vatikano
oktani	oktani
aciono	at͡sjono
tale	tale
bordizar	bordizar
memoros	memorɔs
tertremo	tertremo
formikumar	fɔrmikumar
botanizar	bɔtanizar
memoronta	memoronta
idioti	idi̯oti
akuzoti	akuzoti
adfluar	adflu̯ar
domajar	domad͡ʒar
diplasar	diplasar
homeosexuala	homeoseksuala
desfreshigar	desfreʃiɡar
atentonti	atentonti
yen	jen
objekto	obʒekto
rezuminte	rezuminte
frapante	frapante
violento	violento
skikuronto	skikuronto
fortigir	fortiɡir
joyar	d͡ʒojar
j	ʒ
separor	separɔr
mencioninda	ment͡sjoninda
matino	matinɔ
bandajizote	bandad͡ʒizote
impulsiva	impulsiva
erco	ɛrt͡so
lanci	lant͡si
trahizinti	trahizinti
permisez	permisɛz
fortigite	fortiɡite
recepcionez	ret͡sept͡si̯onɛz
saturonti	saturonti
augmentus	au̯ɡmentus
kantis	kantis
filtrato	filtrato
anticipante	antit͡sipante
jonki	d͡ʒonki
turisto	turisto
anmo	anmo
deputonti	deputonti
s	se
helpante	helpante
aranjas	aranʒas
kunlaborus	kunlaborus
equilibrote	ekvilibrote
femuro	femuro
substitucar	substitut͡sar
olima	olima
iti	iti
spontane	spontane
turdi	turdi
buklo	buklo
anciena	ant͡sijɛna
bandajizati	bandaʒizati
adicionir	adit͡si̯onir
frazo	frazo
direktadi	direktadi
filtrez	filtrɛs
damnir	damnir
prezidante	prezidante
akuzanta	akuzanta
vespereskanta	vespereskanta
jonki	ʒonki
desorganizo	desorɡanizo
equilibriti	eku̯ilibriti
plako	plako
puritano	puritano
rafto	rafto
fagonuco	faɡonut͡so
anticipanti	antit͡sipanti
tribui	tribui
saturinte	saturinte
imaginonte	imaɡinonte
bakante	bakante
vespero	vespero
domajar	domaʒar
filtrar	filtrar
boliigez	boliiɡɛz
rekortar	rekortar
argumento	arɡumento
parturar	parturar
skandinavia	skandinavi̯a
enlanjigar	enland͡ʒiɡar
faxar	faɡzar
equilibrota	eku̯ilibrota
frosto	frosto
irante	irante
ablativo	ablativo
championokonkurso	t͡ʃampi̯onokonkurso
bolo	bolo
laxigus	laksiɡus
retopagino	retopaɡino
akuzinto	akuzinto
frotos	frotɔs
desaranjar	desaranʒar
avelano	avelano
vespereskinte	vespereskinte
deputar	deputar
sklavo	sklavo
mekaniko	mekaniko
mezepoko	mezepoko
el	ɛl
pronuncar	pronunt͡sar
judikero	d͡ʒudikero
strokar	strɔkar
silkatra	silkatra
judikinti	ʒudikinti
sterko	sterko
darfar	darfar
irus	irus
nudisto	nudisto
bineto	bineto
disciplinoti	dist͡siplinoti
susurar	susurar
redemto	redemto
equilibronti	eku̯ilibronti
letro	letro
quanta	kwanta
responsanta	responsanta
japono	d͡ʒapono
projetis	prod͡ʒetis
fairo	faiɾɔ
instrumento	instrumento
hangaro	hanɡaro
xe	ksɛ
revoluciono	revolut͡siono
rezume	rezume
exasperite	eksasperite
maso	maso
bandajiziti	bandaʒiziti
exasperote	eɡzasperote
sulfito	sulfito
acendar	at͡sɛndar
explikor	eɡzplikɔr
vapornavi	vapornavi
biro	biro
orelo	orelo
emiri	emiri
adias	adi̯as
helpis	helpis
adoptante	adoptante
iracis	irat͡sis
fervoyala	fervojala
restauror	restau̯rɔr
nukumo	nukumɔ
cesigoti	t͡sesiɡoti
adjacanta	adʒat͡santa
employar	emplojar
sepultar	sepultar
praktikis	praktikis
celibino	t͡selibino
sequanta	sekwanta
tormentante	tormentante
saturante	saturante
citonto	t͡sitonto
erorar	erorar
permisir	permisir
eroras	eroras
trapasar	trapasar
venerdio	vɛnɛɾdiɔ
fortigus	fortiɡus
fortigonti	fortiɡonti
arkipelago	arkipelaɡo
traduko	traduko
prismato	prismato
agnoskonti	aɡnoskonti
chanjonti	t͡ʃanʒonti
projetoto	proʒetoto
insultinto	insultinto
striizez	striizɛs
eriko	eriko
fetida	fetida
adoptanti	adoptanti
helpoti	helpoti
axiomo	aɡzi̯omo
decidonte	det͡sidonte
dicata	dit͡sata
exasperoto	eɡzasperoto
vejetarar	veʒetarar
mankar	mankar
plano	plano
rasponta	rasponta
sutar	sutar
obstini	obstini
fondar	fondar
koquinte	kokvinte
incendias	int͡sendi̯as
gramatiko	ɡramatiko
bielorusia	bielorusia
yusta	justa
bakterio	bakterio
damnor	damnɔr
filtros	filtrɔs
oficiri	ofit͡siri
fotografas	fotoɡrafas
adorata	adorata
lamentinte	lamentinte
justa	ʒusta
almono	almono
idealo	ideala
permisar	permisar
dicante	dit͡sante
koquoti	kokvoti
gravitez	ɡravitɛs
equilibrito	eku̯ilibrito
festinar	festinar
sketeyo	sketejo
pasteto	pasteto
datumaro	datumaro
sonji	sonʒi
equilibrita	ekvilibrita
chanco	t͡ʃant͡so
kontinto	kontinto
brakiumo	brakjumɔ
restaurez	restau̯rɛz
piktor	piktɔr
boxar	boksar
altajo	altaʒo
grami	ɡrami
ankro	ankro
fato	fato
satiro	satiro
sisata	sisata
alejos	aled͡ʒɔs
demonstris	demonstris
insigno	insiɡno
amoranti	amoranti
imagininto	imaɡininto
aceptoti	at͡septoti
esonto	esonto
floso	flɔsɔ
bisquito	bisku̯ito
vadir	vadir
tradukesar	tradukesar
bordumo	bordumo
organizato	orɡanizato
naufrajar	nau̯frad͡ʒar
slovenia	sloveni̯a
juveli	d͡ʒuveli
klorido	klorido
bestio	bestio
refraktez	refraktɛs
skribita	skribita
babilema	babilema
transpozez	transpozɛs
atentis	atentis
gratar	ɡratar
japonia	ʒaponi̯a
etuyo	etujo
envolvor	envolvɔr
aparati	aparati
koqueri	kokweri
telegramo	teleɡramo
gravitonte	ɡravitonte
sovaja	sovad͡ʒa
libera	libera
fabo	fabo
minacar	minat͡sar
centimetro	t͡sentimetro
prezidor	prezidɔr
ofensus	ofensus
fundamento	fundamento
glatigonti	ɡlatiɡonti
chanjinti	t͡ʃand͡ʒinti
favoris	favoris
pasajero	pasad͡ʒero
funciono	funt͡si̯ono
due	du̯e
sisanta	sisanta
laudis	lau̯dis
kaoso	kaoso
moderna	moderna
decidito	det͡sidito
glavo	ɡlavo
juntar	ʒuntar
abatita	abatita
incendiis	int͡sendiis
aparato	aparato
skikurante	skikurante
kapitali	kapitali
koquas	koku̯as
abandonanto	abandonanto
ajornis	aʒornis
z	z
tableti	tableti
sajeso	saʒeso
exasperota	eɡzasperota
memoronto	memoronto
skulturo	skulturo
desorganizir	desorɡanizir
ofensate	ofensate
z	ze
abundanta	abundanta
koquite	kokvite
sikijar	sikiʒar
citez	t͡sitɛs
nepopulara	nepopulara
brechizanti	bret͡ʃizanti
imperar	imperar
garantio	ɡarantijo
sorgonto	sorɡonto
nebulo	nebulo
memorite	memorite
abatata	abatata
glacio	ɡlatsio
litigito	litiɡito
sternutar	sternutar
frotor	frotɔr
frapanto	frapanto
vespereskante	vespereskante
insultonto	insultonto
aeronavo	aeronavo
memorate	memorate
avelano	avelanɔ
akompanata	akompanata
exuduro	eksuduro
refraktez	refraktɛz
apertanto	apertanto
literaturaji	literaturad͡ʒi
shamigas	ʃamiɡas
lamentonti	lamentonti
dope	dope
akuzinte	akuzinte
alejez	aled͡ʒɛs
filtrati	filtrati
nelogikala	neloɡikala
suficar	sufit͡sar
bandajizota	bandaʒizota
refraktas	refraktas
aerosolo	aerosolo
citir	t͡sitir
erorus	erorus
krepo	krepo
cirkumskribar	t͡sirkumskribar
spliti	spliti
lamentir	lamentir
anticipate	antit͡sipate
neracionala	nerat͡si̯onala
bramas	bramas
adoras	adoras
arkeologio	arkeoloɡi̯o
frapanta	frapanta
botanizata	botanizata
decidinto	det͡sidinto
kantanti	kantanti
finlandana	finlandana
voco	vot͡so
jovdio	ʒɔvdiɔ
stufito	stufito
disimulus	disimulus
koaktar	kɔaktar
prezideri	prezideri
flajoleti	flaʒoleti
plaso	plaso
kunlaboras	kunlaboras
ferma	fɛrma
tertremi	tertremi
abandonabus	abandonabus
miligramo	miliɡramo
fotografez	fotoɡrafɛz
parafalo	parafalɔ
verda	verda
remedio	remedio
mondolingui	mondolinɡvi
kabino	kabino
piktos	piktɔs
okarini	okarini
diferenciar	diferent͡siar
vertico	vertit͡so
cirkumironti	t͡sirkumironti
momenti	momenti
mirakla	mirakla
fantazior	fantazi̯ɔr
atentonto	atentonto
juntata	d͡ʒuntata
vadati	vadati
bulgaria	bulɡari̯a
organa	orɡana
litiginti	litiɡinti
jirafi	ʒirafi
flotacar	flotat͡sar
emiro	emiro
maratono	maratono
jaro	d͡ʒaro
enkorpigoti	enkorpiɡoti
folio	foli̯o
patrini	patrini
skikuras	skikuras
maxim	maksim
mentala	mentala
regeneronti	reɡeneronti
signifiko	siɡnifiko
ciencisto	t͡siɛnt͡sistɔ
praktikor	praktikɔr
be	be
plumostroko	plumostroko
substantivo	substantivo
dicas	dit͡sas
pijamo	pid͡ʒamo
formiko	fɔrmikɔ
gracioza	ɡrat͡sjoza
jorno	d͡ʒorno
granizas	ɡranizas
dicite	dit͡site
esamo	esamo
vadez	vadɛz
homarala	homarala
obsoleta	obsoleta
neurono	neu̯rono
flajoleto	flaʒoleto
enkorpiginto	enkorpiɡinto
neopreni	neopreni
ampero	ampero
pektorala	pektorala
fotografate	fotoɡrafate
insultez	insultɛz
materialismo	materi̯alismo
roto	roto
chanjar	t͡ʃanʒar
horlojeto	horloʒeto
unika	unika
nasko	nasko
monomero	monomero
regenerate	reɡenerate
insultas	insultas
dicor	dit͡sɔr
imaginoto	imaɡinoto
prosternez	prosternɛs
axiomo	aksi̯omo
exasperonte	eksasperonte
konfundar	kɔnfundar
adorus	adorus
profeto	prɔfɛtɔ
adorato	adorato
benki	benki
decidir	det͡sidir
atingita	atinɡita
demonstro	demonstro
mielo	mi̯elo
decidez	det͡sidɛs
iterar	iterar
suburbo	suburbo
internacioneso	internat͡sijoneso
repudiar	repudi̯ar
papa	papa
laboristaro	laboristaro
favorus	favorus
abjekta	abʒekta
fidar	fidar
fiera	fi̯era
favorante	favorante
roki	roki
augmentez	au̯ɡmentɛz
mujar	muʒar
tentote	tentote
vehar	vehar
voluntar	vɔluntaɾ
komplikar	komplikar
abandonante	abandonante
akuzas	akuzas
aviacar	aviat͡sar
politikala	politikala
favorote	favorote
akompaninto	akompaninto
regresir	reɡresir
gratitudoza	ɡratitudoza
deputas	deputas
plezure	plɛzuɾɛ
anke	anke
projetos	proʒetɔs
kortico	kortit͡so
iris	iris
sindikati	sindikati
parento	parento
equilibrate	eku̯ilibrate
plualtigar	plualtiɡar
pramo	pramo
funero	funero
equilibrito	ekvilibrito
fortigati	fortiɡati
koquonti	kokwonti
fortiginto	fortiɡinto
kande	kande
apelor	apelɔr
perspektivo	perspektivo
deputiti	deputiti
greso	ɡreso
dissolvi	dissolvi
konocar	konocar
deputos	deputɔs
koqueyi	kokveji
chanjabez	t͡ʃand͡ʒabɛs
iros	irɔs
projeto	proʒeto
genuo	ɡenuo
enkorpiginta	enkorpiɡinta
evolucionir	evolut͡si̯onir
sorgote	sorɡote
sublimanti	sublimanti
fenestro	fenestro
moskeo	moskeo
onklino	onklino
menciononti	ment͡si̯ononti
shamigir	ʃamiɡir
lor	lɔɾ
albergo	albɛrɡo
augmentez	au̯ɡmentɛs
saturis	saturis
duimo	duimo
avida	avida
adoptez	adoptɛs
jenerozesi	d͡ʒenerozesi
trahizonti	trahizonti
demonstrez	demonstrɛz
adorinto	adorinto
prosternos	prosternɔs
bubuli	bubuli
equilibros	ekvilibrɔs
abandoninto	abandoninto
bito	bito
kalemburo	kalemburo
abandoninte	abandoninte
planko	plaŋkɔ
desplasizar	desplasizar
fiancitulo	fiant͡situlɔ
koquita	kokwita
bramez	bramɛs
fotografos	fotoɡrafɔs
berberiso	berberiso
sorgonte	sorɡonte
enkorpigir	enkorpiɡir
abandonato	abandonato
akushar	akuʃar
marchas	mart͡ʃas
generalo	ɡeneralo
protisto	protisto
redakteri	redakteri
lito	lito
weldez	weldɛz
kateto	kateto
litigoti	litiɡoti
predikar	predikar
kastano	kastano
raspar	raspar
napalmo	napalmo
faxar	faksar
abandonito	abandonito
benigna	beniɡna
glatigiti	ɡlatiɡiti
erorante	erorante
tentinte	tentinte
sinso	sinso
plezuro	plezuro
litero	litero
turnos	turnɔs
demonstras	demonstras
katedri	katedri
aplikez	aplikɛz
desorganizante	desorɡanizante
cent	sent
festininti	festininti
ka	ka
netransitiva	netɾansitiva
mato	mato
eskapar	eskapar
kakar	kakaɾ
anticipato	antit͡sipato
organizus	orɡanizus
obsidiani	obsidi̯ani
bakinto	bakinto
demonstrata	demonstrata
sunlumo	sunlumo
aceptito	at͡septito
w	we
lernar	lɛɾnaɾ
botanizanti	botanizanti
separas	separas
pos	pɔs
canokte	t͡sanokte
kantez	kantɛs
posmilita	posmilita
sako	sakɔ
purpuro	purpuro
konteno	kɔnteno
organizonte	orɡanizonte
raspate	raspate
ajustez	aʒustɛz
formo	formo
kabano	kabanɔ
osto	osto
mencionanti	ment͡si̯onanti
stufanti	stufanti
dominacar	dɔminat͡sar
mutono	mutono
kalsono	kalsono
fortigota	fortiɡota
enkorpigez	enkorpiɡɛz
dimezo	dimezo
fodar	fodar
adorinte	adorinte
sinkar	siŋkaɾ
adurolo	adurolo
granizos	ɡranizɔs
ve	vɛ
kravati	kravati
promulgas	promulɡas
abortigar	abortiɡar
turismo	turismo
decidonti	det͡sidonti
litigez	litiɡɛs
kontado	kontado
efikar	efikar
exajeranti	eksaʒeranti
evo	evo
envolvar	envolvar
b	be
salvar	salvar
stato	stato
chanjus	t͡ʃand͡ʒus
certe	t͡serte
projetote	prod͡ʒetote
aerolito	aerolito
plear	plear
ago	aɡo
lacerto	lat͡serto
avancigar	avant͡siɡar
fiasko	fiasko
frapoto	frapoto
aceptite	at͡septite
talono	talono
qualesala	kwalesala
skribos	skribɔs
organizar	oɾɡanizaɾ
preco	pɾɛt͡sɔ
skrubo	skrubo
germania	ɡermani̯a
delikata	delikata
glatiginti	ɡlatiɡinti
vu	vu
brakiumo	brakiumɔ
politiko	politiko
indijar	indiʒar
atentus	atentus
alejar	aled͡ʒar
guidar	ɡvidar
mosko	mosko
che	t͡ʃɛ
nederlando	nederlando
brazilia	brazili̯a
odiante	odi̯ante
vespereskonti	vespereskonti
doloro	doloro
juar	d͡ʒuar
minim	minim
lorneto	lorneto
lango	lanɡo
decido	det͡sido
ad	ad
hezitar	hezitar
tentis	tentis
suverena	suverena
judikinto	ʒudikinto
decensar	det͡sensar
trahizor	trahizɔr
regresar	reɡresar
kontos	kontɔs
expresema	eɡzpresema
adios	adi̯ɔs
descharjar	dest͡ʃarʒar
bandajizata	bandaʒizata
bisextila	bisɛkstila
kalzumo	kalzumɔ
ajornus	ad͡ʒornus
vereso	vɛrɛsɔ
repliko	repliko
tormentus	tormentus
abrupta	abrupta
tentita	tentita
judikeri	d͡ʒudikeri
fortiginta	fortiɡinta
lamentez	lamentɛz
avane	avane
domo	dɔmɔ
turnus	turnus
vadoti	vadoti
butro	butro
ofensar	ofensar
baro	baro
projetate	proʒetate
klimato	klimato
stufinte	stufinte
pasajo	pasad͡ʒo
desrespektar	desrespektar
bandajizinto	bandaʒizinto
specigar	spet͡siɡar
esperez	esperɛs
pasti	pasti
planajo	planad͡ʒo
desorganizata	desorɡanizata
odianti	odi̯anti
barometro	barɔmɛtrɔ
plastiko	plastiko
memoris	memoris
kunlaboro	kunlaboro
veino	vɛi̯no
longigar	lonɡiɡar
kontredicar	kɔntrɛdit͡saɾ
kolda	kolda
manjaji	mand͡ʒad͡ʒi
stando	stando
perisar	perisar
agnoskiti	aɡnoskiti
sen	sen
populi	populi
abatoti	abatoti
kantanto	kantanto
virgulo	virɡulo
inter	intɛɾ
serchar	sɛrt͡ʃar
explikos	eɡzplikɔs
agitesar	aɡitesar
spaco	spat͡so
enkorpigita	enkorpiɡita
bandajizite	bandad͡ʒizite
r	ɾe
favorito	favorito
alimentar	alimɛntar
donaji	donad͡ʒi
organizata	orɡanizata
vesto	vesto
equilibrati	eku̯ilibrati
bandajizabez	bandaʒizabɛz
lamentante	lamentante
sisanti	sisanti
kontor	kontɔr
astrofiziko	astrofiziko
legacez	leɡat͡sɛz
desfidema	desfidema
imaginata	imaɡinata
ideala	ideala
baseni	baseni
milito	milito
demonstrate	demonstrate
mamifero	mamifero
abatus	abatus
apreciar	apret͡si̯ar
anjelo	anʒelo
poka	poka
komplikus	komplikus
suko	suko
skriboto	skriboto
laxigis	laɡziɡis
vaditi	vaditi
separos	separɔs
atingez	atinɡɛs
kasero	kasero
rideto	ridɛtɔ
desfacilaji	desfat͡silaʒi
propagadi	propaɡadi
cadie	t͡sadie
anciena	ant͡sijena
arti	arti
lundio	lundiɔ
merkato	merkato
lamenti	lamenti
skikuranta	skikuranta
bandajizati	bandad͡ʒizati
repudiez	repudi̯ɛz
beko	beko
arkivisto	arkivisto
botanizote	botanizote
lagi	laɡi
bandajizonta	bandad͡ʒizonta
pluvar	pluvaɾ
piktar	piktar
vizajo	vizad͡ʒo
dansar	dansar
kindo	kindo
konjedar	konʒedar
agro	aɡro
envolvez	envolvɛz
tentota	tentota
apertita	apertita
blankigar	blankiɡar
odorar	odorar
glutus	ɡlutus
amorinti	amorinti
tentez	tentɛs
od	ɔd
sorgite	sorɡite
menciononta	ment͡si̯ononta
lore	lore
spico	spit͡so
distingar	distinɡar
kunfuzar	kunfuzar
memorinto	memorinto
bramus	bramus
frapez	frapɛz
abdikas	abdikas
koloro	kɔlɔɾɔ
organika	orɡanika
che	t͡ʃe
guindo	ɡwindo
salvo	salvo
flamo	flamo
oceani	ot͡seani
tentati	tentati
apertos	apertɔs
magio	maɡijo
monstri	monstri
akuziti	akuziti
motoro	motoro
m	me
izraelido	izraelido
strikis	strikis
botanizante	botanizante
gravitus	ɡravitus
anuncar	anunt͡sar
defensez	defensɛz
iracas	irat͡sas
papo	papo
kantonti	kantonti
desorganizus	desorɡanizus
paco	pat͡so
propagado	propaɡado
insultir	insultir
decidez	det͡sidɛz
automobilo	au̯tɔmɔbilɔ
hido	hido
naufrajar	nau̯fraʒar
aplikinti	aplikinti
nokto	nokto
temporo	tɛmporo
demonstros	demonstrɔs
disciplinor	dist͡siplinɔr
prostracar	prostrat͡sar
equilibro	ekvilibro
bisextila	bisɛɡztila
demonstri	demonstri
sorgota	sorɡota
krimino	krimino
luktar	luktar
exteraji	eksteraʒi
broshuro	broʃuro
nociva	not͡siva
akuzate	akuzate
jetanto	d͡ʒetanto
malakiti	malakiti
fragi	fraɡi
memorote	memorote
mamo	mamo
stulo	stulo
dispozez	dispozɛz
stuvo	stuvo
kantir	kantir
triumfo	triumfo
equilibrinto	ekvilibrinto
februari	februari
fiancitino	fiant͡sitino
benedikar	benedikar
melanino	melanino
heroeso	heroeso
vadonti	vadonti
likata	likata
laxigor	laɡziɡɔr
transpozar	transpozar
saturanta	saturanta
adicionas	adit͡si̯onas
esanta	esanta
pulsaro	pulsaro
babilachez	babilat͡ʃɛz
favoriti	favoriti
facila	fat͡sila
personala	personala
konjelar	konʒelar
altaji	altad͡ʒi
bandajizanti	bandaʒizanti
koquinti	kokvinti
respiras	respiras
akompanita	akompanita
olua	olwa
divorcigar	divort͡siɡar
procento	prot͡sento
fanfaronar	fanfaronar
dispozar	dispozar
fantaziez	fantazi̯ɛs
exkuzo	ɛkskuzɔ
morfino	morfino
genomi	ɡenomi
extensar	ɛɡztɛnsar
aktoro	aktɔɾɔ
adorate	adorate
agnoskita	aɡnoskita
albergestro	albɛrɡɛstro
westo	westo
adoronte	adoronte
ventos	ventɔs
manjebla	manʒebla
fotografez	fotoɡrafɛs
mustardo	mustardo
internaciona	internat͡siona
fantazius	fantazi̯us
torono	tɔɾɔnɔ
agnoskite	aɡnoskite
kazo	kazo
trahizanti	trahizanti
frapota	frapota
afecionar	afet͡sionar
frapo	frapo
aktorino	aktɔɾinɔ
jovdii	d͡ʒovdii
plumaligar	plumaliɡar
interviuvar	intɛɾvjuvaɾ
jaluza	ʒaluza
manko	manko
aplikiti	aplikiti
extraordinara	ekstraordinarijo
abatinti	abatinti
me	mɛ
stufinto	stufinto
t	te
polala	polala
botanizinto	botanizinto
judikoto	d͡ʒudikoto
favoras	favoras
kavalo	kavalo
bujio	bud͡ʒi̯o
digna	diɡna
prejudiko	pred͡ʒudiko
restaurate	restau̯rate
transitar	tɾansitaɾ
perkutar	perkutar
bandajizanti	bandad͡ʒizanti
festinonta	festinonta
cise	t͡sise
brino	bɾinɔ
iracor	irat͡sɔr
aranjos	arand͡ʒɔs
insularo	insularo
recepcionus	ret͡sept͡si̯onus
jeristo	d͡ʒeristo
disimulis	disimulis
dungo	dunɡo
aboliso	aboliso
incendiez	int͡sendi̯ɛz
jupizar	ʒupizar
jari	d͡ʒari
fotografato	fotoɡrafato
visilo	visilo
naturo	naturo
exasperanta	eksasperanta
problemo	problemo
equilibronto	eku̯ilibronto
komplikis	komplikis
universo	universo
startar	startar
abrevias	abrevi̯as
ajustar	aʒustar
bandajizonto	bandaʒizonto
jako	d͡ʒako
koquor	kokwɔr
rakar	rakar
perpetua	perpetua
reklamacar	reklamat͡sar
indutar	indutar
abandonus	abandonus
predicas	predit͡sas
herbo	herbo
endokarpo	endokarpo
desfacilaji	desfat͡silad͡ʒi
kontributajo	kontributaʒo
parto	parto
martelo	martelo
promulgos	promulɡɔs
iracir	irat͡sir
fortigate	fortiɡate
bonfacar	bɔnfat͡sar
bersar	bersar
desplumizar	desplumizar
auskultilo	au̯skultilo
linguo	linɡvo
devota	devota
filtriti	filtriti
akademiano	akademi̯ano
desfacileskar	desfat͡sileskar
festinos	festinɔs
explikis	eksplikis
equilibriti	ekvilibriti
magazino	maɡazino
laxigas	laksiɡas
kokoso	kokoso
dicato	dit͡sato
equilibrante	ekvilibrante
fluar	flu̯ar
saltar	saltar
nocar	not͡sar
aceptonte	at͡septonte
memorota	memorota
volfo	volfo
sofismi	sofismi
kande	kandɛ
perucho	perut͡ʃo
koquoto	kokwoto
infanto	infanto
rasponto	rasponto
granizez	ɡranizɛz
abatiso	abatiso
adsur	adsur
brechizati	bret͡ʃizati
tirkesto	tirkɛsto
responsiva	responsiva
alejir	aled͡ʒir
dubar	dubar
disimulas	disimulas
somero	somero
agnoskota	aɡnoskota
ibe	ibe
tentor	tentɔr
leda	leda
dika	dika
siesto	siesta
kandelieri	kandeli̯eri
akumular	akumular
jirafi	d͡ʒirafi
bandajizita	bandad͡ʒizita
papiliono	papiliono
glatigir	ɡlatiɡir
avalancho	avalant͡ʃo
dolorigar	doloriɡar
striizis	striizis
sorginto	sorɡinto
guidez	ɡu̯idɛz
exasperante	eksasperante
jovdii	ʒovdii
horlojo	horloʒo
lorneti	lorneti
sanigez	saniɡɛz
insultis	insultis
bakonto	bakonto
rezumar	rezumar
regenerati	reɡenerati
coexistir	t͡soeksistir
febrar	febrar
atingez	atinɡɛz
gracio	ɡrat͡sjo
boliigez	boliiɡɛs
atomo	atomo
fraponto	fraponto
hike	hikɛ
bandajizito	bandad͡ʒizito
skribanta	skribanta
aplikanti	aplikanti
kartocho	kartot͡ʃo
avokado	avokado
akompanar	akompanar
akuzar	akuzar
memorez	memorɛz
kauzi	kau̯zi
jaro	ʒaro
praktikez	praktikɛs
aqua	aku̯a
ventar	ventar
kontita	kontita
akuzata	akuzata
divenar	divenar
pensionar	pensi̯onar
filtranti	filtranti
exasperanta	eɡzasperanta
judikoto	ʒudikoto
akuzota	akuzota
fabrikar	fabrikar
fortigor	fortiɡɔr
lektanto	lektanto
fuzeo	fuzeo
litiginte	litiɡinte
ganso	ɡanso
organizis	orɡanizis
skurelo	skurelo
equilibrita	eku̯ilibrita
participi	partit͡sipi
imagininti	imaɡininti
joyala	ʒojala
parashuto	paraʃuto
decidite	det͡sidite
perturbati	perturbati
irez	irɛz
sua	sua
projetanta	proʒetanta
atentonta	atentonta
trotuaro	trotuaro
filtrante	filtrante
malta	malta
botanizito	botanizito
nazo	nazo
sorgis	sorɡis
vehilo	vehilo
gulfi	ɡulfi
prezidas	prezidas
koquinto	kokvinto
favoronte	favoronte
artoverko	artoverko
jenerozesi	ʒenerozesi
brino	brino
importanta	importanta
exkuzar	ekskuzar
torto	tɔɾtɔ
kontato	kontato
babilar	babilar
ruptilo	ruptilo
pluvo	pluvo
sata	sata
detali	detali
nukleo	nukleo
memoras	memoras
delicio	dɛlit͡siɔ
nematodi	nematodi
fantaziez	fantazi̯ɛz
sukombar	sukombar
furtar	furtar
bioteknologio	bioteknoloɡio
sorgez	sorɡɛs
equilibrus	ekvilibrus
vortari	vortari
hispania	hispania
nutrivi	nutrivi
gravitonti	ɡravitonti
laudati	lau̯dati
equilibranta	ekvilibranta
fortiginte	fortiɡinte
automobilo	au̯tomobilo
imaginante	imaɡinante
printempo	printempo
mondumo	mondumo
amorati	amorati
tenera	tenera
odiate	odi̯ate
lamentinta	lamentinta
lamentinti	lamentinti
marasmo	marasmo
rasponte	rasponte
fluir	fluir
diskursi	diskursi
privacar	privat͡sar
fraciono	frat͡siono
projetata	proʒetata
equilibrinte	ekvilibrinte
exasperus	eɡzasperus
ridinda	ridinda
burjoni	burʒoni
belgia	belɡia
joyanta	ʒojanta
koquato	kokvato
detalo	detalo
piktas	piktas
depozato	depozato
abstrakta	abstrakta
favorinto	favorinto
nuko	nuko
ol	ɔl
atentite	atentite
apene	apene
quala	kwala
filtrinto	filtrinto
abandonor	abandonɔr
raspati	raspati
raspinta	raspinta
projetante	prod͡ʒetante
deputanti	deputanti
observatorii	observatorii
macedonia	mat͡sedoni̯a
insultite	insultite
chagreno	t͡ʃaɡreno
ciencisto	t͡sient͡sisto
kaudala	kau̯dala
abolisanto	abolisanto
nacionala	nat͡sjonala
planaji	planaʒi
zefiri	zefiri
legala	leɡala
odo	odo
desorganizati	desorɡanizati
exterajo	eɡzterad͡ʒo
autoryuro	au̯torjuro
revuar	revu̯ar
shamo	ʃamo
nura	nura
kunlaborir	kunlaborir
adorote	adorote
enkorpigonto	enkorpiɡonto
defensate	defensate
damnez	damnɛs
abatato	abatato
organizos	orɡanizɔs
liti	liti
akademio	akademio
atingati	atinɡati
citanti	t͡sitanti
lanjo	lanʒo
gluo	ɡluo
kontonta	kontonta
probus	probus
exekuti	eksekuti
skikurinte	skikurinte
singlu	sinɡlu
esencala	esent͡sala
skribir	skribir
predicate	predit͡sate
raspota	raspota
filozofiar	filozofiar
burleska	burleska
ajornas	ad͡ʒornas
okarino	okarino
buxo	bukso
rivereto	rivereto
iluziono	iluziono
divorco	divort͡so
boliir	boliir
heliko	heliko
vere	vere
observatorio	observatori̯o
kosmo	kosmo
kontenajo	kɔntenad͡ʒo
ya	ja
brechizez	bret͡ʃizɛz
pacala	pat͡sala
bulteno	bulteno
populara	populara
fotografor	fotoɡrafɔr
hundini	hundini
sorganti	sorɡanti
organizito	orɡanizito
ornitorinko	ornitorinko
longitudo	lonɡitudo
junio	ʒuni̯o
barelo	barelo
jorni	ʒorni
organizanto	orɡanizanto
anekdoto	anekdoto
progresi	proɡresi
quo	kwo
fakturo	fakturo
gravitinta	ɡravitinta
incendiante	int͡sendi̯ante
exasperanti	eksasperanti
redaktero	redaktero
participo	partit͡sipo
aceptanti	at͡septanti
abator	abatɔr
biti	biti
idisto	idisto
anticipar	antit͡sipar
gratigar	ɡratiɡar
poltrono	poltrono
projetate	prod͡ʒetate
manjar	mand͡ʒaɾ
mondolinguo	mondolinɡwo
anticipati	antit͡sipati
akustiko	akustiko
kruri	kruri
repudior	repudi̯ɔr
kantoto	kantoto
interlukto	interlukto
vice	vit͡se
lo	lo
hundala	hundala
kravato	kravato
trefo	trefo
lokacar	lokat͡sar
exulcero	eɡzult͡sero
sublimata	sublimata
lamentus	lamentus
mortigar	mɔrtiɡar
civitani	t͡sivitani
kabareto	kabareto
likate	likate
bramez	bramɛz
striko	striko
explikar	eksplikar
remarkar	ɾɛmaɾkaɾ
kontus	kontus
plu	plu
skriburi	skriburi
ventis	ventis
agnoskinta	aɡnoskinta
nomenklaturo	nomenklaturo
radiar	radiar
sociologio	sot͡si̯oloɡi̯o
kapreolo	kapreolo
aeroportuo	aeroportuo
adoptati	adoptati
izobari	izobari
atentata	atentata
talono	talɔnɔ
transpozez	transpozɛz
vespo	vespo
pardonar	pardonar
bolietar	boli̯etar
augmentar	au̯ɡmɛntaɾ
unajo	unaʒo
fotografar	fotoɡrafar
sorgiti	sorɡiti
pordisto	pordisto
kruelajo	kruelaʒo
febla	febla
laudir	lau̯dir
kantita	kantita
zezear	zezear
enduktar	enduktar
omnibuso	ɔmnibusɔ
aorto	aorto
krear	krear
kontributajo	kontributad͡ʒo
sa	sa
reale	reale
piktir	piktir
nitrido	nitrido
abatar	abatar
enirar	enirar
sorgoti	sorɡoti
polemikas	polemikas
expresema	ekspresema
desorganizanta	desorɡanizanta
kakar	kakar
nekrologo	nekroloɡo
kom	kom
profeto	profeto
anticipez	antit͡sipɛs
desorganizonti	desorɡanizonti
solene	solene
koloniano	kɔlɔnianɔ
desorganizoti	desorɡanizoti
sensala	sensala
bazolineo	bazolineo
koquate	kokvate
religioza	reliɡioza
honorumala	honorumala
iritar	iritar
dentisto	dentisto
administranto	administranto
atentez	atentɛz
audaco	au̯dat͡so
navigar	naviɡar
adorita	adorita
sorgate	sorɡate
kreinti	kreinti
sparar	sparar
sokursar	sokursar
praktikus	praktikus
hirundo	hirundo
kapri	kapri
facar	fat͡sar
imperiestro	imperiestro
aplikar	aplikar
depozir	depozir
dinamitagar	dinamitaɡar
nivar	nivar
sorgonta	sorɡonta
oficiez	ofit͡si̯ɛz
bandajizante	bandaʒizante
bonfaco	bonfat͡so
defensez	defensɛs
civitano	t͡sivitano
grano	ɡrano
ilo	ilo
astronomo	astronomo
makulo	makulo
eskadro	eskadro
bastonagir	bastonaɡir
joyema	d͡ʒojema
laudas	lau̯das
nomar	nomar
kruelaji	kruelad͡ʒi
organeto	oɾɡanɛtɔ
demonstrus	demonstrus
fabrikos	fabrikɔs
insertor	insertɔr
skribonti	skribonti
laxigez	laɡziɡɛs
exasperato	eksasperato
digestar	diɡestar
en	en
guidez	ɡvidɛs
konstruktar	kɔnstruktar
kambiar	kambiar
favoror	favorɔr
pronomo	pronomo
damnus	damnus
lexiko	leɡziko
pensir	pensir
hungrar	hunɡrar
pioniro	pi̯oniro
novembri	novembri
moldova	moldova
trahizata	trahizata
submisar	submisaɾ
pavilioni	pavili̯oni
pedo	pedo
sajesi	saʒesi
metadono	metadono
vertuoza	vertuoza
plumizar	plumizar
memoronti	memoronti
boliigas	boliiɡas
apertate	apertate
citonte	t͡sitonte
akuzinti	akuzinti
aranjus	aranʒus
fosato	fosato
prezidir	prezidir
placo	plat͡so
acido	at͡sido
enkorpigez	enkorpiɡɛs
desorganizanto	desorɡanizanto
festinante	festinante
granario	ɡranarjɔ
klozez	klozɛz
splito	splito
predicata	predit͡sata
pupeo	pupeo
shamigus	ʃamiɡus
obstaklo	obstaklo
delegito	deleɡito
saturas	saturas
florkaulo	florkau̯lo
brechizoti	bret͡ʃizoti
trahizar	trahizar
klimar	klimar
senhara	senhara
januaro	ʒanuaro
absoluta	absoluta
turo	turo
recepcionos	ret͡sept͡si̯onɔs
legacar	leɡat͡sar
bigamo	biɡamo
joyigar	d͡ʒojiɡar
hefo	hɛfɔ
exasperez	eksasperɛz
citonti	t͡sitonti
ze	zɛ
singla	sinɡla
projetiti	proʒetiti
adianto	adi̯anto
papala	papala
raptar	ɾaptaɾ
skiglitar	skiɡlitar
spektar	spektar
iracos	irat͡sɔs
kadro	kadro
insultati	insultati
desorganizeso	desorɡanizeso
mikrofono	mikrofono
nulo	nulo
balasto	balasto
zero	zero
mentiar	mentiar
aktoro	aktoro
dursto	dursto
irlando	irlando
organizeso	orɡanizeso
intervido	intɛrvido
pregi	preɡi
strikus	strikus
exasperor	eksasperɔr
tentoti	tentoti
libreto	libreto
rokoza	rokoza
pensas	pensas
rezumote	rezumote
lamentez	lamentɛs
jaspo	ʒaspo
bandajizate	bandaʒizate
demonstrante	demonstrante
brokato	brokato
shamigez	ʃamiɡɛz
likonta	likonta
futuro	futuro
sonjo	sond͡ʒo
nevini	nevini
diminutas	diminutas
likanta	likanta
amoratulo	amoratulo
oficiir	ofit͡siir
filtrota	filtrota
nexta	neksta
projetinte	proʒetinte
orfano	orfano
koloro	koloro
he	he
vintrala	vintrala
pensez	pensɛz
imaginote	imaɡinote
preurbo	preurbo
obliviar	oblivi̯ar
chanjiti	t͡ʃand͡ʒiti
literi	literi
saturonto	saturonto
aceptir	at͡septir
