recipe	ret͡sˈipe
Achille	at͡ʃˈile
preparar	prˌeparˈar
predecessores	prˌedet͡sesˈores
superviventia	sˌupervivˈentja
typic	tˈipik
inducite	ˌindut͡sˈite
muros	mˈuros
Fame	fˈame
interne	intˈerne
exilio	eksˈiljo
fluvio	flˈuvjo
the	tˈe
verbal	verbˈal
visitate	vˌisitˈate
signate	siɡnˈate
revolutionari	rˌevolˌutjonˈari
essite	esˈite
SIDA	sˈida
Region	reɡjˈon
laboratores	lˌaboratˈores
Adjectivos	ˌadʒektˈivos
duceva	dut͡sˈeva
sentimentos	sˌentimˈentos
breve	brˈeve
uncias	ˈunt͡sjas
interior	ˌinterjˈor
Anque	ˈanke
secunda	sekˈunda
politica	polˈitika
humanos	humˈanos
asiatic	asjˈatik
separation	sˌeparatjˈon
habilitates	hˌabilitˈates
sia	sˈia
universitates	ˌunivˌersitˈates
moneta	monˈeta
dialogo	djˈaloɡo
sape	sˈape
Europa	e͡ʊrˈopa
lucta	lˈukta
provincia	provˈint͡sja
principato	prˌint͡sipˈato
Achilles	akˈiles
Margareta	mˌarɡarˈeta
basse	bˈase
judee	ʒudˈee
Membros	mˈembros
guerra	ɡwˈera
discographic	dˌiskoɡrˈafik
initialmente	ˌinitjalmˈente
Jam	ʒˈam
medical	mˌedikˈal
britannic	britˈannik
estima	estˈima
chefes	t͡ʃˈefes
Aires	ˈa͡ɪres
quarte	kwˈarte
Frequentemente	frˌekwentemˈente
varietate	vˌarjetˈate
zona	zˈona
supra	sˈupra
nervos	nˈervos
Casa	kˈasa
precoce	prekˈot͡se
Atlantico	atlˈantiko
explication	ˌeksplikatjˈon
regula	rˈeɡula
interviews	ˈinterviws
mineral	mˌinerˈal
periculose	pˌerikulˈose
Recerca	ret͡sˈerka
standard	stˈandard
psychologia	psˌikoloɡˈia
Francisco	frant͡sˈisko
excludite	ˌekskludˈite
sicut	sˈikut
objectivo	ˌobʒektˈivo
Nigre	nˈiɡre
cliente	kljˈente
Martin	martˈin
exploration	ˌeksploratjˈon
commentarios	kˌomentˈarjos
telescopio	tˌeleskˈopjo
statua	stˈatwa
cessa	t͡sˈesa
prediction	prˌediktjˈon
puncta	pˈunkta
monasterio	mˌonastˈerjo
ceremonia	t͡sˌeremonˈia
alora	alˈora
adjectivos	ˌadʒektˈivos
vicinitate	vˌit͡sinitˈate
Carlos	kˈarlos
motto	mˈoto
attributos	ˌatribˈutos
facilitar	fˌat͡silitˈar
reger	reɡˈer
petroleo	pˌetrolˈeo
honor	honˈor
novemente	nˌovemˈente
Priamo	prjˈamo
particula	partˈikula
arrivava	ˌarivˈava
exposition	ˌekspositjˈon
carta	kˈarta
secunde	sekˈunde
temperate	tˌemperˈate
milliardos	miljˈardos
capites	kˈapites
exprime	eksprˈime
blues	blwˈes
foco	fˈoko
functiones	funktjˈones
musulmanes	mˌusulmˈanes
insenia	insˈenja
ligamines	lˈiɡamˌines
mytho	mˈito
Comocunque	kˌomokˈuŋkwe
arrivate	ˌarivˈate
litterari	lˌiterˈari
transformate	trˌansformˈate
dura	dˈura
decembre	det͡sˈembre
trova	trˈova
applicationes	ˌaplikatjˈones
UMI	ˈumi
saper	sapˈer
sole	sˈole
contextos	kontˈekstos
tubos	tˈubos
Herodoto	hˌerodˈoto
univa	unˈiva
nam	nˈam
superava	sˌuperˈava
ample	ˈample
grados	ɡrˈados
uno	ˈuno
viagiava	vjaɡjˈava
Alcun	ˈalkun
pagina	pˈaɡina
Contato	kontˈato
White	whˈite
television	tˌelevisjˈon
priones	prjˈones
usante	usˈante
morphologia	mˌorfoloɡˈia
satellite	satˈelite
experimentation	ˌeksperˌimentatjˈon
ultime	ˈultime
lassava	lasˈava
Santa	sˈanta
homosexuales	hˌomosekswˈales
criticas	krˈitikas
elevation	ˌelevatjˈon
versos	vˈersos
Peter	petˈer
romanic	romˈanik
patronos	patrˈonos
sport	spˈort
Magnus	mˈaɡnus
Corona	korˈona
era	ˈera
discurso	diskˈurso
incontra	inkˈontra
lacte	lˈakte
commercialmente	kˌomert͡sjalmˈente
historias	histˈorjas
representationes	rˌepresˌentatjˈones
permittente	pˌermitˈente
regnos	rˈeɡnos
alie	ˈalje
servite	servˈite
figuras	fiɡˈuras
Balki	bˈalki
detaliate	dˌetaljˈate
minimo	mˈinimo
universitate	ˌunivˌersitˈate
historia	histˈorja
contractiones	kˌontraktjˈones
discute	diskˈute
extende	ekstˈende
primemente	prˌimemˈente
Roll	rˈol
phase	fˈase
danese	danˈese
visitava	vˌisitˈava
qualitates	kwˌalitˈates
Abu	ˈabu
vita	vˈita
benque	bˈeŋkwe
Mar	mˈar
plus	plˈus
citatano	t͡sˌitatˈano
corda	kˈorda
san	sˈan
fundamental	fˌundamentˈal
umbra	ˈumbra
prohibition	prˌohibitjˈon
stella	stˈela
romantic	romˈantik
martial	martjˈal
inflation	ˌinflatjˈon
thema	tˈema
genetic	ɡenˈetik
bisonte	bisˈonte
avantiate	ˌavantjˈate
appreciate	ˌapret͡sjˈate
responsabile	rˌesponsˈabile
resimila	rˌesimˈila
armenio	armˈenjo
sic	sˈik
hydrogeno	hidrˈoɡeno
assignate	ˌasiɡnˈate
consideration	kˌonsidˌeratjˈon
Lublin	lublˈin
Libro	lˈibro
termino	tˈermino
educative	ˌedukatˈive
milliones	miljˈones
substantia	substˈantja
attitude	ˌatitˈude
magazines	mˌaɡazˈins
committee	komˈiti
sulco	sˈulko
patrimonio	pˌatrimˈonjo
versiones	versjˈones
characteristic	kˌarakterˈistik
Austria	ˈawstrja
Ibi	ˈibi
pote	pˈote
Districto	distrˈikto
Groningen	ɡrˌoniŋɡˈen
necun	nekˈun
conducto	kondˈukto
composite	kompˈosite
excepte	ekst͡sˈepte
costas	kˈostas
deos	ðˈeos
politico	polˈitiko
mori	mˈori
mal	mˈal
commandante	kˌomandˈante
technica	tˈeknika
tunc	tˈunk
honorari	hˌonorˈari
Henry	hˈenri
programmation	prˌoɡramatjˈon
guarda	ɡwˈarda
europee	ˌeuropˈee
Russia	rˈusja
recipite	rˌet͡sipˈite
Olympic	olˈimpik
Tempore	tˈempore
tendentia	tendˈentja
dunque	dˈuŋkwe
populo	pˈopulo
tendentias	tendˈentjas
grec	ɡrˈek
Irlanda	irlˈanda
discoperiva	dˌiskoperˈiva
culturas	kultˈuras
rota	rˈota
poeta	poˈeta
simplemente	sˌimplemˈente
Post	pˈost
substantivo	sˌubstantˈivo
peccato	pekˈato
nomines	nˈomines
fundator	fˌundatˈor
criterios	kritˈerjos
attinge	atˈiŋɡe
interaction	ˌinteraktjˈon
april	aprˈil
Leon	leˈon
complexo	komplˈekso
Battalia	batˈalja
infinitivo	ˌinfinitˈivo
film	fˈilm
vitro	vˈitro
sedes	sˈedes
administrative	ˌadminˌistratˈive
previemente	prˌevjemˈente
ILGA	ˈilɡa
colonia	kˌolonˈia
operation	ˌoperatjˈon
Shakespeare	ʃˌakespeˈare
rango	rˈaŋɡo
impossibile	ˌimposˈibile
habitat	hˌabitˈat
continuemente	kˌontinwemˈente
erosion	ˌerosjˈon
partita	partˈita
combinate	kˌombinˈate
reduce	redˈut͡se
undas	ˈundas
vino	vˈino
privilegios	prˌivilˈeɡjos
suggerite	sˌuɡerˈite
abandonava	ˌabandonˈava
circulos	t͡sˈirkulos
essayos	esˈajos
mente	mˈente
IALA	jˈala
cosas	kˈosas
notar	notˈar
rubie	rˈubje
equipamento	ˌekwipamˈento
appareva	ˌaparˈeva
denomina	dˌenomˈina
cade	kˈade
penal	penˈal
Switza	swˈitza
metallo	metˈalo
ratto	rˈato
Carl	kˈarl
investigation	ˌinvestˌiɡatjˈon
inspirate	ˌinspirˈate
partisanos	pˌartisˈanos
faciente	fat͡sjˈente
metropolitan	mˌetropˌolitˈan
Alba	ˈalba
Varie	vˈarje
concorda	konkˈorda
unic	ˈunik
responder	rˌespondˈer
opiniones	ˌopinjˈones
sequente	sekwˈente
veces	vˈet͡ses
probas	prˈobas
constituente	kˌonstitwˈente
Universitate	ˌunivˌersitˈate
infectiones	ˌinfektjˈones
Marte	mˈarte
ancora	ankˈora
politicas	polˈitikas
cento	t͡sˈento
Non	nˈon
posteriormente	pˌosterjormˈente
credite	kredˈite
correcte	korˈekte
etiam	ˈetjam
habitantes	hˌabitˈantes
hellenistic	hˌelenˈistik
Est	ˈest
considerar	kˌonsiderˈar
preciose	pret͡sjˈose
se	sˈe
abundantia	ˌabundˈantja
manca	mˈanka
descriptiones	dˌeskriptjˈones
Apollo	apˈolo
piano	pjˈano
pro	prˈo
procede	prot͡sˈede
arabic	arˈabik
mangiar	manʒˈar
poetas	poˈetas
depingite	dˌepiŋɡˈite
islamic	islˈamik
anthropologia	ˌantropˌoloɡˈia
studia	stˈudja
Stato	stˈato
Entertainment	ˌenterta͡ɪnmˈent
architecto	ˌart͡ʃitˈekto
ama	ˈama
linear	lˌineˈar
Ecclesias	eklˈesjas
initiava	ˌinitjˈava
Evangelios	ˌevaŋɡˈeljos
Fundation	fˌundatjˈon
ex	ˈeks
finite	finˈite
obras	ˈobras
passos	pˈasos
humide	hˈumide
rebelliones	rˌebeljˈones
historic	histˈorik
appoia	apˈo͡ɪa
monarchia	mˌonarkˈia
pisces	pˈist͡ses
potite	potˈite
reunion	re͡ʊnjˈon
artes	ˈartes
radios	rˈadjos
proprietario	prˌoprjetˈarjo
triangulo	trjˈanɡulo
transmittite	trˌansmitˈite
Jutlandia	ʒutlˈandja
fructo	frˈukto
proba	prˈoba
Kennedy	kenˈedi
planos	plˈanos
octo	ˈokto
presenta	presˈenta
ganiate	ɡanjˈate
Age	ˈaɡe
ganiava	ɡanjˈava
ingenieria	ˌinɡenjerˈia
alternative	ˌalternatˈive
navigation	nˌaviɡatjˈon
colonias	kˌolonˈias
superficie	sˌuperfˈit͡sje
qualque	kwˈalke
abolition	ˌabolitjˈon
salvation	sˌalvatjˈon
differentias	dˌiferˈentjas
folk	fˈolk
Joh	ʒˈoh
civilisationes	t͡sˌivilˌisatjˈones
transformava	trˌansformˈava
Luther	lutˈer
dominio	domˈinjo
apprentissage	ˌaprentisˈaʒe
integral	ˌinteɡrˈal
bits	bˈits
personage	pˌersonˈaʒe
demonstrate	dˌemonstrˈate
cultural	kˌulturˈal
manco	mˈanko
superate	sˌuperˈate
editorial	ˌeditorjˈal
jardin	ʒardˈin
apparentia	ˌaparˈentja
filos	fˈilos
RFCs	ˌeɹˌefsˌeˈes
contribue	kontrˈibwe
Francia	frˈant͡sja
vocales	vokˈales
parte	pˈarte
compositor	kˌompositˈor
physicamente	fˌisikamˈente
lingua	lˈiŋɡwa
practicas	prˈaktikas
Agamemnon	ˌaɡamemnˈon
organisationes	ˌorɡanˌisatjˈones
codification	kˌodifˌikatjˈon
reimplaciar	rˌe͡ɪmplat͡sjˈar
mediterranee	mˌeditˌeranˈee
national	nˌatjonˈal
offensive	ˌofensˈive
themas	tˈemas
sulfure	sˈulfure
pisca	pˈiska
approbation	ˌaprobatjˈon
registrate	rˌeɡistrˈate
presso	prˈeso
pectore	pˈektore
media	mˈedja
comparation	kˌomparatjˈon
Basel	basˈel
resta	rˈesta
latere	lˈatere
mandava	mandˈava
geographia	ɡˌeoɡrafˈia
natal	natˈal
illa	ˈila
executar	ˌeksekutˈar
paises	pˈa͡ɪses
tal	tˈal
precios	prˈet͡sjos
Testamento	tˌestamˈento
radioamatorismo	rˌadjoˌamatorˈismo
pareva	parˈeva
jornalista	ʒˌornalˈista
apud	ˈapud
personalitates	pˌersonˌalitˈates
Terra	tˈera
Marco	mˈarko
durabile	durˈabile
convertite	kˌonvertˈite
plantas	plˈantas
Huygens	hujɡˈens
dono	dˈono
controversia	kˌontrovˈersja
regime	reʒˈim
Linnaeus	linˈae͡ʊs
adversario	ˌadversˈarjo
companiones	kˌompanjˈones
permitte	permˈite
World	wˈorld
sancte	sˈankte
generes	ɡˈeneres
Pacioli	pat͡sjˈoli
feminin	fˌeminˈin
German	ɡermˈan
Justitia	ʒustˈitja
saepe	saˈepe
articulo	artˈikulo
Como	kˈomo
files	faˈils
metro	mˈetro
possibilitate	pˌosibˌilitˈate
notas	nˈotas
portate	portˈate
equilibrio	ˌekwilˈibrjo
psychologic	psˌikolˈoɡik
testimonio	tˌestimˈonjo
ulle	ˈule
application	ˌaplikatjˈon
Mat	mˈat
fundation	fˌundatjˈon
deber	debˈer
switze	swˈitze
Kristian	kristjˈan
domos	dˈomos
exprimite	ˌeksprimˈite
flores	flˈores
recursos	rekˈursos
sono	sˈono
cortice	kˈortit͡se
Der	dˈer
functionamento	fˌunktjonamˈento
governate	ɡˌovernˈate
Etate	etˈate
fonte	fˈonte
apparato	ˌaparˈato
sta	stˈa
Miguel	miɡwˈel
extreme	ekstrˈeme
declara	deklˈara
historicamente	hˌistorˌikamˈente
Multe	mˈulte
emotional	ˌemotjonˈal
incontrava	ˌinkontrˈava
conduce	kondˈut͡se
epistolas	epˈistolas
armas	ˈarmas
km	kˌaˈem
theologic	tˌeolˈoɡik
victoria	viktˈorja
esserea	ˌeserˈea
litteras	lˈiteras
designate	dˌesiɡnˈate
reuni	rˈe͡ʊni
folklore	folklˈor
fossiles	fˈosiles
educate	ˌedukˈate
labores	labˈores
pedophilia	pˌedofilˈia
isto	ˈisto
bloco	blˈoko
territorial	tˌeritorjˈal
blau	blˈa͡ʊ
depost	depˈost
receptas	ret͡sˈeptas
municipios	mˌunit͡sˈipjos
protocollos	prˌotokˈolos
nive	nˈive
designo	desˈiɡno
solar	solˈar
constitution	kˌonstitutjˈon
adoptate	ˌadoptˈate
spatio	spˈatjo
corpores	kˈorpores
talia	tˈalja
action	aktjˈon
distribution	dˌistributjˈon
haver	havˈer
unitate	ˌunitˈate
stato	stˈato
unificate	ˌunifikˈate
moral	morˈal
regina	reɡˈina
julian	ʒuljˈan
caudas	kˈa͡ʊdas
chromium	kromjˈum
jornales	ʒornˈales
animate	ˌanimˈate
local	lokˈal
conservar	kˌonservˈar
distantia	distˈantja
tempores	tˈempores
rationamento	rˌatjonamˈento
exceptiones	ˌekst͡septjˈones
magic	mˈaɡik
terreno	terˈeno
celebration	t͡sˌelebratjˈon
designava	dˌesiɡnˈava
linea	linˈea
deserto	desˈerto
voluntarios	vˌoluntˈarjos
dependentia	dˌependˈentja
perque	perkˈe
hereditage	hˌereditˈaʒe
respondeva	rˌespondˈeva
London	ɫˈondon
mission	misjˈon
copyright	kˈopirˌait
importantia	ˌimportˈantja
gravitate	ɡrˌavitˈate
facite	fat͡sˈite
possession	pˌosesjˈon
del	dˈel
papa	pˈapa
synthetic	sintˈetik
Traduction	trˌaduktjˈon
animal	ˌanimˈal
Depost	depˈost
zero	zˈero
symbolo	sˈimbolo
liturgic	litˈurɡik
expectate	ˌekspektˈate
aere	ˈaere
cambia	kˈambja
poc	pˈok
terminar	tˌerminˈar
registration	rˌeɡistratjˈon
sucro	sˈukro
hereditate	hˌereditˈate
Canada	kˌanadˈa
eterne	etˈerne
hereditari	hˌereditˈari
assemblea	ˌasemblˈea
Intertanto	ˌintertˈanto
satis	sˈatis
immediatemente	ˌimedjˌatemˈente
membrana	membrˈana
african	ˌafrikˈan
audientia	a͡ʊdjˈentja
democratic	dˌemokrˈatik
Hannover	hˌanovˈer
involve	invˈolve
iconic	ikˈonik
Day	dˈaj
communication	kˌomunˌikatjˈon
primari	primˈari
industria	indˈustrja
Top	tˈop
esseres	esˈeres
parietes	parjˈetes
pulvere	pˈulvere
usa	ˈusa
sol	sˈol
christianismo	krˌistjanˈismo
Largo	lˈarɡo
territorios	tˌeritˈorjos
mandato	mandˈato
sectores	sektˈores
origine	orˈiɡine
supporto	supˈorto
guitarras	ɡhitˈaras
nodo	nˈodo
lassa	lˈasa
photographias	phˌotoɡrafˈias
Tu	tˈu
traverso	travˈerso
Parola	parˈola
Copertura	kˌopertˈura
tractamento	trˌaktamˈento
Multes	mˈultes
Espaniol	ˌespanjˈol
judice	ʒˈudit͡se
pacific	pat͡sˈifik
al	ˈal
accessibile	ˌakt͡sesˈibile
augmentate	ˌa͡ʊɡmentˈate
mantener	mˌantenˈer
theoric	teˈorik
conducta	kondˈukta
authentic	a͡ʊtˈentik
Confederation	kˌonfedˌeratjˈon
visitas	visˈitas
considerava	kˌonsiderˈava
annual	anwˈal
vice	vˈit͡se
besonia	besˈonja
Society	sot͡sjˈeti
ligno	lˈiɡno
dividite	dˌividˈite
passar	pasˈar
Wilhelm	wilhˈelm
probabile	probˈabile
Nederland	ŋˈederland
disciplinas	dˌist͡siplˈinas
juventute	ʒˌuventˈute
finales	finˈales
faction	faktjˈon
perder	perdˈer
collection	kˌolektjˈon
Basse	bˈase
ponte	pˈonte
sanitate	sˌanitˈate
fratres	frˈatres
constantemente	kˌonstantemˈente
reporto	repˈorto
arrestate	ˌarestˈate
resto	rˈesto
directe	dirˈekte
systema	sistˈema
proclamava	prˌoklamˈava
cogniscite	kˌoɡnist͡sˈite
vadeva	vadˈeva
dante	dˈante
Bulgaria	bulɡˈarja
occider	ˌot͡sidˈer
polonese	pˌolonˈese
favor	favˈor
perdeva	perdˈeva
lineas	linˈeas
abusos	abˈusos
Cesare	t͡sesˈare
apostolos	apˈostolos
pecias	pˈet͡sjas
continua	kontˈinwa
predication	prˌedikatjˈon
bastante	bastˈante
supernominate	sˌupernˌominˈate
sacre	sˈakre
infundibulo	ˌinfundˈibulo
pesa	pˈesa
cyclo	t͡sˈiklo
James	ʒˈames
fortiate	fortjˈate
calendario	kˌalendˈarjo
vacca	vˈaka
littera	lˈitera
cosa	kˈosa
alsi	alsˈi
creative	krˌeatˈive
sonate	sonˈate
tractato	traktˈato
personas	persˈonas
vices	vˈit͡ses
publicationes	pˌublikatjˈones
judeos	ʒudˈeos
finiva	finˈiva
reges	rˈeɡes
biographia	bjˌoɡrafˈia
special	spet͡sjˈal
pionero	pjonˈero
conversion	kˌonversjˈon
camera	kˈamera
con	kˈon
dicite	dit͡sˈite
indicate	ˌindikˈate
Version	versjˈon
petroglyphos	petrˈoɡlifos
corage	korˈaʒe
assecurar	ˌasekurˈar
ideologia	ˌideˌoloɡˈia
januario	ʒanwˈarjo
interesse	ˌinterˈese
desiro	desˈiro
appoiar	ˌapo͡ɪˈar
plano	plˈano
naturalistic	nˌaturalˈistik
significante	sˌiɡnifikˈante
clause	klˈa͡ʊse
descendentes	dˌest͡sendˈentes
perse	pˈerse
Granada	ɡranˈada
pur	pˈur
generalmente	ɡˌeneralmˈente
american	ˌamerikˈan
integration	ˌinteɡratjˈon
Kazakhstan	kˌazakhstˈan
sententia	sentˈentja
criticava	krˌitikˈava
equationes	ˌekwatjˈones
modos	mˈodos
celebre	t͡sˈelebre
unquam	ˈunkwam
musica	mˈusika
estranier	ˌestranjˈer
criticate	krˌitikˈate
eveni	evˈeni
pagan	paɡˈan
machinas	mˈakinas
tenite	tenˈite
geometric	ɡˌeomˈetrik
communicar	kˌomunikˈar
imprimite	ˌimprimˈite
tabella	tabˈela
spatios	spˈatjos
sera	serˈa
estranie	estrˈanje
soveranitate	sˌoverˌanitˈate
naturalmente	nˌaturalmˈente
Museo	musˈeo
Jupiter	ʒˈupiter
evolution	ˌevolutjˈon
productive	prˌoduktˈive
ma	mˈa
combatter	kˌombatˈer
el	ˈel
applicate	ˌaplikˈate
passageros	pˌasaʒˈeros
corresponde	kˌorespˈonde
prestigiose	prˌestiɡjˈose
kilometros	kilˈometros
age	ˈaɡe
phrase	frˈase
subito	sˈubito
automaticamente	ˌa͡ʊtomˌatikamˈente
Mexico	mˈeksiko
ambiente	ambjˈente
juvene	ʒˈuvene
include	inklˈude
productos	prodˈuktos
fluvios	flˈuvjos
cursos	kˈursos
filio	fˈiljo
gratia	ɡrˈatja
comenciante	kˌoment͡sjˈante
magnitude	mˌaɡnitˈude
disposition	dˌispositjˈon
affligite	ˌafliɡˈite
gradualmente	ɡrˌadwalmˈente
theorias	tˌeorˈias
inimicos	ˌinimˈikos
proponite	prˌoponˈite
frequentemente	frˌekwentemˈente
Tony	tˈoni
donos	dˈonos
distribuite	dˌistribwˈite
on	ˈon
nomination	nˌominatjˈon
producer	prˌodut͡sˈer
necessitate	nˌet͡sesitˈate
includeva	ˌinkludˈeva
vider	vidˈer
subinde	subˈinde
adresse	adrˈese
passage	pasˈaʒe
electron	ˌelektrˈon
qual	kwˈal
vias	vˈias
ove	ˈove
dominios	domˈinjos
imperator	ˌimperatˈor
Bolívar	bˌolivˈar
prepositiones	prˌepositjˈones
causante	ka͡ʊsˈante
gente	ɡˈente
natrium	nˈatrjum
reguardo	reɡwˈardo
Verso	vˈerso
imprisionate	ˌimprisjonˈate
edition	ˌeditjˈon
reflexion	rˌefleksjˈon
proprietate	prˌoprjetˈate
conventiones	kˌonventjˈones
viste	vˈiste
prision	prisjˈon
Cascadas	kaskˈadas
il	ˈil
presidente	prˌesidˈente
Su	sˈu
recommenda	rˌekomˈenda
forma	fˈorma
cholera	kˈolera
apprendeva	ˌaprendˈeva
plagia	plˈaʒa
succession	sˌut͡sesjˈon
arco	ˈarko
soldatos	soldˈatos
Russe	rˈuse
potentias	potˈentjas
separar	sˌeparˈar
explicar	ˌeksplikˈar
Philippinas	fˌilipˈinas
artista	artˈista
Venetia	venˈetja
cantatrice	kˌantatrˈit͡se
Theatre	teˈatre
mathematica	mˌatemˈatika
di	dˈi
planetas	planˈetas
studiava	studjˈava
contos	kˈontos
clinic	klˈinik
laborava	lˌaborˈava
Odysseo	ˌodisˈeo
cavallero	kˌavalˈero
terminos	tˈerminos
In	ˈin
illac	ˈilak
introducer	ˌintrodut͡sˈer
difficultates	dˌifikultˈates
catena	katˈena
minutas	minˈutas
aperte	apˈerte
visibile	visˈibile
fusion	fusjˈon
for	fˈor
vetere	vˈetere
lectores	lektˈores
molybdenum	mˌolibdenˈum
Dictionary	dˌiktjonˈari
manuscriptos	mˌanuskrˈiptos
comic	kˈomik
laco	lˈako
rational	rˌatjonˈal
Declaration	dˌeklaratjˈon
affirmava	ˌafirmˈava
information	ˌinformatjˈon
avantiamento	ˌavantjamˈento
limite	lˈimite
quotidian	kwˌotidjˈan
theoria	tˌeorˈia
III	trˈes
prominente	prˌominˈente
traducite	trˌadut͡sˈite
despecto	despˈekto
sever	sevˈer
problemas	problˈemas
emplea	emplˈea
Sol	sˈol
arbitrari	ˌarbitrˈari
Republica	repˈublika
Carolo	kˈarolo
recognoscite	rˌekoɡnost͡sˈite
dialectal	djˌalektˈal
standardisate	stˌandardisˈate
decime	dˈet͡sime
acute	akˈute
servicio	servˈit͡sjo
subjecto	subʒˈekto
obedientia	ˌobedjˈentja
partes	pˈartes
correspondente	kˌorespondˈente
promover	prˌomovˈer
indian	indjˈan
expressiones	ˌekspresjˈones
totos	tˈotos
combination	kˌombinatjˈon
protocollo	prˌotokˈolo
cambiava	kambjˈava
viages	vjˈaʒes
avantiar	ˌavantjˈar
apportar	ˌaportˈar
acido	ˈat͡sido
gas	ɡˈas
catholicos	katˈolikos
troppo	trˈopo
episodio	ˌepisˈodjo
supportar	sˌuportˈar
Trek	trˈek
plu	plˈu
photographia	phˌotoɡrafˈia
fini	fˈini
alimentation	ˌalimˌentatjˈon
mechanica	mekˈanika
acclamate	ˌaklamˈate
organisate	ˌorɡanisˈate
affaires	afˈers
signos	sˈiɡnos
monarchias	mˌonarkˈias
ligamine	lˈiɡamˌine
quartieros	kwartjˈeros
monastic	monˈastik
correspondentia	kˌorespondˈentja
derectos	derˈektos
poneva	ponˈeva
Larry	lˈari
excambio	ekskˈambjo
terminationes	tˌerminatjˈones
fabrication	fˌabrikatjˈon
officialmente	ˌofit͡sjalmˈente
placer	plat͡sˈer
realisate	rˌealisˈate
costose	kostˈose
dominate	dˌominˈate
continente	kˌontinˈente
le	lˈe
fortias	fˈortjas
editiones	ˌeditjˈones
observava	ˌobservˈava
mesurate	mˌesurˈate
Andersen	ˌandersˈen
XML	ˌiksˌemˈel
semantic	semˈantik
naves	nˈaves
Blanc	blˈank
association	ˌasot͡sjatjˈon
duce	dˈut͡se
spisse	spˈise
concentrate	kˌont͡sentrˈate
genes	ɡˈenes
Johan	ʒohˈan
venir	venˈir
tempo	tˈempo
Que	kˈe
astronomos	astrˈonomos
ferma	fˈerma
casa	kˈasa
alimento	ˌalimˈento
control	kontrˈol
discussion	dˌiskusjˈon
hic	hˈik
explora	eksplˈora
r	ˈer
julio	ʒˈuljo
toures	toˈures
classes	klˈases
plan	plˈan
affaire	afˈer
considera	kˌonsidˈera
occupate	ˌokupˈate
s	ˈes
substantias	substˈantjas
sonava	sonˈava
capturate	kˌapturˈate
cognoscentias	kˌoɡnost͡sˈentjas
realisar	rˌealisˈar
linguistas	linɡwˈistas
remane	remˈane
substantivos	sˌubstantˈivos
Robert	robˈert
oriental	ˌorjentˈal
ha	hˈa
eminente	ˌeminˈente
La	lˈa
Christo	krˈisto
cathedral	kˌatedrˈal
candidato	kˌandidˈato
confusion	kˌonfusjˈon
Andross	andrˈoss
movimentos	mˌovimˈentos
Pakistan	pˌakistˈan
temperaturas	tˌemperatˈuras
formulas	fˈormulas
Libano	ɫˈibano
conduceva	kˌondut͡sˈeva
notitias	notˈitjas
rival	rivˈal
Gregorio	ɡreɡˈorjo
solution	sˌolutjˈon
pueras	pˈueras
omnes	ˈomnes
false	fˈalse
plures	plˈures
vector	vektˈor
humanitate	hˌumanitˈate
frequentia	frekwˈentja
pace	pˈat͡se
quadro	kwˈadro
instrumento	ˌinstrumˈento
zirconium	zirkˈonjum
identic	idˈentik
famose	famˈose
Vasa	vˈasa
solo	sˈolo
popular	pˌopulˈar
mus	mˈus
Sovente	sovˈente
iste	ˈiste
agricultura	ˌaɡrikultˈura
troianos	tro͡ɪˈanos
annunciava	ˌanunt͡sjˈava
Dorking	dorkˈiŋɡ
veni	vˈeni
die	dˈie
philosopho	philˈosofo
lanceate	lˌant͡seˈate
conquirer	kˌoŋkwirˈer
suffre	sˈufre
administrate	ˌadministrˈate
considerabile	kˌonsiderˈabile
son	sˈon
travalio	travˈaljo
Oceano	ot͡sˈeano
filas	fˈilas
medic	mˈedik
Wujek	wuʒˈek
nave	nˈave
tarde	tˈarde
vehiculos	vehˈikulos
incontrate	ˌinkontrˈate
responde	respˈonde
litros	lˈitros
Praga	prˈaɡa
pornographia	pˌornoɡrafˈia
prender	prendˈer
influentias	inflwˈentjas
Bakonyi	bakˈonji
gigante	ɡiɡˈante
influente	inflwˈente
parlar	parlˈar
quaranta	kwarˈanta
explicate	ˌeksplikˈate
existite	ˌeksistˈite
travaliar	trˌavaljˈar
combatto	kombˈato
de	dˈe
continueva	kˌontinwˈeva
massa	mˈasa
bolla	bˈola
verde	vˈerde
tote	tˈote
travaliatores	trˌavaljatˈores
Australia	a͡ʊstrˈalja
Parlamento	pˌarlamˈento
viagia	vjˈaɡja
tra	trˈa
Michael	mˌit͡ʃaˈel
mythologia	mˌitoloɡˈia
formula	fˈormula
producite	prˌodut͡sˈite
nos	nˈos
B	bˈe
describe	deskrˈibe
pecia	pˈet͡sja
apparer	ˌaparˈer
Argentina	ˌarɡentˈina
North	nˈort
pression	presjˈon
construe	kˈonstrwe
illes	ˈiles
essentialmente	ˌesentjalmˈente
sacco	sˈako
liquide	lˈikwide
affirma	afˈirma
vento	vˈento
Guerras	ɡwˈeras
nervose	nervˈose
Celsius	t͡sˈelsjus
leon	leˈon
Minnesota	mˌinesˈota
vehiculo	vehˈikulo
antenna	antˈena
resultato	rˌesultˈato
emotiones	ˌemotjˈones
regiones	reɡjˈones
trovava	trovˈava
Democratic	dˌemokrˈatik
servicios	servˈit͡sjos
purmente	purmˈente
tractos	trˈaktos
homosexual	hˌomosekswˈal
Super	sˈuper
meliorava	mˌeljorˈava
relative	rˌelatˈive
marineros	mˌarinˈeros
establir	ˌestablˈir
vacuo	vˈakwo
schola	st͡ʃˈola
debile	dˈebile
dicer	dit͡sˈer
Manuel	manwˈel
ulterior	ˌulterjˈor
Palatio	palˈatjo
appoiate	ˌapo͡ɪˈate
concipite	kˌont͡sipˈite
declinava	dˌeklinˈava
prefixo	prefˈikso
textual	tekstwˈal
complexitate	kˌompleksitˈate
van	vˈan
Hollywood	hˌoliwoˈod
requirite	rˌekwirˈite
insectos	insˈektos
apprende	aprˈende
transferite	trˌansferˈite
officio	ofˈit͡sjo
obscur	obskˈur
municipal	mˌunit͡sipˈal
partitas	partˈitas
nucleo	nuklˈeo
converteva	kˌonvertˈeva
Quando	kwˈando
poner	ponˈer
chloro	klˈoro
fundos	fˈundos
exacte	eksˈakte
California	kˌalifˈornja
creation	krˌeatjˈon
lanthano	lantˈano
libros	lˈibros
longe	lˈoŋɡe
extremitate	ˌekstremitˈate
maritage	mˌaritˈaʒe
variation	vˌarjatjˈon
capabile	kapˈabile
adverbios	advˈerbjos
resultante	rˌesultˈante
accepta	at͡sˈepta
Love	lˈove
germanos	ɡermˈanos
estate	estˈate
defensive	dˌefensˈive
secundas	sekˈundas
classificate	klˌasifikˈate
externe	ekstˈerne
impedi	impˈedi
chaco	ʃˈako
dissolveva	dˌisolvˈeva
interslavo	ˌinterslˈavo
significatos	sˌiɡnifikˈatos
Ha	hˈa
Britannic	britˈannik
recognosceva	rˌekoɡnost͡sˈeva
variationes	vˌarjatjˈones
sito	sˈito
Louis	ɫwˈi
elastic	elˈastik
lancea	lant͡sˈea
corruption	kˌoruptjˈon
postal	postˈal
altitude	ˌaltitˈude
assumeva	ˌasumˈeva
sino	sˈino
computator	kˌomputatˈor
private	privˈate
ancian	ant͡sjˈan
philosophia	phˌilosofˈia
brancas	brˈankas
moleculas	molˈekulas
optic	ˈoptik
Street	streˈet
abundante	ˌabundˈante
et	ˈet
Provincia	provˈint͡sja
annuncia	anˈunt͡sja
Lingua	lˈiŋɡwa
filia	fˈilja
popularitate	pˌopulˌaritˈate
me	mˈe
traditional	trˌaditjonˈal
Toki	tˈoki
assimilation	ˌasimˌilatjˈon
membro	mˈembro
pop	pˈop
testa	tˈesta
antique	antˈikwe
catto	kˈato
visita	visˈita
comportamento	kˌomportamˈento
Isto	ˈisto
Pauc	pˈawk
mille	mˈile
Anglaterra	ˌaŋɡlatˈera
transporto	transpˈorto
Dominica	domˈinika
intensitate	ˌintensitˈate
liberal	lˌiberˈal
directemente	dˌirektemˈente
verso	vˈerso
pronunciar	prˌonunt͡sjˈar
nube	nˈube
preservar	prˌeservˈar
potential	pˌotentjˈal
cader	kadˈer
provar	provˈar
species	spˈet͡sjes
copia	kˈopja
attaccar	ˌatakˈar
montaniose	mˌontanjˈose
ab	ˈab
preparation	prˌeparatjˈon
sentir	sentˈir
la	lˈa
demandava	dˌemandˈava
codice	kˈodit͡se
periculo	perˈikulo
locationes	lˌokatjˈones
patre	pˈatre
promotion	prˌomotjˈon
studentes	studˈentes
lateres	lˈateres
contrario	kontrˈarjo
scenas	st͡sˈenas
locate	lokˈate
Pablo	pˈablo
Oriental	ˌorjentˈal
population	pˌopulatjˈon
eveniva	ˌevenˈiva
Athena	atˈena
million	miljˈon
senti	sˈenti
dansa	dˈansa
preter	prˈeter
christiano	kristjˈano
quadrato	kwadrˈato
adde	ˈade
Britannia	britˈanja
credentia	kredˈentja
nomine	nˈomine
Multo	mˈulto
Paulo	pˈa͡ʊlo
patientes	patjˈentes
publicava	pˌublikˈava
legite	leɡˈite
America	amˈerika
technicas	tˈeknikas
cambiamentos	kˌambjamˈentos
cum	kˈum
Rege	rˈeɡe
socialista	sˌot͡sjalˈista
algorithmo	ˌalɡorˈitmo
Julietta	ʒuljˈeta
accidente	ˌat͡sidˈente
Columbia	kolˈumbja
contribueva	kˌontribwˈeva
traductiones	trˌaduktjˈones
amicos	amˈikos
deberea	dˌeberˈea
verbo	vˈerbo
hospite	hˈospite
cata	kˈata
coperi	kopˈeri
Supreme	suprˈeme
recercatores	rˌet͡serkatˈores
pertine	pertˈine
persecution	pˌersekutjˈon
discursos	diskˈursos
Cook	koˈok
segmento	seɡmˈento
palladium	palˈadjum
grammatic	ɡramˈatik
utilisante	ˌutilisˈante
Hollanda	holˈanda
to	tˈo
torno	tˈorno
maestro	maˈestro
ducite	dut͡sˈite
Evangelio	ˌevaŋɡˈeljo
manipulation	mˌanipˌulatjˈon
utilisava	ˌutilisˈava
materias	matˈerjas
partial	partjˈal
creder	kredˈer
excellente	ˌekst͡selˈente
sed	sˈed
poter	potˈer
XIX	dˈet͡senˈovem
Typicamente	tˌipikamˈente
renominate	rˌenominˈate
passate	pasˈate
carbon	karbˈon
Hodie	hˈodje
valle	vˈale
reflecte	reflˈekte
pedophile	pedˈofile
tenue	tˈenwe
crescer	krest͡sˈer
fabrica	fˈabrika
vendita	vˈendita
Testes	tˈestes
magazine	mˌaɡazˈin
mesme	mˈesme
Sayyid	sajjˈid
functional	fˌunktjonˈal
reactiones	rˌeaktjˈones
Posteriormente	pˌosterjormˈente
illas	ˈilas
compliva	komplˈiva
patiente	patjˈente
remaner	rˌemanˈer
stellas	stˈelas
arbore	ˈarbore
cinque	t͡sˈiŋkwe
independentia	ˌindependˈentja
disveloppa	dˌisvelˈopa
elaborate	ˌelaborˈate
Raphael	rˌafaˈel
artistic	artˈistik
Manila	manˈila
dedicava	dˌedikˈava
evita	evˈita
mandate	mandˈate
consilio	konsˈiljo
opponentes	ˌoponˈentes
Camera	kˈamera
Totevia	tˌotevˈia
designa	desˈiɡna
armenie	armˈenje
recercas	ret͡sˈerkas
contribution	kˌontributjˈon
sagessa	saʒˈesa
Norvegia	norvˈeɡja
spectaculo	spektˈakulo
emphase	ˈemfase
governar	ɡˌovernˈar
Apollon	apˈolon
potera	potˈera
final	finˈal
innovationes	ˌinovatjˈones
astronomic	ˌastronˈomik
facente	fat͡sˈente
esser	esˈer
music	mˈusik
lege	lˈeɡe
inseniate	ˌinsenjˈate
canes	kˈanes
cameras	kˈameras
tertio	tˈertjo
dominica	domˈinika
initio	inˈitjo
Gode	ɡˈode
proportion	prˌoportjˈon
alphabeto	ˌalfabˈeto
contacto	kontˈakto
Professor	prˌofesˈor
molle	mˈole
abandonar	ˌabandonˈar
propagation	prˌopaɡatjˈon
reduction	rˌeduktjˈon
St	ˌestˈe
Penelope	pˌenelˈope
patrono	patrˈono
ferite	ferˈite
structura	struktˈura
medicina	mˌedit͡sˈina
centros	t͡sˈentros
unda	ˈunda
Personas	persˈonas
literalmente	lˌiteralmˈente
prefixos	prefˈiksos
permission	pˌermisjˈon
rugby	rˈuɡbi
profunditate	prˌofunditˈate
Era	ˈera
influentiava	ˌinflwentjˈava
castello	kastˈelo
partitos	partˈitos
configuration	kˌonfiɡˌuratjˈon
amico	amˈiko
objective	ˌobʒektˈive
Parolas	parˈolas
russe	rˈuse
qua	kwˈa
esseva	esˈeva
congresso	koŋɡrˈeso
Johannes	ʒohˈannes
scriptor	skriptˈor
composition	kˌompositjˈon
republicas	repˈublikas
specialmente	spˌet͡sjalmˈente
seculo	sˈekulo
rende	rˈende
Latin	latˈin
orange	orˈanʒe
economic	ˌekonˈomik
museo	musˈeo
dece	dˈet͡se
Disney	disnˈej
errores	erˈores
scientific	st͡sjentˈifik
rolos	rˈolos
Erik	erˈik
casas	kˈasas
immagazinate	ˌimaɡˌazinˈate
instantanee	ˌinstantanˈee
prestigio	prestˈiɡjo
expression	ˌekspresjˈon
character	karˈakter
voleva	volˈeva
registrava	rˌeɡistrˈava
divinitate	dˌivinitˈate
terras	tˈeras
utensiles	utˈensiles
Nos	nˈos
coronate	kˌoronˈate
magne	mˈaɡne
seligite	sˌeliɡˈite
Duce	dˈut͡se
n	ˈen
Thomas	tˈomas
photo	fˈoto
septimana	sˌeptimˈana
gigantes	ɡiɡˈantes
grecos	ɡrˈekos
inviava	invjˈava
partition	pˌartitjˈon
parente	parˈente
discussiones	dˌiskusjˈones
ferroviari	fˌerovjˈari
limites	lˈimites
Gilbert	ɡilbˈert
gratias	ɡrˈatjas
velocitate	vˌelot͡sitˈate
mesurar	mˌesurˈar
extension	ˌekstensjˈon
elegite	ˌeleɡˈite
mechanismos	mˌet͡ʃanˈismos
musicos	mˈusikos
unes	ˈunes
refere	refˈere
ambes	ˈambes
statal	statˈal
vendite	vendˈite
observate	ˌobservˈate
instabilitate	ˌinstabˌilitˈate
portava	portˈava
alterate	ˌalterˈate
documentos	dˌokumˈentos
causar	ka͡ʊsˈar
obtenite	ˌobtenˈite
nomen	nomˈen
construer	konstrwˈer
desinentia	dˌesinˈentja
leges	lˈeɡes
variabile	varjˈabile
urbes	ˈurbes
proprietarios	prˌoprjetˈarjos
Organisation	ˌorɡanˌisatjˈon
Media	mˈedja
centrate	t͡sentrˈate
normative	nˌormatˈive
porta	pˈorta
incorporate	ˌinkorporˈate
politic	polˈitik
familias	famˈiljas
initial	ˌinitjˈal
jornal	ʒornˈal
traditiones	trˌaditjˈones
epic	ˈepik
longeve	loŋɡˈeve
nobile	nˈobile
fundava	fundˈava
ante	ˈante
questiones	kwestjˈones
eventos	evˈentos
Annos	ˈanos
febre	fˈebre
calcular	kˌalkulˈar
obra	ˈobra
aqua	ˈakwa
Canto	kˈanto
miraculos	mirˈakulos
mantene	mantˈene
Cromwell	kromwˈel
Gallia	ɡˈalja
sclavos	sklˈavos
comprehende	kˌomprehˈende
continuitate	kˌontinwitˈate
Pilato	pilˈato
germano	ɡermˈano
presente	presˈente
Anglese	aŋɡlˈese
religiones	rˌeliɡjˈones
lumine	lˈumine
Piaget	pjaɡˈet
west	wˈest
transition	trˌansitjˈon
comprendite	kˌomprendˈite
phantastic	fantˈastik
alimentar	ˌalimentˈar
assereva	ˌaserˈeva
executa	ˌeksekˈuta
universo	ˌunivˈerso
conquirite	kˌoŋkwirˈite
dialectos	djalˈektos
constitue	konstˈitwe
inspiration	ˌinspiratjˈon
continue	kontˈinwe
Uppsala	upsˈala
permanente	pˌermanˈente
Liberation	lˌiberatjˈon
automatic	ˌa͡ʊtomˈatik
interlingua	ˌinterlˈiŋɡwa
protegite	prˌoteɡˈite
vegetation	vˌeɡetatjˈon
pellicula	pelˈikula
static	stˈatik
avante	avˈante
initia	inˈitja
fronte	frˈonte
singule	sˈinɡule
litteratura	lˌiteratˈura
poema	poˈema
liga	lˈiɡa
scholas	st͡ʃˈolas
mechanic	mekˈanik
Sub	sˈub
rhodium	rhˈodjum
io	ˈio
captivitate	kˌaptivitˈate
captura	kaptˈura
expone	ekspˈone
empleate	ˌempleˈate
legier	leʒˈer
occideva	ˌot͡sidˈeva
participante	pˌartit͡sipˈante
gania	ɡˈanja
direction	dˌirektjˈon
construite	konstrwˈite
recentemente	rˌet͡sentemˈente
fortalessas	fˌortalˈesas
isotopo	isˈotopo
chimpanzes	ʃˌimpanzˈes
dicte	dˈikte
und	ˈund
imperio	impˈerjo
ordinari	ˌordinˈari
artistas	artˈistas
file	faˈil
pertinente	pˌertinˈente
discoperir	dˌiskoperˈir
desirava	dˌesirˈava
orientate	ˌorjentˈate
complite	komplˈite
distinguite	dˌistiŋɡwˈite
notava	notˈava
grado	ɡrˈado
Ecce	ˈet͡se
Barcelona	bˌart͡selˈona
operas	ˈoperas
registro	reɡˈistro
castellos	kastˈelos
Consilio	konsˈiljo
mangia	mˈaŋɡja
reaction	rˌeaktjˈon
mystic	mˈistik
Joseph	ʒˈosef
roman	romˈan
stratas	strˈatas
associationes	ˌasot͡sjatjˈones
Un	ˈun
electrones	ˌelektrˈones
municipalitates	mˌunit͡sˌipalitˈates
concerne	kont͡sˈerne
theologia	tˌeoloɡˈia
linguistica	linɡwˈistika
occupa	okˈupa
comenciava	kˌoment͡sjˈava
titanium	titˈanjum
matrimonio	mˌatrimˈonjo
nihil	nˈihil
credeva	kredˈeva
Tacito	tat͡sˈito
Generalmente	ɡˌeneralmˈente
radice	radˈit͡se
basic	bˈasik
passages	pasˈaʒes
scala	skˈala
regulate	rˌeɡulˈate
expansion	ˌekspansjˈon
casos	kˈasos
opponeva	ˌoponˈeva
digito	dˈiɡito
completate	kˌompletˈate
comenciate	kˌoment͡sjˈate
adopta	adˈopta
balla	bˈala
Nova	nˈova
poetic	poˈetik
establite	ˌestablˈite
qualificate	kwˌalifikˈate
primes	prˈimes
utilisa	ˌutilˈisa
ubicate	ˌubikˈate
batteria	bˌaterˈia
oves	ˈoves
Kinsey	kinsˈej
capace	kapˈat͡se
organos	ˈorɡanos
pensar	pensˈar
genera	ɡenˈera
communista	kˌomunˈista
societates	sˌot͡sjetˈates
Don	dˈon
Mais	mˈais
pluvial	pluvjˈal
religion	rˌeliɡjˈon
computatores	kˌomputatˈores
Tribunal	trˌibunˈal
Historia	histˈorja
vender	vendˈer
debilitate	dˌebilitˈate
intervallo	ˌintervˈalo
resulta	resˈulta
c	sˈe
meliorate	mˌeljorˈate
encyclopedia	ˌent͡siklˌopedˈia
developpate	dˌevelopˈate
conferentia	kˌonferˈentja
timor	timˈor
Pois	pˈois
sequite	sekwˈite
tractava	traktˈava
suppression	sˌupresjˈon
motion	motjˈon
Papa	pˈapa
Chinese	ʃinˈese
significar	sˌiɡnifikˈar
eligite	ˌeliɡˈite
inspirava	ˌinspirˈava
nascentia	nast͡sˈentja
amicitate	ˌamit͡sitˈate
federal	fˌederˈal
proprietates	prˌoprjetˈates
separava	sˌeparˈava
materiales	mˌaterjˈales
sacrificios	sˌakrifˈit͡sjos
frontiera	frontjˈera
essentia	esˈentja
vocabulos	vokˈabulos
equivalente	ˌekwivalˈente
existe	eksˈiste
Polo	pˈolo
anglese	aŋɡlˈese
Documento	dˌokumˈento
slavos	slˈavos
eruditos	ˌerudˈitos
edificate	ˌedifikˈate
bordo	bˈordo
Research	rˌeseˈart͡ʃ
Polonia	polˈonja
estimate	ˌestimˈate
phasic	fˈasik
capturar	kˌapturˈar
diametro	djˈametro
ideal	ˌideˈal
rotante	rotˈante
consequente	kˌonsekwˈente
concerto	kont͡sˈerto
experimento	ˌeksperimˈento
designator	dˌesiɡnatˈor
campion	kampjˈon
glandulas	ɡlˈandulas
qualcosa	kwalkˈosa
conte	kˈonte
grave	ɡrˈave
adjuta	adʒˈuta
Regina	reɡˈina
ambe	ˈambe
entra	ˈentra
spiritual	spˌiritwˈal
regal	reɡˈal
discutite	dˌiskutˈite
ambito	ˈambito
energetic	ˌenerɡˈetik
maritate	mˌaritˈate
infantia	infˈantja
Buenos	bwˈenos
cocina	kot͡sˈina
chassa	ʃˈasa
Tote	tˈote
cursa	kˈursa
integrate	ˌinteɡrˈate
opposition	ˌopositjˈon
neutral	ne͡ʊtrˈal
incarcerate	ˌinkart͡serˈate
papiro	papˈiro
fraude	frˈa͡ʊde
Monte	mˈonte
Paises	pˈa͡ɪses
determinar	dˌeterminˈar
modellos	modˈelos
justitia	ʒustˈitja
corte	kˈorte
strato	strˈato
conferentias	kˌonferˈentjas
incorporava	ˌinkorporˈava
antiquitate	ˌantikwitˈate
Le	lˈe
studios	stˈudjos
imagines	imˈaɡines
XVI	dˈet͡seseks
major	maʒˈor
Tjörn	tʒˈorn
Arthur	artˈur
crusta	krˈusta
Bernard	bernˈard
phonetic	fonˈetik
constituite	kˌonstitwˈite
definitiones	dˌefinitjˈones
non	nˈon
tentativas	tˌentatˈivas
edificio	ˌedifˈit͡sjo
Biblia	bˈiblja
Quatro	kwˈatro
conversation	kˌonversatjˈon
Bismarck	bismˈarkk
politicos	polˈitikos
Fox	fˈoks
planification	plˌanifˌikatjˈon
theatral	tˌeatrˈal
parla	pˈarla
argumento	ˌarɡumˈento
assecurava	ˌasekurˈava
Toto	tˈoto
dense	dˈense
propaganda	prˌopaɡˈanda
ideas	idˈeas
Amsterdam	ˌamsterdˈam
publicate	pˌublikˈate
usava	usˈava
cardiac	kardˈiak
orientation	ˌorjentatjˈon
Federal	fˌederˈal
majoritate	mˌaʒoritˈate
tropic	trˈopik
Jonathan	ʒˌonatˈan
habitate	hˌabitˈate
jammais	ʒamˈais
resistentia	rˌesistˈentja
Maria	marˈia
reducer	rˌedut͡sˈer
wiki	wˈiki
EC	ˈek
membros	mˈembros
individual	ˌindividwˈal
promitteva	prˌomitˈeva
etiquetta	ˌetikˈeta
notate	notˈate
sensibile	sensˈibile
egyptian	ˌeɡiptjˈan
imagine	imˈaɡine
disveloppava	dˌisvelopˈava
salvage	salvˈaʒe
bilingue	bilˈiŋɡwe
anniversario	ˌaniversˈarjo
capite	kˈapite
infra	ˈinfra
Constantino	kˌonstantˈino
face	fˈat͡se
Galles	ɡˈales
Omne	ˈomne
Instituto	ˌinstitˈuto
emissiones	ˌemisjˈones
contine	kontˈine
jocava	ʒokˈava
positiones	pˌositjˈones
progressive	prˌoɡresˈive
Dum	dˈum
circumferite	t͡sˌirkumferˈite
bibliothecas	bˌibljotˈekas
cellular	t͡sˌelulˈar
forestes	forˈestes
luctava	luktˈava
variate	varjˈate
auro	ˈa͡ʊro
aventuras	ˌaventˈuras
promove	promˈove
section	sektjˈon
perde	pˈerde
judicio	ʒudˈit͡sjo
corpore	kˈorpore
felice	felˈit͡se
confrontava	kˌonfrontˈava
confirmate	kˌonfirmˈate
effortio	efˈortjo
sphera	sfˈera
attacco	atˈako
ecclesias	eklˈesjas
Gruppo	ɡrˈupo
Egypto	eɡˈipto
varie	vˈarje
American	ˌamerikˈan
Brahe	brˈahe
laborar	lˌaborˈar
Sectiones	sektjˈones
Jedi	ʒˈedi
secundari	sˌekundˈari
aperiva	ˌaperˈiva
homines	hˈomines
conservate	kˌonservˈate
glacie	ɡlˈat͡sje
discopertas	dˌiskopˈertas
listate	listˈate
reimplaciava	rˌe͡ɪmplat͡sjˈava
Cor	kˈor
sanctos	sˈanktos
tene	tˈene
contemporanee	kˌontempˌoranˈee
mortes	mˈortes
ir	ˈir
usate	usˈate
extense	ekstˈense
concedite	kˌont͡sedˈite
altemente	ˌaltemˈente
equation	ˌekwatjˈon
continentes	kˌontinˈentes
applica	ˈaplika
vive	vˈive
refusava	rˌefusˈava
septime	sˈeptime
professional	prˌofesjonˈal
artificial	ˌartifit͡sjˈal
revela	revˈela
correctemente	kˌorektemˈente
includite	ˌinkludˈite
Studios	stˈudjos
registrar	rˌeɡistrˈar
empleo	emplˈeo
presentation	prˌesentatjˈon
Aeroporto	ˌaeropˈorto
medievo	medjˈevo
dialecto	djalˈekto
complicate	kˌomplikˈate
curiositate	kˌurjositˈate
virus	vˈirus
pagate	paɡˈate
expeditiones	ˌekspeditjˈones
derecto	derˈekto
audir	a͡ʊdˈir
legislative	lˌeɡislatˈive
obteneva	ˌobtenˈeva
satellites	satˈelites
imposition	ˌimpositjˈon
responsa	respˈonsa
area	arˈea
prince	prˈint͡se
sovietic	sovjˈetik
via	vˈia
Japon	ʒapˈon
o	ˈo
continer	kˌontinˈer
collectiones	kˌolektjˈones
tertie	tˈertje
relation	rˌelatjˈon
individuo	ˌindivˈidwo
destinate	dˌestinˈate
suffreva	sufrˈeva
proque	prokˈe
actualitate	ˌaktwalitˈate
dispositiones	dˌispositjˈones
resolver	rˌesolvˈer
Renascentia	rˌenast͡sˈentja
assertion	ˌasertjˈon
Ciceron	t͡sˌit͡serˈon
unitari	ˌunitˈari
luce	lˈut͡se
truppas	trˈupas
apparition	ˌaparitjˈon
rejection	rˌeʒektjˈon
Normandia	ŋˌormandˈia
argumentos	ˌarɡumˈentos
Gabriel	ɡabrjˈel
adulte	adˈulte
habilitate	hˌabilitˈate
Latio	lˈatjo
obligate	ˌobliɡˈate
liquido	lˈikwido
definir	dˌefinˈir
supervive	sˌupervˈive
prova	prˈova
Romulo	rˈomulo
tentava	tentˈava
concentration	kˌont͡sentratjˈon
linguage	linɡwˈaʒe
tellurium	telˈurjum
naval	navˈal
Georgia	ɡeˈorɡja
governava	ɡˌovernˈava
specificamente	spˌet͡sifˌikamˈente
assere	asˈere
retes	rˈetes
sanguine	sˈanɡwine
reimplaciate	rˌe͡ɪmplat͡sjˈate
christianos	kristjˈanos
sequer	sekwˈer
obligatori	ˌobliɡatˈori
medieval	mˌedjevˈal
describeva	dˌeskribˈeva
competentia	kˌompetˈentja
vincite	vint͡sˈite
acquireva	ˌakkwirˈeva
Indonesia	ˌindonˈesja
XIV	dˈet͡sekwˈatro
avantages	ˌavantˈaʒes
abstracte	abstrˈakte
diario	djˈarjo
discrimination	dˌiskrimˌinatjˈon
pauco	pˈawko
ferro	fˈero
sposo	spˈoso
tende	tˈende
granos	ɡrˈanos
John	ʒˈohn
condemnation	kˌondemnatjˈon
comenciamento	kˌoment͡sjamˈento
Mundo	mˈundo
independentemente	ˌindepˌendentemˈente
longemente	lˌoŋɡemˈente
deveni	devˈeni
attingite	ˌatiŋɡˈite
conception	kˌont͡septjˈon
mi	mˈi
rocca	rˈoka
preservate	prˌeservˈate
sinistra	sinˈistra
cognoscentia	kˌoɡnost͡sˈentja
Tal	tˈal
mexican	mˌeksikˈan
wikis	wˈikis
Zelanda	zelˈanda
Statos	stˈatos
Nove	nˈove
Hectore	hektˈore
publication	pˌublikatjˈon
Nulle	nˈule
Michel	mit͡ʃˈel
amica	amˈika
adolescentia	ˌadolest͡sˈentja
expandite	ˌekspandˈite
cantava	kantˈava
esque	ˈeske
capitulos	kapˈitulos
dextera	dˈekstera
cognoscer	kˌoɡnost͡sˈer
Latino	latˈino
completar	kˌompletˈar
Equus	ˈekwus
Manifesto	mˌanifˈesto
motor	motˈor
traditionalmente	trˌaditjˌonalmˈente
Los	lˈos
saison	sezˈon
E	ˈe
stilos	stˈilos
message	mesˈaʒe
mina	mˈina
adjectivo	ˌadʒektˈivo
Hertz	hˈertz
serpente	serpˈente
atmosphera	ˌatmosfˈera
unir	unˈir
crimine	krˈimine
pretendentes	prˌetendˈentes
tamen	tˈamen
capital	kˌapitˈal
jocator	ʒˌokatˈor
kg	kˌaɡˈe
referentias	rˌeferˈentjas
notion	notjˈon
cruce	krˈut͡se
simple	sˈimple
identifica	ˌidentˈifika
instructiones	ˌinstruktjˈones
aliquando	ˌalikwˈando
pronuncia	pronˈunt͡sja
Ambe	ˈambe
Citate	t͡sitˈate
communmente	kˌomunmˈente
generation	ɡˌeneratjˈon
incontrar	ˌinkontrˈar
unicamente	ˌunikamˈente
Neptuno	neptˈuno
position	pˌositjˈon
forte	fˈorte
practicamente	prˌaktikamˈente
distaccate	dˌistakˈate
stabilite	stˌabilˈite
licentias	lit͡sˈentjas
epocha	ˈepoka
situate	sitwˈate
indigena	indˈiɡena
altera	altˈera
vale	vˈale
brun	brˈun
Interlingua	ˌinterlˈiŋɡwa
PM	pˌeˈem
defender	dˌefendˈer
prisioneros	prˌisjonˈeros
praseodymium	prˌaseodˈimjum
datos	dˈatos
ordines	ˈordines
precisemente	prˌet͡sisemˈente
idiomas	idjˈomas
dirigeva	dˌiriɡˈeva
calculo	kˈalkulo
native	natˈive
vapor	vapˈor
of	ˈof
providite	prˌovidˈite
chimia	kimˈia
retro	rˈetro
excessive	ˌekst͡sesˈive
Zeus	ʒˈeus
plen	plˈen
individuos	ˌindivˈidwos
depois	depˈois
riviera	rivjˈera
jam	ʒˈam
cyclos	t͡sˈiklos
Paz	pˈaz
chassatores	t͡ʃˌasatˈores
actor	aktˈor
Ni	nˈi
Foucault	fˌoukˈa͡ʊlt
yttrium	ˈitrjum
computation	kˌomputatjˈon
characteristica	kˌarakterˈistika
figura	fiɡˈura
u	ˈu
palatio	palˈatjo
sacrificio	sˌakrifˈit͡sjo
philosophos	philˈosofos
poteres	potˈeres
parlamentari	pˌarlamentˈari
memorias	memˈorjas
sexanta	seksˈanta
oculos	ˈokulos
nostre	nˈostre
actualmente	ˌaktwalmˈente
pares	pˈares
narrationes	nˌaratjˈones
boxa	bˈoksa
augmentava	ˌa͡ʊɡmentˈava
originate	ˌoriɡinˈate
subsequente	sˌubsekwˈente
provide	provˈide
multes	mˈultes
Es	ˈes
exprimer	ˌeksprimˈer
ensemble	ansˈamble
populate	pˌopulˈate
titulos	tˈitulos
cognoscimento	kˌoɡnost͡simˈento
neon	nˈeon
malade	malˈade
XIII	dˈet͡setres
espaniol	ˌespanjˈol
particular	pˌartikulˈar
affecta	afˈekta
simultanee	sˌimultanˈee
preservation	prˌeservatjˈon
vade	vˈade
cargo	kˈarɡo
Sovietic	sovjˈetik
narration	nˌaratjˈon
necessita	nˌet͡sesˈita
distingue	distˈiŋɡwe
fresc	frˈesk
istas	ˈistas
clarmente	klarmˈente
Medievo	medjˈevo
loyal	lojˈal
reguarda	reɡwˈarda
Sicilia	sit͡sˈilja
prendite	prendˈite
factores	faktˈores
expertos	ekspˈertos
publica	pˈublika
Alora	alˈora
nodos	nˈodos
Jan	ʒˈan
Insulas	ˈinsulas
Macedonia	mˌat͡sedˈonja
Spirito	spˈirito
imperatores	ˌimperatˈores
in	ˈin
Christian	kristjˈan
Donald	donˈald
incerte	int͡sˈerte
certemente	t͡sˌertemˈente
qualcunque	kwalkˈuŋkwe
Benque	bˈeŋkwe
Secunde	sekˈunde
tractatos	traktˈatos
communitari	kˌomunitˈari
provider	prˌovidˈer
English	eŋɡlˈiʃ
dama	dˈama
familia	famˈilja
ADN	ˈadn
idea	idˈea
continuate	kˌontinwˈate
comencia	komˈent͡sja
Solo	sˈolo
regional	rˌeɡjonˈal
est	ˈest
remarcabile	rˌemarkˈabile
principalmente	prˌint͡sipalmˈente
revolta	revˈolta
ruthenium	rutˈenjum
isse	ˈise
decade	dˈekade
philosophic	phˌilosˈofik
citates	t͡sitˈates
influentiar	ˌinflwentjˈar
conquesta	koŋkwˈesta
typicamente	tˌipikamˈente
Ido	ˈido
sexte	sˈekste
alicunos	ˌalikˈunos
corde	kˈorde
zinc	zˈink
cargas	kˈarɡas
scriptura	skriptˈura
You	jˈou
methodo	mˈetodo
Sancte	sˈankte
aquas	ˈakwas
mediante	medjˈante
professores	prˌofesˈores
alicuno	ˌalikˈuno
currente	kurˈente
Regal	reɡˈal
capitano	kˌapitˈano
Poseidon	pˌose͡ɪdˈon
costumes	kostˈumes
describite	dˌeskribˈite
situation	sˌitwatjˈon
septentrional	sˌeptentrjonˈal
tropical	trˌopikˈal
galleco	ɡalˈeko
Scriptura	skriptˈura
negotios	neɡˈotjos
anonyme	anˈonime
exemplos	eksˈemplos
observationes	ˌobservatjˈones
Platon	plˈaton
novo	nˈovo
emergentia	ˌemerɡˈentja
posseder	pˌosedˈer
participar	pˌartit͡sipˈar
experte	ekspˈerte
Science	st͡sjˈent͡se
minime	mˈinime
Exemplos	eksˈemplos
movimento	mˌovimˈento
phenomenos	fenˈomenos
canna	kˈana
Sur	sˈur
Inter	ˈinter
valor	valˈor
restava	restˈava
Anne	ˈane
reproduction	rˌeproduktjˈon
grandor	ɡrandˈor
colpo	kˈolpo
David	davˈid
banca	bˈanka
surge	sˈurɡe
perdite	perdˈite
tourismo	turˈismo
cinctura	t͡sinktˈura
series	sˈerjes
dextere	dˈekstere
Union	unjˈon
normalmente	nˌormalmˈente
integre	ˈinteɡre
disciplina	dˌist͡siplˈina
unitates	ˌunitˈates
identitate	ˌidentitˈate
superar	sˌuperˈar
ver	vˈer
Originalmente	ˌoriɡˌinalmˈente
motores	motˈores
appellate	ˌapelˈate
entrata	entrˈata
electronic	ˌelektrˈonik
scriptos	skrˈiptos
aperite	ˌaperˈite
proposito	propˈosito
Lu	lˈu
criminal	krˌiminˈal
Secun	sekˈun
accordate	ˌakordˈate
exclusivemente	ˌeksklusˌivemˈente
bandas	bˈandas
resultar	rˌesultˈar
actores	aktˈores
favorabile	fˌavorˈabile
celebrate	t͡sˌelebrˈate
extendite	ˌekstendˈite
precision	prˌet͡sisjˈon
occurreva	ˌokurˈeva
circum	t͡sˈirkum
isolate	ˌisolˈate
PIB	pˈib
projectos	proʒˈektos
hemispherio	hˌemisfˈerjo
Software	sˈoftware
vaste	vˈaste
fluxo	flˈukso
conforme	konfˈorme
principio	print͡sˈipjo
separate	sˌeparˈate
armeas	armˈeas
distacca	distˈaka
Lor	lˈor
converte	konvˈerte
planta	plˈanta
existeva	ˌeksistˈeva
radioamator	rˌadjoˌamatˈor
inundation	ˌinundatjˈon
antennas	antˈenas
photographic	phˌotoɡrˈafik
musico	mˈusiko
amor	amˈor
hereditava	hˌereditˈava
pedones	pedˈones
frequente	frekwˈente
filios	fˈiljos
demandar	dˌemandˈar
pena	pˈena
Roman	romˈan
occurrite	ˌokurˈite
essera	esˈera
dolor	dolˈor
ressources	ressˈurses
ager	aɡˈer
dar	dˈar
du	dˈu
dum	dˈum
titulate	tˌitulˈate
voto	vˈoto
Turner	turnˈer
constitutional	kˌonstitˌutjonˈal
active	aktˈive
mano	mˈano
dispare	dispˈare
Laco	lˈako
regular	rˌeɡulˈar
ni	nˈi
contexto	kontˈeksto
oleo	olˈeo
facto	fˈakto
sud	sˈud
secrete	sekrˈete
Nam	nˈam
Alte	ˈalte
bandiera	bandjˈera
Kalmar	kalmˈar
realitate	rˌealitˈate
cifra	t͡sˈifra
honores	honˈores
basa	bˈasa
peninsula	penˈinsula
industrial	ˌindustrjˈal
adjacente	ˌadʒat͡sˈente
marcas	mˈarkas
nigro	nˈiɡro
Plus	plˈus
emittite	ˌemitˈite
West	wˈest
vinti	vˈinti
effecto	efˈekto
evangelio	ˌevaŋɡˈeljo
Altere	ˈaltere
Bornholm	bornhˈolm
large	lˈarɡe
desirate	dˌesirˈate
politicamente	pˌolitˌikamˈente
chimic	kˈimik
subite	sˈubite
slovene	slovˈene
describer	dˌeskribˈer
Lege	lˈeɡe
pedophilic	pˌedofˈilik
servitor	sˌervitˈor
cobalt	kˈobalt
arrivata	ˌarivˈata
importa	impˈorta
catholicismo	kˌatolit͡sˈismo
tabulas	tˈabulas
temporal	tˌemporˈal
exception	ˌekst͡septjˈon
futur	futˈur
termination	tˌerminatjˈon
ordine	ˈordine
recognosce	rˌekoɡnˈost͡se
alcunos	alkˈunos
diminuer	dˌiminwˈer
diffusion	dˌifusjˈon
Anna	ˈana
semper	sˈemper
metros	mˈetros
conditional	kˌonditjonˈal
motivos	motˈivos
superfacie	sˌuperfˈat͡sje
Historicamente	hˌistorˌikamˈente
saliva	salˈiva
seriose	serjˈose
adverbio	advˈerbjo
mantenite	mˌantenˈite
galaxia	ɡalˈaksja
intende	intˈende
sovente	sovˈente
dieta	djˈeta
judicial	ʒˌudit͡sjˈal
Festival	fˌestivˈal
nominal	nˌominˈal
gris	ɡrˈis
Insula	ˈinsula
José	ʒˈose
logic	lˈoɡik
effortios	efˈortjos
discoperta	dˌiskopˈerta
Zig	zˈiɡ
occurre	okˈure
contatos	kontˈatos
durava	durˈava
partito	partˈito
novas	nˈovas
Cure	kˈure
organisa	ˌorɡanˈisa
norvegian	nˌorveɡjˈan
copula	kˈopula
defensa	defˈensa
parasito	pˌarasˈito
manieras	manjˈeras
socialismo	sˌot͡sjalˈismo
causas	kˈa͡ʊsas
promissa	promˈisa
virtute	virtˈute
equipage	ˌekwipˈaʒe
consisteva	kˌonsistˈeva
Heleno	helˈeno
ido	ˈido
existente	ˌeksistˈente
comedias	komˈedjas
alimentos	ˌalimˈentos
dimensiones	dˌimensjˈones
competition	kˌompetitjˈon
fixar	fiksˈar
baptisate	bˌaptisˈate
cassa	kˈasa
dedicate	dˌedikˈate
touristas	turˈistas
advocato	ˌadvokˈato
Ambes	ˈambes
mechanismo	mˌet͡ʃanˈismo
alte	ˈalte
libere	lˈibere
nunc	nˈunk
rata	rˈata
populos	pˈopulos
dea	dˈea
cosmic	kˈosmik
horizontal	hˌorizontˈal
mundial	mundjˈal
declarava	dˌeklarˈava
cognosce	koɡnˈost͡se
Gay	ɡˈaj
commercial	kˌomert͡sjˈal
attaccate	ˌatakˈate
rar	rˈar
requesta	rekwˈesta
indice	ˈindit͡se
exigeva	ˌeksiɡˈeva
originari	ˌoriɡinˈari
solide	sˈolide
sclavitude	sklˌavitˈude
energia	ˌenerɡˈia
City	t͡sˈiti
baptismo	baptˈismo
seliger	sˌeliɡˈer
Gratias	ɡrˈatjas
guida	ɡwˈida
donate	donˈate
Ludovico	ludˈoviko
representar	rˌepresentˈar
classification	klˌasifˌikatjˈon
circulo	t͡sˈirkulo
Nobel	nobˈel
additional	ˌaditjonˈal
multitude	mˌultitˈude
benes	bˈenes
tu	tˈu
indium	ˈindjum
copertura	kˌopertˈura
cm	sˌeˈem
pictura	piktˈura
calide	kˈalide
flechas	flˈeʃas
plural	plurˈal
entitates	ˌentitˈates
governamental	ɡˌovernˌamentˈal
legal	leɡˈal
platteforma	plˌatefˈorma
aquatic	akwˈatik
novem	nˈovem
conjunctemente	kˌonʒunktemˈente
traffico	trˈafiko
error	erˈor
predominante	prˌedominˈante
incarnation	ˌinkarnatjˈon
album	ˈalbum
violentia	vjolˈentja
differente	dˌiferˈente
puera	pˈuera
suggere	suɡˈere
diversitate	dˌiversitˈate
distante	distˈante
tue	tˈue
seligeva	sˌeliɡˈeva
consentimento	kˌonsentimˈento
origina	ˌoriɡˈina
studio	stˈudjo
metallic	metˈalik
secun	sekˈun
totes	tˈotes
masculos	mˈaskulos
radioamatori	rˌadjoˌamatˈori
technetium	teknˈetjum
abbreviation	ˌabrevjatjˈon
asino	ˈasino
cruciate	krut͡sjˈate
companion	kˌompanjˈon
recensiones	rˌet͡sensjˈones
localisate	lˌokalisˈate
continuava	kˌontinwˈava
Enrique	enrˈikwe
ganiator	ɡˌanjatˈor
grammatical	ɡrˌamatikˈal
binari	binˈari
tensiones	tensjˈones
programmas	proɡrˈamas
region	reɡjˈon
diceva	dit͡sˈeva
esperanto	ˌesperˈanto
beltate	beltˈate
deveniva	dˌevenˈiva
origines	orˈiɡines
confundite	kˌonfundˈite
incendio	int͡sˈendjo
valores	valˈores
Durante	durˈante
perfecte	perfˈekte
extendeva	ˌekstendˈeva
pensatores	pˌensatˈores
elemental	ˌelementˈal
jocar	ʒokˈar
significa	siɡnˈifika
tornava	tornˈava
syllaba	sˈilaba
autoritates	ˌa͡ʊtoritˈates
trainamento	trˌa͡ɪnamˈento
accusate	ˌakusˈate
Leonidas	ɫeˈonidas
facte	fˈakte
oral	orˈal
disco	dˈisko
suffixos	sufˈiksos
experimental	ˌeksperˌimentˈal
objectos	obʒˈektos
prime	prˈime
stratos	strˈatos
China	ʃˈina
salute	salˈute
SUA	swˈa
sexualmente	sˌekswalmˈente
reforma	refˈorma
fundamento	fˌundamˈento
OmegaT	ˈomeɡatˈe
usualmente	ˌuswalmˈente
slovenos	slovˈenos
conto	kˈonto
elementos	ˌelemˈentos
parolas	parˈolas
gadolinimum	ɡˌadolˌinimˈum
generationes	ɡˌeneratjˈones
statos	stˈatos
facultate	fˌakultˈate
originava	ˌoriɡinˈava
appoio	apˈojo
contar	kontˈar
autoritate	ˌa͡ʊtoritˈate
placiava	plat͡sjˈava
coronas	korˈonas
interslave	ˌinterslˈave
sequeva	sekwˈeva
cornos	kˈornos
Departimento	dˌepartimˈento
possibilemente	pˌosibˌilemˈente
gentes	ɡˈentes
Linné	lˈine
sexos	sˈeksos
autonome	a͡ʊtˈonome
conceptos	kont͡sˈeptos
hebreo	hebrˈeo
acceptava	ˌat͡septˈava
similar	sˌimilˈar
componente	kˌomponˈente
question	kwestjˈon
y	ˌipsilˈon
causate	ka͡ʊsˈate
distantias	distˈantjas
istos	ˈistos
agitation	ˌaɡitatjˈon
battalia	batˈalja
per	pˈer
referite	rˌeferˈite
romances	romˈant͡ses
tagalog	tˌaɡalˈoɡ
mappas	mˈapas
cadita	kadˈita
sacramentos	sˌakramˈentos
actual	aktwˈal
Svedia	svˈedja
Scotia	skˈotja
Eneas	enˈeas
peso	pˈeso
componite	kˌomponˈite
conserva	konsˈerva
frigido	frˈiɡido
femina	fˈemina
operationes	ˌoperatjˈones
Duo	dˈuo
Hic	hˈik
curso	kˈurso
racia	rˈat͡sja
electiones	ˌelektjˈones
maio	mˈajo
guerras	ɡwˈeras
pronunciate	prˌonunt͡sjˈate
Similarmente	sˌimilarmˈente
scepticismo	st͡sˌeptit͡sˈismo
assassinate	ˌasasinˈate
supportate	sˌuportˈate
activitates	ˌaktivitˈates
presidential	prˌesidentjˈal
e	ˈe
porto	pˈorto
apparente	ˌaparˈente
crear	kreˈar
lassar	lasˈar
definite	dˌefinˈite
millias	mˈiljas
influentiate	ˌinflwentjˈate
collo	kˈolo
Grande	ɡrˈande
novembre	novˈembre
milles	mˈiles
crede	krˈede
lista	lˈista
adjutar	ˌadʒutˈar
viros	vˈiros
reputation	rˌeputatjˈon
obtene	obtˈene
doctrinas	doktrˈinas
cresceva	krest͡sˈeva
marcate	markˈate
semines	sˈemines
affectate	ˌafektˈate
Tamben	tambˈen
juncto	ʒˈunkto
punctos	pˈunktos
nasceva	nast͡sˈeva
connectite	kˌonektˈite
illustrate	ˌilustrˈate
post	pˈost
Portugal	pˌortuɡˈal
institutiones	ˌinstitutjˈones
facie	fˈat͡sje
gusto	ɡˈusto
uso	ˈuso
Bon	bˈon
assi	asˈi
nomina	nomˈina
menses	mˈenses
hollandese	hˌolandˈese
cortes	kˈortes
viveva	vivˈeva
Victoria	viktˈorja
apogeo	ˌapoɡˈeo
absentia	absˈentja
essaya	esˈaja
aspectos	aspˈektos
tecto	tˈekto
esse	ˈese
education	ˌedukatjˈon
permittite	pˌermitˈite
dur	dˈur
rolo	rˈolo
patente	patˈente
emphysema	ˌemfisˈema
accusationes	ˌakusatjˈones
normas	nˈormas
Zag	zˈaɡ
social	sot͡sjˈal
Trump	trˈump
finalmente	fˌinalmˈente
Assi	asˈi
cartas	kˈartas
restante	restˈante
actrice	aktrˈit͡se
Ordine	ˈordine
talento	talˈento
doctrina	doktrˈina
interactiones	ˌinteraktjˈones
apprender	ˌaprendˈer
Wikidata	wˌikidˈata
monumentos	mˌonumˈentos
turres	tˈures
emission	ˌemisjˈon
significantia	sˌiɡnifikˈantja
Brasil	brasˈil
sposa	spˈosa
Assemblea	ˌasemblˈea
normanne	normˈane
ja	ʒˈa
Unite	unˈite
pullos	pˈulos
haberea	hˌaberˈea
diplomatic	dˌiplomˈatik
parve	pˈarve
De	dˈe
compositiones	kˌompositjˈones
un	ˈun
slave	slˈave
causava	ka͡ʊsˈava
hasardo	hasˈardo
coincide	ko͡ɪnt͡sˈide
marita	marˈita
permitter	pˌermitˈer
Initialmente	ˌinitjalmˈente
informationes	ˌinformatjˈones
credentias	kredˈentjas
migration	mˌiɡratjˈon
rejectate	rˌeʒektˈate
Senior	senjˈor
quales	kwˈales
Tractato	traktˈato
largemente	lˌarɡemˈente
validitate	vˌaliditˈate
revolution	rˌevolutjˈon
MSX	ˌemˌesˈiks
Representantes	rˌepresentˈantes
LHC	ˌelhˌasˈe
elementari	ˌelementˈari
Derectos	derˈektos
campania	kampˈanja
campos	kˈampos
stricte	strˈikte
professor	prˌofesˈor
dos	dˈos
departimento	dˌepartimˈento
identificar	ˌidentˌifikˈar
completemente	kˌompletemˈente
retornava	rˌetornˈava
distribuer	dˌistribwˈer
presentava	prˌesentˈava
boxer	bˈokser
fideles	fidˈeles
Peru	perˈu
moderne	modˈerne
coperir	kˌoperˈir
NAMBLA	nˈambla
Maurice	ma͡ʊrˈit͡se
Mary	mˈari
conquireva	kˌoŋkwirˈeva
vel	vˈel
mappa	mˈapa
cuje	kˈuʒe
insimul	insˈimul
VII	sˈepte
defini	defˈini
ritos	rˈitos
doctor	doktˈor
secta	sˈekta
neodymium	nˌeodˈimjum
Belgica	βˈelɡika
tempos	tˈempos
falcon	falkˈon
diffundite	dˌifundˈite
progresso	proɡrˈeso
compacte	kompˈakte
retirar	rˌetirˈar
alicunes	ˌalikˈunes
patres	pˈatres
phosphoro	phˈosforo
Julia	ʒˈulja
revistas	revˈistas
servir	servˈir
experientias	ˌeksperjˈentjas
Taiwan	ta͡ɪwˈan
investigationes	ˌinvestˌiɡatjˈones
manos	mˈanos
require	rekwˈire
successive	sˌut͡sesˈive
stadios	stˈadjos
vital	vitˈal
ruptura	ruptˈura
prevention	prˌeventjˈon
vivente	vivˈente
avantia	avˈantja
organic	orɡˈanik
natura	natˈura
offerer	ˌoferˈer
fortuna	fortˈuna
Senato	senˈato
accentos	at͡sˈentos
Groenlandia	ɡrˌoenlˈandja
XV	dˈet͡set͡sˈinkwe
fixate	fiksˈate
premios	prˈemjos
possessive	pˌosesˈive
vendeva	vendˈeva
aspecto	aspˈekto
Committee	komˈiti
musical	mˌusikˈal
studiate	studjˈate
ASCII	ˈast͡sji
necesse	net͡sˈese
Fide	fˈide
ponite	ponˈite
universitari	ˌunivˌersitˈari
differentia	dˌiferˈentja
Messia	mesˈia
pone	pˈone
culto	kˈulto
publicar	pˌublikˈar
assatis	asˈatis
Minor	minˈor
spiral	spirˈal
prende	prˈende
equalmente	ˌekwalmˈente
Mundial	mundjˈal
Marx	mˈarks
habita	habˈita
alternativa	ˌalternatˈiva
precedente	prˌet͡sedˈente
Bakunin	bˌakunˈin
suffixo	sufˈikso
generar	ɡˌenerˈar
educational	ˌedukˌatjonˈal
Marilyn	mˌarilˈin
dictionarios	dˌiktjonˈarjos
disparition	dˌisparitjˈon
expandeva	ˌekspandˈeva
dynamic	dinˈamik
Lo	lˈo
credente	kredˈente
marin	marˈin
conducer	kˌondut͡sˈer
victimas	vˈiktimas
decideva	dˌet͡sidˈeva
Del	dˈel
Regno	rˈeɡno
maxime	mˈaksime
interessante	ˌinteresˈante
rigide	rˈiɡide
Oriente	orjˈente
inventava	ˌinventˈava
inventor	ˌinventˈor
etc	ˈetk
proteina	protˈe͡ɪna
scriptores	skriptˈores
particulas	partˈikulas
Illo	ˈilo
pare	pˈare
cambiar	kambjˈar
titular	tˌitulˈar
Armstrong	armstrˈoŋɡ
Brown	brˈown
personal	pˌersonˈal
poesia	pˌoesˈia
pacchettos	pat͡ʃˈetos
commun	komˈun
autumno	a͡ʊtˈumno
quatro	kwˈatro
algorithmos	ˌalɡorˈitmos
Grammy	ɡrˈami
primarimente	prˌimarimˈente
Filio	fˈiljo
associate	ˌasot͡sjˈate
effective	ˌefektˈive
Costa	kˈosta
physic	fˈisik
efficace	ˌefikˈat͡se
limita	limˈita
Nord	nˈord
periodo	perˈiodo
arrangiamento	ˌaranʒamˈento
typos	tˈipos
libertate	lˌibertˈate
Pro	prˈo
textos	tˈekstos
Nicolas	nikˈolas
analytic	ˌanalˈitik
contato	kontˈato
regno	rˈeɡno
Ante	ˈante
Augusto	a͡ʊɡˈusto
declarate	dˌeklarˈate
predas	prˈedas
VI	sˈeks
revista	revˈista
Institute	ˌinstitˈute
libertates	lˌibertˈates
dissolution	dˌisolutjˈon
neutre	nˈe͡ʊtre
Washington	wˌaʃiŋɡtˈon
variabiles	varjˈabiles
judicamento	ʒˌudikamˈento
vestimentos	vˌestimˈentos
inseniar	ˌinsenjˈar
termina	termˈina
color	kolˈor
quadrate	kwadrˈate
destructive	dˌestruktˈive
singular	sˌiŋɡulˈar
Grec	ɡrˈek
Chicago	t͡ʃikˈaɡo
habitual	hˌabitwˈal
statounitese	stˌatoˌunitˈese
musulman	mˌusulmˈan
symbolos	sˈimbolos
gravitational	ɡrˌavitˌatjonˈal
notabilemente	nˌotabˌilemˈente
Secundo	sekˈundo
archaic	arkˈaik
necuno	nekˈuno
attitudes	ˌatitˈudes
urban	urbˈan
Collegio	kolˈeɡjo
latino	latˈino
Imperio	impˈerjo
immagazinage	ˌimaɡˌazinˈaʒe
basso	bˈaso
León	leˈon
Alexander	ˌaleksandˈer
complexe	komplˈekse
intention	ˌintentjˈon
manifestava	mˌanifestˈava
reticulo	retˈikulo
studiar	studjˈar
accordo	akˈordo
augmentar	ˌa͡ʊɡmentˈar
Istos	ˈistos
Partito	partˈito
optime	ˈoptime
codices	kˈodit͡ses
Pace	pˈat͡se
Castello	kastˈelo
reuniones	re͡ʊnjˈones
Frits	frˈits
specie	spˈet͡sje
turre	tˈure
throno	trˈono
opponente	ˌoponˈente
strontium	strˈontjum
secur	sekˈur
disveloppate	dˌisvelopˈate
disputas	dispˈutas
cavitate	kˌavitˈate
assisteva	ˌasistˈeva
fundo	fˈundo
constante	konstˈante
note	nˈote
seque	sˈekwe
respectar	rˌespektˈar
linguages	linɡwˈaʒes
Ergo	ˈerɡo
habitation	hˌabitatjˈon
approbate	ˌaprobˈate
Erasmo	erˈasmo
municipalitate	mˌunit͡sˌipalitˈate
simile	sˈimile
radioamatores	rˌadjoˌamatˈores
divider	dˌividˈer
Nascite	nast͡sˈite
salvate	salvˈate
guidate	ɡwidˈate
pronunciation	prˌonunt͡sjatjˈon
magnetic	maɡnˈetik
Internet	ˌinternˈet
perdita	pˈerdita
Commission	kˌomisjˈon
placia	plˈat͡sja
expedition	ˌekspeditjˈon
attraction	ˌatraktjˈon
director	dˌirektˈor
tono	tˈono
stylo	stˈilo
adaptate	ˌadaptˈate
Records	rˈekords
genere	ɡˈenere
developpamento	dˌevelˌopamˈento
flotta	flˈota
terminava	tˌerminˈava
anno	ˈano
arrivar	ˌarivˈar
Juan	ʒwˈan
relativemente	rˌelatˌivemˈente
ibi	ˈibi
guitarra	ɡhitˈara
puero	pˈuero
revelate	rˌevelˈate
discoperite	dˌiskoperˈite
defendeva	dˌefendˈeva
supreme	suprˈeme
loco	lˈoko
incognite	inkˈoɡnite
creante	kreˈante
joco	ʒˈoko
Hidalgo	hidˈalɡo
intense	intˈense
provincias	provˈint͡sjas
Vos	vˈos
difficultate	dˌifikultˈate
São	sˈao
geographic	ɡˌeoɡrˈafik
governa	ɡovˈerna
dollares	dolˈares
logica	lˈoɡika
dialogos	djˈaloɡos
contactos	kontˈaktos
nordic	nˈordik
democratia	dˌemokratˈia
recente	ret͡sˈente
juncte	ʒˈunkte
paradoxo	pˌaradˈokso
Van	vˈan
bisontes	bisˈontes
inimico	ˌinimˈiko
drogas	drˈoɡas
ista	ˈista
prefere	prefˈere
latin	latˈin
volumines	volˈumines
blanc	blˈank
gothic	ɡˈotik
rangos	rˈaŋɡos
nove	nˈove
iodo	jˈodo
fundate	fundˈate
installation	ˌinstalatjˈon
interesses	ˌinterˈeses
adolescentes	ˌadolest͡sˈentes
pugno	pˈuɡno
diabolo	djˈabolo
principios	print͡sˈipjos
Florentia	florˈentja
cosino	kosˈino
acceptation	ˌat͡septatjˈon
Mark	mˈark
Alfred	alfrˈed
entrava	entrˈava
heterosexual	hˌeterˌosekswˈal
promovite	prˌomovˈite
matre	mˈatre
nickel	nˈikel
practic	prˈaktik
Press	prˈess
detalios	detˈaljos
mm	ˌemˈem
uniforme	ˌunifˈorme
representative	rˌepresˌentatˈive
Ponte	pˈonte
povre	pˈovre
sexo	sˈekso
quantitates	kwˌantitˈates
Cambridge	kambrˈidɡe
alcohol	ˌalkohˈol
dimension	dˌimensjˈon
Ricardo	rikˈardo
arabe	ˈarabe
alco	ˈalko
cupro	kˈupro
rebellion	rˌebeljˈon
Introduction	ˌintroduktjˈon
repasto	repˈasto
Patroclo	patrˈoklo
formante	formˈante
interprisas	ˌinterprˈisas
interpretar	ˌinterpretˈar
systemas	sistˈemas
Castilia	kastˈilja
catalan	kˌatalˈan
tabula	tˈabula
Dewey	dewˈej
sufficiente	sˌufit͡sjˈente
possibile	posˈibile
declination	dˌeklinatjˈon
combina	kombˈina
quand	kwˈand
passive	pasˈive
realisa	rˌealˈisa
attribuite	ˌatribwˈite
transformation	trˌansformatjˈon
II	duˈo
influentia	inflwˈentja
Kansas	kˈansas
sapite	sapˈite
Blue	blwˈe
attention	ˌatentjˈon
colon	kˈolon
official	ˌofit͡sjˈal
proponeva	prˌoponˈeva
rapidemente	rˌapidemˈente
Sture	stˈure
compositores	kˌompositˈores
las	lˈas
ganiar	ɡanjˈar
minor	minˈor
Dido	dˈido
monarcha	monˈart͡ʃa
global	ɡlobˈal
periodos	perˈiodos
adultos	adˈultos
UE	wˈe
Scripturas	skriptˈuras
previe	prˈevje
Tunc	tˈunk
decision	dˌet͡sisjˈon
Ministerio	mˌinistˈerjo
Addams	adˈams
Vide	vˈide
constitueva	kˌonstitwˈeva
essential	ˌesentjˈal
or	ˈor
pelle	pˈele
goal	ɡˈol
imperial	ˌimperjˈal
Plure	plˈure
lexical	lˌeksikˈal
juridic	ʒurˈidik
hebree	hebrˈee
fortalessa	fˌortalˈesa
supervivente	sˌupervivˈente
octobre	oktˈobre
graphic	ɡrˈafik
novellas	novˈelas
demanda	demˈanda
moveva	movˈeva
anima	ˈanima
portugese	pˌortuɡˈese
pp	pˌepˈe
critica	krˈitika
intime	ˈintime
medalia	medˈalja
personalitate	pˌersonˌalitˈate
vader	vadˈer
demonstra	demˈonstra
octave	oktˈave
lo	lˈo
veniva	venˈiva
taxa	tˈaksa
Georgio	ɡeˈorɡjo
precipitation	prˌet͡sipˌitatjˈon
melio	mˈeljo
absolutemente	ˌabsolˌutemˈente
sensos	sˈensos
participate	pˌartit͡sipˈate
sequentia	sekwˈentja
en	ˈan
Stockholm	stokkhˈolm
manganese	mˌaŋɡanˈese
Actualmente	ˌaktwalmˈente
characterisa	t͡ʃˌarakterˈisa
production	prˌoduktjˈon
tenta	tˈenta
pan	pˈan
sex	sˈeks
augusto	a͡ʊɡˈusto
desira	desˈira
alcunes	alkˈunes
scandium	skˈandjum
jocos	ʒˈokos
retorno	retˈorno
pensata	pensˈata
international	ˌinternˌatjonˈal
ser	sˈer
architectura	ˌart͡ʃitektˈura
Frank	frˈaŋk
telephono	telˈefono
insula	ˈinsula
determinate	dˌeterminˈate
generate	ɡˌenerˈate
consonantes	kˌonsonˈantes
ministros	minˈistros
JSP	ʒˌotaˌespˈe
infinite	ˌinfinˈite
subgeneres	subɡˈeneres
resolvite	rˌesolvˈite
appropriate	ˌaproprjˈate
Hector	hektˈor
convention	kˌonventjˈon
capitulo	kapˈitulo
construction	kˌonstruktjˈon
activista	ˌaktivˈista
sapeva	sapˈeva
tardive	tardˈive
situationes	sˌitwatjˈones
programma	proɡrˈama
voces	vˈot͡ses
videva	vidˈeva
Cid	t͡sˈid
Nonobstante	nˌonobstˈante
linguistic	linɡwˈistik
localitate	lˌokalitˈate
ne	nˈe
Mi	mˈi
derivate	dˌerivˈate
realisation	rˌealˌisatjˈon
vocabulario	vˌokabulˈarjo
electricitate	ˌelektrˌit͡sitˈate
governamentos	ɡˌovernamˈentos
structuras	struktˈuras
definiva	dˌefinˈiva
europeos	ˌeuropˈeos
citatanos	t͡sˌitatˈanos
compara	kompˈara
Illes	ˈiles
multo	mˈulto
quartiero	kwartjˈero
Vaticano	vˌatikˈano
coperite	kˌoperˈite
acto	ˈakto
autonomia	ˌa͡ʊtonomˈia
utilisar	ˌutilisˈar
civilisation	t͡sˌivilˌisatjˈon
conspiration	kˌonspiratjˈon
internet	ˌinternˈet
essente	esˈente
museos	musˈeos
considerate	kˌonsiderˈate
pictor	piktˈor
vertical	vˌertikˈal
manteneva	mˌantenˈeva
chef	ʃˈef
Mattheo	matˈeo
deriva	derˈiva
oceanic	ˌot͡seˈanik
luctar	luktˈar
ingeniero	ˌiŋɡenjˈero
ONU	ˈonu
instantia	instˈantja
cellulas	t͡sˈelulas
Quasi	kwˈasi
horas	hˈoras
as	ˈas
Ma	mˈa
celle	t͡sˈele
sonar	sonˈar
idioma	idjˈoma
ora	ˈora
magnesium	maɡnˈesjum
successo	sut͡sˈeso
abbreviate	ˌabrevjˈate
specific	spet͡sˈifik
consiste	konsˈiste
persona	persˈona
referer	rˌeferˈer
Daniel	danjˈel
extra	ˈekstra
quantitate	kwˌantitˈate
is	ˈis
grosse	ɡrˈose
quicunque	kikˈunkwe
ya	jˈa
Federation	fˌederatjˈon
paginas	pˈaɡinas
programmatura	prˌoɡramatˈura
critic	krˈitik
central	t͡sentrˈal
provate	provˈate
introducite	ˌintrodut͡sˈite
junio	ʒˈunjo
touristic	turˈistik
conjugation	kˌonʒuɡatjˈon
processos	prot͡sˈesos
tener	tenˈer
medico	mˈediko
apparentemente	ˌaparˌentemˈente
super	sˈuper
japonese	ʒˌaponˈese
establimento	ˌestablimˈento
telephonic	tˌelefˈonik
totevia	tˌotevˈia
februario	febrwˈarjo
partiva	partˈiva
modifica	modˈifika
kalium	kˈaljum
classic	klˈasik
des	dˈes
certe	t͡sˈerte
causa	kˈa͡ʊsa
servi	sˈervi
programmatores	prˌoɡramatˈores
applicar	ˌaplikˈar
syntaxe	sintˈakse
single	sˈiŋɡle
spectro	spˈektro
infection	ˌinfektjˈon
organo	ˈorɡano
sentiva	sentˈiva
recipeva	rˌet͡sipˈeva
tamben	tambˈen
cauda	kˈa͡ʊda
lanceava	lˌant͡seˈava
fidel	fidˈel
racias	rˈat͡sjas
ergo	ˈerɡo
Lupin	lupˈin
impostos	impˈostos
durar	durˈar
psychiatria	psˌikjatrˈia
Texto	tˈeksto
offensiva	ˌofensˈiva
introduction	ˌintroduktjˈon
disveloppamento	dˌisvelˌopamˈento
violente	vjolˈente
alteremente	ˌalteremˈente
Central	t͡sentrˈal
millennio	milˈenjo
hardware	hˈardware
immigration	ˌimiɡratjˈon
discipulos	dist͡sˈipulos
evento	evˈento
sona	sˈona
explica	ˈeksplika
amante	amˈante
emergeva	ˌemerɡˈeva
signala	siɡnˈala
crescentia	krest͡sˈentja
ubi	ˈubi
Copenhagen	kˌopenhˈaɡen
septe	sˈepte
legenda	leɡˈenda
mer	mˈer
complir	komplˈir
adequate	ˌadekwˈate
nobiles	nˈobiles
sin	sˈin
Corea	korˈea
representante	rˌepresentˈante
tractate	traktˈate
orbital	ˌorbitˈal
teneva	tenˈeva
bases	bˈases
Urano	urˈano
erigite	ˌeriɡˈite
discos	dˈiskos
voluntate	vˌoluntˈate
italian	ˌitaljˈan
regite	reɡˈite
recte	rˈekte
Leonardo	lˌeonˈardo
modello	modˈelo
foras	fˈoras
adherentes	ˌadherˈentes
superior	sˌuperjˈor
sentimento	sˌentimˈento
evolveva	ˌevolvˈeva
Usualmente	ˌuswalmˈente
occasionalmente	ˌokasjˌonalmˈente
decisive	dˌet͡sisˈive
Jamblicho	ʒamblˈit͡ʃo
descende	dest͡sˈende
Madrid	madrˈid
Orleans	ˌorleˈans
listas	lˈistas
glacial	ɡlat͡sjˈal
poteva	potˈeva
fornite	fornˈite
editor	ˌeditˈor
vide	vˈide
Nationes	natjˈones
introduce	ˌintrodˈut͡se
Nuwas	nˈuwas
supervivite	sˌupervivˈite
dorso	dˈorso
scuto	skˈuto
appunctate	ˌapunktˈate
interessate	ˌinteresˈate
Neubronner	nˌe͡ʊbronˈer
vectores	vektˈores
imposto	impˈosto
supernomine	sˌupernomˈine
accentua	at͡sˈentwa
succedite	sˌut͡sedˈite
materia	matˈerja
dramas	drˈamas
vista	vˈista
Se	sˈe
credentes	kredˈentes
districtos	distrˈiktos
Qui	kˈi
Antique	antˈikwe
creator	krˌeatˈor
inseniamentos	ˌinsenjamˈentos
Nota	nˈota
Fiume	fjˈume
patas	pˈatas
festas	fˈestas
Paul	pˈa͡ʊl
pedon	pedˈon
historiographia	hˌistorjˌoɡrafˈia
arrangiate	ˌaraŋɡjˈate
habera	habˈera
irregular	ˌireɡulˈar
realmente	rˌealmˈente
Cage	kˈaɡe
nationes	natjˈones
films	fˈilms
alique	ˈalike
approximativemente	ˌaproksˌimatˌivemˈente
secretario	sˌekretˈarjo
San	sˈan
adoptar	ˌadoptˈar
Alexandria	ˌaleksˈandrja
possedeva	pˌosedˈeva
magia	maɡˈia
illegal	ˌileɡˈal
decennio	det͡sˈenjo
division	dˌivisjˈon
detalio	detˈaljo
factor	faktˈor
molecular	mˌolekulˈar
vidite	vidˈite
calculate	kˌalkulˈate
circumstantias	t͡sˌirkumstˈantjas
maximo	mˈaksimo
Textos	tˈekstos
frontieras	frontjˈeras
entrar	entrˈar
stilo	stˈilo
prohibite	prˌohibˈite
ration	ratjˈon
combinationes	kˌombinatjˈones
circular	t͡sˌirkulˈar
superviveva	sˌupervivˈeva
luna	lˈuna
alcun	ˈalkun
scripto	skrˈipto
cives	t͡sˈives
immediate	ˌimedjˈate
ethnic	ˈetnik
estraniero	ˌestranjˈero
fiction	fiktjˈon
concernente	kˌont͡sernˈente
rosate	rosˈate
phrases	frˈases
deo	ðˈeo
fornir	fornˈir
omne	ˈomne
approximatemente	ˌaproksˌimatemˈente
uni	ˈuni
imponite	ˌimponˈite
offereva	ˌoferˈeva
Con	kˈon
sembla	sˈembla
archivos	art͡ʃˈivos
designos	desˈiɡnos
greco	ɡrˈeko
Microsoft	mˌikrosˈoft
Pona	pˈona
Brongersma	broŋɡˈersma
dictionario	dˌiktjonˈarjo
Espania	espˈanja
commenciava	kˌoment͡sjˈava
instruction	ˌinstruktjˈon
invasion	ˌinvasjˈon
Henrico	henrˈiko
juxta	ʒˈuksta
usar	usˈar
physico	fˈisiko
haveva	havˈeva
Couturat	kˌouturˈat
fundatores	fˌundatˈores
Google	ɡoˈoɡle
chacos	ʃˈakos
articulation	ˌartikˌulatjˈon
rendite	rendˈite
removite	rˌemovˈite
create	kreˈate
anteriormente	ˌanterjormˈente
forsan	fˈorsan
manifesta	mˌanifˈesta
depende	depˈende
ut	ˈut
Al	ˈal
maritava	mˌaritˈava
nude	nˈude
Wikipedia	wˌikipˈedja
liberation	lˌiberatjˈon
primates	primˈates
pronomine	pronˈomine
masculin	mˌaskulˈin
picturas	piktˈuras
Europee	ˌeuropˈee
quadratos	kwadrˈatos
interpretate	ˌinterpretˈate
digital	dˌiɡitˈal
participio	pˌartit͡sˈipjo
faceva	fat͡sˈeva
variantes	varjˈantes
centimetros	t͡sentˈimetros
bon	bˈon
mais	mˈais
por	pˈor
biblic	bˈiblik
monstrava	monstrˈava
promethium	promˈetjum
realisava	rˌealisˈava
avantage	ˌavantˈaʒe
massas	mˈasas
impression	ˌimpresjˈon
formava	formˈava
subjecte	subʒˈekte
predecessor	prˌedet͡sesˈor
quitava	kwitˈava
colonisation	kˌolonˌisatjˈon
metallos	metˈalos
petra	pˈetra
futuro	futˈuro
viver	vivˈer
sur	sˈur
jalne	ʒˈalne
istes	ˈistes
fratre	frˈatre
tentativa	tˌentatˈiva
late	lˈate
Naruto	narˈuto
comenciar	kˌoment͡sjˈar
consequentia	kˌonsekwˈentja
existentia	ˌeksistˈentja
crescite	krest͡sˈite
pannello	panˈelo
Les	lˈes
brasilian	brˌasiljˈan
occidite	ˌot͡sidˈite
Vetule	vˈetule
fundamentos	fˌundamˈentos
feminas	fˈeminas
Jocos	ʒˈokos
commercio	komˈert͡sjo
exige	eksˈiɡe
sacerdote	sˌat͡serdˈote
arte	ˈarte
racemo	rat͡sˈemo
basate	basˈate
eucaryotes	ˌe͡ʊkarjˈotes
date	dˈate
extinction	ˌekstinktjˈon
foreste	forˈeste
organismos	ˌorɡanˈismos
traciar	trat͡sjˈar
internationalmente	ˌinternˌatjonalmˈente
Rock	rˈokk
alto	ˈalto
venita	venˈita
i	ˈi
adresses	adrˈeses
locos	lˈokos
eliger	ˌeliɡˈer
attinger	ˌatiŋɡˈer
fugir	fuɡˈir
compania	kˌompanˈia
forni	fˈorni
solitari	sˌolitˈari
significato	sˌiɡnifikˈato
negative	nˌeɡatˈive
Colombia	kolˈombja
parlamento	pˌarlamˈento
pedophilos	pedˈofilos
Book	boˈok
liberar	lˌiberˈar
colores	kolˈores
domestic	domˈestik
recerca	ret͡sˈerka
proposition	prˌopositjˈon
secular	sˌekulˈar
consentite	kˌonsentˈite
Occidente	ˌot͡sidˈente
demonstrava	dˌemonstrˈava
real	reˈal
material	mˌaterjˈal
scientias	st͡sjˈentjas
classe	klˈase
usator	ˌusatˈor
radiation	rˌadjatjˈon
fin	fˈin
Existe	eksˈiste
materne	matˈerne
Smith	smˈit
densitate	dˌensitˈate
village	vilˈaʒe
classificar	klˌasifikˈar
atheismo	atˈe͡ɪsmo
attachate	ˌatat͡ʃˈate
governator	ɡˌovernatˈor
inferior	ˌinferjˈor
declarationes	dˌeklaratjˈones
unite	unˈite
continental	kˌontinentˈal
muro	mˈuro
ecclesia	eklˈesja
Charles	t͡ʃˈarles
complimento	kˌomplimˈento
mares	mˈares
reformas	refˈormas
Hans	hˈans
columna	kolˈumna
destrueva	destrwˈeva
senior	senjˈor
fugiva	fuɡˈiva
observation	ˌobservatjˈon
examine	eksˈamine
passa	pˈasa
defensores	dˌefensˈores
prendeva	prendˈeva
Eduardo	edwˈardo
preste	prˈeste
identificate	ˌidentˌifikˈate
formate	formˈate
Septe	sˈepte
Carinthia	karˈintja
Die	dˈie
malgrado	malɡrˈado
rural	rurˈal
sportive	sportˈive
affin	afˈin
quarto	kwˈarto
tan	tˈan
George	ɡeˈorɡe
debattos	debˈatos
massive	masˈive
Illos	ˈilos
these	tˈese
Vasari	vasˈari
passo	pˈaso
contes	kˈontes
leve	lˈeve
roccas	rˈokas
portraits	portrˈes
impedir	ˌimpedˈir
Convention	kˌonventjˈon
representantes	rˌepresentˈantes
Nostre	nˈostre
memoria	memˈorja
India	ˈindja
Gaio	ɡˈa͡ɪo
administration	ˌadminˌistratjˈon
curte	kˈurte
infantil	ˌinfantˈil
stoppar	stopˈar
diaphragma	djafrˈaɡma
solutiones	sˌolutjˈones
representava	rˌepresentˈava
minerales	mˌinerˈales
show	ʃˈow
fungos	fˈuŋɡos
produceva	prˌodut͡sˈeva
clientes	kljˈentes
retirava	rˌetirˈava
cinquanta	t͡siŋkwˈanta
sexual	sekswˈal
currer	kurˈer
absolute	ˌabsolˈute
nemo	nˈemo
secundo	sekˈundo
controlo	kontrˈolo
technologias	tˌeknoloɡˈias
hindu	hindˈu
sablo	sˈablo
amplitude	ˌamplitˈude
definitive	dˌefinitˈive
historietta	hˌistorjˈeta
mortos	mˈortos
equipa	ekwˈipa
parlava	parlˈava
substantial	sˌubstantjˈal
extincte	ekstˈinkte
Traditionalmente	trˌaditjˌonalmˈente
Sud	sˈud
Communitate	kˌomunitˈate
organisation	ˌorɡanˌisatjˈon
disparite	dˌisparˈite
practicate	prˌaktikˈate
Ab	ˈab
accordos	akˈordos
aures	ˈawres
fluido	flˈuido
York	jˈork
deputatos	dˌeputˈatos
costume	kostˈume
Engels	eŋɡˈels
dona	dˈona
Systema	sistˈema
induction	ˌinduktjˈon
experimentos	ˌeksperimˈentos
Africa	ˈafrika
editate	ˌeditˈate
propone	propˈone
aggressive	ˌaɡresˈive
Per	pˈer
angelo	ˈanɡelo
labora	labˈora
comparate	kˌomparˈate
V	vˈe
stabile	stˈabile
episcopo	epˈiskopo
soldato	soldˈato
Lancaster	lˌankastˈer
pedemontese	pˌedemontˈese
bucca	bˈuka
rhythmo	rˈitmo
sonos	sˈonos
indefinite	ˌindefinˈite
redactor	rˌedaktˈor
Jerusalem	ʒˌerusalˈem
districto	distrˈikto
Royal	rojˈal
etymologic	ˌetimolˈoɡik
notation	nˌotatjˈon
Consequentemente	kˌonsekwˌentemˈente
armea	armˈea
reservate	rˌeservˈate
essayate	ˌesajˈate
compilate	kˌompilˈate
centro	t͡sˈentro
lentemente	lˌentemˈente
habitava	hˌabitˈava
paisage	pa͡ɪsˈaʒe
dentes	dˈentes
denomination	dˌenomˌinatjˈon
presentia	presˈentja
Gustav	ɡustˈav
cognite	kˈoɡnite
auree	a͡ʊrˈee
los	lˈos
becco	bˈeko
posta	pˈosta
occurrer	ˌokurˈer
diagramma	djaɡrˈama
communitate	kˌomunitˈate
evidente	ˌevidˈente
tribo	trˈibo
Republican	rˌepublikˈan
lector	lektˈor
equalitate	ˌekwalitˈate
House	hoˈuse
Orthodoxe	ˌortodˈokse
rito	rˈito
moriva	morˈiva
tosto	tˈosto
pariete	parjˈete
masculo	mˈaskulo
Desde	dˈesde
lor	lˈor
hereditario	hˌereditˈarjo
scopo	skˈopo
pulmonar	pˌulmonˈar
moderate	mˌoderˈate
septimanas	sˌeptimˈanas
officiero	ˌofit͡sjˈero
corporal	kˌorporˈal
mentionate	mˌentjonˈate
Julio	ʒˈuljo
summa	sˈuma
extrememente	ˌekstrememˈente
costa	kˈosta
description	dˌeskriptjˈon
una	ˈuna
bibliotheca	bˌibljotˈeka
senso	sˈenso
Illa	ˈila
evidentia	ˌevidˈentja
puncto	pˈunkto
mentiona	mentjˈona
terrestre	terˈestre
Alteres	ˈalteres
observar	ˌobservˈar
formation	fˌormatjˈon
general	ɡˌenerˈal
viage	vjˈaʒe
strategia	strˌateɡˈia
silicium	silˈit͡sjum
economia	ˌekonomˈia
multos	mˈultos
Beatles	beˈatles
armate	armˈate
variante	varjˈante
populose	pˌopulˈose
Congresso	koŋɡrˈeso
solmente	solmˈente
pilo	pˈilo
vulpes	vˈulpes
creaturas	krˌeatˈuras
specialistas	spˌet͡sjalˈistas
Turre	tˈure
permitteva	pˌermitˈeva
cantos	kˈantos
premio	prˈemjo
Tiberio	tibˈerjo
preparate	prˌeparˈate
blanco	blˈanko
conventional	kˌonventjonˈal
atomic	atˈomik
agricole	ˌaɡrikˈole
contento	kontˈento
tradition	trˌaditjˈon
tales	tˈales
vigor	viɡˈor
altere	ˈaltere
similaritates	sˌimilˌaritˈates
modo	mˈodo
studente	studˈente
obvie	ˈobvje
superficial	sˌuperfit͡sjˈal
bestial	bestjˈal
maladia	mˌaladˈia
exemplares	ˌeksemplˈares
render	rendˈer
modificationes	mˌodifˌikatjˈones
condemnate	kˌondemnˈate
scripte	skrˈipte
impacto	impˈakto
principe	print͡sˈipe
Aragon	ˌaraɡˈon
proxime	prˈoksime
granpatre	ɡranpˈatre
operator	ˌoperatˈor
accompaniate	ˌakompanjˈate
filo	fˈilo
biologic	bjolˈoɡik
Danmark	danmˈark
leger	leɡˈer
rubidium	rubˈidjum
radices	radˈit͡ses
monte	mˈonte
republican	rˌepublikˈan
Paris	parˈis
lassate	lasˈate
Guerra	ɡwˈera
mostra	mˈostra
cognoscite	kˌoɡnost͡sˈite
germanium	ɡermˈanjum
radical	rˌadikˈal
selectionate	sˌelektjonˈate
vulgar	vulɡˈar
acidos	ˈat͡sidos
acquirite	ˌakkwirˈite
opera	ˈopera
retornar	rˌetornˈar
Xenophon	ksˌenofˈon
mundo	mˈundo
Arte	ˈarte
distinction	dˌistinktjˈon
biographias	bjˌoɡrafˈias
Bison	bisˈon
prefixate	prˌefiksˈate
Universal	ˌuniversˈal
italiano	ˌitaljˈano
experimentava	ˌeksperˌimentˈava
ambiental	ˌambjentˈal
etate	etˈate
abuso	abˈuso
Elizabeth	ˌelizabˈet
particularmente	pˌartikˌularmˈente
formal	formˈal
plagias	plˈaʒas
niobium	niˈobjum
mercato	merkˈato
substituite	sˌubstitwˈite
nota	nˈota
participava	pˌartit͡sipˈava
General	ɡˌenerˈal
editores	ˌeditˈores
tempore	tˈempore
celo	t͡sˈelo
decennios	det͡sˈenjos
sperantia	sperˈantja
gallium	ɡˈaljum
durante	durˈante
tribos	trˈibos
base	bˈase
fontes	fˈontes
confrontar	kˌonfrontˈar
renascentia	rˌenast͡sˈentja
pipiones	pipjˈones
characteristicas	kˌarakterˈistikas
policia	pˌolit͡sˈia
signava	siɡnˈava
Jehovah	ʒehˈovah
potentia	potˈentja
fabricate	fˌabrikˈate
scribe	skrˈibe
votos	vˈotos
par	pˈar
nascite	nast͡sˈite
Finalmente	fˌinalmˈente
morte	mˈorte
referendum	rˌeferˈendum
Aphrodite	ˌafrodˈite
ben	bˈen
Invariabile	ˌinvarjˈabile
quasi	kwˈasi
signal	siɡnˈal
informal	ˌinformˈal
includente	ˌinkludˈente
supertoto	sˌupertˈoto
initiate	ˌinitjˈate
urbe	ˈurbe
devenite	dˌevenˈite
PIE	pjˈe
Concilio	kont͡sˈiljo
utilisation	ˌutilˌisatjˈon
archeologic	ˌarkeolˈoɡik
Peano	peˈano
sanitari	sˌanitˈari
vengiantia	venʒˈantja
addition	ˌaditjˈon
Valle	vˈale
litoral	lˌitorˈal
New	nˈiw
phenomeno	fenˈomeno
interpretation	ˌinterprˌetatjˈon
calefaction	kˌalefaktjˈon
pressa	prˈesa
fama	fˈama
fortemente	fˌortemˈente
duple	dˈuple
administrator	ˌadminˌistratˈor
Menelao	mˌenelˈao
condition	kˌonditjˈon
usual	uswˈal
technologic	tˌeknolˈoɡik
trans	trˈans
theatro	teˈatro
supporta	supˈorta
ubique	ubˈikwe
obscuritate	ˌobskuritˈate
nocte	nˈokte
energic	enˈerɡik
anterior	ˌanterjˈor
International	ˌinternˌatjonˈal
veritate	vˌeritˈate
cantatores	kˌantatˈores
appartamento	ˌapartamˈento
divideva	dˌividˈeva
franc	frˈank
inter	ˈinter
Schola	st͡ʃˈola
Las	lˈas
actiones	aktjˈones
Claudio	klˈa͡ʊdjo
mental	mentˈal
pueros	pˈueros
independente	ˌindependˈente
norma	nˈorma
comprendeva	kˌomprendˈeva
mense	mˈense
justo	ʒˈusto
venite	venˈite
devenir	dˌevenˈir
intervention	ˌinterventjˈon
defende	defˈende
autores	a͡ʊtˈores
sector	sektˈor
XX	vˈinti
mythologic	mˌitolˈoɡik
photos	fˈotos
distinguer	dˌistiŋɡwˈer
canta	kˈanta
vole	vˈole
immense	imˈense
equipas	ekwˈipas
gestion	ɡestjˈon
rapide	rˈapide
servitores	sˌervitˈores
scientista	st͡sjentˈista
anatomic	ˌanatˈomik
location	lˌokatjˈon
travalios	travˈaljos
connexe	konˈekse
adjutava	ˌadʒutˈava
contributiones	kˌontributjˈones
possede	posˈede
lupo	lˈupo
damno	dˈamno
vulpe	vˈulpe
diabete	djabˈete
posto	pˈosto
veniente	venjˈente
interprisa	ˌinterprˈisa
alcuno	alkˈuno
primo	prˈimo
indicante	ˌindikˈante
resurrection	rˌesurektjˈon
va	vˈa
cordes	kˈordes
centos	t͡sˈentos
Sin	sˈin
testamento	tˌestamˈento
russo	rˈuso
habe	hˈabe
quanto	kwˈanto
grano	ɡrˈano
Libere	lˈibere
rete	rˈete
menacia	menˈat͡sja
pais	pˈa͡ɪs
Sede	sˈede
Singapur	sˌiŋɡapˈur
dependente	dˌependˈente
explicava	ˌeksplikˈava
cadeva	kadˈeva
School	st͡ʃoˈol
romance	romˈant͡se
Israel	ˌisraˈel
rotation	rˌotatjˈon
C	sˈe
implementation	ˌimplemˌentatjˈon
Centro	t͡sˈentro
dextra	dˈekstra
lectiones	lektjˈones
homine	hˈomine
medio	mˈedjo
monstrar	monstrˈar
scientia	st͡sjˈentja
da	dˈa
importante	ˌimportˈante
descendentia	dˌest͡sendˈentja
cerca	t͡sˈerka
toto	tˈoto
Ecclesia	eklˈesja
grande	ɡrˈande
territorio	tˌeritˈorjo
traduceva	trˌadut͡sˈeva
hierarchia	hjˌerarkˈia
relationate	rˌelatjonˈate
conservation	kˌonservatjˈon
Lord	lˈord
falleva	falˈeva
Ci	t͡sˈi
practica	prˈaktika
religiose	rˌeliɡjˈose
apparite	ˌaparˈite
Jacobo	ʒˈakobo
nonobstante	nˌonobstˈante
cercava	t͡serkˈava
necessitates	nˌet͡sesitˈates
apportate	ˌaportˈate
copias	kˈopjas
ca	kˈa
revolutiones	rˌevolutjˈones
consistente	kˌonsistˈente
transverso	transvˈerso
pensava	pensˈava
publicitate	pˌublit͡sitˈate
fictional	fˌiktjonˈal
classifica	klasˈifika
ave	ˈave
postea	postˈea
characteres	t͡ʃˌaraktˈeres
lectura	lektˈura
probabilemente	prˌobabˌilemˈente
momento	momˈento
resultatos	rˌesultˈatos
pete	pˈete
Iste	ˈiste
infectate	ˌinfektˈate
pederastia	pˌederastˈia
francese	frant͡sˈese
compositos	kompˈositos
cavallos	kavˈalos
brasilianos	brˌasiljˈanos
cambios	kˈambjos
Germania	ɡermˈanja
celtic	t͡sˈeltik
experientia	ˌeksperjˈentja
disveloppar	dˌisvelopˈar
serviva	servˈiva
attingeva	ˌatiŋɡˈeva
analyse	anˈalise
Alcunes	alkˈunes
centra	t͡sˈentra
crea	krˈea
relievo	reljˈevo
addite	adˈite
reducite	rˌedut͡sˈite
schema	st͡ʃˈema
Montreal	mˌontreˈal
precio	prˈet͡sjo
El	ˈel
ordinava	ˌordinˈava
remover	rˌemovˈer
representation	rˌepresˌentatjˈon
stadio	stˈadjo
divin	divˈin
contineva	kˌontinˈeva
detra	dˈetra
suffice	sufˈit͡se
public	pˈublik
frequentias	frekwˈentjas
intendeva	ˌintendˈeva
subjectos	subʒˈektos
VIH	vˈih
legislation	lˌeɡislatjˈon
apportava	ˌaportˈava
pertineva	pˌertinˈeva
rege	rˈeɡe
orthographia	ˌortoɡrafˈia
valide	vˈalide
stationes	statjˈones
Compania	kˌompanˈia
human	humˈan
reteneva	rˌetenˈeva
laboratorio	lˌaboratˈorjo
esperantistas	ˌesperantˈistas
spatial	spatjˈal
essayava	ˌesajˈava
consonante	kˌonsonˈante
inscription	ˌinskriptjˈon
commando	komˈando
derivation	dˌerivatjˈon
plure	plˈure
censo	t͡sˈenso
clave	klˈave
occupava	ˌokupˈava
documento	dˌokumˈento
ancestre	ant͡sˈestre
alliantia	aljˈantja
accento	at͡sˈento
intelligente	ˌinteliɡˈente
connexiones	kˌoneksjˈones
menaciate	mˌenat͡sjˈate
organismo	ˌorɡanˈismo
costo	kˈosto
introduceva	ˌintrodut͡sˈeva
apte	ˈapte
gruppos	ɡrˈupos
narra	nˈara
calor	kalˈor
domesticate	dˌomestikˈate
Grecia	ɡrˈet͡sja
familiar	fˌamiljˈar
directiones	dˌirektjˈones
Lisbona	lisbˈona
les	lˈes
modificate	mˌodifikˈate
interpreta	ˌinterprˈeta
harmonia	hˌarmonˈia
gloria	ɡlˈorja
societate	sˌot͡sjetˈate
dramatic	dramˈatik
transmitter	trˌansmitˈer
initiativa	ˌinitjatˈiva
finir	finˈir
amonta	amˈonta
enorme	enˈorme
sitos	sˈitos
separatemente	sˌeparˌatemˈente
contrasto	kontrˈasto
rock	rˈokk
specialisate	spˌet͡sjalisˈate
Ultra	ˈultra
conscientia	konst͡sjˈentja
cumulo	kˈumulo
I	ˈi
appello	apˈelo
opposite	opˈosite
campo	kˈampo
Certe	t͡sˈerte
Academia	ˌakademˈia
aves	ˈaves
Philippo	filˈipo
ligate	liɡˈate
Madagascar	mˌadaɡaskˈar
incontro	inkˈontro
infantes	infˈantes
successos	sut͡sˈesos
marito	marˈito
Corporation	kˌorporatjˈon
magazin	mˌaɡazˈin
offere	ofˈere
Martijn	martˈiʒn
partialmente	pˌartjalmˈente
seta	sˈeta
intra	ˈintra
Vita	vˈita
concrete	konkrˈete
punk	pˈuŋk
Italia	itˈalja
multiple	mˈultiple
nulle	nˈule
civil	t͡sivˈil
parentheses	parˈenteses
Java	ʒˈava
spirito	spˈirito
fabula	fˈabula
vicin	vit͡sˈin
car	kˈar
strata	strˈata
debatto	debˈato
nederlandese	nˌederlandˈese
no	nˈo
como	kˈomo
prophetia	prˌofetˈia
largor	larɡˈor
perception	pˌert͡septjˈon
forrage	forˈaʒe
election	ˌelektjˈon
nova	nˈova
litteralmente	lˌiteralmˈente
surgeva	surɡˈeva
tractamentos	trˌaktamˈentos
fila	fˈila
disveloppamentos	dˌisvelˌopamˈentos
lacos	lˈakos
catholic	katˈolik
significava	sˌiɡnifikˈava
filmes	fˈilmes
functiona	funktjˈona
assassinato	ˌasasinˈato
Albert	albˈert
successor	sˌut͡sesˈor
mortal	mortˈal
categoria	kˌateɡorˈia
Dublin	dublˈin
Tres	trˈes
momentos	momˈentos
Jean	ʒeˈan
exterior	ˌeksterjˈor
requireva	rˌekwirˈeva
Societate	sˌot͡sjetˈate
function	funktjˈon
monachos	mˈonakos
marca	mˈarka
parallel	pˌaralˈel
definition	dˌefinitjˈon
Hall	hˈol
facilitates	fˌat͡silitˈates
pede	pˈede
incorrecte	ˌinkorˈekte
rapiditate	rˌapiditˈate
addeva	adˈeva
precise	pret͡sˈise
parentes	parˈentes
traductores	trˌaduktˈores
elemento	ˌelemˈento
complete	komplˈete
Atlantic	atlˈantik
essayo	esˈajo
usque	ˈuske
divisiones	dˌivisjˈones
scopos	skˈopos
mar	mˈar
cambio	kˈambjo
usatores	ˌusatˈores
destruite	destrwˈite
Daejeon	dˌaeʒeˈon
anatomia	ˌanatomˈia
parlatores	pˌarlatˈores
conclusion	kˌonklusjˈon
duration	dˌuratjˈon
IV	kwˈatro
donava	donˈava
symptomas	simptˈomas
sectiones	sektjˈones
acquisition	ˌakkwisitjˈon
Helena	hˈelena
peste	pˈeste
liberemente	lˌiberemˈente
Normalmente	nˌormalmˈente
proveniente	prˌovenjˈente
exactemente	ˌeksaktemˈente
communion	kˌomunjˈon
vision	visjˈon
appellava	ˌapelˈava
debite	dˈebite
decidite	dˌet͡sidˈite
unification	ˌunifˌikatjˈon
evitar	ˌevitˈar
defia	defˈia
desde	dˈesde
frigide	frˈiɡide
erronee	ˌeronˈee
Dunque	dˈuŋkwe
positive	pˌositˈive
converter	kˌonvertˈer
debe	dˈebe
Language	laŋɡwˈaɡe
cooperation	kˌoopˌeratjˈon
ancestres	ant͡sˈestres
Alicun	ˈalikun
Licentia	lit͡sˈentja
King	kˈiŋɡ
X	ˈiks
Cata	kˈata
licentia	lit͡sˈentja
svedese	svedˈese
obstante	obstˈante
rattos	rˈatos
William	wiljˈam
statistica	statˈistika
recognoscer	rˌekoɡnost͡sˈer
dextre	dˈekstre
varia	vˈarja
passato	pasˈato
decades	dˈekades
historico	histˈoriko
melior	meljˈor
Occidental	ˌot͡sidentˈal
martio	mˈartjo
transmission	trˌansmisjˈon
denominate	dˌenominˈate
vetule	vˈetule
quante	kwˈante
fiasco	fjˈasko
Brian	brjˈan
institution	ˌinstitutjˈon
li	lˈi
representate	rˌepresentˈate
favorite	fˌavorˈite
occupation	ˌokupatjˈon
autor	a͡ʊtˈor
vocabulo	vokˈabulo
ethica	ˈetika
attaccos	atˈakos
victima	vˈiktima
appella	apˈela
jazz	d͡ʒˈez
capacitate	kˌapat͡sitˈate
aragonese	ˌaraɡonˈese
byzantin	bˌizantˈin
electe	elˈekte
canales	kanˈales
colpos	kˈolpos
surprisa	surprˈisa
Io	ˈio
dynastia	dˌinastˈia
preda	prˈeda
contra	kˈontra
formato	formˈato
lontan	lontˈan
qui	kˈi
Aves	ˈaves
Pais	pˈa͡ɪs
categorias	kˌateɡorˈias
caso	kˈaso
quinte	kwˈinte
Corte	kˈorte
accesso	at͡sˈeso
presidentia	prˌesidˈentja
romanos	romˈanos
ultra	ˈultra
crise	krˈise
star	stˈar
Equalmente	ˌekwalmˈente
sede	sˈede
duo	dˈuo
gases	ɡˈases
academia	ˌakademˈia
Pythagoras	pitˈaɡoras
participa	pˌartit͡sˈipa
gran	ɡrˈan
christian	kristjˈan
ISO	ˈiso
facilemente	fˌat͡silemˈente
planeta	planˈeta
possibilitates	pˌosibˌilitˈates
novella	novˈela
dirigente	dˌiriɡˈente
selenium	selˈenjum
The	tˈe
retirate	rˌetirˈate
compilation	kˌompilatjˈon
Jones	ʒˈones
immigrantes	ˌimiɡrˈantes
micre	mˈikre
Uno	ˈuno
sempre	sˈempre
originalmente	ˌoriɡˌinalmˈente
Saturno	satˈurno
mobile	mˈobile
coxa	kˈoksa
pseudonymo	psˌeudˈonimo
voluntari	vˌoluntˈari
Johann	ʒohˈan
focar	fokˈar
monstrate	monstrˈate
columnas	kolˈumnas
liberate	lˌiberˈate
lassante	lasˈante
assume	asˈume
apertura	ˌapertˈura
Constitution	kˌonstitutjˈon
arriva	arˈiva
humor	humˈor
stabilitate	stˌabilitˈate
chronic	krˈonik
Debite	dˈebite
eventualmente	ˌeventwalmˈente
risco	rˈisko
claudite	kla͡ʊdˈite
creava	kreˈava
conta	kˈonta
branca	brˈanka
exister	ˌeksistˈer
appellar	ˌapelˈar
Utah	utˈah
fame	fˈame
tolerantia	tˌolerˈantja
pronomines	pronˈomines
ordinate	ˌordinˈate
galaxias	ɡalˈaksjas
terminate	tˌerminˈate
financiari	fˌinant͡sjˈari
Association	ˌasot͡sjatjˈon
Si	sˈi
succedeva	sˌut͡sedˈeva
culpa	kˈulpa
proximitate	prˌoksimitˈate
Edward	edwˈard
poemas	poˈemas
ronde	rˈonde
occasion	ˌokasjˈon
orchestra	ort͡ʃˈestra
corona	korˈona
dies	dˈies
data	dˈata
Niagara	ŋjˈaɡara
militar	mˌilitˈar
intendite	ˌintendˈite
felicitate	fˌelit͡sitˈate
ad	ˈad
rumine	rˈumine
longitude	lˌoŋɡitˈude
invariabile	ˌinvarjˈabile
cessava	t͡sesˈava
augmenta	a͡ʊɡmˈenta
station	statjˈon
numero	nˈumero
distinctive	dˌistinktˈive
Historias	histˈorjas
que	kˈe
manual	manwˈal
krypton	krˈipton
rationes	ratjˈones
decisiones	dˌet͡sisjˈones
difficile	difˈit͡sile
dignitate	dˌiɡnitˈate
hora	hˈora
criterio	kritˈerjo
viagiar	vjaʒˈar
travaliava	trˌavaljˈava
oceano	ot͡sˈeano
Piro	pˈiro
traductor	trˌaduktˈor
Esque	ˈeske
haber	habˈer
auxiliar	ˌa͡ʊksiljˈar
quando	kwˈando
multe	mˈulte
banda	bˈanda
Troia	θrˈoja
academic	ˌakadˈemik
Antonio	antˈonjo
Giovanni	ɡjovˈani
accentuate	ˌat͡sentwˈate
certo	t͡sˈerto
medios	mˈedjos
intentiones	ˌintentjˈones
fructos	frˈuktos
Quanto	kwˈanto
mover	movˈer
dubita	dˈubita
prole	prˈole
derivar	dˌerivˈar
limitate	lˌimitˈate
Re	rˈe
schemas	st͡ʃˈemas
iva	ˈiva
separa	sepˈara
electric	elˈektrik
dice	dˈit͡se
match	mˈat͡ʃ
cultura	kultˈura
ministerio	mˌinistˈerjo
Angeles	aŋɡˈeles
bonasus	bonˈasus
plana	plˈana
comprension	kˌomprensjˈon
communitates	kˌomunitˈates
transgenere	trˌansɡenˈere
simultaneemente	sˌimultˌaneemˈente
mathematic	mˌatemˈatik
trenta	trˈenta
manifestation	mˌanifˌestatjˈon
portrait	portrˈe
chinese	ʃinˈese
Roma	rˈoma
Prime	prˈime
episodios	ˌepisˈodjos
discoperi	dˌiskopˈeri
modification	mˌodifˌikatjˈon
controlate	kˌontrolˈate
projecto	proʒˈekto
primavera	prˌimavˈera
comocunque	kˌomokˈuŋkwe
version	versjˈon
a	ˈa
gamba	ɡˈamba
adder	adˈer
retorna	retˈorna
seculos	sˈekulos
regularmente	rˌeɡularmˈente
trovar	trovˈar
vitas	vˈitas
protection	prˌotektjˈon
grandemente	ɡrˌandemˈente
IP	ˈip
minas	mˈinas
propriemente	prˌoprjemˈente
characterisate	t͡ʃˌaraktˌerisˈate
segmentos	seɡmˈentos
normal	normˈal
maladias	mˌaladˈias
utile	ˈutile
catalogo	katˈaloɡo
aun	ˈa͡ʊn
hospites	hˈospites
imponeva	ˌimponˈeva
intersection	ˌintersektjˈon
Proque	prokˈe
promoveva	prˌomovˈeva
inventate	ˌinventˈate
manuscripto	mˌanuskrˈipto
Istes	ˈistes
hodie	hˈodje
supernatural	sˌupernˌaturˈal
decide	det͡sˈide
humano	humˈano
cercar	t͡serkˈar
bobina	bobˈina
bracio	brˈat͡sjo
selection	sˌelektjˈon
visual	viswˈal
crescimento	krˌest͡simˈento
chordas	t͡ʃˈordas
objectivos	ˌobʒektˈivos
pms	pˌeˌemˈes
Magne	mˈaɡne
templo	tˈemplo
kitsune	kitsˈune
representa	rˌepresˈenta
parlantes	parlˈantes
declino	deklˈino
crescente	krest͡sˈente
Duvert	duvˈert
productivitate	prˌoduktˌivitˈate
Luna	lˈuna
Alteremente	ˌalteremˈente
celebrava	t͡sˌelebrˈava
problema	problˈema
prece	prˈet͡se
Revolution	rˌevolutjˈon
sue	sˈue
symbolic	simbˈolik
cresce	krˈest͡se
german	ɡermˈan
Auro	ˈa͡ʊro
annos	ˈanos
designar	dˌesiɡnˈar
gamma	ɡˈama
facile	fˈat͡sile
gay	ɡˈaj
troian	tro͡ɪˈan
Ora	ˈora
monetari	mˌonetˈari
numerose	nˌumerˈose
reception	rˌet͡septjˈon
Newton	ŋˈewton
atomos	ˈatomos
carne	kˈarne
indica	ˈindika
brevemente	brˌevemˈente
executive	ˌeksekutˈive
regulas	rˈeɡulas
debeva	debˈeva
insulas	ˈinsulas
mythic	mˈitik
vicinos	vit͡sˈinos
Star	stˈar
insulina	ˌinsulˈina
Pedro	pˈedro
ministro	minˈistro
assalto	asˈalto
vocal	vokˈal
populationes	pˌopulatjˈones
tracta	trˈakta
germanic	ɡermˈanik
re	rˈe
parola	parˈola
soror	sorˈor
securitate	sˌekuritˈate
Bibliotheca	bˌibljotˈeka
dirige	dirˈiɡe
traduction	trˌaduktjˈon
homosexualitate	hˌomosˌekswalitˈate
patria	pˈatrja
traducer	trˌadut͡sˈer
objecto	obʒˈekto
titulo	tˈitulo
jocatores	ʒˌokatˈores
nubes	nˈubes
portion	portjˈon
technologia	tˌeknoloɡˈia
instrumentos	ˌinstrumˈentos
industrias	indˈustrjas
pedes	pˈedes
velocitates	vˌelot͡sitˈates
su	sˈu
facilita	fˌat͡silˈita
lithium	lˈitjum
includer	ˌinkludˈer
incorpora	ˌinkorpˈora
Sparta	spˈarta
modificar	mˌodifikˈar
matur	matˈur
mata	mˈata
explicite	eksplˈit͡site
comprar	komprˈar
governamento	ɡˌovernamˈento
visitar	vˌisitˈar
statuas	stˈatwas
citate	t͡sitˈate
pauc	pˈawk
quantic	kwˈantik
dominava	dˌominˈava
processo	prot͡sˈeso
disordine	disˈordine
Tom	tˈom
gruppo	ɡrˈupo
presentate	prˌesentˈate
web	wˈeb
medietate	mˌedjetˈate
communismo	kˌomunˈismo
Ben	bˈen
battalias	batˈaljas
