អាង	ʔaaŋ
ម្យ៉ាង	myaaŋ
យឺត	yɨɨt
ពេលល្ងាច	peellŋiec
ផ្ទេរ	ptee
ករណី	kaʔraʔnəy
អាហ្នឹង	ʔaanɨŋ
ចុកពោះ	cokpʊəh
ក្មេង	kmeeŋ
ក្រញូវ	krɑɲəv
ស្មាតហ្វូន	smaatfoun
ឡាវ	laav
ចែក	caek
ឬ	rɨɨ
កាក់	kak
តេឡេ	teelee
ខាង	kʰaaŋ
តាំងពី	taŋpii
ថ្មើរជើង	tmaəcəəŋ
បុព្វការី	boppeaʔkaarəy
ចូលហ៊ុន	coulhun
ចំណីអាហារ	cɑmnəyʔaahaa
អឺអើ	ʔəɨʔaə
អឹម	ʔəm
ដំឡើង	dɑmlaəŋ
ស្មា	smaa
ដូចជា	douccie
ចុះបើ	cohbaə
រក្សា	reaksaa
ប្រូតេអ៊ីន	prouteeʔiin
លើក	lǝǝk
ទោស	tooh
ព្រុស	pruh
ពោត	poot
អ៎	ʔɑɑ
អ្វីមួយ	ʔvǝymuǝy
សរសេរ	sɑɑsee
កំប្លេ	kɑmplee
កប៉ាល់	kaʔpal
ចាក់សោរក	caksaorɔɔk
បន្ទាប់មក	bɑntoapmɔɔk
ផ្លូវទឹក	pləvtɨk
ត្រួត	truət
ចុក	cok
បួង	buəŋ
សម្រេចចិត្ត	sɑmraccət
បូរ៉ា	bouraa
ហាត់	hat
ងូតទឹក	ŋuuttɨk
រៀបរយ	riəprɔɔy
រលាយ	rɔliey
រៀន	riən
កូកា	koukaa
ចូលលុយគ្នា	coulluyknie
សំយុង	sɑmyoŋ
ប៉ែក	paek
រាយប៉ាយ	rieypaay
ហក់	hɑk
កណ្ណិកា	kɑnəkaa
ការ	kaa
ក្បាលជង្គង់	kbaalcʊəŋkʊəŋ
បុណ្យទាន	bontien
បងប្រុស	bɑɑŋproh
ស័ក្ដិសិទ្ធិ	saksət
កៀប	kiəp
ហ៊ើយ	hǝǝy
បឹង	bəŋ
ត្រង់ណា	trɑŋnaa
កម្ពុជាក្រោម	kampuʔciekraom
ខ្មោច	kmaoc
សិង	səŋ
ស្រក	srɑɑk
ដាំ	dam
ដុសធ្មេញ	dohtmɨɲ
យ៉ាប់	yap
ចម្រៀង	cɑmriəŋ
កម្រ	kɑmrɑɑ
ស្ករ	skɑɑ
ដាក់គ្នា	dakknie
រីផត	riipʰɑɑt
តួ	tuə
ណា	naa
សាល	saal
រូបគំនូរ	ruupkumnuu
ចិត្តល្អ	cətlʔɑɑ
អាវយឺត	ʔaavyɨɨt
ជនបរទេស	cɔɔnbɑɑrəteeh
ប៉ុណ្ណឹង	ponnəŋ
វត្តភ្នំ	voatpnum
មធ្យម	matyum,meaʔtyum
កាត់បន្ថយ	katbɑntʰɑɑy
ទំនេរ	tumnee
សុខទុក្ខ	soktuk
ឆាប់	cʰap
រាត្រី	rietrəy
ច្រូតស្រូវ	croutsrǝv
ម៉ាឃីតធីង	maakʰiitʰiiŋ
វៀល	viəl
ពងក្រពើ	pɔɔŋkrɑpəə
សម្ភារៈ	sɑmpʰiereaʔ
គ្រង	krɔɔŋ
កួច	kuəc
អូតែល	ʔoutael
ឈឺពោះ	cʰɨɨpʊəh
តាក់ស៊ី	taksii
ស្រោមជើង	sraomcəəŋ
ញី	ɲii
ថាឲ្យ	tʰaaʔaoy
ទីទៃ	tiitey
ខ	kʰɑɑ
ច្រៀង	crieŋ
ទាក់ទង	teaktɔɔŋ
ផ្សាររាត្រី	psaarietrəy
គ្រប់កន្លែង	krupkɑnlaeŋ
ជូត	cuut
ផ្ទុយ	ptuy
ស្វាគមន៍	svaakum
ដូនតា	dountaa
ប្រសក	prɑsɑk
វិចិត្រ	viʔcət
ទទួលយក	tɔtuəlyɔɔk
ប្រល័យ	prɑlay
អត់កើត	ʔɑtkaət
ទុយោ	tuyoo
អាទិត្យ	ʔaatɨt
យោក	yook
ជាមួយគ្នា	ciemuəyknie
អត់អីអេ	ʔɑtʔəyʔee
ដែក	daek
ពីព្រោះ	piiprʊəh
ប៉ា	paa
រ៉ូប៊ីនេទឹក	roubiineetɨk
សារជាតិ	saaraʔciet
ពូត	puut
ដំណើរ	dɑmnaə
បង	bɑɑŋ
សុខចិត្ត	sokcət
ការងារ	kaaŋie
តា	taa
ភាគី	pʰiekii
រងើកភ្លើង	rɔŋəəkpləəŋ
អ៊ីម៉ែល	ʔiimael
អាស៊ី	ʔaazii
ធម្មតា	tʰoammeaʔtaa
ទូន្មាន	tuulmien,tuunmien
ម្យ៉ាងវិញទៀត	myaaŋvɨɲtiət
ប្រាក់រាយ	prakriey
ធ្មឹង	tmɨŋ
បន្ទប់ទឹក	bɑntuptɨk
ដេញដោល	dəɲdaol
ទីរួមខេត្ត	tiiruəmkʰaet
ខារ៉ាអូខេ	kʰaaraaʔoukʰee
ជាយក្រុង	cieykroŋ
ក្រូច	krouc
ស្លាដក់	slaadɑk
សង្ឃឹម	sɑŋkʰɨm
ហូយ	houy
ក្រាល	kraal
កាហ្វេ	kaafee
ភ្លែត	plɛɛt
ម្សៅ	msav
បក	bɑɑk
ស្ដីបន្ទោស	sdǝybɑntooh
ទឹករលក	tɨkrɔlɔɔk
រថយន្តក្រុង	rʊətyʊənkroŋ
សល់	sɑl
ពោរ	pou
ពិត	pɨt
ហាងកាហ្វេ	haaŋkaafee
ខគោ	kʰɑɑkoo
ចាប់ជាតិ	capciet
បង្ហោះ	bɑŋhɑh
កើប	kaəp
អាវសាច់ក្រណាត់	ʔaavsackrɑnat
ជញ្ជូន	cʊəɲcuun
ជិតស្និទ្ធ	cɨtsnǝt
ឆ្លងកាត់	clɑɑŋkat
អ្នកធ្វើការ	neaktvəəkaa
តោង	taoŋ
ស្ដាំ	sdam
ធីតា	tʰiidaa
ផលិត	pʰɑlɨt,pʰɑlət
ហើរ	haǝ
គំនិត	kumnɨt
ទង្វើ	tʊəŋvəə
អត់ទាន់	ʔɑttoan
ជ្រុល	crul
ជម្រើស	cumrəəh
ឧស្ម័ន	ʔusman
ព	pɔɔ
នៀក	niək
ស្រមោល	srɑmaol
ផ្សារ	psaa
ធៀបការ	tʰiəpkaa
ចូលគ្នា	coulknie
ឆុង	cʰoŋ
ដើមឈើ	daəmcʰəə
អត្ថន័យ	ʔattʰaʔney
ញឹក	ɲɨk
បាយដំណើបសំខ្យា	baaydɑmnaəpsɑŋkyaa
អគ្គិសនី	ʔakkihsaʔnii
បន្លឺ	bɑnlɨɨ,bɑnləɨ
បែក	baek
ទូកក្ដោង	tuukkdaoŋ
ចាប់ហួយ	caphuəy
ជីវី	ciivii
ប្រជ្រៀត	prɑcriet
រូបមន្ត	ruupmʊən
គុណ	kun
ទឹកស៊ីអ៊ីវ	tɨksiiʔiiv
រង្វាស់រង្វាល់	rʊəŋvoahrʊəŋvoal
ដោយឡែក	daoylaek
ស្រក់	srɑk
ប្រចាំ	prɑcam
ពុល	pul
ទៀន	tien
ទាយ	tiey
ទ្រព្យសម្បត្តិ	troapsɑmbat
អស់សាំង	ʔɑhsaŋ
សប្បាយ	sapbaay
ទាំងមូល	teaŋmuul
ពេលថ្ងៃ	peeltŋay
ក្បាល	kbaal
ផ្អាប់ទុក	pʔaptuk
ជនជាតិ	cɔɔnciet
បន្ទាប់ពី	bɑntoappii
កុមារី	koʔmaarəy
ជាច្រើន	ciecraən
ទើប	təəp
ពិតប្រាកដ	pɨtpraakɑɑt
សេរេ	seeree
កំណត់	kɑmnɑt
ម្លប់	mlup
មីង	miiŋ
ហូរ	hou
ភាគច្រើន	pʰiekcraən
បែកអេក	baekʔeek
កូកាកូឡា	koukaakoulaa
ផ្សង	psɑɑŋ
នាឡិកា	nieleʔkaa
ហាល	haal
ផ្លិតទឹក	pləttɨk
ឥត	ʔət
បញ្ញើ	bɑɲɲaə
ភាព	pʰiep
ផ្លូវលំ	pləvlum
ចោល	caol
ដំបូល	dɑmboul
លៀន	liǝn
រីឯ	riiʔae
ឡានក្រុង	laankroŋ
គ្រលុក	krɔluk
ជាមួយនឹង	ciemuəynɨŋ
រាងកាយ	rieŋkaay
ត្រជាក់	trɑceak
ពោល	pool
កាន់	kan
ទែម៉ូម៉ែត្រ	tɛɛmoumaet
អូស្ត្រាលី	ʔoostraalii
នឹងគ្នា	nɨŋknie
មេឃ	meek
សម្ដែង	sɑmdaəŋ
ទ្រនិច	trɔnɨc
អត់	ʔɑt
ទឹកទន្លេ	tɨktʊənlee
ឈឺក្បាល	cʰɨɨkbaal
ប្រហើរ	prɑhaə
ស្បែកជើងប៊ូ	sbaekcǝǝŋpuu
ពាសវាលពាសកាល	piehvielpiehkaal
ដាក់ពាក្យ	dakpiek
ដាក់តាំង	daktaŋ
សូន្យ	soun
ផ្ដេសផ្ដាស	pdeehpdaah
សំដី	sɑmdəy
ថ្នាំសន្លប់	tnamsɑnlɑp
ក្បាលរ៉ូប៊ីនេទឹក	kbaalroubiineetɨk
ម៉ូតូ	moutou
តម្លៃ	tɑmlay
ប្រភេទ	prɑpʰeet
កម្រាលឥដ្ឋ	kɑmraalʔǝt
សៀមរាប	siǝmriep
កូនប្រុស	kounproh
អ៊ុត	ʔut
បុប្ផា	boppʰaa
ចំណោទ	cɑmnaot
ភាន់ច្រឡំ	pʰoancrɑlɑm
ហ្គាស	geah
កៅឆាយ	kavcʰaay
ត្រូវអំពើ	trəvʔɑmpəə
ស៊ប់	sup
សំបុក	sɑmbok
ចំពីមុខ	cɑmpiimuk
ជណ្ដើរយន្ត	cʊəndaəyʊən
រង់ចាំ	rʊəŋcam,rɔɔŋcam
បណ្ដាលឲ្យ	bɑndaalʔaoy
ជ្រកម្លប់	crɔɔkmlup
ព្រី	prii
របៀប	rɔbiəp
បង្ក	bɑŋkɑɑ
ហែលទឹក	haeltɨk
ទ្រាប់	troap
ដោះសោ	dɑhsao
កោង	kaoŋ
ង៉ៃក្រោយ	ŋaykraoy
កន្លែង	kɑnlaeŋ
ដឹកទំនិញ	dəktumnɨɲ
ព្រះមហាក្សត្រ	preahmɔhaaksat
ប្ដឹង	pdəŋ
លា	lie
ចង្អៀត	cɑŋʔiət
ភ្នែក	pnɛɛk
ហាត់ប្រាណ	hatpraan
ទូកចែវ	tuukcaev
បញ្ឈរជង្គង់	bɑɲcʰɔɔcʊəŋkʊəŋ
តូប	toup
ស្តុប	stop
តែពីសតែពាស	taepiihtaepieh
ឆ្ងាញ់	cŋaɲ
លួច	luəc
សន្ទនា	sɑnteaʔnie
ច្របាច់	crɑbac
ខ្លោង	klaoŋ
ត្រីដៀប	trəydiəp
អ្នកឌុប	neakdup
ស្មើ	smaə
ប្រភព	prɑpʰup
នាគ	niek
ចរិយា	caʔreʔyaa
ផ្ទាល់	ptoal
ទាស់ត្រង់	toahtrɑŋ
ម៉ោ	mao
ជះ	ceah
តារា	taaraa
លង់ទឹក	lʊəŋtɨk
ចាក់សោ	caksao
ផ្កា	pkaa
ប្រាក់អាប់	prakʔap
អាយុ	ʔaayuʔ
ស្រុកកំណើត	srokkɑmnaət
ចំពោះ	cɑmpʊəh
ពាក្យសុំ	pieksom
ស្អែក	sʔaek
ស្រាក្រហម	sraakrɑhɑɑm
នីមួយៗ	niimuəyniimuəy
ស្រូវប្រាំង	srǝvpraŋ
ក្រណាត់	krɑnat
ពលកម្ម	pʊəlleaʔkam
ពន្លឺ	pʊənlɨɨ
អាមេរិក	ʔaameerik
ភាយ	pʰiey
កន្សែងពោះគោ	kɑnsaeŋpʊəhkoo
ទំនង	tumnɔɔŋ
ល្អមើល	lʔɑɑməəl
ចុងក្រោយ	coŋkraoy
គេ	kee
បំបាត់	bɑmbat
កម្មវិធី	kamviʔtʰii,kammaʔviʔtʰii,kammeaʔviʔtʰii
ម្ជុលចាក់ថ្នាំ	mculcaktnam
រដូវវស្សា	rɔdəvvoahsaa
ខ្នុរ	knao,knol
រទេះ	rɔteh
នោះ	nuh
ល្បាប់	lbap
និយាយលេងសើច	niʔyieyleeŋsaǝc
ញឹកញាប់	ɲɨkɲoap
ទ្រើស	trəəh
ឡេវ	leev
ព្រះវិហារ	preahviʔhie
ភាសា	pʰiesaa
គ្រាំ	kroam
មានទៅស្អី	mientɨvsʔǝy
និយាយ	niʔyiey
ទូរស័ព្ទចល័ត	tuureaʔsapcaʔlat
ពឹង	pɨŋ
អុស	ʔoh
ត្រូវតែ	trəvtae
កម្រិត	kɑmrɨt
ណូ	nou
ឡានពេទ្យ	laanpɛɛt
មិនខ្វល់	mɨnkvɑl
មិនទាន់	mɨntoan
ស្រាប់	srap
ការទូត	kaatuut
ស្រងូតស្រងាត់	srɑŋoutsrɑŋat
ស្កប់ស្កល់	skɑpskɑl
បិទបាំង	bətbaŋ
តម្រូវឲ្យ	tɑmrəvʔaoy
នំ	num
អ៊ឹស	ʔɨh
ធ្វើ	tvəə
ដៃគូ	daykuu
លេងសើច	leeŋsaǝc
ចូលឆ្នាំខ្មែរ	coulcnamkmae
ឲ្យ	ʔaoy
អាជីព	ʔaaciip
ស្រាវជ្រាវ	sraavcriev
ខុសទំនង	kʰohtumnɔɔŋ
មនុស្សម្នាក់	meaʔnuhmneak
ជ័រកៅស៊ូ	coakavsuu
បុក	bok
ចេញដំណើរ	cəɲdɑmnaə
ជាទីបំផុត	cietiibɑmpʰot
ឈ្នួល	cnuəl
ផឹក	pʰək
ទល់មុខ	tʊəlmuk
ទីធ្លា	tiitlie
ឲ្យឈឹង	ʔaoycʰɨŋ
ក្រូចឆ្មារ	krouccmaa
ស្បែកជើងផ្ទាត់	sbaekcəəŋptoat
ចោរឆក់	caocʰɑk
តែង	taeŋ
ខ្សែ	ksae
ប៊ីដុង	biidoŋ
ទិស	tɨh
ទៅ	tɨv
ខាងក្រៅ	kʰaaŋkrav
ឆ្វេង	cveeŋ
ប្រអប់	prɑʔɑp
ស្រឡះ	srɑlah
សណ្ដែកកួរ	sɑndaekkuə
ហេតុការណ៍	haetkaa
រាប់	roap
ពន្ធ	pʊən
កែវ	kaev
មិនថា	mɨntʰaa
កាំបិត	kambət
សុភាព	soʔpʰiep
មួក	muək
ផ្អៀង	pʔiəŋ
ក្រែងលោ	kraeŋloo
បង្កាន់ដៃ	bɑŋkanday
ចង់	cɑŋ
សោកស្ដាយ	saoksdaay
ទេហ	teehɑɑ
ត្រូវនឹង	trəvnɨŋ
កន្ធន់	kɑntʰʊən
យកចិត្តទុកដាក់	yɔɔkcəttukdak
សិស្សានុសិស្ស	səhsaanuʔsəh
ទាំង	teaŋ
កុងតឺន័រ	koŋtəɨnoa
ផុង	pʰoŋ
សុវណ្ណ	soʔvan
ដេរ	dee
ដៃនាង	daynieŋ
ដោះ	dɑh
ពាក់ព័ន្ធ	peakpoan
ថែ	tʰae
ប៉ុក	pok
ដោយសេរី	daoyseerǝy
ទំនុកចិត្ត	tumnukcət
បញ្ញា	paɲɲaa
ធារ៉ា	tʰieraa
ជាង	cieŋ
ចាក់	cak
បម្រាម	bɑmraam
ទំនាក់ទំនង	tumneaktumnɔɔŋ
រំសាយ	rumsaay
ម៉ាស៊ីនលាងចាន	maasinlieŋcaan
ចម្អិន	cɑmʔən
បាវ	baav
គប់	kup
លាន់	loan
រយៈ	reaʔyeaʔ
មួយ	muəy
យល់ព្រម	yʊəlprɔɔm
ខ្វល់	kvɑl
ចំណាយ	cɑmnaay
សម្បជញ្ញៈ	sampaʔcʊəɲɲeaʔ
អាគ្នេយ៍	ʔaknee
ពួកម៉ាក	puəkmaak
ចម្ងល់	cɑmŋɑl
កាលសម័យ	kaalsaʔmay
បិទ	bət
វ៉ា	vaa
អេ៎	ʔee
កកើត	kɑɑkaət
ផ្លែឈើ	plaecʰəə
ចរន្ត	caʔrɑn
ម្ហូប	mhoup
ក្រអូប	krɑʔoup
ជាដាច់ខាត	ciedackʰaat
ដូចម្ដេច	doucmdəc
ចង្កា	cɑŋkaa
បដិមា	paʔdeʔmaa
ងាយ	ŋiey
លូ	luu
ហឹរ	haə,həl
ប្រឹង	prəŋ
វុទ្ធី	vutʰii
ចាបចៀន	caapciən
អស់រលីង	ʔɑhrɔliiŋ
រីកចំរើន	riikcɑmraən
លូក	luuk
ត្រូពិក	tropik
ជាប់លេខ	coapleek
ដទៃទៀត	dɑteytiət
ម្នាស់	mnoah
ចង្កៀង	cɑŋkiəŋ
អធ្រាត្រ	ʔaʔtriet
ភ្លឹង	plɨŋ
សុំ	som
ស្រែកហៅ	sraekhav
សិស្ស	səh
អរូបី	ʔaʔruupǝy
យ៉ាង	yaaŋ
ចត់	cɑt
ហ្នឹងអ៎	nɨŋʔɑɑ
បែកគុម្ព	baekkum
ថ្លើម	tlaəm
ស្មាអាវ	smaaʔaav
ច្រវា	crɑvaa
ជក់ចិត្ត	cʊəkcət
ស្នេហា	snaehaa
ហេវ	heev
នំប៉័ង	numpaŋ
ជង្គង់	cʊəŋkʊəŋ
ហោប៉ៅ	haopav
ខ្ញុំ	kɲom
ម៉េច	məc
ក្លិន	klən
ក្បង់	kbɑŋ
អានោះ	ʔaanuh
មោឃៈ	mookʰeaʔ
ខ្ទឹមបារាំង	ktɨmbaaraŋ
ផ្សេងទៀត	pseeŋtiət
ថង់យាម	tʰɑŋyiem
សំពត់	sɑmpʊət
ស្ម័គ្រចិត្ត	smakcət
ស្បង់	sbɑŋ
កណ្ដោរ	kɑndao
ហួស	huǝh
រំលឹក	rumlɨk
បែងចែក	baeŋcaek
ក្រិត	krət
ធ្នើរ	tnəə
ឆើត	cʰaət
ចោះ	cɑh
កូនសិស្ស	kounsəh
អញ្ចេះ	ʔɑɲceh
ទីទុយ	tiituy
ថ្ងៃផុតកំណត់	tŋaypʰotkɑmnɑt
ឆ្កែ	ckae
ឆ្លាស់	clah
អស់កម្លាំង	ʔɑhkɑmlaŋ
រីង	riiŋ
ឃ្លុប	klup
ចាំង	caŋ
សញ្ជឹង	sɑɲcɨŋ
ផុយ	pʰoy
ក្មួយ	kmuəy
រស់រាន	rʊəhrien
រូបភាព	ruuppʰiep
នាក់	neak
ព្រម	prɔɔm
បួន	buən
លែង	lɛɛŋ
ចងបូរ	cɑɑŋbou
បាំង	baŋ
ធ្លាប់តែ	tloap
ខ្ចាយ	kcaay
ដូចគ្នា	doucknie
ងុយដេក	ŋuydeek
ទេតើ	teetaə
កកិត	kɑkət
បី	bəy
ភេសជ្ជៈ	pʰeehsacceaʔ
ស្ដាប់ឮ	sdaplɨɨ
នរណា	nɔɔnaa
បង្ហូរ	bɑŋhou
ងើយមើល	ŋəəyməəl
ចរណៃ	cɑɑranay
លុបមុខ	lupmuk
ខុសឆ្គង	kʰohckɔɔŋ
ដំណេក	dɑmneek
វប្បធម៌	voappaʔtʰoa
កិច្ចការ	kəckaa
ស្ទើរ	stǝǝ
ម៉េចដែរ	məcdae
អុំទូក	ʔomtuuk
ខ្វះ	kvah
សុភាសិត	soʔpʰiesət
ជន	cʊən
ស្មោះ	smɑh
ផ្អែម	pʔaem
ចាស	caah
ឡេ	lee
ទោះ	tʊəh
រមាស់	rɔmoah
មាំ	moam
លេង	leeŋ
ផានិត	pʰaanɨt
ទន្ទឹម	tʊəntɨm
ក៏	kɑɑ
ក្រែង	kraeŋ
លើកក្រោយ	lǝǝkkraoy
សស្ងាច	sɑɑsŋaac
ណែន	naen
ភ្នំ	pnum
ជាប្រចាំ	cieprɑcam
ងងុយ	ŋɔŋuy
ពេក	peek
ធ្វើឲ្យ	tvəəʔaoy
សួរ	suə
ម៉ូត	mout
ខ្ទប់	ktup
ក្រចក	krɑcɑɑk
អ្នកដំណើរ	neakdɑmnaə
ចំណិត	cɑmnət
ការ៉ុត	kaarot
ដោះស្រាយ	dɑhsraay
ចំណងជើង	cɑmnɑɑŋcəəŋ
ពិតជា	pɨtcie
ប៉ាវ	paav
បើ	baə
រមួល	rɔmuəl
កញ្ចប់	kɑɲcɑp
ពែនភ្នែន	pɛɛnpnɛɛn
សាង	saaŋ
អា៎	ʔaa
នៅតែ	nɨvtae
ឌូយ	duuy
មន្ទិល	mʊəntɨl
គុយទាវ	kuytiev
ជម្រាបលា	cumrieplie
ចៅស្រី	cavsrǝy
បុគ្គល	bokkʊəl
ជួបជុំ	cuəpcum
ចៀន	ciən
គិលានុប្បដ្ឋាយិកា	kiʔlienuʔpattʰaayiʔkaa
ថ្លៃ	tlay
រៀងរាល់ថ្ងៃ	riəŋroaltŋay
លែងកើត	lɛɛŋkaət
ការចាយវាយ	kaacaayviey,kaacaayvay
ស៊ាំ	soam
កំពុង	kɑmpuŋ
ជិតខាង	cɨtkʰaaŋ
ខ្ជិល	kcɨl
ផ្តិល	ptəl
អបិយជំនឿ	ʔappəyyeaʔcumnɨə
ឆត្រ	cʰat
ខ្លាច	klaac
កណ្ដឹង	kɑndəŋ
ប្រដាប់	prɑdap
ចង្រៃយោ	cɑŋrayyoo
ភាគ	pʰiek
ជើង	cəəŋ
ចងចាំ	cɑɑŋcam
រុញ	ruɲ
ជើងពាន	cəəŋpien
វ៉ៃ	vay
អុជៗ	ʔocʔoc
ច្រឡំ	crɑlɑm
ចំណែកឯ	cɑmnaekʔae
បញ្ជ្រៀត	bɑɲcriət
រំពេចនោះ	rumpɨcnuh
វា	vie
ខ្វេះ	kveh
ប៊ិច	bic
គ្រូបង្រៀន	kruubɑŋriən
តាំង	taŋ
កង	kɑɑŋ
លីដា	liidaa
សម្ងាត់	sɑmŋat
សាយឡិន	saaylən
ស្មារតី	smaardəy
ប្រាក់	prak
សន្ធរម៉ុក	sɑntʰɔɔmok
តស់	tɑh
នាង	nieŋ
ប៊ីយេរ	biiyɛɛ
ចាស់	cah
វាយ	vay,viey
ប៉ាន់តែ	pantae
ដិត	dət
អ៊ំ	ʔum,ʔom
ផ្ទៃសមុទ្រ	pteysaʔmot
រើស	rəəh
ប្រណាំង	prɑnaŋ
ត	tɑɑ
ព្រឹក	prɨk
ប្រជុំជន	prɑcumcɔɔn
មុំ	mum
រោម	room
វៃ	vey
ស៊ុម	sum
ប្រុង	proŋ
អតិថិជន	ʔaʔteʔtʰeʔcɔɔn
ដែរ	dae
កំឡុង	kɑmloŋ
ខេត្ត	kʰaet
ស្រេចតែ	sractae
ខុសត្រូវ	kʰohtrəv
ពុះ	puh
ថ្ងូរ	tŋou
ស្លាប	slaap
ល្អប្រើ	lʔɑɑpraə
នានា	nienie
ខ្ពស់	kpʊəh
សំបុត្រឡាន	sɑmbotlaan
នឿយ	nɨəy
ស្កៀប	skiǝp
អាម៉ាហ្ស៉ូន	ʔaamaasɑn
អណ្ដែត	ʔɑndaet
កញ្ញា	kaɲɲaa
ប៉ង់	pɑŋ
ពាក្យស្លោក	piekslaok
គម្រប	kumrɔɔp
កកូរ	kɑkou
យាយ	yiey
ពេញ	pɨɲ
បោស	baoh
ហេឡូ	heelou
ប្លែក	plaek
អង្ករ	ʔɑŋkɑɑ
ប៉ាស់ស្ព័រ	pahspoa
ឱសថស្ថាន	ʔaosɑɑtʰɑɑstʰaan
ឃ្លាន	klien
លេខសម្ងាត់	leeksɑmŋat
ប្រៀប	priəp
បេះ	beh
ឱកាស	ʔaokaah
ពោរពេញ	poopɨɲ
ស៊ី	sii
អាក្រក់	ʔaakrɑk
សព្វ	sɑp
ស៊ីសាមុត	siisaamut
ប្រពៃណី	prɑpeynii
ចិញ្ចឹម	cəɲcəm
ផ្ទះបាយ	pteahbaay
អំពូលម៉ែត្រ	ʔɑmpuulmaet
ជាក់ជា	ceakcie
អត់ឃ្លាន	ʔɑtklien
តិចមើល	təcməəl
គ្រាំគ្រា	kroamkrie
ពូ	puu
ជាសះស្បើយ	ciesahsbaǝy
ចាប់កាន់	capkan
ម្ខាងទៀត	mkʰaaŋtiət
កើត	kaət
ពី	pii
បុរាណ	boʔraan
ឆ្នាំងសាក	cnaŋsaak
ជ្រក	crɔɔk
សុរិយគតិ	soʔreʔyaʔkeaʔteʔ
មួយវិញទៀត	muəyvɨɲtiət
ភ្លេងជាតិ	pleeŋciet
ស្នាម	snaam
បំពង់	bɑmpʊəŋ
ជំនឿ	cumnɨə
ក្រៀមក្រំ	kriəmkrɑm
ផ្ដាច់	pdac
អនុស្សាវរីយ៍	ʔaʔnuhsaavaʔrii
ការដ្ឋាន	kaarattʰaan
វីរៈ	viireaʔ
រើ	rəə
ក្លាយ	klaay
មូល	muul
ស្រោម	sraom
សូវ	səv
ស្វែងរក	svaeŋrɔɔk
ភា	pʰie
ចង្ក្រាន	cɑŋkraan
ទប់	tup
ពន្ធនាគារ	pʊəntʰeaʔniekie
ហ្នឹង	nɨŋ
ផ្លាក	plaak
អាប់	ʔap
តាមរយៈ	taamreaʔyeaʔ
ព្រះពុទ្ធ	preahput
ភ្លាម	pliem
ឈាម	cʰiem
រៀល	riəl
កែងដៃ	kaeŋday
កូរ	kou
ចាប់ផ្ដើម	cappdaəm
ឆ្លាក់	clak
សាក្សី	saaksəy
ហ្គែរ	kae
ម៉ាស៊ីនបូមធូលី	maasinboumtʰuulii
សួន	suən
ការេ	kaaree
ជួនជា	cuəncie
សេន	seen,saen
ទទេ	tɔtee
ជ្រែ	crɛɛ
ស្លាក់	slak
ជ័រព្នៅ	coapnɨv
ខាងក្នុង	kʰaaŋknoŋ
ជួល	cuəl
សឹងអី	səŋʔəy
ទិដ្ឋភាព	tittʰaʔpʰiep
បង្ការ	bɑŋkaa
សាលា	saalaa
ម៉េះ	meh
បរិយាកាស	paʔreʔyaakaah
ពោធិ៍សាត់	poosat
នឹកឃើញ	nɨkkʰəəɲ
រអៀសខ្លួន	rɔʔiəhkluən
សាកល្បង	saaklbɑɑŋ
និស្សិត	nihsət
សម្រុក	sɑmrok
ចុះឡើង	cohlaəŋ
ស្អាតបាត	sʔaatbaat
ស៊យ	sɔɔy
យក្ស	yeak
ផ្ដល់	pdɑl
លូន	luun
ដីល្បាប់	dəylbap
សឹងតែ	sǝŋtae
អត់ទោស	ʔɑttooh
សាក	saak
រសាត់	rɔsat
វេជ្ជបញ្ជា	vɨcceaʔbɑɲcie
និយាយលេង	niʔyieyleeŋ
ត្រឹមតែ	trəmtae
ល្បែង	lbaeŋ
ត្រូវចិត្ត	trəvcət
អាវរងា	ʔaavrɔŋie
សាច់ប្រាក់	sacprak
គ្រីនធី	kriintʰii
ល្មម	lmɔɔm
អំបោះ	ʔɑmbɑh
ទូទាំង	tuuteaŋ
ផ្ទៃមុខ	pteymuk
ខ្យល់គរ	kcɑlkɔɔ
ភ្ញាក់	pɲeak
ពាក់ឆៀង	peakcʰiəŋ
ជ្រែងហោប៉ៅ	crɛɛŋhaopav
អស់	ʔɑh
ណាំវ៉ា	namvaa
ពុំខាន	pumkʰaan
ហាក	haak
អូ៎	ʔou
ស្រឡាញ់	srɑlaɲ
ហ្គារ៉ាស់	gaarah
ក្រចកដៃ	krɑcɑɑkday
អឺ	ʔəɨ
កែង	kaeŋ
អំណោយផល	ʔɑmnaoypʰɑl
រវល់	rɔvʊəl
ជាជាង	ciecieŋ
ផ្សំ	psɑm
ជួរ	cuə
ឈ្នះ	cneah
ក្របី	krɑbəy
ស្មាន	smaan
ប្រគល់	prɑkʊəl
ប្រាកដ	prakɑt
ចូលចិត្ត	coulcət
ឡើង	laəŋ
ទង្គិច	tʊəŋkɨc
ស្និទ្ធស្នាល	snǝtsnaal
ទីតាំង	tiitaŋ
សិដ្ឋ	sət
ក្លាសេ	klaasee
វែង	vɛɛŋ
សក់	sɑk
ពេលថ្ងៃត្រង់	peeltŋaytrɑŋ
សន្តិសុខ	sɑnteʔsok
មូសខ្លា	muuhklaa
ភីហ្សា	piisaa
នង្គ័ល	ʔɑŋkoal,neaŋkoal,lʊəŋkoal
ទទួលរង	tɔtuəlrɔɔŋ
មួល	muəl
យប់	yup
ចង្កូម	cɑŋkoum
ថែម	tʰaem
ចែកចេញជា	caekcəɲcie
ត្រាំ	tram
ដើមស្រូវ	daəmsrəv
មុខជូរ	mukcuu
ដូច	douc
បិណ្ឌ	bən
ព្រាយ	priey
កត់ត្រា	kɑttraa
សិក្ខាសាលា	səkkʰaasaalaa,sekkʰaasaalaa
ថ្ងៃសៅរ៍	tŋaysav
ណោះ	nɑh
សាច់ក្រណាត់	sackrɑnat
គណិត	keaʔnet
កង្ហារ	kɑŋhaa
ស្វាយប៉ោម	svaaypaom
ស្រា	sraa
អង្គញ់	ʔɑŋkʊəɲ
សែន	saen
ឧបករណ៍	ʔuʔpaʔkɑɑ
មេរោគ	meerook
អ៊ើ	ʔəə
ខ្លាំង	klaŋ
ទម្លាប់	tumloap
កុយ	koy
ប្រាថ្នា	pratnaa
ដើមទង	daəmtɔɔŋ
នាំឲ្យ	noamʔaoy
ទឹកចិត្ត	tɨkcət
អាស្រ័យ	ʔaasray
វាសនា	viehsnaa,viesaʔnaa
ចូល	coul
វត្ត	voat
វិក្កយបត្រ	vikkaʔyaeaʔbat
ពីរោះ	piirʊəh
ក្រយៅដៃ	krɑyavday
ជាន់	coan
ឈូស	cʰuuh
ក្លែងក្លាយ	klaeŋklaay
ហាលថ្ងៃ	haaltŋay
សម្រាក	sɑmraak
អាទិភាព	ʔaatɨʔpʰiep
ចាកចេញ	caakcəɲ
ប្រយោជន៍	prɑyaoc
កាលពី	kaalpii
អ្នកជិតខាង	neakcɨtkʰaaŋ
គ្រាន់បើ	kroanbaə
ប្រតិទិន	prɑteʔtɨn
ខណ្ឌ	kʰan
ព្យួរ	pyuə
ពណ៌	poa
អាឡែង	ʔaalaeŋ
តិចទៀត	təctiət
ឈឺចាប់	cʰɨɨcap
បាល់	bal
ស្រួលបួល	sruǝlbuəl
ជាស្រេច	ciesrac
ស្រូវ	srəv
ក្រៅ	krav
លាងចាន	lieŋcaan
ស្រាល	sraal
ដងទន្លេ	dɑɑŋtʊənlee
កក	kɑɑk
ភ្នាល់	pnoal
ហ៊ាន	hien
បារម្ភ	baarɑm
រិះគន់	rihkʊən
ឪពុក	ʔǝvpuk
ប្រហោង	prɑhaoŋ
ទ្រាំ	troam
ឆែកមើល	cʰaekməəl
ខ្ទាត	ktiet
អារម្មណ៍	ʔaarɑm
មក	mɔɔk
បបរ	bɑbɑɑ
បង្អង់	bɑŋʔɑŋ
ខើច	kʰaəc
ត្បាល់	tbal
ដដែល	dɑdael
កម្មករ	kammaʔkɑɑ
រប៉ាត់រប៉ាយ	rɔpatrɔpaay
យឹត	yɨt
ពឹងផ្អែក	pɨŋpʔaek
មកកាន់	mɔɔkkan
ថ្នាំ	tnam
ពិបាក	piʔbaak
សន្យា	sɑnyaa
មួកការពារ	muəkkaapie
ណា៎	naa
ផ្លូវភេទ	pləvpʰeet
បាល់ទាត់	baltoat
ក្រោយ	kraoy
ឬក៏	rɨɨkɑɑ
កាំជណ្ដើរ	kamcʊəndaə
ចេញឈាម	cəɲcʰiem
ស្រាប់តែ	sraptae
គុក	kuk
លុយអាប់	luyʔap
វិបុល	viʔbol
ក្លៀក	kliək
ពាក្យ	piek
ក្រៅពី	kravpii
បាត់បង់	batbɑŋ
ច្រវាក់	crɑvak
ចំពុះ	cɑmpuh
កំពូលភ្នំ	kɑmpuulpnum
ហូប	houp
បាប	baap
ជុំវិញ	cumvɨɲ
ហុយ	hoy
កអាវ	kɑɑʔaav
បរិមាណ	paʔreʔmaan
សីតុណ្ហមាត្រ	səytonhaʔmiet
រវិច	rɔvɨc
ស្គាល់គ្នា	skoalknie
ប៊ីចេង	biiceeŋ
ស័ក្តិសម	saksɑm
យ៉ាងដូចម្ដេច	yaaŋdoucmdəc
ដាលីន	daalɨn
ចំណង់	cɑmnɑŋ
បញ្ជាក់	bɑɲceak
ពេលវេលា	peelveelie
ឃ្លោង	klooŋ
ប៉េងប៉ោះ	peeŋpɑh
ពួកគាត់	puəkkoat
ខ្ពុរ	kpuu,kpul
ទឹកសុទ្ធ	tɨksot
សម្ងំ	sɑmŋɑm
រីករាយ	riikriey
ដំរី	dɑmrəy
ស្បែកជើងប៉ាតា	sbaekcǝǝŋbaataa
មើលទៅ	məəltɨv
ដំឡូងបារាំង	dɑmlouŋbaaraŋ
សុជាតិ	soʔciet
ត្រចៀក	trɑciək
អកុសល	ʔaʔkoʔsɑl
អត់ធ្មត់	ʔɑttmʊət
រៀប	riəp
ជាដើម	ciedaəm
ចំបើង	cɑmbaəŋ
អង្អែល	ʔɑŋʔael
អង់គ្លេស	ʔɑŋkleeh
ប្រេះ	preh
ទើស	təəh
បាញ់	baɲ
រឹង	rɨŋ
ឆេះ	cʰeh
ទូទឹកកក	tuutɨkkɑɑk
ដុតឆេះ	dotcʰeh
ប្រហែស	prɑhaeh
ផ្សារទំនើប	psaatumnəəp
ស្រោច	sraoc
បែរ	bae
ក្រ	krɑɑ
សង់	sɑŋ
ផ្លូវ	pləv
គ្រោះថ្នាក់	krʊəktnak
ដឹងខ្លួន	dəŋkluən
រ៉ូប	roup
ថ្នាំដុសធ្មេញ	tnamdohtmɨɲ
រតនៈ	roattaʔnaʔ,reaʔtaʔnaʔ
ទូកអុំ	tuukʔom
សាច់ដុំ	sacdom
ពិធីករ	piʔtʰiikɑɑ
កញ្ចក់	kɑɲcɑk
ម្រាមដៃ	mriemday
ស្នែង	snaeŋ
ស្ដីឲ្យ	sdǝyʔaoy
បណ្ដូល	bɑndoul
បាច់	bac
កូនមាន់	kounmoan
ខ្យល់	kcɑl,kyɑl,ksɑl
រូប	ruup
ហ្អ	ʔɑ
ថ្ងៃនេះ	tŋaynih
ដូចមុន	doucmun
កាលបរិច្ឆេទ	kaalpaʔrəccʰaet,kaalbɑɑrəccʰaet
ត្រី	trəy
ម៉ា	maa
បាច	baac
ផ្ងារ	pŋaa
ទីផ្សារ	tiipsaa
អើយ	ʔaəy,ʔəəy
ចំកណ្ដាល	cɑmkɑndaal
អសន្តិសុខ	ʔaʔsɑnteʔsok
ម្នាក់ឯង	mneakʔaeŋ
ពីដើម	piidaəm
ដេញ	dəɲ
សារធាតុ	saaraʔtʰiet
ច្រាំង	craŋ
កូនក្មេង	kounkmeeŋ
លីង	liiŋ
លេស	leeh
ខ្យង	kyɑɑŋ,kcɑɑŋ
របាំង	rɔbaŋ
ច្រមុះ	crɑmoh
នំបញ្ចុក	numbɑɲcok
ទារ	tie
ទិសដៅ	tɨhdav
ស្រេក	sreek
ហ្វាម៉ាស៊ី	faamaasii
ផ្សំថ្នាំ	psɑmtnam
មង្ឃុត	mʊəŋkʰut
រេ	ree
ហើយនិង	haǝynɨŋ
ចាប់ចិត្ត	capcət
អេក្រង់	ʔeekrɑŋ
ជិះ	cih
អំពូល	ʔɑmpuul
របារ	rɔbaa
លាត	liet
ខូចខាត	kʰouckʰaat
ខ្ចប់	kcɑp
បងប្អូន	bɑɑŋpʔoun
ក្រៀម	kriəm
ធាក់	tʰeak
ទឹកស៊ុប	tɨksup
ក្ដាប់	kdap
ផ្សែង	psaeŋ
កម្ចាត់	kɑmcat
ទប់ទល់	tuptʊəl
ហ្វូម	foum
ឆ្អិន	cʔən
ស្វ័យ	svay
អាល់កុល	ʔalko
បង់បិទដំបៅ	bɑŋbətdɑmbav
គុណភាព	kunaʔpʰiep
ក្រោយពេល	kraoypeel
ល្អ	lʔɑɑ
លំអងផ្កា	lumʔɑɑŋpkaa
ឆ្លង	clɑɑŋ
ពិចនិច	pɨcnɨc
ក្រហម	krɑhɑɑm
ហ្នុង	noŋ
ស្បើយ	sbaəy
ដង្កូវទឹក	dɑŋkəvtɨk
អញ្ចុះ	ʔɑɲcoh
សេព	saep
ចុង	coŋ
វាស់	voah
សុគន្ធ	soʔkʊən
កើតឡើង	kaətlaəŋ
ពង	pɔɔŋ
ផារី	pʰaarii
ឈើគូស	cʰəəkuuh
បាត់ស្រេក	batsreek
កេស	keeh
ដង	dɑɑŋ
ទិញ	tɨɲ
ស្រដៀងនឹង	srɑdiǝŋnɨŋ
យួរ	yuə
ការវះកាត់	kaaveahkat
រានហាល	rienhaal
ម៉ាគំនរ	maakumnɔɔ
កសិករ	kaʔseʔkɑɑ
ទុំ	tum
វិលមុខ	vɨlmuk
ប្រាកដជា	praakɑɑtcie
បងស្រី	bɑɑŋsrǝy
ចន្ទល់	cɑntʊəl
បះ	bah
ប្រវែង	prɑvaeŋ
ខាងដើម	kʰaaŋdaəm
សុខសប្បាយ	soksapbaay
បំបែក	bɑmbaek
ហុច	hoc
មាស	mieh
កំណក	kɑmnɑɑk
លិច	lɨc
តឹង	təŋ
ខ្មាសគេ	kmaahkee
ថ្ងៃចន្ទ	tŋaycan
គុម្ព	kum
នរោត្តម	nɔroodɑm
ចៅ	cav
ថ្ម	tmɑɑ
ប្រឡង	prɑlɑɑŋ
ប្រជាប្រិយភាព	prɑcieprəypʰiep
សម្បត្តិ	sɑmbat
ដោះសា	dɑhsaa
យក	yɔɔk
ម្នាក់	mneak
ម្ជុល	mcul
បណ្ណាល័យ	pannaalay
ពេញចិត្ត	pɨɲcət
ឪពុកម្ដាយ	ʔǝvpukmdaay
ផ្សេង	pseeŋ
គួរឲ្យ	kuəʔaoy
ពំនូក	pumnuuk
ផ្ទះល្វែង	pteahlvɛɛŋ
ស្គាល់	skoal
សន្លប់	sɑnlɑp
ចីវរ	ciivɔɔ
ក្រឡុក	krɑlok
សត្វល្អិត	satlʔǝt
ឱប	ʔaop
បណ្ដាញទំនាក់ទំនងសង្គម	bɑndaaɲtumneaktumnɔɔŋsɑŋkum
ថាមពល	tʰaamaʔpʊəl
តួនាទី	tuənietii
ហ្វេសប៊ុក	feehbuk
សារភាព	saaraʔpʰiep
បឋម	paʔtʰɑm
រលក	rɔlɔɔk
ប្រុស	proh
ខាងណា	kʰaaŋnaa
លក្ខខណ្ឌ	leakkʰan
សភាព	saʔpʰiep
ផ្គុំ	pkum
រោង	rooŋ
ឈាន	cʰien
ឱន	ʔaon
សម្អាត	sɑmʔaat
ផ្លូវជាតិ	pləvciet
ស្ទើរគ្រប់	stǝǝkrup
ច្រាសដុសធ្មេញ	craahdohtmɨɲ
ពពក	pɔpɔɔk
ជីវិត	ciivɨt
កាយ	kaay
បង្កប់ន័យ	bɑŋkɑpney
ធ្លាយ	tliey
ចឹង	cəŋ
សិទ្ធិ	sət
ដក់	dɑk
អាកាស	ʔaakaah
សម្ផស្ស	sampʰɑh
អ្នកបើកបរ	neakbaəkbɑɑ
កន្លង	kɑnlɑɑŋ
កាំកង់	kamkɑŋ
ភ្នំសន្ទុក	pnumsɑntuk
យី	yii
បារមី	baareaʔməy
បន្ទប់គេង	bɑntupkeeŋ
ក្រប	krɑɑp
ខួបកំណើត	kʰuəpkɑmnaət
មុខវិជ្ជា	mukvɨccie
រដូវ	rɔdəv
ឆួល	cʰuəl
ឃ្លីងឃ្លោង	kliiŋklooŋ
ថាស	tʰaah
បណ្ដុំ	bɑndom
ស្រុក	srok
មិនទាំង	mɨnteaŋ
ខ្ជាប់	kcoap
ពែង	pɛɛŋ
លត	lɔɔt
ណារី	naarii
ត្រកង	trɑkɑɑŋ
ភ្លេចភ្លាំង	plɨcpleaŋ
ដុំដែក	domdaek
ដើរលេង	daəleeŋ
សុទ្ធតែ	sottae
កាច់ចង្កូត	kaccɑŋkout
ម្ភៃ	mpʰey
ធ្លាក់	tleak
ត្នោត	tnaot
ទាក់ជើង	teakcəəŋ
ការិយាល័យ	kaareʔyaalay
ម៉ោង	maoŋ
ខ្វិត	kvət
ស្របាល	srɑbaal
ពិពណ៌នា	piʔpoanaʔnie,piʔpoanie
ឪឡឹក	ʔǝvlǝk
សីហា	səyhaa
ងាក	ŋiek
ទុកទុក	tuktuk
ដាស់	dah
បកប្រែ	bɑɑkprae
ឆ្កឹះ	ckəh
គ្រោះអាក្រក់	krʊəkʔaakrɑk
បដិសេធ	paʔdeʔsaet
ដប់ប្រាំ	dɑppram
ប្លាស្ទិក	plaastɨk
រូបថត	ruuptʰɑɑt
គ្រប់សព្វ	krupsɑp
មេសា	meesaa
រយៈពេល	reaʔyeaʔpeel
អំពើ	ʔɑmpəə
តេនីស	teeniih
ប្រាំង	praŋ
លាគ្នា	lieknie
កន្ត្រក	kɑntrɑɑk
ដៃ	day
ខួរក្បាល	kʰuəkbaal
រងាវ	rɔŋiev
ទំពា	tumpie
ចុះ	coh
បរិភោគ	bɑɑreʔpʰook
តំបន់	tɑmbɑn
សំប៉ែត	sɑmpaet
ពិនិត្យ	piʔnɨt
អត្តសញ្ញាណប័ណ្ណ	ʔattaʔsaɲɲaanban
កាស្យូ	kaasyou
ស្នាក់	snak
តាមពិត	taampɨt
ឡប់ៗ	lɑplɑp
តម្រៀប	tɑmriəp
មេ	mee
ញាប់	ɲoap
ដង្ហើម	dɑŋhaəm
ក្អម	kʔɑɑm
សាប៊ូកក់សក់	saabuukɑksɑk
ក្រដាសកេស	krɑdaahkeeh
សសរ	sɑsɑɑ
មិន	mɨn
រំលង	rumlɔɔŋ
ភ្ជាប់នឹង	pcoapnɨŋ
សច្ចា	saccaa
ចំ	cɑm
ចាយ	caay
ហើយៗ	haǝyhaǝy
កឿង	kɨəŋ
ហត់នឿយ	hatnɨəy
រំលែកទុក្ខ	rumlɛɛktuk
កាល	kaal
ថ្ងៃត្រង់	tŋaytrɑŋ
ទំហំ	tumhum
បញ្ចុះបញ្ចូល	bɑɲcohbɑɲcoul
គឺ	kɨɨ
ស្អិត	sʔət
ហែក	haek
ជូនពរ	cuunpɔɔ
រកស៊ី	rɔɔksii
សង្ឃ	sɑŋ
ស្វាយកែវចិន	svaaykaevcən
ឃ្យូត	kyuut
ល្បឿន	lbɨǝn
ម្សិលមិញ	msəlmɨɲ
ជាមិនខាន	ciemɨnkʰaan
មិនមែន	mɨnmɛɛn
ស្រាវិស្គី	sraaviskii
ទៀង	tiəŋ
ប៉ូលិស	poulih
ពពុះ	pɔpuh
ភ្លើងស្តុប	pləəŋstop
តារាង	taaraaŋ
បោះពុម្ព	bɑhpum
ស្រាយ	sraay
អង្សាសេ	ʔɑŋsaasee
មណ្ឌលគិរី	mʊəndʊəlkiʔrii
ស្វិត	svət
ថា	tʰaa
សណ្ដូក	sɑndouk
ផលដំណាំ	pʰɑldɑmnam
ចា៎ស	caah
ចាំ	cam
ខល	kʰɑɑl
ប៉ះ	pah
ពាក្យសូរដូច	pieksoudouc
អត់ទេស	ʔɑtteeh
ពិសី	piʔsəy
អៀន	ʔiǝn
ចង្កាក់	cɑŋkak
អនុវត្ត	ʔaʔnuʔvoat
ទទួល	tɔtuəl
រាក	riek
គ្រឿងផ្សំ	krɨəŋpsɑm
មើម	məəm
សោះ	sɑh
ចំណីចំណុក	cɑmnəycɑmnok
តេ	tee
សាឡុង	saaloŋ
ថ្វាយបង្គំ	tvaaybɑŋkum
ខុសវិន័យ	kʰohviʔney
ថោក	tʰaok
អញ្ជើញ	ʔɑɲcəəɲ
រួសរាយ	ruəhriey
ជឿ	cɨə
មេមាន់	meemoan
សុខុម	sokʰom
តស៊ូ	tɑɑsuu
ប្រូម៉ូសិន	broumousǝn
ឥឡូវហ្នឹង	ʔəyləvnɨŋ,ʔləvnɨŋ,ʔiʔləvnɨŋ
សឺរ៉ាំង	səɨraŋ
លក់ដាច់	lʊəkdac
ញេញធ្មេញ	ɲɨɲtmɨɲ
សេរី	seerəy
ថ្ងៃសីល	tŋaysǝl
ក្បាលរ៉ូប៊ីនេ	kbaalroubiinee
កាត់តម្លៃ	kattɑmlay
សាប៊ូ	saabuu
ត្រើយ	traəy
ជ្រលក់	crɔlʊək
ពេលព្រឹកព្រលឹម	peelprɨkprɔlɨm
លើកលែង	lǝǝklɛɛŋ
កៅអី	kavʔəy
អាហារដ្ឋាន	ʔaahaatʰaan
ដុះ	doh
យ៉ាប់ម៉ង	yapmɑɑŋ
អេ	ʔee
នាំគ្នា	noamknie
តែប៉ុណ្ណោះ	taeponnɑh
ម្រាមដៃនាង	mriemdaynieŋ
ខូច	kʰouc
ឌុប	dup
អ៊ុនៗ	ʔunʔun
លាប	liep
ជោគជ័យ	cookcey
អេឡិចត្រូនិច	eeləttrounɨt
សាមសិប	saamsəp
មួយទៀត	muəytiət
ខៀវ	kʰiəv
ឆ្មា	cmaa
ពូថៅ	puutʰav
ផ្ទៃ	ptey
ចៀស	ciəh
គ្រោះថ្នាក់ចរាចរណ៍	krʊəktnakcɑraacɑɑ
ស្រដៀង	srɑdiǝŋ
សំឡី	sɑmləy
បាតទន្លេ	baattʊənlee
រសៀល	rɔsiəl
ស្រះ	srah
លំដាប់លំដោយ	lumdaplumdaoy
ដារិន	daarɨn
បង្ហាញ	bɑŋhaaɲ
ជ្រើសរើស	crəəhrəəh
សរសើរ	sɑɑsaə
លាន់មាត់	loanmoat
ចែកឋាន	caektʰaan
ដង្កូវ	dɑŋkəv
បណ្ដេញ	bɑndəɲ
ឡាម	laam
គ្រលង	krɔlɔɔŋ
ត្រដាង	trɑdaaŋ
ហត់	hɑt
លាស់	loah
ធ្ងន់ធ្ងរ	tŋʊəntŋɔɔ
ប្រឹងប្រែង	prəŋpraeŋ
អង្វែង	ʔɑŋvaeŋ
ស្ថិត	stʰət,tʰət
ប្រាក់ខែ	prakkʰae
ទំព័រ	tumpoa
គណនី	keaʔnaʔnəy,keaʔnaʔnii
អាលុយមីញ៉ូម	ʔaaluymiiɲoum
ខាំ	kʰam
ស្ងាត់	sŋat
ស៊យអាណេះ	sɔɔyʔaaneh
អក្ខរាវិរុទ្ធ	ʔakkʰaʔraaviʔrut
ប្រអប់ស្នោ	prɑʔɑpsnao
រលាត់	rɔloat
គាំង	keaŋ
ឡាតេ	laatee
ណាត់	nat
រដូវរងា	rɔdəvrɔŋie
យ៉ាងម៉េច	yaaŋməc
សៀត	siǝt
កូនដៃ	kounday
ទន់ខ្សោយ	tʊənksaoy
ខាងចុង	kʰaaŋcoŋ
ទីនេះ	tiinih
ពេញនិយម	pɨɲniʔyum
សូម្បីតែ	soumbəytae
ហេតុអី	haetʔəy
ភ	pʰɔɔ
សប្បាយចិត្ត	sapbaaycət
យន្តហោះ	yʊənhɑh
ពួកគេ	puəkkee
ស៊ីរ៉ែន	siiraen
មន្ទីរពេទ្យ	mʊəntiipɛɛt
ស្អុះ	sʔoh
ស្និត	snǝt
ចង្អុល	cɑŋʔol
ព្រួយ	pruəy
សីល	səl
ចាំងថ្ងៃ	caŋtŋay
យុវជន	yuʔveaʔcʊən
នេះ	nih
ចំណង់ចំណូលចិត្ត	cɑmnɑŋcɑmnoulcət
ពីក្រោយ	piikraoy
បន្ទប់ល	bɑntuplɔɔ
ថ្នេរ	tnee
ទឹក	tɨk
ឱ	ʔao
កម្សាន្ត	kɑmsaan
បង្អុរ	bɑŋʔao,bɑŋʔol
ព័ត៌មាន	poadɑɑmien
ញ៉ាំ	ɲam
ប្រទេស	prɑteeh
វិញ	vɨɲ
រំលាយអាហារ	rumlieyʔaahaa
ជម្រាបសួរ	cumriepsuǝ
ផ្លុំ	plom
អាកាសធាតុ	ʔaakaasaʔtʰiet
អ្នកទិញ	neaktɨɲ
សម្រេច	sɑmrac
និយាយរួម	niʔyieyruəm
អត្ថប្រយោជន៍	ʔattʰaʔprɑyaoc
ប្អូនស្រី	pʔounsrǝy
ប្រេង	preeŋ
សំណើម	sɑmnaəm
ពីក្រោម	piikraom
ជំនួយ	cumnuəy
ក្អែល	kʔael
ផ្ដេក	pdeek
ជីដូនជីតា	ciidounciitaa
ដើម	daəm
ពេលព្រឹក	peelprɨk
ស្វាយ	svaay
វាំងនន	veaŋnɔɔn
ប្រាំមួយ	prammuəy
សុភមង្គល	soʔpʰeaʔmeaŋkʊəl,soʔpʰeaʔmʊəŋkʊəl
អង្គែ	ʔɑŋkɛɛ
វីដេអូ	viideeʔou
ប៉ុណ្ណោះ	ponnɑh
ងើប	ŋəəp
ខាងក្រោយ	kʰaaŋkraoy
មុជ	muc
សង្គ្រោះ	sɑŋkrʊəh
ហើមពោះ	haǝmpʊəh
លេប	leep
ធ្វេសប្រហែស	tveehprɑhaeh
រាប	riep
សំរាម	sɑmraam
ផល	pʰɑl
ធម្មជាតិ	tʰoamʔciet,tʰoammeaʔciet
ទន្លេ	tʊənlee
សាឡេត	saaleet
អង្គុយ	ʔɑŋkuy
នំខេក	numkʰeek
លុយរាយ	luyriey
សែសិប	saesǝp
ខ្ចី	kcəy
តែម	taem
ពោះ	pʊəh
ម៉ាស៊ីនបញ្ចាំងស្លាយ	maasinbɑɲcaŋslaay
បៀម	biəm
ខាងលើ	kʰaaŋlǝǝ
នុង	nuŋ
ណេះ	neh
បញ្ហា	paɲhaa,baɲhaa
យេស	yeeh
ច្រើន	craən
ទិន្នន័យ	tɨnneaʔney
ប្រាប់	prap
រដូវប្រាំង	rɔdəvpraŋ
អ្នកស្រែ	neaksrae
ឡាបូ	laabou
ចាន	caan
សុភាពបុរស	soʔpʰiepboʔrɑh
ដៃគូសន្ទនា	daykuusɑnteaʔnie
យូរ	yuu
គូ	kuu
ស្រពោន	srɑpoon
កត់	kɑt
ឧស្សាហ៍	ʔussaa
អេធីអឹម	ʔeetʰiiʔəm
ពិធីបុណ្យ	piʔtʰiibon
ពួកខ្ញុំ	puəkkɲom
ចោរ	cao
មានណា	miennaa
អែប	ʔaep
បង្កង់	bɑŋkɑŋ
យុថ្កា	yuttkaa
លើស	lǝǝh
ជុំគ្នា	cumknie
ទំនប់ទឹក	tumnuptɨk
ប្រញាប់ប្រញាល់	prɑɲapprɑɲal
អៀម	ʔiǝm
ទឹកជំនន់	tɨkcumnʊən
ជ្រាលជ្រៅ	crielcrɨv
មិត្តប្រុស	mɨtproh
មី	mii
លុបចោល	lupcaol
ចៃដន្យ	caydɑn
វេន	veen
ប្រសិនបើ	prɑsənbaə
ព្រលឹម	prɔlɨm
ដុំ	dom
ស្រីខួច	srəykʰuəc
នាទី	nietii
ចំហៀង	cɑmhiəŋ
ទៅមុខ	tɨvmuk
ប្រតិកម្ម	prɑteʔkam
ពេទ្យ	pɛɛt
ពិតមែន	pɨtmɛɛn
បង្ហើយ	bɑŋhaəy
ខោ	kʰao
របស់	rɔbɑh
ខុស	kʰoh
អង្រែ	ʔɑŋrɛɛ
គ្រប់ទីកន្លែង	kruptiikɑnlaeŋ
ប៉ោម	paom
ស្រុកស្រែ	sroksrae
ភោជនីយដ្ឋាន	pʰooceaʔniiyeaʔtʰaan
ព្រោះ	prʊəh
ទាល់	toal
កិន	kən
ដៃខ្លី	daykləy
ខ្សោយ	ksaoy
ចិន	cən
ទាំងអស់គ្នា	teaŋʔɑhknie
ស្ងៀម	sŋiǝm
ឡាំង	laŋ
ថ្នម	tnɑɑm
ដឺម៉ង់	dəɨmɑŋ
សោភ័ណភាព	saopʰoanapʰiep
ផ្លែ	plae
ចំណេញ	cɑmnəɲ
ពាក់កណ្ដាល	peakkɑndaal
យោបល់	yoobɑl
បូនើស	bounǝǝs
ម្ទេសប្លោក	mteehplaok
ហូបចុក	houpcok
ប្រាំពីរ	prampii,prampɨl
ឯ	ʔae
សណ្ដែក	sɑndaek
ដាក់បាត្រ	dakbaat
ក្តី	kdəy
សើម	saəm
ស្រេច	srac
បាំងវាំងនន	baŋveaŋnɔɔn
ចាហួយ	caahuəy
ទើបតែ	təəptae
ហ្សែន	sɛɛn
ឈូង	cʰuuŋ
ជាមុនសិន	ciemunsən
ភ្លើង	pləəŋ
បើក	baək
ម៉ូនីទ័រ	mouniitoa
ទៅតាម	tɨvtaam
ស្កុត	skot
ប្រកួត	prɑkuət
ហាង	haaŋ
ចៀសផ្លូវ	ciəhpləv
សុវត្ថិភាព	soʔvattʰeʔpʰiep
មានការ	mienkaa
ដុស	doh
ឈើច្រត់	cʰəəcrɑt
ឆា	cʰaa
ប្រាស់	prah
សំយោគសញ្ញា	saŋyooksaɲɲaa
អាហារសម្រន់	ʔaahaasɑmrɑn
អាពាហ៍ពិពាហ៍	ʔaapiepiʔpie
ចំណាញ់	cɑmnaɲ
កំប៉ុង	kɑmpoŋ
ស៊ីម	siim
ឆ្ងាយ	cŋaay
ប្រុងប្រយ័ត្ន	proŋprɑyat
ឥឡូវនេះ	ʔəyləvnih,ʔləvnih,ʔiʔləvnih
ស្រួល	sruəl
ជ្រញ់	crʊəɲ
កូដ	kout
ងុយគេង	ŋuykeeŋ
ក្រដាស	krɑdaah
ម្លិះ	mlih
សុផល	soʔpʰɑl
បញ្ចូល	bɑɲcoul
កម្ទេចកម្ទី	kɑmtɨckɑmtii
ស៊ីណា	siinaa
សំពត់ហូល	sɑmpʊəthoul
អំបិល	ʔɑmbəl
បាក់	bak
ញ៉ាំការ	ɲamkaa
គោរព	koorup
កក់សក់	kɑksɑk
មុត	mut
ក្រុមគ្រួសារ	kromkruəsaa
សន្លឹក	sɑnlək
នាគារ	niekie
មែនទែន	mɛɛntɛɛn
រវាង	rɔvieŋ
ផងដែរ	pʰɑɑŋdae
សុភី	soʔpʰii
តម្បារ	tɑmbaa
សមរម្យ	sɑmrum
លោក	look
ចំណី	cɑmnəy
មួកសុវត្ថិភាព	muəksoʔvattʰeʔpʰiep
រួច	ruəc
ដី	dəy
បារី	baarəy,pərəy
ស្អាត	sʔaat
គូទ	kuut
ព្រមទាំង	prɔɔmteaŋ
ជាប់នឹង	coapnɨŋ
សំខាន់	sɑmkʰan
តែ	tae
ហប់	hɑp
អាគុយ	ʔaakuy
មិនសូវ	mɨnsəv
ចិញ្ចើមផ្លូវ	cəɲcaəmpləv
ចេញចូល	cəɲcoul
រពឹស	rɔpɨh
ជួប	cuəp
ភក់	pʰʊək
រាំង	reaŋ
ស្រីពេជ្រ	srǝypɨc
ងាប់	ŋoap
ហ្វែល	fael
ច្របល់	crɑbɑl
វែក	vɛɛk
បំពានច្បាប់	bɑmpiencbap
សូម្បី	soumbəy
កុំ	kom
អ្នកបម្រើ	neakbɑmraə
ពងមាន់	pɔɔŋmoan
ប្រាំពិល	prampɨl
សុជីវធម៌	soʔciiveaʔtʰoa
ជ្រះ	creah
កាត	kaat
សាកលវិទ្យាល័យ	saakɑlvittyielay
អំឡុង	ʔɑmloŋ
បំពង់ក	bɑmpʊəŋkɑɑ
សាធារណៈ	saatʰiereaʔnaʔ
ជោក	cook
ម្សិលម្ង៉ៃ	msəlmŋay
សន្ទូង	sɑntuuŋ
គ្រឿងញៀន	krɨəŋɲiən
កៀក	kiək
ស្រស់ស្រូប	srɑhsroop
ធានា	tʰienie
ចូលរួម	coulruəm
ផ្កាប់	pkap
រដូវភ្លៀង	rɔdəvpliəŋ
ខោវប៊យ	kʰaubɔɔy
បញ្ច្រាស	bɑɲcraah
ព្រួយបារម្ភ	pruəybaarɑm
ស្រូវវស្សា	srǝvvoahsaa
បក់	bɑk
ចាក់ក្រឡេក	cakkrɑleek
ខ្លួនឯង	kluənʔaeŋ
ច្រូត	crout
ក្ដារ	kdaa
ផាមួង	pʰaamuəŋ
អ្វី	ʔvəy
ចង្អើរ	cɑŋʔaə
សងខាង	sɑɑŋkʰaaŋ
ដល់ពេលបច្ចុប្បន្ន	dɑlpeelpaccopbɑn
រង្វង់	rʊəŋvʊəŋ
សំបក	sɑmbɑɑk
បច្ចុប្បន្ន	paccopbɑn
រឹងកំព្រឹស	rɨŋkɑmprɨh
ថវិកា	tʰaʔviʔkaa
ពេលខ្លះ	peelklah
អឺះ	ʔɨh
ឈប់	cʰup
បន្តិច	bɑntəc
ផ្ទុយពី	ptuypii
ត្រូវមាត់	trəvmoat
ក្លឹប	kləp
បរិស្ថាន	bɑɑreʔstʰaan
កើយ	kaəy
ប្រជែង	prɑcɛɛŋ
ម្ល៉េះ	mleh
សម្លៀកបំពាក់	sɑmliəkbɑmpeak
គម្លាត	kumliet
ម្ដងម្នាក់	mdɑɑŋmneak
មានបាន	mienbaan
ពឹងពាក់	pɨŋpeak
ទឹកក្រឡុក	tɨkkrɑlok
អ្នកណា	neaknaa
ខកចិត្ត	kʰɑɑkcət
គ្រប់	krup
លុតជង្គង់	lutcʊəŋkʊəŋ
មិនបាច់	mɨnbac
ធុំក្លិន	tʰumklən
កាយវិការ	kaayviʔkaa
ទម្ងន់	tumŋʊən
ផុត	pʰot
ម៉េប	məp
ក្អួត	kʔuət
ពេលយប់	peelyup
ម៉ូយ	mouy
កុម្ម៉ង់	kommɑŋ
គ្រឿងស្រវឹង	krɨəŋsrɑvǝŋ
ឆាប់រហ័ស	cʰaprɔhah
ជប់លៀង	cupliǝŋ
ឆែក	cʰaek
កំសៀវ	kɑmsiəv
ស្ថានភាព	stʰaanpʰiep
ត្រូវការ	trəvkaa
មិត្ត	mɨt
មាតា	miedaa
ពិសេស	piʔseh
អនុញ្ញាត	ʔaʔnuɲɲaat
ស្គែន	skɛɛn
ឫស	rɨh
កាច	kaac
ប្រព័ន្ធ	prɑpoan
ក្រឡេក	krɑleek
ធុន	tʰun
ម៉ាស៊ីនត្រជាក់	maasintrɑceak
ទម្លាក់	tumleak
ពីមុន	piimun
ថ្នាក់	tnak
ដ៏	dɑɑ
ចម្លែក	cɑmlaek
រលាក	rɔliek
រាវ	riev
ឯកសណ្ឋាន	ʔaeksɑntʰaan
ប៉ាន់ស្មាន	pansmaan
ច្រក	crɑɑk
លំបាក	lumbaak
ថ្នាំស្ពឹក	tnamspɨk
កម្រាលព្រំ	kɑmraalprum
វង្វេងផ្លូវ	vʊəŋveeŋpləv
តែងតែ	taeŋtae
មួម៉ៅ	muəmav
បូម	boum
និង	nɨŋ
សណ្ដូកជើង	sɑndoukcəəŋ
ខ្មែរ	kmae
កន្សែង	kɑnsaeŋ
ឋានៈ	tʰaanaʔ
ដូរ	dou
រថយន្ត	rʊətyʊən
ស្ករស	skɑɑsɑɑ
ប្រៃ	pray
កញ្ច្រែង	kɑɲcraeŋ
សម្បូរ	sɑmbou
ប្រើឲ្យ	praəʔaoy
ផ្ទុយទៅវិញ	ptuytɨvvɨɲ
ចាំបាច់	cambac
ដល់	dɑl
ច្រឡូកច្រឡំ	crɑloukcrɑlɑm
រឹត	rɨt
ទឹកភ្លៀង	tɨkpliəŋ
ឈ្មោះ	cmʊəh
ជាប់គ្នា	coapknie
ម៉ាក់	mak
ក្រឡេចក្រឡុច	krɑləckrɑloc
ការ៉ូ	karou
ជប៉ុន	ceaʔpon
ដឹកដៃ	dəkday
អបអរ	ʔɑɑpʔɑɑ
ទូរទស្សន៍	tuureaʔtʊəh
ថ្នល់	tnɑl,knɑl
តាសអី	taahʔəy
ពូន	puun
អន្លក់	ʔɑnlʊək
បើកចំហ	baəkcɑmhɑɑ
រែក	rɛɛk
បូក	bouk
ម្ដុំ	mdom
ឆៅ	cʰav
រៀបចំ	riəpcɑm
ដូចគ្នានឹង	doucknienɨŋ
ដំ	dɑm
គ្រប់គ្រាន់	krupkroan
ផ្ទាប់	ptoap
ដែកគោល	daekkool
ធារី	tʰierii
សំណង	sɑmnɑɑŋ
ស៊ីឈ្នួល	siicnuəl
ប៉ាក់	pak
សណ្ឋាគារ	sɑntʰaakie
អូតូម៉ាទិច	ʔoutoumaatɨc
នួក	nuək
រាក់	reak
រអិល	rɔʔəl
រួយ	ruəy
អណ្ដែតអណ្ដូង	ʔɑndaetʔɑndouŋ
ថ្មើរ	tmaə
មាត់ទន្លេ	moattʊənlee
សំឡេង	sɑmleeŋ
ទឹកមុខស្អុយ	tɨkmuksʔoy
ស្លៀកពាក់	sliǝkpeak
សាបស្រូវ	saapsrǝv
ថៃ	tʰay
ក្រោយមក	kraoymɔɔk
ក្បៀស	kbiəh
ក្ដោប	kdaop
ងើយ	ŋəəy
បើកបរ	baəkbɑɑ
វិមានឯករាជ្យ	viʔmienʔaekriec
ទើបនឹង	təəpnɨŋ
មធ្យោបាយ	matyoubaay
ដំបូង	dɑmbouŋ
រអែង	rɔʔaeŋ
កាតាប	kaataap
ក្រសួង	krɑsuəŋ
សង្គម	sɑŋkum
កៅស៊ូ	kavsuu
ហ្នឹងមែន	nɨŋmɛɛn
គោលបំណង	koolbɑmnɑɑŋ
ស្ទង់	stʊəŋ
ទះ	teah
កើន	kaən
ឧទាហរណ៍	ʔuʔtiehɑɑ
អ្នកកំប្លែង	neakkɑmplaeŋ
ជាយថាហេតុ	cieyeaʔtʰaahaet
ណាស់	nah
នៃ	ney
ពុលបាយ	pulbaay
កម្រើក	kɑmraək
ផ្លូវគោក	pləvkook
សូម	soum
បាក់តេរី	bakteerii
ភ្នំពេញ	pnumpɨɲ
ដំណាំ	dɑmnam
ម	mɔɔ
ស្កូវ	skǝv
ពរ	pɔɔ
ច្បាប់	cbap
នីតិវិធី	niiteʔviʔtʰii
រាំច្រៀង	roamcrieŋ
កោស	kaoh
កាលពីមុន	kaalpiimun
លក់	lʊək
អញ្ចេក	ʔɑɲcek
អបអរសាទរ	ʔɑɑpʔɑɑsaatɔɔ
ទទួលទាន	tɔtuəltien
រឿង	rɨəŋ
ជំងឺគ្រុនចាញ់	cumŋɨɨkruncaɲ
អុជ	ʔoc
គូសន្ទនា	kuusɑnteaʔnie
ឆូត	cʰout
យោល	yool
ជានិច្ច	cienɨc
ជជែក	cɔcɛɛk
ដប់	dɑp
ខ្ពង់ខ្ពស់	kpʊəŋkpʊəh
សង្ស័យ	sɑŋsay
ពីរណ្ដប់	piindɑp
ថែរក្សា	tʰaereaksaa
អភិវឌ្ឍ	ʔaʔpʰiʔvoat
ទំពែក	tɑmpɛɛk
ចេត្រ	caet
វះ	veah
តុក្កតា	tokkaʔtaa
របូត	rɔbout
កម្លាំង	kɑmlaŋ
កក់	kɑk
សន្សើម	sɑnsaǝm
រៀង	riəŋ
កុហក	koʔhɑk
ដឹក	dək
ដោយសារតែ	daoysaatae
ផាក	pʰaak
កុំឲ្យតែ	komʔaoytae
គល់	kʊəl
អានេះ	ʔaanih
នាំចូល	noamcoul
ប៉ិបស៊ី	pepsii
បទ	bɑt
សាច់	sac
ចំការ	cɑmkaa
ក្បាច់	kbac
មកុដ	meaʔkot,mɔkot
នឹក	nɨk
គ្រូ	kruu
សម	sɑm,sɑɑm
ជក់	cʊək
មើល	məəl
វេជ្ជសាស្ត្រ	vɨcceaʔsaah
ស្រូប	sroup
ផត	pʰɑɑt
យ៉ាងណាក៏ដោយ	yaaŋnaakɑɑdaoy
លក់ដូរ	lʊəkdou
ម្យ៉ាងម្នាក់	myaaŋmneak
បត់	bɑt
កំពង់ផែ	kɑmpʊəŋpʰae
ដោត	daot
ទេសភាព	teehsaʔpʰiep
ជ័រ	coa
ឯកសារ	ʔaekaʔsaa
អ្នករត់តុ	neakrʊəttok
ចំណាស់	cɑmnah
និយម	niʔyum
ខ្ទង់	ktʊəŋ
ញញួរ	ɲɔɲuə
វិជ្ជាពេទ្យ	vɨcciepɛɛt
ងូត	ŋuut
កណ្ដៀវ	kɑndiəv
ប៉ុណ្ណា	ponnaa
ហើយ	haǝy
ក្រុម	krom
ម៉ែ	mae
ផ្អែក	pʔaek
ខ្លួន	kluən
ហា	haa
ត្រសក់	trɑsɑk
ព័ទ្ធ	poat
កោរ	kao
ព្រះពុទ្ធសាសនា	preahputsaasnaa
សាប៊ូដុសខ្លួន	saabuudohkluən
អាសយដ្ឋាន	ʔaasaʔyattʰaan
ស្ពាយ	spiey
គិតលុយ	kɨtluy
វះកាត់	veahkat
ដរាបណា	dɑɑriepnaa
មនុស្ស	meaʔnuh,mɔnuh
ទៅដល់	tɨvdɑl
ទឹកត្រី	tɨktrəy
ប្រាំបួន	prambuən
រោទ៍	roo
វេជ្ជបណ្ឌិត	vɨcceaʔbɑndɨt
កន្លែងធ្វើការ	kɑnlaeŋtvəəkaa
ពិន័យ	piʔney
ចម្លើយ	cɑmlaəy
ត្រៀម	triəm
ហ្គូហ្គល	kuukɔɔl
សម្លប្រហើរ	sɑmlɑɑprɑhaə
រាស់	roah
ពរ្សឺឡែន	poasəɨlaen,pɔɔksəɨlaen
គិត	kɨt
មិនខាន	mɨnkʰaan
ង៉ៃ	ŋay
បញ្ឈប់	bɑɲcʰup
ងាយស្រួល	ŋieysruǝl
សុភា	soʔpʰie
ក្លែប	klaep
លាក់បាំង	leakbaŋ
ស្ទះ	steah
បង្ហូត	bɑŋhoot
អន្ធិល	ʔɑntʰɨl
ថយក្រោយ	tʰɑɑykraoy
ប្រព្រឹត្ត	prɑprɨt
ស៊ូគីស៊ុប	suukiisup
ចង្កេះ	cɑŋkeh
ប៉ាត	paat
បន្ថែម	bɑntʰaem
ពិសា	piisaa,piʔsaa
រុំ	rum
ជំនួស	cumnuəh
ធាតុ	tʰiet
ឈើ	cʰəə
កុំអាល	komʔaal
សាច	saac
ក្រាស	kraah
នាំ	noam
គំនូរ	kumnuu
និវាសដ្ឋាន	niʔviesattʰaan
ធុញថប់	tʰuɲtʰɑp
បន្ទាប់	bɑntoap
សីតុណ្ហភាព	səytonhaʔpʰiep
ញាស់	ɲoah
តម្រង់	tɑmrɑŋ
សែង	saeŋ
ខាប់	kʰap
ថ្ពក់	tpʊək
ចែករំលែក	caekrumlɛɛk
ប	bɑɑ
ប្រែប្រួល	praepruəl
មានអី	mienʔəy
ថ្ងៃកំណើត	tŋaykɑmnaət
ផ្លាស់	plah
គ្លីនិក	kliinək
លឿង	lɨəŋ
ឡែក	laek
ថូ	tʰou
អូ	ʔou
ចុងភៅ	coŋpʰɨv
រាង	rieŋ
ឯកា	ʔaekaa
គត់	kʊət
ទោះបីជា	tʊəhbəycie
ឌីជីថល	diiciitʰɑɑl
ហេតុអ្វី	haetʔvǝy
សំបុត្រ	sɑmbot
សំណាង	sɑmnaaŋ
សង្ហា	sɑŋhaa
ប្រថុយ	prɑtʰoy
ជើងម៉ា	cəəŋmaa
ផ្លូវថ្នល់	pləvtnɑl
ចៀសវាង	ciəhvieŋ
ឈឺ	cʰɨɨ
ទាប	tiep
ទល់	tʊəl
អនឡាញ	ʔɑɑnlaaɲ
រសជាតិ	rʊəhciet
កម្ដៅ	kɑmdav
ចិញ្ចើមថ្នល់	cəɲcaəmtnɑl,cəɲcaəmknɑl
សេវាកម្ម	seeviekam,seevaakam
នៅ	nɨv
ខឹង	kʰəŋ
ឱបដៃ	ʔaopday
បន្ទះ	bɑnteah
ប្រមូល	prɑmoul
ខុសៗគ្នា	kʰohkʰohknie
ភស្តុតាង	pʰoahtaaŋ
ទីកន្លែង	tiikɑnlaeŋ
ផ្ទាល់ខ្លួន	ptoalkluən
អ្នកទទួលភ្ញៀវ	neaktɔtuəlpɲiəv
សិត	sət
មណ្ឌល	mʊəndʊəl
ស្រង់មតិ	srɑŋmeaʔteʔ
ឈាងចូលលេង	cʰieŋcoulleeŋ
វាល់	voal
ហូត	hout
បេះបិទ	behbət
ច្រាស	craah
ត្រឹម	trəm
ស៊ក	sɔɔk
ជាក់ស្ដែង	ceaksdaeŋ
រហែក	rɔhaek
សុំទោស	somtooh
ដោនឡូត	daonlout
បងប្អូនជីដូន	bɑɑŋpʔounciidoun
ដុល្លារ	dollaa
ប៉ុនណា	ponnaa
លម្អ	lumʔɑɑ
បន្ទាន់	bɑntoan
ធំ	tʰom
គ្រែ	krɛɛ
ស្លាបព្រា	slaapprie
ស្ដុក	sdok
បំពង់បឺត	bɑmpʊəŋbəɨt
កន្ត្រៃ	kɑntray
ក្រោម	kraom
ចែវ	caev
ចុម	com
ប៊ូតុង	buutoŋ
អត់អីទេ	ʔɑtʔəytee
ហ្វាន់តា	fantaa
អត់ដែល	ʔɑtdael
មិនដែល	mɨndael
ពាក់	peak
ជូន	cuun
កន្លះ	kɑnlah
រនាំង	rɔneaŋ
អំពើល្អ	ʔɑmpǝǝlʔɑɑ
បែនស្រូវ	baensrǝv
ពេល	peel
បាសក	baasɑk
ខ្ទឹម	ktɨm
ចំនួន	cɑmnuən
ពាក្យមុសា	piekmuʔsaa
របស់របរ	rɔbɑhrɔbɑɑ
កូន	koun
រាំ	roam
ស្រៈ	sraʔ
គេងលក់	keeŋlʊək
អង្ករដំណើប	ʔɑŋkɑɑdɑmnaəp
លីអូ	liiʔou
មានប្រសាសន៍	mienprɑsaah
ខ្ទេច	ktɨc
ទុកចោល	tukcaol
អនាម័យ	ʔaʔnaamay
កន្ត្រៃកាត់ក្រចក	kɑntraykatkrɑcɑɑk
ស្វ័យប្រវត្តិ	svayprɑvoat
ទោះជា	tʊəhcie
មាន់	moan
កាំភ្លើង	kampləəŋ
ទុរេន	tʰuureen,tuʔreen
រំលែក	rumlɛɛk
បន្តុប	bɑntop
ស្រង់	srɑŋ
អាខោន	ʔaakʰaon
បញ្ជោរ	bɑɲcoo
ត្រីអណ្ដែង	trəyʔɑndaeŋ
ទុក្ខ	tuk,tukkʰaʔ
ច	cɑɑ
ឃាត់	kʰoat
ម្ដងៗ	mdɑɑŋmdɑɑŋ
ខាងកើត	kʰaaŋkaət
ថ្ពាល់	tpoal
ប្រធាន	prɑtʰien
បាយ	baay
បង្គន់	bɑŋkʊən
ឲ្យពរ	ʔaoypɔɔ
បរិវេណ	bɑɑreʔveen
អ្នកជំងឺ	neakcumŋɨɨ
បាងកក	baaŋkɑɑk
ស	sɑɑ
ធ្មេញ	tmɨɲ
អាវ	ʔaav
គ្រប	krɔɔp
អូស	ʔouh
ប្រគេន	prɑkeen
ចេះតែ	cehtae
ឆ្ងល់	cŋɑl
គ្រាមភាសា	kriempʰiesaa
ទៅកាន់	tɨvkan
ទីក្រុង	tiikroŋ
ប្រៃសណីយ៍	praysaʔnii
ស្រឡេវ	srɑleev
ទាក់	teak
អាសន្នអន្ធក្រ	ʔaasɑnʔɑnkrɑɑ
ហេតុផល	haetpʰɑl
អាប់ឱនកិត្តិយស	ʔapʔaonketteʔyʊəh
ទឹកក្រូច	tɨkkrouc
នុះ	nuh
អ៊ី	ʔii
ហ្វ្រង់កា	frɑŋkaa
ចូក	couk
រស្មី	reaʔsməy
ព្រៃ	prey
ចាប់	cap
បាទ	baat
ផ្លូវទាល់	pləvtoal
ប្រើ	praə
ស្រែក	sraek
ទូច	tuuc
អ្នកទទួល	neaktɔtuəl
ផ្កាឈូក	pkaacʰuuk
រំខាន	rumkʰaan
ទឹកមុខ	tɨkmuk
មុខងារ	mukŋie
ពុលរលក	pulrɔlɔɔk
ល្ហុង	lhoŋ
សាវម៉ាវ	saavmaav
ថី	tʰəy
រលត់	rɔlʊət
លទ្ធផល	lattʰeaʔpʰɑl
តែងសេចក្តី	taeŋsəckdəy
សម្រាប់	sɑmrap
ថៅកែ	tʰavkae
ផ្សាយ	psaay
អក្សរ	ʔaksɑɑ
សម្រួល	sɑmruǝl
ចរាចរណ៍	cɑraacɑɑ
ខែ	kʰae
ស្រស់បំព្រង	srɑhbɑmprɔɔŋ
រនាស់	rɔnoah
ក្រដាសឡាំង	krɑdaahlaŋ
អាហារ	ʔaahaa
ឈ្ងៀម	cŋiəm
ប៉ុន្តែ	pontae
ក្អឿក	kʔɨək
ខ្លះ	klah
ជាប់	coap
កាវ	kaav
តម្កល់	tɑmkɑl
មូស	muuh
ស្ថានទូត	stʰaantuut
ម្យ៉ាងទៀត	myaaŋtiət
ថ្ងាស	tŋah
កំពុងតែ	kɑmpuŋtae
ហេតុ	haet
នូវ	nɨv
ដណ្ដើម	dɑndaəm
ទុក	tuk
ច្បាស់លាស់	cbahloah
មុខរបរ	mukrɔbɑɑ
អូន	ʔoun
ទំនិញ	tumnɨɲ
មុខរបួស	mukrɔbuəh
កម្ពស់	kɑmpʊəh
ម្ទេស	mteeh
បង្គោល	bɑŋkool
បន្តិចបន្តួច	bɑntəcbɑntuəc
ង៉ៃអាទិត្យ	ŋayʔaatɨt
អីវ៉ាន់	ʔəyvan
និមល	niʔmʊəl
វិធី	viʔtʰii
សុភ័ក្រ	soʔpʰeak
អឺរ៉ុប	ʔəɨrop
ណែនាំ	naenoam
ត្រើយម្ខាង	traəymkʰaaŋ
ម៉ូតូឌុប	moutoudup
ចូលឆ្នាំ	coulcnam
ស្ដាយ	sdaay
ដាច់	dac
ចោលឈូង	caolcʰuuŋ
ស្មៅ	smav
ឡូយ	looy
ពិសិដ្ឋ	piʔsət
កខ្វក់	kɑkvɑk
សា	saa
អត់សូវ	ʔɑtsəv
ប្រាំបី	prambəy
កម្ពុជា	kampuʔcie
ខាងមុខ	kʰaaŋmuk
ប្ដូរ	pdou
គ្រុនចាញ់	kruncaɲ
កំពប់	kɑmpup
ផ្ទាំង	pteaŋ
មេដៃ	meeday
ពីងពាង	piiŋpieŋ
អូហ្វីស	oufiih
បោក	baok
ខាន	kʰaan
ពិន្ទុ	pɨntuʔ
ឡើយ	laəy
អំណោយ	ʔɑmnaoy
មុននឹង	munnɨŋ
ទីនោះ	tiinuh
ជូរ	cuu
ចុច	coc
ប៉ិន	pən
ដូចចង់	douccɑŋ
មកពី	mɔɔkpii
ស្លាប់	slap
ស្តាយ	staay
ឆ្លើយ	claəy
ភ្ជួរ	pcuə
ល្ងាច	lŋiec
កន្និកា	kɑnnikaa
ម្ចាស់	mcah
កាដូ	kaadou
ទៀតសោត	tiətsaot
ដំណោះស្រាយ	dɑmnɑhsraay
ភ្លេចដៃ	plɨcday
រថភ្លើង	rʊətpləəŋ
ថ្ងៃស្អែក	tŋaysʔaek
ន	nɔɔ
ភួយ	pʰuəy
នៅមុខ	nɨvmuk
ហាន់	han
លឿន	lɨən
សារ	saaraʔ,saa
ខាត	kʰaat
ស្អុយ	sʔoy
គាត់	koat
តាម	taam
គ្រួសារ	kruəsaa
ទៀត	tiət
ពិធី	piʔtʰii
ទឹកជ្រលក់	tɨkcrɔlʊək
ជីតា	ciitaa
ទេ	tee
អង្គចងចាំ	ʔɑŋcɑɑŋcam
មកដល់	mɔɔkdɑl
ភ្លៀង	pliəŋ
ទូលាយ	tuuliey
ពន្លិច	pʊənlɨc
លង់	lʊəŋ
ក្រូចសើច	kroucsaǝc
វ៉ាយហ៉្វាយ	waayfaay
ដំណើរការ	dɑmnaəkaa
ធុងសំរាម	tʰuŋsɑmraam
ព្រះ	preah
បង្អែម	bɑŋʔaem
បាតដៃ	baatday
ស្តាតអូឡាំពិក	staatʔoulampɨk
ដើម្បី	daəmbəy
ន័យ	ney
លំហែ	lumhae,rumhae
ពាង	pieŋ
ចេញ	cəɲ
ស្រស់	srɑh
មុខស្អុយ	muksʔoy
ផ្ដើម	pdaəm
ទន់	tʊən
រួម	ruəm
ធ្ងន់	tŋʊən
ស្អី	sʔǝy
រញ៉េរញ៉ៃ	rɔɲeerɔɲay
មរកត	meaʔreaʔkɑt,mɔrəkɑt
ព្រោះអី	prʊəhʔəy
ឆ្អឹង	cʔəŋ
ភ្លេង	pleeŋ
ស្រស់ស្អាត	srɑhsʔaat
រដូវក្ដៅ	rɔdəvkdav
ប្រឡាក់	prɑlak
ដាក់បណ្ដាសា	dakbɑndaasaa
ជំងឺ	cumŋɨɨ
យល់សប្តិ	yʊəlsɑp
អាកប្បកិរិយា	ʔaakappaʔkeʔriʔyaa
ដោយសារ	daoysaa
អេ៎អី	ʔeeʔəy
កន្ទក់	kɑntʊək
តែងខ្លួន	taeŋkluən
ចម្លាក់	cɑmlak
សាប	saap
សំ	sɑm
អាឡូ	ʔaalou
ផ្ដុំ	pdom
បន្ថយ	bɑntʰɑɑy
ជំហាន	cumhien
រ៉ឺម៉ក	rəɨmɑɑk
រយ	rɔɔy
ម៉ាន	maan
កេះ	keh
ថត	tʰɑɑt
ប៉ះចំ	pahcɑm
សម្គាល់	sɑmkoal
ខ្នង	knɑɑŋ
ស្លន់ស្លោ	slanslao
បុគ្គលិក	bokkeaʔlɨk
ខាងក្រោម	kʰaaŋkraom
ទាំងនោះ	teaŋnuh
កំពត	kɑmpɔɔt
បាតសមុទ្រ	baatsaʔmot
នីតា	niitaa
បីសាច	bəysaac
តក់ស្លុត	tɑkslot
រ៉ាប់រង	raprɔɔŋ
ទូ	tuu
សើច	saəc
ឲ្យតែ	ʔaoytae
គម្រោង	kumrooŋ
សេវា	seevie,seevaa
មិត្តស្រី	mɨtsrəy
ថ្លឹង	tləŋ
ខុសច្បាប់	kʰohcbap
ហិត	hǝt
ឧបសគ្គ	ʔuʔpaʔsak
សំណង់	sɑmnɑŋ
ចត	cɑɑt
លាង	lieŋ
ស្រី	srəy
បន់	bɑn
កម្ទេច	kɑmtɨc
ខំប្រឹង	kʰɑmprəŋ
រលាស់	rɔloah
ម៉ាក	maak
ដាក់	dak
អង្សា	ʔɑŋsaa
ចង	cɑɑŋ
បបួល	bɑbuəl
គ្រាន់តែ	kroantae
តាមដាន	taamdaan
បំពង	bɑmpɔɔŋ
អ៊ីអន	ʔiiʔɑɑn
ដឹងគុណ	dəŋkun
ទាន	tien
ប្រេន	breen
គ្រឿងទេស	krɨəŋteeh
ឆ្នាំង	cnaŋ
បេតុង	beetoŋ
គួរសម	kuəsɑɑm
ខ្លួនប្រាណ	kluənpraan
ប្រឡោះ	prɑlɑh
ទឹកម៉ាស៊ីន	tɨkmaasin
ដើរ	daə
ជាទូទៅ	cietuutəv
ប្រលែង	prɑlaeŋ
កាត់ចិត្ត	katcət
ភ្លេច	plɨc
ខះក	kʰahkɑɑ
កាកសំណល់	kaaksɑmnɑl
វ៉ែនតា	vaentaa
ភ័យ	pʰey
ហាម	haam
បែប	baep
ហេមប័រហ្គឹរ	hemboakɨ
ស្មើគ្នា	smaǝknie
ដើមដៃ	daəmday
បៃតង	baytɑɑŋ
កែ	kae
រាល់តែដង	roaltaedɑɑŋ
តង់	tɑŋ
ឥដ្ឋ	ʔət
កាលពីក្មេង	kaalpiikmeeŋ
គោលដៅ	kooldav
គរ	kɔɔ
តាស	taah
ថង់	tʰɑŋ
លុះ	luh
អ្នករត់ម៉ូតូឌុប	neakrʊətmoutoudup
ពុក	puk
ខិតខំ	kʰətkʰɑm
បង្អែក	bɑŋʔaek
រដ្ឋ	roat
ចុងសប្តាហ៍	coŋsappdaa
ឈរ	cʰɔɔ
ក្មេងស្រី	kmeeŋsrǝy
ចាន់	can
វចនានុក្រម	veaʔcaʔnaanuʔkrɑm
ទ្រ	trɔɔ
មុន	mun
ហើយដៃ	haǝyday
ក្រាប	kraap
ឡាន	laan
ថ្មី	tməy
បង្វិល	bɑŋvəl
តុំយ៉ាំ	tomyam
សឹង	səŋ
ទាល់តែ	toaltae
ជាងគេ	cieŋkee
រស់នៅ	rʊəhnɨv
ជា	cie
ពុំសូវ	pumsəv
តម្រូវ	tɑmrəv
ចានដែក	caandaek
ស្តង់	stɑŋ
ត្រឡាច	trɑlaac
ប្តី	pdəy
កាត់	kat
បន្លែ	bɑnlae
ពន្យល់	pʊənyʊəl
ជីរ	cii
ពូនភ្នំ	puunpnum
កូរពោះ	koupʊəh
ចំណងដៃ	cɑmnɑɑŋday
ហុត	hot
ផ្ដាសាយ	pdaasaay
ជាមួយ	ciemuəy
គូស	kuuh
សំណាប	sɑmnaap
សូត្រ	sout
កំប៉ិត	kɑmpət
អំពី	ʔɑmpii
ជ្រួសគ្នា	cruəhknie
សម្ភាសន៍	sɑmpʰieh
អក្សរកាត់	ʔaksɑɑkat
ល្វីង	lviiŋ
ជាតិ	ciet
សំណួរ	sɑmnuə
ខ្សែពួរ	ksaepuə
ប្រេងខ្យល់	preeŋkcɑl,preeŋkyɑl
គណនេយ្យ	keaʔnaʔnəy,kʊənnaʔney
កន្ទេល	kɑnteel
ស្រីរ័ត្ន	srəyroat
អ្នករត់សំបុត្រ	neakrʊətsɑmbot
បង់លុយ	bɑŋluy
ប្រឡេះ	prɑleh
រតនា	reaʔtaʔnaa
កីឡា	kəylaa
ស្រួលខ្លួន	sruǝlkluən
រំភើប	rumpʰəəp
ចប់	cɑp
អប	ʔɑɑp
ពូជ	puuc
ធ្វើមុខ	tvəəmuk
ហ្មត់ចត់	mɑtcɑt
រះ	reah
ធានារ៉ាប់រង	tʰienieraprɔɔŋ
វិល	vɨl
ស្នួ	snuə
សាន	saan
ខំ	kʰɑm
ទឹកលិច	tɨklɨc
រាវចាន	rievcaan
ចាប់ពី	cappii
ប្រសិទ្ធិភាព	prɑsəttʰiʔpʰiep,prɑsettʰiʔpʰiep
ជន់	cʊən
គួរតែ	kuətae
ដឹកជញ្ជូន	dəkcʊəɲcuun
បំភ្លឺ	bɑmplɨɨ
ចន្លោះ	cɑnlɑh
ទូរស័ព្ទ	tuureaʔsap
ទាន់	toan
បាន	baan
មែន	mɛɛn
លាងមាត់	lieŋmoat
ខ្សាច់	ksac
ផ្លាកតម្លៃ	plaaktɑmlay
គ	kɔɔ
វិច្ឆិកា	vɨcceʔkaa
រហ័ស	rɔhah
ជ្រូក	cruuk
ទាំងអស់	teaŋʔɑh
ស៊េរី	seerii
អូខេ	ʔoukʰee
ចម្ងាយ	cɑmŋaay
របង	rɔbɑɑŋ
បបូរមាត់	bɑboumoat
ខ្នើយ	knaəy
គេង	keeŋ
សត្វ	sat
សកម្មភាព	saʔkammeaʔpʰiep
រៀបរាប់	riəproap
កូនស្រី	kounsrǝy
ផែ	pʰae
សាមីខ្លួន	saamǝykluən
ភ្ជាប់	pcoap
ប្រយ័ត្ន	prɑyat
អរុណសួស្ដី	ʔaʔrunsuǝsdǝy
មួយទឹក	muəytɨk
សាច់ញាតិ	sacɲiet
អាយហ្វូន	ʔaayfoun
បិណ្ឌបាត	bənbaat
ស្រស់ស្រាយ	srɑhsraay
បុណ្យ	bon
អាន	ʔaan
ញញឹម	ɲɔɲɨm
ង៉ៃហ្នឹង	ŋaynɨŋ
ខូចខ្លួន	kʰouckluən
ថ្ងៃអាទិត្យ	tŋayʔaatɨt
កណ្ដាល	kɑndaal
ភ្នំបូកគោ	pnumboukkoo
ថ្ងៃក្រោយ	tŋaykraoy
រណារ	rɔnaa
បាយៗ	baaybaay
ព្រឹកមិញ	prɨkmɨɲ
ពាក្យសំដី	pieksɑmdəy
ស៊ុប	sup
ប្រើប្រាស់	praəprah
គគ្រិច	kɔkrɨc
សរុប	saʔrop
វិន័យ	viʔney
អំពៅ	ʔɑmpɨv
សាមញ្ញ	saamaɲ
រួសរាន់	ruəhroan
ពូក	puuk
ក្រូចថ្លុង	krouctloŋ
គ្នា	knie
សណ្ដាប់ធ្នាប់	sɑndaptnoap
ដូច្នេះ	doucneh
ខាងលិច	kʰaaŋlɨc
វ័យ	vey
តិចតួច	təctuəc
ប្រាំ	pram
ទាំងស្រុង	teaŋsroŋ
បោះចោល	bɑhcaol
ទូកញ្ចក់	tuukɑɲcɑk
បង្ខំ	bɑŋkʰɑm
ភ្ជួរស្រែ	pcuəsrae
ពេជ្រ	pɨc
ស្រប	srɑɑp
ហួត	huət
រហូត	rɔhout
រីក	riik
ចង្កូត	cɑŋkout
សិក្សា	səksaa
ជ្រុង	cruŋ
ប្រសិន	prɑsən
រមណីយដ្ឋាន	reaʔmeaʔniiyeaʔtʰaan
សូត្រធម៌	souttʰoa
បើសិនជា	baəsəncie
ស៊ីម៉ងត៍	siimɑŋ
ជាមុន	ciemun
ប្រមាណ	prɑmaan
បៀតបៀន	biətbiən
យ៉ាងតិច	yaaŋtəc
បញ្ចប់	bɑɲcɑp
សុខ	sok
អាក់អន់ស្រពន់ចិត្ត	ʔakʔɑnsrɑpʊəncət
គ្មាន	kmien
ខោទ្រនាប់	kʰaotrɔnoap
សញ្ញា	saɲɲaa
ពន្ធធនាគារ	pʊəntʰeaʔniekie
ដៃអាវ	dayʔaav
អាការៈ	ʔaakaaraʔ,ʔaakaa
អង្កាល់	ʔɑŋkaal
ទឹកកក	tɨkkɑɑ
ត្រីរ៉ស់	trəyrɑh
ហ្មត់	mɑt
ហ្ន៎	nɑɑ
សុខា	soʔkʰaa
ព្រះអាទិត្យ	preahʔaatɨt
មុខតំណ	mukdɑmnɑɑ
រចនាបថ	reaʔcaʔnaabɑt
ថ្នាក់រៀន	tnakriən
ជនរងគ្រោះ	cɔɔnrɔɔŋkrʊək
បញ្ជា	bɑɲcie
ឧបាសក	ʔuʔbaasɑk
បណ្ដាញសង្គម	bɑndaaɲsɑŋkum
ចំរើន	cɑmraən
ឈុត	cʰut
ម្រាមនាងដៃ	mriemnieŋday
ចេះ	ceh
ផ្ញើ	pɲaə
ឆ្កួត	ckuət
សរសៃ	sɑɑsay,təsay
អីទៅ	ʔəytɨv
ស្បែកជើង	sbaekcǝǝŋ
ជួន	cuən
ស៊ិន	sin
អាំង	ʔaŋ
រដូវត្រជាក់	rɔdəvtrɑceak
អីចឹង	ʔəycəŋ
មូសដែកគោល	muuhdaekkool
គ្រូក	kruuk
ចិត្ត	cət
ស្លឹក	slək
រៀម	riəm
លំនឹង	lumnɨŋ
ដណ្ដប់	dɑndɑp
សេរ៉ូម	seeroum
ប្រជាជន	prɑciecʊən
អាឡែងតា	ʔaalaeŋtaa
ថូហ្វល	tʰoufɑl
ឆ្អែត	cʔaet
អំបែង	ʔɑmbaeŋ
ម៉ឺន	məɨn
ត្រង	trɑɑŋ
សួស្ដី	suǝsdǝy
ឈ្មោះហៅក្រៅ	cmʊəhhavkrav
អីគេ	ʔəykee
កូពី	koupii
ម្ជូរ	mcuu
ង៉ៃសុក្រ	ŋaysok
ជំនាន់	cumnoan
ស្ថាប័ន	stʰaaban
មុខមាត់	mukmoat
មេរៀន	meeriən
អត់ទៀង	ʔɑttiəŋ
គ្រូពេទ្យ	kruupɛɛt
សោភា	saopʰie
វេច	vɨc
ជនបទ	cɔɔnbɑt,cʊəneaʔbɑt
អរគុណ	ʔɑɑkun
នាឡិការោទ៍	nieliʔkaaroo
ស៊ីក្លូ	siiklou
ខ្មៅ	kmav
ចីពរ	ciipɔɔ
កាសែត	kaasaet
កាបូប	kaaboup
មានន័យ	mienney
សុខភាព	sokkʰapʰiep
មើលឃើញ	məəlkʰəəɲ
ស្គ្រីន	skriin
ត្រឡប់ត្រឡិន	trɑlɑptrɑlən
ក្រឹម	krəm
ប៉ុន	pon
ជណ្ដើរ	cʊəndaə
ស្ថានីយ	stʰaanii
ចិត	cət
ប្រកបរបរ	prɑkɑɑprɔbɑɑ
បស់	bɑh
ហៀរសំបោរ	hiǝsɑmbao
ព្យញ្ជនៈ	pyʊəɲceaʔneaʔ
អាពួកម៉ាក	ʔaapuəkmaak
ក្បួន	kbuən
ស្ល	slɑɑ
ភ្លឺ	plɨɨ
ឆ្លៀត	cliət
ស្លៀក	sliək
ធ្វើដំណើរ	tvəədɑmnaə
ចោរកម្ម	caokam
មាន	mien
អផ្សុក	ʔapsok
ដែល	dael
សេះ	seh
ប្រជាប្រិយ	prɑcieprəy
ញើស	ɲəəh
ជំងឺគ្រុនឈាម	cumŋɨɨkruncʰiem
ប្រកាច់	prɑkac
វៀតណាម	viətnaam
ហ្គេម	kɛɛm,keem
សមុទ្រ	saʔmot
ចង្ហាន់	cɑŋhan
ម៉េចក៏	məckɑɑ
បោះ	bɑh
ទឹកដោះគោ	tɨkdɑhkoo
មាត់ច្រាំង	moatcraŋ
ច្បាស់	cbah
រក	rɔɔk
ដាណែត	daanaet
ជួបគ្នា	cuəpknie
អន្ទិត	ʔɑntɨt
មិនអីទេ	mɨnʔəytee
ឮសូរ	lɨɨsou
ឆ្ពោះ	cpʊəh
សុខៗ	soksok
បង្ហាញខ្លួន	bɑŋhaaɲkluən
គ្រាប់	kroap
ជ្រាបចូល	criepcoul
ព្រីន	priin
អូយ	ʔooy
ត្រា	traa
លង់លក់	lʊəŋlʊək
យាម	yiem
គ្រឿង	krɨəŋ
បន្ត	bɑntɑɑ
ធ្យូង	tyuuŋ,kcuuŋ
ហាក់ដូចជា	hakdouccie
ទឹកដក់	tɨkdɑk
ម្រាម	mriem
បម្រើ	bɑmraə
ចេក	ceek
អញ្ចឹង	ʔɑɲcəŋ
ក្រពះ	krɑpeah
អារក្សអ្នកតា	ʔaarakneaktaa,ʔaareakneaktaa
ស្ងួត	sŋuət
ហូល	houl
កាទឹក	kaatɨk
វង្វេង	vʊəŋveeŋ
ខក	kʰɑɑk
ត្បៀត	tbiət
ឥឡូវ	ʔləv,ʔəyləv,ʔiʔləv
