بچووک	.bi.çûk
باوەڕ	.ba.weř
سەرکەوتووەکانی	.ser.kew.tu.we.ka.nî
خوێندوویانە	.xwên.dû.ya.ne
کۆبوونەوەگەلێک	.ko.bû.ne.we.ge.lêk
بەخێرایی	.be.xê.ra.yî
هاشمی	.ha.şi.mî
لەکۆتایی	.le.ko.ta.yî
فکری	.fik.rî
پێشووی	.pê.şûy
چاپخانەی	.çap.xa.ney
دیاربەکردا	.dyar.be.kir.da
کەمبوونەوەی	.kem.bû.ne.wey
هێشتا	.hêş.ta
ئەرک	.ʔerk
کچان	.ki.çan
وشک	.wişk
ئیلهام	.ʔîl.ham
رەچاونەگرتنی	.re.çaw.ne.gir.ti.nî
بهێنرێت	.bi.hên.rêt
خاوەنەکانیان	.xa.we.ne.kan.yan
شان	.şan
بنووسین	.bi.nû.sîn
بارودۆخێکدا	.ba.ru.do.xêk.da
ناسێندرابوون	.na.sên.di.ra.bûn
پێداویستیگەلە	.pê.da.wîs.tî.ge.le
هەڵبژارد	.heł.bi.jard
ببات	.bi.bat
ناردنی	.nar.di.nî
هاوسەرەکەی	.haw.se.re.key
سەرکەوتنی	.ser.kew.ti.nî
یەکێتی	.ye.kê.tî
هیچت	.hî.çit
بیروبۆچوونی	.bî.ru.bo.çû.nî
گورجییەکان	.gur.cî.ye.kan
پەسەندکردنی	.pe.send.kir.di.nî,.pe.send.kird.nî
لەوێوە	.le.wê.we
پشتیوانی	.piş.tî.wa.nî
بەردەست	.ber.dest
چاوی	.ça.wî
پۆستە	.pos.te
خوێنەرە	.xwê.ne.re
کۆمەڵایەتییەکان	.ko.me.ła.ye.tî.ye.kan
خۆتێوەردانی	.xo.tê.wer.da.nî
رەچاو	.re.çaw
پرسیارکردن	.pirs.yar.kir.din
بووبێت	.bû.bêt
رۆژاواش	.ro.ja.waş
مۆلیەر	.mol.yer
دادئەستێنیی	.dad.ʔes.tê.nîy
کۆمەڵکوژی	.ko.meł.ku.jî
بگاتە	.bi.ga.te
قازانجەکە	.qa.zan.ce.ke
هەرگیز	.her.gîz
کتێبانەن	.ki.tê.ba.nen
گۆڕینی	.go.řî.nî
توانیان	.twan.yan
منداڵەکانیان	.min.da.łe.kan.yan
هەڵگرت	.heł.girt
پێداچوونەوەکانی	.pê.da.çû.ne.we.ka.nî
هەڵگوێزانی	.heł.gwê.za.nî
خولەکە	.xu.le.ke
بردبوو	.bir.di.bû
کۆچی	.ko.çî
کورتە	.kur.te
وەردەگیرا	.wer.de.gî.ra
مۆبایل	.mo.bayl
بران	.bi.ran
بێزار	.bê.zar
داشکانێکی	.da.şi.ka.nê.kî
شیان	.şyan
فەرهەنگی	.fer.hen.gî
بەوەدا	.be.we.da
دان	.dan
دەمهەوێ	.dem.he.wê
چەشنێکی	.çeş.nê.kî
بابەتێکی	.ba.be.tê.kî
دەسەڵاتێکی	.de.se.ła.tê.kî
ماڵپەڕیان	.mał.peř.yan
بیروبۆچوونەکانی	.bî.ru.bo.çû.ne.ka.nî
ئیتر	.ʔî.tir
دەیگوت	.dey.gut
چ	.çi
بازرگانانە	.ba.zir.ga.na.ne
گوتەی	.gu.tey
تشرینی	.tiş.rî.nî
رێیپێدەدرێ	.rêy.pê.de.di.rê
پەیامنێر	.pe.yam.nêr
ئاقارەدا	.ʔa.qa.re.da
پێوە	.pê.we
چەپ	.çep
دەربڕینی	.der.bi.řî.nî
جوانتان	.cwan.tan
نامۆ	.na.mo
کەمی	.ke.mî
بەڕێوەدەبران	.be.řê.we.de.bi.ran
بەدواوە	.be.dwa.we
سمایل	.si.mayl
مەیلی	.mey.lî
ناڕاست	.na.řast
دابێت	.da.bêt
وەردەگرێ	.wer.de.gi.rê
پشتگریان	.pişt.gir.yan
مێردین	.mêr.dîn
دەڤەرە	.de.ve.re
لەهەرێمی	.le.he.rê.mî
نوێنەران	.nwê.ne.ran
دووەم	.du.wem
کڕیوە	.ki.řî.we
گرنگتر	.gi.ring.tir
یاسایی کردنی	.ya.sa.yî.kir.di.nî
هەندێکیان	.hen.dêk.yan
یاریزانە	.ya.rî.za.ne
پێکهاتەی	.pêk.ha.tey
ئێن	.ʔên
نووسرابوون	.nûs.ra.bûn
بەرپرسیارێتی	.ber.pirs.ya.rê.tî
مایەوە	.ma.ye.we
پیاوێکی	.pya.wê.kî
دەشتوانێ	.deş.twa.nê
کلۆبی	.ki.lo.bî
لەگەڵە	.le.ge.łe
دەیانگوت	.de.yan.gut
پارێزگای	.pa.rêz.gay
دواتر	.dwa.tir
جێگە	.cê.ge
تونس	.tu.nis
تەمەنیان	.te.men.yan
سەرمایەی	.ser.ma.yey
سیستەمە	.sîs.te.me
مرۆڤێک	.mi.ro.vêk
رۆژێک	.ro.jêk
چوونە	.çû.ne
کارە	.ka.re
ئەلعەرەب	.ʔel.ƹe.reb
رێکبخەن	.rêk.bi.xen
لەو	.lew
ڕەهەندی	.ře.hen.dî
مەبەستەش	.me.bes.teş
رستەکانی	.ris.te.ka.nî
ساڵانەی	.sa.ła.ney
زازاییش	.za.za.yîş
موحسین	.muḧ.sîn
پشتگری	.pişt.gi.rî
ئەمڕۆی	.ʔem.řoy
نیگەران	.nî.ge.ran
نووسەرانەدا	.nû.se.ra.ne.da
پەراوێز	.pe.ra.wêz
کۆمەڵناس	.ko.meł.nas
ڕاستییەکان	.řas.tî.ye.kan
لێکرا	.lê.ki.ra
نێوبراوەکاندا	.nêw.bi.ra.we.kan.da
عەتا	.ƹe.ta
خودی	.xu.dî
کتێبفرۆشییەکانیان	.ki.têb.fi.ro.şî.ye.kan.yan
بێبەش	.bê.beş
جیاوازی	.cya.wa.zî
تاقی	.ta.qî
زانیارە	.zan.ya.re
بەڕێوەبەران	.be.řê.we.be.ran
دەخەنە	.de.xe.ne
ئەنیستیتووی	.ʔe.nîs.tî.tûy
ئەوسا	.ʔew.sa
ئینتەرنەتیش	.ʔîn.ter.ne.tîş
ڕەها	.ře.ha
ببینێت	.bi.bî.nêt
درێژایی	.di.rê.ja.yî
وشیار	.wiş.yar
هوونەرا	.hû.ne.ra
چاپکردن	.çap.kir.din
بوونەوەیەکی	.bû.ne.we.ye.kî
تۆمارکردنی	.to.mar.kir.di.nî
دەپەرمنە	.de.per.mi.ne
ناوداری	.naw.da.rî
دامرکاودا	.da.mir.kaw.da
خۆتانەوە	.xo.ta.ne.we
پێیدابڕۆنەوە	.pêy.da.bi.řo.ne.we
ڕێزلێنان	.řêz.lê.nan
حەسیچە	.ḧe.sî.çe
نەخۆشیی	.ne.xo.şîy
پێکهاتەکانی	.pêk.ha.te.ka.nî
کردەوەی	.kir.de.wey
کتێبفرۆشییەکە	.ki.têb.fi.ro.şî.ye.ke
زوو	.zû
بگەیەنن	.bi.ge.ye.nin
سەرۆکایەتیی	.se.ro.ka.ye.tîy
ویستی	.wîs.tî
خرا	.xi.ra
سزادانی	.si.za.da.nî
سێکس	.sêks
ستۆکهۆڵمەوە	.si.tok.hoł.me.we
کاتدا	.kat.da
چەمکی	.çem.kî
زادە	.za.de
کورتەچیرۆکەکانی	.kur.te.çî.ro.ke.ka.nî
نەتەوەییدا	.ne.te.we.yî.da
کتێبفرۆشییەکانی	.ki.têb.fi.ro.şî.ye.ka.nî
پارەیەکی	.pa.re.ye.kî
خاوەنەکەش	.xa.we.ne.keş
نەوەی	.ne.wey
بەرگەکانی	.ber.ge.ka.nî
هۆنراوەکانی	.hon.ra.we.ka.nî
کرا	.ki.ra
خانووبەرەی	.xa.nû.be.rey
ڕووداوە	.řû.da.we
فەرمی	.fer.mî
هێرشی	.hê.ri.şî
هەست	.hest
حاڵێکدا	.ḧa.łêk.da
گۆڤارە	.go.va.re
خۆشی	.xo.şî
ئەمەکێکی	.ʔe.me.kê.kî
دەویست	.de.wîst
شکێکیش	.şi.kê.kîş
پێشێ	.pê.şê
زۆرە	.zo.re
دەستنیشانی	.dest.nî.şa.nî
ژمارەیان	.ji.ma.re.yan
هەڵسەنگاندنانە	.heł.sen.gan.di.na.ne
ئۆگرەتییە	.ʔog.re.tî.ye
وادەی	.wa.dey
کێشابوومەوە	.kê.şa.bû.me.we
تورکیایە	.turk.ya.ye
نێونیشانی	.nêw.nî.şa.nî
داگیرکەر	.da.gîr.ker
گوشاری	.gu.şa.rî
خاوەنی	.xa.we.nî
جێگریی	.cê.gi.rîy
ژێرچەپۆکەیەکیش	.jêr.çe.po.ke.ye.kîş
مەسەلەیەکی	.me.se.le.ye.kî
بگەیەنێت	.bi.ge.ye.nêt
بنێت	.bi.nêt
میسی	.mî.sî
رێکخست	.rêk.xist
تایبەتیدا	.tay.be.tî.da
خزمەت	.xiz.met
ئاراس	.ʔa.ras
بۆرژوازی	.bor.jwa.zî
خۆبەڕێوەبردن	.xo.be.řê.we.bir.din
وەزارەتەوە	.we.za.re.te.we
پێت	.pêt
بەندیخانەکەیە	.ben.dî.xa.ne.ke.ye
هاندەرەکان	.han.de.re.kan
گیرابوو	.gî.ra.bû
دەورەیی	.dew.re.yî
پلەوپایەیەکیان	.pi.lew.pa.ye.yek.yan
هەر	.her
پەرلەمانتاران	.per.le.man.ta.ran
ساڵە	.sa.łe
خۆشحاڵ	.xoş.ḧał
بانگ	.bang
بێسنی	.bês.nî
لاوانی	.la.wa.nî
کوردستانییەکان	.kur.dis.ta.nî.ye.kan
ڕۆڵێکی	.řo.łê.kî
لەچاپدەدران	.le.çap.ded.ran
ساڵان	.sa.łan
شارەکان	.şa.re.kan
لێی	.lêy
کلتوری	.kil.tu.rî
بڵاوکەرانەوە	.bi.ław.ke.ra.ne.we
ڕەچاو	.ře.çaw
سیستەمێکی	.sîs.te.mê.kî
هێنابا	.hê.na.ba
باوک	.bawk
یەکێکیان	.ye.kêk.yan
ئەمڕۆکە	.ʔem.řo.ke
کۆمەڵگایەکی	.ko.meł.ga.ye.kî
لەرێگەی	.le.rê.gey
جەنگەکە	.cen.ge.ke
قوتابی	.qu.ta.bî
کەوابوو	.ke.wa.bû
دڵنیایی	.dił.nya.yî
بڵیندی	.bi.łîn.dî
کوردیدا	.kur.dî.da
رۆژانی	.ro.ja.nî
ناچاردەکرد	.na.çar.de.kird
ژیانەکەمان	.jya.ne.ke.man
فرۆشتن	.fi.roş.tin
قورسایی	.qur.sa.yî
سپاردن	.si.par.din
چەشنێک	.çeş.nêk
خەلکی	.xel.kî
کارهێنانی	.kar.hê.na.nî
لایەنەکان	.la.ye.ne.kan
دەیانسپێرن	.de.yan.si.pê.rin
فۆتۆکۆپییەوە	.fo.to.ko.pî.ye.we
ژیانیدا	.jya.nî.da
چوو	.çû
قامشلۆدان	.qa.miş.lo.dan
لەتم	.le.tim
سەروەری	.ser.we.rî
فەرەنسا	.fe.ren.sa
چاپەمەنیی	.ça.pe.me.nîy
خۆتۆمار	.xo.to.mar
چۆنە	.ço.ne
قەیرانە	.qey.ra.ne
بگرن	.bi.gi.rin
جەستە	.ces.te
خەباتی	.xe.ba.tî
تورکیا	.turk.ya
بژین	.bi.jîn
کوردەکانیان	.kur.de.kan.yan
دەرونی	.de.ru.nî
پێکراوەکان	.pê.ki.ra.we.kan
لێدوانێکدا	.lê.dwa.nêk.da
بەشە	.be.şe
پیلان	.pî.lan
تۆی	.toy
وەک	.wek
تاڵەبانی	.ta.łe.ba.nî
ژووری	.jû.rî
رووداوە	.rû.da.we
ساکاری	.sa.ka.rî
ئیمرالی	.ʔîm.ra.lî
لکێنەرانە	.li.kê.ne.ra.ne
دەبینین	.de.bî.nîn
لێدەکات	.lê.de.kat
نووسینەوە	.nû.sî.ne.we
نەبوون	.ne.bûn
نەدەکرد	.ne.de.kird
پێکهاتنامەکان	.pêk.hat.na.me.kan
دەهات	.de.hat
فەرمان	.fer.man
دەبیندرێنەوە	.de.bîn.di.rê.ne.we
کتێبخانەکە	.ki.têb.xa.ne.ke
چەمچەماڵ	.çem.çe.mał
کۆنفرانسی	.kon.fi.ran.sî
ئارام	.ʔa.ram
تورکیشی	.tur.kî.şî
دەکەم	.de.kem
لێژنەیە	.lêj.ne.ye
خۆپیشاندەران	.xo.pî.şan.de.ran
پەیوەندی	.pey.wen.dî
دەدەن	.de.den
ئایار	.ʔa.yar
بەرزکردنەوەی	.berz.kir.di.ne.wey
یەکەمین	.ye.ke.mîn
ناوی	.na.wî
دەستگیرکردنی	.dest.gîr.kir.di.nî
رسایتڵەکان	.ri.say.ti.łe.kan
بەردەم	.ber.dem
دەدران	.de.di.ran
بڵاوێزی	.bi.ła.wê.zî
خوشک	.xuşk
بەنێوبانگ	.be.nêw.bang
هاتوچۆی	.ha.tu.çoy
مەهدی	.meh.dî
پیاوچاکییەوە	.pyaw.ça.kî.ye.we
منی	.mi.nî
رێپێدانی	.rê.pê.da.nî
ناسراوی	.nas.ra.wî
هێستاش	.hês.taş
پشتگیریی	.piş.ti.gî.rîy
برادەرانەیان	.bi.ra.de.ra.ne.yan
ناکرێنەوە	.na.ki.rê.ne.we
مەحمود	.meḧ.mud
نیشتمانیی	.nîş.ti.ma.nîy
دزیی	.di.zîy
رچەی	.ri.çey
دانراوە	.da.ni.ra.we
روونتر	.rûn.tir
بسڕنەوە	.bis.ři.ne.we
لێبوردن	.lê.bur.din
لەچاپدەرەکە	.le.çap.de.re.ke
چۆمان	.ço.man
شانۆی	.şa.noy
شەشەم	.şe.şem
توانیم	.twa.nîm
جگەرخوێن	.ci.ger.xwên
مەترسیداربوون	.me.tir.sî.dar.bûn
سامانی	.sa.ma.nî
کۆڵی	.ko.łî
گیانی	.gya.nî
ئەمانە	.ʔe.ma.ne
دیویانە	.dîw.ya.ne
ناوە	.na.we
دەن	.den
پایتەختی	.pay.tex.tî
ئاشتی	.ʔaş.tî
دەسبەسەرکردنی	.des.be.ser.kir.di.nî
ئەورووپای	.ʔew.rû.pay
ئۆگرەتییەکانی	.ʔog.re.tî.ye.ka.nî
خڕ	.xiř
هێنا	.hê.na
چاپکراوەیان	.çap.ki.ra.we.yan
مەنسوور	.men.sûr
خەم	.xem
ئارەزووی	.ʔa.re.zûy
پارتیا	.part.ya
سەربەخۆییی	.ser.be.xo.yîy
فەرمانبەرەکانیانەوە	.fer.man.be.re.kan.ya.ne.we
بەشداری	.beş.da.rî
دەنگی	.den.gî
قەبووڵ	.qe.bûł
هەواڵە	.he.wa.łe
تێیدا	.têy.da
یەکێ	.ye.kê
شەهید	.şe.hîd
دەستکەوتەکانی	.dest.kew.te.ka.nî
نەرویج	.ner.wîc
کوردستانیان	.kur.dis.tan.yan
بەشدارەکانی	.beş.da.re.ka.nî
عەدنان	.ƹed.nan
کراوەکاندا	.ki.ra.we.kan.da
دۆستایەتی	.dos.ta.ye.tî
ڕاپرسی	.řa.pir.sî
دەوڵەت	.dew.łet
بنەماکانی	.bi.ne.ma.ka.nî
دەدۆزرێنەوە	.de.doz.rê.ne.we
ئەوکات	.ʔew.kat
بڵەین	.bi.łeyn
ژیاوە	.jya.we
ڕوونە	.řû.ne
باسی	.ba.sî
ئەژانسی	.ʔe.jan.sî
ئە	.ʔe
نێودەوڵەتییەکان	.nêw.dew.łe.tî.ye.kan
داهاتی	.da.ha.tî
خراوە	.xi.ra.we
ئانا	.ʔa.na
زمانانەش	.zi.ma.na.neş
تاد	.tad
دۆخێکدا	.do.xêk.da
ڕێژیمی	.řê.jî.mî
هەوڵە	.hew.łe
سەرەکییەکان	.se.re.kî.ye.kan
کردم	.kir.dim
داهاتوو	.da.ha.tû
توانا	.twa.na
پەردەژییان	.per.de.jî.yan
ئەمریکادا	.ʔem.rî.ka.da
دوژمنانی	.duj.mi.na.nî
بەیانی	.be.ya.nî
پرسیارە	.pirs.ya.re
ئینتەرنت	.ʔîn.ter.nit
سێی	.sêy
مەحمەت	.meḧ.met
یەکەمینەکەیان	.ye.ke.mî.ne.ke.yan
سێهەم	.sê.hem
پەیامی	.pe.ya.mî
پیلانێکی	.pî.la.nê.kî
ئینسان	.ʔîn.san
کردنەوە	.kir.di.ne.we
بەرهەمەکانی	.ber.he.me.ka.nî
خۆشگوزەرانی	.xoş.gu.ze.ra.nî
زانینی	.za.nî.nî
تێدەکۆشن	.tê.de.ko.şin
دەکرێت	.de.ki.rêt
ماڵێدا	.ma.łê.da
دەبینن	.de.bî.nin
هەیەتی	.he.ye.tî
ئەندامایەتیی	.ʔen.da.ma.ye.tîy
ڕۆژەدا	.řo.je.da
نکۆڵێ	.ni.ko.łê
هەڵبژاردەی	.heł.bi.jar.dey
دەرهاتنی	.der.ha.ti.nî
دەبرێ	.deb.rê
بەرتیلی	.ber.tî.lî
بەماناتر	.be.ma.na.tir
هۆکارەکانی	.ho.ka.re.ka.nî
دەیزانی	.dey.za.nî
بارودۆخانەدا	.ba.ru.do.xa.ne.da
هوسێس	.hu.sês
ئاڕاستەی	.ʔa.řas.tey
دەرفەت	.der.fet
فارس	.fars
سەرەڕای	.se.re.řay
لاوە	.la.we
تیرۆری	.tî.ro.rî
دەگرێت	.de.gi.rêt
سەرخستنی	.ser.xis.ti.nî
شەڕە	.şe.ře
میوانداری	.mî.wan.da.rî
کوردییەکان	.kur.dî.ye.kan
پەستابەپەستا	.pes.ta.be.pes.ta
یاسان	.ya.san
دانیشتووی	.da.nîş.tûy
یوسفی	.yu.si.fî
هەڵبژێردرێن	.heł.bi.jêr.di.rên
پەڕتووکنامەی	.peř.tûk.na.mey
بڵاوکەرەوە	.bi.ław.ke.re.we
دۆخەشدا	.do.xeş.da
براکان	.bi.ra.kan
دەیانڕەخسێنێ	.de.yan.řex.sê.nê
محەمەدی	.mi.ḧe.me.dî
ساڵێکە	.sa.łê.ke
حاڵ	.ḧał
هێنرا	.hên.ra
ئەمەیش	.ʔe.meyş
ئاڤەستا	.ʔa.ves.ta
هۆرتەوبەرەیەکی	.hor.tew.be.re.ye.kî
دەگوترێت	.de.gut.rêt
بەوپەڕی	.bew.pe.řî
ئیسمایل	.ʔîs.ma.yil
کۆمپانیایەکی	.kom.pan.ya.ye.kî
ڕابردوو	.řa.bir.dû
بگات	.bi.gat
نکۆڵی	.ni.ko.łî
ئێرانیشدا	.ʔê.ra.nîş.da
دەڤەرێک	.de.ve.rêk
ئایندە	.ʔa.yin.de
ئامارێک	.ʔa.ma.rêk
وێنەی	.wê.ney
مانگرتن	.man.gir.tin
دەرچوو	.der.çû
کۆلێجی	.ko.lê.cî
دەبینی	.de.bî.nî
ڕوخانی	.řu.xa.nî
تەقە	.te.qe
گوتبووی	.gu.ti.bûy
باجە	.ba.ce
گۆرانیبێژی	.go.ra.nî.bê.jî
گەرەکمە	.ge.rek.me
تێپەڕی	.tê.pe.řî
خەلات	.xe.lat
بەندیخانە	.ben.dî.xa.ne
هەناسە	.he.na.se
چاپخانەگەلێک	.çap.xa.ne.ge.lêk
کچ	.kiç
دراونەتەوە	.di.raw.ne.te.we
نەزانیبوو	.ne.za.nî.bû
سەبارەت	.se.ba.ret
هەڵسەنگاندندا	.heł.sen.gan.din.da
دانووستانی	.da.nûs.ta.nî
دەری	.de.rî
چوون	.çûn
هەتا	.he.ta
دەبیندرێ	.de.bîn.di.rê
داساکاندن	.da.sa.kan.din
کۆمەڵەی	.ko.me.łey
ناوەندەکانیان	.na.wen.de.kan.yan
داناون	.da.na.win
داڕێژاندنی	.da.řê.jan.di.nî
ئاوی	.ʔa.wî
ئەژماری	.ʔej.ma.rî
ئێمەیە	.ʔê.me.ye
کەلتی	.kel.tî
بەربەرەکانیی	.ber.be.re.ka.nîy
راستەوخۆ	.ras.tew.xo
دەگەڵ	.de.geł
دەجووڵانەوەی	.de.cû.ła.ne.wey
تکایە	.ti.ka.ye
کێشەیەکی	.kê.şe.ye.kî
بارودۆخە	.ba.ru.do.xe
راگیرکران	.ra.gîr.ki.ran
نووسەرکی	.nû.ser.kî
ئینگلتەرا	.ʔîn.gil.te.ra
نزیکدا	.ni.zîk.da
دەهێنرا	.de.hên.ra
چاودێرییەک	.çaw.dê.rî.yek
ئێران	.ʔê.ran
سیستمە	.sîs.ti.me
نەبووایە	.ne.bu.wa.ye
وەرگێڕاوێکی	.wer.gê.řa.wê.kî
نیمچە	.nîm.çe
ئاوازی	.ʔa.wa.zî
بەسەر	.be.ser
داو	.daw
زیندان	.zîn.dan
جگەرە	.ci.ge.re
چاوپێکەوتنێکم	.çaw.pê.kew.ti.nê.kim
ئابووری	.ʔa.bû.rî
جێگایەک	.cê.ga.yek
نەبوونە	.ne.bû.ne
بڕگەی	.biř.gey
ماوەی	.ma.wey
خێرایی	.xê.ra.yî
بەرپرسە	.ber.pir.se
دەیانهێنینە	.de.yan.hê.nî.ne
گێرە	.gê.re
دەشفرۆشرێن	.deş.fi.roş.rên
ڕوودانی	.řû.da.nî
بۆوە	.bo.we
خۆوە	.xo.we
دەرخست	.der.xist
سەردانەکەی	.ser.da.ne.key
چارەسەرکردنی	.ça.re.ser.kir.di.nî
خەریکە	.xe.rî.ke
مەڵبەندی	.meł.ben.dî
وازیان	.waz.yan
باو	.baw
ئازادییا	.ʔa.za.dî.ya
دەدوان	.ded.wan
سەرەکیمان	.se.re.kî.man
نامە	.na.me
خوە	.xwe
نەکردرێ	.ne.kir.di.rê
بایەخی	.ba.ye.xî
دەگیردرێن	.de.gîr.di.rên
پۆلیس	.po.lîs
تەبایی	.te.ba.yî
تۆن	.ton
بژی	.bi.jî
درێژخایەنەکە	.di.rêj.xa.ye.ne.ke
ڤەکۆلی	.ve.ko.lî
سەرپەرشتی	.ser.pe.riş.tî
حەفتەیەک	.ḧef.te.yek
عەرەبیی	.ƹe.re.bîy
لەدەستداوە	.le.dest.da.we
شلوێ	.şil.wê
گەشت	.geşt
تاش	.taş
هەمیشە	.he.mî.şe
دەچێ	.de.çê
ئەرزەڕۆم	.ʔer.ze.řom
ناڕەوا	.na.ře.wa
سوودێکی	.sû.dê.kî
قادری	.qa.di.rî
کوردییەکانیانەوە	.kur.dî.ye.kan.ya.ne.we
پێدراوە	.pê.di.ra.we
حوکمی	.ḧuk.mî
ڕاستە	.řas.te
وەرگرێ	.wer.gi.rê
رەچاوگرتنی	.re.çaw.gir.ti.nî
گرووپی	.gi.rû.pî
دەیپشکنیم	.dey.piş.ki.nîm
فاکتۆرەکانی	.fak.to.re.ka.nî
ئەڵمانی	.ʔeł.ma.nî
ئەمپەراتووریی	.ʔem.pe.ra.tû.rîy
ڕاستەقینە	.řas.te.qî.ne
ڕادیۆ	.řad.yo
حیزبەکان	.ḧîz.be.kan
رەش	.reş
گەلێک	.ge.lêk
دەم	.dem
تاکی	.ta.kî
یاسایی	.ya.sa.yî
پیشە	.pî.şe
سەربازی	.ser.ba.zî
بەمانای	.be.ma.nay
تورکیادا	.turk.ya.da
پشتیوانیی	.piş.tî.wa.nîy
بەڕێوبەرەکانی	.be.řêw.be.re.ka.nî
کۆپییەکی	.ko.pî.ye.kî
بڵاوکەر	.bi.ław.ker
گەورەیان	.gew.re.yan
رێنووسگۆڕاوەکاندا	.rê.nûs.go.řa.we.kan.da
سعوودیە	.si.ƹûd.ye
دیتنی	.dî.ti.nî
زانیارییەکانی	.zan.ya.rî.ye.ka.nî
نەتەوەی	.ne.te.wey
نووسینگەی	.nû.sîn.gey
شانۆیی	.şa.no.yî
مرۆڤەکان	.mi.ro.ve.kan
ئاگادارنەبوونی	.ʔa.ga.dar.ne.bû.nî
کردی	.kir.dî
دواجار	.dwa.car
بان	.ban
دەهێندرێن	.de.hên.di.rên
ڕێگر	.řê.gir
دەگاتە	.de.ga.te
راستەقینەکانی	.ras.te.qî.ne.ka.nî
نیگەرانی	.nî.ge.ra.nî
پەیکەری	.pey.ke.rî
کەسێک	.ke.sêk
نووسراوەکانی	.nûs.ra.we.ka.nî
مەترسیی	.me.tir.sîy
چەکدارە	.çek.da.re
ئۆتۆمبێل	.ʔo.tom.bêl
سیاسییەوە	.sya.sî.ye.we
نەناردنی	.ne.nar.di.nî
ئیدارەی	.ʔî.da.rey
بەردی	.ber.dî
زێڕ	.zêř
نەدەکردەوە	.ne.de.kir.de.we
وەرگێڕەکانیش	.wer.gê.ře.ka.nîş
شوێنێکی	.şwê.nê.kî
وڵاتدا	.wi.łat.da
چل	.çil
بەندیخاناندا	.ben.dî.xa.nan.da
هەلێکی	.he.lê.kî
فەرمانبەر	.fer.man.ber
پەیوەستە	.pey.wes.te
ئاخۆ	.ʔa.xo
هۆکارە	.ho.ka.re
چوارچێوەی	.çwar.çê.wey
سوکایەتی	.su.ka.ye.tî
ئاسایشی	.ʔa.sa.yi.şî
دەمیشق	.de.mîşq
کتێبانی	.ki.tê.ba.nî
زیندانیانی	.zîn.dan.ya.nî
کۆسپێکی	.kos.pê.kî
پەکەکە	.pe.ke.ke
ئێستاش	.ʔês.taş
بەرهەڵستەکان	.ber.he.łis.te.kan
بەلکی	.bel.kî
کێشەی	.kê.şey
کتێبانێک	.ki.tê.ba.nêk
سارێژکەریی	.sa.rêj.ke.rîy
پاشەکشە	.pa.şek.şe
دەچوو	.de.çû
شکستی	.şi.kis.tî
نێونەتەوەییشە	.nêw.ne.te.we.yî.şe
تەکنەلۆژیای	.tek.ne.loj.yay
خەباتەکانیان	.xe.ba.te.kan.yan
زوڵم	.zu.łim
چوارەمین	.çwa.re.mîn
رێژەیە	.rê.je.ye
جیاوازەوە	.cya.wa.ze.we
گاهەز	.ga.hez
دەگۆڕێت	.de.go.řêt
وتەیەکی	.wi.te.ye.kî
پلەی	.pi.ley
ناوچەیانە	.naw.çe.ya.ne
دیاردەی	.dyar.dey
لەیەکەم	.le.ye.kem
عەلی	.ƹe.lî
دەردەخا	.der.de.xa
یاسا	.ya.sa
ئێرە	.ʔê.re
دوژمنی	.duj.mi.nî
سەرچاوەکان	.ser.ça.we.kan
چینە	.çî.ne
دانیشتووانی	.da.nîş.tu.wa.nî
ئاوارەی	.ʔa.wa.rey
فەرمانی	.fer.ma.nî
بتوانین	.bi.twa.nîn
سیمای	.sî.may
تورکیان	.turk.yan
نمرجن	.ni.mir.cin
راهاتبوون	.ra.ha.ti.bûn
ژی	.jî
دیکەشیان	.dî.keş.yan
بەراوەرد	.be.ra.werd
ڕاپۆرتە	.řa.por.te
سودان	.su.dan
بیاتی	.bya.tî
حەولیان	.ḧewl.yan
بکاتەوە	.bi.ka.te.we
ناوچەیییەکان	.naw.çe.yî.ye.kan
زاگرۆس	.zag.ros
بۆئەوەی	.bo.ʔe.wey
ڕۆحی	.řo.ḧî
خۆیان	.xo.yan
لەیلا	.ley.la
ڕێکەوتی	.řê.kew.tî
کم	.kim
ڕادەی	.řa.dey
رەنێوهاتبوون	.re.nêw.hat.bûn
هەوڵی	.hew.łî
کردووەتەوە	.kir.du.we.te.we
پێدانی	.pê.da.nî
سەلاحەددین	.se.la.ḧed.dîn
کە	.ke
دەرچوون	.der.çûn
قەتەر	.qe.ter
کردوون	.kir.dûn
پێ	.pê
هەڵیگواستە	.he.łî.gwas.te
لکەکانی	.li.ke.ka.nî
سەرەنجام	.se.ren.cam
ستراتیژی	.sit.ra.tî.jî
بۆچی	.bo.çî
ناوەراست	.na.we.rast
لەگەڵیاندا	.le.geł.yan.da
نایابی	.na.ya.bî
بگەڕێتەوە	.bi.ge.řê.te.we
هەموان	.hem.wan
بچن	.bi.çin
بمانەوێت	.bi.ma.ne.wêt
یەکدی	.yek.dî
هۆزی	.ho.zî
مۆدێرن	.mo.dêrn
ڕایگەیاندبوو	.řay.ge.yan.di.bû
گرنگیی	.gi.rin.gîy
پەنای	.pe.nay
پارێزگادا	.pa.rêz.ga.da
خەڵکی	.xeł.kî
سەدام	.se.dam
نێوێکی	.nê.wê.kî
حاندی	.ḧan.dî
تۆماری	.to.ma.rî
لەگەڵدا	.le.geł.da
دەگەیەنێت	.de.ge.ye.nêt
ئەمەیان	.ʔe.me.yan
بارەیەوە	.ba.re.ye.we
کتێبەکانی	.ki.tê.be.ka.nî
ناوەوەی	.na.we.wey
ئەڵێ	.ʔe.łê
کارگەی	.kar.gey
کەسایەتی	.ke.sa.ye.tî
جگەر	.ci.ger
تاوانبارکارییەکی	.ta.wan.bar.ka.rî.ye.kî
لاتینن	.la.tî.nin
کتێبخانەگەلە	.ki.têb.xa.ne.ge.le
ڕای	.řay
منەوە	.mi.ne.we
خستنی	.xis.ti.nî
ئاسیایی	.ʔas.ya.yî
کردمەوە	.kir.di.me.we
ژیابوون	.jya.bûn
نەختێک	.nex.têk
خاڵی	.xa.łî
دامەزرێندراوە	.da.mez.rên.di.ra.we
زانستگای	.za.nist.gay
دەربڕیبوو	.der.bi.řî.bû
عەبدولڕەحمان	.ƹeb.dul.řeḧ.man
دروستبوونی	.di.rust.bû.nî
هەڵگرتنی	.heł.gir.ti.nî
خۆیەتی	.xo.ye.tî
تورکەکانن	.tur.ke.ka.nin
مەزنی	.me.zi.nî
دەکرێنەوە	.de.ki.rê.ne.we
شاعیرە	.şa.ƹî.re
عارفی	.ƹa.ri.fî
خەلیفە	.xe.lî.fe
زانستە	.za.nis.te
ئەمریکاوە	.ʔem.rî.ka.we
پرۆسەکە	.pi.ro.se.ke
هۆرتەوبەرەکانی	.hor.tew.be.re.ka.nî
تەنانەت	.te.na.net
بنەڕەتی	.bi.ne.ře.tî
سنوور	.si.nûr
وەردەگرێت	.wer.de.gi.rêt
کارگێڕییەکیان	.kar.gê.řî.yek.yan
بێتەوە	.bê.te.we
مانگانە	.man.ga.ne
وێنەیەکی	.wê.ne.ye.kî
تیرۆریستی	.tî.ro.rîs.tî
شەری	.şe.rî
بەرە	.be.re
گۆرانییەوە	.go.ra.nî.ye.we
ماشێنی	.ma.şê.nî
لام	.lam
چەشنی	.çeş.nî
بڵاوببووەوە	.bi.ław.bi.bu.we.we
فرۆشراوەکان	.fi.roş.ra.we.kan
گۆڕدران	.goř.di.ran
بڵاودەکرێتەوە	.bi.ław.de.ki.rê.te.we
هاووڵاتیی	.haw.wi.ła.tîy
گرێ	.gi.rê
ڕزگاری	.řiz.ga.rî
پێشگرییەکانیش	.pêş.gi.rî.ye.ka.nîş
جەماوەری	.ce.ma.we.rî
بتوانن	.bi.twa.nin,.bit.wa.nin
زۆرجار	.zor.car
نادرێن	.na.di.rên
دەیانهەوێ	.de.yan.he.wê
گۆڤارانی	.go.va.ra.nî
ناوبانگی	.naw.ban.gî
روون	.rûn
لاتین	.la.tîn
خواستی	.xwas.tî
ئینسانی	.ʔîn.sa.nî
بڵاوکراوی	.bi.ław.ki.ra.wî
باجیشی	.ba.cî.şî
سەرڕا	.ser.řa
گەلی	.ge.lî
زیندانی	.zîn.da.nî
کر	.kir
هۆڵی	.ho.łî
ئاپۆ	.ʔa.po
موڵکی	.muł.kî
سنووردارەوە	.si.nûr.da.re.we
دەکاتە	.de.ka.te
لە	.le
بڵێ	.bi.łê
بێنن	.bê.nin
ئونال	.ʔu.nal
دڵنیا	.dił.nya
خان	.xan
فەرهەنگییەکانی	.fer.hen.gî.ye.ka.nî
ئاماژەمان	.ʔa.ma.je.man
نووسەرەکانیش	.nû.se.re.ka.nîş
جیهانەوە	.cî.ha.ne.we
لەناوچەی	.le.naw.çey
نێشتەجێیەکانی	.nêş.te.cê.ye.ka.nî
پێداگری	.pê.da.gi.rî
بەدەم	.be.dem
ئاگری	.ʔa.gi.rî
گفتوگۆی	.gif.tu.goy
راپۆرتی	.ra.por.tî
ڕەحیم	.ře.ḧîm
بڕیارنامەکە	.biř.yar.na.me.ke
کۆلێژی	.ko.lê.jî
ئەنجامداوە	.ʔen.cam.da.we
سەربەخۆیییان	.ser.be.xo.yî.yan
ڕۆمانە	.řo.ma.ne
دۆستی	.dos.tî
کەیسی	.key.sî
سیاسیی	.sya.sîy
ئاسن	.ʔa.sin
هاوڕێیەکەشم	.haw.řê.ye.ke.şim
لەتەک	.le.tek
جاندان	.can.dan
رابردم	.ra.bir.dim
پلکەتی	.pil.ke.tî
هاوپەیمانی	.haw.pey.ma.nî
گولستان	.gu.lis.tan
بابەتە	.ba.be.te
دابمەزرێن	.da.bi.mez.rên
زاراوەکانی	.za.ra.we.ka.nî
مرد	.mird
بەرتیلەوە	.ber.tî.le.we
لەپێناوی	.le.pê.na.wî
تێبینی	.tê.bî.nî
ساڵەی	.sa.łey
رێکلام	.rêk.lam
هەڵبەستەکانم	.heł.bes.te.ka.nim
شوێنە	.şwê.ne
ساڵیدا	.sa.łî.da
میدیای	.mîd.yay
یارمەتی	.yar.me.tî
کوردانی	.kur.da.nî
دوورەنگی	.dû.ren.gî
بێرەجووک	.bê.re.cûk
جوانتر	.cwan.tir
دەفرۆشرێن	.def.roş.rên
مەسیح	.me.sîḧ
سەید	.seyd
کشانەوەی	.ki.şa.ne.wey
تاکەکان	.ta.ke.kan
هەستی	.hes.tî
دایکەکانیانەوە	.day.ke.kan.ya.ne.we
لەچاپدەرەکانی	.le.çap.de.re.ka.nî
چاپخانەگەلەم	.çap.xa.ne.ge.lem
رێکخراوەگەلی	.rêk.xi.ra.we.ge.lî
هەستێکی	.hes.tê.kî
زوانەکاندا	.zwa.ne.kan.da
گیرفانی	.gîr.fa.nî
پاڵ	.pał
دیدی	.dî.dî
لجەلی	.li.ce.lî
ڕێککەوتن	.řêk.kew.tin
رۆژ	.roj
لەچاپدانەکەشیان	.le.çap.da.ne.keş.yan
لایەن	.la.yen
بەندبکرێ	.bend.bi.ki.rê
چەشنانی	.çeş.na.nî
ئەلەکساندر	.ʔe.lek.san.dir
بابەتەکاندا	.ba.be.te.kan.da
پرزەیان	.pir.ze.yan
شوێنەکان	.şwê.ne.kan
هەمووان	.he.mu.wan
میللی	.mîl.lî
سبەی	.si.bey
شەشیان	.şeş.yan
مەکەن	.me.ken
ئەلقاعیدە	.ʔel.qa.ƹî.de
ئەوێ	.ʔe.wê
ئەکرەم	.ʔe.ki.rem
ڕەمەزان	.ře.me.zan
پاکەتی	.pa.ke.tî
تەلڤیزیۆنییەکان	.tel.vîz.yo.nî.ye.kan
فەتح	.fe.tiḧ
دابوو	.da.bû
کاردەکات	.kar.de.kat
قوبادی	.qu.ba.dî
سێکسی	.sêk.sî
بکات	.bi.kat
هاوبەش	.haw.beş
بەرهەمان	.ber.he.man
گۆڤارەکانیش	.go.va.re.ka.nîş
سان	.san
دەوڵەتە	.dew.łe.te
دەنێرنە	.de.nê.ri.ne
بەرنامەی	.ber.na.mey
دەستوور	.des.tûr
هاوڕێیان	.haw.řê.yan
ڕق	.řiq
شک	.şik
نەوشیروان	.new.şîr.wan
نوسراوە	.nus.ra.we
نەچمەوە	.neç.me.we
ژیانەوەی	.jya.ne.wey
جۆراوجۆر	.co.raw.cor
سەرەتادا	.se.re.ta.da
سەرژمێری	.ser.ji.mê.rî
موزیک	.mu.zîk
نووسراوەگەلێک	.nûs.ra.we.ge.lêk
هاشم	.ha.şim
کۆمەڵی	.ko.me.łî
مڵهوڕی	.mił.hu.řî
بۆلای	.bo.lay
کتێبەکاندا	.ki.tê.be.kan.da
کتێبانیان	.ki.tê.ban.yan
گێڕایەوە	.gê.řa.ye.we
مادی	.ma.dî
ماف	.maf
پارەکەی	.pa.re.key
دلاوەرێ	.di.la.we.rê
بڕوای	.biř.way
دەخاتە	.de.xa.te
دووری	.dû.rî
گۆڕانکاریی	.go.řan.ka.rîy
لەزگین	.lez.gîn
فەتاح	.fe.taḧ
ڕێکخراوی	.řêk.xi.ra.wî
پەیوەندییە	.pey.wen.dî.ye
دامەزرێندراون	.da.mez.rên.di.ra.win
ناهاوبەش	.na.haw.beş
بنچینەی	.bin.çî.ney
بانگهێشت	.bang.hêşt
جیاکارییە	.cya.ka.rî.ye
گەیشت	.ge.yişt
مامۆستاکانی	.ma.mos.ta.ka.nî
فەرمووی	.fer.mûy
لیوای	.lî.way
دەگا	.de.ga
خەڵاتیان	.xe.łat.yan
لەهیچ	.le.hîç
کریستیانۆ	.ki.rîst.ya.no
چۆتە	.ço.te
لەش	.leş
داوا	.da.wa
نەسڕاوەتەوە	.nes.řa.we.te.we
موسلیم	.mus.lîm
لەچاپدەن	.le.çap.den
کردنەکان	.kir.di.ne.kan
فراکسیۆنی	[.fi.rak.syo.nî]
زۆرکارییەکی	.zor.ka.rî.ye.kî
ڕووداوەکە	.řû.da.we.ke
کرابوون	.ki.ra.bûn
ناردنیان	.nar.din.yan
بڕوات	.biř.wat
فیدراڵی	.fîd.ra.łî
نەکرد	.ne.kird
ڕۆژانە	.řo.ja.ne
شارەدێی	.şa.re.dêy
زارەکییانە	.za.re.kî.ya.ne
ئامێری	.ʔa.mê.rî
یانەی	.ya.ney
نەریت	.ne.rît
لەلای	.le.lay
ناوخۆ	.naw.xo
هەبێ	.he.bê
بابەتەکانیان	.ba.be.te.kan.yan
جیاوازییەکان	.cya.wa.zî.ye.kan
یادی	.ya.dî
گوتمان	.gut.man
پارێزگاکان	.pa.rêz.ga.kan
بکرێت	.bi.ki.rêt
ڕۆم	.řom
جووڵ	.cûł
گوترا	.gut.ra
هەستا	.hes.ta
دیاریکراوی	.dya.rî.ki.ra.wî
نامێنێت	.na.mê.nêt
بەدرخان	.be.dir.xan
پێشکەش	.pêş.keş
پێشینەی	.pê.şî.ney
نەدەبوو	.ne.de.bû
خواردنی	.xwar.di.nî
گوندەکان	.gun.de.kan
چاند	.çand
حکوومەتدا	.ḧi.kû.met.da
سێهەمییەکە	.sê.he.mî.ye.ke
خوارێیە	.xwa.rê.ye
تۆڕێکی	.to.řê.kî
پێشانگەکاندا	.pê.şan.ge.kan.da
گشتیی	.giş.tîy
کۆمپانیاکانی	.kom.pan.ya.ka.nî
وڵاتێک	.wi.ła.têk
دڵشاد	.dił.şad
نووسراوەی	.nûs.ra.wey
بڵاودەکرێنەوە	.bi.ław.de.ki.rê.ne.we
دواکەوتنە	.dwa.kew.ti.ne
هەڵدەسەنگاند	.heł.de.sen.gand
دەگیردرا	.de.gîr.di.ra
گەرەکتانە	.ge.rek.ta.ne
مانەوەیان	.ma.ne.we.yan
نوێترین	.nwê.ti.rîn
راکێشاوە	.ra.kê.şa.we
بیرۆکەی	.bî.ro.key
ئازادانە	.ʔa.za.da.ne
ڕانەگەیشتنەکان	.řa.ne.geyş.ti.ne.kan
لێبوردنی	.lê.bur.di.nî
شارەزا	.şa.re.za
بەرنامەکانی	.ber.na.me.ka.nî
هەریەک	.her.yek
فیلمەکە	.fîl.me.ke
گەیشتووەتە	.geyş.tu.we.te
هاوڕێیانی	.haw.řê.ya.nî
پێشگیراو	.pêş.gî.raw
پی	.pî
هەفتەیە	.hef.te.ye
بەرێ	.be.rê
گریلاکانی	.gi.rî.la.ka.nî
دەڵێت	.de.łêt
مەزلووم	.mez.lûm
گوتی	.gu.tî
دەستنووسەکانی	.dest.nû.se.ka.nî
دروستی	.di.rus.tî
پشتگرەکانیشیان	.pişt.gi.re.ka.nîş.yan
هەڵەی	.he.łey
بازرگانیی	.ba.zir.ga.nîy
جارجار	.car.car
کەندوکۆسپە	.ken.du.kos.pe
شەهیدان	.şe.hî.dan
چون	.çun
سوید	.swîd
کاردانەوەی	.kar.da.ne.wey
نڤیسیاران	.ni.vîs.ya.ran
ماتباعی	.mat.ba.ƹî
تیشکی	.tîş.kî
نەتەوەکانی	.ne.te.we.ka.nî
بانکی	.ban.kî
درێژخایەنەوە	.di.rêj.xa.ye.ne.we
کتێبێک	.ki.tê.bêk
گشتیدا	.giş.tî.da
نادەن	.na.den
وڵامەکەیدا	.wi.ła.me.key.da
هەڵبەستن	.heł.bes.tin
کۆبوونەوەکەدا	.ko.bû.ne.we.ke.da
کوردانێک	.kur.da.nêk
خشتەکەی	.xiş.te.key
خوێندەواری	.xwên.de.wa.rî
لێمان	.lê.man
گەیشتووە	.geyş.tu.we
چاوەڕوان	.ça.we.řwan
دۆسیەکانی	.dos.ye.ka.nî
هەمان	.he.man
سەرتاسەری	.ser.ta.se.rî
مانگرتنی	.man.gir.ti.nî
قسەکانیدا	.qi.se.ka.nî.da
ئەکتەر	.ʔek.ter
پازدە	.paz.de
بێدەنگ	.bê.deng
خەباتگێڕی	.xe.bat.gê.řî
لێوەردەگیردرێ	.lê.wer.de.gîr.di.rê
نووسی	.nû.sî
فەرەج	.fe.rec
ڕێبەر	.řê.ber
یاساکانی	.ya.sa.ka.nî
سیاسییەکانەوە	.sya.sî.ye.ka.ne.we
ڕۆژدا	.řoj.da
وەرگێڕانی	.wer.gê.řa.nî
نابرێن	.na.bi.rên
بەدرێژایی	.be.di.rê.ja.yî
پاشتر	.paş.tir
ئەمیش	.ʔe.mîş
سەدەکانی	.se.de.ka.nî
راهێنانی	.ra.hê.na.nî
پیرەمێرد	.pî.re.mêrd
جەنگەیەدا	.cen.ge.ye.da
ئاڵوگۆڕی	.ʔa.łu.go.řî
ژیاندا	.jyan.da
هێناونەتەوە	.hê.naw.ne.te.we
خەڵکێک	.xeł.kêk
بەنێوبانگترین	.be.nêw.bang.ti.rîn
هەڵسەنگاندنی	.heł.sen.gan.di.nî
دەستبەست	.dest.best
ڕێگای	.řê.gay
ئەرتش	.ʔer.tiş
هەڵکردووە	.heł.kir.du.we
هەویستبووی	.he.wîs.ti.bûy
خشتەی	.xiş.tey
تەواوەتیی	.te.wa.we.tîy
بۆمبی	.bom.bî
تری	.ti.rî
باشیشی	.ba.şî.şî
کراوەیە	.ki.ra.we.ye
خۆر	.xor
خەیاڵ	.xe.yał
بکە	.bi.ke
جەژنی	.cej.nî
تێبکۆشن	.tê.bi.ko.şin
لەپێناو	.le.pê.naw
دەداتەوە	.de.da.te.we
خوێنرایەوە	.xwên.ra.ye.we
دەستێوەردانی	.des.tê.wer.da.nî
حساب	.ḧi.sab
رۆژاوای	.ro.ja.way
جەعفەر	.ceƹ.fer
جەنگی	.cen.gî
کارگێرییەکی	.kar.gê.rî.ye.kî
ئەوەوە	.ʔe.we.we
کەرەستە	.ke.res.te
ژیانا	.jya.na
ببێتەوە	.bi.bê.te.we
دادەنێت	.da.de.nêt
ئەنجامی	.ʔen.ca.mî
کورمانجیبێژ	.kur.man.cî.bêj
دۆسیەی	.dos.yey
مسوەگەر	.mis.we.ger
پلانێکی	.pi.la.nê.kî
کرابانەوە	.ki.ra.ba.ne.we
وەرگێڕەکان	.wer.gê.ře.kan
قۆناغ	.qo.naẍ
دەکرانەوە	.de.ki.ra.ne.we
کتێبەکان	.ki.tê.be.kan
جێ	.cê
کۆڵەواری	.ko.łe.wa.rî
تورکیی	.tur.kîy
ئەوین	.ʔe.wîn
تێکۆشیون	.tê.ko.şî.win
ئیلام	.ʔî.lam
دوو	.dû
ش	.şi
بدەم	.bi.dem
وێنەیەکیان	.wê.ne.yek.yan
بزاڤانێک	.bi.za.va.nêk
پەلە	.pe.le
بەجێگەیە	.be.cê.ge.ye
سەباح	.se.baḧ
ئاشکرایە	.ʔaş.ki.ra.ye
گێڕابووەوە	.gê.řa.bu.we.we
نەتەوەگەلێکی	.ne.te.we.ge.lê.kî
ئاکام	.ʔa.kam
هاوڵاتیانی	.haw.łat.ya.nî
شاد	.şad
وزە	.wi.ze
لەسەرە	.le.se.re
بووبووم	.bû.bûm
سۆتە	.so.te
بێن	.bên
جۆراوجۆرەکانی	.co.raw.co.re.ka.nî
دەیکەن	.dey.ken
بۆتەوە	.bo.te.we
وەرگێڕدراونەتەوە	.wer.gêř.di.raw.ne.te.we
ئیتالیا	.ʔî.tal.ya
هەواڵەکان	.he.wa.łe.kan
کوردییەکانیش	.kur.dî.ye.ka.nîş
نەیوێراوە	.ney.wê.ra.we
هاوڕێکانی	.haw.řê.ka.nî
دەدەنێ	.de.de.nê
پێنجشەممە	.pênc.şem.me
پەیوەندییەکانی	.pey.wen.dî.ye.ka.nî
باڵای	.ba.łay
دانیشتووایەتیی	.da.nîş.tu.wa.ye.tîy
ئاقارەکە	.ʔa.qa.re.ke
میلیارد	.mîl.yard
گۆڕاوەتەوە	.go.řa.we.te.we
شارەداریی	.şa.re.da.rîy
ئەزرا	.ʔez.ra
مارەبڕین	.ma.re.bi.řîn
دەبوون	.de.bûn
لێدەکرێت	.lê.de.ki.rêt
بڕانی	.bi.řa.nî
لەبری	.le.bi.rî
تاکە	.ta.ke
ناو	.naw
هێزیی	.hê.zîy
ناوچەیی	.naw.çe.yî
دەرێ	.de.rê
گەیاند	.ge.yand
خوێنەری	.xwê.ne.rî
یەکسەر	.yek.ser
خەرجی	.xer.cî
نازناوی	.naz.na.wî
دەدام	.de.dam
یەکجار	.yek.car
ناوەندە	.na.wen.de
چاک	.çak
کرن	.ki.rin
ڕاست	.řast
دەتوانێ	.de.twa.nê
نەتەوەخوازانەی	.ne.te.we.xwa.za.ney
سیتی	.sî.tî
دێرینی	.dê.rî.nî
نیو	.nîw
بێت	.bêt
هەتاوی	.he.ta.wî
کتێبانەش	.ki.tê.ba.neş
خزمەتگوزارییەک	.xiz.met.gu.za.rî.yek
ئەمنیی	.ʔem.nîy
ئۆفسێتی	.ʔof.sê.tî
نرخەکان	.nir.xe.kan
پۆلیسدا	.po.lîs.da
زگماکی	.zig.ma.kî
خەرج	.xerc
پۆست	.post
جامی	.ca.mî
توانی	.twa.nî
دەزاندران	.de.zan.di.ran
جەمیل	.ce.mîl
هێنان	.hê.nan
جددی	.cid.dî
لەچاپدرابوون	.le.çap.di.ra.bûn
یانگزەهەمین	.yang.ze.he.mîn
ناوەڕاستە	.na.we.řas.te
سەرەتاوە	.se.re.ta.we
بین	.bîn
ئەدی	.ʔe.dî
شەو	.şew
نرخی	.nir.xî
قبووڵ	.qi.bûł
بکردایە	.bi.kir.da.ye
بێبەری	.bê.be.rî
ئوسامە	.ʔu.sa.me
دەنگیان	.deng.yan
حەکاری	.ḧe.ka.rî
تێ	.tê
جیهانیی	.cî.ha.nîy
عیسا	.ƹî.sa
تیژی	.tî.jî
بەیەکەوە	.be.ye.ke.we
سیاسەتە	.sya.se.te
کۆڕی	.ko.řî
گرینگ	.gi.rîng
نانووسرێ	.na.nûs.rê
دێتە	.dê.te
بەڕێوەیان	.be.řê.we.yan
شێت	.şêt
چێژ	.çêj
پێنەدەدرا	.pê.ne.de.di.ra
دیدار	.dî.dar
کوردییەکانیان	.kur.dî.ye.kan.yan
سەرۆکوەزیرانی	.se.rok.we.zî.ra.nî
ئوگرەتی	.ʔug.re.tî
لێ	.lê
هەڵبژاردە	.heł.bi.jar.de
ڕووبەڕووی	.řû.be.řûy
یاریگەی	.ya.rî.gey
هۆرتەوبەرەکان	.hor.tew.be.re.kan
ئیمارات	.ʔî.ma.rat
ڕوخساری	.řux.sa.rî
تورکییەکان	.tur.kî.ye.kan
نێزیکترین	.nê.zîk.ti.rîn
شێوەردی	.şê.wer.dî
پێشمەرگەکانی	.pêş.mer.ge.ka.nî
پاریس	.pa.rîs
ئەمساڵدا	.ʔem.sał.da
تێدەپەڕێ	.tê.de.pe.řê
دژایەتییان	.di.ja.ye.tî.yan
کۆڵ	.koł
ژنان	.ji.nan
تەکنیکییەوە	.tek.nî.kî.ye.we
وڵاتیش	.wi.ła.tîş
دەکڕدرێن	.de.kiř.di.rên
ژیانیان	.jyan.yan
ئەرێ	.ʔe.rê
دەستبەرداری	.dest.ber.da.rî
دەگەڕێت	.de.ge.řêt
بەند	.bend
کرۆنی	.ki.ro.nî
یەکێتیدا	.ye.kê.tî.da
ئەمجارە	.ʔem.ca.re
هەڵبگوێزدرێن	.heł.big.wêz.di.rên
هۆیە	.ho.ye
واشە	.wa.şe
ئەمان	.ʔe.man
دابنێن	.da.bi.nên
ساڵح	.sa.łiḧ
ببەن	.bi.ben
ئەخلاقی	.ʔex.la.qî
سەرسووڕهێنەر	.ser.sûř.hê.ner
زیندانیی	.zîn.da.nîy
دانێن	.da.nên
حەمۆ	.ḧe.mo
هاتن	.ha.tin
چاپدانی	.çap.da.nî
تردا	.tir.da
ڕەحمان	.řeḧ.man
رۆژاوایییان	.ro.ja.wa.yî.yan
ژمارە	.ji.ma.re
کوردستانێ	.kur.dis.ta.nê
مَکتومین	.mek.tu.mîn
دیموکراتی	.dî.muk.ra.tî
هاریکاری	.ha.rî.ka.rî
کارەشیان	.ka.reş.yan
ناتواندرێ	.na.twan.di.rê
ئەمەش	.ʔe.meş
کاولی	.kaw.lî
ستەمبۆڵەوە	.si.tem.bo.łe.we
گۆڤاریش	.go.va.rîş
بیپشکنێ	.bî.piş.ki.nê
پارێزگا	.pa.rêz.ga
کتێبخانەیەکی	.ki.têb.xa.ne.ye.kî
لوبنانی	.lub.na.nî
نیسانی	.nî.sa.nî
دەرگا	.der.ga
لاوازی	.la.wa.zî
فەتەرێکیش	.fe.te.rê.kîş
باسمان	.bas.man
پەرلەمانی	.per.le.ma.nî
خونتا	.xun.ta
پێشمەرگەی	.pêş.mer.gey
سەروەت	.ser.wet
هەڤگرتنا	.hev.gir.ti.na
بایەخێکێ	.ba.ye.xê.kê
رۆژنامەوان	.roj.na.me.wan
بکرێ	.bi.ki.rê
سڵاو	.si.ław
تاریق	.ta.rîq
دیکتاتۆری	.dîk.ta.to.rî
بچێتە	.bi.çê.te
خۆش	.xoş
زماندا	.zi.man.da
کوردان	.kur.dan
رابردوو	.ra.bir.dû
فەرهەنگییەکان	.fer.hen.gî.ye.kan
ئامێرە	.ʔa.mê.re
خانووی	.xa.nûy
دەچێتە	.de.çê.te
لەگەڵ	.le.geł
دێنە	.dê.ne
خوارەوە	.xwa.re.we
بیر	.bîr
هەڵبەستیش	.heł.bes.tîş
بنیات	.bin.yat
میرات	.mî.rat
بەپێچەوانەی	.be.pê.çe.wa.ney
چاپەمەنییەکان	.ça.pe.me.nî.ye.kan
نەبن	.ne.bin
کەسایەتییەکان	.ke.sa.ye.tî.ye.kan
هەڵبەستەکانی	.heł.bes.te.ka.nî
تەلەڤیزیۆنی	.te.le.vîz.yo.nî
غەریب	.ẍe.rîb
کێهە	.kê.he
عەزیزی	.ƹe.zî.zî
تێدەکۆشا	.tê.de.ko.şa
قەرەبوو	.qe.re.bû
دی	.dî
مەریوان	.me.rî.wan
لەبەرامبەر	.le.be.ram.ber
دەنگێکی	.den.gê.kî
فەرمیی	.fer.mîy
ژیاون	.jya.win
تەکنیکی	.tek.nî.kî
گرووپە	.gi.rû.pe
نەیانوێرا	.ne.yan.wê.ra
دەمی	.de.mî
یاریدەدەری	.ya.rî.de.de.rî
دەنێردران	.de.nêr.di.ran
پەرتووکان	.per.tû.kan
داشکانی	.da.şi.ka.nî
نانەشوێن	.na.ne.şwên
گرافیکەکان	.gi.ra.fî.ke.kan
ڕیزی	.řî.zî
بڵێت	.bi.łêt
یەکینەکانی	.ye.kî.ne.ka.nî
کەسایەتییان	.ke.sa.ye.tî.yan
کوڕە	.ku.ře
سازی	.sa.zî
تەواوی	.te.wa.wî
هەبوە	.heb.we
ئەندامێتی	.ʔen.da.mê.tî
تەنیشت	.te.nîşt
چاپکراوەکان	.çap.ki.ra.we.kan
پەنابەرانی	.pe.na.be.ra.nî
سوورە	.sû.re
گواستنەوەی	.gwas.ti.ne.wey
چاوەڕوانیی	.ça.weř.wa.nîy
منداڵەکان	.min.da.łe.kan
ئەزموونەکانی	.ʔez.mû.ne.ka.nî
نەدیوەتەوە	.ne.dî.we.te.we
تیۆری	.tyo.rî
زوان	.zwan
یەکەمجار	.ye.kem.car
سەرلەبەیانی	.ser.le.be.ya.nî
ئەنجامدرا	.ʔen.cam.di.ra
کاتێک	.ka.têk
زانیان	.zan.yan
پەرلەمانتارانی	.per.le.man.ta.ra.nî
خەریکیان	.xe.rîk.yan
وەرگێڕی	.wer.gê.řî
جۆربەجۆرەوە	.cor.be.co.re.we
عوسمانی	.ƹus.ma.nî
هۆکارێکی	.ho.ka.rê.kî
پەیوەندیان	.pey.wend.yan
ئەمیر	.ʔe.mîr
حەسەن	.ḧe.sen
جەستەیی	.ces.te.yî
هەڵبەستەکانیان	.heł.bes.te.kan.yan
دەشڵێت	.deş.łêt
ئەم	.ʔem
ڕۆڵە	.řo.łe
سەردانی	.ser.da.nî
دهۆکی	.di.ho.kî
نامەوە	.na.me.we
پۆستی	.pos.tî
وەربگرین	.wer.big.rîn
نێچیرڤان	.nê.çîr.van
ناکاتەوە	.na.ka.te.we
بشبووبێ	.biş.bû.bê
کاتەیدا	.ka.tey.da
ئەشکەنجەدا	.ʔeş.ken.ce.da
خۆناساندنیان	.xo.na.san.din.yan
عەرەبیدا	.ƹe.re.bî.da
ترین	.ti.rîn
جوانترین	.cwan.ti.rîn
نزم	.ni.zim
دیمەنی	.dî.me.nî
گۆرانییە	.go.ra.nî.ye
گشت	.gişt
گەشەکردنێکی	.ge.şe.kir.di.nê.kî
هێڤی	.hê.vî
چاودێرانی	.çaw.dê.ra.nî
کتێبەکەیانە	.ki.tê.be.ke.ya.ne
کاربەدەستان	.kar.be.des.tan
دۆزیبووەوە	.do.zî.bu.we.we
دەبوو	.de.bû
ڕێژەی	.řê.jey
سەلیم	.se.lîm
بنچینەیەیە	.bin.çî.ne.ye.ye
کەسە	.ke.se
بایەخێکی	.ba.ye.xê.kî
لەگەڵیدا	.le.ge.łî.da
پارەداندا	.pa.re.dan.da
پشکنینی	.piş.ki.nî.nî
دامەوە	.da.me.we
نەداوەتەوە	.ne.da.we.te.we
گۆڤاریان	.go.var.yan
گرنگترین	.gi.ring.ti.rîn
رێبوارە	.rêb.wa.re
بەکۆمەڵ	.be.ko.meł
مەسەلەکە	.me.se.le.ke
یارییەکە	.ya.rî.ye.ke
نەکەوتبوو	.ne.kew.ti.bû
جوغرافییەکانەوە	.cuẍ.ra.fî.ye.ka.ne.we
دایکەکان	.day.ke.kan
دەتوانین	.de.twa.nîn
دابمەزرێنن	.da.bi.mez.rê.nin
دژایەتی	.di.ja.ye.tî
تێکۆشی	.tê.ko.şî
دوورەوڵاتیدا	.dû.re.wi.ła.tî.da
خول	.xul
نەگەیوە	.ne.gey.we
ئەستۆ	.ʔes.to
ڕایگەیاندووە	.řay.ge.yan.du.we
روونە	.rû.ne
ئەشکەنجەکراوەکان	.ʔeş.ken.ce.ki.ra.we.kan
ئەڵمانێ	.ʔeł.ma.nê
بڕە	.bi.ře
رێکخستووە	.rêk.xis.tu.we
حەسەنێ	.ḧe.se.nê
سەرەکیترینیان	.se.re.kî.ti.rîn.yan
دادەنێن	.da.de.nên
ناوچەییی	.naw.çe.yîy
زیانم	.zya.nim
دەبینم	.de.bî.nim
ئەوان	.ʔe.wan
بخەنە	.bi.xe.ne
ئێرانییەکان	.ʔê.ra.nî.ye.kan
داڕێژانی	.da.řê.ja.nî
بزاڤەکە	.bi.za.ve.ke
پەنجا	.pen.ca
کەسییەکانیش	.ke.sî.ye.ka.nîş
هاریدەدەری	.ha.rî.de.de.rî
پارێزگایەدان	.pa.rêz.ga.ye.dan
شتێکیان	.şi.têk.yan
هەشت	.heşt
نیوەڕۆی	.nî.we.řoy
پەروەردە	.per.wer.de
باوەشی	.ba.we.şî
ساڵانە	.sa.ła.ne
زگەکانیان	.zi.ge.kan.yan
بەرینایی	.be.rî.na.yî
بهێنێتە	.bi.hê.nê.te
کێشەگەلە	.kê.şe.ge.le
پێک	.pêk
رۆمانە	.ro.ma.ne
زانیاریگەلێک	.zan.ya.rî.ge.lêk
کوردییە	.kur.dî.ye
پیاوە	.pya.we
نەتەوەیەکگرتووەکان	.ne.te.we.yek.gir.tu.we.kan
رەواندزی	.re.wan.di.zî
دیش	.dîş
پێشتریش	.pêş.ti.rîş
رێکدەخران	.rêk.dex.ran
پێشانگاکە	.pê.şan.ga.ke
سەلماندبایان	.sel.man.di.ba.yan
نایات	.na.yat
هەرزانتر	.her.zan.tir
باشووری	.ba.şû.rî
چەکێک	.çe.kêk
شیری	.şî.rî
پۆلیسان	.po.lî.san
تەقینەوە	.te.qî.ne.we
کۆژراون	.koj.ra.win
ڕوونکردەوە	.řûn.kir.de.we
کۆکراوەکانی	.ko.ki.ra.we.ka.nî
پارەی	.pa.rey
مەڵبەندەکانی	.meł.ben.de.ka.nî
رووپەڕ	.rû.peř
سەرکەوتنێکی	.ser.kew.ti.nê.kî
خێزان	.xê.zan
هەوڵیان	.hewł.yan
عەرەبەکانی	.ƹe.re.be.ka.nî
بەرشەلۆنە	.ber.şe.lo.ne
ناکوردییە	.na.kur.dî.ye
قۆشنی	.qoş.nî
نێودەوڵەتیی	.nêw.dew.łe.tîy
بەدەستهێنانی	.be.dest.hê.na.nî
کتێبفرۆشییانەش	.ki.têb.fi.ro.şî.ya.neş
بۆچوونێکی	.bo.çû.nê.kî
نەویترین	.ne.wî.ti.rîn
ئازاد	.ʔa.zad
ئەشکەنجە	.ʔeş.ken.ce
رێپێنەدراوی	.rê.pê.ne.di.ra.wî
بەکارەکان	.be.ka.re.kan
رۆژهەڵات	.roj.he.łat
گوایە	.gwa.ye
دور	.dur
کەرکوک	.ker.kuk
چاپکراوەکانی	.çap.ki.ra.we.ka.nî
شەقاوێکی	.şe.qa.wê.kî
لەجیاتی	.le.cya.tî
عەزرەتی	.ƹez.re.tî
لەوەی	.le.wey
ژماری	.ji.ma.rî
مزگەوت	.miz.gewt
بۆ	.bo
نژاد	.ni.jad
جەختیشیان	.cex.tîş.yan
درێژە	.di.rê.je
شێوەیە	.şê.we.ye
سیاسەتێکی	.sya.se.tê.kî
ڕووەوە	.řu.we.we
مافە	.ma.fe
خاک	.xak
باسێک	.ba.sêk
پیلانەکان	.pî.la.ne.kan
بەردەگرێ	.ber.deg.rê
داوەتە	.da.we.te
پێشنیاریان	.pêş.nyar.yan
جێبەجێی	.cê.be.cêy
توێژینەوە	.twê.jî.ne.we
زگماکییان	.zig.ma.kî.yan
شیاوی	.şya.wî
حەلەب	.ḧe.leb
زیانێکی	.zya.nê.kî
بەندیخانەکان	.ben.dî.xa.ne.kan
مین	.mîn
دواتری	.dwa.ti.rî
فەرهەنگکوژییەوە	.fer.heng.ku.jî.ye.we
پیاوی	.pya.wî
یارمەتیدانی	.yar.me.tî.da.nî
دەستوری	.des.tu.rî
رۆژانە	.ro.ja.ne
ئەگەرچی	.ʔe.ger.çî
ڕوو	.řû
کۆتاییدا	.ko.ta.yî.da
کوردستانە	.kur.dis.ta.ne
دیکتاتۆر	.dîk.ta.tor
بارەی	.ba.rey
بەرێز	.be.rêz
هەمووی	.he.mûy
مەکە	.me.ke
رژێم	.ri.jêm
کارمەندی	.kar.men.dî
قەت	.qet
نەفەران	.ne.fe.ran
هەستە	.hes.te
دڵم	.di.łim
شێران	.şê.ran
تورک	.turk
ئیمام	.ʔî.mam
لێکەوتەوە	.lê.kew.te.we
ساڵەکانی	.sa.łe.ka.nî
حکوومەتییەکان	.ḧi.kû.me.tî.ye.kan
دەشڵێ	.deş.łê
دەبن	.de.bin
دەڵێ	.de.łê
جاریش	.ca.rîş
داگیرکردنی	.da.gîr.kir.di.nî
سەرەتایی	.se.re.ta.yî
ناکا	.na.ka
لەچاپدرانی	.le.çap.di.ra.nî
خوێن	.xwên
پاشای	.pa.şay
تورکیە	.turk.ye
فەرهەنگیمان	.fer.hen.gî.man
سیاسییەکانیش	.sya.sî.ye.ka.nîş
باسێکیش	.ba.sê.kîş
شریتەکانی	.şi.rî.te.ka.nî
بڕیارەکانی	.biř.ya.re.ka.nî
رێپێدراوبوون	.rê.pê.di.raw.bûn
میوانی	.mî.wa.nî
چەلەبی	.çe.le.bî
سەرچاوەن	.ser.ça.wen
پارێزگایە	.pa.rêz.ga.ye
موختار	.mux.tar
رێکخرا	.rêk.xi.ra
یەکیان	.yek.yan
تەواوەتی	.te.wa.we.tî
پاڵپشتی	.pał.piş.tî
مامۆستا	.ma.mos.ta
فەرهەنگ	.fer.heng
دەگوت	.de.gut
پاشا	.pa.şa
پێکهاتوو	.pêk.ha.tû
نەبینیوەتەوە	.ne.bî.nî.we.te.we
سەرەکیترین	.se.re.kî.ti.rîn
خۆمان	.xo.man
بڕیارنامەیە	.biř.yar.na.me.ye
ببیندرێنەوە	.bi.bîn.di.rê.ne.we
بەوەشەوە	.be.we.şe.we
جزیری	.ci.zî.rî
بڵاوبکرێنەوە	.bi.ław.bi.ki.rê.ne.we
دەکرێتە	.de.ki.rê.te
تیۆریی	.tyo.rîy
دەو	.dew
بهێنە	.bi.hê.ne
دنە	.di.ne
کەمکردنەوەی	.kem.kir.di.ne.wey
شکان	.şi.kan
ململانێی	.mil.mi.la.nêy
کۆ	.ko
جگە	.ci.ge
قاسم	.qa.sim
قسەکەر	.qi.se.ker
زەکی	.ze.kî
سەدا	.se.da
نێوگۆڕینەیە	.nêw.go.řî.ne.ye
دەیانکڕن	.de.yan.kiřn
ئێستاکەی	.ʔês.ta.key
سەرچاوەکانی	.ser.ça.we.ka.nî
سە	.se
لۆزاندا	.lo.zan.da
پێشانگایەک	.pê.şan.ga.yek
وەبیر	.we.bîr
پوور	.pûr
خوێندگەگەلێک	.xwênd.ge.ge.lêk
رێکبخردرێ	.rêk.bi.xir.di.rê
سنوورەکاندا	.si.nû.re.kan.da
ئەمەریکی	.ʔe.me.rî.kî
لەچاپدەرەکاندا	.le.çap.de.re.kan.da
وڵامەکانیانە	.wi.ła.me.kan.ya.ne
ئەوروپادا	.ʔew.ru.pa.da
ئەرکی	.ʔer.kî
بەیاننامەیەکدا	.be.yan.na.me.yek.da
قامشلۆ	.qa.miş.lo
نەمر	.ne.mir
دەیانفرۆشن	.de.yan.fi.ro.şin
فرەیک	.fi.reyk
شارەزایییان	.şa.re.za.yî.yan
کەرتی	.ker.tî
نابێ	.na.bê
خۆیانەوە	.xo.ya.ne.we
لەچاپیان	.le.çap.yan
نازانن	.na.za.nin
شوانی	.şwa.nî
بڵێم	.bi.łêm
نەدەجووڵایەوە	.ne.de.cû.ła.ye.we
گەنجی	.gen.cî
لەچاپدەرێک	.le.çap.de.rêk
ئەوجا	.ʔew.ca
لەساڵی	.le.sa.łî
سازدەکەن	.saz.de.ken
سەدە	.se.de
شێعرەکانی	.şêƹ.re.ka.nî
وەکو	.we.ku
لەچەند	.le.çend
قۆڵی	.qo.łî
کۆنێ	.ko.nê
جۆربەجۆرەکانەوە	.cor.be.co.re.ka.ne.we
گۆڕانکارییەک	.go.řan.ka.rî.yek
سیدییەکان	.sî.dî.ye.kan
تێکدانی	.têk.da.nî
ئێوە	.ʔê.we
هێستا	.hês.ta
کارەبا	.ka.re.ba
بزانن	.bi.za.nin
پەو	.pew
بڵاوکردنەوەکەیان	.bi.ław.kir.di.ne.we.ke.yan
وەرزش	.wer.ziş
بیزانم	.bî.za.nim
فەرهەنگەکان	.fer.hen.ge.kan
چارەسەر	.ça.re.ser
بیاندیننەوە	.byan.dî.ni.ne.we
ڤەکۆلیی	.ve.ko.lîy
پێکدادان	.pêk.da.dan
ناوکی	.naw.kî
قایمقامی	.qaym.qa.mî
سوپا	.su.pa
بە	.be
جغارەکانیان	.ci.ẍa.re.kan.yan
کێشەکە	.kê.şe.ke
وادەکات	.wa.de.kat
نەخۆشخانە	.ne.xoş.xa.ne
سەردەمەدا	.ser.de.me.da
سەربەخۆیی	.ser.be.xo.yî
مووچەیەکیشم	.mû.çe.ye.kî.şim
سووک	.sûk
پەیوەندییان	.pey.wen.dî.yan
بزانین	.bi.za.nîn
پیاوێک	.pya.wêk
تێکنیکانی	.têk.nî.ka.nî
دەزانێت	.de.za.nêt
دەخات	.de.xat
سروە	.sir.we
ماشێنێکی	.ma.şê.nê.kî
ئەرخەنی	.ʔer.xe.nî
داخران	.da.xi.ran
ڤیکتۆریا	.vîk.tor.ya
زەراق	.ze.raq
سەنتەری	.sen.te.rî
گومانی	.gu.ma.nî
دەپەیڤن	.de.pey.vin
ڕایانگەیاند	.řa.yan.ge.yand
لێرەدا	.lê.re.da
گوڵ	.guł
پەیمانشکێنی	.pey.man.şi.kê.nî
چالاکییەک	.ça.la.kî.yek
بۆنی	.bo.nî
زۆر	.zor
سووریایەدە	.sûr.ya.ye.de
سیاسیدا	.sya.sî.da
کاروانی	.kar.wa.nî
وەرگێڕاوەکان	.wer.gê.řa.we.kan
لیژنەیەکی	.lîj.ne.ye.kî
خرایە	.xi.ra.ye
خوای	.xway
نەکراوە	.ne.ki.ra.we
چالاک	.ça.lak
بۆچوون	.bo.çûn
نەوەکا	.ne.we.ka
کۆمۆنیستی	.ko.mo.nîs.tî
بایرن	.bay.rin
ناوچانەی	.naw.ça.ney
ئەوانیش	.ʔe.wa.nîş
دیمۆکراتیکەکانی	.dî.mok.ra.tî.ke.ka.nî
بڕێک	.bi.řêk
چووە	.çu.we
بڵاوکردنەوەی	.bi.ław.kir.di.ne.wey
کرێکراوی	.ki.rê.ki.ra.wî
نەچووە	.ne.çu.we
کتێبخانەکاندا	.ki.têb.xa.ne.kan.da
ساگنچ	.sa.ginç
پێشنیازی	[.pêş.nya.zî]
سەرسووڕی	.ser.sû.řî
بکرێنەوە	.bi.ki.rê.ne.we
هەژاری	.he.ja.rî
بیروباوەڕی	.bî.ru.ba.we.řî
گە	.ge
بەراورد	.be.ra.wird
لەڕێگای	.le.řê.gay
گەڕەکی	.ge.ře.kî
زانیم	.za.nîm
عومەر	.ƹu.mer
بەردەوامە	.ber.de.wa.me
بەندکراو	.bend.ki.raw
گەردوونی	.ger.dû.nî
ناتوانن	.na.twa.nin
بەشدارییان	.beş.da.rî.yan
دیکەدا	.dî.ke.da
کچە	.ki.çe
پێویستمان	.pê.wîst.man
خوێندکارێک	.xwênd.ka.rêk
نەوەکانیشت	.ne.we.ka.nî.şit
ستێر	.si.têr
نێزیکەکانیان	.nê.zî.ke.kan.yan
شێوەیەی	.şê.we.yey
وڵاتەکانی	.wi.ła.te.ka.nî
کارانێک	.ka.ra.nêk
نڤیسکی	.ni.vîs.kî
دیاریکراودا	.dya.rî.ki.raw.da
هەوڵەکانی	.hew.łe.ka.nî
گژ	.gij
دانیشتن	.da.nîş.tin
خانی	.xa.nî
لیستی	.lîs.tî
زمانەکانەوە	.zi.ma.ne.ka.ne.we
وڵاتانەی	.wi.ła.ta.ney
بچینە	.bi.çî.ne
پێشبڕکێی	.pêş.biř.kêy
ئۆپۆزسیۆن	.ʔo.po.zis.yon
لایەنەی	.la.ye.ney
خوێناوی	.xwê.na.wî
تیرێژ	.tî.rêj
چالاکیگەلێک	.ça.la.kî.ge.lêk
ئاماژەیەکی	.ʔa.ma.je.ye.kî
بەعس	.be.ƹis
شوێنەکانی	.şwê.ne.ka.nî
درابوون	.di.ra.bûn
ئەوەتا	.ʔe.we.ta
سەرپەرشتیاری	.ser.pe.rişt.ya.rî
بازاڕەکان	.ba.za.ře.kan
بژاردا	.bi.jar.da
سوور	.sûr
ئاگادارینامەکان	.ʔa.ga.da.rî.na.me.kan
پلان	.pi.lan
ئیسلامیدا	.ʔîs.la.mî.da
پەیوەندییەکی	.pey.wen.dî.ye.kî
دەنگدانی	.deng.da.nî
فاکس	.faks
خێر	.xêr
حەمە	.ḧe.me
کۆمەڵگە	.ko.meł.ge
درێژ	.di.rêj
هێند	.hênd
هێڵی	.hê.łî
پارلەمانی	.par.le.ma.nî
نیشتەجێ	.nîş.te.cê
خوێندووە	.xwên.du.we
کلۆد	.ki.lod
لەچاو	.le.çaw
بەرپرسێکی	.ber.pir.sê.kî
دەدرێن	.de.di.rên
قەراغی	.qe.ra.ẍî
وەربگرێت	.wer.bi.gi.rêt
قبوڵ	.qi.buł
سەرچاوەکە	.ser.ça.we.ke
کتێبپەرەستانەی	.ki.têb.pe.res.ta.ney
دامەزرانی	.da.mez.ra.nî
پارەیە	.pa.re.ye
ڕۆیتەرز	.řoy.terz
خۆشەویست	.xo.şe.wîst
پێشکەوتنێکی	.pêş.kew.ti.nê.kî
پاڵەوانێتی	.pa.łe.wa.nê.tî
وردی	.wir.dî
نهێنیی	.ni.hê.nîy
تەندروستیی	.ten.di.rus.tîy
لەبەر	.le.ber
ڕۆشنایی	.řoş.na.yî
دیاربەکری	.dyar.be.ki.rî
بۆزارسلان	.bo.zar.si.lan
کتێبخانەکەی	.ki.têb.xa.ne.key
گەلاوێژی	.ge.la.wê.jî
لەدەستدانی	.le.des.ti.da.nî
هەیانە	.he.ya.ne
دایانمەزراندوون	.da.yan.mez.ran.dûn
سنە	.si.ne
گۆڤاریشان	.go.va.rî.şan
گرتووە	.gir.tu.we
بڵاوکراونەتەوە	.bi.ław.ki.raw.ne.te.we
کەوتنە	.kew.ti.ne
نکۆڵییانە	.ni.ko.łî.ya.ne
کتێبفرۆشییەک	.ki.têb.fi.ro.şî.yek
دانە	.da.ne
کارگێڕییان	.kar.gê.řî.yan
چاپخانەکانی	.çap.xa.ne.ka.nî
رێکخراوەیەکی	.rêk.xi.ra.we.ye.kî
دەروازەی	.der.wa.zey
نەدا	.ne.da
بەرێوەبەرایەتی	.be.rê.we.be.ra.ye.tî
کۆنگرەی	.kon.gi.rey
چاودێری	.çaw.dê.rî
چۆڵەپێچەی	.ço.łe.pê.çey
کتێبخانانەدا	.ki.têb.xa.na.ne.da
جیهان	.cî.han
کوڕی	.ku.řî
دەدامەوە	.de.da.me.we
بەرجەستە	.ber.ces.te
پەیمانی	.pey.ma.nî
بۆنەیەوە	.bo.ne.ye.we
پرۆژەیەکی	.pi.ro.je.ye.kî
تەنگاوییەک	.ten.ga.wî.yek
ئابوورییان	.ʔa.bû.rî.yan
بەغدای	.beẍ.day
کاتەدا	.ka.te.da
دەڵێن	.de.łên
ناسراون	.nas.ra.win
کوردستانیش	.kur.dis.ta.nîş
کامیان	.kam.yan
رێنووسەوە	.rê.nû.se.we
ڕەوتە	.řew.te
لەلایەنی	.le.la.ye.nî
کەتەلۆگان	.ke.te.lo.gan
مامۆستایانی	.ma.mos.ta.ya.nî
هیچی	.hî.çî
بۆتان	.bo.tan
ئاغای	.ʔa.ẍay
برووشوور	.bi.rû.şûr
بەرنامەیەکی	.ber.na.me.ye.kî
بەرهەمهێنانی	.ber.hem.hê.na.nî
داناوە	.da.na.we
دەکرێ	.de.ki.rê
سەرسنوور	.ser.si.nûr
مەبەست	.me.best
نیزامی	.nî.za.mî
دەگێڕێتەوە	.de.gê.řê.te.we
ژینگە	.jîn.ge
بەرهەمە	.ber.he.me
سەربە	.ser.be
هاوسەری	.haw.se.rî
تاوان	.ta.wan
ڕاوێژکاری	.řa.wêj.ka.rî
ناردرابوو	.nar.di.ra.bû
چاپخانەیەکیان	.çap.xa.ne.yek.yan
دەرنەکەوتووە	.der.ne.kew.tu.we
کارێکی	.ka.rê.kî
نایاسایییەوە	.na.ya.sa.yî.ye.we
چوار	.çwar
لەبەردەم	.le.ber.dem
مەی	.mey
لەژێر	.le.jêr
زگماکیی	.zig.ma.kîy
ئەکرد	.ʔe.kird
کردنەوەی	.kir.di.ne.wey
کارتێک	.kar.têk
سنوورێکدا	.si.nû.rêk.da
پەخشانی	.pex.şa.nî
فەرماندەیی	.fer.man.de.yî
ئێستاکانێ	.ʔês.ta.ka.nê
هەڵوەشاندەوە	.heł.we.şan.de.we
سەر	.ser
ڕۆشنبیر	.řo.şin.bîr
دادەمەزرێنن	.da.de.mez.rê.nin
فرێد	.fi.rêd
قادر	.qa.dir
دواین	.dwayn
کوردانەش	.kur.da.neş
نزیکی	.ni.zî.kî
ڕوودەدات	.řû.de.dat
بڵاوبوونەوەی	.bi.ław.bû.ne.wey
هێنانەوەی	.hê.na.ne.wey
فۆلکلۆر	.fol.ki.lor
حەستەم	.ḧes.tem
سەیدایێ	.sey.da.yê
ئالان	.ʔa.lan
لەچاپدانیان	.le.çap.dan.yan
گەورەی	.gew.rey
راگەیاندن	.ra.ge.yan.din
ئەتۆ	.ʔe.to
تەلەڤیزیۆن	.te.le.vîz.yon
بەرگرییەکان	.ber.gi.rî.ye.kan
پەیڤین	.pey.vîn
دەربارەی	.der.ba.rey
گەنم	.ge.nim
ئینجیلیان	.ʔîn.cîl.yan
بەرەی	.be.rey
هۆنراوەگەلە	.hon.ra.we.ge.le
هەرتک	.her.tik
پێبدرێ	.pê.bi.di.rê
ئی	.ʔî
کەماڵیستەکان	.ke.ma.łîs.te.kan
ڕەزامەندی	.ře.za.men.dî
قەبارەی	.qe.ba.rey
قسەکردن	.qi.se.kir.din
تێڕوانینی	.tê.řwa.nî.nî
دوچاری	.du.ça.rî
سەرنجڕاکێش	.se.rinc.řa.kêş
لێکراون	.lê.ki.ra.win
ناساندنی	.na.san.di.nî
مەسەلەیە	.me.se.le.ye
هەڵوەشێنرا	.heł.we.şên.ra
زمانە	.zi.ma.ne
رووپەڕێک	.rû.pe.řêk
کوژران	.kuj.ran
بزاڤەکانیش	.bi.za.ve.ka.nîş
ماوەتەوە	.ma.we.te.we
موستەفا	.mus.te.fa
مەحموود	.meḧ.mûd
بردنەوەی	.bir.di.ne.wey
چیرۆکە	.çî.ro.ke
لەلایەن	.le.la.yen
ئەندامان	.ʔen.da.man
شارەزاوە	.şa.re.za.we
بازرگانییان	.ba.zir.ga.nî.yan
فەرهەنگێک	.fer.hen.gêk
دەستنووسانێک	.dest.nû.sa.nêk
وڵامەکانیان	.wi.ła.me.kan.yan
عێراقدا	.ƹê.raq.da
شکاو	.şi.kaw
چێرمک	.çê.rimk
باشترین	.baş.ti.rîn
گوتارەکانی	.gu.ta.re.ka.nî
برا	.bi.ra
مێژوویی	.mê.jû.yî
ڕاپەڕین	.řa.pe.řîn
کێشەکان	.kê.şe.kan
ڕژێم	.ři.jêm
ببەستێتەوە	.bi.bes.tê.te.we
ناڕەزایی	.na.ře.za.yî
دابنرێت	.da.bi.ni.rêt
رەشیدێ	.re.şî.dê
دیاربەکر	.dyar.be.kir
ئابووریی	.ʔa.bû.rîy
گروپێکی	.gi.ru.pê.kî
کۆتایی	.ko.ta.yî
یەکتیا	.yek.tya
چەقڵ	.çe.qił
توندوتیژیی	.tun.du.tî.jîy
کەین	.keyn
شیکەری	.şî.ke.rî
بریتانیای	.bi.rî.tan.yay
هیوا	.hî.wa
کێ	.kê
پشت	.pişt
حیزب	.ḧîzb
رخنەگیری	.rix.ne.gî.rî
رۆژنامەیەک	.roj.na.me.yek
بیروڕا	.bî.ru.řa
خراوەتە	.xi.ra.we.te
بۆنە	.bo.ne
کەناڵەکانی	.ke.na.łe.ka.nî
سەرکردایەتیی	.ser.kir.da.ye.tîy
کتێبێکیش	.ki.tê.bê.kîş
دەکرێتەوە	.de.ki.rê.te.we
لەئەنجامدا	.le.ʔen.cam.da
هاوسەرگیری	.haw.ser.gî.rî
ئیسلامیەکان	.ʔîs.lam.ye.kan
بیرکردنەوە	.bîr.kir.di.ne.we
دیاربەکرەوە	.dyar.be.ki.re.we
یاساکان	.ya.sa.kan
ماڵەوە	.ma.łe.we
بەرزتری	.berz.ti.rî
خێزانە	.xê.za.ne
چاودێرییەکان	.çaw.dê.rî.ye.kan
دەهێوراند	.de.hêw.rand
سویسرا	.swîs.ra
دووەمیش	.du.we.mîş
چاپدا	.çap.da
مەدیا	.med.ya
ئەدەب	.ʔe.deb
شارەکانی	.şa.re.ka.nî
ئەوکاتەی	.ʔew.ka.tey
گەنجێکی	.gen.cê.kî
فەلسەفی	.fel.se.fî
بەگ	.beg
دۆخێکی	.do.xê.kî
جببە	.cib.be
تاکو	.ta.ku
لەسەری	.le.se.rî
نێوبراوە	.nêw.bi.ra.we
گەورە	.gew.re
ئاماری	.ʔa.ma.rî
رێیپێنادرێ	.rêy.pê.na.di.rê
کۆبوونەوەگەلە	.ko.bû.ne.we.ge.le
مەولانا	.mew.la.na
قورسی	.qur.sî
بەتەنیا	.be.ten.ya
پەیوەندیەکانی	.pey.wend.ye.ka.nî
خوناڤ	.xu.nav
ڕێگە	.řê.ge
فرۆش	.fi.roş
پەنا	.pe.na
بڵاوکراونەتە	.bi.ław.ki.raw.ne.te
جیاوازەکانی	.cya.wa.ze.ka.nî
پێشوازی	.pêş.wa.zî
عیماد	.ƹî.mad
کاربەدەستێکی	.kar.be.des.tê.kî
میلیۆن	.mîl.yon
نووبهار	.nû.bi.har
گاز	.gaz
بەرامبەر	.be.ram.ber
داڕێژەرەکانی	.da.řê.je.re.ka.nî
ئاسایش	.ʔa.sa.yiş
گەورەکاندا	.gew.re.kan.da
بۆمان	.bo.man
لەدوای	.le.dway
شڵوێ	.şił.wê
جیاوازییان	.cya.wa.zî.yan
داخستنی	.da.xis.ti.nî
پیرۆزی	.pî.ro.zî
هاتبوون	.ha.ti.bûn
بەڕێوەبەریی	.be.řê.we.be.rîy
سەریان	.ser.yan
کراوەکانی	.ki.ra.we.ka.nî
فیدراسیۆنی	.fîd.ras.yo.nî
نەرم	.nerm
دەمیش	.de.mîş
کەمەوە	.ke.me.we
ڕێوشوێنی	.řêw.şwê.nî
توێژینەوەی	.twê.jî.ne.wey
داخوازەکەی	.da.xwa.ze.key
ژیانیش	.jya.nîş
پارچەی	.par.çey
دابنێت	.da.bi.nêt
سەردێڕی	.ser.dê.řî
ڕۆژە	.řo.je
ئەوەم	.ʔe.wem
بوارە	.bwa.re
خوێنی	.xwê.nî
بانە	.ba.ne
بیخوێننەوە	.bî.xwê.ni.ne.we
بکەمەوە	.bi.ke.me.we
ڕێگایەکمان	.řê.ga.yek.man
کردین	.kir.dîn
رۆژاوایی	.ro.ja.wa.yî
لێبکرێ	.lê.bi.ki.rê
پەرتووکەکانیشی	.per.tû.ke.ka.nî.şî
مادەی	.ma.dey
گرووپێکی	.gi.rû.pê.kî
نووسیویەتی	.nû.sîw.ye.tî
بەهاری	.be.ha.rî
دەستخۆشی	.dest.xo.şî
ئەمە	.ʔe.me
ناوخۆیییەکانی	.naw.xo.yî.ye.ka.nî
نرابوو	.ni.ra.bû
ئۆتۆمبێلی	.ʔo.tom.bê.lî
هێرشانە	.hê.ri.şa.ne
بەتەمای	.be.te.may
پێداچوونەوەکان	.pê.da.çû.ne.we.kan
بووە	.bu.we
باقی	.ba.qî
نرخە	.nir.xe
لەهەمان	.le.he.man
سەردانیان	.ser.dan.yan
چییە	.çî.ye
زانکۆی	.zan.koy
ورمێ	.wir.mê
هاتوچووی	.ha.tu.çûy
کایەی	.ka.yey
ئەوەیان	.ʔe.we.yan
کەماڵ	.ke.mał
ڕۆژئاوایی	.řoj.ʔa.wa.yî
راگەیەندراو	.ra.ge.yen.di.raw
هەڵسەنگاندن	.heł.sen.gan.din
تازەش	.ta.zeş
چیای	.çyay
حەوتەمین	.ḧew.te.mîn
هەڵدەکەوێ	.heł.de.ke.wê
نین	.nîn
دواییانەدا	.dway.ya.ne.da
کردنەوەکانی	.kir.di.ne.we.ka.nî
هەڵوەشاندنەوەی	.heł.we.şan.di.ne.wey
توانیویانە	.twa.nîw.ya.ne
چەڵەمەدا	.çe.łe.me.da
چیرۆکدا	.çî.rok.da
کۆیە	.ko.ye
دەنگە	.den.ge
مەرجەکانی	.mer.ce.ka.nî
زۆرتر	.zor.tir
پاشماوەی	.paş.ma.wey
کوردن	.kur.din
ناوەکانە	.na.we.ka.ne
دیا	.dya
دە	.de
ناخۆشییە	.na.xo.şî.ye
کتێبەکە	.ki.tê.be.ke
کرابووەوە	.ki.ra.bu.we.we
دەبیندرا	.de.bîn.di.ra
ناتوانرێت	.nat.wan.rêt
بیانی	.bya.nî
نازناوەوە	.naz.na.we.we
دەنگدانەکاندا	.den.gi.da.ne.kan.da
بەبێ	.be.bê
پێنووسان	.pê.nû.san
ڕێککەوتننامەی	.řêk.kew.tin.na.mey
بیەوێت	.bye.wêt
ڕۆڵەکانی	.řo.łe.ka.nî
لەبەرانبەر	.le.be.ran.ber
مەڵبەندەکانیان	.meł.ben.de.kan.yan
شوان	.şwan
ڕاو	.řaw
بارودۆخەدا	.ba.ru.do.xe.da
بیناسێنین	.bî.na.sê.nîn
بخوێننەوە	.bi.xwê.ni.ne.we
دیوانی	.dî.wa.nî
خۆمم	.xo.mim
موبارەک	.mu.ba.rek
ناتۆ	.na.to
دیت	.dît
بداتەوە	.bi.da.te.we
تەواوەوە	.te.wa.we.we
دڵسۆز	.dił.soz
کوشتنی	.kuş.ti.nî
کەوا	.ke.wa
هەمیشەیی	.he.mî.şe.yî
دووزمانە	.dû.zi.ma.ne
وەرگرت	.wer.girt
بڵاودەکردەوە	.bi.ław.de.kir.de.we
کوروس	.ku.rus
فارسی	.far.sî
جۆربەجۆر	.cor.be.cor
ئازاری	.ʔa.za.rî
سیدیی	.sî.dîy
داهاتووی	.da.ha.tûy
کرانەوەی	.ki.ra.ne.wey
لێکۆڵەرەکان	.lê.ko.łe.re.kan
شاعیر	.şa.ƹîr
دەشتوانن	.deş.twa.nin
بەرپرسان	.ber.pir.san
یاساکە	.ya.sa.ke
تایبەتە	.tay.be.te
کۆمەڵ	.ko.meł
بڵوێزی	.bił.wê.zî
باوە	.ba.we
دڵەڕاوکێی	.di.łe.řaw.kêy
هێرشیان	.hê.riş.yan
سەرژمێریی	.ser.ji.mê.rîy
کەسانێکی	.ke.sa.nê.kî
ئەوەندەی	.ʔe.wen.dey
نمایش	.ni.ma.yiş
خومەینی	.xu.mey.nî
سپی	.si.pî
مەرگ	.merg
سەوز	.sewz
دایکم	.day.kim
بدینێتەوە	.bi.dî.nê.te.we
دووبارە	.dû.ba.re
لوبنان	.lub.nan
سوڵتانی	.suł.ta.nî
فەرهەنگیی	.fer.hen.gîy
شێوەزاری	.şê.we.za.rî
ڕێکەوتنی	.řê.kew.ti.nî
مەکتەبی	.mek.te.bî
سەرەتای	.se.re.tay
زنجیرە	.zin.cî.re
حاڵێک	.ḧa.łêk
چاپخانەیەک	.çap.xa.ne.yek
نەهاتووە	.ne.ha.tu.we
رووپەڕی	.rû.pe.řî
شوێنەواری	.şwê.ne.wa.rî
بەستنەوەی	.bes.ti.ne.wey
دۆخە	.do.xe
یەزیدی	.ye.zî.dî
دەزانێ	.de.za.nê
خواست	.xwast
تەها	.te.ha
لەهەوڵی	.le.hew.łî
دەبم	.de.bim
خوێندنگەیان	.xwên.din.ge.yan
سامی	.sa.mî
مادام	.ma.dam
لێدوانی	.lêd.wa.nî
ئەفغانستان	.ʔef.ẍa.nis.tan
نووری	.nû.rî
شەوان	.şe.wan
کۆیلەپەروەرانەکانی	.koy.le.per.we.ra.ne.ka.nî
دادەشکێ	.da.deş.kê
زایەندێتی	.za.yen.dê.tî
کەسەی	.ke.sey
پیشەیەکی	.pî.şe.ye.kî
نازانم	.na.za.nim
داواکاریییەکە	.da.wa.ka.rîy.ye.ke
گرتووەتەوە	.gir.tu.we.te.we
دووهەمی	.dû.he.mî
وڵاتان	.wi.ła.tan
پێشکەوتنی	.pêş.kew.ti.nî
خوێندنی	.xwên.di.nî
کەمپی	.kem.pî
بکرێن	.bi.ki.rên
لەنێوبەری	.le.nêw.be.rî
ئاسمانیی	.ʔas.ma.nîy
رای	.ray
سۆسیالیست	.sos.ya.lîst
هاوبەشن	.haw.be.şin
ڕەش	.řeş
هەڵدا	.heł.da
نەدەن	.ne.den
سەرگری	.ser.gi.rî
کوردیبێژ	.kur.dî.bêj
قسەم	.qi.sem
بەرهەمێکی	.ber.he.mê.kî
کەسی	.ke.sî
داخرا	.da.xi.ra
سیناریۆی	.sî.nar.yoy
تاقە	.ta.qe
پەرەستاندنی	.pe.res.tan.di.nî
یارمەتیی	.yar.me.tîy
سەرداگیرا	.ser.da.gî.ra
نەک	.nek
ببرێتە	.bib.rê.te
تیشک	.tîşk
کورمانجی	.kur.man.cî
شێخ	.şêx
نوری	.nu.rî
خوێندکاران	.xwênd.ka.ran
پارەکەیان	.pa.re.ke.yan
فڕێ	.fi.řê
کەریمی	.ke.rî.mî
گرفت	.gi.rift
وەخوێننەوە	.we.xwê.ni.ne.we
کتێبی	.ki.tê.bî
کوردستانی	.kur.dis.ta.nî
باشور	.ba.şur
گەر	.ger
مردنی	.mir.di.nî
مردن	.mir.din
کوژراو	.kuj.raw
کۆبانی	.ko.ba.nî
رەزۆیێ	.re.zo.yê
گۆڤارەکەی	.go.va.re.key
پیشکەوتنی	.pîş.kew.ti.nî
جارێکیتر	.ca.rê.kî.tir
چەندەها	.çen.de.ha
سەیر	.seyr
دروستکراوە	.di.rust.ki.ra.we
واش	.waş
ئەندامی	.ʔen.da.mî
محەمەد	.mi.ḧe.med
ئەوڕۆکانێ	.ʔew.řo.ka.nê
ڕەخنە	.řex.ne
تۆ	.to
کۆمیتەی	.ko.mî.tey
خانوویەکی	.xa.nû.ye.kî
بەرین	.be.rîn
شەرمەزار	.şer.me.zar
لیژنەی	.lîj.ney
میسری	.mîs.rî
دەشەلێ	.de.şe.lê
بن	.bin
رژێمی	.ri.jê.mî
تێدەکۆشێ	.tê.de.ko.şê
ئەرەن	.ʔe.ren
کاتی	.ka.tî
کۆم	.kom
گرینگەکان	.gi.rîn.ge.kan
گاڵ	.gał
ئاماژەی	.ʔa.ma.jey
ڕەوشی	.řew.şî
کەسان	.ke.san
خوێندکار	.xwênd.kar
لەگۆڕاندایە	.le.go.řan.da.ye
لەبەرئەوەی	.le.ber.ʔe.wey
گۆشت	.goşt
سامان	.sa.man
حکوومەتی	.ḧi.kû.me.tî
نوێیەکەیان	.nwê.ye.ke.yan
پلانی	.pi.la.nî
ئامۆژگارییان	.ʔa.moj.ga.rî.yan
هەڵەیەکی	.he.łe.ye.kî
پەسەند	.pe.send
سووری	.sû.rî
چم	.çim
گونجاوترە	.gun.caw.ti.re
راستییەکەیان	.ras.tî.ye.ke.yan
بباتەوە	.bi.ba.te.we
ئەڵمانیا	.ʔeł.man.ya
کەمال	.ke.mal
بکەنەوە	.bi.ke.ne.we
یانەکە	.ya.ne.ke
بەو	.bew
هەستکردن	.hest.kir.din
ئاو	.ʔaw
ڕوسیا	.řus.ya
توێژینەوەکانی	.twê.jî.ne.we.ka.nî
بڵاو	.bi.ław
ڕادەیەک	.řa.de.yek
وڵامی	.wi.ła.mî
لەهەمبەر	.le.hem.ber
لانیکەم	.la.nî.kem
پڕبایەخترین	.piř.ba.yex.ti.rîn
نەدابوو	.ne.da.bû
مانگ	.mang
راگەیەندرا	.ra.ge.yen.di.ra
ئامادەی	.ʔa.ma.dey
نووسەرەکانیدا	.nû.se.re.ka.nî.da
داڕێژەرانی	.da.řê.je.ra.nî
مەبەستی	.me.bes.tî
شیاو	.şyaw
تاوتوێکردنی	.taw.twê.kir.di.nî
هەزاریش	.he.za.rîş
دۆخەدا	.do.xe.da
بێبڕوایییەش	.bê.biř.wa.yî.yeş
ئەرتشیدا	.ʔer.ti.şî.da
کۆمەڵە	.ko.me.łe
پێگرتن	.pê.gir.tin
حکومەتێکی	.ḧi.ku.me.tê.kî
هەڵگوێزراون	.heł.gwêz.ra.win
لەچاپنەدرا	.le.çap.ne.di.ra
چێژی	.çê.jî
لەچاپدرابێ	.le.çap.di.ra.bê
راستییەکان	.ras.tî.ye.kan
لەکۆی	.le.koy
ئەیاد	.ʔe.yad
هاووڵاتییەکی	.haw.wi.ła.tî.ye.kî
دواکەوت	.dwa.kewt
منداڵێکی	.min.da.łê.kî
بەدی	.be.dî
ناوچەکانە	.naw.çe.ka.ne
هەموو	.he.mû
کربوونەوە	.kir.bû.ne.we
داری	.da.rî
رێپێنەدراوییەکان	.rê.pê.ne.di.ra.wî.ye.kan
بێگومان	.bê.gu.man
بەڕێوەبەرایەتی	.be.řê.we.be.ra.ye.tî
پانتایی	.pan.ta.yî
ئەمنیەتی	[.ʔem.nye.tî]
هەڤاڵەکانیان	.he.va.łe.kan.yan
کۆمال	.ko.mal
مۆتکلی	.mot.ki.lî
بەلەکی	.be.le.kî
فۆتۆکۆپی	.fo.to.ko.pî
دەوروبەری	.dew.ru.be.rî
دەگیران	.de.gî.ran
نەتەوەخوازیی	.ne.te.we.xwa.zîy
پژاک	.pi.jak
ناکەین	.na.keyn
نەدەگیرا	.ne.de.gî.ra
جوانیان	.cwan.yan
ئەوقاف	.ʔew.qaf
ڕێژەیەکی	.řê.je.ye.kî
ڕە	.ře
ئیسلامییە	.ʔîs.la.mî.ye
وانەی	.wa.ney
هەلانە	.he.la.ne
کۆمپانیاکان	.kom.pan.ya.kan
بەکاری	.be.ka.rî
پەڕتووکنامەیەک	.peř.tûk.na.me.yek
ڕاگەیاندووە	.řa.ge.yan.du.we
زمانکوژییە	.zi.man.ku.jî.ye
بزاڤەکانی	.bi.za.ve.ka.nî
وشە	.wi.şe
کەلوپەلی	.ke.lu.pe.lî
کراوەتەوە	.ki.ra.we.te.we
لەچاپدەرانەن	.le.çap.de.ra.nen
پێکهاتنی	.pêk.ha.ti.nî
مەسەلەی	.me.se.ley
کۆنتڕۆڵی	.kon.ti.řo.łî
نێوخۆیییەکانەوە	.nêw.xo.yî.ye.ka.ne.we
وشەی	.wi.şey
دەردەبڕی	.der.deb.řî
رابگەیەندرێ	.ra.bi.ge.yen.di.rê
ناشتوانن	.naş.twa.nin
بایەخ	.ba.yex
ناوچەکاندا	.naw.çe.kan.da
هەردی	.her.dî
گرووپەکان	.gi.rû.pe.kan
ناوبژیوانی	.naw.bi.jî.wa.nî
هۆی	.hoy
چاوەڕێی	.ça.we.řêy
مۆسکۆ	.mos.ko
خوارێ	.xwa.rê
بۆیە	.bo.ye
دیاربەکرن	.dyar.be.ki.rin
چاکردنەوەی	.ça.kir.di.ne.wey
دەژی	.de.jî
ڕیاڵ	.řyał
ئامرازی	.ʔam.ra.zî
دواوە	.dwa.we
رێزمان	.rêz.man
دێموکراتیک	.dê.muk.ra.tîk
ئەدات	.ʔe.dat
لێپرسینەوەکەمدا	.lê.pir.sî.ne.we.kem.da
وتارەکەیدا	.wi.ta.re.key.da
من	.min
چاپخانەگەلێکیان	.çap.xa.ne.ge.lêk.yan
دروستکردنی	.di.rust.kir.di.nî
کاتێکی	.ka.tê.kî
دەرچووە	.der.çu.we
وێ	.wê
لەکۆڵی	.le.ko.łî
داوە	.da.we
کۆکراوەکان	.ko.ki.ra.we.kan
لەمپەر	.lem.per
ئامادەن	.ʔa.ma.den
هاووڵاتییە	.haw.wi.ła.tî.ye
فەرهاد	.fer.had
بیبیسە	.bî.bî.se
ژێرنووسی	.jêr.nû.sî
دێموکراسی	.dê.muk.ra.sî
کانی	.ka.nî
قەیران	.qey.ran
تێرمینۆلۆژی	.têr.mî.no.lo.jî
بۆچوونە	.bo.çû.ne
نابێت	.na.bêt
ستاندنیان	.si.tan.din.yan
لەمپەرانێکیان	.lem.pe.ra.nêk.yan
وەرناگیردرێ	.wer.na.gîr.di.rê
خووی	.xûy
جەنگەوە	.cen.ge.we
ململانێ	.mil.mi.la.nê
هەردوو	.her.dû
رۆژنامەوانی	.roj.na.me.wa.nî
بەڵکو	.beł.ku
هەندێکیش	.hen.dê.kîş
خەڵکانی	.xeł.ka.nî
ڕۆح	.řoḧ
ئەمڕۆ	.ʔem.řo
بەرهەم	.ber.hem
پاشان	.pa.şan
رێزلێنانی	.rêz.lê.na.nî
وەها	.we.ha
هەڵبژاردن	.heł.bi.jar.din
زیادەباج	.zya.de.bac
کامەران	.ka.me.ran
ڕێگری	.řê.gi.rî
هەندەرانێ	.hen.de.ra.nê
کوشتن	.kuş.tin
گۆڕانکاریگەلێکی	.go.řan.ka.rî.ge.lê.kî
بەکاردەهێنران	.be.kar.de.hên.ran
چالاکییەکانیان	.ça.la.kî.ye.kan.yan
بەکوردی	.be.kur.dî
سەعید	.se.ƹîd
کۆمەڵگادا	.ko.meł.ga.da
دێتەوە	.dê.te.we
شێوازە	.şê.wa.ze
شیعەکان	.şî.ƹe.kan
دەبێ	.de.bê
ڕۆژهەڵات	.řoj.he.łat
چەشنگەلێکی	.çe.şin.ge.lê.kî
کۆبوونەوە	.ko.bû.ne.we
کەنداو	.ken.daw
خاوێن	.xa.wên
بیست	.bîst
ناحیەی	.naḧ.yey
رێکخراوەیەک	.rêk.xi.ra.we.yek
پڕۆژە	.pi.řo.je
سەرهەڵدانی	.ser.heł.da.nî
نافرۆشن	.na.fi.ro.şin
کۆنگرە	.kon.gi.re
لیستە	.lîs.te
بدە	.bi.de
دروشمی	.di.ruş.mî
گۆڤارەکاندا	.go.va.re.kan.da
چالاکی	.ça.la.kî
کۆبوونەوەی	.ko.bû.ne.wey
یانی	.ya.nî
عەفرین	.ƹef.rîn
لکێنراوە	.li.kên.ra.we
دەفرۆشتنەوە	.def.roş.ti.ne.we
قەدەغەکردنی	.qe.de.ẍe.kir.di.nî
ئەحمەدی	.ʔeḧ.me.dî
پێنجەم	.pên.cem
بەرگرییان	.ber.gi.rî.yan
بنکەیەکی	.bin.ke.ye.kî
عەشق	.ƹeşq
نێوەیان	.nê.we.yan
کۆی	.koy
دەکەینەوە	.de.key.ne.we
دەکەی	.de.key
دروستکرد	.di.rust.kird
نارەزایەتی	.na.re.za.ye.tî
گەیاندە	.ge.yan.de
دووەمدا	.du.wem.da
شام	.şam
تابلۆی	.tab.loy
بنووسن	.bi.nû.sin
بەشداران	.beş.da.ran
ئازادکردنی	.ʔa.zad.kir.di.nî
دابینکردنی	.da.bîn.kir.di.nî
دەیانکوت	.de.yan.kut
بڵاویکردبوونەوە	.bi.ła.wî.kir.di.bû.ne.we
ڕووداوەکانی	.řû.da.we.ka.nî
سەرکۆماری	.ser.ko.ma.rî
وەربگرن	.wer.big.rin
تورکییە	.tur.kî.ye
مام	.mam
نەخۆشخانەی	.ne.xoş.xa.ney
دووپاتکردەوە	.dû.pat.kir.de.we
نەتەوەکان	.ne.te.we.kan
وڵام	.wi.łam
چەکدارانی	.çek.da.ra.nî
ئێمەش	.ʔê.meş
جێبەجێ	.cê.be.cê
نییە	.nî.ye
بوونەوە	.bû.ne.we
یەکێتێ	.ye.kê.tê
هەم	.hem
عەبدوڕەحمان	.ƹeb.du.řeḧ.man
ڕۆژنامەنووس	.řoj.na.me.nûs
نێوخۆیییەکان	.nêw.xo.yî.ye.kan
دیسانەوە	.dî.sa.ne.we
ئابوری	.ʔa.bu.rî
حدکا	.ḧid.ka
ڕکابەری	.ři.ka.be.rî
راپرسنامەکە	.ra.pirs.na.me.ke
جێبەجێنەکرانی	.cê.be.cê.ne.ki.ra.nî
بەدڵنیاییەوە	.bed.łi.nyay.ye.we
تابلۆ	.tab.lo
چەپی	.çe.pî
دێڕان	.dê.řan
وێنەکە	.wê.ne.ke
کوردوستانی	.kur.dus.ta.nî
دابین	.da.bîn
لێک	.lêk
تەک	.tek
بایوغلو	.ba.yuẍ.lu
خێرا	.xê.ra
سەیری	.sey.rî
باکوور	.ba.kûr
تێیاندا	.tê.yan.da
هاوڕێیەکان	.haw.řê.ye.kan
مامۆستایان	.ma.mos.ta.yan
وەبەرهێنان	.we.ber.hê.nan
کۆمارخوازەکانی	.ko.mar.xwa.ze.ka.nî
خوار	.xwar
یاریەکانی	.yar.ye.ka.nî
بەها	.be.ha
برد	.bird
فەرمانبەرە	.fer.man.be.re
شەقامەکان	.şe.qa.me.kan
سەرکردایەتی	.ser.kir.da.ye.tî
کتێبەش	.ki.tê.beş
واتای	.wa.tay
حەمکە	.ḧem.ke
وەرگێڕێک	.wer.gê.řêk
هاڕۆڵد	.ha.řołd
درێژخایەن	.di.rêj.xa.yen
ڤیدیۆ	.vî.dyo
ڕووداوانە	.řû.da.wa.ne
پرۆگرامی	.pi.rog.ra.mî
پێشێل	.pê.şêl
ناسنامەی	.nas.na.mey
بدرێ	.bid.rê
هۆرتەوبەرەیە	.hor.tew.be.re.ye
کوردەکانی	.kur.de.ka.nî
ئێمەوە	.ʔê.me.we
کوردانەیە	.kur.da.ne.ye
نەدەدرا	.ne.de.di.ra
دانیشتووە	.da.nîş.tu.we
دەوروبەر	.dew.ru.ber
ئافراندنی	.ʔaf.ran.di.nî
بەتەما	.be.te.ma
پشتسووریی	.pişt.sû.rîy
چاپخانەکەشیاندا	.çap.xa.ne.keş.yan.da
گەنجانی	.gen.ca.nî
رێکخراوەکانی	.rêk.xi.ra.we.ka.nî
عێراقییەکان	.ƹê.ra.qî.ye.kan
بەخشی	.bex.şî
نازناوانە	.naz.na.wa.ne
خانەوادەی	.xa.ne.wa.dey
ڕۆژەی	.řo.jey
شێوەیەکی	.şê.we.ye.kî
بڵاودەکاتەوە	.bi.ław.de.ka.te.we
کانوونی	.ka.nû.nî
هەڵسوکەوتی	.heł.su.kew.tî
شۆڕشی	.şo.ři.şî
ڕووت	.řût
تریان	.tir.yan
کەسایەتیی	.ke.sa.ye.tîy
کەسانە	.ke.sa.ne
کەسوکاری	.ke.su.ka.rî
ئەوروپای	.ʔew.ru.pay
بەشداریی	.beş.da.rîy
بڵاوکراوەتەوە	.bi.ław.ki.ra.we.te.we
ساڵێک	.sa.łêk
گوتنەوە	.gu.ti.ne.we
هەڵبژاردنەکانی	.heł.bi.jar.di.ne.ka.nî
سۆران	.so.ran
جەختی	.cex.tî
تەلەڤیزیۆنە	.te.le.vîz.yo.ne
پڕ	.piř
بابەتی	.ba.be.tî
دەفرۆشدرێن	.def.roş.di.rên
کەوایە	.ke.wa.ye
پێچەوانەوە	.pê.çe.wa.ne.we
داواکارییەی	.da.wa.ka.rî.yey
دەبەنگ	.de.beng
دەکڕی	.de.ki.řî
ئەورووپاش	.ʔew.rû.paş
بنەمای	.bi.ne.may
ئەگینا	.ʔe.gî.na
ئاوایییەکانیان	.ʔa.wa.yî.ye.kan.yan
ناز	.naz
گەنجان	.gen.can
پێشگری	.pêş.gi.rî
جاری	.ca.rî
مەناف	.me.naf
زۆرێک	.zo.rêk
بەرژەوەندی	.ber.je.wen.dî
لەرووی	.le.rûy
ناچار	.na.çar
بەشێوەی	.be.şê.wey
راستیی	.ras.tîy
چەوسانەوەی	.çew.sa.ne.wey
مانایەکی	.ma.na.ye.kî
فێری	.fê.rî
شارەزای	.şa.re.zay
گەبەروبێکار	.ge.be.ru.bê.kar
دەگرێتەوە	.de.gi.rê.te.we
خاوەنە	.xa.we.ne
بدۆزنەوە	.bi.do.zi.ne.we
رامانەوە	.ra.ma.ne.we
فی	.fî
راگەیاندنەکانی	.ra.ge.yan.di.ne.ka.nî
سنوورەکە	.si.nû.re.ke
ناکەن	.na.ken
پێکردنی	.pê.kir.di.nî
عەللاوی	.ƹel.la.wî
دەزگا	.dez.ga
ئاگادارینامەکەدا	.ʔa.ga.da.rî.na.me.ke.da
شاندێکی	.şan.dê.kî
لەسەرجەم	.le.ser.cem
کوردیییەکانیان	.kur.dîy.ye.kan.yan
وەسف	.we.sif
خەلک	.xelk
بەرلەوەی	.ber.le.wey
هاوبڕیارەکانیاندا	.haw.biř.ya.re.kan.yan.da
سەرژمێرییەکە	.ser.ji.mê.rî.ye.ke
دین	.dîn
فیکری	.fîk.rî
گرنگە	.gi.rin.ge
مێشکی	.mêş.kî
لۆژیکی	.lo.jî.kî
سوورییانە	.sû.rî.ya.ne
سەخت	.sext
دارێژراوە	.da.rêj.ra.we
پەرەسەندنی	.pe.re.sen.di.nî
ویژدانی	.wîj.da.nî
وایکردووە	.way.kir.du.we
پێشقوتابی	.pêş.qu.ta.bî
داسەپاند	.da.se.pand
ئانکارادا	.ʔan.ka.ra.da
گۆڵ	.goł
ئەوروپی	.ʔew.ru.pî
دراوسێ	.di.raw.sê
نەیدەتوانی	.ney.det.wa.nî,.ney.de.twa.nî
کرد	.kird
هان	.han
هەردووک	.her.dûk
گەرمیان	.germ.yan
رانەهاتوون	.ra.ne.ha.tûn
پێشکەفتن	.pêş.kef.tin
مەبەستە	.me.bes.te
هەرێمەوە	.he.rê.me.we
جەنابی	.ce.na.bî
بەچەند	.be.çend
داخەوە	.da.xe.we
زیادی	.zya.dî
هەڵبەت	.heł.bet
بەشداربوون	.beş.dar.bûn
کەتەلۆگانە	.ke.te.lo.ga.ne
کوردایەتی	.kur.da.ye.tî
ڕێکخراوێکی	.řêk.xi.ra.wê.kî
تیمی	.tî.mî
بێتە	.bê.te
حسابی	.ḧi.sa.bî
پرسیبووم	.pir.sî.bûm
سێ	.sê
سەربەرزیی	.ser.ber.zîy
ئاسۆ	.ʔa.so
خەڵکەکە	.xeł.ke.ke
هەوڵ	.hewł
بەرواری	.ber.wa.rî
بەیرووتدا	.bey.rût.da
بەکرێ	.be.ki.rê
پێست	.pêst
تەسلیم	.tes.lîm
پۆستەوە	.pos.te.we
هەڵ	.heł
کاربەدەستێک	.kar.be.des.têk
لێپرسراوانی	.lê.pirs.ra.wa.nî
سزای	.si.zay
ڕایانگەیاندووە	.řa.yan.ge.yan.du.we
فڕۆکە	.fi.řo.ke
هەژاند	.he.jand
ئاماژە	.ʔa.ma.je
وەرناگرن	.wer.na.gi.rin
سووکایەتی	.sû.ka.ye.tî
جەنگ	.ceng
شاعیرێک	.şa.ƹî.rêk
نێوانیان	.nê.wan.yan
برایانی	.bi.ra.ya.nî
ئینگلیسییەکان	.ʔîn.gi.lî.sî.ye.kan
خۆیشی	.xoy.şî
گەڕاوم	.ge.řa.wim
ئەستێرەی	.ʔes.tê.rey
بڵێی	.bi.łêy
لەهەر	.le.her
هەڵەبجەی	.he.łeb.cey
وەلات	.we.lat
هزری	.hiz.rî
مەهاباد	.me.ha.bad
چەشنە	.çeş.ne
دەنگ	.deng
شار	.şar
سویسدا	.swîs.da
ملیار	.mil.yar
دەستنووس	.dest.nûs
بوونە	.bû.ne
خۆتێوەردانەکانی	.xo.tê.wer.da.ne.ka.nî
مشت	.mişt
ناردراوەکان	.nar.di.ra.we.kan
کارەساتە	.ka.re.sa.te
ڕۆژئاوا	.řoj.ʔa.wa
دەهێنرێنە	.de.hên.rê.ne
وەزیری	.we.zî.rî
نەرمونیانانەوە	.ner.mu.nya.na.ne.we
ڕابێرت	.řa.bêrt
چیرۆکی	.çî.ro.kî
وێستگەی	.wês.ti.gey
گوندەکانی	.gun.de.ka.nî
گەیشتە	.ge.yiş.te
لەناوچەکەدا	.le.naw.çe.ke.da
خاوەندارێتیشی	.xa.wen.da.rê.tî.şî
تۆمەتی	.to.me.tî
کۆمارخوازی	.ko.mar.xwa.zî
شێوە	.şê.we
ژین	.jîn
دەیەی	.de.yey
چاپەکە	.ça.pe.ke
هەڵبژاردندا	.heł.bi.jar.din.da
خێراکار	.xê.ra.kar
ماوە	.ma.we
ناوەوە	.na.we.we
جیاتی	.cya.tî
ڕێبازی	.řê.ba.zî
نڤیسیاری	.ni.vîs.ya.rî
ئەدەبی	.ʔe.de.bî
هەموویان	.he.mû.yan
نەبونی	.ne.bu.nî
ئاگاداری	.ʔa.ga.da.rî
نەیکا	.ney.ka
هەڕەتێک	.he.ře.têk
نەکرام	.ne.ki.ram
بەشکچی	.be.şik.çî
بەڵگە	.beł.ge
هەورامی	.hew.ra.mî
نابەجێ	.na.be.cê
تەقەمەنی	.te.qe.me.nî
فێستیڤاڵەکە	.fês.tî.va.łe.ke
پێشمەرگە	.pêş.mer.ge
پرسیارێک	.pirs.ya.rêk
رووداوەکانی	.rû.da.we.ka.nî
دەگرت	.de.girt
بەندی	.ben.dî
عەباس	.ƹe.bas
بەنزین	.ben.zîn
فرۆشدا	.fi.roş.da
وەرگێڕ	.wer.gêř
سەرگیرا	.ser.gî.ra
دەستووری	.des.tû.rî
ببنەوە	.bib.ne.we,.bi.bi.ne.we
ئەوی	.ʔe.wî
رووناکبیر	.rû.nak.bîr
بنێرێ	.bi.nê.rê
چەوسانەوە	.çew.sa.ne.we
داواکاریشی	.da.wa.ka.rî.şî
قەرەوی	.qe.re.wî
داون	.da.win
دیمۆکراتیکە	.dî.mok.ra.tî.ke
باراک	.ba.rak
گرتنی	.gir.ti.nî
پەنجەی	.pen.cey
هێنرابوون	.hên.ra.bûn
هۆکارانە	.ho.ka.ra.ne
شیرینی	.şî.rî.nî
سەرکردە	.ser.kir.de
نەتەوەخوازانەیە	.ne.te.we.xwa.za.ne.ye
کوردەکان	.kur.de.kan
خێڵە	.xê.łe
کراوی	.ki.ra.wî
رێنووسی	.rê.nû.sî
هەوڵدان	.hewł.dan
ئاراستەی	.ʔa.ras.tey
ماڵپەڕەکان	.mał.pe.ře.kan
دەڵێیت	.de.łêyt
واژۆکەرەکانی	.wa.jo.ke.re.ka.nî
سالی	.sa.lî
رەنگە	.ren.ge
ئەندازیاری	.ʔen.daz.ya.rî
کێشەیە	.kê.şe.ye
بڕوایان	.biř.wa.yan
نێونیشانێکم	.nêw.nî.şa.nê.kim
باجی	.ba.cî
هەنگاوە	.hen.ga.we
بفرۆشێ	.bif.ro.şê
دوستاخ	.dus.tax
داعشەوە	.da.ƹi.şe.we
فەقی	.fe.qî
عوسمانییەکاندا	.ƹus.ma.nî.ye.kan.da
قازانجێک	.qa.zan.cêk
ژیانی	.jya.nî
کەسێتی	.ke.sê.tî
زێباری	.zê.ba.rî
شەڕ	.şeř
دەکەمەوە	.de.ke.me.we
کوڕەکەی	.ku.ře.key
فرۆشتووین	.fi.roş.tûyn
ناکات	.na.kat
لەباتی	.le.ba.tî
ئومێدی	.ʔu.mê.dî
ناساندبوو	.na.san.di.bû
تێدەچێ	.tê.de.çê
ژوورەدا	.jû.re.da
ماڵی	.ma.łî
بەڕێوەبەرایەتییە	.be.řê.we.be.ra.ye.tî.ye
زانیارییەوە	.zan.ya.rî.ye.we
سویدیش	.swî.dîş
ناوەڕۆکی	.na.we.řo.kî
نەشیانتوانیوە	.neş.yan.twa.nî.we
ئەنجومەنی	.ʔen.cu.me.nî
کاربەدەستانی	.kar.be.des.ta.nî
سوریە	.sur.ye
گۆڤاران	.go.va.ran
سەرباز	.ser.baz
لێزانی	.lê.za.nî
بڕیاردەدەن	.biř.yar.de.den
مابوونەوە	.ma.bû.ne.we
نووسراون	.nûs.ra.win
زۆرکاریدا	.zor.ka.rî.da
سالار	.sa.lar
نەخشەی	.nex.şey
چاودێریی	.çaw.dê.rîy
کوێ	.kwê
هاوکار	.haw.kar
یاساییی	.ya.sa.yîy
دابڕاوەکانی	.da.bi.řa.we.ka.nî
ئەوەش	.ʔe.weş
دابووەوە	.da.bu.we.we
بەڕێوەی	.be.řê.wey
گۆڕانکارییەکانیان	.go.řan.ka.rî.ye.kan.yan
نوێژی	.nwê.jî
هێزەکانی	.hê.ze.ka.nî
کوردیم	.kur.dîm
ئینجیلی	.ʔîn.cî.lî
گەشە	.ge.şe
پارەیان	.pa.re.yan
پار	.par
فەرمییە	.fer.mî.ye
بۆچوونەکاندا	.bo.çû.ne.kan.da
هێندراونەتە	.hên.di.raw.ne.te
کار	.kar
ڕوونیشیکردەوە	.řû.nî.şî.kir.de.we
هەڵبەست	.heł.best
ڕازی	.řa.zî
دەستدرێژی	.dest.di.rê.jî
جێگای	.cê.gay
شتانە	.şi.ta.ne
مۆڵەتی	.mo.łe.tî
سەفەری	.se.fe.rî
راپرسنامەکان	.ra.pirs.na.me.kan
تایبەتی	.tay.be.tî
دەخران	.de.xi.ran
بەرپرسی	.ber.pir.sî
کتێبان	.ki.tê.ban
کتومتی	.ki.tum.tî
دەلوا	.del.wa
نووسینگە	.nû.sîn.ge
رایانگواستبوون	.ra.yan.gwas.ti.bûn
حکوومەتەوە	.ḧi.kû.me.te.we
پێشانگاکەیان	.pê.şan.ga.ke.yan
یەعقووب	.yeƹ.qûb
خاوەنەکان	.xa.we.ne.kan
رزگاریی	.riz.ga.rîy
ڕاهێنانی	.řa.hê.na.nî
بهێنێت	.bi.hê.nêt
کۆبانێ	.ko.ba.nê
ئەردۆغان	.ʔer.do.ẍan
بەسەرهاتی	.be.ser.ha.tî
گ	.gi
بەکۆچ	.be.koç
زمانەکان	.zi.ma.ne.kan
بخرێتە	.bi.xi.rê.te,.bix.rê.te
نموونە	.ni.mû.ne
ئێراندا	.ʔê.ran.da
بڕینی	.bi.řî.nî
پەیامنێری	.pe.yam.nê.rî
ڕێک	.řêk
خەیالی	.xe.ya.lî
چاویان	.çaw.yan
چاپخانەیە	.çap.xa.ne.ye
دڵسۆزی	.dił.so.zî
عەسکەری	.ƹes.ke.rî
کاردەکەن	.kar.de.ken
لێدەکرا	.lê.de.ki.ra
عەرەبە	.ƹe.re.be
ریزی	.rî.zî
سوپای	.su.pay
کۆمیتەیەکی	.ko.mî.te.ye.kî
ژیانە	.jya.ne
خاوەنانەش	.xa.we.na.neş
هەڕەتی	.he.ře.tî
بناغە	.bi.na.ẍe
مەلای	.me.lay
براوەی	.bi.ra.wey
هەنگاوێک	.hen.ga.wêk
فەرهەنگییەکاندا	.fer.hen.gî.ye.kan.da
بڵاوکرانەوە	.bi.ław.ki.ra.ne.we
کام	.kam
پارەوە	.pa.re.we
داسەپان	.da.se.pan
قوربان	.qur.ban
دەستگیر	.dest.gîr
گرنگیان	.gi.ring.yan
حکوومەتێکی	.ḧi.kû.me.tê.kî
بەبڕی	.be.bi.řî
دەکا	.de.ka
دانابوون	.da.na.bûn
مەجلیسی	.mec.lî.sî
ببینە	.bi.bî.ne
بەرزبوونەوەی	.berz.bû.ne.wey
پینتر	.pîn.tir
پێداویستیی	.pê.da.wîs.tîy
دەردەکەوێت	.der.de.ke.wêt
رادەیە	.ra.de.ye
عوسمانییەکانیش	.ƹus.ma.nî.ye.ka.nîş
دەنێرن	.de.nê.rin
ماچ	.maç
رێکخستنی	.rêk.xis.ti.nî
دوێنێ	.dwê.nê
دژ	.dij
حەزرەتی	.ḧez.re.tî
لیژنە	.lîj.ne
کوردییەکانە	.kur.dî.ye.ka.ne
چەوساندنەوە	.çew.san.di.ne.we
کورتیان	.kurt.yan
بوار	.bwar
لەچاپدەران	.le.çap.de.ran
حەمۆی	.ḧe.moy
وتووێژەکانیان	.wi.tu.wê.je.kan.yan
فرە	.fi.re
ئزمیر	.ʔiz.mîr
دادوەری	.dad.we.rî
داڕێژەران	.da.řê.je.ran
تەئکیدی	.teʔ.kî.dî
یەکان	.ye.kan
شوباتی	.şu.ba.tî
چاوەڕوانی	.ça.weř.wa.nî,.ça.we.řwa.nî
تورکیایان	.turk.ya.yan
بڕیارنامەیەکی	.biř.yar.na.me.ye.kî
دەنووسن	.de.nû.sin
فرەتر	.fi.re.tir
تاقیکردنەوەی	.ta.qî.kir.di.ne.wey
یەکێک	.ye.kêk
منداڵان	.min.da.łan
لەچاپدرا	.le.çap.di.ra
سروشت	.si.ruşt
ڕۆژنامەکە	.řoj.na.me.ke
کۆیلە	.koy.le
تێکۆشیبوو	.tê.ko.şî.bû
بوایە	.bwa.ye
ڕەواکانی	.ře.wa.ka.nî
دووی	.dûy
دەخۆڕی	.de.xo.řî
ڕێکەوتن	.řê.kew.tin
چوارشەممە	.çwar.şem.me
یاسایەک	.ya.sa.yek
نووسەران	.nû.se.ran
کارتی	.kar.tî
چۆناوچۆن	.ço.naw.çon
خۆم	.xom
بازرگانی	.ba.zir.ga.nî
چاپکراوەکانیش	.çap.ki.ra.we.ka.nîş
کاریگەر	.ka.rî.ger
ناوچەی	.naw.çey
کراونەتەوە	.ki.raw.ne.te.we
نەگۆڕێندراون	.ne.go.řên.di.ra.win
زەحمەت	.zeḧ.met
ڕەوانەی	.ře.wa.ney
ڕووبەرووی	.řû.be.rûy
دارایی	.da.ra.yî
بەتەواوەتی	.be.te.wa.we.tî
بڵاوکردووەتەوە	.bi.ław.kir.du.we.te.we
ناکامی	.na.ka.mî
دەڵێم	.de.łêm
دەکەونە	.de.ke.wi.ne
کۆکراوەی	.ko.ki.ra.wey
خواردنەوەی	.xwar.di.ne.wey
ماددەی	.mad.dey
دیکەشەوە	.dî.ke.şe.we
پاسپۆرتیشیان	.pas.por.tîş.yan
ئەوا	.ʔe.wa
لەمەوبەر	.le.mew.ber
پێشبینی	.pêş.bî.nî
رێخراوەکاندا	.rêx.ra.we.kan.da
داواکاری	.da.wa.ka.rî
زەڤی	.ze.vî
گرینگیان	.gi.rîng.yan
ڕێبەرایەتی	.řê.be.ra.ye.tî
وەزارەت	.we.za.ret
لێدان	.lê.dan
بەرهەمی	.ber.he.mî
دەگیرا	.de.gî.ra
گشتییەکان	.giş.tî.ye.kan
رێکخراوەی	.rêk.xi.ra.wey
رایانگەیاند	.ra.yan.ge.yand
گیرا	.gî.ra
دیتم	.dî.tim
گەریلا	.ge.rî.la
بۆنەی	.bo.ney
دەرکەوت	.der.kewt
هاتەوە	.ha.te.we
بووبێ	.bû.bê
گۆرانی	.go.ra.nî
هەروەها	.her.we.ha
بەخۆیەوە	.be.xo.ye.we
ئاغا	.ʔa.ẍa
کۆبوونەوەیەک	.ko.bû.ne.we.yek
کاتژمێر	.kat.ji.mêr
هەبووە	.he.bu.we
جەفەر	.ce.fer
پێدا	.pê.da
ماڵەکەم	.ma.łe.kem
گرووپانێکی	.gi.rû.pa.nê.kî
کۆمارخوازیدا	.ko.mar.xwa.zî.da
نێوەکانیشیان	.nê.we.ka.nîş.yan
زۆرینەی	.zo.rî.ney
بۆم	.bom
جوولەکەکان	.cû.le.ke.kan
سەرە	.se.re
ئەمن	.ʔe.min
گروپی	.gi.ru.pî
فرۆشەکەی	.fi.ro.şe.key
ئێستەکانێ	.ʔês.te.ka.nê
شەر	.şer
ئایینییان	.ʔa.yî.nî.yan
کتێبفرۆشییەکەی	.ki.têb.fi.ro.şî.ye.key
هاتوو	.ha.tû
کەش	.keş
فرۆشتبوون	.fi.roş.ti.bûn
تایبەتییەکانی	.tay.be.tî.ye.ka.nî
پێی	.pêy
دڕووتریشدایە	.di.řû.ti.rîş.da.ye
ڕاستەوخۆی	.řas.tew.xoy
بۆنەکەی	.bo.ne.key
تەلەفزیۆن	.te.le.fiz.yon
لەوەتا	.le.we.ta
قەیرانی	.qey.ra.nî
نا	.na
توانایی	.twa.na.yî
تایبەت	.tay.bet
عەبادی	.ƹe.ba.dî
بەدەگمەن	.be.deg.men
کات	.kat
بەپێی	.be.pêy
کێبەرکێ	.kê.ber.kê
ئیعدام	.ʔîƹ.dam
پێشنیارە	.pêş.nya.re
دەوڵەتێکی	.dew.łe.tê.kî
هاوکاری	.haw.ka.rî
زاراوەکان	.za.ra.we.kan
پەڕتووکی	.peř.tû.kî
زاییندراوی	.za.yîn.di.ra.wî
نەدۆزیوەتەوە	.ne.do.zî.we.te.we
راستەوخۆیان	.ras.tew.xo.yan
وەرگێڕاو	.wer.gê.řaw
ئاکار	.ʔa.kar
داونەتەوە	.daw.ne.te.we
پێشانگاگەلی	.pê.şan.ga.ge.lî
ڕۆژئاوادا	.řoj.ʔa.wa.da
ئەرتشی	.ʔer.ti.şî
نوو	.nû
لەچاپدران	.le.çap.di.ran
یاسای	.ya.say
زەمان	.ze.man
وڵاتەکەمان	.wi.ła.te.ke.man
جار	.car
یەکە	.ye.ke
کارەکەیان	.ka.re.ke.yan
نییەکە	.nî.ye.ke
ئازادیخواز	.ʔa.za.dî.xwaz
بەشەی	.be.şey
فەرمانگەی	.fer.man.gey
کردوو	.kir.dû
راستەقینە	.ras.te.qî.ne
لایەنگرییەوە	.la.yen.gi.rî.ye.we
ویلایەتی	.wî.la.ye.tî
لەگەڕدان	.le.geř.dan
ڕووناک	.řû.nak
نەخوێندەوار	.ne.xwên.de.war
ستەمبۆڵدا	.si.tem.boł.da
رێگای	.rê.gay
نیم	.nîm
دەفەرموێت	.de.fer.mwêt
حکومەتەکەی	.ḧi.ku.me.te.key
لیس	.lîs
هاووڵاتیان	.haw.wi.łat.yan
خولەک	.xu.lek
توندوتیژی	.tun.du.tî.jî
دەبنەوە	.de.bi.ne.we
نووسەرە	.nû.se.re
عِلمیَة	.ƹîlm.yeة
بارەگای	.ba.re.gay
باکور	.ba.kur
گلەیی	.gi.le.yî
باری	.ba.rî
گوللە	.gul.le
خودای	.xu.day
کوێت	.kwêt
کۆبۆنەوەگەلێک	.ko.bo.ne.we.ge.lêk
کا	.ka
فرۆشی	.fi.ro.şî
بەیرووتیان	.bey.rût.yan
شۆڕشگێڕی	.şo.řiş.gê.řî
خەونی	.xew.nî
دەکەوێ	.de.ke.wê
باجێکی	.ba.cê.kî
نیازی	.nya.zî
موحەمەد	.mu.ḧe.med
پێکردووە	.pê.kir.du.we
ئەماژەیە	.ʔe.ma.je.ye
والت	.walt
بەگشتی	.be.giş.tî
ماسی	.ma.sî
چاپکراوەگەلەدا	.çap.ki.ra.we.ge.le.da
باوکی	.baw.kî
نایدەن	.nay.den
نەبیسرانی	.ne.bîs.ra.nî
ترەوە	.ti.re.we
ئەنفال	.ʔen.fal
ناکوردی	.na.kur.dî
دەوێرن	.de.wê.rin
لەلایەک	.le.la.yek
پەیەدە	.pe.ye.de
بڵاوکەری	.bi.ław.ke.rî
دەرکرا	.der.ki.ra
کۆپییان	.ko.pî.yan
دەدانێ	.de.da.nê
پاشەکشەی	.pa.şe.ki.şey
ئێرانیش	.ʔê.ra.nîş
دەینەوە	.dey.ne.we
بکەی	.bi.key
ئاژاولەی	.ʔa.jaw.ley
پشتگیری	.pişt.gî.rî
ستەمبۆل	.si.tem.bol
سەعدی	.seƹ.dî
پارکی	.par.kî
دوکان	.du.kan
تێکۆشانی	.tê.ko.şa.nî
زەبەندتریان	.ze.bend.tir.yan
دەولەتی	.dew.le.tî
ڕیزبەندی	.řîz.ben.dî
کۆمێنت	.ko.mênt
پەڕتووکنامەگەلی	.peř.tûk.na.me.ge.lî
راستەقینەی	.ras.te.qî.ney
سیخوڕی	.sî.xu.řî
هێنانە	.hê.na.ne
مەزهەب	.mez.heb
باشە	.ba.şe
دژە	.di.je
تیپی	.tî.pî
نەبێت	.ne.bêt
پێکهێنانی	.pêk.hê.na.nî
دەبرد	.de.bird
خنجیلانەی	.xin.cî.la.ney
نیشاندا	.nî.şan.da
ڕێگەی	.řê.gey
نایاسایانە	.na.ya.sa.ya.ne
ئەستێرە	.ʔes.tê.re
دادەشکێتەوە	.da.deş.kê.te.we
داتێ	.da.tê
ئازادیی	.ʔa.za.dîy
گەلێکی	.ge.lê.kî
مامەڵە	.ma.me.łe
ڕێپێدران	.řê.pê.di.ran
پێشانگایەدا	.pê.şan.ga.ye.da
داسەپانیان	.da.se.pan.yan
عاموودە	.ƹa.mû.de
قاهر	.qa.hir
بگرە	.bi.gi.re
داگرتن	.da.gir.tin
قاهیرە	.qa.hî.re
دەق	.deq
رادیۆ	.rad.yo
عادل	.ƹa.dil
ئەندام	.ʔen.dam
ئادانا	.ʔa.da.na
سایەی	.sa.yey
ساڵیادی	.sał.ya.dî
ئەمەیە	.ʔe.me.ye
زۆرتری	.zor.ti.rî
یێ	.yê
تەقسیم	.teq.sîm
ئامێرێک	.ʔa.mê.rêk
تایبەتییەکانیان	.tay.be.tî.ye.kan.yan
پاراستن	.pa.ras.tin
سەدەی	.se.dey
هەیە	.he.ye
بەرگی	.ber.gî
مانگانێک	.man.ga.nêk
چاکیشیان	.ça.kîş.yan
لاتینەوە	.la.tî.ne.we
چوارەمییەکەش	.çwa.re.mî.ye.keş
گرتەوە	.gir.te.we
هەڵپەڕکێیە	.heł.peř.kê.ye
ترسی	.tir.sî
ئەنستیتووە	.ʔe.nis.tî.tu.we
هەڵکەوێ	.heł.ke.wê
چاپخانەیانە	.çap.xa.ne.ya.ne
خۆڕایییانە	.xo.řa.yî.ya.ne
أجنَبي	.ʔec.ne.bî
سڕانەوەی	.si.řa.ne.wey
شێعر	.şê.ƹir
ئینگلیسی	.ʔîn.gi.lî.sî
نایەوێت	.na.ye.wêt
نووسەرانەوە	.nû.se.ra.ne.we
شاردان	.şar.dan
خۆشحاڵی	.xoş.ḧa.łî
کورتی	.kur.tî
گۆڤارانێک	.go.va.ra.nêk
شای	.şay
گۆڕانکارییە	.go.řan.ka.rî.ye
بخاتە	.bi.xa.te
خۆت	.xot
دووکانەکانی	.dû.ka.ne.ka.nî
بووون	.bû.win
نەوزاد	.new.zad
سەرەخۆ	.se.re.xo
رەوت	.rewt
دادئەستێن	.dad.ʔes.tên
هێمن	.hê.min
هاوڕێ	.haw.řê
دانانی	.da.na.nî
تێدایە	.tê.da.ye
دەسەڵاتدارەکانی	.de.se.łat.da.re.ka.nî
بەوەکرد	.be.we.kird
نێوەکانیان	.nê.we.kan.yan
بەجێ	.be.cê
دەزگەی	.dez.gey
ئیش	.ʔîş
لێدوان	.lê.dwan
حەیدەر	.ḧey.der
کۆچیندران	.ko.çîn.di.ran
فولکلۆر	.ful.ki.lor
ئاستێکدان	.ʔas.têk.dan
پێناسەی	.pê.na.sey
دابەزاندنی	.da.be.zan.di.nî
مەرج	.merc
کارکردن	.kar.kir.din
ناوبراو	.naw.bi.raw
کربوو	.kir.bû
سەرو	.se.ru
هەڵەیە	.he.łe.ye
گۆڕەپانی	.go.ře.pa.nî
دەکڕن	.de.ki.řin
لێدەفرۆشرێ	.lê.def.roş.rê
ستوکهۆڵم	.si.tuk.hołm
لەچاپدەدرێ	.le.çap.ded.rê
نووسینەوەی	.nû.sî.ne.wey
ماڵەکەی	.ma.łe.key
دەژیان	.dej.yan
گرووپێکن	.gi.rû.pê.kin
بڕەخسێ	.bi.řex.sê
دەنێردرێن	.de.nêr.di.rên
دیجلە	.dîc.le
نوێیە	.nwê.ye
شێوەیەک	.şê.we.yek
ژن	.jin
چاپخانەوە	.çap.xa.ne.we
بەهار	.be.har
بەشدار	.beş.dar
ناردرابان	.nar.di.ra.ban
ناخی	.na.xî
دۆسیە	.dos.ye
گرینگی	.gi.rîn.gî
قۆڵبەستیان	.qoł.best.yan
ئامریکایییەکاندان	.ʔam.rî.ka.yî.ye.kan.dan
هەرچەندە	.her.çen.de
لێپرسینەوە	.lê.pir.sî.ne.we
دەرمان	.der.man
کۆمەڵگا	.ko.meł.ga
ئێستای	.ʔês.tay
جێگیر	.cê.gîr
عەرزێ	.ƹer.zê
دیکەوە	.dî.ke.we
چەکداری	.çek.da.rî
ببنە	.bi.bi.ne,.bib.ne
دانەمەزراندنی	.da.ne.mez.ran.di.nî
نێوبراوەکان	.nêw.bi.ra.we.kan
زمانەکانی	.zi.ma.ne.ka.nî
روانینی	.rwa.nî.nî
ڕووبەڕووبوونەوەی	.řû.be.řû.bû.ne.wey
مێردەکەی	.mêr.de.key
حەلەبدا	.ḧe.leb.da
دەگاتێ	.de.ga.tê
ئاگر	.ʔa.gir
عێڕاق	.ƹê.řaq
هاوسەنگی	.haw.sen.gî
ویدا	.wî.da
کوردیزادە	.kur.dî.za.de
هەشتەم	.heş.tem
شوناسی	.şu.na.sî
تێرۆریزم	.tê.ro.rî.zim
کردووم	.kir.dûm
بڕیارنامەیەک	.biř.yar.na.me.yek
فەرهەنگییەکانن	.fer.hen.gî.ye.ka.nin
وەرگرەکانی	.wer.gi.re.ka.nî
یاریگای	.ya.rî.gay
پیادە	.pya.de
پۆلیسەوە	.po.lî.se.we
پێشبرد	.pêş.bird
گەورەیی	.gew.re.yî
وتووێژم	.wi.tu.wê.jim
رەنگی	.ren.gî
حوکمڕانی	.ḧu.kim.řa.nî
ساڵ	.sał
کوردەوە	.kur.de.we
حەمسۆرۆ	.ḧem.so.ro
ئەڵێت	.ʔe.łêt
یانەکانی	.ya.ne.ka.nî
بەفەرمی	.be.fer.mî
داهێنانی	.da.hê.na.nî
خزمەتی	.xiz.me.tî
عەلیرزا	.ƹe.lî.ri.za
مانچستەر	.man.çis.ter
بێکەس	.bê.kes
کارەساتی	.ka.re.sa.tî
هونەرمەند	.hu.ner.mend
گوتە	.gu.te
فرۆشیش	.fi.ro.şîş
سەرکردەی	.ser.kir.dey
واتە	.wa.te
هەڵمژینی	.heł.mi.jî.nî
سەرەرای	.se.re.ray
بەبڕوای	.beb.řway
ئاشوورییەوە	.ʔa.şû.rî.ye.we
دەرکەوتن	.der.kew.tin
وەرگێڕاوەن	.wer.gê.řa.wen
دۆخەکە	.do.xe.ke
عوسمانییەکان	.ƹus.ma.nî.ye.kan
وتارانە	.wi.ta.ra.ne
لەوێ	.le.wê
وەباڵی	.we.ba.łî
بەشدارەکان	.beş.da.re.kan
نهێنییەکانی	.ni.hê.nî.ye.ka.nî
ناوچەیە	.naw.çe.ye
بەرزی	.ber.zî
کەمتر	.kem.tir
ئاڵماندا	.ʔał.man.da
بەهێز	.be.hêz
مامە	.ma.me
چیدیکە	.çî.dî.ke
زەنگیەوە	.zeng.ye.we
پێشەنگی	.pê.şen.gî
شارەزایی	.şa.re.za.yî
هاوارێ	.ha.wa.rê
ئەرمەنی	.ʔer.me.nî
هزر	.hi.zir
دەزانین	.de.za.nîn
زمانی	.zi.ma.nî
بەتەنها	.be.ten.ha
وەزیرانی	.we.zî.ra.nî
هەوڵێکی	.hew.łê.kî
گرنگەکانی	.gi.rin.ge.ka.nî
کەڵەوەشکێنی	.ke.łe.weş.kê.nî
لایەنەکانی	.la.ye.ne.ka.nî
بەرشەلۆنەی	.ber.şe.lo.ney
کتێبەکەیان	.ki.tê.be.ke.yan
جارێک	.ca.rêk
سووتا	.sû.ta
برینداری	.bi.rîn.da.rî
کۆمیتەیەک	.ko.mî.te.yek
ئەوەندە	.ʔe.wen.de
رێکخراوەیەکیان	.rêk.xi.ra.we.yek.yan
سبەینێ	.si.bey.nê
میلان	.mî.lan
سەرژمێرییەکی	.ser.ji.mê.rî.ye.kî
نیشتمان	.nîş.ti.man
میکانیزمی	.mî.ka.nîz.mî
فۆلکلۆرەکان	.fol.ki.lo.re.kan
بەزۆر	.be.zor
خولقابێ	.xul.qa.bê
کەس	.kes
بیرم	.bî.rim
لەپشت	.le.pişt
ڤەستا	.ves.ta
دوژمن	.duj.min
ئەوەی	.ʔe.wey
ئانکارا	.ʔan.ka.ra
کەڵک	.kełk
لەندەن	.len.den
لیبیا	.lîb.ya
ددانانم	.di.da.na.nim
کارەکەدا	.ka.re.ke.da
چیدی	.çî.dî
کرایە	.ki.ra.ye
لەرێگای	.le.rê.gay
داگیرکرا	.da.gîr.ki.ra
نەبووە	.ne.bu.we
ئەرکێکە	.ʔer.kê.ke
پەیوەندییەدا	.pey.wen.dî.ye.da
هەشبوون	.heş.bûn
کەمترە	.kem.ti.re
پالۆ	.pa.lo
جۆرە	.co.re
ئاژانس	.ʔa.jans
گەورەترینەکەیان	.gew.re.ti.rî.ne.ke.yan
تاوانەکەت	.ta.wa.ne.ket
کردبووەوە	.kir.di.bu.we.we
شێواز	.şê.waz
ڕەوای	.ře.way
بۆتە	.bo.te
نەشیتوانیوە	.ne.şî.twa.nî.we
کاوا	.ka.wa
خوێنەر	.xwê.ner
سەرانسەری	.se.ran.se.rî
کۆپیگەلێک	.ko.pî.ge.lêk
لەچاپداوە	.le.çap.da.we
دەبرێن	.deb.rên
ڕووناکی	.řû.na.kî
سەفەر	.se.fer
چینی	.çî.nî
دەردەچێت	.der.de.çêt
مارسی	.mar.sî
تێدەکۆشان	.tê.de.ko.şan
دەبات	.de.bat
ئەوپەڕی	.ʔew.pe.řî
ژێر	.jêr
دەرکردنی	.der.kir.di.nî
ژێرزەمینێکی	.jêr.ze.mî.nê.kî
کەناری	.ke.na.rî
کوردستاندا	.kur.dis.tan.da
ناچاری	.na.ça.rî
رێکوپێکییەکی	.rê.ku.pê.kî.ye.kî
پێشەوا	.pê.şe.wa
زارۆکانن	.za.ro.ka.nin
رێدراوە	.rê.di.ra.we
گاندی	.gan.dî
قەومی	.qew.mî
تەنگدا	.ten.gi.da
هۆگر	.ho.gir
وەرگێڕان	.wer.gê.řan
دوبارە	.du.ba.re
نائاسایی	.na.ʔa.sa.yî
حکومەت	.ḧi.ku.met
ساڵانەدا	.sa.ła.ne.da
نەتوانێت	.ne.twa.nêt
دنەدەری	.di.ne.de.rî
سەرژمێرییەکەدا	.ser.ji.mê.rî.ye.ke.da
بەڕێوەبەرە	.be.řê.we.be.re
سێدارە	.sê.da.re
بازاڕدۆزینەوە	.ba.zař.do.zî.ne.we
کتێبدا	.ki.têb.da
تەکنەلۆژیا	.tek.ne.loj.ya
وایان	.wa.yan
بەناوبانگ	.be.naw.bang
شەرم	.şe.rim
نە	.ne
دیالە	.dya.le
بڵاوکراوەکان	.bi.ław.ki.ra.we.kan
دەستمان	.dest.man
تێپەڕبوونی	.tê.peř.bû.nî
چڕەکەیان	.çi.ře.ke.yan
کەمپینی	.kem.pî.nî
مەسەلە	.me.se.le
وڵامێک	.wi.ła.mêk
لەوەش	.le.weş
ڕا	.řa
ئاخر	.ʔa.xir
ڕاگرتنی	.řa.gir.ti.nî
بەهۆی	.be.hoy
چارەی	.ça.rey
پشکنین	.piş.ki.nîn
پاک	.pak
هەڵدەگەڕێنەوە	.heł.de.ge.řê.ne.we
هێمای	.hê.may
وەدەست	.we.dest
نەخێندەواری	.ne.xên.de.wa.rî
تێکڕا	.têk.řa
کاییدا	.ka.yî.da
سوریا	.sur.ya
نێوبڕێکی	.nêw.bi.řê.kî
نەمانی	.ne.ma.nî
خڕکەمەوە	.xiř.ke.me.we
ڕۆژنامەنووسانی	.řoj.na.me.nû.sa.nî
بەرگەی	.ber.gey
سیاسییەکاندا	.sya.sî.ye.kan.da
وی	.wî
ڕاگەیاندن	.řa.ge.yan.din
بوو	.bû
دەگەڵی	.de.ge.łî
تامەزرۆیییەکی	.ta.mez.ro.yî.ye.kî
بەخۆپەرمانیان	.be.xo.per.man.yan
هەڵاتم	.he.ła.tim
قسەوباس	.qi.sew.bas
ئانتەر	.ʔan.ter
ڕووداوی	.řû.da.wî
تورکەکانە	.tur.ke.ka.ne
نووسەرانیش	.nû.se.ra.nîş
مەترسییە	.me.tir.sî.ye
لەبار	.le.bar
بەدەستی	.be.des.tî
فێستیڤاڵانێکی	.fês.tî.va.ła.nê.kî
خێزانەکەی	.xê.za.ne.key
نانێردرێن	.na.nêr.di.rên
لەوبارەیەوە	.lew.ba.re.ye.we
پێدەکات	.pê.de.kat
دەکران	.de.ki.ran
داهاتوودا	.da.ha.tû.da
فڕۆکەوانی	.fi.řo.ke.wa.nî
دوور	.dûr
بەریتانی	.be.rî.ta.nî
هەرکام	.her.kam
کتێبخانەگەلێک	.ki.têb.xa.ne.ge.lêk
پێکەوە	.pê.ke.we
زۆرجاران	.zor.ca.ran
هاتنەوە	.ha.ti.ne.we
دژوارە	.dij.wa.re
چاپەمەنی	.ça.pe.me.nî
وێکڕا	.wêk.řa
دەمێنییەوە	.de.mê.nî.ye.we
گومروکەوە	.gum.ru.ke.we
بەڵکە	.beł.ke
با	.ba
پێوەندییە	.pê.wen.dî.ye
ئۆجالان	.ʔo.ca.lan
نزیکەی	.ni.zî.key
ئامانجی	.ʔa.man.cî
دامەزراوەیەکی	.da.mez.ra.we.ye.kî
شاخ	.şax
کچەکەی	.ki.çe.key
دەخا	.de.xa
ئەلکوردی	.ʔel.kur.dî
بینی	.bî.nî
بەرهەمەکان	.ber.he.me.kan
ڕەسمی	.řes.mî
وەڵامی	.we.ła.mî
یەکگرتووەکان	.yek.gir.tu.we.kan
باشوری	.ba.şu.rî
چالاکانی	.ça.la.ka.nî
ئەدەبییانەوە	.ʔe.de.bî.ya.ne.we
باشیان	.baş.yan
کەسانی	.ke.sa.nî
سیاسییەکان	.sya.sî.ye.kan
جۆربەجۆرەکانی	.cor.be.co.re.ka.nî
رامیار	.ram.yar
دایک	.dayk
بڵاودەکەنەوە	.bi.ław.de.ke.ne.we
بڕیاریان	.biř.yar.yan
بەتەواوی	.be.te.wa.wî
خوێندکاری	.xwênd.ka.rî
ئەنجامدا	.ʔen.cam.da
ڕۆژنامە	.řoj.na.me
نموونەی	.ni.mû.ney
کوردیدایە	.kur.dî.da.ye
چاپخانە	.çap.xa.ne
تێکەڵ	.tê.keł
لاپەڕە	.la.pe.ře
نامەیەک	.na.me.yek
عەقڵ	.ƹe.qił
نەناسێندراوە	.ne.na.sên.di.ra.we
نەمان	.ne.man
یاریەکە	.yar.ye.ke
هونەرمەندانی	.hu.ner.men.da.nî
نووسین	.nû.sîn
دیبوونیەوە	.dî.bûn.ye.we
قسەوباسی	.qi.sew.ba.sî
بسڕێتەوە	.bis.řê.te.we
مافەکانی	.ma.fe.ka.nî
سینەمایی	.sî.ne.ma.yî
قەڵس	.qełs
پابەند	.pa.bend
دژیان	.dij.yan
دەرچوونی	.der.çû.nî
ئەمنی	.ʔem.nî
ناسنامە	.nas.na.me
بنەڕەتەوە	.bi.ne.ře.te.we
سەرم	.se.rim
کڕینی	.ki.řî.nî
چاپخانەکەیان	.çap.xa.ne.ke.yan
ڕێبوار	.řê.bwar
پارت	.pa.rit
مۆڵەتەوە	.mo.łe.te.we
ڕاکێشانی	.řa.kê.şa.nî
ئەنستیتووەکان	.ʔe.nis.tî.tu.we.kan
تێبینیگەلی	.tê.bî.nî.ge.lî
بەکورتی	.be.kur.tî
کیلۆمیتر	.kî.lo.mî.tir
بووبوون	.bû.bûn
کردبێت	.kir.di.bêt
گاڵتە	.gał.te
جەلال	.ce.lal
داهێنران	.da.hên.ran
دۆقان	.do.qan
مانگی	.man.gî
خۆرئاوا	.xor.ʔa.wa
دەسەڵاتدارەکان	.de.se.łat.da.re.kan
تازەی	.ta.zey
ناوەڕاستی	.na.we.řas.tî
بەڕێوەبەرایەتییەکان	.be.řê.we.be.ra.ye.tî.ye.kan
هۆنراوەی	.hon.ra.wey
کۆمپانیایەک	.kom.pan.ya.yek
تاوانباریگەلەدا	.ta.wan.ba.rî.ge.le.da
ڕووبەڕوو	.řû.be.řû
کرێکارانی	.ki.rê.ka.ra.nî
ڕێکخستن	.řêk.xis.tin
جزیر	.ci.zîr
خزمەتکردنی	.xiz.met.kir.di.nî
هۆرتە	.hor.te
خێراکارەکان	.xê.ra.ka.re.kan
چەڵەمەکانیان	.çe.łe.me.kan.yan
داد	.dad
جەمال	.ce.mal
ماڵپەڕانەدا	.mał.pe.řa.ne.da
نەدەکرا	.ne.de.ki.ra
دەرەکی	.de.re.kî
نەتەوەکەمان	.ne.te.we.ke.man
جببەش	.cib.beş
خوێنەرانەش	.xwê.ne.ra.neş
وتەی	.wi.tey
بۆخۆیان	.bo.xo.yan
ئەستۆی	.ʔes.toy
دێموکراتی	.dê.muk.ra.tî
داوی	.da.wî
قورئان	.qur.ʔan
نووسەرەکاندا	.nû.se.re.kan.da
دەستنیشان	.dest.nî.şan
دیاردەیەکی	.dyar.de.ye.kî
ئەوڕۆ	.ʔew.řo
بمێننەوە	.bi.mên.ne.we
فلسێکم	.fil.sê.kim
نووسینگەکە	.nû.sîn.ge.ke
نێویان	.nêw.yan
بتواندرێ	.bit.wan.di.rê
بەدەر	.be.der
ئەمین	.ʔe.mîn
ڕەنگە	.řen.ge
مێ	.mê
بەندیخانەیە	.ben.dî.xa.ne.ye
بەکاربهێندرێ	.be.kar.bi.hên.di.rê
کرداری	.kir.da.rî
پێڕست	.pê.řist
کڕی	.ki.řî
ڕزگار	.řiz.gar
بزانێت	.bi.za.nêt
نووسەرانێکی	.nû.se.ra.nê.kî
داوایان	.da.wa.yan
ڕوونکردنەوەی	.řûn.kir.di.ne.wey
چاپەمەنیگەلە	.ça.pe.me.nî.ge.le
تۆم	.tom
لەوە	.le.we
بەشێکی	.be.şê.kî
بەرهەمەکەی	.ber.he.me.key
بەرەکانیان	.be.re.kan.yan
ڕاپۆرتی	.řa.por.tî
رەگەز	.re.gez
هۆشیار	.hoş.yar
رۆمانەکان	.ro.ma.ne.kan
خاڵە	.xa.łe
خەڵکەوە	.xeł.ke.we
دەکەوێتەوە	.de.ke.wê.te.we
کراوەتە	.ki.ra.we.te
تاوانی	.ta.wa.nî
توند	.tund
نەینەوا	.ney.ne.wa
ڕوونیکردەوە	.řû.nî.kir.de.we
بی	.bî
پۆستکراوەگەلێک	.post.ki.ra.we.ge.lêk
گل	.gil
هاتە	.ha.te
زۆرن	.zo.rin
هێزە	.hê.ze
ڕادەیەکی	.řa.de.ye.kî
کەوتۆتە	.kew.to.te
پشکنیمی	.piş.ki.nî.mî
خاسی	.xa.sî
ئۆدەی	.ʔo.dey
دەکەنەوە	.de.ke.ne.we
بەناوبانگەکان	.be.naw.ban.ge.kan
پاکستان	.pa.kis.tan
دەسەڵاتدا	.de.se.łat.da
دەستنووسەکانیان	.dest.nû.se.kan.yan
بەهێزتر	.be.hêz.tir
ڕایدەگەیەنێت	.řay.de.ge.ye.nêt
باوەڕی	.ba.we.řî
دادەنرێن	.da.de.ni.rên
ئاشکرا	.ʔaş.ki.ra
یەکەمی	.ye.ke.mî
بدەن	.bi.den
ئەوانەی	.ʔe.wa.ney
شارەدارییەکان	.şa.re.da.rî.ye.kan
ئەیلوولی	.ʔey.lû.lî
دانیشتوون	.da.nîş.tûn
کەم‌کراو	.kem.ki.raw
پیاوانی	.pya.wa.nî
نووسراوی	.nûs.ra.wî
ئامانجەکانی	.ʔa.man.ce.ka.nî
بڕیارنامەی	.biř.yar.na.mey
نەوەکانی	.ne.we.ka.nî
گوندانە	.gun.da.ne
نووسرابوو	.nûs.ra.bû
جۆرێکی	.co.rê.kî
ژێرچاپەکانیان	.jêr.ça.pe.kan.yan
هاوڕێژەیە	.haw.řê.je.ye
تێک	.têk
لەگەڵیان	.le.geł.yan
پارێزراو	.pa.rêz.raw
تایبەتدا	.tay.bet.da
لەسێدارەدانی	.le.sê.da.re.da.nî
رایبگەیەنن	.ray.bi.ge.ye.nin
بزاڤە	.bi.za.ve
بوونی	.bû.nî
دامەزرێندرێ	.da.mez.rên.di.rê
ئاوایی	.ʔa.wa.yî
ببیندرێ	.bi.bîn.di.rê
ماڵپەڕانەم	.mał.pe.řa.nem
نێن	.nên
ناشرین	.na.şi.rîn
دەکڕێ	.de.ki.řê
دامەزراند	.da.mez.rand
هەڵبژاردنەکان	.heł.bi.jar.di.ne.kan
براهیم	.bi.ra.hîm
چڕ	.çiř
تووڕە	.tû.ře
وڵاتەکەی	.wi.ła.te.key
هەڵوێستی	.heł.wês.tî
دەردەکەون	.der.de.ke.win
سێیەمی	.sê.ye.mî
پەروەردەی	.per.wer.dey
جم	.cim
پێشکەوتوو	.pêş.kew.tû
ڕێوڕەسمی	.řêw.řes.mî
هاریدەدەریان	.ha.rî.de.der.yan
پیرۆز	.pî.roz
بڕێکی	.bi.řê.kî
خوێندنگەکاندا	.xwên.din.ge.kan.da
پێناسە	.pê.na.se
دەستپێکی	.dest.pê.kî
هەردەم	.her.dem
هاوچەرخ	.haw.çerx
مووسیقاییی	.mû.sî.qa.yîy
کتێبیش	.ki.tê.bîş
ئامانجە	.ʔa.man.ce
لایەکەوە	.la.ye.ke.we
بەلام	.be.lam
لەوانەن	.le.wa.nen
فەڕانسە	.fe.řan.se
پەیمانگای	.pey.man.gay
ناکەوێ	.na.ke.wê
گەڕانەوەی	.ge.řa.ne.wey
ئەکەم	.ʔe.kem
زیانی	.zya.nî
پێداویستییەکانی	.pê.da.wîs.tî.ye.ka.nî
نەگونجراو	.ne.gunc.raw
بکرێتەوە	.bi.ki.rê.te.we
مەحاڵە	.me.ḧa.łe
ئاقارێکدا	.ʔa.qa.rêk.da
مەبەستم	.me.bes.tim
فرۆشتنەوە	.fi.roş.ti.ne.we
رۆڵی	.ro.łî
دەیانتوانی	.de.yan.twa.nî
نیوەڕۆ	.nî.we.řo
دەگرێ	.de.gi.rê
پێشانگا	.pê.şan.ga
پێنج	.pênc
هیند	.hînd
کوردێک	.kur.dêk
نەوتی	.new.tî
ڕۆڵ	.řoł
مێژووی	.mê.jûy
جیاوازەکان	.cya.wa.ze.kan
هەڵەبجە	.he.łeb.ce
ژیاننامە	.jyan.na.me
دواون	.dwa.win
کەنەوە	.ke.ne.we
ئاڵبانییەکان	.ʔał.ba.nî.ye.kan
کاریگەری	.ka.rî.ge.rî
بندەستی	.bin.des.tî
زووتر	.zû.tir
یەکەمەکەیاندا	.ye.ke.me.ke.yan.da
کورمانجیش	.kur.man.cîş
لاساری	.la.sa.rî
درنگی	.di.rin.gî
ئامانجم	.ʔa.man.cim
دەنان	.de.nan
داواکارییەکانی	.da.wa.ka.rî.ye.ka.nî
سەرەکییەتی	.se.re.kî.ye.tî
خولەکی	.xu.le.kî
ببووەوە	.bi.bu.we.we
پێشانگاکەدا	.pê.şan.ga.ke.da
گواستنەوە	.gwas.ti.ne.we
ناوچەکە	.naw.çe.ke
لەتیف	.le.tîf
رێزیان	.rêz.yan
پرسە	.pir.se
ئەمنییەکانەوە	.ʔem.nî.ye.ka.ne.we
بپارێزن	.bi.pa.rê.zin
دانیەل	.dan.yel
خۆڕاگری	.xo.řa.gi.rî
هەڤیازییەکیان	.hev.ya.zî.yek.yan
بم	.bim
زیرەک	.zî.rek
نابوو	.na.bû
دەچنە	.de.çi.ne
پرۆتۆکۆل	.pi.ro.to.kol
دنیای	.din.yay
زیاتری	.zya.ti.rî
خراپە	.xi.ra.pe
رێپێدراو	.rê.pê.di.raw
داسەپێندراوە	.da.se.pên.di.ra.we
سلێمان	.si.lê.man
بەڵگەی	.beł.gey
خەڵاتەکانی	.xe.ła.te.ka.nî
دەبا	.de.ba
ناوەکی	.na.we.kî
فەلسەفە	.fel.se.fe
دەڵێین	.de.łêyn
هۆگریانن	.ho.gir.ya.nin
هەواڵێکی	.he.wa.łê.kî
کوروسە	.ku.ru.se
مانەوەی	.ma.ne.wey
دۆسیەیەکی	.dos.ye.ye.kî
چەڵەمەگەلە	.çe.łe.me.ge.le
پەخش	.pe.xiş
نالەبارانەدا	.na.le.ba.ra.ne.da
ئینگلیزی	.ʔîn.gi.lî.zî
وەرگیراوە	.wer.gî.ra.we
پەردە	.per.de
دەکەوێتە	.de.ke.wê.te
ئاڵمان	.ʔał.man
پەڕتووکە	.peř.tû.ke
ناکۆکی	.na.ko.kî
بمێنێتەوە	.bi.mê.nê.te.we
ها	.ha
دەهێنن	.de.hê.nin
وەلی	.we.lî
مۆڵەت	.mo.łet
کەسایەتییەکی	.ke.sa.ye.tî.ye.kî
دەسەڵات	.de.se.łat
بیەوێ	.bye.wê
بەرێوەچوو	.be.rê.we.çû
پەرلەمانتار	.per.le.man.tar
بۆیەش	.bo.yeş
دیوە	.dî.we
خایاند	.xa.yand
مامەڵەی	.ma.me.łey
هێزێک	.hê.zêk
کورددا	.kurd.da
ئیشکەکان	.ʔîş.ke.kan
لەمە	.le.me
دووهەمەکەشیان	.dû.he.me.keş.yan
تێدا	.tê.da
چیرۆکان	.çî.ro.kan
مرۆڤ	.mi.rov
بردن	.bir.din
نەتەوەیییەکانی	.ne.te.we.yî.ye.ka.nî
تاران	.ta.ran
هەرچی	.her.çî
نرخەکە	.nir.xe.ke
ڕاستییە	.řas.tî.ye
موکریانییە	.mu.ki.rya.nî.ye
مێشک	.mêşk
بریندار	.bi.rîn.dar
عێراقیش	.ƹê.ra.qîş
دانان	.da.nan
شانازی	.şa.na.zî
شێرزاد	.şêr.zad
دەپارێزرێ	.de.pa.rêz.rê
بەرمیل	.ber.mîl
ڕابردووی	.řa.bir.dûy
راسپاردەکان	.ra.si.par.de.kan
ئەوەکی	.ʔe.we.kî
ڕۆڵی	.řo.łî
هەلومەرجێکی	.he.lu.mer.cê.kî
هاوڕێیە	.haw.řê.ye
تایمز	.taymz
نەکردنی	.ne.kir.di.nî
نەڕۆمەوە	.ne.řo.me.we
پڕبکەنەوە	.piř.bi.ke.ne.we
ناحەزتر	.na.ḧez.tir
مەرال	.me.ral
پشتیوانییان	.piş.tî.wa.nî.yan
هێزی	.hê.zî
زمانەکەیان	.zi.ma.ne.ke.yan
سیستەمی	.sîs.te.mî
کاندید	.kan.dîd
دیمەشق	.dî.meşq
ساڵی	.sa.łî
بیانووی	.bya.nûy
هەتاکوو	.he.ta.kû
هاتوچۆ	.ha.tu.ço
ڕێز	.řêz
وەرگێڕاونەتەوە	.wer.gê.řaw.ne.te.we
شایانی	.şa.ya.nî
فەرانسە	.fe.ran.se
ئاقاری	.ʔa.qa.rî
هەبوون	.he.bûn
لەهەمانکاتدا	.le.he.man.kat.da
ماددی	.mad.dî
کەسیش	.ke.sîş
دەدرێت	.de.di.rêt
ویستت	.wîs.tit
رۆژنامەوانانە	.roj.na.me.wa.na.ne
رۆژیدا	.ro.jî.da
حورییەت	.ḧu.rî.yet
گۆڕانی	.go.řa.nî
ئەدەبیی	.ʔe.de.bîy
چواری	.çwa.rî
بینین	.bî.nîn
رەخساند	.rex.sand
سیاسییەکانیان	.sya.sî.ye.kan.yan
جل	.cil
کەسایەتیگەلی	.ke.sa.ye.tî.ge.lî
ڕانەگەیەندراوی	.řa.ne.ge.yen.di.ra.wî
کردەوە	.kir.de.we
هاوچەرخدا	.haw.çerx.da
کاتێ	.ka.tê
کوردەواری	.kur.de.wa.rî
شاری	.şa.rî
دادەنێردرێن	.da.de.nêr.di.rên
ئەوە	.ʔe.we
بانگهێشتی	.bang.hêş.tî
شەڵاڵی	.şe.ła.łî
ئۆدە	.ʔo.de
مارکەکانی	.mar.ke.ka.nî
هیوادارم	.hî.wa.da.rim
رێپێنەدانی	.rê.pê.ne.da.nî
خاڵەکانی	.xa.łe.ka.nî
حەلەبێ	.ḧe.le.bê
هەڵبەستەوە	.heł.bes.te.we
بەڕێوەدەچێت	.be.řê.we.de.çêt
زۆرم	.zo.rim
ئاساییترین	.ʔa.sa.yît.rîn
ئەرنێست	.ʔer.nêst
باکوری	.ba.ku.rî
کارا	.ka.ra
بینیوە	.bî.nî.we
کوردستانن	.kur.dis.ta.nin
ئەنقەرە	.ʔen.qe.re
تیرۆژ	.tî.roj
گۆڤاری	.go.va.rî
ناگرێت	.na.gi.rêt
دوام	.dwam
شیعە	.şî.ƹe
ناوەندی	.na.wen.dî
پۆستەکەدا	.pos.te.ke.da
کاتەوە	.ka.te.we
رواڵەت	.rwa.łet
خوارد	.xward
ئیمپەراتۆریی	.ʔîm.pe.ra.to.rîy
سەندیکای	.sen.dî.kay
جیاواز	.cya.waz
ڕەفتار	.řef.tar
پێهات	.pê.hat
بڕیاردان	.biř.yar.dan
بەرهەڵستی	.ber.he.łis.tî
جۆرەی	.co.rey
بگونجێ	.bi.gun.cê
هێناوە	.hê.na.we
بڕیارنامە	.biř.yar.na.me
وەرگێڕەکەی	.wer.gê.ře.key
هێنراون	.hên.ra.win
دەستوورەوە	.des.tû.re.we
سوودیی	.sû.dîy
ئەرتەشی	.ʔer.te.şî
لەڕووی	.le.řûy
ئەوەمان	.ʔe.we.man
دەسەلات	.de.se.lat
سابیر	.sa.bîr
ساتێک	.sa.têk
خوێندبوویان	.xwên.di.bû.yan
دووردەست	.dûr.dest
بەردرام	.ber.di.ram
کەڕەتێک	.ke.ře.têk
بزووتنەوەیەکی	.bi.zût.ne.we.ye.kî
بوونەوەی	.bû.ne.wey
چاپخانەکەی	.çap.xa.ne.key
گەلان	.ge.lan
تورکمەن	.turk.men
قۆناغی	.qo.na.ẍî
درامای	.di.ra.may
زۆرتریان	.zor.tir.yan
کوردەکانیش	.kur.de.ka.nîş
سەردەمە	.ser.de.me
رێپێنەدراوییی	.rê.pê.ne.di.ra.wî.yî
سوری	.su.rî
مەترسییەوە	.me.tir.sî.ye.we
رێبوارەکان	.rêb.wa.re.kan
خزمەتگۆزاریی	.xiz.met.go.za.rîy
خاوەنەکانی	.xa.we.ne.ka.nî
ئەفریقا	.ʔef.rî.qa
کەسانێک	.ke.sa.nêk
هەڵاواردن	.he.ła.war.din
پێکدادانی	.pêk.da.da.nî
دووهەمیان	.dû.hem.yan
پێناس	.pê.nas
چەکدارەکان	.çek.da.re.kan
دینار	.dî.nar
رەوانی	.re.wa.nî
دیسان	.dî.san
نابوون	.na.bûn
سەرچاوەیەکی	.ser.ça.we.ye.kî
کۆمپانیاگەلە	.kom.pan.ya.ge.le
نی	.nî
داگیریان	.da.gîr.yan
دەبینێتەوە	.de.bî.nê.te.we
لوبنانەوە	.lub.na.ne.we
بەڕێوەبەرەکانی	.be.řê.we.be.re.ka.nî
لەچاپ	.le.çap
هێندەی	.hên.dey
کارەکە	.ka.re.ke
نهێنییانەی	.ni.hê.nî.ya.ney
سنوورانە	.si.nû.ra.ne
تریشەوە	.ti.rî.şe.we
هەردووکشیان	.her.dû.kiş.yan
گیروداوە	.gî.ru.da.we
وەرگێڕاوەکانیش	.wer.gê.řa.we.ka.nîş
بیچمی	.bîç.mî
جەڤدەت	.cev.det
سواری	.swa.rî
درێژیی	.di.rê.jîy
میوان	.mî.wan
خەڵاتێکی	.xe.ła.tê.kî
ئەمریکییەکان	.ʔem.rî.kî.ye.kan
هەڵگواستوونەتەوە	.heł.gwas.tû.ne.te.we
هۆگریان	.ho.gir.yan
وەردەگێڕدرێنەوە	.wer.de.gêř.di.rê.ne.we
بەرهەڵست	.ber.he.łist
نەکرا	.ne.ki.ra
رێکخەری	.rêk.xe.rî
ئاگادار	.ʔa.ga.dar
هەڵسەنگێنین	.heł.sen.gê.nîn
دەنگدان	.deng.dan
هێنراوەتە	.hên.ra.we.te
ساڵانێکی	.sa.ła.nê.kî
وەرگرتووە	.wer.gir.tu.we
قامشلۆڕا	.qa.miş.lo.řa
توورەج	.tû.rec
رێپێنەدان	.rê.pê.ne.dan
خارپێت	.xar.pêt
گیراوە	.gî.ra.we
مەڵبەند	.meł.bend
بژیوی	.bi.jî.wî
نەتەوەییی	.ne.te.we.yîy
زمانانە	.zi.ma.na.ne
کتێبە	.ki.tê.be
توێژەرێکی	.twê.je.rê.kî
چێڵسی	.çêł.sî
کتێبفرۆشیی	.ki.têb.fi.ro.şîy
دەرببڕیبا	.der.bib.řî.ba
پێکهاتە	.pêk.ha.te
دواتریش	.dwa.ti.rîş
لێدانی	.lê.da.nî
زینە	.zî.ne
لێژنەی	.lêj.ney
لەمەو	.le.mew
بەردەوامی	.ber.de.wa.mî
تەندروست	.ten.di.rust
ژان	.jan
نەکەین	.ne.keyn
نەخێر	.ne.xêr
کەن	.ken
ئینتەرنەت	.ʔîn.ter.net
ئابوورییەوە	.ʔa.bû.rî.ye.we
بنواڕنە	.bi.nwa.ři.ne
گەڵاڵەیەی	.ge.ła.łe.yey
بنەڕەتییەکان	.bi.ne.ře.tî.ye.kan
ئەورووپا	.ʔew.rû.pa
لایەنێکی	.la.ye.nê.kî
کوردە	.kur.de
ئامەدی	.ʔa.me.dî
فێر	.fêr
ئۆسکاری	.ʔos.ka.rî
هەلومەرجە	.he.lu.mer.ce
رخنەگیریی	.rix.ne.gî.rîy
دیاربەکردایە	.dyar.be.kir.da.ye
نڤیسیاریی	.ni.vîs.ya.rîy
کێشەگەلی	.kê.şe.ge.lî
نوێنەرەکانی	.nwê.ne.re.ka.nî
گۆڤارێکی	.go.va.rê.kî
دەدەم	.de.dem
زەرد	.zerd
لیستانەش	.lîs.ta.neş
ئەوەدا	.ʔe.we.da
مافخوازی	.maf.xwa.zî
نەدان	.ne.dan
بارودۆخی	.ba.ru.do.xî
چاپەمەنییەکاندا	.ça.pe.me.nî.ye.kan.da
هەن	.hen
باجەکە	.ba.ce.ke
هەڵگوێسرابوونەوە	.heł.gwês.ra.bû.ne.we
تۆمارکردن	.to.mar.kir.din
خوێندنەوە	.xwên.di.ne.we
پێشوازیی	.pêş.wa.zîy
داخوازی	.da.xwa.zî
یاریزانێکی	.ya.rî.za.nê.kî
ژمارێکیان	.ji.ma.rêk.yan
وڵایەتە	.wi.ła.ye.te
تێرمینۆلۆژیی	.têr.mî.no.lo.jîy
ببینین	.bi.bî.nîn
گواسرایەوە	.gwas.ra.ye.we
خەو	.xew
دەکردن	.de.kir.din
نموونەیە	.ni.mû.ne.ye
تازەنووسەر	.ta.ze.nû.ser
بێوار	.bê.war
رخنەگیر	.rix.ne.gîr
بەلجیکا	.bel.cî.ka
ڕۆمانی	.řo.ma.nî
بەشداریکردنی	.beş.da.rî.kir.di.nî
بنووسە	.bi.nû.se
شارەوانی	.şa.re.wa.nî
بەڵێ	.be.łê
چاپ	.çap
وتووێژی	.wi.tu.wê.jî
ڕۆڵەی	.řo.łey
پرسی	.pir.sî
بەعسەکان	.beƹ.se.kan
ئەزموونە	.ʔez.mû.ne
بیانفرۆشن	.byan.fi.ro.şin
نەدەگرتن	.ne.de.gir.tin
سەرەکییەکەشی	.se.re.kî.ye.ke.şî
هاتبوو	.ha.ti.bû
ئیمەیلەوە	.ʔî.mey.le.we
مەجید	.me.cîd
شتەکان	.şi.te.kan
نووسەرانەی	.nû.se.ra.ney
دیارە	.dya.re
مانگەدا	.man.ge.da
بەرزنجی	.ber.zin.cî
نەقشبەندی	.neqş.ben.dî
ناویان	.naw.yan
هاویاریی	.haw.ya.rîy
خستە	.xis.te
بڕوانە	.biř.wa.ne
کەتەلۆگ	.ke.te.log
زانستی	.za.nis.tî
ئەڤ	.ʔev
زەحمەتکێشانی	.zeḧ.met.kê.şa.nî
نەنووسرابوو	.ne.nûs.ra.bû
ئەرمەنستانیش	.ʔer.me.nis.ta.nîş
گەڵ	.geł
ئەڵماندایە	.ʔeł.man.da.ye
شتێکی	.şi.tê.kî
گەورەکان	.gew.re.kan
ئاسایییە	.ʔa.sa.yî.ye
باسم	.ba.sim
بیستەم	.bîs.tem
ژنێک	.ji.nêk
فیلم	.fîlm
لەپاش	.le.paş
چەڵەمەیەوە	.çe.łe.me.ye.we
نەکەن	.ne.ken
لێکبوونەوەی	.lêk.bû.ne.wey
ترووسکاییی	.ti.rûs.ka.yîy
ڕژێمی	.ři.jê.mî
خستنە	.xis.ti.ne
دەدان	.de.dan
هۆکی	.ho.kî
خوێندنگەیەک	.xwên.din.ge.yek
تۆمارکرا	.to.mar.ki.ra
دەفرۆشرێ	.def.roş.rê
بدۆزمەوە	.bi.doz.me.we
زمانکوژییەک	.zi.man.ku.jî.yek
گەڵاڵەی	.ge.ła.łey
مالکی	.ma.li.kî
ئێستاکانێش	.ʔês.ta.ka.nêş
لایەک	.la.yek
دارا	.da.ra
نەکراونەتەوە	.ne.ki.raw.ne.te.we
رابردوویەکی	.ra.bir.dû.ye.kî
هاتنی	.ha.ti.nî
توێژینەوەیەکم	.twê.jî.ne.we.ye.kim
دەستی	.des.tî
هەڕەشەوگوڕەشەیە	.he.ře.şew.gu.ře.şe.ye
ئاوا	.ʔa.wa
ئەواندا	.ʔe.wan.da
خەریک	.xe.rîk
قوربانی	.qur.ba.nî
ترسناک	.tirs.nak
هەڵبەستی	.heł.bes.tî
لەچاپدراوی	.le.çap.di.ra.wî
چێچێنەکان	.çê.çê.ne.kan
دانیشتووایەتیدا	.da.nîş.tu.wa.ye.tî.da
ڕێگەیان	.řê.ge.yan
نیشانەی	.nî.şa.ney
زانیارییان	.zan.ya.rî.yan
یەکجاری	.yek.ca.rî
ئیتالی	.ʔî.ta.lî
هاوڕێیەکانیان	.haw.řê.ye.kan.yan
لایان	.la.yan
درۆ	.di.ro
سروودی	.si.rû.dî
سیاسی	.sya.sî
دواییی	.dwa.yîy
لێکۆڵینەوەیەکی	.lê.ko.łî.ne.we.ye.kî
دەسحەقێک	.des.ḧe.qêk
سیستمی	.sîs.ti.mî
نەوەک	.ne.wek
سەتان	.se.tan
سکاڵای	.si.ka.łay
ئەنجوومەنی	.ʔen.cû.me.nî
دەستگیرکراوەکانیش	.dest.gîr.ki.ra.we.ka.nîş
قۆناغەدا	.qo.na.ẍe.da
نەما	.ne.ma
بەئاسانی	.be.ʔa.sa.nî
نووسینگەکەیانەوە	.nû.sîn.ge.ke.ya.ne.we
وازی	.wa.zî
شۆڕش	.şo.řiş
گونجاو	.gun.caw
چاپخانەگەلی	.çap.xa.ne.ge.lî
رێپێنەدراو	.rê.pê.ne.di.raw
سرۆشتییەکان	.si.roş.tî.ye.kan
کەنداوی	.ken.da.wî
مارس	.mars
شارەداری	.şa.re.da.rî
ئاشنا	.ʔaş.na
کۆمەڵگای	.ko.meł.gay
سازدانی	.saz.da.nî
یاریی	.ya.rîy
بەختیار	.bext.yar
لەچاپدراوە	.le.çap.di.ra.we
ئەی	.ʔey
نهێنیانە	.ni.hên.ya.ne
ماڵئاوایی	.mał.ʔa.wa.yî
داکۆکی	.da.ko.kî
کێش	.kêş
بستێنن	.bis.tê.nin
بادینان	.ba.dî.nan
جەلادەت	.ce.la.det
شارەزایییەکی	.şa.re.za.yî.ye.kî
دەگات	.de.gat
ستەمبۆڵدایە	.si.tem.boł.da.ye
جۆر	.cor
تەلەفیزیۆنی	.te.le.fîz.yo.nî
نوێیەکان	.nwê.ye.kan
هەزاران	.he.za.ran
نەخایاند	.ne.xa.yand
ئینتێرنێتەوە	.ʔîn.têr.nê.te.we
گوڵان	.gu.łan
ڕاپۆرتێکی	.řa.por.tê.kî
دەزگە	.dez.ge
سیستمێکی	.sîs.ti.mê.kî
خوێندن	.xwên.din
دنیا	.din.ya
تورکمان	.tur.ki.man
کاربەدەستەکانیش	.kar.be.des.te.ka.nîş
جیایی	.cya.yî
خەیاڵی	.xe.ya.łî
ماڵپەڕی	.mał.pe.řî
دەردەکەوت	.der.de.kewt
عەبدوڵڵا	.ƹeb.duł.ła
زانکۆ	.zan.ko
خۆڵیان	.xoł.yan
ڕووخانی	.řû.xa.nî
بازاڕ	.ba.zař
زایینی	.za.yî.nî
تورکیای	.turk.yay
چێ	.çê
شێوازی	.şê.wa.zî
خوێندنەوەیان	.xwên.di.ne.we.yan
ت	.ti
ژمارەی	.ji.ma.rey
لێکۆڵینەوەکان	.lê.ko.łî.ne.we.kan
خوێندنگەیەکی	.xwên.din.ge.ye.kî
بڵاوکەرەوەی	.bi.ław.ke.re.wey
ئاوارە	.ʔa.wa.re
بەنێوی	.be.nê.wî
فۆرمی	.for.mî
هاو	.haw
گێڕامەوە	.gê.řa.me.we
وەردیانەکانی	.werd.ya.ne.ka.nî
هی	.hî
گوتبوویان	.gu.ti.bû.yan
سەرەکییەکانی	.se.re.kî.ye.ka.nî
لێکدانەوەکانی	.lêk.da.ne.we.ka.nî
دەیتوانی	.dey.twa.nî
پێشەکی	.pê.şe.kî
بەسەرۆکایەتی	.be.se.ro.ka.ye.tî
سەرینی	.se.rî.nî
زێڕینی	.zê.řî.nî
خەباتگێرەکانی	.xe.bat.gê.re.ka.nî
ئەسەد	.ʔe.sed
یاسایییەوە	.ya.sa.yî.ye.we
هوگۆ	.hu.go
پەیوەست	.pey.west
نووسەریش	.nû.se.rîş
سینەما	.sî.ne.ma
کتێبفرۆشییەکەم	.ki.têb.fi.ro.şî.ye.kem
گەرمەی	.ger.mey
ڕۆناڵدۆ	.řo.nał.do
بەمانەش	.be.ma.neş
بڕیاریدا	.biř.ya.rî.da
لێکۆڵینەوەیەک	.lê.ko.łî.ne.we.yek
ئوزچەلک	.ʔuz.çelk
خوەندەڤان	.xwen.de.van
بیرەوەری	.bî.re.we.rî
زاڵ	.zał
خوویان	.xû.yan
یەکسانی	.yek.sa.nî
ڕێکخستنی	.řêk.xis.ti.nî
دنیادا	.din.ya.da
تائێستاش	.ta.ʔês.taş
بەستنی	.bes.ti.nî
کارێک	.ka.rêk
واژۆ	.wa.jo
ئێلیۆت	.ʔêl.yot
دەمیشقیش	.de.mîş.qîş
دەبیست	.de.bîst
هەڵوێستە	.heł.wês.te
سوودی	.sû.dî
رادەگوێزن	.ra.de.gwê.zin
چالاکوانی	.ça.lak.wa.nî
بۆچوونەوە	.bo.çû.ne.we
لێدوانەکەیدا	.lêd.wa.ne.key.da
کارمەندانی	.kar.men.da.nî
جارە	.ca.re
سەرەوە	.se.re.we
پەشیمان	.pe.şî.man
زۆربوونەوەیە	.zor.bû.ne.we.ye
گەلە	.ge.le
فەرهەنگێکی	.fer.hen.gê.kî
جاروبار	.ca.ru.bar
بۆچوونەکانی	.bo.çû.ne.ka.nî
دەفرۆشن	.def.ro.şin
بیگاتێ	.bî.ga.tê
هۆرتەوبەرە	.hor.tew.be.re
سەربازیی	.ser.ba.zîy
دەشاردنەوە	.de.şar.di.ne.we
ناسر	.na.sir
خوێندنەوەی	.xwên.di.ne.wey
کوردستانەوە	.kur.dis.ta.ne.we
دەسەڵاتی	.de.se.ła.tî
ئەوتۆی	.ʔew.toy
ناکرێت	.na.ki.rêt
عەرز	.ƹerz
مرۆڤدا	.mi.rov.da
درابوویێ	.di.ra.bû.yê
نێودەوڵەتی	.nêw.dew.łe.tî
سێیەم	.sê.yem
بەڕێوەبەرانی	.be.řê.we.be.ra.nî
چالاکیی	.ça.la.kîy
موو	.mû
سووکایەتیی	.sû.ka.ye.tîy
بەندیخانەی	.ben.dî.xa.ney
دووەمیان	.du.wem.yan
بگرێتەوە	.bi.gi.rê.te.we
سەرژمێرییە	.ser.ji.mê.rî.ye
هەواڵ	.he.wał
وەرگێڕاوم	.wer.gê.řa.wim
پێستی	.pês.tî
فەرمانبەران	.fer.man.be.ran
روانگەی	.rwan.gey
رۆمان	.ro.man
تۆپی	.to.pî
نووسینی	.nû.sî.nî
سۆلژەنیتسین	.sol.je.nît.sîn
کارگێڕیی	.kar.gê.řîy
گەنج	.genc
دامەزرێنێ	.da.mez.rê.nê
ڕەفتاری	.řef.ta.rî
دۆلاری	.do.la.rî
چۆن	.çon
بێگانە	.bê.ga.ne
کوڕ	.kuř
رەچەڵاکەکانی	.re.çe.ła.ke.ka.nî
کاندیدی	.kan.dî.dî
حەقیقەت	.ḧe.qî.qet
دەگەڕێتەوە	.de.ge.řê.te.we
بچنە	.bi.çi.ne
بەکارکرد	.be.kar.kird
رستانە	.ris.ta.ne
خۆراکی	.xo.ra.kî
نایاسایییەکان	.na.ya.sa.yî.ye.kan
ئەودا	.ʔew.da
راستمان	.rast.man
تریش	.ti.rîş
هێناوەتە	.hê.na.we.te
سۆنگەی	.son.gey
وایە	.wa.ye
واتایەکی	.wa.ta.ye.kî
تازەلەچاپدراو	.ta.ze.le.çap.di.raw
ڕەئوف	.ře.ʔuf
شارانە	.şa.ra.ne
کوژراون	.kuj.ra.win
کارگێڕییەکی	.kar.gê.řî.ye.kî
ئیسلامیی	.ʔîs.la.mîy
تیرۆرکردنی	.tî.ror.kir.di.nî
نەناسراو	.ne.nas.raw
ئەمجارەیان	.ʔem.ca.re.yan
کردبا	.kir.di.ba
پێری	.pê.rî
هەواڵەکانی	.he.wa.łe.ka.nî
هەرزانترن	.her.zan.ti.rin
وێژە	.wê.je
نهێنی	.ni.hê.nî
مڕداین	.miř.dayn
گەڵاڵەیە	.ge.ła.łe.ye
کۆپییە	.ko.pî.ye
نایانگەنێ	.na.yan.ge.nê
وتووێژ	.wi.tu.wêj
ئەنیستیتووە	.ʔe.nîs.tî.tu.we
تائێستا	.ta.ʔês.ta
بەلای	.be.lay
سیاسەتەکانی	.sya.se.te.ka.nî
شەڕەکەدا	.şe.ře.ke.da
لەسەرتاسەری	.le.ser.ta.se.rî
گوتیشی	.gu.tî.şî
بێژم	.bê.jim
مەزهەبی	.mez.he.bî
لەکاتێکدایە	.le.ka.têk.da.ye
ئەستۆیە	.ʔes.to.ye
دەسەڵاتە	.de.se.ła.te
لەوانەیە	.le.wa.ne.ye
رۆڵێکی	.ro.łê.kî
لانی	.la.nî
هەڵاتن	.he.ła.tin
گشتییەکاندا	.giş.tî.ye.kan.da
هەفتەیەک	.hef.te.yek
پەروەردەیی	.per.wer.de.yî
گێڕانەوەی	.gê.řa.ne.wey
ئاواز	.ʔa.waz
سەرژمێرییەکاندا	.ser.ji.mê.rî.ye.kan.da
کەم‌کراوەکان	.kem.ki.ra.we.kan
ئەکرێت	.ʔe.ki.rêt
ئیسپانی	.ʔîs.pa.nî
قیژەی	.qî.jey
ئاستی	.ʔas.tî
خوێندکارەکان	.xwênd.ka.re.kan
تۆسقاڵێکیش	.tos.qa.łê.kîş
بکەوێتە	.bi.ke.wê.te
داڕووخانە	.da.řû.xa.ne
بڕوا	.biř.wa
بانگهێشتکراو	.bang.hêşt.ki.raw
واتا	.wa.ta
ن	.ni
پێدەکرێت	.pê.de.ki.rêt
بەخۆوە	.be.xo.we
کوڕان	.ku.řan
ئەبوبەکر	.ʔe.bu.be.kir
ڕۆیشتن	.řoyş.tin
فێرکردنی	.fêr.kir.di.nî
ڕاهێنەر	.řa.hê.ner
کەشتی	.keş.tî
مەراسیمی	.me.ra.sî.mî
جۆربەجۆریان	.cor.be.cor.yan
بەرەوڕووی	.be.rew.řûy
خەڵکدا	.xełk.da
بەداخەوە	.be.da.xe.we
کارن	.ka.rin
پارچەکانی	.par.çe.ka.nî
زۆرتربوونەوەشی	.zor.tir.bû.ne.we.şî
برای	.bi.ray
شانی	.şa.nî
دەرهێنەری	.der.hê.ne.rî
مەدەنی	.me.de.nî
یەمەن	.ye.men
بیسەلمێنن	.bî.sel.mê.nin
پە	.pe
نەدەهات	.ne.de.hat
هاتبوونە	.ha.ti.bû.ne
ڕۆژئاواش	.řoj.ʔa.waş
پەرلەمان	.per.le.man
پەیوەندیی	.pey.wen.dîy
نیشانی	.nî.şa.nî
پارچە	.par.çe
بەگوێرەی	.be.gwê.rey
خوێندەوارە	.xwên.de.wa.re
مەبەستێک	.me.bes.têk
کۆمپانیای	.kom.pan.yay
ئیسلامییەکان	.ʔîs.la.mî.ye.kan
ئاراوە	.ʔa.ra.we
وابوو	.wa.bû
ڕۆژنامەوانیدا	.řoj.na.me.wa.nî.da
ڕۆشنبیران	.řo.şin.bî.ran
تیرۆریستانی	.tî.ro.rîs.ta.nî
دووەمی	.du.we.mî
فۆتۆ	.fo.to
خۆشبەختانە	.xoş.bex.ta.ne
بەهای	.be.hay
دەنووسنەوە	.de.nû.si.ne.we
پرۆسەیە	.pi.ro.se.ye
لیستێکی	.lîs.tê.kî
گەلەکانی	.ge.le.ka.nî
لەلایەکی	.le.la.ye.kî
بەتایبەتیش	.be.tay.be.tîş
دار	.dar
قوتابخانەکان	.qu.tab.xa.ne.kan
بەندیخانەدا	.ben.dî.xa.ne.da
هەڵمەتی	.heł.me.tî
مۆسیقای	.mo.sî.qay
کۆمپانیاگەلی	.kom.pan.ya.ge.lî
یەکەمدا	.ye.kem.da
خێزانەکانیان	.xê.za.ne.kan.yan
رایەڵە	.ra.ye.łe
یەکەکانی	.ye.ke.ka.nî
لەچاپدەدا	.le.çap.de.da
ئۆگرەتیش	.ʔog.re.tîş
نووسراوەکانیان	.nûs.ra.we.kan.yan
زانیارییەکان	.zan.ya.rî.ye.kan
سنووری	.si.nû.rî
پێغەمبەری	.pê.ẍem.be.rî
شەپۆلی	.şe.po.lî
لەچاپدەرانێکی	.le.çap.de.ra.nê.kî
نێوەکوردییەکان	.nê.we.kur.dî.ye.kan
بنەماڵەکەی	.bi.ne.ma.łe.key
حەزی	.ḧe.zî
دەرخستم	.der.xis.tim
زانیومە	.za.nîw.me
نێونەتەوەیی	.nêw.ne.te.we.yî
هێنانەکەم	.hê.na.ne.kem
سود	.sud
دووپاتی	.dû.pa.tî
گرژی	.gir.jî
دیکەی	.dî.key
هەزیرکردنی	.he.zîr.kir.di.nî
دەبەخشێت	.de.bex.şêt
ئامادەکراوەکانی	.ʔa.ma.de.ki.ra.we.ka.nî
دەناسێنن	.de.na.sê.nin
فڕۆکەخانەی	.fi.řo.ke.xa.ney
دایکی	.day.kî
ناڕەزایەتی	.na.ře.za.ye.tî
داشکانەوە	.da.şi.ka.ne.we
پێشتر	.pêş.tir
هۆشیاری	.hoş.ya.rî
ئاینی	.ʔay.nî
سپای	.si.pay
پاڵەوانەکانی	.pa.łe.wa.ne.ka.nî
جۆربەجۆرەکان	.cor.be.co.re.kan
کۆمەڵایەتی	.ko.me.ła.ye.tî
پڕۆژەکان	.pi.řo.je.kan
چەتەکان	.çe.te.kan
س	.si
هەولێر	.hew.lêr
کتێبفرۆشێکی	.ki.têb.fi.ro.şê.kî
ئاخوندی	.ʔa.xun.dî
بەرهەمانێک	.ber.he.ma.nêk
سزا	.si.za
ئیمەیل	.ʔî.meyl
دەما	.de.ma
بڕیارێکی	.biř.ya.rê.kî
دەچووە	.de.çu.we
سیمینار	.sî.mî.nar
سازمانی	.saz.ma.nî
پێشوی	.pêş.wî
سەری	.se.rî
نڤیسکیی	.ni.vîs.kîy
ئایینییەکانە	.ʔa.yî.nî.ye.ka.ne
نووسراوەکاندا	.nûs.ra.we.kan.da
دڵنیام	.dił.nyam
چاپخانەیەکی	.çap.xa.ne.ye.kî
ئەنوەر	.ʔen.wer
شۆڕشە	.şo.ři.şe
دەنا	.de.na
چاپخانەگەلە	.çap.xa.ne.ge.le
دەنگەکانی	.den.ge.ka.nî
هەناردەکردنی	.he.nar.de.kir.di.nî
تەشهیر	.teş.hîr
ناسراوەکانی	.nas.ra.we.ka.nî
کتێبخانەکانم	.ki.têb.xa.ne.ka.nim
بەجێدەهێڵێ	.be.cê.de.hê.łê
ئەفسەری	.ʔef.se.rî
رۆیشتە	.royş.te
پێکهاتەیەکی	.pêk.ha.te.ye.kî
کەڕەت	.ke.řet
ئاسمان	.ʔas.man
لەوەدایە	.le.we.da.ye
شێرکۆ	.şêr.ko
خۆشم	.xo.şim
هەندێکیشیان	.hen.dê.kîş.yan
بەرهەمانە	.ber.he.ma.ne
رەوتی	.rew.tî
گومروک	.gum.ruk
تورکەکانیشدا	.tur.ke.ka.nîş.da
لەچاپدەر	.le.çap.der
بەڕێوەچوونی	.be.řê.we.çû.nî
قەدەغە	.qe.de.ẍe
لێکدانەوەی	.lêk.da.ne.wey
رێپێنەدراوەکان	.rê.pê.ne.di.ra.we.kan
بەدیهێنانی	.be.dî.hê.na.nî
تاریکی	.ta.rî.kî
کردبوو	.kir.di.bû
ماڵپەری	.mał.pe.rî
بانگەوازی	.ban.ge.wa.zî
دەبردن	.de.bir.din
بەهەمان	.be.he.man
مافەکانیان	.ma.fe.kan.yan
نوێیان	.nwê.yan
پێشووەکاندا	.pê.şu.we.kan.da
مانەوەم	.ma.ne.wem
ژنانی	.ji.na.nî
کارەسات	.ka.re.sat
ئانگژا	.ʔan.gi.ja
کۆراندمەوە	.ko.ran.di.me.we
چەڵەمەیەشدا	.çe.łe.me.yeş.da
ئەورووپادا	.ʔew.rû.pa.da
رێخۆشکەری	.rê.xoş.ke.rî
ئاب	.ʔab
هەرچەند	.her.çend
دەنگەکان	.den.ge.kan
لەمەودوا	.le.mew.dwa
مامۆستای	.ma.mos.tay
زێڕین	.zê.řîn
بارەوە	.ba.re.we
راگەیاندنی	.ra.ge.yan.di.nî
یە	.ye
پرسیم	.pir.sîm
منداڵ	.min.dał
تەقەی	.te.qey
دۆزیونەتەوە	.do.zîw.ne.te.we
پرسیار	.pirs.yar
خوازیاری	.xwaz.ya.rî
ئەشکەنجانە	.ʔeş.ken.ca.ne
ئەنجامدراوە	.ʔen.cam.di.ra.we
هێشت	.hêşt
تیرۆر	.tî.ror
کۆکردنەوەی	.ko.kir.di.ne.wey
مەودای	.mew.day
چاپەمەنیگەلێک	.ça.pe.me.nî.ge.lêk
زانیاریی	.zan.ya.rîy
نارد	.nard
بزاڤەکەدا	.bi.za.ve.ke.da
قازانجی	.qa.zan.cî
بیروبڕوایان	.bî.ru.biř.wa.yan
قسە	.qi.se
ئاوات	.ʔa.wat
بکرێتە	.bi.ki.rê.te
دیونەتەوە	.dîw.ne.te.we
زانین	.za.nîn
راگەیاندووە	.ra.ge.yan.du.we
کارەکەشیان	.ka.re.keş.yan
لەبەرامبەردا	.le.be.ram.ber.da
سەددام	.sed.dam
بەرنامە	.ber.na.me
رێگا	.rê.ga
سازدەکرێ	.saz.de.ki.rê
زیان	.zyan
ناخۆش	.na.xoş
دوای	.dway
رۆژنامەگەل	.roj.na.me.gel
چۆڵ	.çoł
زۆرکات	.zor.kat
بوارەکانی	.bwa.re.ka.nî
سا	.sa
ڕاهێنان	.řa.hê.nan
ببووی	.bi.bûy
سەرەخۆشی	.se.re.xo.şî
بێکاری	.bê.ka.rî
بەڕووی	.be.řûy
بنەما	.bi.ne.ma
بەحرەین	.beḧ.reyn
أجنَبی	.ʔec.ne.bî
ئافرەتان	.ʔaf.re.tan
دەخوازێت	.de.xwa.zêt
ڕێکخەری	.řêk.xe.rî
دکتۆر	.dik.tor
بگرێت	.bi.gi.rêt
یۆرۆ	.yo.ro
لاو	.law
قسەیە	.qi.se.ye
لەبەندیخاناندا	.le.ben.dî.xa.nan.da
قەرزدار	.qerz.dar
کتێبانم	.ki.tê.ba.nim
ولاتە	.wi.la.te
پرۆگرامانی	.pi.rog.ra.ma.nî
بەباشی	.be.ba.şî
چاودێرەکانی	.çaw.dê.re.ka.nî
سەڵەف	.se.łef
لێکۆڵینەوەی	.lê.ko.łî.ne.wey
پێمان	.pê.man
دەکرێن	.de.ki.rên
ماندووبوونی	.man.dû.bû.nî
هێدی	.hê.dî
ماڵپەڕان	.mał.pe.řan
نێوە	.nê.we
لێکراوە	.lê.ki.ra.we
چووەتە	.çu.we.te
سەرچاوکەی	.ser.çaw.key
رێی	.rêy
حاجی	.ḧa.cî
پۆلیسی	.po.lî.sî
شتەی	.şi.tey
ماڵپەڕ	.mał.peř
بەسەردەبا	.be.ser.de.ba
هەفتەی	.hef.tey
توندوتێژی	.tun.du.tê.jî
بەرەو	.be.rew
خۆیانە	.xo.ya.ne
رخنەگیرانە	.rix.ne.gî.ra.ne
کیلۆمەتر	.kî.lo.me.tir
ئاژانسی	.ʔa.jan.sî
پێشانگاکانی	.pê.şan.ga.ka.nî
دەتوانیت	.de.twa.nît
زۆرکارییە	.zor.ka.rî.ye
خۆیدا	.xoy.da
کوردییان	.kur.dî.yan
تورکەکاندا	.tur.ke.kan.da
بەرنامەگەلەش	.ber.na.me.ge.leş
هێنابوو	.hê.na.bû
بەدواداچوونی	.be.dwa.da.çû.nî
دایکیان	.dayk.yan
منیش	.mi.nîş
ئایینین	.ʔa.yî.nîn
بەبۆنەی	.be.bo.ney
دوابەدوای	.dwa.be.dway
پاشایەتی	.pa.şa.ye.tî
نەتەوەکاندا	.ne.te.we.kan.da
کوردستانیشدا	.kur.dis.ta.nîş.da
گۆڤارەکە	.go.va.re.ke
زڕوزا	.zi.řu.za
وڵاتانی	.wi.ła.ta.nî
دێموکرات	.dê.muk.rat
پێغەمبەر	.pê.ẍem.ber
گفتوگۆکردن	.gif.tu.go.kir.din
شوێنەی	.şwê.ney
عوسمان	.ƹus.man
تۆمارنەکردنی	.to.mar.ne.kir.di.nî
توانیاندا	.twan.yan.da
شەست	.şest
سەرەنجی	.se.ren.cî
دەهێنرێ	.de.hên.rê
ڕێکخراوەکانی	.řêk.xi.ra.we.ka.nî
ناتوانین	.na.twa.nîn
زۆربووەوە	.zor.bu.we.we
بنەماڵەی	.bi.ne.ma.łey
گووتی	.gû.tî
کۆپیگەلەیە	.ko.pî.ge.le.ye
بوونیان	.bûn.yan
کراوەکان	.ki.ra.we.kan
دەرکەوتوون	.der.kew.tûn
تاوانە	.ta.wa.ne
سەعات	.se.ƹat
حیزبی	.ḧîz.bî
جەلەولا	.ce.lew.la
ڕەوشتی	.ře.wiş.tî
دادەمەزرێندرێ	.da.de.mez.rên.di.rê
ڕێژەیە	.řê.je.ye
قۆڵبەستی	.qoł.bes.tî
رەنگ	.reng
ساکارتر	.sa.kar.tir
ماڵێ	.ma.łê
مانایە	.ma.na.ye
لەنێوبردنیان	.le.nêw.bir.din.yan
دیاربەکرە	.dyar.be.ki.re
زۆرینە	.zo.rî.ne
کۆبوونەوەکان	.ko.bû.ne.we.kan
پێوەندیی	.pê.wen.dîy
نووسراوەیان	.nûs.ra.we.yan
کارادەمر	.ka.ra.de.mir
بهێنرێ	.bi.hên.rê
نەچێت	.ne.çêt
بەلاوەنانی	.be.la.we.na.nî
وێران	.wê.ran
چارسانجاک	.çar.san.cak
ناوەند	.na.wend
ئاژەڵ	.ʔa.jeł
دەهێنا	.de.hê.na
چارە	.ça.re
نانی	.na.nî
بەمەش	.be.meş
کتێبخانە	.ki.têb.xa.ne
رۆژنامەیە	.roj.na.me.ye
پێشخستن	.pêş.xis.tin
دانەبەزێنن	.da.ne.be.zê.nin
بەهەموو	.be.he.mû
دەکەون	.de.ke.win,.de.kewn
ئێوەی	.ʔê.wey
دڵی	.di.łî
بەکارهێنەرەکانی	.be.kar.hê.ne.re.ka.nî
ساکار	.sa.kar
ماتۆڕ	.ma.toř
وەرگێڕاوانێک	.wer.gê.řa.wa.nêk
کێبەرکێیەکی	.kê.ber.kê.ye.kî
دەوڵەمەند	.dew.łe.mend
باشوور	.ba.şûr
کێشەیەی	.kê.şe.yey
چووکی	.çû.kî
عەبدولڵا	.ƹeb.dul.ła
بەشار	.be.şar
یەکێتیی	.ye.kê.tîy
بەڕێوەبردنی	.be.řê.we.bir.di.nî
خوێندگەکاندا	.xwênd.ge.kan.da
باتلێر	.bat.lêr
دەرفەتە	.der.fe.te
وزەی	.wi.zey
فێڵ	.fêł
هاتووە	.ha.tu.we
خوێنگەکاندا	.xwên.ge.kan.da
ئامانج	.ʔa.manc
هۆیەکی	.ho.ye.kî
رۆژنامە	.roj.na.me
مل	.mil
تۆماردەکرێن	.to.mar.de.ki.rên
ئەکەن	.ʔe.ken
کێشەیەک	.kê.şe.yek
سووبسید	.sûb.sîd
بدات	.bi.dat
زیادبوونی	.zyad.bû.nî
کردوە	.kir.dwe
وەرگرن	.wer.gi.rin
حدک	.ḧi.dik
سەتیی	.se.tîy
نەفت	.neft
کتێبفرۆشییەکاندا	.ki.têb.fi.ro.şî.ye.kan.da
کۆتای	.ko.tay
هەوا	.he.wa
سەربەخۆی	.ser.be.xoy
هێرشەکانی	.hê.ri.şe.ka.nî
کتێبفرۆشیگەلێکی	.ki.têb.fi.ro.şî.ge.lê.kî
دەرمانی	.der.ma.nî
بەپێچەوانەوە	.be.pê.çe.wa.ne.we
دەدرێ	.de.di.rê
تۆپ	.top
خوێنەرانیش	.xwê.ne.ra.nîş
بەرژەوەندییە	.ber.je.wen.dî.ye
راحەتتر	.ra.ḧet.tir
گوند	.gund
میللەتی	.mîl.le.tî
گومان	.gu.man
ڕێبەری	.řê.be.rî
میدیا	.mîd.ya
بەدەستهێناوە	.be.des.ti.hê.na.we
تورکیاش	.turk.yaş
سەرلەنوێ	.ser.le.nwê
نەبی	.ne.bî
مەترسیدار	.me.tir.sî.dar,[.met.ri.sî.dar]
پڕۆسەی	.pi.řo.sey
گوتوویەتی	.gu.tû.ye.tî
دەدا	.de.da
دڵەکاندا	.di.łe.kan.da
ئەگەریش	.ʔe.ge.rîş
حیزبە	.ḧîz.be
هەڤیارییەکان	.hev.ya.rî.ye.kan
ئاوارەکان	.ʔa.wa.re.kan
ئامانجەکانیان	.ʔa.man.ce.kan.yan
روونی	.rû.nî
پاشدا	.paş.da
تۆمارنەکراون	.to.mar.ne.ki.ra.win
بەرامبەردا	.be.ram.ber.da
تێپەڕینی	.tê.pe.řî.nî
کەم‌ئەزموونەوە	.kem.ʔez.mû.ne.we
ئەوەیش	.ʔe.weyş
ئەژمارێک	.ʔej.ma.rêk
کەمە	.ke.me
خولەکەکانی	.xu.le.ke.ka.nî
باتی	.ba.tî
کچەکە	.ki.çe.ke
سەرچاوەی	.ser.ça.wey
نمایشی	.ni.ma.yi.şî
فرۆشران	.fi.roş.ran
ئەبێ	.ʔe.bê
قوتابخانە	.qu.tab.xa.ne
دێنێ	.dê.nê
سەرکەوتن	.ser.kew.tin
کەچا	.ke.ça
دەقە	.de.qe
هاوسەرۆکی	.haw.se.ro.kî
ڕۆژنامەنووسان	.řoj.na.me.nû.san
تۆمارکراوە	.to.mar.ki.ra.we
کەسایەتییە	.ke.sa.ye.tî.ye
دەبەن	.de.ben
راپرسنامەکەیان	.ra.pirs.na.me.ke.yan
وا	.wa
هەزار	.he.zar
سیابەند	.sya.bend
پێشانگاکان	.pê.şan.ga.kan
سەرووی	.se.rûy
ئەزموون	.ʔez.mûn
بەرفراوان	.ber.fi.ra.wan
گۆران	.go.ran
گۆڵی	.go.łî
سەبری	.seb.rî
شت	.şit
هانی	.ha.nî
وابێ	.wa.bê
تاوەکو	.ta.we.ku
لایەنگری	.la.yen.gi.rî
تورکییەوە	.tur.kî.ye.we
بەرچاوترن	.ber.çaw.ti.rin
پێداچوونەوەی	.pê.da.çû.ne.wey
بورهان	.bur.han
ماونەتەوە	.maw.ne.te.we
جارانیش	.ca.ra.nîş
شەممە	.şem.me
ئاستێکی	.ʔas.tê.kî
بەڵکوو	.beł.kû
بەشێک	.be.şêk
کۆسپە	.kos.pe
چەنێتییە	.çe.nê.tî.ye
لقی	.li.qî
رەوتێکی	.rew.tê.kî
درۆشمەکەی	.di.roş.me.key
دەستەوە	.des.te.we
هیوای	.hî.way
چەوساندنەوەیە	.çew.san.di.ne.we.ye
نیشان	.nî.şan
نووسەرانی	.nû.se.ra.nî
مووچەی	.mû.çey
بەسەردا	.be.ser.da
ناردووە	.nar.du.we
تایبەتیش	.tay.be.tîş
کۆمەڵگایە	.ko.meł.ga.ye
جۆرەکانی	.co.re.ka.nî
ڕاگەیاندنی	.řa.ge.yan.di.nî
سەربازە	.ser.ba.ze
ما	.ma
گرنگ	.gi.ring
شەش	.şeş
پاسداران	.pas.da.ran
باوەڕە	.ba.we.ře
دەستکەوت	.dest.kewt
خەون	.xewn
سووڕ	.sûř
هەبووبێ	.he.bû.bê
کارزان	.kar.zan
سانسۆرکردنی	.san.sor.kir.di.nî
بەرەکانی	.be.re.ka.nî
وە	.we
ئەمڕۆش	.ʔem.řoş
بکۆچدرێن	.bi.koç.di.rên
حکوومەتەکانی	.ḧi.kû.me.te.ka.nî
رێکخراوانەیان	.rêk.xi.ra.wa.ne.yan
مەسیحی	.me.sî.ḧî
باوەڕیان	.ba.weř.yan
لیوا	.lî.wa
خۆزات	.xo.zat
هەڵویستیان	.heł.wîst.yan
دەربڕیوە	.der.bi.řî.we
ئەو	.ʔew
ملی	.mi.lî
دەگرن	.de.gi.rin
ئازادە	.ʔa.za.de
بەشێوەیەک	.be.şê.we.yek
رێبەرەوە	.rê.be.re.we
کراوەن	.ki.ra.wen
قازی	.qa.zî
کەچی	.ke.çî
کێشە	.kê.şe
ڕۆژهەلاتی	.řoj.he.la.tî
شەهیدی	.şe.hî.dî
بەدوور	.be.dûr
رێکخراونەتەوە	.rêk.xi.raw.ne.te.we
ماوەیەدا	.ma.we.ye.da
واقیع	.wa.qîƹ
کۆمپانیا	.kom.pan.ya
بەیبوون	.bey.bûn
هەمیش	.he.mîş
شیعری	.şîƹ.rî
بکڕن	.bi.ki.řin
بدینرێنەوە	.bi.dîn.rê.ne.we
خۆشەویستی	.xo.şe.wîs.tî
جێگری	.cê.gi.rî
جۆراو	.co.raw
چاتر	.ça.tir
ترس	.tirs
ئیبراهیم	.ʔîb.ra.hîm
کاری	.ka.rî
کاریگەرە	.ka.rî.ge.re
والی	.wa.lî
هەنووکە	.he.nû.ke
ڕێزگرتن	.řêz.gir.tin
دانەوەی	.da.ne.wey
بەزەیی	.be.ze.yî
سزادران	.si.za.di.ran
ئاکامە	.ʔa.ka.me
پاش	.paş
کوتلەی	.kut.ley
ماڵپەڕانە	.mał.pe.řa.ne
بەڵێنی	.be.łê.nî
بەشداریان	.beş.dar.yan
نەدەکەوت	.ne.de.kewt
وەفدێکی	.wef.dê.kî
نێوانی	.nê.wa.nî
ساڵانەوە	.sa.ła.ne.we
دەبێتە	.de.bê.te
ئیخوان	.ʔîx.wan
زانایانی	.za.na.ya.nî
حکوومەتییە	.ḧi.kû.me.tî.ye
ناکۆکیگەلی	.na.ko.kî.ge.lî
شێعری	.şêƹ.rî
مرۆڤێکە	.mi.ro.vê.ke
کراون	.ki.ra.win
سینەماکاری	.sî.ne.ma.ka.rî
دەداتە	.de.da.te
هۆکاری	.ho.ka.rî
کرێکار	.ki.rê.kar
تێدەکۆشی	.tê.de.ko.şî
ئاڵن	.ʔa.łin
نوێی	.nwêy
پرسیارەکانی	.pirs.ya.re.ka.nî
دەخوێننەوە	.de.xwê.ni.ne.we
زۆرەوە	.zo.re.we
خزم	.xi.zim
چەسپاندنی	.çes.pan.di.nî
مەلەدی	.me.le.dî
بڵاویکردەوە	.bi.ła.wî.kir.de.we
نادات	.na.dat
کرام	.ki.ram
بوارێکدا	.bwa.rêk.da
نەمتوانی	.nem.twa.nî
ئەز	.ʔez
چمک	.çimk
ستوکهۆڵمەوە	.si.tuk.hoł.me.we
لکێنەری	.li.kê.ne.rî
هێمینگوەی	.hê.mîng.wey
کردبێ	.kir.di.bê
ئینتەرنەتدا	.ʔîn.ter.net.da
ئاخافتن	.ʔa.xaf.tin
چەکدارەکانی	.çek.da.re.ka.nî
کێبەرکێگەلێک	.kê.ber.kê.ge.lêk
گەلاوێژ	.ge.la.wêj
باڵی	.ba.łî
بەرپرسەکانی	.ber.pir.se.ka.nî
بڵاوکردنەوەوە	.bi.ław.kir.di.ne.we.we
هاتوونەتە	.ha.tû.ne.te
لێپرسینەوەیەک	.lê.pir.sî.ne.we.yek
عێراق	.ƹê.raq
بڵێین	.bi.łêyn
بنووسرێ	.bi.nûs.rê
نووسیندا	.nû.sîn.da
کوردیگەلە	.kur.dî.ge.le
سەرکوتی	.ser.ku.tî
هیچ	.hîç
نێت	.nêt
دیکەشی	.dî.ke.şî
گرتن	.gir.tin
هەڵگوێسدراون	.heł.gwês.di.ra.win
گەورەتر	.gew.re.tir
بەیرووتەوە	.bey.rû.te.we
هەنگاوەکانی	.hen.ga.we.ka.nî
بەلاش	.be.laş
کوردیان	.kurd.yan
نزیک	.ni.zîk
وێڕای	.wê.řay
بینیندا	.bî.nîn.da
گرووپانی	.gi.rû.pa.nî
گریان	.gir.yan
باڵا	.ba.ła
عەشقیان	.ƹeşq.yan
خڕیان	.xiř.yan
فۆرم	.form
قۆناغەکانی	.qo.na.ẍe.ka.nî
سەنگ	.seng
فەرهەنگییەدا	.fer.hen.gî.ye.da
مۆدێلی	.mo.dê.lî
هاووڵاتی	.haw.wi.ła.tî
فراوان	.fi.ra.wan
کوردییەکاندا	.kur.dî.ye.kan.da
کاتێکیش	.ka.tê.kîş
ڕاستەقینەی	.řas.te.qî.ney
سۆسیال	.sos.yal
نوێبنیانەکەی	.nwê.bin.ya.ne.key
بهێنین	.bi.hê.nîn
دەرکەوتووە	.der.kew.tu.we
پەڵپێکە	.peł.pê.ke
هاوار	.ha.war
کۆمیسیۆنی	.ko.mîs.yo.nî
کەناڵی	.ke.na.łî
دەکەن	.de.ken
نەکربوو	.ne.kir.bû
گۆڕێ	.go.řê
دەوێ	.de.wê
ئارخا	.ʔar.xa
دەژین	.de.jîn
دەخایێنێ	.de.xa.yê.nê
نادرکێنن	.na.dir.kê.nin
بەردەوامیی	.ber.de.wa.mîy
باکووری	.ba.kû.rî
پێشکەشی	.pêş.ke.şî
پەوند	.pewnd
شەممەی	.şem.mey
چیرۆک	.çî.rok
جگەرخوێنیش	.ci.ger.xwê.nîş
دایانگرن	.da.yan.gi.rin
دەگێڕاوە	.de.gê.řa.we
زانیوە	.za.nî.we
سوێندیان	.swênd.yan
شەریف	.şe.rîf
تەمموز	.tem.muz
گوتیان	.gut.yan
ئاسمانی	.ʔas.ma.nî
عەرەبی	.ƹe.re.bî
دانەیە	.da.ne.ye
حەکیمخان	.ḧe.kîm.xan
گەرەکیان	.ge.rek.yan
جۆرج	.corc
هاوڕیش	.haw.řîş
کەمترین	.kem.ti.rîn
چاپدران	.çap.di.ran
راستە	.ras.te
هۆیەوە	.ho.ye.we
کێشەکانی	.kê.şe.ka.nî
شانۆگەری	.şa.no.ge.rî
چونکە	.çun.ke
پارەکە	.pa.re.ke
دێفۆ	.dê.fo
بەهێزە	.be.hê.ze
بالای	.ba.lay
هێندە	.hên.de
موسڵمان	.mu.sił.man]
هێرشێکی	.hê.ri.şê.kî
چاپەمەنییەوە	.ça.pe.me.nî.ye.we
هەڤالەکانی	.he.va.le.ka.nî
تووشی	.tû.şî
دەفرۆشت	.de.fi.roşt
گەڕ	.geř
هەستیان	.hest.yan
وتیشیان	.wi.tîş.yan
دێن	.dên
تێکچوونی	.têk.çû.nî
پیلانی	.pî.la.nî
مەیدانی	.mey.da.nî
لەچاپدەرەکان	.le.çap.de.re.kan
لایەکی	.la.ye.kî
تیرۆریستان	.tî.ro.rîs.tan
ئیتلاعاتی	.ʔît.la.ƹa.tî
بایەخانە	.ba.ye.xa.ne
ئەمانەن	.ʔe.ma.nen
رابردووی	.ra.bir.dûy
وەرزشی	.wer.zi.şî
ترسان	.tir.san
لەچاپدراوەکانی	.le.çap.di.ra.we.ka.nî
لەمبارەیەوە	.lem.ba.re.ye.we
ئارادایە	.ʔa.ra.da.ye
یەکەم	.ye.kem
بخات	.bi.xat
یاخی	.ya.xî
ئاسان	.ʔa.san
دەردەکەوێ	.der.de.ke.wê
تۆمارکرد	.to.mar.kird
ئاڵا	.ʔa.ła
لێزانەکانەوە	.lê.za.ne.ka.ne.we
ڕێکخراوەکان	.řêk.xi.ra.we.kan
لێرەوە	.lê.re.we
لەچاپدەرێکی	.le.çap.de.rê.kî
ناتوانێ	.nat.wa.nê,.na.twa.nê
بری	.bi.rî
ئەدەبییانەوەیە	.ʔe.de.bî.ya.ne.we.ye
دووهەمین	.dû.he.mîn
فەرمییان	.fer.mî.yan
دابەش	.da.beş
ناردبوو	.nar.di.bû
هاوڕا	.haw.řa
حەوت	.ḧewt
دەبەستێت	.de.bes.têt
دەناسرێن	.de.nas.rên
کتێبێکی	.ki.tê.bê.kî
رووی	.rûy
ناڕێکەوە	.na.řê.ke.we
ئینتەرنەتی	.ʔîn.ter.ne.tî
سەریاندا	.ser.yan.da
دادپەروەری	.dad.per.we.rî
پارەش	.pa.reş
تەواویی	.te.wa.wîy
شادی	.şa.dî
باڵیۆزی	.bał.yo.zî
شوێنکەوتنی	.şwên.kew.ti.nî
هاندەرانی	.han.de.ra.nî
دەجووڵێنەوە	.de.cû.łê.ne.we
سازکرد	.saz.kird
دیاری	.dya.rî
نەخۆشییە	.ne.xo.şî.ye
ناوچەگەلە	.naw.çe.ge.le
حیزبێکی	.ḧîz.bê.kî
کۆپیگەلە	.ko.pî.ge.le
راگەیەندراوی	.ra.ge.yen.di.ra.wî
جیاوازن	.cya.wa.zin
ڕێککەوتنی	.řêk.kew.ti.nî
ئەوانە	.ʔe.wa.ne
تەواوبوونی	.te.waw.bû.nî
ئیعدامی	.ʔîƹ.da.mî
ناوچەکان	.naw.çe.kan
لێکۆڵینەوەیەدا	.lê.ko.łî.ne.we.ye.da
چیا	.çya
هەواڵنێری	.he.wał.nê.rî
فایەق	.fa.yeq
ئەزموونی	.ʔez.mû.nî
پرۆسەی	.pi.ro.sey
نێوخۆیان	.nêw.xo.yan
دام	.dam
هاوبەشی	.haw.be.şî
ڕاگەیەنرا	.řa.ge.yen.ra
جەوهەر	.cew.her
کاروان	.kar.wan
چەتەکانی	.çe.te.ka.nî
کچانی	.ki.ça.nî
ئەبێت	.ʔe.bêt
مێژوو	.mê.jû
بڕۆ	.bi.řo
خوێنەرەکانی	.xwê.ne.re.ka.nî
کرماشان	.kir.ma.şan
ناوەندەکەی	.na.wen.de.key
فێرگەکاندا	.fêr.ge.kan.da
چاپی	.ça.pî
دراوە	.di.ra.we
کتێبخانەیەک	.ki.têb.xa.ne.yek
دەلاڤ	.de.lav
ئاکامەکان	.ʔa.ka.me.kan
تەنیایی	.ten.ya.yî
زانیارییەک	.zan.ya.rî.yek
خەلیل	.xe.lîl
خانم	.xa.nim
منە	.mi.ne
خوێندەواریی	.xwên.de.wa.rîy
دروست	.di.rust
گوێی	.gwêy
زەبەند	.ze.bend
سەلامەتی	.se.la.me.tî
وەفدی	.wef.dî
نوێنەرانی	.nwê.ne.ra.nî
ببن	.bi.bin
پەخشی	.pex.şî
جارانەی	.ca.ra.ney
بغازیچی	.bi.ẍa.zî.çî
خاسە	.xa.se
تامەزرۆییی	.ta.mez.ro.yîy
ویست	.wîst
ئەوەشی	.ʔe.we.şî
ناوازە	.na.wa.ze
بەتایبەتی	.be.tay.be.tî
گرفتی	.gi.rif.tî
قەتیان	.qet.yan
ڕۆژی	.řo.jî
زمانێک	.zi.ma.nêk
چاوپێکەوتنەکانی	.çaw.pê.kew.ti.ne.ka.nî
ئایینی	.ʔa.yî.nî
سۆسیالیستی	.sos.ya.lîs.tî
دەتوانرێت	.de.twan.rêt
ئاماژەیە	.ʔa.ma.je.ye
گرفتە	.gi.rif.te
تەماوی	.te.ma.wî
کانن	.ka.nin
بەڕێوەبەری	.be.řê.we.be.rî
لەخۆی	.le.xoy
دەسحەقی	.des.ḧe.qî
ڕێکخراوەیی	.řêk.xi.ra.we.yî
ئۆتۆمبێلەکانی	.ʔo.tom.bê.le.ka.nî
ستایشی	.si.ta.yi.şî
دانیشتووان	.da.nîş.tu.wan
ڕۆژ	.řoj
ئەنبار	.ʔen.bar
سەد	.sed
یاسایییان	.ya.sa.yî.yan
دەرفەتێکیان	.der.fe.têk.yan
زۆربوونی	.zor.bû.nî
بەخشینی	.bex.şî.nî
کۆنگرەکەدا	.kon.gi.re.ke.da
بەرپرسیار	.ber.pirs.yar
کچێکی	.ki.çê.kî
نووسراوەکان	.nûs.ra.we.kan
پرسیارەتان	.pirs.ya.re.tan
هاتوون	.ha.tûn
پینتێر	.pîn.têr
کەنەدا	.ke.ne.da
دەزانی	.de.za.nî
شارانی	.şa.ra.nî
ستەم	.si.tem
زین	.zîn
کتێبیان	.ki.têb.yan
وەرگێڕانەوە	.wer.gê.řa.ne.we
مە	.me
دەستنیشانکردنی	.dest.nî.şan.kir.di.nî
بیرۆکە	.bî.ro.ke
سەرجەمی	.ser.ce.mî
گوتەیەکی	.gu.te.ye.kî
کەسێکی	.ke.sê.kî
دەبیت	.de.bît
هەنگاوی	.hen.ga.wî
کێیە	.kê.ye
سۆزی	.so.zî
هەڵوێست	.heł.wêst
در	.dir
هاووڵاتییەک	.haw.wi.ła.tî.yek
جەستەی	.ces.tey
گەڕان	.ge.řan
عەبدوڵا	.ƹeb.du.ła
نازناو	.naz.naw
پرۆگرامەکانیان	.pi.rog.ra.me.kan.yan
نووسیویانە	.nû.sîw.ya.ne
رێپێنەدراوانە	.rê.pê.ne.di.ra.wa.ne
دامەزراوە	.da.mez.ra.we
نیشتەجێیە	.nîş.te.cê.ye
هاوڕێیەکانم	.haw.řê.ye.ka.nim
دەرهێنانی	.der.hê.na.nî
نێوبراوەکە	.nêw.bi.ra.we.ke
بۆچوونیان	.bo.çûn.yan
دەخەمڵێندرێ	.de.xem.łên.di.rê
کتێبخانەیە	.ki.têb.xa.ne.ye
پێشەوە	.pê.şe.we
پڕچاودێری	.piř.çaw.dê.rî
ئەمینداری	.ʔe.mîn.da.rî
لەچاپدەرانێک	.le.çap.de.ra.nêk
عەرەبستان	.ƹe.re.bis.tan
بەڕێوەچوو	.be.řê.we.çû
ساڵن	.sa.łin
چاپدان	.çap.dan
کاتە	.ka.te
وڵات	.wi.łat
ئازادیخوازی	.ʔa.za.dîx.wa.zî
یەکیەتیی	.yek.ye.tîy
دەتوانن	.de.twa.nin
کاندا	.kan.da
ئەمریکای	.ʔem.rî.kay
دەچن	.de.çin
بەروار	.ber.war
دروستکردووە	.di.rust.kir.du.we
چوارچێوەیەدا	.çwar.çê.we.ye.da
نیشتیمان	.nîş.tî.man
لەسەر	.le.ser
نیشاندانی	.nî.şan.da.nî
بلیمەتانە	.bi.lî.me.ta.ne
وێنە	.wê.ne
یاریزانانی	.ya.rî.za.na.nî
هەلی	.he.lî
بزانم	.bi.za.nim
خێزانانێکی	.xê.za.na.nê.kî
دانەوە	.da.ne.we
خێزانی	.xê.za.nî
دانیشتنی	.da.nîş.ti.nî
دووپات	.dû.pat
جەبار	.ce.bar
وڵاتە	.wi.ła.te
زۆربەی	.zor.bey
راستیدا	.ras.tî.da
عاشقی	.ƹa.şi.qî
دەدرا	.de.di.ra
خۆڵەمێش	.xo.łe.mêş
تاریک	.ta.rîk
قاتی	.qa.tî
پیرۆزبایی	.pî.roz.ba.yî
سەرۆکی	.se.ro.kî
ڕۆژان	.řo.jan
نێونراوە	.nêw.ni.ra.we
ڕووداو	.řû.daw
رۆژنامەی	.roj.na.mey
پێچەوانەی	.pê.çe.wa.ney
فەلەستین	.fe.les.tîn
ئۆپۆزسیۆنی	.ʔo.po.zis.yo.nî
دانیشتوان	.da.nîş.twan
نامەیەکی	.na.me.ye.kî
تەلەب	.te.leb
هەمو	.he.mu
تووش	.tûş
ئێمەدا	.ʔê.me.da
گەندەڵی	.gen.de.łî
مانگە	.man.ge
ئافرەتانی	.ʔa.fi.re.ta.nî
ڕادەربڕین	.řa.der.bi.řîn
شاران	.şa.ran
دەزگای	.dez.gay
ئامادەبوونی	.ʔa.ma.de.bû.nî
جەماوەر	.ce.ma.wer
یۆنانی	.yo.na.nî
کچی	.ki.çî
لەدوو	.le.dû
ڕەت	.řet
فیستیڤاڵە	.fîs.tî.va.łe
لەبەرچاو	.le.ber.çaw
تەمۆ	.te.mo
لاپەڕەیی	.la.pe.ře.yî
مووچەیان	.mû.çe.yan
ئاکینان	.ʔa.kî.nan
کتێبفرۆشەکە	.ki.têb.fi.ro.şe.ke
لەشی	.le.şî
ئەگەری	.ʔe.ge.rî
پرۆگرامە	.pi.rog.ra.me
ئەنجومەن	.ʔen.cu.men
بەرەنگاری	.be.ren.ga.rî
چاپخانەکان	.çap.xa.ne.kan
حکوومەتە	.ḧi.kû.me.te
بڕۆن	.bi.řon
بەری	.be.rî
پەیام	.pe.yam
هۆنراوە	.hon.ra.we
ئەڤیندارانە	.ʔe.vîn.da.ra.ne
داسەپاندن	.da.se.pan.din
هاوڕێن	.haw.řên
کارلێکەرییان	.kar.lê.ke.rî.yan
کۆمەڵگەیەکی	.ko.meł.ge.ye.kî
هێنایە	.hê.na.ye
یەکەمیان	.ye.kem.yan
وێنەیە	.wê.ne.ye
ئەمساڵ	.ʔem.sał
نادرێت	.nad.rêt
چیخۆف	.çî.xof
مەڕ	.meř
نیسان	.nî.san
درێژەی	.di.rê.jey
پێکەنین	.pê.ke.nîn
بارە	.ba.re
ئەسپێردرایە	.ʔes.pêr.di.ra.ye
سەرچاوە	.ser.ça.we
بەوەشدا	.be.weş.da
کەوتووە	.kew.tu.we
رۆژان	.ro.jan
رۆژانێکی	.ro.ja.nê.kî
مَطبَع	.me.beƹ
کەوتنی	.kew.ti.nî
لۆ	.lo
نایاسایییانەمان	.na.ya.sa.yî.ya.ne.man
کۆبوونەوەکانی	.ko.bû.ne.we.ka.nî
گەمارۆ	.ge.ma.ro
هەڵوێستێکی	.heł.wês.tê.kî
کۆڕ	.koř
جومهووریەت	.cum.hûr.yet
دهۆک	.di.hok
هارڤارد	.har.vard
بکەیت	.bi.keyt
ناشارەزا	.na.şa.re.za
فیلمەکانی	.fîl.me.ka.nî
گیانیان	.gyan.yan
خراپی	.xi.ra.pî
دەکەیت	.de.keyt
سەردەمداریی	.ser.dem.da.rîy
هەلومەرجەکە	.he.lu.mer.ce.ke
بینای	.bî.nay
ناردراون	.nar.di.ra.win
دیاربەکرێ	.dyar.be.ki.rê
پەیدا	.pey.da
دابا	.da.ba
یارییەکی	.ya.rî.ye.kî
کەوتە	.kew.te
بەربڵاوانە	.ber.bi.ła.wa.ne
موچەی	.mu.çey
ئینتەرنەتەوە	.ʔîn.ter.ne.te.we
جەخت	.cext
شەهیدانی	.şe.hî.da.nî
پێشوو	.pê.şû
نەبوونی	.ne.bû.nî
سەربازییەکانی	.ser.ba.zî.ye.ka.nî
رێکدەخرا	.rêk.dex.ra
بابەتانێک	.ba.be.ta.nêk
مانا	.ma.na
ئۆدەیان	.ʔo.de.yan
هەلێکە	.he.lê.ke
دیاردەگەلێکی	.dyar.de.ge.lê.kî
باش	.baş
تێزێک	.tê.zêk
بەرهەمهێنان	.ber.hem.hê.nan
ژنی	.ji.nî
یۆنان	.yo.nan
کوت	.kut
هێرش	.hê.riş
شارۆچکەکان	.şa.roç.ke.kan
دەپرینگانەوە	.de.pi.rîn.ga.ne.we
دەر	.der
زوانەکەمان	.zwa.ne.ke.man
پەکیان	.pek.yan
ئەلئەسەد	.ʔel.ʔe.sed
کۆریای	.kor.yay
ترسە	.tir.se
لاواز	.la.waz
سادق	.sa.diq
روانگەوە	.rwan.ge.we
درابن	.di.ra.bin
دەگەڵیان	.de.geł.yan
دەرخستووە	.der.xis.tu.we
نەورۆز	.new.roz
کێوی	.kê.wî
بارودۆخەکە	.ba.ru.do.xe.ke
پلەوپایەیەکی	.pi.lew.pa.ye.ye.kî
پارتە	.par.te
دوایییانە	.dwa.yî.ya.ne
نادۆزرێتەوە	.na.doz.rê.te.we
کڕیارەکانیشی	.kiř.ya.re.ka.nî.şî
کێشەیان	.kê.şe.yan
یاسایەکی	.ya.sa.ye.kî
شوێنانی	.şwê.na.nî
گەریلایانە	.ge.rî.la.ya.ne
گەیشتن	.geyş.tin
مەحکوم	.meḧ.kum
ماشینەکانی	.ma.şî.ne.ka.nî
کورکەی	.kur.key
سارد	.sard
ڤیکتۆر	.vîk.tor
مەدریدی	.med.rî.dî
کەم	.kem
گۆڕی	.go.řî
بەیرووتێ	.bey.rû.tê
فێرکاریدا	.fêr.ka.rî.da
تۆڵە	.to.łe
دەکەین	.de.keyn
هیلال	.hî.lal
پیس	.pîs
یەکگرتوو	.yek.gir.tû
داعش	.da.ƹiş
پێم	.pêm
ئەمەکەش	.ʔe.me.keş
ڕیز	.řîz
ڕوونی	.řû.nî
باس	.bas
کشتوکاڵ	.kiş.tu.kał
درا	.di.ra
کوردیمان	.kur.dî.man
پوول	.pûl
بگیرێت	.bi.gî.rêt
دوایی	.dwa.yî
رێپێنەدراوییەکاندا	.rê.pê.ne.di.ra.wî.ye.kan.da
چوونی	.çû.nî
مارکس	.marks
دەفرۆشدران	.def.roş.di.ran
ئێرانەوە	.ʔê.ra.ne.we
بۆیان	.bo.yan
ئۆسێ	.ʔo.sê
بۆشایی	.bo.şa.yî
بووەتە	.bu.we.te
میسر	.mî.sir
سەرنجێکی	.se.rin.cê.kî
حەز	.ḧez
عەرەبەکاندا	.ƹe.re.be.kan.da
مرۆیی	.mi.ro.yî
چاوپێکەوتن	.çaw.pê.kew.tin
هەشن	.he.şin
ناردرا	.nar.di.ra
بێبەرین	.bê.be.rîn
ڕەوتی	.řew.tî
کارەبای	.ka.re.bay
قورسە	.qur.se
دەمێنێتەوە	.de.mê.nê.te.we
بڵاوی	.bi.ła.wî
نەتەوەیەک	.ne.te.we.yek
بەسرە	.bes.re
ئاشکرای	.ʔaş.ki.ray
دەبووە	.de.bu.we
نابێتەوە	.na.bê.te.we
دەخرێتە	.de.xi.rê.te
رۆژنامەکان	.roj.na.me.kan
پارەشی	.pa.re.şî
لەچاپدەری	.le.çap.de.rî
موحەممەد	.mu.ḧem.med
نموونەیەکی	.ni.mû.ne.ye.kî
خوێندەوارەکان	.xwên.de.wa.re.kan
هەژمار	.hej.mar
بچوک	.bi.çuk
سووریای	.sûr.yay
ڕۆژانەی	.řo.ja.ney
تێکۆشان	.tê.ko.şan
ئینقلابی	.ʔîn.qi.la.bî
کۆسرەت	.kos.ret
پارێزگایەدا	.pa.rêz.ga.ye.da
هیچیان	.hîç.yan
پسپۆڕانە	.pis.po.řa.ne
بەستن	.bes.tin
نەسەلمێندراوە	.ne.sel.mên.di.ra.we
دانی	.da.nî
بەرژەوەندییەکانی	.ber.je.wen.dî.ye.ka.nî
ماوەیەک	.ma.we.yek
دادوەرییەکان	.dad.we.rî.ye.kan
خەریکن	.xe.rî.kin
نەبوە	.neb.we
ڕێکەوت	.řê.kewt
هەژار	.he.jar
فەڕەنسییەکاندا	.fe.řen.sî.ye.kan.da
شتێک	.şi.têk
هەرکەسێک	.her.ke.sêk
بەرد	.berd
وەرگێڕانە	.wer.gê.řa.ne
نەماوەتەوە	.ne.ma.we.te.we
پان	.pan
زانایان	.za.na.yan
زاندرابوو	.zan.di.ra.bû
لەچاپدەرانە	.le.çap.de.ra.ne
یەکڕیزی	.yek.řî.zî
دەدۆزرایەوە	.de.doz.ra.ye.we
مەزن	.me.zin
بەرپرسانی	.ber.pir.sa.nî
لایەنانە	.la.ye.na.ne
خستەڕوو	.xis.te.řû
کانونی	.ka.nu.nî
هەندەک	.hen.dek
زانستگایییان	.za.nist.ga.yî.yan
ڕاشکاوانە	.řa.şi.ka.wa.ne
ئوسترالیا	.ʔus.ti.ral.ya
ئەفسانە	.ʔef.sa.ne
بنکەکانی	.bin.ke.ka.nî
کتێبخانانەی	.ki.têb.xa.na.ney
تێدەچوو	.tê.de.çû
کتێبخانا	.ki.têb.xa.na
هەبوو	.he.bû
ڕەتکردەوە	.řet.kir.de.we
مەدرید	.med.rîd
شێوازێکە	.şê.wa.zê.ke
لاوەکان	.la.we.kan
بەکارهێنەری	.be.kar.hê.ne.rî
کەوتن	.kew.tin
چیرۆکەکان	.çî.ro.ke.kan
مەحکووم	.meḧ.kûm
ئەکات	.ʔe.kat
چاپخانەیەدا	.çap.xa.ne.ye.da
ئەرسەلان	.ʔer.se.lan
قسانەی	.qi.sa.ney
ناوچانە	.naw.ça.ne
مانگان	.man.gan
جیاجیا	.cya.cya
مارەبڕینەکەی	.ma.re.bi.řî.ne.key
بەسوود	.be.sûd
گشتی	.giş.tî
خایاندی	.xa.yan.dî
بڵاوکردنەوەیە	.bi.ław.kir.di.ne.we.ye
رێپێدراون	.rê.pê.di.ra.win
پەردەی	.per.dey
عارف	.ƹa.rif
چارەسەری	.ça.re.se.rî
کتێبفرۆشی	.ki.têb.fi.ro.şî
فەرمییەکانی	.fer.mî.ye.ka.nî
گرینگییەکی	.gi.rîn.gî.ye.kî
ئێوارەی	.ʔê.wa.rey
لەئاکامدا	.le.ʔa.kam.da
برایم	.bi.raym
سەرەکی	.se.re.kî
دا	.da
میدیاکانی	.mîd.ya.ka.nî
بنێردرێ	.bi.nêr.di.rê
فۆلکلۆرن	.fol.ki.lo.rin
ماڵیاندا	.mał.yan.da
نیشتمانی	.nîş.ti.ma.nî
سوریادا	.sur.ya.da
نیشتمانپەروەرییە	.nîş.ti.man.per.we.rî.ye
خۆیەوە	.xo.ye.we
هونەریی	.hu.ne.rîy
نەهات	.ne.hat
نەتەوەخوازەکانی	.ne.te.we.xwa.ze.ka.nî
ئێوەش	.ʔê.weş
هات	.hat
فێستیڤاڵ	.fês.tî.vał
ئەرێنی	.ʔe.rê.nî
کاتژمێری	.kat.ji.mê.rî
دامەزراوەی	.da.mez.ra.wey
دابمەزرێ	.da.bi.mez.rê
ئانتەرەوە	.ʔan.te.re.we
مەترسی	.me.tir.sî
رۆژنامەکە	.roj.na.me.ke
ئێکجار	.ʔêk.car
پێناسەکانی	.pê.na.se.ka.nî
جلی	.ci.lî
دەس	.des
بێبەشەکاندا	.bê.be.şe.kan.da
لێیانتێکدەچوو	.lê.yan.têk.de.çû
ڤاتە	.va.te
دەگەل	.de.gel
ماڵپەڕە	.mał.pe.ře
هەڵگری	.heł.gi.rî
بابەت	.ba.bet
لێپرسینەکەم	.lê.pir.sî.ne.kem
لایە	.la.ye
بەندکراوە	.bend.ki.ra.we
تۆمارەکان	.to.ma.re.kan
پەیامێکی	.pe.ya.mê.kî
هاتووەتە	.ha.tu.we.te
نووسەرەکانی	.nû.se.re.ka.nî
درکێندران	.dir.kên.di.ran
رێکخران	.rêk.xi.ran
باغجالر	.baẍ.ca.lir
سەرۆک	.se.rok
رووداوەیە	.rû.da.we.ye
خەڵکەکانی	.xeł.ke.ka.nî
دەریا	.der.ya
کومیتەی	.ku.mî.tey
دیکە	.dî.ke
ئاقارێکی	.ʔa.qa.rê.kî
لێیانپرسی	.lê.yan.pir.sî
ناوەڕاستدا	.na.we.řast.da
دەنووسی	.de.nû.sî
ڕۆژنامەی	.řoj.na.mey
کردنە	.kir.di.ne
ئاکامدا	.ʔa.kam.da
کانگای	.kan.gay
ناتوانێت	.nat.wa.nêt
دەهێنێت	.de.hê.nêt
تازەلاوەکان	.ta.ze.la.we.kan
ئاسۆی	.ʔa.soy
کۆشکی	.koş.kî
شتانەی	.şi.ta.ney
وردە	.wir.de
ڤرۆنسکی	.vi.ro.nis.kî
رەگەڵ	.re.geł
هەڵۆ	.he.ło
چارەنووس	.ça.re.nûs
بەرازیلی	.be.ra.zî.lî
ناوەڕاست	.na.we.řast
بەرلین	.ber.lîn
ئیسلام	.ʔîs.lam
داواخوازانە	.da.wa.xwa.za.ne
دەگرتەوە	.de.gir.te.we
دەنووسێت	.de.nû.sêt
لەچاپداون	.le.çap.da.win
ملم	.mi.lim
هاوچەرخەوە	.haw.çer.xe.we
چەپڕەوە	.çep.ře.we
تەمووزی	.te.mû.zî
دەگەڕێنن	.de.ge.řê.nin
ڕووی	.řûy
لەسەرەتاوە	.le.se.re.ta.we
کابرا	.kab.ra
پێداهەڵگوتنەوەی	.pê.da.heł.gu.ti.ne.wey
وێژەیەکی	.wê.je.ye.kî
قاهیرەدا	.qa.hî.re.da
راگرتنی	.ra.gir.ti.nî
ڕەوا	.ře.wa
سەرەتا	.se.re.ta
بڵاوکرنەوەی	.bi.ław.kir.ne.wey
روانگەگەلێکی	.rwan.ge.ge.lê.kî
کۆسپ	.kosp
تورکیدا	.tur.kî.da
لێدەکەن	.lê.de.ken
حزبە	.ḧiz.be
ئاسانتر	.ʔa.san.tir
وانە	.wa.ne
ئینجیل	.ʔîn.cîl
بەڕێزان	.be.řê.zan
پارێزگاکانی	.pa.rêz.ga.ka.nî
بابەتەکە	.ba.be.te.ke
بارودۆخێکی	.ba.ru.do.xê.kî
چەپۆکی	.çe.po.kî
پێوەری	.pê.we.rî
هەڵبەتە	.heł.be.te
دەیانەوێ	.de.ya.ne.wê
سروشتی	.si.ruş.tî
کۆمەک	.ko.mek
سویددا	.swîd.da
یەکدا	.yek.da
کۆپیی	.ko.pîy
هێزانە	.hê.za.ne
رووداوەیەکی	.rû.da.we.ye.kî
کۆپیدا	.ko.pî.da
لەچاپدان	.le.çap.dan
بابەتەوە	.ba.be.te.we
خونتایەکی	.xun.ta.ye.kî
دەسەڵاتدار	.de.se.łat.dar
بدەنەوە	.bi.de.ne.we
داهێزانی	.da.hê.za.nî
کرانی	.ki.ra.nî
چاپکراوەیەکی	.çap.ki.ra.we.ye.kî
داوەتەوە	.da.we.te.we
پەنجەرە	.pen.ce.re
بابی	.ba.bî
لیرەی	.lî.rey
دێپارتمانی	.dê.par.ti.ma.nî
بووبوو	.bû.bû
ئازادیێ	.ʔa.zad.yê
بەگژیاندا	.be.gij.yan.da
گۆڤار	.go.var
رەگەزی	.re.ge.zî
یەکی	.ye.kî
رێکخراوەکە	.rêk.xi.ra.we.ke
خەبات	.xe.bat
گرینگیی	.gi.rîn.gîy
پەیڕەوی	.pey.ře.wî
کڕین	.ki.řîn
هەروەک	.her.wek
کۆبوونەوەگەلی	.ko.bû.ne.we.ge.lî
بڵێن	.bi.łên
قەڵای	.qe.łay
هادی	.ha.dî
لۆزان	.lo.zan
فراوانی	.fi.ra.wa.nî
یوونایتد	.yû.nay.tid
هەڕەتە	.he.ře.te
ئینجا	.ʔîn.ca
هێمنی	.hê.mi.nî
هاوکارییان	.haw.ka.rî.yan
دیجیتاڵی	.dî.cî.ta.łî
خراپتر	.xi.rap.tir
کەرکووک	.ker.kûk
رێکخرابوو	.rêk.xi.ra.bû
تەواوکردنی	.te.waw.kir.di.nî
ئێستەش	.ʔês.teş
لاویش	.la.wîş
بەرەنگارییەکان	.be.ren.ga.rî.ye.kan
ستۆکهۆڵم	.si.tok.hołm
ددان	.di.dan
بزوتنەوەی	.bi.zut.ne.wey
متمانە	.mit.ma.ne
کەرکوکی	.ker.ku.kî
یاریزانان	.ya.rî.za.nan
سال	.sal
کوژرانی	.kuj.ra.nî
دەبینرێت	.de.bîn.rêt
تەنیا	.ten.ya
وەنووسن	.we.nû.sin
نەتەوەیییەکان	.ne.te.we.yî.ye.kan
بردووە	.bir.du.we
پشتیوانییەک	.piş.tî.wa.nî.yek
فەوجی	.few.cî
پاسا	.pa.sa
دیناری	.dî.na.rî
مان	.man
نەخشە	.nex.şe
ون	.win
جێگاکەی	.cê.ga.key
بریتین	.bi.rî.tîn
دەستدا	.dest.da
وتارێکی	.wi.ta.rê.kî
هۆ	.ho
کتێبفرۆشییانێک	.ki.têb.fi.ro.şî.ya.nêk
خۆکوژی	.xo.ku.jî
بەندیخانەیەکی	.ben.dî.xa.ne.ye.kî
دەڕوات	.de.řwat
ئیسلامی	.ʔîs.la.mî
چارەنووسی	.ça.re.nû.sî
ئەڤیندارانەی	.ʔe.vîn.da.ra.ney
ئارامی	.ʔa.ra.mî
کتوپڕ	.ki.tu.piř
بەهەر	.be.her
ڕۆیشت	.řo.yişt
دەیهەوێت	.dey.he.wêt
زیاترە	.zya.ti.re
ئیسراییلیش	.ʔîs.ra.yî.lîş
بەڵام	.be.łam
رێنووسگۆڕاوەکان	.rê.nûs.go.řa.we.kan
ئێستە	.ʔês.te
مانای	.ma.nay
لەمپەری	.lem.pe.rî
دۆسیەگەلی	.dos.ye.ge.lî
بناغەی	.bi.na.ẍey
بابەتێک	.ba.be.têk
وەزارەتیش	.we.za.re.tîş
ئێرانی	.ʔê.ra.nî
سەردەمی	.ser.de.mî
ڕفیق	.ři.fîq
دەگمەن	.deg.men
حوسێن	.ḧu.sên
فۆلکلۆرەکانەوە	.fol.ki.lo.re.ka.ne.we
دەبرا	.de.bi.ra
چاپکراوەکانیان	.çap.ki.ra.we.kan.yan
عێراقەوە	.ƹê.ra.qe.we
فێستیڤاڵی	.fês.tî.va.łî
نادەنێ	.na.de.nê
لەچاپدانی	.le.çap.da.nî
ییتس	.yî.tis
چەکم	.çe.kim
ئەردۆن	.ʔer.don
هونەری	.hu.ne.rî
پۆل	.pol
پەشێو	.pe.şêw
بووم	.bûm
سکرتێری	.si.kir.tê.rî
شوبات	.şu.bat
لێیە	.lê.ye
کارەکان	.ka.re.kan
بزاڤی	.bi.za.vî
فرۆشەکە	.fi.ro.şe.ke
پێشخستنی	.pêş.xis.ti.nî
ئەندامەکانی	.ʔen.da.me.ka.nî
نزیکەوە	.ni.zî.ke.we
بەردەوامن	.ber.de.wa.min
ئاوێزە	.ʔa.wê.ze
چاوەڕێ	.ça.we.řê
لەئاست	.le.ʔast
دواخستنی	.dwa.xis.ti.nî
پێویستن	.pê.wîs.tin
دۆزینەوەی	.do.zî.ne.wey
ئەوەبوو	.ʔe.we.bû
نەژاد	.ne.jad
ڕۆشنبیری	.řo.şin.bî.rî
بیت	.bît
مۆسیقا	.mo.sî.qa
ئەهلی	.ʔeh.lî
دەستیان	.dest.yan
ڕاهێنەری	.řa.hê.ne.rî
سووژن	.sû.jin
یەکیەتی	.yek.ye.tî
پەیوەندیدا	.pey.wen.dî.da
بەشدارانە	.beş.da.ra.ne
جارێ	.ca.rê
کۆمەڵگەی	.ko.meł.gey
لیکۆڵینەوەیەک	.lî.ko.łî.ne.we.yek
ژێرخانی	.jêr.xa.nî
جۆراوجۆری	.co.raw.co.rî
توانای	.twa.nay
بانگهێشتنامەی	.bang.hêşt.na.mey
لەچاپدراوەکان	.le.çap.di.ra.we.kan
ئاڵای	.ʔa.łay
ڕۆژنامەنوس	.řoj.na.me.nus
خزمەکانیان	.xiz.me.kan.yan
رووناکبیرێک	.rû.nak.bî.rêk
سەرکەوتوو	.ser.kew.tû
منداڵی	.min.da.łî
لینکەی	.lîn.key
دەکردنەوە	.de.kir.di.ne.we
چەمکە	.çem.ke
نووسراونەتەوە	.nûs.raw.ne.te.we
هەوڵێک	.hew.łêk
زۆرکارییەوە	.zor.ka.rî.ye.we
منداڵە	.min.da.łe
پێشووەکان	.pê.şu.we.kan
سێرت	.sêrt
بەعسی	.beƹ.sî
لی	.lî
رێکخراون	.rêk.xi.ra.win
بریتیە	.bi.rît.ye
یەکگرتووی	.yek.gir.tûy
پێکرد	.pê.kird
نەتەوەپەرستی	.ne.te.we.pe.ris.tî
عێراقییە	.ƹê.ra.qî.ye
نایاسایییەکانەوە	.na.ya.sa.yî.ye.ka.ne.we
بڕوانامەی	.biř.wa.na.mey
پێویستیان	.pê.wîst.yan
نووسەرانێک	.nû.se.ra.nêk
پڕۆژەیەکی	.pi.řo.je.ye.kî
حەمید	.ḧe.mîd
هاوڕێی	.haw.řêy
لابردران	.la.bir.di.ran
گۆی	.goy
لەڤین	.le.vîn
وەکوو	.we.kû
نێوکۆڵانەکاندا	.nêw.ko.ła.ne.kan.da
عەزیز	.ƹe.zîz
پرسیارێکی	.pirs.ya.rê.kî
کلۆبەکان	.ki.lo.be.kan
بەغدا	.beẍ.da
کاغەزی	.ka.ẍe.zî
بەچاکی	.be.ça.kî
خاوەن	.xa.wen
جاف	.caf
بکەین	.bi.keyn
ناسرانیان	.nas.ran.yan
بەردەوام	.ber.de.wam
نووسراو	.nûs.raw
کاکە	.ka.ke
گوزەرانی	.gu.ze.ra.nî
باڵاخانەی	.ba.ła.xa.ney
ئەندامایەتی	.ʔen.da.ma.ye.tî
لا	.la
ڤورال	.vu.ral
پەڕانپەڕی	.pe.řan.pe.řî
وام	.wam
کوردیی	.kur.dîy
کووتاڵەکان	.kû.ta.łe.kan
هێز	.hêz
تێکۆشین	.tê.ko.şîn
بایز	.ba.yiz
دەوروپشتیان	.dew.ru.pişt.yan
رەفەکانەوە	.re.fe.ka.ne.we
لەدەستی	.le.des.tî
تەلڤیزیۆنی	.tel.vîz.yo.nî
رەنگییەکانیش	.ren.gî.ye.ka.nîş
داخستین	.da.xis.tîn
ئاسوودەتر	.ʔa.sû.de.tir
لێوە	.lê.we
حیزبەکانی	.ḧîz.be.ka.nî
ئەمریکا	.ʔem.rî.ka
ئەژمارێکی	.ʔej.ma.rê.kî
گوزارشت	.gu.za.rişt
گەرەکمان	.ge.rek.man
بەریان	.ber.yan
رێکخراوەکەیان	.rêk.xi.ra.we.ke.yan
فەرمانبەرانی	.fer.man.be.ra.nî
پارێزەر	.pa.rê.zer
پۆلیسەکان	.po.lî.se.kan
کشانەوە	.ki.şa.ne.we
جیهانیدا	.cî.ha.nî.da
کۆنە	.ko.ne
دەنێرێ	.de.nê.rê
ڕۆژانی	.řo.ja.nî
لەمپەرەکان	.lem.pe.re.kan
قامشلۆوە	.qa.miş.lo.we
هتد	.hi.tid
ئاکاری	.ʔa.ka.rî
ڕاستی	.řas.tî
قسەی	.qi.sey
بدینمەوە	.bi.dîn.me.we
لەمانە	.le.ma.ne
هۆزەکان	.ho.ze.kan
نامەی	.na.mey
ئاگای	.ʔa.gay
باجەکان	.ba.ce.kan
ژیانێکی	.jya.nê.kî
دەهاویشتنە	.de.ha.wîş.ti.ne
لاوی	.la.wî
گوندی	.gun.dî
جێبەجێکردنی	.cê.be.cê.kir.di.nî
کرێکاران	.ki.rê.ka.ran
رووپەڕەکانی	.rû.pe.ře.ka.nî
پەنابەران	.pe.na.be.ran
تەلەفۆن	.te.le.fon
دووبەڵا	.dû.be.ła
هەریەکە	.her.ye.ke
پشکی	.piş.kî
بونی	.bu.nî
داگیرکردبوون	.da.gîr.kir.di.bûn
گۆڕانکاری	.go.řan.ka.rî
خاوەنێکی	.xa.we.nê.kî
شارەکانیش	.şa.re.ka.nîş
دابمەزرێندرێ	.da.bi.mez.rên.di.rê
موکریانی	.mu.ki.rya.nî
زۆرترە	.zor.ti.re
دێ	.dê
سن	.sin
قاسملوو	.qa.sim.lû
نوێنەرایەتی	.nwê.ne.ra.ye.tî
رەخنە	.rex.ne
مامۆستاکانیانەوە	.ma.mos.ta.kan.ya.ne.we
گوشار	.gu.şar
خێزانەکەم	.xê.za.ne.kem
ڕەشید	.ře.şîd
نموونەگەلێک	.ni.mû.ne.ge.lêk
پتەوکردنی	.pi.tew.kir.di.nî
سەرکردەکانی	.ser.kir.de.ka.nî
زاخۆ	.za.xo
جیهاندا	.cî.han.da
تواناکانی	.twa.na.ka.nî
دەرکەوێ	.der.ke.wê
کوردم	.kur.dim
لەپێش	.le.pêş
بۆچوونەکانیان	.bo.çû.ne.kan.yan
سەردان	.ser.dan
وەرە	.we.re
کۆن	.kon
پەرلەماندا	.per.le.man.da
بۆنەوە	.bo.ne.we
بزاڤدا	.bi.zav.da
نەهێنراوە	.ne.hên.ra.we
پێشی	.pê.şî
کوردیخوێن	.kur.dî.xwên
کتێبخانەکانیشدا	.ki.têb.xa.ne.ka.nîş.da
موسڵمانان	.mu.sił.ma.nan]
دەبین	.de.bîn
خۆیاندا	.xo.yan.da
نێزیکەی	.nê.zî.key
هەندەران	.hen.de.ran
دیاریکراو	.dya.rî.ki.raw
لەوێدا	.le.wê.da
ئامادەکاریگەلێکی	.ʔa.ma.de.ka.rî.ge.lê.kî
داگیرکرد	.da.gîr.kird
گوێم	.gwêm
خەوی	.xe.wî
بۆتانەوە	.bo.ta.ne.we
ڕابردوودا	.řa.bir.dû.da
کۆمێنتی	.ko.mên.tî
نهێنییانەیە	.ni.hê.nî.ya.ne.ye
سوورەکەی	.sû.re.key
نابێتە	.na.bê.te
دادگایی	.dad.ga.yî
خاوەنداریی	.xa.wen.da.rîy
لەوەدا	.le.we.da
ئامادەکاری	.ʔa.ma.de.ka.rî
ماوەیەکی	.ma.we.ye.kî
ئەدەن	.ʔe.den
گوتراوە	.gut.ra.we
ناوچەیەک	.naw.çe.yek
درۆشمێکی	.di.roş.mê.kî
دیالۆگ	.dya.log
بڵاوکرانی	.bi.ław.ki.ra.nî
وێژەی	.wê.jey
تازەکاندا	.ta.ze.kan.da
وڵاتی	.wi.ła.tî
ناتوانیت	.na.twa.nît
درووست	.di.rûst
ئارەزوو	.ʔa.re.zû
دەقی	.de.qî
شاهانە	.şa.ha.ne
بەرێوەبەری	.be.rê.we.be.rî
نیۆیۆرک	.nyo.york
چەکی	.çe.kî
کۆمەڵایەتیی	.ko.me.ła.ye.tîy
یاساوە	.ya.sa.we
جی	.cî
هاوینی	.ha.wî.nî
مەلی	.me.lî
خاتوو	.xa.tû
خۆزگە	.xoz.ge
نووسەریشن	.nû.se.rî.şin
گەیشتنی	.geyş.ti.nî
سەرانی	.se.ra.nî
دەربڕین	.der.bi.řîn
ناشێ	.na.şê
دیاردە	.dyar.de
لێیان	.lê.yan
خەباتگێڕیی	.xe.bat.gê.řîy
فەڕەنسییەکانیش	.fe.řen.sî.ye.ka.nîş
ئاکامی	.ʔa.ka.mî
رێنووس	.rê.nûs
گۆڤارەکان	.go.va.re.kan
گەنجە	.gen.ce
دەی	.dey
لەچاپدەدەن	.le.çap.de.den
دانوستان	.da.nus.tan
تاکەکانی	.ta.ke.ka.nî
خانوو	.xa.nû
هەنگاوێکی	.hen.ga.wê.kî
کتێبخانەی	.ki.têb.xa.ney
دەیسپێرن	.dey.si.pê.rin
دەسووتاندن	.de.sû.tan.din
فرات	.fi.rat
تر	.tir
فرۆشییەکاندا	.fi.ro.şî.ye.kan.da
گرەگەزێک	.gi.re.ge.zêk
حاڵەت	.ḧa.łet
بۆردومان	.bor.du.man
وەربگیردرێت	.wer.bi.gîr.di.rêt
بڵاوکراو	.bi.ław.ki.raw
نووسراوەکانیانەوە	.nûs.ra.we.kan.ya.ne.we
کۆچاندنە	.ko.çan.di.ne
عەین	.ƹeyn
حەستەمەشدا	.ḧes.te.meş.da
ولاتی	.wi.la.tî
شەوە	.şe.we
ئەرمەنستاندا	.ʔer.me.nis.tan.da
هێرشبەری	.hê.riş.be.rî
تۆفیق	.to.fîq
نڤیسیارەکان	.ni.vîs.ya.re.kan
دانیشووانی	.da.nî.şu.wa.nî
شوێنی	.şwê.nî
عوسمانیدا	.ƹus.ma.nî.da
شانازییە	.şa.na.zî.ye
رۆژا	.ro.ja
گوندەکانەوە	.gun.de.ka.ne.we
تێپەڕ	.tê.peř
بووەوە	.bu.we.we
ئەشکەنجەیان	.ʔeş.ken.ce.yan
نێوخۆیی	.nêw.xo.yî
پێناوی	.pê.na.wî
شەخسی	.şex.sî
ڕەخنەی	.řex.ney
کێشەگەلێکی	.kê.şe.ge.lê.kî
بڵاوکردنەوە	.bi.ław.kir.di.ne.we
سەرنجی	.se.rin.cî
دووەمین	.du.we.mîn
هەڵسەنگێنێ	.heł.sen.gê.nê
شتە	.şi.te
یۆنانییەکان	.yo.na.nî.ye.kan
وایکرد	.way.kird
نایاساییی	.na.ya.sa.yîy
ماددە	.mad.de
راڤە	.ra.ve
مەرگی	.mer.gî
پڕە	.pi.ře
تێرمینۆلۆژیکی	.têr.mî.no.lo.jî.kî
دەنیز	.de.nîz
زیادکردنی	.zyad.kir.di.nî
تەلەڤیزیۆنییەکانی	.te.le.vîz.yo.nî.ye.ka.nî
ئینتەرنێت	.ʔîn.ter.nêt
دیاربەکریش	.dyar.be.ki.rîş
هەواڵی	.he.wa.łî
عەفرینێ	.ƹef.rî.nê
کتێبانە	.ki.tê.ba.ne
جیاکردنەوەی	.cya.kir.di.ne.wey
واز	.waz
بکەن	.bi.ken
مێژووە	.mê.ju.we
ئاوای	.ʔa.way
دەڤەری	.de.ve.rî
کەسیان	.kes.yan
بوونەتەوە	.bû.ne.te.we
بەڕێوەدەچوون	.be.řê.we.de.çûn
بردە	.bir.de
گوتران	.gut.ran
هەستان	.hes.tan
نەکردووە	.ne.kir.du.we
خۆراک	.xo.rak
ئیداری	.ʔî.da.rî
خولە	.xu.le
فرۆشراون	.fi.roş.ra.win
لێرە	.lê.re
ڕوویان	.řû.yan
ئامادەیی	.ʔa.ma.de.yî
سەرچاوەیە	.ser.ça.we.ye
نێزیکی	.nê.zî.kî
ئامریکا	.ʔam.rî.ka
خالید	.xa.lîd
هەڵبژاردنە	.heł.bi.jar.di.ne
هەڵمەت	.heł.met
خەڵاتەکان	.xe.ła.te.kan
ئاراستە	.ʔa.ras.te
بڵاویکردۆتەوە	.bi.ła.wî.kir.do.te.we
بەدەست	.be.dest
ئەمنیش	.ʔe.mi.nîş
کردووین	.kir.dûyn
لەمیانی	.lem.ya.nî
گوندانەوە	.gun.da.ne.we
ئەشکەنجەش	.ʔeş.ken.ceş
داڕشتنی	.da.řiş.ti.nî
ئەژمارەکانی	.ʔej.ma.re.ka.nî
شێوازانی	.şê.wa.za.nî
ساڵانی	.sa.ła.nî
کشتوکاڵی	.kiş.tu.ka.łî
شتی	.şi.tî
سوڵتان	.suł.tan
ئەوانی	.ʔe.wa.nî
فەرهەنگەکانی	.fer.hen.ge.ka.nî
سامانە	.sa.ma.ne
شەیتان	.şey.tan
سینەمای	.sî.ne.may
هەڤاڵ	.he.vał
راگەیەندراوە	.ra.ge.yen.di.ra.we
پێنووس	.pê.nûs
کوردییەوە	.kur.dî.ye.we
تورکی	.tur.kî
هاندانی	.han.da.nî
سەختی	.sex.tî
سەرکەوت	.ser.kewt
ماڵپەڕەکانیش	.mał.pe.ře.ka.nîş
نیشانەکانی	.nî.şa.ne.ka.nî
چاپکردنیدا	.çap.kir.di.nî.da
پیشان	.pî.şan
دەمێک	.de.mêk
هێزێکی	.hê.zê.kî
پێگەیەکی	.pê.ge.ye.kî
ناسرا	.nas.ra
چەڵەمە	.çe.łe.me
پزیشکی	.pi.zîş.kî
دەفرۆشێ	.def.ro.şê
گۆرانیی	.go.ra.nîy
باسکردنی	.bas.kir.di.nî
سوود	.sûd
هاودەنگیی	.haw.den.gîy
دەیانهەوێت	.de.yan.he.wêt
ئەدا	.ʔe.da
لای	.lay
ئیسلامدا	.ʔîs.lam.da
ببووە	.bi.bu.we
گۆڕانکارییەکی	.go.řan.ka.rî.ye.kî
کربوون	.kir.bûn
ڕەسەنی	.ře.se.nî
بەفر	.be.fir
نەدەدا	.ne.de.da
گرتە	.gir.te
بەرزە	.ber.ze
وێژەدا	.wê.je.da
لابردنی	.la.bir.di.nî
لەهەموو	.le.he.mû
یاد	.yad
دواییەی	.dway.yey
بەندێکی	.ben.dê.kî
ڕوانگەی	.řwan.gey
فرۆشیان	.fi.roş.yan
لویس	.lwîs
تە	.te
شانۆیەک	.şa.no.yek
نووسەرەکانیان	.nû.se.re.kan.yan
کردوونەتەوە	.kir.dû.ne.te.we
بارگواستنەوە	.bar.gwas.ti.ne.we
بتوانێ	.bit.wa.nê,.bi.twa.nê
کایەوە	.ka.ye.we
پارتییە	.par.tî.ye
کورمێنج	.kur.mênc
تێرۆریزمەوە	.tê.ro.rîz.me.we
پاکی	.pa.kî
کورتەپێداچوونەوەیەک	.kur.te.pê.da.çû.ne.we.yek
نێومان	.nêw.man
بوارەدا	.bwa.re.da
تەرخان	.ter.xan
بابەکان	.ba.be.kan
سەردەم	.ser.dem
بریتانیا	.bi.rî.tan.ya
هاوشێوەی	.haw.şê.wey
قەدیس	.qe.dîs
وێنەگری	.wê.ne.gi.rî
کۆچیان	.koç.yan
یەکسان	.yek.san
ستێرمان	.si.têr.man
دەشزانن	.deş.za.nin
یەکێکە	.ye.kê.ke
باڵەک	.ba.łek
فراوانتر	.fi.ra.wan.tir
کان	.kan
پیر	.pîr
پیشەی	.pî.şey
نووسەرێکی	.nû.se.rê.kî
بتوانم	.bit.wa.nim,.bi.twa.nim
کراوە	.ki.ra.we
راماونەتەوە	.ra.maw.ne.te.we
ملکەچی	.mil.ke.çî
بۆسەر	.bo.ser
سەرێ	.se.rê
کرابوو	.ki.ra.bû
لەبارەی	.le.ba.rey
فارسییەوە	.far.sî.ye.we
گەشەپێدانی	.ge.şe.pê.da.nî
داڕێژەری	.da.řê.je.rî
بایەختر	.ba.yex.tir
زانیاری	.zan.ya.rî
حاکم	.ḧa.kim
خولی	.xu.lî
ناوەکانی	.na.we.ka.nî
تەمەنی	.te.me.nî
نوێژ	.nwêj
زیاتر	.zya.tir
خوا	.xwa
ڕۆژنامەنووسی	.řoj.na.me.nû.sî
دابەزینی	.da.be.zî.nî
دەکات	.de.kat
سلێمانی	.si.lê.ma.nî
ترساون	.tir.sa.win
دەرەوەی	.de.re.wey
کتێبخانەکان	.ki.têb.xa.ne.kan
خود	.xud
کارکردنی	.kar.kir.di.nî
قاعیدە	.qa.ƹî.de
نێوەوە	.nê.we.we
سەرۆکایەتی	.se.ro.ka.ye.tî
ناوخۆیی	.naw.xo.yî
ناکاو	.na.kaw
دووگۆلی	.dû.go.lî
بدلیس	.bid.lîs
کارانە	.ka.ra.ne
هەریەکەیان	.her.ye.ke.yan
حاڵەتێکی	.ḧa.łe.tê.kî
باسیان	.bas.yan
نووسەرێک	.nû.se.rêk
خستۆتە	.xis.to.te
دران	.di.ran
تورکییان	.tur.kî.yan
کتێبخانەکانی	.ki.têb.xa.ne.ka.nî
شەوێک	.şe.wêk
پرسێکی	.pir.sê.kî
دۆزراوەکانم	.doz.ra.we.ka.nim
ڕووباری	.řû.ba.rî
بەڕێ	.be.řê
وان	.wan
هەندەرانیشدا	.hen.de.ra.nîş.da
تۆمارەکانی	.to.ma.re.ka.nî
دەسەڵاتداران	.de.se.łat.da.ran
توانیویەتی	.twa.nîw.ye.tî
جیاوازە	.cya.wa.ze
ناساند	.na.sand
بزووتنەوەی	.bi.zût.ne.wey
نووسیبوو	.nû.sî.bû
پێگەی	.pê.gey
کردەوەیەک	.kir.de.we.yek
چەتوونە	.çe.tû.ne
زووبەزوو	.zû.be.zû
منداڵەکە	.min.da.łe.ke
هاوڕێیەکانی	.haw.řê.ye.ka.nî
هاواری	.ha.wa.rî
بێژین	.bê.jîn
یان	.yan
بەناوبانگی	.be.naw.ban.gî
چاپدانیان	.çap.dan.yan
سەرنج	.se.rinc
ئاساییی	.ʔa.sa.yîy
یاساگۆڕێنەکە	.ya.sa.go.řê.ne.ke
کەندوقووڵ	.ken.du.qûł
حکوومەتیدا	.ḧi.kû.me.tî.da
سازکردنی	.saz.kir.di.nî
ناوەندەکانی	.na.wen.de.ka.nî
هەروا	.her.wa
ماڵەکاندا	.ma.łe.kan.da
بەرخۆدانی	.ber.xo.da.nî
دەوڵەتانی	.dew.łe.ta.nî
سەرسووڕییانە	.ser.sû.řî.ya.ne
شۆرش	.şo.riş
رەپێیان	.re.pê.yan
رێنووسانی	.rê.nû.sa.nî
جیهانە	.cî.ha.ne
بەراستی	.be.ras.tî
رۆژێ	.ro.jê
چۆنیەتی	.çon.ye.tî
هەڵوەشێندبایەوە	.heł.we.şên.di.ba.ye.we
پێگە	.pê.ge
مووش	.mûş
کۆنترۆڵی	.kon.ti.ro.łî
کۆسپانەدایە	.kos.pa.ne.da.ye
پێکهێنا	.pêk.hê.na
رێژەی	.rê.jey
نهێنین	.ni.hê.nîn
دەستپێکردنی	.dest.pê.kird.nî
چاپخانەکە	.çap.xa.ne.ke
بەختەوەری	.bex.te.we.rî
وڵاتەی	.wi.ła.tey
ژێرچەپۆکەکانیش	.jêr.çe.po.ke.ka.nîş
ئیمپراتۆری	.ʔîm.pi.ra.to.rî
گۆڤارەی	.go.va.rey
چکۆلە	.çi.ko.le
لاپەڕەی	.la.pe.řey
بکەم	.bi.kem
رێکخرانەوە	.rêk.xi.ra.ne.we
بردەوە	.bir.de.we
گرێبەستی	.gi.rê.bes.tî
سدیق	.si.dîq
شەڕی	.şe.řî
گوتەبێژی	.gu.te.bê.jî
ڕێی	.řêy
زووانە	.zu.wa.ne
رێکدەخرێن	.rêk.dex.rên
کتێبفرۆشییانە	.ki.têb.fi.ro.şî.ya.ne
دیوی	.dî.wî
پەلەی	.pe.ley
کی	.kî
بچووکی	.bi.çû.kî
بانگەشەی	.ban.ge.şey
دەتوانرێ	.de.twan.rê
بەس	.bes
هاتۆتە	.ha.to.te
ساز	.saz
سێڤر	.sê.vir
بەڕێوەدەچوو	.be.řê.we.de.çû
گۆڤارێک	.go.va.rêk
یاریزان	.ya.rî.zan
سیاسەتدا	.sya.set.da
پێویستی	.pê.wîs.tî
گەورەکانی	.gew.re.ka.nî
لێدەکەوێتەوە	.lê.de.ke.wê.te.we
زگیان	.zig.yan
ئەژمارەدا	.ʔej.ma.re.da
هەستم	.hes.tim
نەریتی	.ne.rî.tî
لەچاپدەرانێکیش	.le.çap.de.ra.nê.kîş
ویلیام	.wîl.yam
ناردران	.nar.di.ran
ڕۆژئاوای	.řoj.ʔa.way
ناڕەوای	.na.ře.way
ناتوانم	.na.twa.nim
خاڵ	.xał
هەردوولا	.her.dû.la
سوورییەکان	.sû.rî.ye.kan
دامەزرا	.da.mez.ra
ئەژمارانە	.ʔej.ma.ra.ne
عەفریندا	.ƹef.rîn.da
مووچە	.mû.çe
سنوری	.si.nu.rî
می	.mî
کەڵکیان	.kełk.yan
کاروباری	.ka.ru.ba.rî
شنگال	.şin.gal
بودجەی	.bud.cey
ڕادەستی	.řa.des.tî
گەمارۆی	.ge.ma.roy
گوتوویانە	.gu.tû.ya.ne
ڕەسەن	.ře.sen
گەورەیە	.gew.re.ye
لیۆنێل	.lyo.nêl
بدرێت	.bi.di.rêt,.bid.rêt
سەدی	.se.dî
ڕووسیا	.řûs.ya
بابە	.ba.be
بەهێزی	.be.hê.zî
رۆژنامەیەکی	.roj.na.me.ye.kî
لەدایک	.le.dayk
شێوەکاری	.şê.we.ka.rî
شاعیران	.şa.ƹî.ran
شێرپەنجە	.şêr.pen.ce
ناموسڵمانەکان	.na.mu.sił.ma.ne.kan
کابرای	.kab.ray
دێت	.dêt
سیاسییە	.sya.sî.ye
دەیاننووسی	.de.yan.nû.sî
شیکردنەوەی	.şî.kir.di.ne.wey
کارەکانی	.ka.re.ka.nî
ناوەندێکی	.na.wen.dê.kî
دەبینرێ	.de.bîn.rê
دەچێت	.de.çêt
شکست	.şi.kist
حاڵەتە	.ḧa.łe.te
ژنە	.ji.ne
کتێبانەیان	.ki.tê.ba.ne.yan
ژێرچاودێریی	.jêr.çaw.dê.rîy
قەرس	.qers
بڕیارە	.biř.ya.re
میدیاکان	.mîd.ya.kan
دەهاتن	.de.ha.tin
کەڕەتان	.ke.ře.tan
نەکرێت	.ne.ki.rêt
شا	.şa
بەکارهێندرابوون	.be.kar.hên.di.ra.bûn
دامرکاندنی	.da.mir.kan.di.nî
ناهێننەوە	.na.hê.ni.ne.we
ئێزدی	.ʔêz.dî
خزمەتگوزارییەکانی	.xiz.met.gu.za.rî.ye.ka.nî
ئاگادارییان	.ʔa.ga.da.rî.yan
خودا	.xu.da
بەناوی	.be.na.wî
ئەمرۆ	.ʔem.ro
دادەنرێت	.da.de.ni.rêt
هەڵبژاردنی	.heł.bi.jar.di.nî
جینۆساید	.cî.no.sayd
رێنووسە	.rê.nû.se
ستەمبۆڵێ	.si.tem.bo.łê
پێشگرییان	.pêş.gi.rî.yan
نووسەرەوە	.nû.se.re.we
دەزگایەکی	.dez.ga.ye.kî
ئەرتشییە	.ʔer.ti.şî.ye
دوا	.dwa
مەیدان	.mey.dan
نووسەرانیشی	.nû.se.ra.nî.şî
توندی	.tun.dî
نێوانەم	.nê.wa.nem
لایەنێک	.la.ye.nêk
دەیانوێرا	.de.yan.wê.ra
چەکە	.çe.ke
هەڕەتەشدا	.he.ře.teş.da
ئێراق	.ʔê.raq
چیتر	.çî.tir
دامەزراندنی	.da.mez.ran.di.nî
ڕۆژنامەگەری	.řoj.na.me.ge.rî
دەورێکی	.dew.rê.kî
رابردوودا	.ra.bir.dû.da
کۆنترۆڵکردنی	.kon.ti.roł.kir.di.nî
وێنەکان	.wê.ne.kan
دوان	.dwan
ئوڤاجک	.ʔu.vack
هەناردە	.he.nar.de
گەڕایەوە	.ge.řa.ye.we
کوژراوە	.kuj.ra.we
سەرچاوکە	.ser.çaw.ke
پیری	.pî.rî
فەتەر	.fe.ter
جەوهەری	.cew.he.rî
بێجگە	.bêc.ge
هونەر	.hu.ner
جوانە	.cwa.ne
بازنەی	.baz.ney
نەکراوەتەوە	.ne.ki.ra.we.te.we
پیشەیەک	.pî.şe.yek
ئاوەدانی	.ʔa.we.da.nî
فرۆشراوە	.fi.roş.ra.we
لێکبڕابێتن	.lêk.bi.řa.bê.tin
یانەکەی	.ya.ne.key
کۆچ	.koç
دوازدە	.dwaz.de
بوون	.bûn
حوسێنی	.ḧu.sê.nî
دەدەین	.de.deyn
یەکلایی	.yek.la.yî
کتێبەکەش	.ki.tê.be.keş
لەکار	.le.kar
بازرگانەکانیشەوە	.ba.zir.ga.ne.ka.nî.şe.we
گۆڕاندایە	.go.řan.da.ye
دووهەمدا	.dû.hem.da
ڕادیۆی	.řad.yoy
مێژوودا	.mê.jû.da
مرۆڤایەتی	.mi.ro.va.ye.tî
ئامادەبوون	.ʔa.ma.de.bûn
بەهۆیەوە	.be.ho.ye.we
بازاڕەکانی	.ba.za.ře.ka.nî
سووریا	.sûr.ya
چاو	.çaw
ئەوانەدا	.ʔe.wa.ne.da
ڕاپۆرتەکە	.řa.por.te.ke
باڵبەستیان	.bał.best.yan
دیاریکردنی	.dya.rî.kir.di.nî
ئەرکێکی	.ʔer.kê.kî
نایاسایییانە	.na.ya.sa.yî.ya.ne
رێیان	.rê.yan
هونەرمەندان	.hu.ner.men.dan
بەخۆڕایی	.be.xo.řa.yî
دەوری	.dew.rî
چاوم	.ça.wim
کردە	.kir.de
سەرجەمدا	.ser.cem.da
بەرهەمەکانیان	.ber.he.me.kan.yan
سوننە	.sun.ne
بازاڕی	.ba.za.řî
زمان	.zi.man
ئۆکرانیا	.ʔok.ran.ya
بەرچاو	.ber.çaw
دابەزاندووە	.da.be.zan.du.we
راگەیەندراوەکانی	.ra.ge.yen.di.ra.we.ka.nî
یەکتری	.yek.ti.rî
سی	.sî
دابێ	.da.bê
زۆرکاری	.zor.ka.rî
قوتابیان	.qu.tab.yan
عێراقیان	.ƹê.raq.yan
یارییە	.ya.rî.ye
ئەنجامێکی	.ʔen.ca.mê.kî
کێوین	.kê.wîn
کرێکارەکانی	.ki.rê.ka.re.ka.nî
دوورلەبڕوای	.dûr.le.biř.way
سکەنێرێکیان	.si.ke.nê.rêk.yan
هیندوو	.hîn.dû
نازانین	.na.za.nîn
پەرەبستێنێ	.pe.re.bis.tê.nê
کارهێنراون	.kar.hên.ra.win
نەخۆشی	.ne.xo.şî
ڕێنمایی	.řê.ni.ma.yî
دەبردە	.de.bir.de
دەرهێنەر	.der.hê.ner
میر	.mîr
نەدات	.ne.dat
ڕەگەزی	.ře.ge.zî
حکوومەت	.ḧi.kû.met
ماوەیەکە	.ma.we.ye.ke
ئەرمەنییەکان	.ʔer.me.nî.ye.kan
خۆ	.xo
دابوون	.da.bûn
ئەواندایە	.ʔe.wan.da.ye
تەماشا	.te.ma.şa
مەتر	.me.tir
منداڵانی	.min.da.ła.nî
لێم	.lêm
ئافرەت	.ʔaf.ret
سادە	.sa.de
بیرماندا	.bîr.man.da
رۆژهەڵاتی	.roj.he.ła.tî
لەنێوان	.le.nê.wan
خدر	.xi.dir
چارەدیتنەوەیەکی	.ça.re.dî.ti.ne.we.ye.kî
زانستییەکاندا	.za.nis.tî.ye.kan.da
دیکەیان	.dî.ke.yan
ژیاننامەکەی	.jyan.na.me.key
ئاماژەیان	.ʔa.ma.je.yan
پێویست	.pê.wîst
وتاری	.wi.ta.rî
فوئاد	.fu.ʔad
دادگای	.dad.gay
پۆستەری	.pos.te.rî
پەڕ	.peř
هەبوونی	.he.bû.nî
ڕێ	.řê
هەڵسوکەوت	.heł.su.kewt
داود	.da.wid
لەماوەی	.le.ma.wey
شێوەی	.şê.wey
چاپکراویان	.çap.ki.raw.yan
کرابێت	.ki.ra.bêt
کوردستانێڕا	.kur.dis.ta.nê.řa
وەزیر	.we.zîr
چەندە	.çen.de
گورزەک	.gur.zek
هەڵوەشاند	.heł.we.şand
پێشکەوتووییی	.pêş.kew.tû.yîy
ماڵەکانیشدا	.ma.łe.ka.nîş.da
راگەیاند	.ra.ge.yand
ناسراو	.nas.raw
ئەوەیە	.ʔe.we.ye
بەهاوکاری	.be.haw.ka.rî
تۆڕی	.to.řî
ناسنامەیەک	.nas.na.me.yek
دانیشتووایەتییان	.da.nîş.tu.wa.ye.tî.yan
خوێندەوە	.xwên.de.we
بردنی	.bir.di.nî
نزیکە	.ni.zî.ke
پەرلەمانتاری	.per.le.man.ta.rî
بەئاشکرا	.be.ʔaş.ki.ra
دواییدا	.dwa.yî.da
یەکشەممە	.yek.şem.me
لێکرد	.lê.kird
زۆرتریش	.zor.ti.rîş
گەل	.gel
کارەی	.ka.rey
گەڕانێکی	.ge.řa.nê.kî
دەستکەوتە	.dest.kew.te
رادەیەک	.ra.de.yek
زۆربەشیان	.zor.beş.yan
تۆرەمەی	.to.re.mey
ڕێژیم	.řê.jîm
داهات	.da.hat
بەشێوەیەکی	.be.şê.we.ye.kî
دۆخی	.do.xî
شکاندنی	.şi.kan.di.nî
بەرگرییەک	.ber.gi.rî.yek
ژیاری	.jya.rî
هێنایەوە	.hê.na.ye.we
وتەکانی	.wi.te.ka.nî
ئەندامێکی	.ʔen.da.mê.kî
بگەن	.bi.gen
دەرفەتی	.der.fe.tî
گولێن	.gu.lên
پەرەپێدانی	.pe.re.pê.da.nî
کتێبەی	.ki.tê.bey
کوردانە	.kur.da.ne
ئەدەبیاتی	.ʔe.deb.ya.tî
خزمەتگۆزارییەکانی	.xiz.met.go.za.rî.ye.ka.nî
وەرگرتنی	.wer.gir.ti.nî
تاوتوێ	.taw.twê
منداڵەکانی	.min.da.łe.ka.nî
وەرگێڕەکانی	.wer.gê.ře.ka.nî
هەواڵگری	.he.wał.gi.rî
کوردستان	.kur.dis.tan
ماڵێکی	.ma.łê.kî
یەکگرتوویی	.yek.gir.tû.yî
بابەتانەی	.ba.be.ta.ney
وازهێنانی	.waz.hê.na.nî
ژاپۆن	.ja.pon
نرخ	.nirx
نەبێ	.ne.bê
خەڵات	.xe.łat
هاووڵاتییانی	.haw.wi.ła.tî.ya.nî
دەرووی	.de.rûy
هەستەکان	.hes.te.kan
دڵە	.di.łe
داگیر	.da.gîr
یانەیە	.ya.ne.ye
شی	.şî
تی	.tî
چالاکییە	.ça.la.kî.ye
پەیوەندییەکان	.pey.wen.dî.ye.kan
کوردی	.kur.dî
سێشەممە	.sê.şem.me
بهێنن	.bi.hê.nin
گیان	.gyan
خەڵکێکی	.xeł.kê.kî
ئابی	.ʔa.bî
ئەویش	.ʔe.wîş
نادرێ	.na.di.rê
ڕێکخراوە	.řêk.xi.ra.we
کارەکانیان	.ka.re.kan.yan
گەشەی	.ge.şey
ڕایگەیاند	.řay.ge.yand
جارجاریش	.car.ca.rîş
ڕۆحانی	.řo.ḧa.nî
بڕیاری	.biř.ya.rî
بۆی	.boy
کران	.ki.ran
خەباتگێڕە	.xe.bat.gê.ře
جیا	.cya
ئەوتۆ	.ʔew.to
سەردەشت	.ser.deşt
کارگێڕی	.kar.gê.řî
دراوەوە	.di.ra.we.we
رێکبخا	.rêk.bi.xa
سیریلیکەوە	.sî.rî.lî.ke.we
دەزگاکانی	.dez.ga.ka.nî
هیوادارین	.hî.wa.da.rîn
وڵاتانە	.wi.ła.ta.ne
شەنگال	.şen.gal
کردن	.kir.din
سەربەخۆیییەکی	.ser.be.xo.yî.ye.kî
ژنێکی	.ji.nê.kî
شەقام	.şe.qam
نەتەوەخوازییە	.ne.te.we.xwa.zî.ye
لەچاپدەدرێن	.le.çap.ded.rên
بڵاوکردنەوەدایە	.bi.ław.kir.di.ne.we.da.ye
قووڵ	.qûł
دەشێت	.de.şêt
کەوت	.kewt
بنکەی	.bin.key
بهێڵێتەوە	.bi.hê.łê.te.we
بنیاتنانی	.bin.yat.na.nî
شێوەزارانی	.şê.we.za.ra.nî
دەستنووسە	.dest.nû.se
ئەنجامەکانی	.ʔen.ca.me.ka.nî
چاپەمەنییە	.ça.pe.me.nî.ye
حاڵەتی	.ḧa.łe.tî
نەیاندەتوانی	.ne.yan.det.wa.nî
کێشی	.kê.şî
خەڵاتی	.xe.ła.tî
خامنەیی	.xam.ne.yî
بریار	.bir.yar
ڕاستیدا	.řas.tî.da
ساڵەدا	.sa.łe.da
بەیرووت	.bey.rût
ناوچەیەدا	.naw.çe.ye.da
فشار	.fi.şar
فڕۆکەی	.fi.řo.key
کتێبانێکی	.ki.tê.ba.nê.kî
کاریگەرییەکی	.ka.rî.ge.rî.ye.kî
سەلام	.se.lam
تازەلەچاپدراوەکان	.ta.ze.le.çap.di.ra.we.kan
کەسانێکیش	.ke.sa.nê.kîş
پرسیارانە	.pirs.ya.ra.ne
دەرناخا	.der.na.xa
لەچاپدانە	.le.çap.da.ne
گمگم	.gim.gim
تازەنووسەرەکان	.ta.ze.nû.se.re.kan
ژمارەیەکی	.ji.ma.re.ye.kî
بوارەکە	.bwa.re.ke
بەشدارن	.beş.da.rin
رێکخەرە	.rêk.xe.re
پایە	.pa.ye
پێویستە	.pê.wîs.te
بپارێزێ	.bi.pa.rê.zê
دادگادا	.dad.ga.da
مێشکدا	.mêş.ki.da
ناخۆشی	.na.xo.şî
گەرمیانی	.germ.ya.nî
تاکەکەسی	.ta.ke.ke.sî
نێر	.nêr
سڤیل	.si.vîl
ماڵپەڕێک	.mał.pe.řêk
هەبێت	.he.bêt
ئەورووپاوە	.ʔew.rû.pa.we
وەستان	.wes.tan
پەڕتووکەکەیان	.peř.tû.ke.ke.yan
کەتالۆگێکی	.ke.ta.lo.gê.kî
کرانەوە	.ki.ra.ne.we
کێو	.kêw
خانمە	.xa.ni.me
نەکات	.ne.kat
پێشانگای	.pê.şan.gay
داواخوازیی	.da.wa.xwa.zîy
کاغەز	.ka.ẍez
ڕەنج	.řenc
تایبەتیان	.tay.bet.yan
کۆبوونەوەیەکی	.ko.bû.ne.we.ye.kî
بەڕێوەبەرەکان	.be.řê.we.be.re.kan
ناسراوە	.nas.ra.we
کەلە	.ke.le
گۆڕان	.go.řan
زانستگایەکی	.za.nist.ga.ye.kî
حاستیدا	.ḧas.tî.da
نەهێشتنی	.ne.hêş.ti.nî
نادیار	.na.dyar
دیاردەیە	.dyar.de.ye
ڕێگرتن	.řê.gir.tin
کۆما	.ko.ma
دەستەڵاتی	.des.te.ła.tî
بینراوەکانی	.bîn.ra.we.ka.nî
بەشێکیان	.be.şêk.yan
خوێندگەی	.xwênd.gey
ناردن	.nar.din
هۆیەکانیان	.ho.ye.kan.yan
نووسینگەکەشیدا	.nû.sîn.ge.ke.şî.da
رەوشەن	.rew.şen
هەربۆیە	.her.bo.ye
پێکهاتووە	.pêk.ha.tu.we
گۆل	.gol
وێرای	.wê.ray
هۆییەک	.hoy.yek
رێکبخرێ	.rêk.bix.rê
دیار	.dyar
ڕۆما	.řo.ma
لەڕێگەی	.le.řê.gey
لەکۆڵ	.le.koł
بێگانەکانیشیان	.bê.ga.ne.ka.nîş.yan
چاکە	.ça.ke
هەرکەس	.her.kes
ئاهەنگی	.ʔa.hen.gî
ئەرشیڤی	.ʔer.şî.vî
دەرکرد	.der.kird
پێشکەشکردنی	.pêş.keş.kir.di.nî
دەشیانگوت	.deş.yan.gut
خەڵک	.xełk
مووسا	.mû.sa
کاوە	.ka.we
چی	.çî
هەڵە	.he.łe
لەئاستی	.le.ʔas.tî
چەندان	.çen.dan
ئەلجەواز	.ʔel.ce.waz
ئامادەکردنی	.ʔa.ma.de.kir.di.nî
گەشەپێدان	.ge.şe.pê.dan
شیرین	.şî.rîn
لیرەیی	.lî.re.yî
کتێبفرۆشەکان	.ki.têb.fi.ro.şe.kan
حیزبێک	.ḧîz.bêk
نێزیک	.nê.zîk
باشتر	.baş.tir
ئایین	.ʔa.yîn
ڕەچاوی	.ře.ça.wî
ژمارەیەک	.ji.ma.re.yek
گەرم	.germ
ئەدریش	.ʔed.rîş
لەڕاستیدا	.le.řas.tî.da
کامیل	.ka.mîl
دێرسیم	.dêr.sîm
کاتیشدا	.ka.tîş.da
بار	.bar
سەربازانی	.ser.ba.za.nî
کوردانەی	.kur.da.ney
دەگەرێتەوە	.de.ge.rê.te.we
ناکەم	.na.kem
مەشق	.meşq
سزادرانی	.si.za.di.ra.nî
بەشداریکردن	.beş.da.rî.kir.din
زەوی	.ze.wî
ناوەندیی	.na.wen.dîy
هۆکارێک	.ho.ka.rêk
پارتی	.par.tî
بووژانەوەیە	.bû.ja.ne.we.ye
یەکێکی	.ye.kê.kî
مستەفا	.mis.te.fa
نەیتوانیوە	.ney.twa.nî.we
داواکارییە	.da.wa.ka.rî.ye
مەسعوود	.mes.ƹûd
دامەزرابوون	.da.mez.ra.bûn
ئەندامانی	.ʔen.da.ma.nî
هەڵدەکەوت	.heł.de.kewt
خوێندنەوەکانی	.xwên.di.ne.we.ka.nî
زۆرکارییی	.zor.ka.rî.yî
دەرەبەگانەدا	.de.re.be.ga.ne.da
دەکرایەوە	.de.ki.ra.ye.we
کلاسیک	.ki.la.sîk
نەدراوە	.ne.di.ra.we
رۆژاوا	.ro.ja.wa
بەشێکە	.be.şê.ke
سەیرە	.sey.re
ملیان	.mil.yan
کردبوونەوەی	.kir.di.bû.ne.wey
خوێنەرانی	.xwê.ne.ra.nî
نەماون	.ne.ma.win
نەکرابوو	.ne.ki.ra.bû
تاوانبارکردنی	.ta.wan.bar.kir.di.nî
نایە	.na.ye
ناسێندرابوو	.na.sên.di.ra.bû
نەدیوە	.ne.dî.we
چیایێ	.çya.yê
ئەوەشدا	.ʔe.weş.da
تێگەیشتن	.tê.geyş.tin
بەکارهێنانی	.be.kar.hê.na.nî
ڕۆمان	.řo.man
ئیدی	.ʔî.dî
ئاگاهی	.ʔa.ga.hî
دهۆکێ	.di.ho.kê
فێدراسیۆنی	.fêd.ras.yo.nî
پزیشک	.pi.zîşk
قسەکەرە	.qi.se.ke.re
بیروڕای	.bî.ru.řay
کێشەسازکەرە	.kê.şe.saz.ke.re
قەزای	.qe.zay
مەرسین	.mer.sîn
کێبەرکێی	.kê.ber.kêy
بزاڤەکان	.bi.za.ve.kan
بەندە	.ben.de
میراودەلی	.mî.raw.de.lî
گرفتەکانی	.gi.rif.te.ka.nî
کۆمەڵگەدا	.ko.meł.ge.da
هەڕەشە	.he.ře.şe
هەڕەشەی	.he.ře.şey
دەکەنە	.de.ke.ne
بەرچاوی	.ber.ça.wî
چین	.çîn
ئەنجامە	.ʔen.ca.me
باوکم	.baw.kim
دزەکان	.di.ze.kan
رێکخراوانە	.rêk.xi.ra.wa.ne
شارانەدا	.şa.ra.ne.da
هاوکات	.haw.kat
بریتی	.bi.rî.tî
غازی	.ẍa.zî
گوندە	.gun.de
خەمی	.xe.mî
پێشنیاری	.pêş.nya.rî,[.pêş.nya.rî]
وڵاتەکەیان	.wi.ła.te.ke.yan
بخەینە	.bi.xey.ne
ژیان	.jyan
ڕێزی	.řê.zî
بەدواداچوون	.bed.wa.da.çûn
ئاوریان	.ʔa.wir.yan
شوێن	.şwên
دابمەزرێندرێن	.da.bi.mez.rên.di.rên
مافی	.ma.fî
بکەوێت	.bi.ke.wêt
زەحمەتە	.zeḧ.me.te
لێکۆڵینەوەیەکم	.lê.ko.łî.ne.we.ye.kim
فیدراڵ	.fîd.rał
قازانج	.qa.zanc
براکەی	.bi.ra.key
بیری	.bî.rî
سەپاندنی	.se.pan.di.nî
سنووردار	.si.nûr.dar
کورمانج	.kur.manc
بینینی	.bî.nî.nî
کۆڕەکە	.ko.ře.ke
گەرمی	.ger.mî
گەیشتبا	.geyş.ti.ba
هێزکردنەوەی	.hêz.kir.di.ne.wey
تورکیاوە	.turk.ya.we
پتر	.pi.tir
لەچاپدەرەکانەوە	.le.çap.de.re.ka.ne.we
رێژانە	.rê.ja.ne
هەموومان	.he.mû.man
دەریانخست	.der.yan.xist
ماڵەکەیان	.ma.łe.ke.yan
داهێنان	.da.hê.nan
کۆراندمانەوە	.ko.ran.di.ma.ne.we
زازایی	.za.za.yî
ئایینیی	.ʔa.yî.nîy
میری	.mî.rî
فێرگە	.fêr.ge
دەتاراند	.de.ta.rand
ناویسان	.na.wî.san
بتوانێت	.bi.twa.nêt
ئەستاند	.ʔes.tand
عوسمانیڕا	.ƹus.ma.nî.řa
کەمێک	.ke.mêk
کاریگەریی	.ka.rî.ge.rîy
جۆراوجۆرەوە	.co.raw.co.re.we
نیشانیان	.nî.şan.yan
لایەنی	.la.ye.nî
بەر	.ber
گۆڤارەکەدایە	.go.va.re.ke.da.ye
ڕاستەوخۆ	.řas.tew.xo
رادەیەکی	.ra.de.ye.kî
نوێیەکانی	.nwê.ye.ka.nî
مەرجە	.mer.ce
ڤیدیۆیی	.vîd.yo.yî
چاوە	.ça.we
پێشگرییە	.pêş.gi.rî.ye
سەقز	.se.qiz
یەکەی	.ye.key
بینیمان	.bî.nî.man
شوێنێک	.şwê.nêk
خانەقین	.xa.ne.qîn
پیشەسازی	.pî.şe.sa.zî
ڕێژوان	.řêj.wan
نەمێنێت	.ne.mê.nêt
شەرعی	.şer.ƹî
وەستا	.wes.ta
هەندێک	.hen.dêk
گەلانی	.ge.la.nî
شانۆیە	.şa.no.ye
خانەی	.xa.ney
دەستە	.des.te
تورکییەکانیان	.tur.kî.ye.kan.yan
مێژوویانەی	.mê.jû.ya.ney
دەنگێ	.den.gê
خزمەتگوزاری	.xiz.met.gu.za.rî
خۆبێژ	.xo.bêj
پیاوان	.pya.wan
زارەکی	.za.re.kî
خوێنەران	.xwê.ne.ran
دەهاتە	.de.ha.te
کۆبوونەوەیەدا	.ko.bû.ne.we.ye.da
بداتە	.bi.da.te
هەواڵدەری	.he.wał.de.rî
ساڵاندا	.sa.łan.da
ناوەنجی	.na.wen.cî
دەرئەنجامێکی	.der.ʔen.ca.mê.kî
دیتمەوە	.dît.me.we
سەرکتێبە	.ser.ki.tê.be
پێداویستییەکان	.pê.da.wîs.tî.ye.kan
دابەشکردنی	.da.beş.kir.di.nî
دامڕشتبوو	.dam.řiş.ti.bû
ماکی	.ma.kî
چاپخەگەلە	.çap.xe.ge.le
حەسیچەن	.ḧe.sî.çen
فرۆشرابان	.fi.roş.ra.ban
دەرئەنجامی	.der.ʔen.ca.mî
وەرزی	.wer.zî
ڕاشیگەیاند	.řa.şî.ge.yand
فرمێسک	.fir.mêsk
زمانکوژی	.zi.man.ku.jî
گۆلی	.go.lî
ئاوەڵاوە	.ʔa.we.ła.we
سەرکوت	.ser.kut
هەلبژاردەی	.hel.bi.jar.dey
دەبینێ	.de.bî.nê
کەرەستەی	.ke.res.tey
بەخۆی	.be.xoy
یەکگرتووەکانی	.yek.gir.tu.we.ka.nî
نرخێکی	.nir.xê.kî
فەلسەفەی	.fel.se.fey
بەدوای	.be.dway
بریتانییەکان	.bi.rî.ta.nî.ye.kan
ڕوویدا	.řûy.da
خێراکارانێک	.xê.ra.ka.ra.nêk
نابن	.na.bin
رێپێنەدراویی	.rê.pê.ne.di.ra.wîy
وەرنەگرتووە	.wer.ne.gir.tu.we
دەکرا	.de.ki.ra
ڕێبەرانی	.řê.be.ra.nî
چاوەکانی	.ça.we.ka.nî
داهاتووشدا	.da.ha.tûş.da
پێشانگایەکی	.pê.şan.ga.ye.kî
سوپاسی	.su.pa.sî
نوورەدین	.nû.re.dîn
کۆتاییی	.ko.ta.yîy
بەتایبەت	.be.tay.bet
شۆرشی	.şo.ri.şî
باڵاخانەیەکی	.ba.ła.xa.ne.ye.kî
نەتەوایەتی	.ne.te.wa.ye.tî
چوونکە	.çûn.ke
بەنێوبانگەکان	.be.nêw.ban.ge.kan
ئاستەنگەکان	.ʔas.ten.ge.kan
حوسەین	.ḧu.seyn
ئەسڵانی	.ʔes.ła.nî
بووی	.bûy
خێی	.xêy
دووزمانەکان	.dû.zi.ma.ne.kan
تاوانێک	.ta.wa.nêk
مێژدا	.mêj.da
دانیشتوواندا	.da.nîş.tu.wan.da
وەرگێڕاوانە	.wer.gê.řa.wa.ne
تیۆرییەکی	.tyo.rî.ye.kî
دەیکات	.dey.kat
ئازادی	.ʔa.za.dî
کتێبەکانیان	.ki.tê.be.kan.yan
دەگوترێ	.de.gut.rê
ئەورووپی	.ʔew.rû.pî
شاراوە	.şa.ra.we
بڕیبوون	.bi.řî.bûn
پر	.pir
کورد	.kurd
بڕا	.bi.řa
وڵاتێکی	.wi.ła.tê.kî
قۆناغە	.qo.na.ẍe
دەربەندیخان	.der.ben.dî.xan
دەپرسا	.de.pir.sa
بەمەبەستی	.be.me.bes.tî
ناسینی	.na.sî.nî
دەیویست	.dey.wîst
حافیز	.ḧa.fîz
قەڵەم	.qe.łem
دەردەخات	.der.de.xat
نوێ	.nwê
سەرهێڵ	.ser.hêł
عەرەبیش	.ƹe.re.bîş
لایەنە	.la.ye.ne
بپارێزێت	.bi.pa.rê.zêt
دەریایی	.der.ya.yî
هەڵمەتێکی	.heł.me.tê.kî
سەرەکیی	.se.re.kîy
راوەستێندران	.ra.wes.tên.di.ran
پێزانین	.pê.za.nîn
جێگەی	.cê.gey
بەرگریکردن	.ber.gi.rî.kir.din
باسانە	.ba.sa.ne
بنەمایەکی	.bi.ne.ma.ye.kî
کتێبەکەی	.ki.tê.be.key
قۆڵبەست	.qoł.best
سەردار	.ser.dar
کوژرا	.kuj.ra
سنوورە	.si.nû.re
نوێنەری	.nwê.ne.rî
داواکارییەکیان	.da.wa.ka.rî.yek.yan
بەکار	.be.kar
یاسایییەکان	.ya.sa.yî.ye.kan
رێکخراوە	.rêk.xi.ra.we
ئێرانە	.ʔê.ra.ne
دەستەی	.des.tey
موراد	.mu.rad
عەرەب‌کردنە	.ƹe.reb.kir.di.ne
چاپخانەگەلێکی	.çap.xa.ne.ge.lê.kî
مەلایان	.me.la.yan
کەلتوری	.kel.tu.rî
هەلومەرجانێک	.he.lu.mer.ca.nêk
ویتمن	.wît.min
نەتەوەیەکی	.ne.te.we.ye.kî
بڕبڕەیانە	.biř.bi.ře.ya.ne
خوێندکاریدا	.xwênd.ka.rî.da
رادەوەستێندرێن	.ra.de.wes.tên.di.rên
بەرەوە	.be.re.we
گرنگی	.gi.rin.gî
هەڕۆڵد	.he.řołd
دوایییانەدا	.dwa.yî.ya.ne.da
وەزیران	.we.zî.ran
دڵنیایییەوە	.dił.nya.yî.ye.we
تەندروستی	.ten.di.rus.tî
لەم	.lem
کەسییەکان	.ke.sî.ye.kan
دەستیپێکرد	.des.tî.pê.kird
خوارەوەی	.xwa.re.wey
بەنرخە	.be.nir.xe
ساڵانێک	.sa.ła.nêk
وڵاتەدا	.wi.ła.te.da
سایتی	.say.tî
گەلەکەمان	.ge.le.ke.man
هەرێمی	.he.rê.mî
یەکەوە	.ye.ke.we
دەستەبەر	.des.te.ber
گەڵاڵەکانی	.ge.ła.łe.ka.nî
مارچە	.mar.çe
هەینی	.hey.nî
گەلێ	.ge.lê
شارەزان	.şa.re.zan
زۆرکارییەکانی	.zor.ka.rî.ye.ka.nî
پێشگرییەکان	.pêş.gi.rî.ye.kan
ئیسماعیل	.ʔîs.ma.ƹîl
سیاسییەکانیشدا	.sya.sî.ye.ka.nîş.da
فیستیڤاڵی	.fîs.tî.va.łî
پشتی	.piş.tî
تربەسپی	.tir.be.si.pî
دوولایەنەی	.dû.la.ye.ney
بابان	.ba.ban
بۆکان	.bo.kan
بۆخۆم	.bo.xom
بەدەستهێنا	.be.dest.hê.na
پێیەی	.pê.yey
ناوخۆی	.naw.xoy
کردنیان	.kir.din.yan
ناونیشانی	.naw.nî.şa.nî
لەدەرەوەی	.le.de.re.wey
خوایە	.xwa.ye
ئەسپ	.ʔesp
کوردەکانە	.kur.de.ka.ne
بکەینەوە	.bi.key.ne.we
دەرببڕیت	.der.bi.bi.řît
نوسینی	.nu.sî.nî
نەیانتوانیبوو	.ne.yan.twa.nî.bû
پۆلەکانی	.po.le.ka.nî
پێکەوەییگەلی	.pê.ke.we.yî.ge.lî
بەندەکانی	.ben.de.ka.nî
پێیە	.pê.ye
هێرشە	.hê.ri.şe
بڵاوکەرەکان	.bi.ław.ke.re.kan
نازانێت	.na.za.nêt
وەڵام	.we.łam
هیوامان	.hî.wa.man
لوبناندا	.lub.nan.da
ناوەرۆکی	.na.we.ro.kî
چوارەمی	.çwa.re.mî
دینی	.dî.nî
زانکۆکانی	.zan.ko.ka.nî
بکەنە	.bi.ke.ne
ناسراوەوە	.nas.ra.we.we
ئانکارادایە	.ʔan.ka.ra.da.ye
بڵاوکراوەکانی	.bi.ław.ki.ra.we.ka.nî
نووسەرانە	.nû.se.ra.ne
رامیارە	.ram.ya.re
دەزانم	.de.za.nim
شەڕێکی	.şe.řê.kî
ناوەندیان	.na.wend.yan
دات	.dat
بڕی	.bi.řî
چەکدار	.çek.dar
هەنگاو	.hen.gaw
رێیانپێنادرێ	.rê.yan.pê.na.di.rê
ئەمنییەکانی	.ʔem.nî.ye.ka.nî
سودی	.su.dî
بەسە	.be.se
باسە	.ba.se
رووپەڕانیش	.rû.pe.řa.nîş
خولقاندنی	.xul.qan.di.nî
دیواری	.dî.wa.rî
ئایینیش	.ʔa.yî.nîş
مالیکی	.ma.lî.kî
کارەکەی	.ka.re.key
پێئەسپێردرا	.pê.ʔes.pêr.di.ra
تیا	.tya
ناچیرۆکەکاندا	.na.çî.ro.ke.kan.da
هەرێم	.he.rêm
بەینێکی	.bey.nê.kî
درابێ	.di.ra.bê
بەڵکەم	.beł.kem
کەی	.key
هۆڵەندا	.ho.łen.da
نامناسێ	.nam.na.sê
هەرتکیان	.her.tik.yan
عێراقە	.ƹê.ra.qe
جودا	.cu.da
بانگەشە	.ban.ge.şe
دەخرێن	.de.xi.rên
لەیەک	.le.yek
تاوانبار	.ta.wan.bar
قسەکانی	.qi.se.ka.nî
دەکردەوە	.de.kir.de.we
پەیڕەو	.pey.řew
سنوورەکانی	.si.nû.re.ka.nî
کچێک	.ki.çêk
پرسیارێکیان	.pirs.ya.rêk.yan
باج	.bac
کارتێکەر	.kar.tê.ker
پیشەیە	.pî.şe.ye
چۆنایەتیی	.ço.na.ye.tîy
ئافراند	.ʔaf.rand
کەیفی	.key.fî
سیاسییەکانی	.sya.sî.ye.ka.nî
کورت	.kurt
نووسراوەگەلی	.nûs.ra.we.ge.lî
ئومێد	.ʔu.mêd
لەسایەی	.le.sa.yey
ئایندەی	.ʔa.yin.dey
برینداربوون	.bi.rîn.dar.bûn
هەڵدەگوێزرانەوە	.heł.de.gwêz.ra.ne.we
بەکر	.be.kir
برایەتی	.bi.ra.ye.tî
یاسایە	.ya.sa.ye
قورئانی	.qur.ʔa.nî
ڕەسوڵ	.ře.suł
ورد	.wird
ناوەندییەکانی	.na.wen.dî.ye.ka.nî
کێشانە	.kê.şa.ne
شیووعی	.şyû.ƹî
جیهانی	.cî.ha.nî
سووچێکی	.sû.çê.kî
پێچ	.pêç
سەربازەکانی	.ser.ba.ze.ka.nî
دەکوژران	.de.kuj.ran
شێعرە	.şêƹ.re
کەواتە	.ke.wa.te
پێدەچێت	.pê.de.çêt
نوسینگەی	.nu.sîn.gey
هەمبەر	.hem.ber
شارە	.şa.re
پەرە	.pe.re
نادۆزرێنەوە	.na.doz.rê.ne.we
فیلمی	.fîl.mî
نەتەوەیی	.ne.te.we.yî
خواردن	.xwar.din
فرەتری	.fi.re.ti.rî
نووسیویە	.nû.sîw.ye
باجەکانی	.ba.ce.ka.nî
هەوای	.he.way
پڕۆژەکە	.pi.řo.je.ke
پەرەی	.pe.rey
چەندین	.çen.dîn
لەگشتیدا	.le.giş.tî.da
جۆربەجۆری	.cor.be.co.rî
نەدەهاتن	.ne.de.ha.tin
جلوبەرگی	.ci.lu.ber.gî
دیداری	.dî.da.rî
ئەیلول	.ʔey.lul
نەجمەددین	.nec.med.dîn
ئێستاکە	.ʔês.ta.ke
لێزانێکی	.lê.za.nê.kî
لێدوانێکیدا	.lê.dwa.nê.kî.da
کۆمەڵانی	.ko.me.ła.nî
دەناساند	.de.na.sand
تەماشای	.te.ma.şay
یاساکەی	.ya.sa.key
چاپکران	.çap.ki.ran
تێگەیشتنی	.tê.geyş.ti.nî
ناداتەوە	.na.da.te.we
درەنگ	.di.reng
هەناردەی	.he.nar.dey
چاکسازیی	.çak.sa.zîy
ئەمانەش	.ʔe.ma.neş
پاسەوانی	.pa.se.wa.nî
پێش	.pêş
گێل	.gêl
راشکاو	.ra.şi.kaw
سەرجەم	.ser.cem
ئاکشەنەر	.ʔak.şe.ner
لەناوبردنی	.le.naw.bir.di.nî
هەڵبەستەکان	.heł.bes.te.kan
کتێب	.ki.têb
مایەی	.ma.yey
گوتاری	.gu.ta.rî
خاوەنان	.xa.we.nan
علیە	.ƹil.ye
سێبەری	.sê.be.rî
مرۆڤە	.mi.ro.ve
تلێفۆنەوە	.ti.lê.fo.ne.we
کتێبەکانیشی	.ki.tê.be.ka.nî.şî
دەستبەدەست	.dest.be.dest
ناگونجێن	.na.gun.cên
هیندستان	.hîn.dis.tan
ناڕاستەوخۆیانە	.na.řas.tew.xo.ya.ne
ویلایەتە	.wî.la.ye.te
بگیردرێن	.bi.gîr.di.rên
بدۆزێتەوە	.bi.do.zê.te.we
منداڵێک	.min.da.łêk
نووسینگەکانی	.nû.sîn.ge.ka.nî
کۆپییەک	.ko.pî.yek
راگەیاندبوو	.ra.ge.yan.di.bû
دانیشێنرابوون	.da.nî.şên.ra.bûn
یوسف	.yu.sif
بناسێنێ	.bi.na.sê.nê
کتێبەوە	.ki.tê.be.we
لەخوارەوە	.le.xwa.re.we
خەڵکە	.xeł.ke
فیلمە	.fîl.me
بریتییە	.bi.rî.tî.ye
دەرکەوتنی	.der.kew.ti.nî
قەوارە	.qe.wa.re
ئەحمەد	.ʔeḧ.med
ماون	.ma.win
ترە	.ti.re
قۆڵبەستکرانیان	.qoł.best.ki.ran.yan
گرت	.girt
هەڵوەشێندرا	.heł.we.şên.di.ra
بۆت	.bot
تمەن	.ti.men
ئامۆژگاری	.ʔa.moj.ga.rî
دژایەتیی	.di.ja.ye.tîy
چاکی	.ça.kî
شەوی	.şe.wî
زمانێکی	.zi.ma.nê.kî
کۆماری	.ko.ma.rî
پارێزگاری	.pa.rêz.ga.rî
هۆرتەوبەرەی	.hor.tew.be.rey
کەسانەی	.ke.sa.ney
نوێش	.nwêş
قسانە	.qi.sa.ne
بڕیارەی	.biř.ya.rey
تەمەن	.te.men
زۆربەیان	.zor.be.yan
تەواو	.te.waw
ڕەجەب	.ře.ceb
دەهێنرێن	.de.hên.rên
یاسین	.ya.sîn
بەرازیل	.be.ra.zîl
بڵاوکردەوە	.bi.ław.kir.de.we
کوردییانە	.kur.dî.ya.ne
چاپدەکرێ	.çap.de.ki.rê
بێ	.bê
دزی	.di.zî
ڕاگەیەندرا	.řa.ge.yen.di.ra
قەتی	.qe.tî
بەدرخانەکان	.be.dir.xa.ne.kan
دژوارکردنەوەی	.dij.war.kir.di.ne.wey
کتێبخانەگەلی	.ki.têb.xa.ne.ge.lî
هەردووکیان	.her.dûk.yan
دەدن	.de.din
خوێندنگەکان	.xwên.din.ge.kan
سەرێکانیم	.se.rê.ka.nîm
گەشتیاری	.geşt.ya.rî
قسەیان	.qi.se.yan
پلەوپایەی	.pi.lew.pa.yey
دەچووقاند	.de.çû.qand
فرۆشێکی	.fi.ro.şê.kî
بەزۆری	.be.zo.rî
پەیوەندییەکیان	.pey.wen.dî.yek.yan
ئەتۆمی	.ʔe.to.mî
چاپدەرەکان	.çap.de.re.kan
بزووتنەوە	.bi.zût.ne.we
گشتین	.giş.tîn
لاوان	.la.wan
پرس	.pirs
بەتاڵ	.be.tał
گۆشتی	.goş.tî
وەربگیردرێ	.wer.bi.gîr.di.rê
تازە	.ta.ze
بێدەنگی	.bê.den.gî
دەنێت	.de.nêt
لەنێو	.le.nêw
ئاسیا	.ʔas.ya
ئەرتشیی	.ʔer.ti.şîy
پردی	.pir.dî
چاپخانەکاندا	.çap.xa.ne.kan.da
کەمبوونەوەیەکی	.kem.bû.ne.we.ye.kî
ئاستە	.ʔas.te
ناوێت	.na.wêt
ناوچەکانی	.naw.çe.ka.nî
ئاڵمانێدا	.ʔał.ma.nê.da
رەوا	.re.wa
دەنووسێ	.de.nû.sê
راستییە	.ras.tî.ye
فەرەنسی	.fe.ren.sî
پارە	.pa.re
تەوەری	.te.we.rî
کەوتەوە	.kew.te.we
بنێن	.bi.nên
تا	.ta
وێنەکانی	.wê.ne.ka.nî
ڕەتکردنەوەی	.řet.kir.di.ne.wey
نێوی	.nê.wî
نەتەوە	.ne.te.we
دەرباز	.der.baz
خورماتوو	.xur.ma.tû
نالەباریی	.na.le.ba.rîy
حاڵێکدایە	.ḧa.łêk.da.ye
سەرمایەداری	.ser.ma.ye.da.rî
ناوەندێک	.na.wen.dêk
بەوەی	.be.wey
ئەکتەری	.ʔek.te.rî
ئاکارەکانی	.ʔa.ka.re.ka.nî
خۆشە	.xo.şe
پێشکەوتن	.pêş.kew.tin
خەریکی	.xe.rî.kî
نوێدا	.nwê.da
لێکۆڵینەوە	.lê.ko.łî.ne.we
تەلێفۆن	.te.lê.fon
دەستپێدەکات	.dest.pê.de.kat
وەرگێڕاوە	.wer.gê.řa.we
تەوەرەکانی	.te.we.re.ka.nî
نان	.nan
مرۆڤناسی	.mi.rov.na.sî
کردەی	.kir.dey
فرۆشتنی	.fi.roş.ti.nî
ناکرێ	.na.ki.rê
چەڤلیک	.çev.lîk
ڕاپەڕینی	.řa.pe.řî.nî
جیاوازییەکی	.cya.wa.zî.ye.kî
ئەلفوبێی	.ʔel.fu.bêy
دەستور	.des.tur
ناسک	.nask
سەلماندنی	.sel.man.di.nî
توێژینەوەیەک	.twê.jî.ne.we.yek
ماندوو	.man.dû
ئەندامەکانیان	.ʔen.da.me.kan.yan
کاریان	.kar.yan
ڕۆژنامەوانی	.řoj.na.me.wa.nî
کرێکاری	.ki.rê.ka.rî
تاکێکی	.ta.kê.kî
بڵاوکردنەوەشی	.bi.ław.kir.di.ne.we.şî
سەرمایە	.ser.ma.ye
دۆزی	.do.zî
هۆکارەکەش	.ho.ka.re.keş
ساڵەکان	.sa.łe.kan
ئاگادارینامەی	.ʔa.ga.da.rî.na.mey
حەمەد	.ḧe.med
بڕیار	.biř.yar
فەڕەنسا	.fe.řen.sa
ناوخۆیییەکان	.naw.xo.yî.ye.kan
رێکخراوەکان	.rêk.xi.ra.we.kan
قۆناغێکی	.qo.na.ẍê.kî
نەیتوانی	.ney.twa.nî
سەدر	.se.dir
داڕێژراو	.da.řêj.raw
چەن	.çen
لایەنگرانی	.la.yen.gi.ra.nî
توشی	.tu.şî
فیلمێکی	.fîl.mê.kî
ئاوێنە	.ʔa.wê.ne
ئینگلیس	.ʔîn.gi.lîs
ئەوروپا	.ʔew.ru.pa
چینەکانی	.çî.ne.ka.nî
کۆنگرەیەکی	.kon.gi.re.ye.kî
کاتێکدایە	.ka.têk.da.ye
یونس	.yuns
لەچاپدەریان	.le.çap.der.yan
کەتەلۆگەکانی	.ke.te.lo.ge.ka.nî
هاوڕێیانە	.haw.řê.ya.ne
بەیەک	.be.yek
گەڕانەوە	.ge.řa.ne.we
ڕەوانە	.ře.wa.ne
بەوەش	.be.weş
ئاگاداریی	.ʔa.ga.da.rîy
بەندیخانەکاندا	.ben.dî.xa.ne.kan.da
دەروونی	.de.rû.nî
لەدەستدا	.le.dest.da
لەوانەش	.le.wa.neş
بەڕێز	.be.řêz
پابەندی	.pa.ben.dî
ئایینییە	.ʔa.yî.nî.ye
هۆنراوەکان	.hon.ra.we.kan
پرۆسەیەکی	.pi.ro.se.ye.kî
ئەنستیتووی	.ʔe.nis.tî.tûy
بستێنێ	.bis.tê.nê
کۆمار	.ko.mar
لەچاپدراون	.le.çap.di.ra.win
تابوو	.ta.bû
تایبەتمەندی	.tay.bet.men.dî
هێنانیان	.hê.nan.yan
ڕەنگ	.řeng
دەبوایە	.de.bwa.ye
عەبدولکەریم	.ƹeb.dul.ke.rîm
چالاکییەکانی	.ça.la.kî.ye.ka.nî
داواکاریی	.da.wa.ka.rîy
سیروان	.sîr.wan
زانا	.za.na
خزماتگوزارییەکانی	.xiz.mat.gu.za.rî.ye.ka.nî
نیوەی	.nî.wey
بزاڤێکیان	.bi.za.vêk.yan
زانی	.za.nî
کلتووری	.kil.tû.rî
نێونەتەوەییی	.nêw.ne.te.we.yîy
یەکتر	.yek.tir
نیشتەجێبوون	.nîş.te.cê.bûn
پەیوەندیدار	.pey.wen.dî.dar
هەڵبەستێکی	.heł.bes.tê.kî
پێشان	.pê.şan
شاندی	.şan.dî
ئیسپانیا	.ʔîs.pan.ya
ئیمزا	.ʔîm.za
زیندانەکانی	.zîn.da.ne.ka.nî
یاریگا	.ya.rî.ga
کەمتریش	.kem.ti.rîş
بنێردرێن	.bi.nêr.di.rên
وەرگێڕەکە	.wer.gê.ře.ke
بازرگانەکان	.ba.zir.ga.ne.kan
کەسانەش	.ke.sa.neş
بڵاوکەرە	.bi.ław.ke.re
سەرەنجێکی	.se.ren.cê.kî
خۆپیشاندان	.xo.pî.şan.dan
رزگاری	.riz.ga.rî
دەکەوێت	.de.ke.wêt
رابگیردرێ	.ra.bi.gîr.di.rê
بوونەتە	.bû.ne.te
متمانەی	.mit.ma.ney
ئیحسان	.ʔîḧ.san
وەرگێر	.wer.gêr
بگۆڕێت	.bi.go.řêt
زمانەکە	.zi.ma.ne.ke
دەستم	.des.tim
تورکەکان	.tur.ke.kan
زۆریشی	.zo.rî.şî
دەچوومەوە	.de.çû.me.we
دەمانەوێت	.de.ma.ne.wêt
جان	.can
لەوان	.le.wan
مەدرەسە	.med.re.se
ڕابگرێت	.řa.big.rêt
یاریزانی	.ya.rî.za.nî
ئەمەی	.ʔe.mey
ماڵ	.mał
ناسێندرا	.na.sên.di.ra
زۆریش	.zo.rîş
گول	.gul
بەڕاستی	.be.řas.tî
پۆستیی	.pos.tîy
گەرەکم	.ge.re.kim
ڕێبین	.řê.bîn
نیوە	.nî.we
تیرۆریست	.tî.ro.rîst
رێپێدان	.rê.pê.dan
میوە	.mî.we
چاپەمەنییەکانی	.ça.pe.me.nî.ye.ka.nî
واشبکەن	.waş.bi.ken
ئێمەی	.ʔê.mey
خۆتان	.xo.tan
رۆژەکانی	.ro.je.ka.nî
بڵاوکردنەوەیان	.bi.ław.kir.di.ne.we.yan
دەفتەری	.def.te.rî
ڕۆشنبیریی	.řo.şin.bî.rîy
زەیۆنیستەکان	.ze.yo.nîs.te.kan
نەویتر	.ne.wî.tir
نووسەری	.nû.se.rî
دایەوە	.da.ye.we
هەتانە	.he.ta.ne
وریا	.wir.ya
خۆیی	.xo.yî
بەدرەددین	.bed.red.dîn
وڵاتەکان	.wi.ła.te.kan
ئەوکاتە	.ʔew.ka.te
لێدوانێکی	.lê.dwa.nê.kî
ئاوارەکانی	.ʔa.wa.re.ka.nî
ئەرکەکانی	.ʔer.ke.ka.nî
درێژی	.di.rê.jî
خانووەکە	.xa.nu.we.ke
کلاسیکی	.ki.la.sî.kî
شێوازێک	.şê.wa.zêk
رێکخەرەکانی	.rêk.xe.re.ka.nî
قورس	.qurs
پێشنیار	.pêş.nyar
ساڵانیان	.sa.łan.yan
هەندێکی	.hen.dê.kî
ماڵان	.ma.łan
ڕۆژێ	.řo.jê
کەل	.kel
دیوەتەوە	.dî.we.te.we
دەبینرێن	.de.bîn.rên
ڕەزا	.ře.za
مامەوە	.ma.me.we
تراک	.ti.rak
بابەتانەدا	.ba.be.ta.ne.da
دوێنی	.dwê.nî
هەواڵدەریی	.he.wał.de.rîy
کۆپی	.ko.pî
ڕووسی	.řû.sî
کردووە	.kir.du.we
ژینگەی	.jîn.gey
دەموونرانەوە	.de.mûn.ra.ne.we
بووەتەوە	.bu.we.te.we
نرابێ	.ni.ra.bê
بەرژەوەندیی	.ber.je.wen.dîy
ئاڵوگۆڕییەکان	.ʔa.łu.go.řî.ye.kan
قوتابخانەی	.qu.tab.xa.ney
فشاری	.fi.şa.rî
تاکوو	.ta.kû
داواکارەکانی	.da.wa.ka.re.ka.nî
کارگێری	.kar.gê.rî
بەرهەمانی	.ber.he.ma.nî
تاوانباریی	.ta.wan.ba.rîy
بەپەلە	.be.pe.le
تەلەڤیزیۆنەکان	.te.le.vîz.yo.ne.kan
لەپاڵ	.le.pał
سووریادا	.sûr.ya.da
هێنابوویان	.hê.na.bû.yan
لیستەکانی	.lîs.te.ka.nî
سیریلیک	.sî.rî.lîk
هاووڵاتیانی	.haw.wi.łat.ya.nî
ڕۆژێک	.řo.jêk
وەبەرهێنانی	.we.ber.hê.na.nî
سەربەخۆ	.ser.be.xo
خەڵاتەش	.xe.ła.teş
لیرە	.lî.re
شەقامی	.şe.qa.mî
کولتووری	.kul.tû.rî
دیتەوە	.dî.te.we
نۆ	.no
بووین	.bûyn
تێکڕای	.têk.řay
بدا	.bi.da
ئەستەمە	.ʔes.te.me
نووسیوە	.nû.sî.we
ئەوانەش	.ʔe.wa.neş
خاکی	.xa.kî
دەدەنەوە	.de.de.ne.we
کوبانێ	.ku.ba.nê
گوتم	.gu.tim
جیابوونەوە	.cya.bû.ne.we
ڕێگا	.řê.ga
قایشی	.qay.şî
وەزارەتی	.we.za.re.tî
سەرژمێرییەدا	.ser.ji.mê.rî.ye.da
نەبوو	.ne.bû
هەشتەمین	.heş.te.mîn
خوێنەرەکان	.xwê.ne.re.kan
توانیویە	.twa.nîw.ye
هەرێمەکە	.he.rê.me.ke
بەدرخانەکانەوە	.be.dir.xa.ne.ka.ne.we
بیروڕاکان	.bî.ru.řa.kan
ئاڵۆزی	.ʔa.ło.zî
داوای	.da.way
پ	.pi
رابردووەوە	.ra.bir.du.we.we
لەشکری	.leş.ki.rî
هونەرە	.hu.ne.re
گەیاندنی	.ge.yan.di.nî
ناڤەندا	.na.ven.da
تەنیاییدا	.ten.ya.yî.da
مانگێک	.man.gêk
هەڵاوێر	.he.ła.wêr
روویان	.rû.yan
نەداوە	.ne.da.we
زیاد	.zyad
پاڵەوانی	.pa.łe.wa.nî
نووسەر	.nû.ser
پێیان	.pê.yan
یاساگەلە	.ya.sa.ge.le
نیوەیان	.nî.we.yan
چاپکراو	.çap.ki.raw
دەسەڵاتداریی	.de.se.łat.da.rîy
دەمەوێ	.de.me.wê
شارستانی	.şa.ris.ta.nî
کوردییەکانی	.kur.dî.ye.ka.nî
ئیمە	.ʔî.me
لەخۆ	.le.xo
ناگەنە	.na.ge.ne
تۆمارکراون	.to.mar.ki.ra.win
بەڕێوەبەرانیکی	.be.řê.we.be.ra.nî.kî
پەرەئەستێنی	.pe.re.ʔes.tê.nî
وەسفی	.wes.fî
تاقمە	.taq.me
باران	.ba.ran
هێشتبوو	.hêş.ti.bû
بیانەوێ	.bya.ne.wê
جیهاد	.cî.had
ئیسرائیل	.ʔîs.ra.ʔîl
قوونیە	.qûn.ye
مەلا	.me.la
ماڵپەڕەکانیاندا	.mał.pe.ře.kan.yan.da
بنکە	.bin.ke
زاری	.za.rî
پتەو	.pi.tew
وەرگێڕاوی	.wer.gê.řa.wî
تاهیر	.ta.hîr
مافێکی	.ma.fê.kî
پڕۆژەیە	.pi.řo.je.ye
روانینیان	.rwa.nîn.yan
ناوەندییان	.na.wen.dî.yan
دۆزراوەکانی	.doz.ra.we.ka.nî
رۆژنامەوانیی	.roj.na.me.wa.nîy
سەدان	.se.dan
گەیشتبێ	.geyş.ti.bê
دەبێت	.de.bêt
بگەڕێنەوە	.bi.ge.řê.ne.we
هۆکارانی	.ho.ka.ra.nî
سەتە	.se.te
بینەر	.bî.ner
دابوونێ	.da.bû.nê
ئیرادەی	.ʔî.ra.dey
پارێزگاکانیش	.pa.rêz.ga.ka.nîş
نەگرین	.ne.gi.rîn
کوردەکانەوە	.kur.de.ka.ne.we
چەمیشگەزەک	.çe.mîş.ge.zek
بەجێهێشت	.be.cê.hêşt
دواکەوتنی	.dwa.kew.ti.nî
چینایەتی	.çî.na.ye.tî
دەسەڵاتدارانی	.de.se.łat.da.ra.nî
حەمۆدا	.ḧe.mo.da
نێوان	.nê.wan
دایکییان	.day.kî.yan
چاپدەدران	.çap.de.di.ran
کفری	.kif.rî
جوانی	.cwa.nî
خاوەنەکانیانە	.xa.we.ne.kan.ya.ne
بەوە	.be.we
بژێوی	.bi.jê.wî
سەلاح	.se.laḧ
سۆرانییە	.so.ra.nî.ye
گەیاندن	.ge.yan.din
پێداچوونەوە	.pê.da.çû.ne.we
زازا	.za.za
نرخیان	.nirx.yan
گوڵی	.gu.łî
وڵامیان	.wi.łam.yan
کرمانجی	.kir.man.cî
تێچووون	.tê.çû.win
کولتوور	.kul.tûr
بەش	.beş
نەیانتوانی	.ne.yan.twa.nî
کوردەکاندا	.kur.de.kan.da
ڕاستیە	.řast.ye
مێژوویییەکان	.mê.jû.yî.ye.kan
کراو	.ki.raw
ساڵیادەکان	.sał.ya.de.kan
زۆرکارانەی	.zor.ka.ra.ney
ماڵە	.ma.łe
وتویەتی	.wi.tu.ye.tî
بەدژی	.bed.jî
دۆست	.dost
بەریتانیا	.be.rî.tan.ya
نەخوێندەواریی	.ne.xwên.de.wa.rîy
گیراوم	.gî.ra.wim
بەهێزکردنی	.be.hêz.kir.di.nî
ببینن	.bi.bî.nin
و	.we
هێنانی	.hê.na.nî
ئەویان	.ʔew.yan
هەڵدەین	.heł.deyn
پەیماننامەی	.pey.man.na.mey
قەبارە	.qe.ba.re
شکا	.şi.ka
فەرهەنگییەکانیان	.fer.hen.gî.ye.kan.yan
گریلاکان	.gi.rî.la.kan
کاتەی	.ka.tey
دوورە	.dû.re
نووسراوە	.nûs.ra.we
بۆچوونی	.bo.çû.nî
کربا	.kir.ba
باسەکانی	.ba.se.ka.nî
بگەنە	.bi.ge.ne
هەورامان	.hew.ra.man
رحا	.ri.ḧa
بەیان	.be.yan
پسپۆڕی	.pis.po.řî
زەنگی	.zen.gî
گازی	.ga.zî
راگواست	.ra.gwast
ئایا	.ʔa.ya
بودجە	.bud.ce
بەڕێوەبەرایەتیی	.be.řê.we.be.ra.ye.tîy
میراتە	.mî.ra.te
کۆسپەکان	.kos.pe.kan
چەند	.çend
دلاوەر	.di.la.wer
لاتینیش	.la.tî.nîş
تەیب	.te.yib
دوایین	.dwa.yîn
کو	.ku
کوشت	.kuşt
پێناو	.pê.naw
هەندێکشیان	.hen.dê.kiş.yan
فەڕەنسییەکان	.fe.řen.sî.ye.kan
سۆڤیەت	.sov.yet
پرۆسە	.pi.ro.se
گوێ	.gwê
بەرکراون	.ber.ki.ra.win
لوتکەی	.lut.key
ئێلیفسن	.ʔê.lîf.sin
ئێستاکەش	.ʔês.ta.keş
بەئامادەبوونی	.be.ʔa.ma.de.bû.nî
ولە	.wi.le
رۆژنامەوانانی	.roj.na.me.wa.na.nî
لەوانەی	.le.wa.ney
ڕۆژهەڵاتی	.řoj.he.ła.tî
ڕووداوەکان	.řû.da.we.kan
رێکبخرێن	.rêk.bix.rên
کرایەوە	.ki.ra.ye.we
خۆیانی	.xo.ya.nî
لازەکان	.la.ze.kan
پەڕی	.pe.řî
کوا	.kwa
لیست	.lîst
ڕێگایەکی	.řê.ga.ye.kî
دانیشتووەکان	.da.nîş.tu.we.kan
رێکیدەخست	.rê.kî.de.xist
خەڵکەکەی	.xeł.ke.key
بەرهەڵستە	.ber.he.łis.te
چەک	.çek
یانە	.ya.ne
دێرسم	.dêr.sim
هەرسێک	.her.sêk
کۆنترۆڵ	.kon.ti.roł
ئینگلیز	.ʔîn.gi.lîz
بردنم	.bir.di.nim
مەم	.mem
یەکانی	.ye.ka.nî
رێک	.rêk
خواردنەوە	.xwar.di.ne.we
بڵیند	.bi.łînd
خارپێتیش	.xar.pê.tîş
هەرێمە	.he.rê.me
سەرژمێرییەکەی	.ser.ji.mê.rî.ye.key
فاکتەری	.fak.te.rî
دەبینێت	.de.bî.nêt
بەرزترین	.be.riz.ti.rîn
دەستکەوتی	.dest.kew.tî
کاک	.kak
بەهەشت	.be.heşt
هۆگرەکانی	.ho.gi.re.ka.nî
هەرێمدا	.he.rêm.da
گۆڤارەکانی	.go.va.re.ka.nî
ئاسانی	.ʔa.sa.nî
زۆردارانەیە	.zor.da.ra.ne.ye
ئێستادا	.ʔês.ta.da
ژمارەکانی	.ji.ma.re.ka.nî
نووسینگەکەمان	.nû.sîn.ge.ke.man
چوارەم	.çwa.rem
گەرچی	.ger.çî
کورسی	.kur.sî
سەرەتاکانی	.se.re.ta.ka.nî
بیرە	.bî.re
نالەبار	.na.le.bar
سەرباری	.ser.ba.rî
دەمهەوێت	.dem.he.wêt
ئۆگرەتی	.ʔog.re.tî
یارییەکانی	.ya.rî.ye.ka.nî
ڕووداوێکی	.řû.da.wê.kî
زۆرترین	.zor.ti.rîn
شارەکە	.şa.re.ke
لەڕێی	.le.řêy
ناوچەیەکی	.naw.çe.ye.kî
نوێنەرایەتیی	.nwê.ne.ra.ye.tîy
خۆشیان	.xoş.yan
دەکاتەوە	.de.ka.te.we
پیشەیی	.pî.şe.yî
دەوێت	.de.wêt
پەڕتووکەکانی	.peř.tû.ke.ka.nî
دەیەوێ	.de.ye.wê
نموونەیەک	.ni.mû.ne.yek
دووهەمەکە	.dû.he.me.ke
گرینگە	.gi.rîn.ge
کیمیایی	.kîm.ya.yî
دایە	.da.ye
نەتوانن	.ne.twa.nin
دەمۆکراتیا	.de.mok.rat.ya
هەڵگەڕێنەوە	.heł.ge.řê.ne.we
پرێس	.pi.rês
دەرگای	.der.gay
تەلەفزیۆنی	.te.le.fiz.yo.nî
کەلار	.ke.lar
ئا	.ʔa
نیشتیمانی	.nîş.tî.ma.nî
توندوتیژانەتر	.tun.du.tî.ja.ne.tir
گوت	.gut
ئاسایییەکان	.ʔa.sa.yî.ye.kan
کرابوونەوە	.ki.ra.bû.ne.we
زیندوو	.zîn.dû
بزاندرێن	.bi.zan.di.rên
پۆلی	.po.lî
شانۆ	.şa.no
بەناو	.be.naw
چاوێکی	.ça.wê.kî
دەوڵەتی	.dew.łe.tî
ئاشکرایکرد	.ʔaş.ki.ray.kird
باشووردا	.ba.şûr.da
بزانە	.bi.za.ne
نووسەرەکە	.nû.se.re.ke
هەرە	.he.re
دێرک	.dê.rik
هەولێری	.hew.lê.rî
بنەڕەتدا	.bi.ne.řet.da
حوزنی	.ḧuz.nî
هونەرمەندی	.hu.ner.men.dî
بنێرن	.bi.nê.rin
بیروباسیان	.bî.ru.bas.yan
داواکارییان	.da.wa.ka.rî.yan
سەرشانی	.ser.şa.nî
بەڵێن	.be.łên
زۆریان	.zor.yan
چاپکراوە	.çap.ki.ra.we
نەشتەرگەری	.neş.ter.ge.rî
سۆرانیش	.so.ra.nîş
تلێفۆن	.ti.lê.fon
دەتواندرێن	.de.twan.di.rên
خەڵاتە	.xe.ła.te
