турбуленција	turbulɛnt͡sija
подзамрзне	pɔdzamr̩znɛ
гуштер	ɡuʃtɛr
непобитност	nɛpɔbitnɔst
противуставен	prɔtivustavɛn
лисица	lisit͡sa
џиџе	d͡ʒid͡ʒɛ
гулапче	ɡuɫapt͡ʃɛ
опитомува	ɔpitɔmuva
именува	imɛnuva
ѕвони	d͡zvɔni
велингтонски	vɛliŋktɔnski
воздржаност	vɔzdr̩ʒanɔst
тужителка	tuʒitɛɫka
сребрест	srɛbrɛst
катедрала	katɛdraɫa
километарски	kiɫɔmɛtarski
раскитува	raskituva
ајдутство	ajdutstvɔ
ребро	rɛbrɔ
жила	ʒiɫa
јагуар	jaɡuar
оман	ɔman
справедливост	spravɛdlivɔst
знак	znak
паунче	paunt͡ʃɛ
тикве	tikvɛ
брош	brɔʃ
полемика	pɔlɛmika
воодушевеност	vɔɔduʃɛvɛnɔst
доуредува	dɔurɛduva
педерче	pɛdɛrt͡ʃɛ
асиметрија	asimɛtrija
прегазува	prɛɡazuva
грб	ɡr̩p
неуредност	nɛuɾɛdnɔst
комарци	kɔmart͡si
маршира	marʃiɾa
подосвежи	pɔdɔsvɛʒi
тежок	tɛʒɔk
пешкирче	pɛʃkirt͡ʃɛ
суетност	suɛtnɔst
папочен	papɔt͡ʃɛn
сразмерност	srazmɛrnɔst
испокраде	ispɔkradɛ
корен	kɔɾɛn
провев	prɔvɛf
гневност	ɡnɛvnɔst
бидејќи	bidɛjci
надзборува	nadzbɔɾuva
необоен	nɛɔbɔɛn
наш	naʃ
книга	kniɡa
изведувачки	izvɛduvat͡ʃki
криумчар	krijumt͡ʃar
иследи	islɛdi
неискреност	nɛiskrɛnɔst
шуми	ʃumi
оформува	ɔfɔrmuva
цвеќарство	t͡svɛcarstvɔ
компјутер	kɔmpjutɛr
рочиште	rɔt͡ʃiʃtɛ
самоубиец	samɔubijɛt͡s
аман	aman
дури	duɾi
протокол	prɔtɔkɔɫ
ктиторски	ktitɔrski
катанче	katant͡ʃɛ
темноцрвен	tɛmnɔt͡sr̩vɛn
витези	vitɛzi
живинарство	ʒivinarstvɔ
погинува	pɔɡinuva
густ	ɡust
игривост	iɡrivɔst
дење	dɛɲɛ
шанец	ʃanɛt͡s
гломазност	ɡɫɔmaznɔst
овчарство	ɔft͡ʃarstvɔ
ситуациски	situat͡siski
чамче	t͡ʃamt͡ʃɛ
берлин	bɛrlin
молитва	mɔlitva
препече	prɛpɛt͡ʃɛ
како	kakɔ
скулпторски	skuɫptɔrski
бесчесност	bɛʃt͡ʃɛsnɔst
одлежи	ɔdlɛʒi
издвојува	izdvɔjuva
прачка	prat͡ʃka
ангел	aŋɡɛɫ
немилосрдност	nɛmiɫɔsr̩dnɔst
накалемува	nakalɛmuva
крајпатен	krajpatɛn
куќарка	kucarka
будала	budaɫa
угодник	uɡɔdnik
грд	ɡr̩t
јорганче	jɔrɡant͡ʃɛ
ксенофобија	ksɛnɔfɔbija
стадиум	stadijum
изретчува	izrɛtt͡ʃuva
дрндање	dr̩n̩daɲɛ
цензорски	t͡sɛnzɔrski
интерес	intɛɾɛs
вибрациски	vibrat͡siski
бог	bɔk
будилник	budiɫnik
секојдневност	sɛkɔjdnɛvnɔst
замавтува	zamaftuva
подиспразни	pɔdisprazni
курови	kuɾɔvi
одличност	ɔdlit͡ʃnɔst
гласеж	ɡɫasɛʃ
навивачки	navivat͡ʃki
расподели	raspɔdɛli
инквизиција	iŋkvizit͡sija
авијација	avijat͡sija
засмрдува	zasmr̩duva
учебнички	ut͡ʃɛbnit͡ʃki
препознатливост	prɛpɔznatlivɔst
впие	fpijɛ
повеќезначност	pɔvɛcɛznat͡ʃnɔst
наложништво	naɫɔʒniʃtvɔ
шраф	ʃraf
внедрува	vnɛdruva
поѕвони	pɔd͡zvɔni
бигамија	biɡamija
потскрати	pɔtskrati
сапун	sapun
опсадник	ɔpsadnik
недопрен	nɛdɔprɛn
редакторка	rɛdaktɔrka
мезе	mɛzɛ
одморски	ɔdmɔrski
дом	dɔm
скопјанче	skɔpjant͡ʃɛ
дволик	dvɔlik
добро	dɔˑβ̞rɔ̩
ризичност	rizit͡ʃnɔst
леденост	lɛdɛnɔst
електроника	ɛlɛktrɔnika
авторов	aftɔɾɔf
расколник	raskɔɫnik
преѕида	prɛd͡zida
своеглавост	svɔɛɡɫavɔst
фушерски	fuʃɛrski
големство	ɡɔlɛmstvɔ
заменичка	zamɛnit͡ʃka
конституција	kɔnstitut͡sija
пребричува	prɛbrit͡ʃuva
испива	ispiva
пребарувач	prɛbaɾuvat͡ʃ
телеологија	tɛlɛɔɫɔɡija
пиперче	pipɛrt͡ʃɛ
брадва	bradva
изнаправи	iznapravi
згрижува	zɡriʒuva
овдешен	ɔvdɛʃɛn
перверзија	pɛrvɛrzija
митинг	mitiŋk
маглоса	maɡɫɔsa
безвременост	bɛzvrɛmɛnɔst
сунѓер	sunɟɛr
редовност	rɛdɔvnɔst
ловоров	ɫɔvɔɾɔf
русија	rusija
пиштол	piʃtɔɫ
изнакапе	iznakapɛ
донесува	dɔnɛsuva
ориентациски	ɔɾijɛntat͡siski
најгвирц	najɡvirt͡s
пеперутка	pɛpɛɾutka
кара	kaɾa
уметник	umɛtnik
шура	ʃuɾa
беден	bɛdɛn
вистинољубивост	vistinɔlubivɔst
солза	sɔɫza
разрушеност	razruʃɛnɔst
презадолженост	prɛzadɔɫʒɛnɔst
косово	kɔsɔvɔ
карактеризација	kaɾaktɛɾizat͡sija
вдлабнатост	vdɫabnatɔst
повторливост	pɔftɔrlivɔst
дружба	druʒba
избувен	izbuvɛn
ѕиден	d͡zidɛn
десничарка	dɛsnit͡ʃarka
грбавост	ɡr̩bavɔst
незадоволителност	nɛzadɔvɔlitɛɫnɔst
испомоча	ispɔmɔt͡ʃa
убива	ubiva
противпожарен	prɔtifpɔʒaɾɛn
дозакопча	dɔzakɔpt͡ʃa
кус	kus
јајце	jajt͡sɛ
истоименик	istɔimɛnik
необновен	nɛɔbnɔvɛn
врие	vrijɛ
пламенче	pɫamɛnt͡ʃɛ
слободољубивост	sɫɔbɔdɔlubivɔst
гудачки	ɡudat͡ʃki
доста	dɔsta
пропорција	prɔpɔrt͡sija
денски	dɛnski
берберка	bɛrbɛrka
гиздавост	ɡizdavɔst
силеџиство	silɛd͡ʒistvɔ
аномалија	anɔmalija
небаре	nɛbaɾɛ
прегори	prɛɡɔɾi
заморност	zamɔrnɔst
дестинација	dɛstinat͡sija
импровизација	imprɔvizat͡sija
расфрла	rasfr̩ɫa
дојадува	dɔjaduva
водиме	vɔdimɛ
испобега	ispɔbɛɡa
плаши	pɫaʃi
круничка	krunit͡ʃka
благородничка	bɫaɡɔrɔdnit͡ʃka
цвеќе	t͡svɛcɛ
чивит	t͡ʃivit
методичност	mɛtɔdit͡ʃnɔst
клинче	klint͡ʃɛ
необновлив	nɛɔbnɔvlif
трогнатост	trɔɡnatɔst
деветпати	dɛvɛtpati
обнадежува	ɔbnadɛʒuva
производство	prɔizvɔtstvɔ
расади	rasadi
соучесништво	sɔut͡ʃɛsniʃtvɔ
благоевград	bɫaɡɔɛvɡrat
избодува	izbɔduva
заветен	zavɛtɛn
сонце	sɔnt͡sɛ
напасник	napasnik
надлежност	nadlɛʒnɔst
презакажува	prɛzakaʒuva
оди	ɔdi
хартија	xartija
змиест	zmijɛst
иновациски	inɔvat͡siski
маж	maʃ
граничник	ɡranit͡ʃnik
незабележан	nɛzabɛlɛʒan
осквернува	ɔskvɛrnuva
библиографија	biblijɔɡrafija
преобработи	prɛɔbrabɔti
потпече	pɔtpɛt͡ʃɛ
необјаснет	nɛɔbjasnɛt
наочник	naɔt͡ʃnik
подзасука	pɔdzasuka
мукнува	muknuva
крепкост	krɛpkɔst
паликир	palikir
мочовод	mɔt͡ʃɔvɔt
канада	kanada
дострижува	dɔstriʒuva
заѕвонува	zad͡zvɔnuva
хотел	xɔtɛɫ
готовност	ɡɔtɔvnɔst
сомнителност	sɔmnitɛɫnɔst
неплатен	nɛpɫatɛn
туристка	turistka
сеирџија	sɛird͡ʒija
запоставеност	zapɔstavɛnɔst
флуктуација	fɫuktuat͡sija
боцнува	bɔt͡snuva
прегледува	prɛɡlɛduva
жонглерка	ʒɔŋɡlɛrka
кабелче	kabɛɫt͡ʃɛ
топличок	tɔplit͡ʃɔk
бадијала	badijaɫa
крводарител	kr̩vɔdaɾitɛɫ
бозон	bɔzɔn
сабји	sabji
биопсија	bijɔpsija
куферче	kufɛrt͡ʃɛ
ненаместен	nɛnamɛstɛn
шупа	ʃupa
ќефови	cɛfɔvi
кафеџија	kafɛd͡ʒija
осквернител	ɔskvɛrnitɛɫ
имотност	imɔtnɔst
род	rɔt
неудобност	nɛudɔbnɔst
наполнува	napɔɫnuva
прага	praɡa
безделник	bɛzdɛɫnik
вујков	vujkɔf
ѕвезда	d͡zvɛzda
пари	paɾi
раса	rasa
проститутка	prɔstitutka
погрден	pɔɡr̩dɛn
дувачки	duvat͡ʃki
потрепери	pɔtrɛpɛɾi
честољубивост	t͡ʃɛstɔlubivɔst
флејта	flɛjta
комунизам	kɔmunizam
прикове	prikɔvɛ
прекривка	prɛkrifka
воденичарка	vɔdɛnit͡ʃarka
литанија	litanija
разреденост	razrɛdɛnɔst
едноличност	ɛdnɔlit͡ʃnɔst
понеделник	pɔnɛdɛɫnik
пури	puɾi
лом	ɫɔm
вашингтон	vaʃiŋktɔn
ѕид	d͡zit
амортизација	amɔrtizat͡sija
лепливост	lɛplivɔst
скептик	skɛptik
недооформен	nɛdɔɔfɔrmɛn
водиве	vɔdivɛ
негација	nɛɡat͡sija
молерисува	mɔlɛrisuva
искривеност	iskrivɛnɔst
ткајач	tkajat͡ʃ
изнапише	iznapiʃɛ
ѓаволов	ɟavɔɫɔf
малубројност	maɫubrɔjnɔst
побегнува	pɔbɛɡnuva
зелче	zɛɫt͡ʃɛ
курва	kurva
лозов	ɫɔzɔf
зајачиште	zajat͡ʃiʃtɛ
теократија	tɛɔkratija
народност	naɾɔdnɔst
грофовија	ɡrɔfɔvija
век	vɛk
диван	divan
буцнува	but͡snuva
чкрапав	t͡ʃkrapaf
фурна	furna
викиншки	vikinʃki
греота	ɡrɛɔta
вадучки	vadut͡ʃki
штрајкувач	ʃtrajkuvat͡ʃ
свиѓа	sviɟa
загнојува	zaɡnɔjuva
одгледувачки	ɔdɡlɛduvat͡ʃki
врша	vr̩ʃa
мудрец	mudrɛt͡s
раскрои	raskrɔi
енклитичен	ɛnklitit͡ʃɛn
небиднина	nɛbidnina
непланиран	nɛpɫaniɾan
некрофилија	nɛkrɔfilija
хафниум	xafnijum
заечува	zaɛt͡ʃuva
магаре	maɡaɾɛ
влажност	vɫaʒnɔst
дрт	dr̩t
сипаничав	sipanit͡ʃaf
месечарка	mɛsɛt͡ʃarka
подзачисти	pɔdzat͡ʃisti
пироманија	piɾɔmanija
недоплатен	nɛdɔpɫatɛn
поткупливост	pɔtkuplivɔst
ранобуден	ranɔbudɛn
дејствителност	dɛjstvitɛɫnɔst
карфиол	karfijɔɫ
трансакциски	transakt͡siski
бруќе	brucɛ
психа	psixa
ежиња	ɛʒiɲa
оси	ɔsi
блуднички	bɫudnit͡ʃki
страшливост	straʃlivɔst
македонци	makɛdɔnt͡si
ајванче	ajvant͡ʃɛ
недозреан	nɛdɔzrɛan
ме	mɛ
рунтав	runtaf
гајдари	ɡajdaɾi
разборитост	razbɔɾitɔst
потемнетост	pɔtɛmnɛtɔst
џебови	d͡ʒɛbɔvi
ветруле	vɛtrulɛ
оттурнува	ɔtturnuva
тринаесет	trinaɛsɛt
ежови	ɛʒɔvi
сложенка	sɫɔʒɛŋka
трошка	trɔʃka
брезичка	brɛzit͡ʃka
муслимански	muslimanski
разнобојност	raznɔbɔjnɔst
подзагори	pɔdzaɡɔɾi
детено	dɛtɛnɔ
мајмуни	majmuni
вреќичка	vrɛcit͡ʃka
фонт	fɔnt
пеење	pɛɛɲɛ
мутациски	mutat͡siski
идеја	idɛja
курвин	kurvin
рипнува	ripnuva
испосакати	ispɔsakati
четврток	t͡ʃɛtvr̩tɔk
градба	ɡradba
гавранче	ɡavrant͡ʃɛ
меана	mɛana
сладок	sɫadɔk
лексикографија	lɛksikɔɡrafija
омлет	ɔmlɛt
кипарски	kiparski
применливост	primɛnlivɔst
проневерувач	prɔnɛvɛɾuvat͡ʃ
градински	ɡradinski
разделеност	razdɛlɛnɔst
удопство	udɔpstvɔ
реавост	rɛavɔst
водат	vɔdat
африка	afrika
габер	ɡabɛr
руча	rut͡ʃa
чембалист	t͡ʃɛmbalist
казанџија	kazand͡ʒija
зеленчуков	zɛlɛnt͡ʃukɔf
неистребливост	nɛistrɛblivɔst
тајна	tajna
изнапржи	iznapr̩ʒi
долготрајност	dɔɫɡɔtrajnɔst
изнамрчи	iznamr̩t͡ʃi
крзнар	kr̩znar
огранок	ɔɡranɔk
огледало	ɔɡlɛdaɫɔ
заташкува	zataʃkuva
неспомнат	nɛspɔmnat
тромавост	trɔmavɔst
расчепка	raʃt͡ʃɛpka
идеален	idɛalɛn
витештва	vitɛʃtva
соединети	sɔɛdinɛti
амнезија	amnɛzija
недоплетен	nɛdɔplɛtɛn
алхемија	aɫxɛmija
тенок	tɛnɔk
добивка	dɔbifka
испотепа	ispɔtɛpa
напоредник	napɔɾɛdnik
туѓински	tuɟinski
ќебапче	cɛbapt͡ʃɛ
него	nɛɡɔ
полувреме	pɔɫuvrɛmɛ
орце	ɔrt͡sɛ
врат	vrat
дислексија	dislɛksija
расипаност	rasipanɔst
портичка	pɔrtit͡ʃka
броеви	brɔɛvi
клетвен	klɛtvɛn
генерал	ɡɛnɛraɫ
безживотност	bɛʒʒivɔtnɔst
уметност	umɛtnɔst
поднареди	pɔdnaɾɛdi
штави	ʃtavi
бумбаров	bumbaɾɔf
скептичност	skɛptit͡ʃnɔst
безосновност	bɛzɔsnɔvnɔst
пресостави	prɛsɔstavi
непроверен	nɛprɔvɛɾɛn
суеверие	suɛvɛɾijɛ
обувка	ɔbufka
лош	ɫɔʃ
нешто	nɛʃtɔ
лимен	limɛn
мајсторче	majstɔrt͡ʃɛ
џемперче	d͡ʒɛmpɛrt͡ʃɛ
шупливост	ʃuplivɔst
градација	ɡradat͡sija
чајник	t͡ʃajnik
минск	minsk
компиров	kɔmpiɾɔf
броило	brɔiɫɔ
дрогира	drɔɡiɾa
блуткавост	bɫutkavɔst
кобила	kɔbiɫa
подбел	pɔdbɛɫ
морфофонологија	mɔrfɔfɔnɔɫɔɡija
расклопува	raskɫɔpuva
лезетски	lɛzɛtski
јаболков	jabɔɫkɔf
свиларство	sviɫarstvɔ
сѐ	sɛ
џимиринка	d͡ʒimiɾiŋka
ткае	tkaɛ
фелдмаршал	fɛɫdmarʃaɫ
полица	pɔlit͡sa
извитоперува	izvitɔpɛɾuva
издишка	izdiʃka
тука	tuka
кукличе	kuklit͡ʃɛ
тенија	tɛnija
мелничар	mɛɫnit͡ʃar
вокатив	vɔkatif
набожен	nabɔʒɛn
охриѓанка	ɔxriɟaŋka
недоработен	nɛdɔrabɔtɛn
заискрува	zaiskruva
комичарка	kɔmit͡ʃarka
неснаодливост	nɛsnaɔdlivɔst
лондончанец	ɫɔndɔnt͡ʃanɛt͡s
ватерполо	vatɛrpɔɫɔ
белетристички	bɛlɛtristit͡ʃki
устројство	ustrɔjstvɔ
поларизација	pɔɫaɾizat͡sija
напатеност	napatɛnɔst
рамо	ramɔ
чанта	t͡ʃanta
мајкин	majkin
баку	baku
насаскува	nasaskuva
подосветли	pɔdɔsvɛtli
незаменливост	nɛzamɛnlivɔst
јазичник	jazit͡ʃnik
налудничавост	naɫudnit͡ʃavɔst
недолечен	nɛdɔlɛt͡ʃɛn
тројка	trɔjka
замира	zamiɾa
стан	stan
епистемологија	ɛpistɛmɔɫɔɡija
под	pɔt
самодржавие	samɔdr̩ʒavijɛ
обелува	ɔbɛɫuva
велигден	vɛliɡdɛn
базален	bazalɛn
смоквин	smɔkvin
бочвар	bɔt͡ʃvar
владејачки	vɫadɛjat͡ʃki
ова	ɔva
правопис	pravɔpis
јок	jɔk
полјоделство	pɔɫjɔdɛɫstvɔ
брборливост	br̩bɔrlivɔst
јаглениса	jaɡlɛnisa
прегрупира	prɛɡrupiɾa
интеракција	intɛrakt͡sija
прегради	prɛɡradi
милионер	milijɔnɛr
сребрар	srɛbrar
антипатија	antipatija
јагодичка	jaɡɔdit͡ʃka
блазонирања	bɫazɔniɾaɲa
отровност	ɔtrɔvnɔst
нукуалофа	nukuaɫɔfa
февруари	fɛvruaɾi
провокација	prɔvɔkat͡sija
казахстан	kazaxstan
лисиче	lisit͡ʃɛ
каивче	kaift͡ʃɛ
прооден	prɔɔdɛn
перница	pɛrnit͡sa
десница	dɛsnit͡sa
јасновидство	jasnɔvitstvɔ
унгарски	uŋɡarski
доколку	dɔkɔɫku
количество	kɔlit͡ʃɛstvɔ
уверува	uvɛɾuva
книгине	kniɡinɛ
кафенце	kafɛnt͡sɛ
чембалисти	t͡ʃɛmbalisti
планинче	pɫanint͡ʃɛ
интеграциски	intɛɡrat͡siski
подискара	pɔdiskaɾa
клоцнува	kɫɔt͡snuva
тапија	tapija
неменливост	nɛmɛnlivɔst
кондуктерски	kɔnduktɛrski
митарство	mitarstvɔ
изводливост	izvɔdlivɔst
запаливост	zapalivɔst
пишување	piʃuvaɲɛ
кршталник	kr̩ʃtaɫnik
испозакачи	ispɔzakat͡ʃi
пушење	puʃɛɲɛ
ѕвонарски	d͡zvɔnarski
успешност	uspɛʃnɔst
мајсторство	majstɔrstvɔ
крап	krap
истражувачка	istraʒuvat͡ʃka
грам	ɡram
вреснува	vrɛsnuva
распердаши	raspɛrdaʃi
крџалија	kr̩d͡ʒalija
ранче	rant͡ʃɛ
воздухопловство	vɔzduxɔpɫɔfstvɔ
боже	bɔʒɛ
прст	pr̩st
баталува	bataɫuva
ронка	rɔŋka
несреденост	nɛsrɛdɛnɔst
џамови	d͡ʒamɔvi
главатар	ɡɫavatar
охриѓанче	ɔxriɟant͡ʃɛ
пламнува	pɫamnuva
дораскажува	dɔɾaskaʒuva
забеганост	zabɛɡanɔst
разгранетост	razɡranɛtɔst
несилка	nɛsiɫka
лудува	ɫuduva
зајадува	zajaduva
јабанџија	jaband͡ʒija
божик	bɔʒik
изнакрка	iznakr̩ka
непресушност	nɛprɛsuʃnɔst
теме	tɛmɛ
разбран	razbran
наминува	naminuva
нецелосност	nɛt͡sɛɫɔsnɔst
ножички	nɔʒit͡ʃki
разнобоен	raznɔbɔɛn
докрпува	dɔkr̩puva
скорпија	skɔrpija
благородништво	bɫaɡɔrɔdniʃtvɔ
потсоблече	pɔtsɔblɛt͡ʃɛ
даблин	dablin
евалуација	ɛvaɫuat͡sija
биолог	bijɔɫɔk
подзастане	pɔdzastanɛ
неисполнет	nɛispɔɫnɛt
менторски	mɛntɔrski
приземност	prizɛmnɔst
фунафути	funafuti
недовршеност	nɛdɔvr̩ʃɛnɔst
невиден	nɛvidɛn
срдечност	sr̩dɛt͡ʃnɔst
неказнет	nɛkaznɛt
бомба	bɔmba
машина	maʃina
билет	bilɛt
потиснатост	pɔtisnatɔst
коњ	kɔɲ
издолжува	izdɔɫʒuva
преде	prɛdɛ
незаконитост	nɛzakɔnitɔst
шпионство	ʃpijɔnstvɔ
врти	vr̩ti
шија	ʃija
јаничар	janit͡ʃar
курна	kurna
лале	ɫalɛ
безбојност	bɛzbɔjnɔst
кашичка	kaʃit͡ʃka
заварувач	zavaɾuvat͡ʃ
интеграција	intɛɡrat͡sija
ботаничар	bɔtanit͡ʃar
преврне	prɛvr̩nɛ
дрнка	dr̩n̩ka
бургас	burɡas
кандило	kandiɫɔ
информациски	iɱfɔrmat͡siski
жир	ʒir
ѕверка	d͡zvɛrka
дереџе	dɛɾɛd͡ʒɛ
бучава	but͡ʃava
свиларски	sviɫarski
рекламација	rɛkɫamat͡sija
самуил	samuiɫ
памуче	pamut͡ʃɛ
стрела	strɛɫa
усмрденост	usmr̩dɛnɔst
тебе	tɛbɛ
исклучив	iskɫut͡ʃif
морач	mɔɾat͡ʃ
седумдесет	sɛdumdɛsɛt
неискористен	nɛiskɔɾistɛn
репортер	rɛpɔrtɛr
опасен	ɔpasɛn
загреб	zaɡrɛp
шилеже	ʃilɛʒɛ
чува	t͡ʃuva
аргентина	arɡɛntina
двојазичност	dvɔjazit͡ʃnɔst
шапка	ʃapka
бепче	bɛpt͡ʃɛ
јадење	jadɛɲɛ
незгодност	nɛzɡɔdnɔst
костим	kɔstim
снешковци	snɛʃkɔft͡si
страдалник	stradaɫnik
луѓето	ɫuɟɛtɔ
чесност	t͡ʃɛsnɔst
застапништво	zastapniʃtvɔ
рафинерија	rafinɛɾija
мама	mama
артикулира	artikuliɾa
недокваканост	nɛdɔkvakanɔst
кроце	krɔt͡sɛ
туш	tuʃ
накострешеност	nakɔstrɛʃɛnɔst
критичност	kritit͡ʃnɔst
стија	stija
стетоскоп	stɛtɔskɔp
штетност	ʃtɛtnɔst
испочитува	ispɔt͡ʃituva
сиднејски	sidnɛjski
џабе	d͡ʒabɛ
назадност	nazadnɔst
ветренце	vɛtrɛnt͡sɛ
чкртне	t͡ʃkr̩tnɛ
поквичи	pɔkvit͡ʃi
штеточинец	ʃtɛtɔt͡ʃinɛt͡s
нужник	nuʒnik
потребен	pɔtrɛbɛn
свеќарство	svɛcarstvɔ
прегрева	prɛɡrɛva
спремност	sprɛmnɔst
трансакција	transakt͡sija
занаетчиски	zanaɛtt͡ʃiski
мадрид	madrit
кола	kɔɫa
џимиринки	d͡ʒimiɾiŋki
вереник	vɛɾɛnik
гусарски	ɡusarski
гркинка	ɡr̩kiŋka
компензација	kɔmpɛnzat͡sija
пародија	parɔdija
доиспитува	dɔispituva
евтин	ɛftin
интранет	intranɛt
необработливост	nɛɔbrabɔtlivɔst
инерција	inɛrt͡sija
запнува	zapnuva
виза	viza
управнички	upravnit͡ʃki
несварливост	nɛsvarlivɔst
шестнаесет	ʃɛstnaɛsɛt
кошничарски	kɔʃnit͡ʃarski
муце	mut͡sɛ
долгокос	dɔɫɡɔkɔs
пласт	pɫast
маживе	maʒivɛ
развратник	razvratnik
безмерност	bɛzmɛrnɔst
испоубие	ispɔubijɛ
вентилациски	vɛntiɫat͡siski
расипништво	rasipniʃtvɔ
блискост	bliskɔst
еден	ɛdɛn
шминка	ʃmiŋka
работоспособност	rabɔtɔspɔsɔbnɔst
одмореност	ɔdmɔɾɛnɔst
еднонасочност	ɛdnɔnasɔt͡ʃnɔst
искосува	iskɔsuva
поскапува	pɔskapuva
повреви	pɔvrɛvi
национализам	nat͡sijɔnalizam
конверзија	kɔɱvɛrzija
вујко	vujkɔ
кринов	krinɔf
предвестува	prɛdvɛstuva
разубавеност	razubavɛnɔst
валканост	vaɫkanɔst
кабулски	kabuɫski
жиро	ʒiɾɔ
мешнува	mɛʃnuva
џемпер	d͡ʒɛmpɛr
бодибилдерка	bɔdibiɫdɛrka
гол	ɡɔɫ
испорачувач	ispɔrat͡ʃuvat͡ʃ
збунувачки	zbunuvat͡ʃki
тиквеник	tikvɛnik
клуче	kɫut͡ʃɛ
заљубеност	zalubɛnɔst
добричува	dɔbrit͡ʃuva
организациски	ɔrɡanizat͡siski
крпичка	kr̩pit͡ʃka
лафи	ɫafi
техничарка	tɛxnit͡ʃarka
трагичарка	traɡit͡ʃarka
ѓомлезец	ɟɔmlɛzɛt͡s
сомун	sɔmun
забучува	zabut͡ʃuva
инсинуација	insinuat͡sija
истенчува	istɛnt͡ʃuva
подзине	pɔdzinɛ
домарка	dɔmarka
заладува	zaɫaduva
догледува	dɔɡlɛduva
ненаселеност	nɛnasɛlɛnɔst
бомбаш	bɔmbaʃ
свртува	svr̩tuva
откочи	ɔtkɔt͡ʃi
смешност	smɛʃnɔst
насамарува	nasamaɾuva
предци	prɛtt͡si
проникнува	prɔniknuva
спорт	spɔrt
бензин	bɛnzin
кореја	kɔrɛja
надоаѓа	nadɔaɟa
овие	ɔvijɛ
аглест	aɡlɛst
чешмен	t͡ʃɛʃmɛn
монопол	mɔnɔpɔɫ
гратче	ɡratt͡ʃɛ
есцајг	ɛst͡sajk
докршува	dɔkr̩ʃuva
љубител	lubitɛɫ
изнабута	iznabuta
олтарски	ɔɫtarski
конфедерациски	kɔɱfɛdɛrat͡siski
реав	rɛaf
извиткува	izvitkuva
бутче	butt͡ʃɛ
добрина	dɔbrina
геотермален	ɡɛɔtɛrmalɛn
цвет	t͡svɛt
размерливост	razmɛrlivɔst
обор	ɔbɔr
централизација	t͡sɛntralizat͡sija
менливост	mɛnlivɔst
бестелесност	bɛstɛlɛsnɔst
ѕирка	d͡zirka
хеликоптери	xɛlikɔptɛɾi
вплетува	fplɛtuva
избрзува	izbr̩zuva
’рти	r̩ti
изнаделка	iznadɛɫka
гризнува	ɡriznuva
желевце	ʒɛlɛft͡sɛ
ружа	ruʒa
пица	pit͡sa
необучен	nɛɔbut͡ʃɛn
ѕверче	d͡zvɛrt͡ʃɛ
инфузија	infuzija
потпорасне	pɔtpɔɾasnɛ
маѓар	maɟar
даблински	dablinski
лимони	limɔni
премете	prɛmɛtɛ
намаленост	namalɛnɔst
чизмичка	t͡ʃizmit͡ʃka
превиткува	prɛvitkuva
рамка	ramka
спорост	spɔɾɔst
чудно	t͡ʃudnɔ
окрка	ɔkr̩ka
престолен	prɛstɔlɛn
оќорува	ɔcɔɾuva
масленце	maslɛnt͡sɛ
чистотник	t͡ʃistɔtnik
осумдесет	ɔsumdɛsɛt
правдољубивост	pravdɔlubivɔst
ѓуптин	ɟuptin
нострификација	nɔstrifikat͡sija
железнички	ʒɛlɛznit͡ʃki
шкембе	ʃkɛmbɛ
комотност	kɔmɔtnɔst
седело	sɛdɛɫɔ
неподобен	nɛpɔdɔbɛn
изналупа	iznaɫupa
најквирц	najkvirt͡s
ненареден	nɛnaɾɛdɛn
непробојност	nɛprɔbɔjnɔst
бебе	bɛbɛ
наглост	naɡɫɔst
четворче	t͡ʃɛtvɔrt͡ʃɛ
неоткриен	nɛɔtkrijɛn
прочепка	prɔt͡ʃɛpka
внатре	vnatrɛ
благодушност	bɫaɡɔduʃnɔst
болежливост	bɔlɛʒlivɔst
експресионистички	ɛksprɛsijɔnistit͡ʃki
песок	pɛsɔk
анемија	anɛmija
задоволителност	zadɔvɔlitɛɫnɔst
незаштитеност	nɛzaʃtitɛnɔst
чуварка	t͡ʃuvarka
става	stava
мевце	mɛft͡sɛ
умереност	umɛɾɛnɔst
пребродува	prɛbrɔduva
врзе	vr̩zɛ
засити	zasiti
пештерски	pɛʃtɛrski
коприва	kɔpriva
стандардизација	standardizat͡sija
гревче	ɡrɛft͡ʃɛ
несочуван	nɛsɔt͡ʃuvan
исходен	isxɔdɛn
меѓусебност	mɛɟusɛbnɔst
мовче	mɔft͡ʃɛ
ѓуптинка	ɟuptiŋka
испруженост	ispruʒɛnɔst
крој	krɔj
опсипува	ɔpsipuva
роб	rɔp
претседава	prɛtsɛdava
неспокојност	nɛspɔkɔjnɔst
жилавост	ʒiɫavɔst
јоргованов	jɔrɡɔvanɔf
овчарче	ɔft͡ʃart͡ʃɛ
губернија	ɡubɛrnija
билјар	biljar
извинувачки	izvinuvat͡ʃki
крт	kr̩t
архитектура	arxitɛktuɾa
зачукува	zat͡ʃukuva
докинува	dɔkinuva
испакнатост	ispaknatɔst
клавичембала	kɫavit͡ʃɛmbaɫa
недостижност	nɛdɔstiʒnɔst
живински	ʒivinski
доползи	dɔpɔɫzi
интонациски	intɔnat͡siski
животи	ʒivɔti
даб	dap
женава	ʒɛnava
обдарува	ɔbdaɾuva
колебливост	kɔlɛblivɔst
вонка	vɔŋka
волфрам	vɔɫfram
премореност	prɛmɔɾɛnɔst
јаболчест	jabɔɫt͡ʃɛst
хелсиншки	xɛɫsinʃki
уметница	umɛtnit͡sa
староликост	starɔlikɔst
наслутува	nasɫutuva
пајка	pajka
султанка	suɫtaŋka
сирење	siɾɛɲɛ
аргументациски	arɡumɛntat͡siski
курвичка	kurvit͡ʃka
килимар	kilimar
конфучиј	kɔɱfut͡ʃij
парада	parada
доруча	dɔɾut͡ʃa
месо	mɛsɔ
последен	pɔslɛdɛn
мрднува	mr̩dnuva
единаесет	ɛdinaɛsɛt
платински	pɫatinski
обезвластува	ɔbɛzvɫastuva
велосипед	vɛɫɔsipɛt
непокриен	nɛpɔkrijɛn
подразмести	pɔdrazmɛsti
фудбал	fudbaɫ
прднува	pr̩dnuva
градинарка	ɡradinarka
потрпи	pɔtr̩pi
сандала	sandaɫa
разбудува	razbuduva
интуиција	intuit͡sija
излачува	izɫat͡ʃuva
обесправеност	ɔbɛspravɛnɔst
чудесност	t͡ʃudɛsnɔst
расцути	rast͡suti
иницијација	init͡sijat͡sija
гостилничарка	ɡɔstiɫnit͡ʃarka
баш	baʃ
првородство	pr̩vɔrɔtstvɔ
кукличка	kuklit͡ʃka
картографија	kartɔɡrafija
курви	kurvi
предложи	prɛdɫɔʒi
каде	kadɛ
ненајаден	nɛnajadɛn
насапунува	nasapunuva
задавува	zadavuva
чембала	t͡ʃɛmbaɫa
готвач	ɡɔtvat͡ʃ
волнарство	vɔɫnarstvɔ
ек	ɛk
набабреност	nababrɛnɔst
кочан	kɔt͡ʃan
градови	ɡradɔvi
паунов	paunɔf
ананас	ananas
јавачка	javat͡ʃka
гои	ɡɔi
катаљарда	katalarda
коњушарски	kɔɲuʃarski
скрб	skr̩p
скопје	skɔpjɛ
пенис	pɛnis
формација	fɔrmat͡sija
научува	naut͡ʃuva
коритце	kɔɾitt͡sɛ
подискастри	pɔdiskastri
шверцерка	ʃvɛrt͡sɛrka
брбливост	br̩blivɔst
стабилизација	stabilizat͡sija
тешкичок	tɛʃkit͡ʃɔk
неизразен	nɛizrazɛn
воденичар	vɔdɛnit͡ʃar
одлазува	ɔdɫazuva
сосопственик	sɔsɔpstvɛnik
показен	pɔkazɛn
навлажнува	navɫaʒnuva
заб	zap
зимава	zimava
поткаже	pɔtkaʒɛ
резерват	rɛzɛrvat
доусовршува	dɔusɔvr̩ʃuva
дописничка	dɔpisnit͡ʃka
комисиски	kɔmisiski
рехабилитација	rɛxabilitat͡sija
апозиција	apɔzit͡sija
ѕвечало	d͡zvɛt͡ʃaɫɔ
егоцентричност	ɛɡɔt͡sɛntrit͡ʃnɔst
оддалеченост	ɔddalɛt͡ʃɛnɔst
сибирски	sibirski
кокосов	kɔkɔsɔf
дослушува	dɔsɫuʃuva
македонија	makɛdɔnija
екстраполација	ɛkstrapɔɫat͡sija
мимика	mimika
примрзи	primr̩zi
викинг	vikiŋk
темница	tɛmnit͡sa
приврзаност	privr̩zanɔst
преполовеност	prɛpɔɫɔvɛnɔst
амин	amin
угоре	uɡɔɾɛ
теснински	tɛsninski
резбарство	rɛzbarstvɔ
спинети	spinɛti
насадува	nasaduva
јагленов	jaɡlɛnɔf
изнаучи	iznaut͡ʃi
стаклар	stakɫar
босна	bɔsna
закржлавеност	zakr̩ʒɫavɛnɔst
трнинка	tr̩niŋka
асимилација	asimiɫat͡sija
или	ili
класификација	kɫasifikat͡sija
полжав	pɔɫʒaf
разнородност	raznɔɾɔdnɔst
ненамачкан	nɛnamat͡ʃkan
расчетка	raʃt͡ʃɛtka
часовничарски	t͡ʃasɔvnit͡ʃarski
воопшто	vɔɔpʃtɔ
отпадничка	ɔtpadnit͡ʃka
погрми	pɔɡr̩mi
загушува	zaɡuʃuva
прстен	pr̩stɛn
кадифе	kadifɛ
праведност	pravɛdnɔst
платно	pɫatnɔ
лекарство	lɛkarstvɔ
подостари	pɔdɔstaɾi
фенерче	fɛnɛrt͡ʃɛ
гранче	ɡrant͡ʃɛ
чуден	t͡ʃudɛn
ронче	rɔnt͡ʃɛ
снеговица	snɛɡɔvit͡sa
срнче	sr̩nt͡ʃɛ
конзул	kɔnzuɫ
пребара	prɛbaɾa
земјоделство	zɛmjɔdɛɫstvɔ
контактен	kɔntaktɛn
новини	nɔvini
блазонирање	bɫazɔniɾaɲɛ
обезименува	ɔbɛzimɛnuva
соматски	sɔmatski
преморува	prɛmɔɾuva
расположлив	raspɔɫɔʒlif
белило	bɛliɫɔ
порнографија	pɔrnɔɡrafija
полковнички	pɔɫkɔvnit͡ʃki
распласти	raspɫasti
чинија	t͡ʃinija
цица	t͡sit͡sa
енергичност	ɛnɛrɡit͡ʃnɔst
закитува	zakituva
испогмечи	ispɔɡmɛt͡ʃi
помагач	pɔmaɡat͡ʃ
мравка	mrafka
тенис	tɛnis
јазол	jazɔɫ
ишка	iʃka
блокче	bɫɔkt͡ʃɛ
искорнува	iskɔrnuva
работа	rabɔta
разговорливост	razɡɔvɔrlivɔst
семестарски	sɛmɛstarski
џуџенце	d͡ʒud͡ʒɛnt͡sɛ
премреже	prɛmrɛʒɛ
недорешен	nɛdɔɾɛʃɛn
угарење	uɡaɾɛɲɛ
спрат	sprat
зачмаеност	zat͡ʃmaɛnɔst
бечви	bɛt͡ʃvi
сиромашност	sirɔmaʃnɔst
вера	vɛɾa
академија	akadɛmija
јунаштво	junaʃtvɔ
јаженце	jaʒɛnt͡sɛ
занишува	zaniʃuva
софија	sɔfija
фалта	faɫta
сува	suva
отрезнува	ɔtrɛznuva
опојност	ɔpɔjnɔst
клер	klɛr
пиво	pivɔ
наликува	nalikuva
сесија	sɛsija
кавгаџика	kavɡad͡ʒika
копјенце	kɔpjɛnt͡sɛ
доткајува	dɔtkajuva
одлази	ɔdɫazi
иловица	iɫɔvit͡sa
дува	duva
шлапа	ʃɫapa
прслуче	pr̩sɫut͡ʃɛ
ѓуле	ɟulɛ
вага	vaɡa
порабува	pɔrabuva
мечиња	mɛt͡ʃiɲa
циркуски	t͡sirkuski
туткав	tutkaf
шестотини	ʃɛstɔtini
борење	bɔɾɛɲɛ
радарски	radarski
незачуван	nɛzat͡ʃuvan
крштелен	kr̩ʃtɛlɛn
ветровит	vɛtrɔvit
зградичка	zɡradit͡ʃka
корелација	kɔɾɛɫat͡sija
императорка	impɛratɔrka
крај	kraj
виткост	vitkɔst
птица	ptit͡sa
рака	raka
надничарски	nadnit͡ʃarski
свинче	svint͡ʃɛ
бубрежен	bubrɛʒɛn
гуде	ɡudɛ
исполаже	ispɔɫaʒɛ
репетициски	rɛpɛtit͡siski
викендичка	vikɛndit͡ʃka
бомбардер	bɔmbardɛr
тигарски	tiɡarski
испоздрави	ispɔzdravi
измрсува	izmr̩suva
околен	ɔkɔlɛn
конкуренција	kɔŋkurɛnt͡sija
македонец	makɛdɔnɛt͡s
буков	bukɔf
жонглерство	ʒɔŋɡlɛrstvɔ
бесови	bɛsɔvi
изеде	izɛdɛ
изнамачка	iznamat͡ʃka
дабов	dabɔf
преопредели	prɛɔprɛdɛli
нетолеранција	nɛtɔlɛrant͡sija
доследност	dɔslɛdnɔst
снегулка	snɛɡuɫka
облак	ɔbɫak
драгоценост	draɡɔt͡sɛnɔst
гушнува	ɡuʃnuva
разработи	razrabɔti
корпорациски	kɔrpɔrat͡siski
увезувач	uvɛzuvat͡ʃ
куцнува	kut͡snuva
паркинг	parkiŋk
повари	pɔvaɾi
физиологија	fizijɔɫɔɡija
кратковечност	kratkɔvɛt͡ʃnɔst
бумбар	bumbar
јер	jɛr
ферментација	fɛrmɛntat͡sija
спроводник	sprɔvɔdnik
должничка	dɔɫʒnit͡ʃka
делфински	dɛɫfinski
подраспара	pɔdraspaɾa
служба	sɫuʒba
постепеност	pɔstɛpɛnɔst
грмувче	ɡr̩muft͡ʃɛ
фараон	faɾaɔn
подразголи	pɔdrazɡɔli
крчма	kr̩t͡ʃma
ѓаволка	ɟavɔɫka
неделивост	nɛdɛlivɔst
разбере	razbɛɾɛ
петунија	pɛtunija
четворица	t͡ʃɛtvɔɾit͡sa
видричка	vidrit͡ʃka
покровителка	pɔkrɔvitɛɫka
подзатемни	pɔdzatɛmni
виснува	visnuva
бадем	badɛm
турист	turist
надмоќност	nadmɔcnɔst
запливува	zaplivuva
лавче	ɫaft͡ʃɛ
кутриња	kutriɲa
редакторски	rɛdaktɔrski
композициски	kɔmpɔzit͡siski
базалтов	bazaɫtɔf
взори	vzɔɾi
космонаутка	kɔsmɔnautka
алитерација	alitɛrat͡sija
одборник	ɔdbɔrnik
јурнува	jurnuva
одвиткува	ɔdvitkuva
завева	zavɛva
маѓепсаност	maɟɛpsanɔst
посебност	pɔsɛbnɔst
загледаност	zaɡlɛdanɔst
несоодветност	nɛsɔɔdvɛtnɔst
застапеност	zastapɛnɔst
подзаниша	pɔdzaniʃa
брезов	brɛzɔf
пуши	puʃi
филологија	fiɫɔɫɔɡija
реализација	rɛalizat͡sija
весел	vɛsɛɫ
изделка	izdɛɫka
хомофонија	xɔmɔfɔnija
запалка	zapaɫka
немилосрдие	nɛmiɫɔsr̩dijɛ
бура	buɾa
каснува	kasnuva
флејтист	flɛjtist
неизводливост	nɛizvɔdlivɔst
дождови	dɔʒdɔvi
бесплотност	bɛspɫɔtnɔst
гајда	ɡajda
аристотел	aɾistɔtɛɫ
сиже	siʒɛ
отрпнува	ɔtr̩pnuva
датив	datif
русинка	rusiŋka
квасец	kvasɛt͡s
соговорница	sɔɡɔvɔrnit͡sa
мирис	miɾis
другар	druɡar
ситничавост	sitnit͡ʃavɔst
транспозиција	transpɔzit͡sija
ќупче	cupt͡ʃɛ
дните	dnitɛ
предосеќа	prɛdɔsɛca
ран	ran
фати	fati
семе	sɛmɛ
овенатост	ɔvɛnatɔst
непретпазливост	nɛprɛtpazlivɔst
денар	dɛnar
флорет	fɫɔrɛt
воинство	vɔinstvɔ
посредништво	pɔsrɛdniʃtvɔ
беспокојност	bɛspɔkɔjnɔst
попишувач	pɔpiʃuvat͡ʃ
избраница	izbranit͡sa
квадратче	kvadratt͡ʃɛ
писмо	pismɔ
побрбори	pɔbr̩bɔɾi
меланхоличност	mɛɫanxɔlit͡ʃnɔst
плет	plɛt
свилест	svilɛst
денон	dɛnɔn
исцицува	ist͡sit͡suva
слово	sɫɔvɔ
овација	ɔvat͡sija
македонка	makɛdɔŋka
распаднатост	raspadnatɔst
мангупче	maŋɡupt͡ʃɛ
коледе	kɔlɛdɛ
јаболче	jabɔɫt͡ʃɛ
вишок	viʃɔk
растение	rastɛnijɛ
зборче	zbɔrt͡ʃɛ
тапанче	tapant͡ʃɛ
собитие	sɔbitijɛ
вода	vɔda
плотски	pɫɔtski
звање	zvaɲɛ
шнајдерка	ʃnajdɛrka
глогов	ɡɫɔɡɔf
оксидација	ɔksidat͡sija
згрешува	zɡrɛʃuva
конференциски	kɔɱfɛrɛnt͡siski
тркачки	tr̩kat͡ʃki
назад	nazat
презрева	prɛzrɛva
реума	rɛuma
боксови	bɔksɔvi
незакотвен	nɛzakɔtvɛn
ориз	ɔɾis
том	tɔm
абажур	abaʒur
формализација	fɔrmalizat͡sija
братов	bratɔf
ќилим	cilim
рисјанин	risjanin
црвило	t͡sr̩viɫɔ
изнагнете	iznaɡnɛtɛ
пушта	puʃta
виме	vimɛ
светлост	svɛtɫɔst
поборник	pɔbɔrnik
слеан	slɛan
успех	uspɛx
живописен	ʒivɔpisɛn
сонценце	sɔnt͡sɛnt͡sɛ
зажуборува	zaʒubɔɾuva
чекан	t͡ʃɛkan
другарка	druɡarka
јаготче	jaɡɔtt͡ʃɛ
чепорест	t͡ʃɛpɔɾɛst
збрка	zbr̩ka
назадува	nazaduva
златест	zɫatɛst
групација	ɡrupat͡sija
изнастава	iznastava
бунар	bunar
вход	fxɔt
кафуле	kafulɛ
истрчува	istr̩t͡ʃuva
везиров	vɛziɾɔf
везе	vɛzɛ
стаписаност	stapisanɔst
интервју	intɛrvju
подгорчува	pɔdɡɔrt͡ʃuva
отец	ɔtɛt͡s
сабајле	sabajlɛ
посегнува	pɔsɛɡnuva
сеул	sɛuɫ
студент	studɛnt
констатација	kɔnstatat͡sija
залепува	zalɛpuva
лунѕа	ɫund͡za
сестраност	sɛstranɔst
подослободи	pɔdɔsɫɔbɔdi
орјатка	ɔrjatka
поларизациски	pɔɫaɾizat͡siski
збороред	zbɔɾɔɾɛt
многупати	mnɔɡupati
лошотија	ɫɔʃɔtija
условност	usɫɔvnɔst
седларски	sɛdɫarski
преиспита	prɛispita
пишуваат	piʃuvaat
три	tri
штичка	ʃtit͡ʃka
неумоливост	nɛumɔlivɔst
пливање	plivaɲɛ
кусур	kusur
целосен	t͡sɛɫɔsɛn
предочува	prɛdɔt͡ʃuva
воспаленост	vɔspalɛnɔst
втрча	ftr̩t͡ʃa
велик	vɛlik
егзибиција	ɛɡzibit͡sija
ловџиски	ɫɔvd͡ʒiski
ќос	cɔs
неоснован	nɛɔsnɔvan
инквизициски	iŋkvizit͡siski
првостепен	pr̩vɔstɛpɛn
студентка	studɛntka
симболизација	simbɔlizat͡sija
злоупотребувач	zɫɔupɔtrɛbuvat͡ʃ
лутециум	ɫutɛt͡sijum
древност	drɛvnɔst
чеканче	t͡ʃɛkant͡ʃɛ
година	ɡɔdina
паун	paun
штурец	ʃtuɾɛt͡s
ситничарски	sitnit͡ʃarski
ливаѓе	livaɟɛ
запрегнува	zaprɛɡnuva
кристал	kristaɫ
втораче	ftɔɾat͡ʃɛ
песничка	pɛsnit͡ʃka
вампирски	vampirski
писменце	pismɛnt͡sɛ
бујрум	bujrum
простодушност	prɔstɔduʃnɔst
маало	maaɫɔ
невистина	nɛvistina
подозривост	pɔdɔzrivɔst
кукле	kuklɛ
аџиски	ad͡ʒiski
преобликува	prɛɔblikuva
предучилиштен	prɛdut͡ʃiliʃtɛn
ткајачка	tkajat͡ʃka
артикулација	artikuɫat͡sija
овошје	ɔvɔʃjɛ
цутне	t͡sutnɛ
закуп	zakup
застарува	zastaɾuva
ѓон	ɟɔn
ладничок	ɫadnit͡ʃɔk
палка	paɫka
заговорница	zaɡɔvɔrnit͡sa
кратковид	kratkɔvit
лондонец	ɫɔndɔnɛt͡s
пробив	prɔbif
наука	nauka
доставувач	dɔstavuvat͡ʃ
токиски	tɔkiski
грбоносец	ɡr̩bɔnɔsɛt͡s
огласен	ɔɡɫasɛn
пресретне	prɛsrɛtnɛ
седмица	sɛdmit͡sa
пеперуткин	pɛpɛɾutkin
опипува	ɔpipuva
шаховски	ʃaxɔfski
берлински	bɛrlinski
прашки	praʃki
блато	bɫatɔ
претставништво	prɛtstavniʃtvɔ
изнакваси	iznakvasi
зародиш	zaɾɔdiʃ
грижливост	ɡriʒlivɔst
претплатничка	prɛtpɫatnit͡ʃka
немост	nɛmɔst
нередовност	nɛrɛdɔvnɔst
клада	kɫada
јуница	junit͡sa
муленце	mulɛnt͡sɛ
надморски	nadmɔrski
биоенергија	bijɔɛnɛrɡija
тексас	tɛksas
жали	ʒali
курварство	kurvarstvɔ
лигуш	liɡuʃ
свеќарски	svɛcarski
ербап	ɛrbap
љубопитност	ʎubɔpitnɔst
подзамиже	pɔdzamiʒɛ
заканувачки	zakanuvat͡ʃki
божилак	bɔʒiɫak
отвора	ɔtvɔɾa
врапчуле	vrapt͡ʃulɛ
трзачки	tr̩zat͡ʃki
куре	kuɾɛ
кои	kɔi
умешност	umɛʃnɔst
зарекува	zarɛkuva
кутивче	kutift͡ʃɛ
нормализација	nɔrmalizat͡sija
непрекинатост	nɛprɛkinatɔst
омекнатост	ɔmɛknatɔst
шешир	ʃɛʃir
јајцест	jajt͡sɛst
јадови	jadɔvi
вкочанетост	fkɔt͡ʃanɛtɔst
оривче	ɔɾift͡ʃɛ
разбој	razbɔj
двоуснен	dvɔusnɛn
затоа	zatɔa
воспалителен	vɔspalitɛlɛn
елиминација	ɛliminat͡sija
ако	akɔ
чорапче	t͡ʃɔɾapt͡ʃɛ
духовништво	duxɔvniʃtvɔ
сословие	sɔsɫɔvijɛ
крзнарство	kr̩znarstvɔ
уши	uʃi
смрт	smr̩t
одбранува	ɔdbranuva
сандаче	sandat͡ʃɛ
водиште	vɔdiʃtɛ
кујничка	kujnit͡ʃka
цигари	t͡siɡaɾi
сингапур	siŋɡapur
топот	tɔpɔt
евруле	ɛvrulɛ
србин	sr̩bin
отпишува	ɔtpiʃuva
превземе	prɛvzɛmɛ
наплиска	napliska
јавува	javuva
уреднички	urɛdnit͡ʃki
предлага	prɛdɫaɡa
неизрамнет	nɛizramnɛt
живописност	ʒivɔpisnɔst
незакрепнатост	nɛzakrɛpnatɔst
надградува	nadɡraduva
оскудност	ɔskudnɔst
бурност	burnɔst
конфигурација	kɔɱfiɡurat͡sija
колонизациски	kɔɫɔnizat͡siski
ботови	bɔtɔvi
морковче	mɔrkɔft͡ʃɛ
грубијанство	ɡrubijanstvɔ
парталче	partaɫt͡ʃɛ
регистрација	rɛɡistrat͡sija
подзакачи	pɔdzakat͡ʃi
шејтан	ʃɛjtan
рицар	rit͡sar
докројува	dɔkrɔjuva
виолина	vijɔlina
отвори	ɔtvɔɾi
досетливост	dɔsɛtlivɔst
умник	umnik
тимбу	timbu
крзно	kr̩znɔ
очи	ɔt͡ʃi
конгрес	kɔŋɡrɛs
недоразвиен	nɛdɔrazvijɛn
противприроден	prɔtifpriɾɔdɛn
конјугациски	kɔnjuɡat͡siski
житен	ʒitɛn
сарма	sarma
персиски	pɛrsiski
неколку	nɛkɔlku
претседателство	prɛtsɛdatɛɫstvɔ
подисправи	pɔdispravi
просветен	prɔsvɛtɛn
обесштетува	ɔbɛʃʃtɛtuva
мачителка	mat͡ʃitɛɫka
бендисува	bɛndisuva
нотарски	nɔtarski
деловник	dɛɫɔvnik
лиснат	lisnat
братучедски	bratut͡ʃɛtski
двостраност	dvɔstranɔst
заборавеност	zabɔravɛnɔst
цвеќарски	t͡svɛcarski
фирма	firma
роботизација	rɔbɔtizat͡sija
извонредност	izvɔnrɛdnɔst
завет	zavɛt
изнадроби	iznadrɔbi
дефинициски	dɛfinit͡siski
емитува	ɛmituva
јаз	jas
конверзациски	kɔɱvɛrzat͡siski
брборка	br̩bɔrka
снежиња	snɛʒiɲa
видело	vidɛɫɔ
блудствува	bɫutstvuva
мерило	mɛɾiɫɔ
озвучи	ɔzvut͡ʃi
овчар	ɔft͡ʃar
ноздра	nɔzdra
апозициски	apɔzit͡siski
петлов	pɛtɫɔf
чешма	t͡ʃɛʃma
дени	dɛni
лисабон	lisabɔn
ведро	vɛdrɔ
поднаближува	pɔdnabliʒuva
мажон	maʒɔn
берберница	bɛrbɛrnit͡sa
месарка	mɛsarka
сармичка	sarmit͡ʃka
сликарски	slikarski
фреквенциски	frɛkvɛnt͡siski
фондовски	fɔndɔfski
крикет	krikɛt
несовесност	nɛsɔvɛsnɔst
недоличност	nɛdɔlit͡ʃnɔst
едвај	ɛdvaj
бунарче	bunart͡ʃɛ
село	sɛɫɔ
основен	ɔsnɔvɛn
координаторски	kɔɔrdinatɔrski
рецитација	rɛt͡sitat͡sija
вчера	ft͡ʃɛɾa
бутан	butan
родоотстапник	rɔdɔɔtstapnik
кришум	kriʃum
октомври	ɔktɔɱvri
јагула	jaɡuɫa
бои	bɔi
дивокоза	divɔkɔza
испозагине	ispɔzaɡinɛ
бајачки	bajat͡ʃki
претприемчивост	prɛtprijɛmt͡ʃivɔst
опседнатост	ɔpsɛdnatɔst
авиокомпанија	avijɔkɔmpanija
начелен	nat͡ʃɛlɛn
пандан	pandan
чајче	t͡ʃajt͡ʃɛ
опијанетост	ɔpijanɛtɔst
кукичка	kukit͡ʃka
калуѓерство	kaɫuɟɛrstvɔ
веб	vɛp
комби	kɔmbi
суфикс	sufiks
череп	t͡ʃɛɾɛp
мачиште	mat͡ʃiʃtɛ
палто	paɫtɔ
дегустација	dɛɡustat͡sija
неразбирливост	nɛɾazbirlivɔst
нотарка	nɔtarka
отуѓеност	ɔtuɟɛnɔst
лупи	ɫupi
отсечност	ɔtsɛt͡ʃnɔst
летнува	lɛtnuva
конзерваториум	kɔnzɛrvatɔɾijum
шрафче	ʃraft͡ʃɛ
незаоблен	nɛzaɔblɛn
неостварливост	nɛɔstvarlivɔst
оќори	ɔcɔɾi
бирократизација	biɾɔkratizat͡sija
гумичка	ɡumit͡ʃka
сонетен	sɔnɛtɛn
деспот	dɛspɔt
луѓево	ɫuɟɛvɔ
идолопоклонство	idɔɫɔpɔkɫɔnstvɔ
ереван	ɛɾɛvan
тенорски	tɛnɔrski
имено	imɛnɔ
шестмина	ʃɛstmina
бруцош	brut͡sɔʃ
пречисти	prɛt͡ʃisti
филхармонија	fiɫxarmɔnija
јајник	jajnik
недобушен	nɛdɔbuʃɛn
храм	xram
насоли	nasɔli
камшик	kamʃik
фотогеничност	fɔtɔɡɛnit͡ʃnɔst
ној	nɔj
снег	snɛk
спорен	spɔɾɛn
сено	sɛnɔ
воин	vɔin
океан	ɔkɛan
услужува	usɫuʒuva
купувачки	kupuvat͡ʃki
свињарски	sviɲarski
рениум	rɛnijum
шеќер	ʃɛcɛr
чорба	t͡ʃɔrba
изнагали	iznaɡali
утре	utrɛ
да	daː
стреличарство	strɛlit͡ʃarstvɔ
зборообразување	zbɔɾɔɔbrazuvaɲɛ
варов	vaɾɔf
фурнаџија	furnad͡ʒija
откупувач	ɔtkupuvat͡ʃ
кристализација	kristalizat͡sija
соин	sɔin
гледачки	ɡlɛdat͡ʃki
партицип	partit͡sip
пресретливост	prɛsrɛtlivɔst
дотркала	dɔtr̩kaɫa
разностраност	raznɔstranɔst
устичка	ustit͡ʃka
инспекторка	inspɛktɔrka
тбилисиски	dbilisiski
оклопен	ɔkɫɔpɛn
ташничка	taʃnit͡ʃka
раселува	rasɛɫuva
недвижности	nɛdviʒnɔsti
двонасочност	dvɔnasɔt͡ʃnɔst
сабја	sabja
грција	ɡr̩t͡sija
иселеништво	isɛlɛniʃtvɔ
климатизација	klimatizat͡sija
асови	asɔvi
јужњак	juʒɲak
искривоколчува	iskrivɔkɔɫt͡ʃuva
милениче	milɛnit͡ʃɛ
ѕвезди	d͡zvɛzdi
бангладеш	baŋɡɫadɛʃ
првобитност	pr̩vɔbitnɔst
кров	krɔf
ваму	vamu
медовина	mɛdɔvina
неопходност	nɛɔpxɔdnɔst
хрват	xr̩vat
врапченце	vrapt͡ʃɛnt͡sɛ
шума	ʃuma
детонација	dɛtɔnat͡sija
изнасече	iznasɛt͡ʃɛ
ѕверство	d͡zvɛrstvɔ
агрономија	aɡrɔnɔmija
оглупавеност	ɔɡɫupavɛnɔst
разредувач	razrɛduvat͡ʃ
послика	pɔslika
згуснувач	zɡusnuvat͡ʃ
подзачешла	pɔdzat͡ʃɛʃɫa
испонастине	ispɔnastinɛ
женски	ʒɛnski
круша	kruʃa
заматува	zamatuva
грабливост	ɡrablivɔst
расеаност	rasɛanɔst
труп	trup
човека	t͡ʃɔvɛka
есен	ɛsɛn
запаметува	zapamɛtuva
громогласност	ɡrɔmɔɡɫasnɔst
вепар	vɛpar
клаустрофобија	kɫaustrɔfɔbija
недоучен	nɛdɔut͡ʃɛn
мрсул	mr̩suɫ
разгаштува	razɡaʃtuva
екран	ɛkran
сечач	sɛt͡ʃat͡ʃ
комичност	kɔmit͡ʃnɔst
нескротливост	nɛskrɔtlivɔst
одбегнува	ɔdbɛɡnuva
натрапничка	natrapnit͡ʃka
прегледа	prɛɡlɛda
безропотност	bɛzrɔpɔtnɔst
доцртува	dɔt͡sr̩tuva
палеонтологија	palɛɔntɔɫɔɡija
пазарџија	pazard͡ʒija
бесценетост	bɛst͡sɛnɛtɔst
попишти	pɔpiʃti
управен	upravɛn
неуставност	nɛustavnɔst
шокираност	ʃɔkiɾanɔst
пикнува	piknuva
ритмичност	ritmit͡ʃnɔst
палче	paɫt͡ʃɛ
љубовџиски	lubɔvd͡ʒiski
испорака	ispɔɾaka
поднастине	pɔdnastinɛ
кљанкање	klaŋkaɲɛ
петел	pɛtɛɫ
конта	kɔnta
неодговорност	nɛɔdɡɔvɔrnɔst
полупа	pɔɫupa
тој	tɔj
огледалце	ɔɡlɛdaɫt͡sɛ
опавче	ɔpaft͡ʃɛ
настрадува	nastraduva
механичарски	mɛxanit͡ʃarski
трафика	trafika
свирење	sviɾɛɲɛ
помрачува	pɔmrat͡ʃuva
црвливост	t͡sr̩vlivɔst
’рѓа	r̩ɟa
насее	nasɛɛ
хит	xit
незамисливост	nɛzamislivɔst
литарски	litarski
кадравост	kadravɔst
интересчија	intɛrɛʃt͡ʃija
испофрла	ispɔfr̩ɫa
црвен	t͡sr̩vɛn
блудник	bɫudnik
моторен	mɔtɔɾɛn
јаболчница	jabɔɫt͡ʃnit͡sa
сунѓерче	sunɟɛrt͡ʃɛ
нелегален	nɛlɛɡalɛn
загадочност	zaɡadɔt͡ʃnɔst
пасија	pasija
криволов	krivɔɫɔf
стомничка	stɔmnit͡ʃka
пупче	pupt͡ʃɛ
ѓерданче	ɟɛrdant͡ʃɛ
дишење	diʃɛɲɛ
даде	dadɛ
кондензатор	kɔndɛnzatɔr
компонента	kɔmpɔnɛnta
годинашен	ɡɔdinaʃɛn
нестабилност	nɛstabiɫnɔst
врач	vrat͡ʃ
кромид	krɔmit
лизнува	liznuva
доделка	dɔdɛɫka
погалува	pɔɡaɫuva
ѕвекот	d͡zvɛkɔt
деца	dɛt͡sa
њујоршки	ɲujɔrʃki
мрежичка	mrɛʒit͡ʃka
озрачува	ɔzrat͡ʃuva
непрокопсаност	nɛprɔkɔpsanɔst
збрца	zbr̩t͡sa
неразреден	nɛrazrɛdɛn
стена	stɛna
проклитика	prɔklitika
глувче	ɡɫuft͡ʃɛ
предипли	prɛdipli
полжавче	pɔɫʒaft͡ʃɛ
издушува	izduʃuva
тишина	tiʃina
провокаторски	prɔvɔkatɔrski
детуле	dɛtulɛ
прекумерност	prɛkumɛrnɔst
домазни	dɔmazni
државност	dr̩ʒavnɔst
рејкјавички	rɛjkjavit͡ʃki
пониша	pɔniʃa
затвореност	zatvɔɾɛnɔst
алигатор	aliɡatɔr
дух	dux
осло	ɔsɫɔ
потекува	pɔtɛkuva
безбол	bɛzbɔɫ
безначајност	bɛznat͡ʃajnɔst
мравче	mraft͡ʃɛ
деливост	dɛlivɔst
раштрканост	raʃtr̩kanɔst
младоженски	mɫadɔʒɛnski
отчукува	ɔtt͡ʃukuva
дрндало	dr̩ndaɫɔ
тесар	tɛsar
шумолење	ʃumɔlɛɲɛ
горчливост	ɡɔrt͡ʃlivɔst
кафиња	kafiɲa
недостоинственост	nɛdɔstɔinstvɛnɔst
погори	pɔɡɔɾi
јаболко	jabɔɫkɔ
особеност	ɔsɔbɛnɔst
примеса	primɛsa
кинетика	kinɛtika
презаспива	prɛzaspiva
суд	sut
цеца	t͡sɛt͡sa
дотопи	dɔtɔpi
пролив	prɔlif
распуштеност	raspuʃtɛnɔst
авиони	avijɔni
календар	kalɛndar
илустрација	iɫustrat͡sija
гласче	ɡɫaʃt͡ʃɛ
граѓанин	ɡraɟanin
ѓаурка	ɟaurka
козарство	kɔzarstvɔ
ненормалност	nɛnɔrmaɫnɔst
раситнува	rasitnuva
билјарство	biljarstvɔ
опис	ɔpis
сценографија	st͡sɛnɔɡrafija
декорација	dɛkɔrat͡sija
противречен	prɔtivrɛt͡ʃɛn
довлекува	dɔvlɛkuva
пара	paɾa
неупотребен	nɛupɔtrɛbɛn
тужбен	tuʒbɛn
брутови	brutɔvi
дивјачка	divjat͡ʃka
трбушен	tr̩buʃɛn
изнареди	iznaɾɛdi
бандитски	banditski
економичност	ɛkɔnɔmit͡ʃnɔst
умее	umɛɛ
колаче	kɔɫat͡ʃɛ
оптегнува	ɔptɛɡnuva
заточение	zatɔt͡ʃɛnijɛ
уметништво	umɛtniʃtvɔ
загатка	zaɡatka
краварски	kravarski
прасенце	prasɛnt͡sɛ
изедува	izɛduva
ситничарка	sitnit͡ʃarka
елки	ɛɫki
инсталациски	instaɫat͡siski
пијан	pijan
партал	partaɫ
овнешки	ɔvnɛʃki
догребува	dɔɡrɛbuva
циција	t͡sit͡sija
наобразба	naɔbrazba
неповрзаност	nɛpɔvr̩zanɔst
мил	miɫ
регулаторски	rɛɡuɫatɔrski
развлеченост	razvlɛt͡ʃɛnɔst
брисел	brisɛɫ
автостоперка	aftɔstɔpɛrka
мерач	mɛɾat͡ʃ
ласерски	ɫasɛrski
онтологија	ɔntɔɫɔɡija
пет	pɛt
математичарка	matɛmatit͡ʃarka
полула	pɔɫuɫa
хотелски	xɔtɛɫski
бродоградба	brɔdɔɡradba
слаткарски	sɫatkarski
нацеди	nat͡sɛdi
попреченост	pɔprɛt͡ʃɛnɔst
размазеност	razmazɛnɔst
сауна	sauna
помодреност	pɔmɔdrɛnɔst
фотоќелија	fɔtɔcɛlija
поврат	pɔvrat
постенка	pɔstɛŋka
потчинува	pɔtt͡ʃinuva
заложник	zaɫɔʒnik
бранува	branuva
превезе	prɛvɛzɛ
многу	mnɔɡu
ковче	kɔft͡ʃɛ
испопрска	ispɔpr̩ska
раскове	raskɔvɛ
гнет	ɡnɛt
качамак	kat͡ʃamak
дниве	dnivɛ
едукација	ɛdukat͡sija
политичарски	pɔlitit͡ʃarski
метличка	mɛtlit͡ʃka
сака	saka
тим	tim
испоцрка	ispɔt͡sr̩ka
интерпретациски	intɛrprɛtat͡siski
ѕвекнува	d͡zvɛknuva
сублимација	sublimat͡sija
ракомет	rakɔmɛt
чешелче	t͡ʃɛʃɛɫt͡ʃɛ
редупликација	rɛduplikat͡sija
ручек	rut͡ʃɛk
пердув	pɛrduf
бискупов	biskupɔf
млекарски	mlɛkarski
околност	ɔkɔɫnɔst
животност	ʒivɔtnɔst
нечитливост	nɛt͡ʃitlivɔst
кајче	kajt͡ʃɛ
паликирски	palikirski
пченче	pt͡ʃɛnt͡ʃɛ
среденост	srɛdɛnɔst
фустан	fustan
полунаводник	pɔɫunavɔdnik
усрден	usr̩dɛn
борови	bɔɾɔvi
бунгалов	buŋɡaɫɔf
изрипува	izripuva
противположен	prɔtifpɔɫɔʒɛn
рендгенски	rɛndɡɛnski
викиречник	vikirɛt͡ʃnik
копито	kɔpitɔ
четиристотини	t͡ʃɛtiɾistɔtini
намеси	namɛsi
петнаесет	pɛtnaɛsɛt
мора	mɔɾa
смарагден	smaɾaɡdɛn
прелистувач	prɛlistuvat͡ʃ
безготовински	bɛzɡɔtɔvinski
потхранетост	pɔtxranɛtɔst
превитка	prɛvitka
островче	ɔstrɔft͡ʃɛ
ветрило	vɛtriɫɔ
лимон	limɔn
аспирација	aspirat͡sija
испопука	ispɔpuka
превари	prɛvaɾi
возбуденост	vɔzbudɛnɔst
безобличност	bɛzɔblit͡ʃnɔst
закалува	zakaɫuva
испосник	ispɔsnik
испосере	ispɔsɛɾɛ
изготви	izɡɔtvi
препржува	prɛpr̩ʒuva
бессилност	bɛssiɫnɔst
возила	vɔziɫa
залез	zalɛs
мудрува	mudruva
штедрост	ʃtɛdrɔst
тесноградост	tɛsnɔɡradɔst
заора	zaɔɾa
победител	pɔbɛditɛɫ
намуртеност	namurtɛnɔst
недопржен	nɛdɔpr̩ʒɛn
харизматичност	xaɾizmatit͡ʃnɔst
пукнува	puknuva
потписник	pɔtpisnik
плукалник	pɫukaɫnik
распашува	raspaʃuva
поимник	pɔimnik
остарува	ɔstaɾuva
копаничар	kɔpanit͡ʃar
чај	t͡ʃaj
многулик	mnɔɡulik
тесто	tɛstɔ
дообјаснува	dɔɔbjasnuva
ѕидарство	d͡zidarstvɔ
солзичка	sɔɫzit͡ʃka
анови	anɔvi
соперничка	sɔpɛrnit͡ʃka
механизација	mɛxanizat͡sija
се	sɛ
овес	ɔvɛs
изморува	izmɔɾuva
станува	stanuva
прописност	prɔpisnɔst
редукција	rɛdukt͡sija
недоставен	nɛdɔstavɛn
безрадосност	bɛzradɔsnɔst
препечати	prɛpɛt͡ʃati
разговор	razɡɔvɔr
дипломатија	dipɫɔmatija
опстојува	ɔpstɔjuva
вознемирувачки	vɔznɛmiruvat͡ʃki
хидрант	xidrant
мечувалка	mɛt͡ʃuvaɫka
чпп	t͡ʃəpəpə
бојлерче	bɔjlɛrt͡ʃɛ
издашност	izdaʃnɔst
отсвирува	ɔtsviɾuva
дворјанство	dvɔrjanstvɔ
професорство	prɔfɛsɔrstvɔ
магаренце	maɡaɾɛnt͡sɛ
слончиња	sɫɔnt͡ʃiɲa
хемичарски	xɛmit͡ʃarski
заледеност	zalɛdɛnɔst
париче	paɾit͡ʃɛ
момин	mɔmin
близост	blizɔst
сомот	sɔmɔt
разгаштеност	razɡaʃtɛnɔst
лицитаторски	lit͡sitatɔrski
будимпештански	budimpɛʃtanski
неделник	nɛdɛɫnik
додека	dɔdɛka
заслепувачки	zaslɛpuvat͡ʃki
научноистражувачки	naut͡ʃnɔistraʒuvat͡ʃki
неточност	nɛtɔt͡ʃnɔst
пчеличка	pt͡ʃɛlit͡ʃka
кликнува	kliknuva
препараторски	prɛparatɔrski
корупција	kɔrupt͡sija
населеност	nasɛlɛnɔst
мажу	maʒu
аклиматизација	aklimatizat͡sija
добрососедство	dɔbrɔsɔsɛtstvɔ
радиоемисија	radijɔɛmisija
маченце	mat͡ʃɛnt͡sɛ
нов	nɔf
чембалистка	t͡ʃɛmbalistka
погледнува	pɔɡlɛdnuva
реставраторски	rɛstavratɔrski
жиличка	ʒilit͡ʃka
тетратче	tɛtratt͡ʃɛ
недоволност	nɛdɔvɔɫnɔst
богобојазливост	bɔɡɔbɔjazlivɔst
готварски	ɡɔtvarski
волчјак	vɔɫt͡ʃjak
неприкладност	nɛprikɫadnɔst
заматеност	zamatɛnɔst
води	vɔdi
имиграција	imiɡrat͡sija
човекољубивост	t͡ʃɔvɛkɔlubivɔst
беспокојство	bɛspɔkɔjstvɔ
чајџилници	t͡ʃajd͡ʒiɫnit͡si
испреплетува	isprɛplɛtuva
бесповратност	bɛspɔvratnɔst
платформа	pɫatfɔrma
келнер	kɛɫnɛr
шверцер	ʃvɛrt͡sɛr
додиплува	dɔdipɫuva
реконструкциски	rɛkɔnstrukt͡siski
скијање	skijaɲɛ
момчештво	mɔmt͡ʃɛʃtvɔ
дрзок	dr̩zɔk
брцнува	br̩t͡snuva
букурешт	bukuɾɛʃt
почива	pɔt͡ʃiva
истовремено	istɔvrɛmɛnɔ
обзнани	ɔbznani
братуле	bratulɛ
премрзне	prɛmr̩znɛ
кугла	kuɡɫa
презаситеност	prɛzasitɛnɔst
загрмува	zaɡr̩muva
бирачки	biɾat͡ʃki
отвореност	ɔtvɔɾɛnɔst
барем	baɾɛm
неисплакнат	nɛispɫaknat
држи	dr̩ʒi
истоштува	istɔʃtuva
лондонка	ɫɔndɔŋka
акал	akaɫ
исполепи	ispɔlɛpi
ц	ǀ
парник	parnik
бројчаник	brɔjt͡ʃanik
докастри	dɔkastri
лихва	lixva
приклучница	prikɫut͡ʃnit͡sa
фрустрација	frustrat͡sija
постројка	pɔstrɔjka
подрасчисти	pɔdraʃt͡ʃisti
опседнува	ɔpsɛdnuva
крилест	krilɛst
станарство	stanarstvɔ
престанок	prɛstanɔk
сот	sɔt
заклопи	zakɫɔpi
прекрои	prɛkrɔi
цар	t͡sar
топка	tɔpka
вујнин	vujnin
чим	t͡ʃim
јазлест	jazlɛst
подискриви	pɔdiskrivi
кичма	kit͡ʃma
бајрактар	bajraktar
црнокос	t͡sr̩nɔkɔs
блазони	bɫazɔni
ебе	ɛbɛ
манџа	mand͡ʒa
еднаш	ɛdnaʃ
ампутација	amputat͡sija
непал	nɛpaɫ
мрсулавост	mr̩suɫavɔst
исцрнува	ist͡sr̩nuva
испобаци	ispɔbat͡si
искрснува	iskr̩snuva
деспотство	dɛspɔtstvɔ
сношти	snɔʃti
вечерва	vɛt͡ʃɛrva
водоводен	vɔdɔvɔdɛn
дегенерација	dɛɡɛnɛrat͡sija
одигрува	ɔdiɡruva
левица	lɛvit͡sa
оваа	ɔvaa
филм	fiɫm̩
галежност	ɡalɛʒnɔst
замок	zamɔk
документација	dɔkumɛntat͡sija
колоквиум	kɔɫɔkvijum
стрви	str̩vi
снегулки	snɛɡuɫki
занесеност	zanɛsɛnɔst
хроника	xrɔnika
ќеркичка	cɛrkit͡ʃka
столче	stɔɫt͡ʃɛ
флоскула	fɫɔskuɫa
смотра	smɔtra
мушама	muʃama
непоткупливост	nɛpɔtkuplivɔst
изнасее	iznasɛɛ
прерасне	prɛɾasnɛ
вранец	vranɛt͡s
засвирува	zasviɾuva
посмртница	pɔsmr̩tnit͡sa
годинава	ɡɔdinava
приштински	priʃtinski
закупнина	zakupnina
фереџе	fɛɾɛd͡ʒɛ
елеганција	ɛlɛɡant͡sija
готовински	ɡɔtɔvinski
приспособливост	prispɔsɔblivɔst
приврзаничка	privr̩zanit͡ʃka
праисторија	praistɔɾija
ослободителка	ɔsɫɔbɔditɛɫka
навасува	navasuva
лихварски	lixvarski
книгите	kniɡitɛ
испотпише	ispɔtpiʃɛ
стомак	stɔmak
кодификација	kɔdifikat͡sija
вџашеност	vd͡ʒaʃɛnɔst
ребренце	rɛbrɛnt͡sɛ
потонува	pɔtɔnuva
бруталност	brutaɫnɔst
дебитен	dɛbitɛn
завршува	zavr̩ʃuva
педерство	pɛdɛrstvɔ
пораснува	pɔrasnuva
басови	basɔvi
надареност	nadaɾɛnɔst
кметува	kmɛtuva
дека	dɛka
добројува	dɔbrɔjuva
кошмар	kɔʃmar
леукемија	lɛukɛmija
талка	taɫka
салатичка	saɫatit͡ʃka
брак	brak
гранитен	ɡranitɛn
условува	usɫɔvuva
плачливост	pɫat͡ʃlivɔst
збор	zbɔr
ранг	raŋk
мраз	mras
сигурносен	siɡurnɔsɛn
рејкјавик	rɛjkjavik
чудесно	t͡ʃudɛsnɔ
гомнарски	ɡɔmnarski
коцкичка	kɔt͡skit͡ʃka
кутре	kutrɛ
разочарувачки	razɔt͡ʃaruvat͡ʃki
евро	ɛvrɔ
десетка	dɛsɛtka
неисхранетост	nɛisxranɛtɔst
предродилен	prɛdrɔdilɛn
изгрејсонце	izɡrɛjsɔnt͡sɛ
излишност	izliʃnɔst
војводство	vɔjvɔtstvɔ
рамномерност	ramnɔmɛrnɔst
калорија	kaɫɔɾija
дабар	dabar
слаб	sɫap
риба	riba
послание	pɔsɫanijɛ
преврзе	prɛvr̩zɛ
хармонично	xarmɔnit͡ʃnɔ
орев	ɔɾɛf
аксиологија	aksijɔɫɔɡija
безвкусност	bɛsfkusnɔst
покривка	pɔkrifka
домесува	dɔmɛsuva
бетонски	bɛtɔnski
число	t͡ʃisɫɔ
бес	bɛs
грозјенце	ɡrɔzjɛnt͡sɛ
јогуртче	jɔɡurtt͡ʃɛ
картичка	kartit͡ʃka
зацвилува	zat͡sviɫuva
штитеничка	ʃtitɛnit͡ʃka
заштитнички	zaʃtitnit͡ʃki
трансфер	transfɛr
усте	ustɛ
потемнува	pɔtɛmnuva
брои	brɔi
маче	mat͡ʃɛ
вклопеност	fkɫɔpɛnɔst
лебарник	lɛbarnik
дренов	drɛnɔf
изнакраде	iznakradɛ
вршалка	vr̩ʃaɫka
сладоледџија	sɫadɔlɛdd͡ʒija
пооди	pɔɔdi
јајцевод	jajt͡sɛvɔt
трн	tr̩n̩
актуализација	aktualizat͡sija
известувачка	izvɛstuvat͡ʃka
опстанува	ɔpstanuva
претрпува	prɛtr̩puva
директорство	dirɛktɔrstvɔ
нимфа	niɱfa
сложен	sɫɔʒɛn
предомисли	prɛdɔmisli
простирка	prɔstirka
искашлува	iskaʃɫuva
ич	it͡ʃ
краткост	kratkɔst
видрин	vidrin
орница	ɔrnit͡sa
камо	kamɔ
престегне	prɛstɛɡnɛ
пишувате	piʃuvatɛ
побудалува	pɔbudaɫuva
застанува	zastanuva
металургија	mɛtaɫurɡija
восприемливост	vɔsprijɛmlivɔst
врзува	vr̩zuva
момчуле	mɔmt͡ʃulɛ
преживее	prɛʒivɛɛ
грутче	ɡrutt͡ʃɛ
кокори	kɔkɔɾi
заедно	zaɛdnɔ
окупација	ɔkupat͡sija
развратност	razvratnɔst
погуга	pɔɡuɡa
подзатегне	pɔdzatɛɡnɛ
платинест	pɫatinɛst
меѓувремен	mɛɟuvrɛmɛn
заменливост	zamɛnlivɔst
ресторан	rɛstɔran
неизлечивост	nɛizlɛt͡ʃivɔst
исцрта	ist͡sr̩ta
привршува	privr̩ʃuva
семиологија	sɛmijɔɫɔɡija
лизгавост	lizɡavɔst
соба	sɔba
лимарски	limarski
стиснатост	stisnatɔst
преграден	prɛɡradɛn
јад	jat
допадливост	dɔpadlivɔst
необузданост	nɛɔbuzdanɔst
нагласеност	naɡɫasɛnɔst
водите	vɔditɛ
подизрамни	pɔdizramni
засводи	zasvɔdi
педофилија	pɛdɔfilija
подосвести	pɔdɔsvɛsti
патопис	patɔpis
неправедност	nɛpravɛdnɔst
водине	vɔdinɛ
овци	ɔft͡si
самоубиство	samɔubistvɔ
побожност	pɔbɔʒnɔst
задоцнува	zadɔt͡snuva
испожени	ispɔʒɛni
опчинетост	ɔpt͡ʃinɛtɔst
понудува	pɔnuduva
отпадник	ɔtpadnik
лулиња	ɫuliɲa
прокобник	prɔkɔbnik
клуч	kɫut͡ʃ
измерува	izmɛɾuva
обемност	ɔbɛmnɔst
фазанов	fazanɔf
ноџе	nɔd͡ʒɛ
рицарски	rit͡sarski
лимета	limɛta
бочварство	bɔt͡ʃvarstvɔ
незапирливост	nɛzapirlivɔst
ништожност	niʃtɔʒnɔst
недобро	nɛdɔbrɔ
ракче	rakt͡ʃɛ
осакатува	ɔsakatuva
тајност	tajnɔst
пневмонија	pnɛvmɔnija
шумоли	ʃumɔli
едноставност	ɛdnɔstavnɔst
мливо	mlivɔ
сапунџија	sapund͡ʒija
панкерка	paŋkɛrka
книги	kniɡi
непривлечност	nɛprivlɛt͡ʃnɔst
безутешност	bɛzutɛʃnɔst
сликовит	slikɔvit
забутува	zabutuva
спинета	spinɛta
патка	patka
емисија	ɛmisija
бушавост	buʃavɔst
јазичест	jazit͡ʃɛst
мажите	maʒitɛ
женкарство	ʒɛŋkarstvɔ
замерка	zamɛrka
грбовник	ɡr̩bɔvnik
надживува	nadʒivuva
нагрдува	naɡr̩duva
сопруга	sɔpruɡa
сознание	sɔznanijɛ
аорист	aɔɾist
јајценце	jajt͡sɛnt͡sɛ
непостојаност	nɛpɔstɔjanɔst
дообликува	dɔɔblikuva
јазици	jazit͡si
балистика	balistika
невалидност	nɛvalidnɔst
кавалче	kavaɫt͡ʃɛ
предизвика	prɛdizvika
дотовари	dɔtɔvaɾi
убиец	ubijɛt͡s
руски	ruski
збеснува	zbɛsnuva
син	sin
дим	dim
подзапржи	pɔdzapr̩ʒi
среден	srɛdɛn
ларвин	ɫarvin
испопродаде	ispɔprɔdadɛ
истребувачка	istrɛbuvat͡ʃka
срочиште	srɔt͡ʃiʃtɛ
доселеничка	dɔsɛlɛnit͡ʃka
козметичар	kɔzmɛtit͡ʃar
јанѕа	jand͡za
дообразложува	dɔɔbrazɫɔʒuva
испоказни	ispɔkazni
синџир	sind͡ʒir
извичен	izvit͡ʃɛn
денарски	dɛnarski
проневера	prɔnɛvɛɾa
будалче	budaɫt͡ʃɛ
мачкиште	mat͡ʃkiʃtɛ
неисчистен	nɛiʃt͡ʃistɛn
папок	papɔk
недогорен	nɛdɔɡɔɾɛn
долу	dɔɫu
патлиџанче	patlid͡ʒant͡ʃɛ
бокс	bɔks
книжар	kniʒar
летоска	lɛtɔska
неудопство	nɛudɔpstvɔ
накосеност	nakɔsɛnɔst
автоматизација	aftɔmatizat͡sija
срцуле	sr̩t͡sulɛ
споредливост	spɔrɛdlivɔst
куп	kup
ѓеврек	ɟɛvrɛk
пот	pɔt
езотеричност	ɛzɔtɛɾit͡ʃnɔst
накитува	nakituva
двигател	dviɡatɛɫ
мостра	mɔstra
ежов	ɛʒɔf
стравува	sɛstravuva
самун	samun
барови	baɾɔvi
залајува	zaɫajuva
хистологија	xistɔɫɔɡija
вжештеност	vʒɛʃtɛnɔst
бишкечки	biʃkɛt͡ʃki
врвнојазичен	vr̩vnɔjazit͡ʃɛn
ролја	rɔlja
тровче	trɔft͡ʃɛ
бессодржајност	bɛssɔdr̩ʒajnɔst
вежбанка	vɛʒbaŋka
пребои	prɛbɔi
самоуштво	samɔuʃtvɔ
луле	ɫulɛ
ѕвечи	d͡zvɛt͡ʃi
наместува	namɛstuva
менталитет	mɛntalitɛt
платонски	pɫatɔnski
тетинов	tɛtinɔf
офтика	ɔftika
кавал	kavaɫ
износува	iznɔsuva
изгладнетост	izɡɫadnɛtɔst
намамува	namamuva
гази	ɡazi
ненаметливост	nɛnamɛtlivɔst
пакетче	pakɛtt͡ʃɛ
аеронаутика	aɛɾɔnautika
горе	ɡɔɾɛ
прифали	prifali
вагон	vaɡɔn
излезен	izlɛzɛn
март	mart
гребнува	ɡrɛbnuva
филолог	fiɫɔɫɔk
вон	vɔn
ресто	rɛstɔ
зора	zɔɾa
арнаутка	arnautka
двојност	dvɔjnɔst
поле	pɔlɛ
аналитичарка	analitit͡ʃarka
џогер	d͡ʒɔɡɛr
златарски	zɫatarski
мрачност	mrat͡ʃnɔst
ламба	ɫamba
белогазец	bɛɫɔɡazɛt͡s
исполнителност	ispɔɫnitɛɫnɔst
инспекторски	inspɛktɔrski
липов	lipɔf
виенски	vijɛnski
храна	xrana
свирче	svirt͡ʃɛ
придушувач	priduʃuvat͡ʃ
обезвучува	ɔbɛzvut͡ʃuva
книжен	kniʒɛn
новост	nɔvɔst
кошница	kɔʃnit͡sa
група	ɡrupa
бесплатност	bɛspɫatnɔst
имунологија	imunɔɫɔɡija
исончаност	isɔnt͡ʃanɔst
испопрати	ispɔprati
влада	vɫada
џелат	d͡ʒɛɫat
сторител	stɔɾitɛɫ
влакненце	vɫaknɛnt͡sɛ
подрасплете	pɔdrasplɛtɛ
поглуми	pɔɡɫumi
американец	amɛrikanɛt͡s
надразнетост	nadraznɛtɔst
прегрнува	prɛɡr̩nuva
десен	dɛsɛn
исклучителност	iskɫut͡ʃitɛɫnɔst
менторка	mɛntɔrka
реинкарнација	rɛiŋkarnat͡sija
цвеќенце	t͡svɛcɛnt͡sɛ
велепредавство	vɛlɛprɛdafstvɔ
здравје	zdravjɛ
коњарство	kɔɲarstvɔ
тиквичка	tikvit͡ʃka
филогенетски	fiɫɔɡɛnɛtski
јорган	jɔrɡan
солун	sɔɫun
ракија	rakija
википедија	vikipɛdija
задновенечен	zadnɔvɛnɛt͡ʃɛn
гуштерче	ɡuʃtɛrt͡ʃɛ
комшилак	kɔmʃiɫak
скитнички	skitnit͡ʃki
критичарски	kritit͡ʃarski
фотелја	fɔtɛlja
човештво	t͡ʃɔvɛʃtvɔ
лелека	lɛlɛka
гласје	ɡɫasjɛ
трагичност	traɡit͡ʃnɔst
поленце	pɔlɛnt͡sɛ
отпечати	ɔtpɛt͡ʃati
несигурност	nɛsiɡurnɔst
пресоли	prɛsɔli
подиспегла	pɔdispɛɡɫa
пасошки	pasɔʃki
регистрациски	rɛɡistrat͡siski
жабарка	ʒabarka
превие	prɛvijɛ
запазува	zapazuva
лажливост	ɫaʒlivɔst
техеран	tɛxɛɾan
променливост	prɔmɛnlivɔst
умотворба	umɔtvɔrba
осум	ɔsum
предлог	prɛdɫɔk
деветмина	dɛvɛtmina
чистота	t͡ʃistɔta
учителство	ut͡ʃitɛɫstvɔ
јавор	javɔr
снаин	snain
варварство	varvarstvɔ
боица	bɔit͡sa
изнервираност	iznɛrviɾanɔst
херцег	xɛrt͡sɛk
докупува	dɔkupuva
осарник	ɔsarnik
џокер	d͡ʒɔkɛr
јагодов	jaɡɔdɔf
сафра	safra
ко	kɔ
одбивност	ɔdbivnɔst
засраменост	zasramɛnɔst
излета	izlɛta
јајцев	jajt͡sɛf
циничност	t͡sinit͡ʃnɔst
кукурек	kukuɾɛk
кујна	kujna
виљушка	viluʃka
тракторски	traktɔrski
книгана	kniɡana
расекува	rasɛkuva
каснатина	kasnatina
испогази	ispɔɡazi
итрец	itrɛt͡s
школа	ʃkɔɫa
несамостојност	nɛsamɔstɔjnɔst
благост	bɫaɡɔst
аптека	aptɛka
гума	ɡuma
блогови	bɫɔɡɔvi
непроменливост	nɛprɔmɛnlivɔst
очовечува	ɔt͡ʃɔvɛt͡ʃuva
сочност	sɔt͡ʃnɔst
сензација	sɛnzat͡sija
немаштија	nɛmaʃtija
прободува	prɔbɔduva
звуков	zvukɔf
блокови	bɫɔkɔvi
другарува	druɡaɾuva
таткоубиство	tatkɔubistvɔ
газдин	ɡazdin
глужд	ɡɫuʃt
гроза	ɡrɔza
долупува	dɔɫupuva
еким	ɛkim
метонимија	mɛtɔnimija
накиснува	nakisnuva
центурија	t͡sɛntuɾija
клумка	kɫumka
домачка	dɔmat͡ʃka
бебешки	bɛbɛʃki
чешки	t͡ʃɛʃki
блескавост	blɛskavɔst
намќорски	namcɔrski
над	nat
топкање	tɔpkaɲɛ
поглода	pɔɡɫɔda
разгаленост	razɡalɛnɔst
запршка	zapr̩ʃka
пресметлив	prɛsmɛtlif
нокширче	nɔkʃirt͡ʃɛ
пиперка	pipɛrka
рема	rɛma
индијка	indijka
напивка	napifka
златен	zɫatɛn
лихварка	lixvarka
дванаесет	dvanaɛsɛt
забелешка	zabɛlɛʃka
мизантропија	mizantrɔpija
памук	pamuk
подотрезни	pɔdɔtrɛzni
испцуе	ispt͡suɛ
сродност	srɔdnɔst
хировитост	xirɔvitɔst
орјати	ɔrjati
тромб	trɔmp
мое	mɔɛ
в	v
врашки	vraʃki
теленце	tɛlɛnt͡sɛ
сливче	slift͡ʃɛ
господство	ɡɔspɔtstvɔ
беда	bɛda
недокажан	nɛdɔkaʒan
царица	t͡saɾit͡sa
постмодерен	pɔstmɔdɛɾɛn
неприкосновеност	nɛprikɔsnɔvɛnɔst
неукрасен	nɛukrasɛn
победа	pɔbɛda
непогода	nɛpɔɡɔda
искреност	iskrɛnɔst
навигациски	naviɡat͡siski
преод	prɛɔt
електроиндустрија	ɛlɛktrɔindustrija
седница	sɛdnit͡sa
сирачки	siɾat͡ʃki
едновременост	ɛdnɔvrɛmɛnɔst
клапнува	kɫapnuva
играчки	iɡrat͡ʃki
сало	saɫɔ
паркче	parkt͡ʃɛ
бесрамница	bɛsramnit͡sa
предавник	prɛdavnik
дотогај	dɔtɔɡaj
пресликува	prɛslikuva
аглутинација	aɡɫutinat͡sija
опуштеност	ɔpuʃtɛnɔst
одвлекува	ɔdvlɛkuva
крв	kr̩f
рамнодушност	ramnɔduʃnɔst
мисирче	misirt͡ʃɛ
резбар	rɛzbar
јадро	jadrɔ
доострува	dɔɔstruva
угледност	uɡlɛdnɔst
олеснителен	ɔlɛsnitɛlɛn
директност	diɾɛktnɔst
пустец	pustɛt͡s
метрика	mɛtrika
поготви	pɔɡɔtvi
вотка	vɔtka
хрватски	xr̩vatski
братоубиство	bratɔubistvɔ
варен	vaɾɛn
сите	sitɛ
обесхрабреност	ɔbɛsxrabrɛnɔst
застудува	zastuduva
гласиште	ɡɫasiʃtɛ
жениве	ʒɛnivɛ
јагленче	jaɡlɛnt͡ʃɛ
фонтови	fɔntɔvi
вари	vaɾi
кромитче	krɔmitt͡ʃɛ
македонче	makɛdɔnt͡ʃɛ
беглост	bɛɡɫɔst
мажот	maʒɔt
турчин	turt͡ʃin
прозрачност	prɔzrat͡ʃnɔst
срценце	sr̩t͡sɛnt͡sɛ
бедро	bɛdrɔ
овоштарство	ɔvɔʃtarstvɔ
одерува	ɔdɛɾuva
ликов	likɔf
шест	ʃɛst
сливов	slivɔf
престојува	prɛstɔjuva
организаторски	ɔrɡanizatɔrski
издлабува	izdɫabuva
одреденост	ɔdrɛdɛnɔst
дошепнува	dɔʃɛpnuva
бодрост	bɔdrɔst
настинува	nastinuva
погодност	pɔɡɔdnɔst
златарка	zɫatarka
непрекинливост	nɛprɛkinlivɔst
несогласност	nɛsɔɡɫasnɔst
испонарача	ispɔnaɾat͡ʃa
потарашка	pɔtaɾaʃka
чешел	t͡ʃɛʃɛɫ
домива	dɔmiva
писмуле	pismulɛ
гнездо	ɡnɛzdɔ
надополнува	nadɔpɔɫnuva
сајбија	sajbija
чиј	t͡ʃij
абаџија	abad͡ʒija
бавнорастечки	bavnɔrastɛt͡ʃki
лопатче	ɫɔpatt͡ʃɛ
користољубивост	kɔɾistɔlubivɔst
предавнички	prɛdavnit͡ʃki
неоран	nɛɔɾan
довиткува	dɔvitkuva
поручек	pɔɾut͡ʃɛk
исушува	isuʃuva
собичка	sɔbit͡ʃka
репрезентациски	rɛprɛzɛntat͡siski
галванизација	ɡaɫvanizat͡sija
осумстотини	ɔsumstɔtini
беспристрасност	bɛspristrasnɔst
пицерија	pit͡sɛɾija
истовременост	istɔvrɛmɛnɔst
запушеност	zapuʃɛnɔst
знаменце	znamɛnt͡sɛ
сонародник	sɔnaɾɔdnik
стакларство	stakɫarstvɔ
прележи	prɛlɛʒi
иселенички	isɛlɛnit͡ʃki
беспредметност	bɛsprɛdmɛtnɔst
дапче	dapt͡ʃɛ
нарцизам	nart͡sizam
мелнички	mɛɫnit͡ʃki
каранфилче	karaɱfiɫt͡ʃɛ
распростре	rasprɔstrɛ
сланинка	sɫaniŋka
модификација	mɔdifikat͡sija
габичка	ɡabit͡ʃka
неодобрен	nɛɔdɔbrɛn
изнакара	iznakaɾa
халуцинација	xaɫut͡sinat͡sija
приклучок	prikɫut͡ʃɔk
поноси	pɔnɔsi
споменичен	spɔmɛnit͡ʃɛn
толеранција	tɔlɛrant͡sija
десетче	dɛsɛtt͡ʃɛ
измамнички	izmamnit͡ʃki
очила	ɔt͡ʃiɫa
кваси	kvasi
пропустливост	prɔpustlivɔst
математичар	matɛmatit͡ʃar
земјоделец	zɛmjɔdɛlɛt͡s
логорува	ɫɔɡɔɾuva
вилушка	viɫuʃka
а	a
секташтво	sɛktaʃtvɔ
мој	mɔj
динамика	dinamika
невоспитаност	nɛvɔspitanɔst
логорски	ɫɔɡɔrski
цртичка	t͡sr̩tit͡ʃka
самостојност	samɔstɔjnɔst
раководител	rakɔvɔditɛɫ
рогат	rɔɡat
хералд	xɛɾaɫt
намолува	namɔɫuva
гајдаџии	ɡajdad͡ʒii
жена	ʒɛna
прекоси	prɛkɔsi
свештеник	svɛʃtɛnik
обновлив	ɔbnɔvlif
страница	stranit͡sa
уличарски	ulit͡ʃarski
ироничност	irɔnit͡ʃnɔst
избезуменост	izbɛzumɛnɔst
пчели	pt͡ʃɛli
мадридски	madritski
животинче	ʒivɔtint͡ʃɛ
малку	maɫku
кризен	krizɛn
свиен	svijɛn
набројува	nabrɔjuva
чиновништво	t͡ʃinɔvniʃtvɔ
посече	pɔsɛt͡ʃɛ
чамец	t͡ʃamɛt͡s
сестра	sɛstra
спроводен	sprɔvɔdɛn
катастарски	katastarski
фиксност	fiksnɔst
бесплодност	bɛspɫɔdnɔst
неопишан	nɛɔpiʃan
плуг	pɫuk
космонаут	kɔsmɔnaut
попречувач	pɔprɛt͡ʃuvat͡ʃ
онеспособеност	ɔnɛspɔsɔbɛnɔst
класификациски	kɫasifikat͡siski
испобрише	ispɔbriʃɛ
поданица	pɔdanit͡sa
соборен	sɔbɔɾɛn
брборење	br̩bɔɾɛɲɛ
спринтер	sprintɛr
неповреден	nɛpɔvrɛdɛn
крокодил	krɔkɔdiɫ
гледа	ɡlɛda
итрост	itrɔst
орасположува	ɔɾaspɔɫɔʒuva
влепува	vlɛpuva
абдикација	abdikat͡sija
јунаштина	junaʃtina
дубаи	dubai
учител	ut͡ʃitɛɫ
исповитка	ispɔvitka
конфузен	kɔɱfuzɛn
волшебност	vɔɫʃɛbnɔst
какофонија	kakɔfɔnija
замолува	zamɔɫuva
кнез	knɛs
хартивче	xartift͡ʃɛ
еволуциски	ɛvɔɫut͡siski
каса	kasa
книжарски	kniʒarski
испрекинатост	isprɛkinatɔst
бадемов	badɛmɔf
природа	priɾɔda
резолуција	rɛzɔɫut͡sija
досушува	dɔsuʃuva
бракови	brakɔvi
перипетија	pɛɾipɛtija
хистерија	xistɛɾija
меѓугенерациски	mɛɟuɡɛnɛrat͡siski
преора	prɛɔɾa
ондека	ɔndɛka
родољубивост	rɔdɔlubivɔst
битола	bitɔɫa
лекомисленост	lɛkɔmislɛnɔst
корито	kɔɾitɔ
прогресија	prɔɡrɛsija
универзитет	univɛrzitɛt
вака	vaka
бананче	banant͡ʃɛ
гуштерски	ɡuʃtɛrski
заедништво	zaɛdniʃtvɔ
безвредност	bɛzvrɛdnɔst
ординарии	ɔrdinaɾii
пицнат	pit͡snat
тркалце	tr̩kaɫt͡sɛ
равенство	ravɛnstvɔ
заостанатост	zaɔstanatɔst
куглање	kuɡɫaɲɛ
белокрилест	bɛɫɔkrilɛst
нанижува	naniʒuva
стринин	strinin
прекрасност	prɛkrasnɔst
гладен	ɡɫadɛn
чаршафче	t͡ʃarʃaft͡ʃɛ
заличува	zalit͡ʃuva
воинственост	vɔinstvɛnɔst
неуништливост	nɛuniʃtlivɔst
сперма	spɛrma
мечта	mɛt͡ʃta
иселеничка	isɛlɛnit͡ʃka
козарски	kɔzarski
недосежност	nɛdɔsɛʒnɔst
прокрварува	prɔkr̩vaɾuva
бавност	bavnɔst
кастрација	kastrat͡sija
јави	javi
изнаврне	iznavr̩nɛ
ишарет	iʃaɾɛt
разлошеност	razɫɔʃɛnɔst
сестринство	sɛstrinstvɔ
превод	prɛvɔt
безопасен	bɛzɔpasɛn
прдеж	pr̩dɛʃ
мечка	mɛt͡ʃka
хрватка	xr̩vatka
џипови	d͡ʒipɔvi
несовпадливост	nɛsɔfpadlivɔst
гласилка	ɡɫasiɫka
регистарски	rɛɡistarski
примарен	primaɾɛn
сопружник	sɔpruʒnik
отпадништво	ɔtpadniʃtvɔ
поставеност	pɔstavɛnɔst
поофка	pɔɔfka
засебност	zasɛbnɔst
јули	juli
левичарка	lɛvit͡ʃarka
дупка	dupka
неразјаснет	nɛrazjasnɛt
хералдика	xɛraɫdika
нелупен	nɛɫupɛn
потресеност	pɔtrɛsɛnɔst
непризнаен	nɛpriznaɛn
спарува	spaɾuva
витка	vitka
здиплува	zdipɫuva
рекламациски	rɛkɫamat͡siski
јаглен	jaɡlɛn
напакува	napakuva
сапунче	sapunt͡ʃɛ
преиначува	prɛinat͡ʃuva
ќуќур	cucur
соленост	sɔlɛnɔst
ќелавост	cɛɫavɔst
испомачка	ispɔmat͡ʃka
јагода	jaɡɔda
грчки	ɡr̩t͡ʃki
сложеност	sɫɔʒɛnɔst
острилка	ɔstriɫka
авионче	avijɔnt͡ʃɛ
разработува	razrabɔtuva
повелбен	pɔvɛɫbɛn
сукало	sukaɫɔ
аташе	ataʃɛ
статичност	statit͡ʃnɔst
обратно	ɔbratnɔ
суверен	suvɛɾɛn
недочитан	nɛdɔt͡ʃitan
разбраност	razbranɔst
болезливост	bɔlɛzlivɔst
епика	ɛpika
кљанкач	klaŋkat͡ʃ
посен	pɔsɛn
врескало	vrɛskaɫɔ
зграда	zɡrada
имитаторка	imitatɔrka
родовник	rɔdɔvnik
меч	mɛt͡ʃ
млеко	mlɛkɔ
мев	mɛf
работничка	rabɔtnit͡ʃka
доручек	dɔɾut͡ʃɛk
стиснува	stisnuva
затегнатост	zatɛɡnatɔst
упропастеност	uprɔpastɛnɔst
зуцне	zut͡snɛ
свирепост	sviɾɛpɔst
еженце	ɛʒɛnt͡sɛ
неодмереност	nɛɔdmɛɾɛnɔst
генетика	ɡɛnɛtika
излапеност	izɫapɛnɔst
семкар	sɛmkar
киселкавост	kisɛɫkavɔst
доѕидува	dɔd͡ziduva
коленце	kɔlɛnt͡sɛ
згрченост	zɡr̩t͡ʃɛnɔst
презакаже	prɛzakaʒɛ
неврологија	nɛvrɔɫɔɡija
анкара	aŋkaɾa
дрвар	dr̩var
грее	ɡrɛɛ
штрк	ʃtr̩k
монаштво	mɔnaʃtvɔ
плиснува	plisnuva
рис	ris
доџвакува	dɔd͡ʒvakuva
неуслужливост	nɛusɫuʒlivɔst
поднавали	pɔdnavali
предок	prɛdɔk
плука	pɫuka
нерастворливост	nɛɾastvɔrlivɔst
подочен	pɔdɔt͡ʃɛn
добришува	dɔbriʃuva
битолчанец	bitɔɫt͡ʃanɛt͡s
зачекорува	zat͡ʃɛkɔɾuva
суптилност	suptiɫnɔst
краварка	kravarka
дотогаш	dɔtɔɡaʃ
прабаба	prababa
аскетство	askɛtstvɔ
бонбона	bɔmbɔna
пиков	pikɔf
ѕвездест	d͡zvɛzdɛst
аписки	apiski
маларичен	maɫaɾit͡ʃɛn
гранка	ɡraŋka
ѕидарски	d͡zidarski
забиберува	zabibɛɾuva
денешница	dɛnɛʃnit͡sa
постелен	pɔstɛlɛn
крава	krava
преноќева	prɛnɔcɛva
рим	rim
опомена	ɔpɔmɛna
фустанче	fustant͡ʃɛ
жито	ʒitɔ
јадрен	jadrɛn
влезен	vlɛzɛn
броење	brɔɛɲɛ
магичност	maɡit͡ʃnɔst
пренапрегне	prɛnaprɛɡnɛ
женана	ʒɛnana
реквием	rɛkvijɛm
штица	ʃtit͡sa
предомислува	prɛdɔmisɫuva
мелничарски	mɛɫnit͡ʃarski
најлонски	najɫɔnski
двесте	dvɛstɛ
мангал	maŋɡaɫ
полугодие	pɔɫuɡɔdijɛ
итност	itnɔst
атина	atina
подбира	pɔdbiɾa
отсекува	ɔtsɛkuva
опортунистички	ɔpɔrtunistit͡ʃki
милијарда	milijarda
полнолетнички	pɔɫnɔlɛtnit͡ʃki
подразбистри	pɔdrazbistri
двополов	dvɔpɔɫɔf
недораснат	nɛdɔɾasnat
недосликан	nɛdɔslikan
преупати	prɛupati
четка	t͡ʃɛtka
роднина	rɔdnina
шеесет	ʃɛɛsɛt
рекреација	rɛkrɛat͡sija
заповедничка	zapɔvɛdnit͡ʃka
возмутува	vɔzmutuva
музичарски	muzit͡ʃarski
ладен	ɫadɛn
џаболебарка	d͡ʒabɔlɛbarka
боцкавост	bɔt͡skavɔst
безрасудност	bɛzrasudnɔst
репродукциски	rɛprɔdukt͡siski
киевски	kijɛfski
нож	nɔʃ
премеле	prɛmɛlɛ
креација	krɛat͡sija
подзамириса	pɔdzamiɾisa
подвозник	pɔdvɔznik
елен	ɛlɛn
бернски	bɛrn̩ski
сонцуле	sɔnt͡sulɛ
адреса	adrɛsa
изведувач	izvɛduvat͡ʃ
двојче	dvɔjt͡ʃɛ
навлажува	navɫaʒuva
топчест	tɔpt͡ʃɛst
вие	vijɛ
подлец	pɔdlɛt͡s
нежив	nɛʒif
девијација	dɛvijat͡sija
лупа	ɫupa
ракавичка	rakavit͡ʃka
испржува	ispr̩ʒuva
здрвеност	zdr̩vɛnɔst
нукуалофански	nukuaɫɔfanski
покајник	pɔkajnik
коприна	kɔprina
оков	ɔkɔf
исцрцорува	ist͡sr̩t͡sɔɾuva
елоквентност	ɛɫɔkvɛntnɔst
деновите	dɛnɔvitɛ
јамајка	jamajka
опашка	ɔpaʃka
црногорка	t͡sr̩nɔɡɔrka
попречен	pɔprɛt͡ʃɛn
зетов	zɛtɔf
безграничност	bɛzɡranit͡ʃnɔst
бисерка	bisɛrka
пргавост	pr̩ɡavɔst
подреденост	pɔdrɛdɛnɔst
денови	dɛnɔvi
самогласка	samɔɡɫaska
затворенички	zatvɔrɛnit͡ʃki
обичен	ɔbit͡ʃɛn
сантиметар	santimɛtar
автомобил	aftɔmɔbiɫ
зашто	zaʃtɔ
тревник	trɛvnik
квадрат	kvadrat
притисочен	pritisɔt͡ʃɛn
гавран	ɡavran
маничен	manit͡ʃɛn
полковник	pɔɫkɔvnik
лимонче	limɔnt͡ʃɛ
беспристраност	bɛspristranɔst
шал	ʃaɫ
пошие	pɔʃijɛ
довек	dɔvɛk
града	ɡrada
неискусност	nɛiskusnɔst
подрум	pɔdrum
сто	stɔ
ограѓе	ɔɡraɟɛ
волов	vɔɫɔf
завие	zavijɛ
трилогија	triɫɔɡija
асоцијација	asɔt͡sijat͡sija
услужливост	usɫuʒlivɔst
леток	lɛtɔk
убоден	ubɔdɛn
шкафче	ʃkaft͡ʃɛ
врв	vr̩f
коскест	kɔskɛst
допукува	dɔpukuva
апостол	apɔstɔɫ
патетичност	patɛtit͡ʃnɔst
несодржајност	nɛsɔdr̩ʒajnɔst
анкарски	aŋkarski
река	rɛka
гејша	ɡɛjʃa
џилит	d͡ʒilit
краткометражен	kratkɔmɛtraʒɛn
делегација	dɛlɛɡat͡sija
агломерација	aɡɫɔmɛrat͡sija
катјон	katjɔn
неспремност	nɛsprɛmnɔst
грамада	ɡramada
цинков	t͡siŋkɔf
деведесет	dɛvɛdɛsɛt
вонредност	vɔnrɛdnɔst
вошка	vɔʃka
поврие	pɔvrijɛ
задремува	zadrɛmuva
трњак	tr̩ɲak
модалност	mɔdaɫnɔst
десетпати	dɛsɛtpati
испоумре	ispɔumrɛ
камшиче	kamʃit͡ʃɛ
брборко	br̩bɔrkɔ
сукња	sukɲa
преплакне	prɛpɫaknɛ
свеќа	svɛca
испогризе	ispɔɡrizɛ
американски	amɛrikanski
жените	ʒɛnitɛ
ѕвездолик	d͡zvɛzdɔlik
студио	studijɔ
бликнува	bliknuva
коски	kɔski
свирач	sviɾat͡ʃ
заврзува	zavr̩zuva
регресија	rɛɡrɛsija
разноликост	raznɔlikɔst
проодува	prɔɔduva
ѕидови	d͡zidɔvi
родина	rɔdina
прелистува	prɛlistuva
индиец	indijɛt͡s
вселена	fsɛlɛna
сликовитост	slikɔvitɔst
барање	baɾaɲɛ
јазик	jazik
конзервација	kɔnzɛrvat͡sija
ушле	uʃlɛ
речник	rɛt͡ʃnik
постојаност	pɔstɔjanɔst
стенографија	stɛnɔɡrafija
истанченост	istant͡ʃɛnɔst
подносливост	pɔdnɔslivɔst
пишувај	piʃuvaj
едначи	ɛdnat͡ʃi
ликвидација	likvidat͡sija
прегрне	prɛɡr̩nɛ
клацка	kɫat͡ska
коа	kɔa
градини	ɡradini
ужас	uʒas
допинг	dɔpiŋk
свидетелство	svidɛtɛɫstvɔ
амстердам	amstɛrdam
зема	zɛma
зебрест	zɛbrɛst
расповие	raspɔvijɛ
аблатив	abɫatif
в	f
испоразбуди	ispɔrazbudi
импресија	imprɛsija
отапеност	ɔtapɛnɔst
прозорче	prɔzɔrt͡ʃɛ
кметов	kmɛtɔf
истребувач	istrɛbuvat͡ʃ
оџачарски	ɔd͡ʒat͡ʃarski
недопишан	nɛdɔpiʃan
докторува	dɔktɔɾuva
поучност	pɔut͡ʃnɔst
атрофија	atrɔfija
млекар	mlɛkar
хаос	xaɔs
беља	bɛla
ватикански	vatikanski
вирус	viɾus
тапан	tapan
извод	izvɔt
оцртува	ɔt͡sr̩tuva
забришува	zabriʃuva
баронство	baɾɔnstvɔ
ламбичка	ɫambit͡ʃka
надгласилен	nadɡɫasilɛn
омаеност	ɔmaɛnɔst
одмереност	ɔdmɛɾɛnɔst
озон	ɔzɔn
колбас	kɔɫbas
наплука	napɫuka
обзнанува	ɔbznanuva
журналист	ʒurnalist
стап	stap
мелодичност	mɛɫɔdit͡ʃnɔst
дошминка	dɔʃmiŋka
педесет	pɛdɛsɛt
надзорен	nadzɔɾɛn
резултат	rɛzuɫtat
источњак	istɔt͡ʃɲak
категоризација	katɛɡɔɾizat͡sija
раскалуѓери	raskaɫuɟɛɾi
гробарски	ɡrɔbarski
вол	vɔɫ
лентичка	lɛntit͡ʃka
администраторка	administratɔrka
колкумина	kɔɫkumina
запловува	zapɫɔvuva
брлив	br̩lif
крутост	krutɔst
узурпација	uzurpat͡sija
наемник	naɛmnik
преосмисли	prɛɔsmisli
детето	dɛtɛtɔ
кафе	kafɛ
точак	tɔt͡ʃak
благовременост	bɫaɡɔvrɛmɛnɔst
готварство	ɡɔtvarstvɔ
избавител	izbavitɛɫ
расече	rasɛt͡ʃɛ
мегаломанија	mɛɡaɫɔmanija
немил	nɛmiɫ
канбера	kambɛɾa
завесичка	zavɛsit͡ʃka
знаме	znamɛ
резиденција	rɛzidɛnt͡sija
преплови	prɛpɫɔvi
оро	ɔɾɔ
шлака	ʃɫaka
безбожнички	bɛzbɔʒnit͡ʃki
изрод	izrɔt
недоразбран	nɛdɔɾazbran
овчи	ɔft͡ʃi
превозник	prɛvɔznik
љубов	ʎubɔf
манипулативен	manipuɫativɛn
добиточен	dɔbitɔt͡ʃɛn
животно	ʒivɔtnɔ
уплашеност	upɫaʃɛnɔst
седларство	sɛdɫarstvɔ
рокер	rɔkɛr
заплакнува	zapɫaknuva
столови	stɔɫɔvi
ѓонови	ɟɔnɔvi
торба	tɔrba
прозодија	prɔzɔdija
века	vɛka
делотворност	dɛɫɔtvɔrnɔst
ненајавен	nɛnajavɛn
мечеви	mɛt͡ʃɛvi
поканува	pɔkanuva
омеѓува	ɔmɛɟuva
помпезност	pɔmpɛznɔst
доправа	dɔprava
раскрсти	raskr̩sti
соблазнивост	sɔbɫaznivɔst
читанка	t͡ʃitaŋka
лактациски	ɫaktat͡siski
самоодржлив	samɔɔdr̩ʒlif
полифонија	pɔlifɔnija
духовитост	duxɔvitɔst
недочистен	nɛdɔt͡ʃistɛn
исцрпност	ist͡sr̩pnɔst
пасинок	pasinɔk
тулиум	tulijum
крдо	kr̩dɔ
детство	dɛtstvɔ
арнотија	arnɔtija
зрнце	zr̩n̩t͡sɛ
опијанува	ɔpijanuva
неисправен	nɛispravɛn
врне	vr̩nɛ
кучиште	kut͡ʃiʃtɛ
мисиркин	misirkin
шамивче	ʃamift͡ʃɛ
орлов	ɔrɫɔf
бишкек	biʃkɛk
чичков	t͡ʃit͡ʃkɔf
бунарски	bunarski
еднозначност	ɛdnɔznat͡ʃnɔst
палавост	paɫavɔst
неизречен	nɛizrɛt͡ʃɛn
дотрошува	dɔtrɔʃuva
зијан	zijan
козметичарка	kɔzmɛtit͡ʃarka
уредност	uɾɛdnɔst
сантиметри	santimɛtri
ѕвечалка	d͡zvɛt͡ʃaɫka
испоначичка	ispɔnat͡ʃit͡ʃka
разнишаност	razniʃanɔst
неполнолетност	nɛpɔɫnɔlɛtnɔst
антонимија	antɔnimija
кварт	kvart
шпоретче	ʃpɔɾɛtt͡ʃɛ
апсеник	apsɛnik
ролерка	rɔlɛrka
ѓаволски	ɟavɔɫski
доскока	dɔskɔka
крикнува	kriknuva
ненаспан	nɛnaspan
математика	matɛmatika
стомна	stɔmna
поплете	pɔplɛtɛ
скитништво	skitniʃtvɔ
едностраност	ɛdnɔstranɔst
бакрдан	bakr̩dan
август	avɡust
кивнува	kivnuva
овца	ɔft͡sa
пајче	pajt͡ʃɛ
седумстотини	sɛdumstɔtini
едноударен	ɛdnɔudaɾɛn
пешкир	pɛʃkir
итербиум	itɛrbijum
неотуѓивост	nɛɔtuɟivɔst
ждригнува	ʒdriɡnuva
невистинитост	nɛvistinitɔst
згмечува	zɡmɛt͡ʃuva
љубителски	lubitɛɫski
џепче	d͡ʒɛpt͡ʃɛ
споредност	spɔɾɛdnɔst
недојаден	nɛdɔjadɛn
давеник	davɛnik
предупредува	prɛduprɛduva
неутрализација	nɛutralizat͡sija
испоснички	ispɔsnit͡ʃki
еже	ɛʒɛ
бездејност	bɛzdɛjnɔst
мапа	mapa
карти	karti
пренамени	prɛnamɛni
ревија	rɛvija
обезмастува	ɔbɛzmastuva
дни	dni
изгнаси	izɡnasi
хранливост	xranlivɔst
навредливост	navrɛdlivɔst
преслече	prɛslɛt͡ʃɛ
масленост	maslɛnɔst
владетелка	vɫadɛtɛɫka
лани	ɫani
железарски	ʒɛlɛzarski
багдадски	baɡdatski
ишне	iʃnɛ
презема	prɛzɛma
шерифов	ʃɛɾifɔf
недоверба	nɛdɔvɛrba
брзоплет	br̩zɔplɛt
подрумски	pɔdrumski
гласничка	ɡɫasnit͡ʃka
јазичар	jazit͡ʃar
актерски	aktɛrski
белучка	bɛɫut͡ʃka
ѕвоно	d͡zvɔnɔ
брадичка	bradit͡ʃka
бргу	br̩ɡu
безличност	bɛzlit͡ʃnɔst
љубовник	lubɔvnik
изостреност	izɔstrɛnɔst
мишка	miʃka
’рдоква	r̩dɔkva
многубројност	mnɔɡubrɔjnɔst
развратница	razvratnit͡sa
кљанка	klaŋka
ровчица	rɔft͡ʃit͡sa
твој	tvɔj
недвижност	nɛdviʒnɔst
доктрина	dɔktrina
одвртува	ɔdvr̩tuva
лондончанка	ɫɔndɔnt͡ʃaŋka
кајсија	kajsija
ѕирне	d͡zirnɛ
готован	ɡɔtɔvan
надвишува	nadviʃuva
создание	sɔzdanijɛ
плебеец	plɛbɛɛt͡s
измазнува	izmaznuva
претресува	prɛtrɛsuva
наденува	nadɛnuva
астронаутски	astrɔnautski
ѕвонлив	d͡zvɔnlif
црквичка	t͡sr̩kvit͡ʃka
сопотписник	sɔpɔtpisnik
певливост	pɛvlivɔst
пунктуација	puŋktuat͡sija
ќелави	cɛɫavi
охриѓанец	ɔxriɟanɛt͡s
заема	zaɛma
недозволивост	nɛdɔzvɔlivɔst
вест	vɛst
триесет	trijɛsɛt
годишник	ɡɔdiʃnik
каиш	kaiʃ
спечалува	spɛt͡ʃaɫuva
чивија	t͡ʃivija
прозор	prɔzɔr
селце	sɛɫt͡sɛ
затвор	zatvɔr
простор	prɔstɔr
ѕвечарка	d͡zvɛt͡ʃarka
потекло	pɔtɛkɫɔ
нетактичност	nɛtaktit͡ʃnɔst
лактација	ɫaktat͡sija
доигрува	dɔiɡruva
висост	visɔst
сувански	suvanski
уметнички	umɛtnit͡ʃki
легендарност	lɛɡɛndarnɔst
висне	visnɛ
шпионски	ʃpijɔnski
палестина	palɛstina
дедомразовци	dɛdɔmrazɔft͡si
фалсификација	faɫsifikat͡sija
учебник	ut͡ʃɛbnik
крајче	krajt͡ʃɛ
центрира	t͡sɛntriɾa
двоженство	dvɔʒɛnstvɔ
коњче	kɔɲt͡ʃɛ
покркори	pɔkr̩kɔɾi
подигнува	pɔdiɡnuva
анјон	anjɔn
железен	ʒɛlɛzɛn
презими	prɛzimi
криптологија	kriptɔɫɔɡija
неизбричен	nɛizbrit͡ʃɛn
земјичка	zɛmjit͡ʃka
прсторед	pr̩stɔɾɛt
испогради	ispɔɡradi
опсудува	ɔpsuduva
влијателност	vlijatɛɫnɔst
предосети	prɛdɔsɛti
подзаврти	pɔdzavr̩ti
кој	kɔj
антиобиотички	antijɔbijɔtit͡ʃki
сопруг	sɔpruk
венче	vɛnt͡ʃɛ
преброди	prɛbrɔdi
соборува	sɔbɔɾuva
преболи	prɛbɔli
електрика	ɛlɛktrika
затреперува	zatrɛpɛɾuva
рунтавост	runtavɔst
витешки	vitɛʃki
ненадоместливост	nɛnadɔmɛstlivɔst
прекршување	prɛkr̩ʃuvaɲɛ
снешко	snɛʃkɔ
поларизаторски	pɔɫaɾizatɔrski
критичар	kritit͡ʃar
тревичка	trɛvit͡ʃka
дада	dada
портретски	pɔrtrɛtski
шот	ʃɔt
пигментација	piɡmɛntat͡sija
англиски	aŋɡliski
нарација	narat͡sija
граматика	ɡramatika
хибернација	xibɛrnat͡sija
зборување	zbɔruvaɲɛ
континент	kɔntinɛnt
чешмичка	t͡ʃɛʃmit͡ʃka
лепило	lɛpiɫɔ
кајгана	kajɡana
лажичка	ɫaʒit͡ʃka
преименува	prɛimɛnuva
автостоперски	aftɔstɔpɛrski
деформација	dɛfɔrmat͡sija
преврнува	prɛvr̩nuva
преградува	prɛɡraduva
чорап	t͡ʃɔɾap
облачност	ɔbɫat͡ʃnɔst
слаткарство	sɫatkarstvɔ
вретено	vrɛtɛnɔ
термодинамика	tɛrmɔdinamika
педерка	pɛdɛrka
кујни	kujni
кандилце	kandiɫt͡sɛ
достојност	dɔstɔjnɔst
компактност	kɔmpaktnɔst
сонародничка	sɔnarɔdnit͡ʃka
тахикардија	taxikardija
нискост	niskɔst
тапанарка	tapanarka
лапсус	ɫapsus
негодува	nɛɡɔduva
доволно	dɔvɔɫnɔ
апстракција	apstrakt͡sija
глупавост	ɡɫupavɔst
сводник	svɔdnik
неспоредлив	nɛspɔɾɛdlif
набавка	nabafka
анорексија	anɔrɛksija
пронајдок	prɔnajdɔk
непрочистен	nɛprɔt͡ʃistɛn
иновација	inɔvat͡sija
крцкавост	kr̩t͡skavɔst
внедри	vnɛdri
клен	klɛn
јавност	javnɔst
здебелува	zdɛbɛɫuva
експедиција	ɛkspɛdit͡sija
складност	skɫadnɔst
забарство	zabarstvɔ
спасителен	spasitɛlɛn
физиономија	fizijɔnɔmija
курсен	kursɛn
шушкавост	ʃuʃkavɔst
недокршен	nɛdɔkr̩ʃɛn
активација	aktivat͡sija
ќешки	cɛʃki
родилка	rɔdiɫka
круна	kruna
жено	ʒɛnɔ
јајчен	jajt͡ʃɛn
неверничка	nɛvɛrnit͡ʃka
кафез	kafɛs
кокиче	kɔkit͡ʃɛ
автобиографија	aftɔbijɔɡrafija
чешмиче	t͡ʃɛʃmit͡ʃɛ
преглас	prɛɡɫas
најавувач	najavuvat͡ʃ
често	t͡ʃɛstɔ
изнастиска	iznastiska
брашноса	braʃnɔsa
величество	vɛlit͡ʃɛstvɔ
мечувалец	mɛt͡ʃuvalɛt͡s
петстотини	pɛtstɔtini
герунд	ɡɛɾunt
илјада	iljada
тениски	tɛniski
панкер	paŋkɛr
жичен	ʒit͡ʃɛn
зев	zɛf
дојденец	dɔjdɛnɛt͡s
велингтон	vɛliŋktɔn
булка	buɫka
глас	ɡɫas
предназначи	prɛdnaznat͡ʃi
дунав	dunaf
опасност	ɔpasnɔst
јон	jɔn
празноглавост	praznɔɡɫavɔst
московски	mɔskɔfski
награба	naɡraba
испостиска	ispɔstiska
сурат	suɾat
англија	aŋɡlija
мастика	mastika
автоматски	aftɔmatski
чембало	t͡ʃɛmbaɫɔ
голушка	ɡɔɫuʃka
разум	razum
ќупови	cupɔvi
сатана	satana
зборливост	zbɔrlivɔst
потсопне	pɔtsɔpnɛ
благонаклонетост	bɫaɡɔnakɫɔnɛtɔst
отпоздрави	ɔtpɔzdravi
изнудувач	iznuduvat͡ʃ
седуммина	sɛdummina
ветка	vɛtka
подобност	pɔdɔbnɔst
изнавари	iznavaɾi
седнува	sɛdnuva
перјаница	pɛrjanit͡sa
снисходливост	snisxɔdlivɔst
дечиња	dɛt͡ʃiɲa
пребришува	prɛbriʃuva
кревкост	krɛfkɔst
плаши	sɛpɫaʃi
преврие	prɛvrijɛ
соавторство	sɔaftɔrstvɔ
можеби	mɔʒɛbi
бранче	brant͡ʃɛ
јахта	jaxta
прешминка	prɛʃmiŋka
детево	dɛtɛvɔ
потпекува	pɔtpɛkuva
победи	pɔbɛdi
господин	ɡɔspɔdin
штекер	ʃtɛkɛr
кибрит	kibrit
бриселски	brisɛɫski
аба	aba
жонглер	ʒɔŋɡlɛr
патлиџан	patlid͡ʒan
впечатливост	fpɛt͡ʃatlivɔst
блудничи	bɫudnit͡ʃi
испозатвори	ispɔzatvɔɾi
кога	kɔɡa
вампирче	vampirt͡ʃɛ
распетла	raspɛtɫa
пантомимичен	pantɔmimit͡ʃɛn
намокрува	namɔkruva
бејзбол	bɛjzbɔɫ
отстои	ɔtstɔi
гулабов	ɡuɫabɔf
америка	amɛɾika
неопипливост	nɛɔpiplivɔst
пцост	pt͡sɔst
соединет	sɔɛdinɛt
гора	ɡɔɾa
петолиние	pɛtɔlinijɛ
подотпара	pɔdɔtpaɾa
козичка	kɔzit͡ʃka
преосетливост	prɛɔsɛtlivɔst
формулира	fɔrmuliɾa
испозаборави	ispɔzabɔɾavi
мушичка	muʃit͡ʃka
ем	ɛm
тешкотија	tɛʃkɔtija
јавен	javɛn
хомонимија	xɔmɔnimija
словенец	sɫɔvɛnɛt͡s
молчаливост	mɔɫt͡ʃalivɔst
губитнички	ɡubitnit͡ʃki
доплетува	dɔplɛtuva
обилност	ɔbiɫnɔst
битолчанка	bitɔɫt͡ʃaŋka
досега	dɔsɛɡa
заробенички	zaɾɔbɛnit͡ʃki
неподготвен	nɛpɔdɡɔtvɛn
небесен	nɛbɛsɛn
однародува	ɔdnarɔduva
импровизаторка	imprɔvizatɔrka
без	bɛs
појадок	pɔjadɔk
десет	dɛsɛt
магла	maɡɫa
сопственица	sɔpstvɛnit͡sa
бедност	bɛdnɔst
беспримерност	bɛsprimɛrnɔst
цветче	t͡svɛtt͡ʃɛ
недорасонет	nɛdɔrasɔnɛt
генетичарка	ɡɛnɛtit͡ʃarka
билетарници	bilɛtarnit͡si
угостителство	uɡɔstitɛɫstvɔ
џип	d͡ʒip
гајдаџија	ɡajdad͡ʒija
колекција	kɔlɛkt͡sija
натамошен	natamɔʃɛn
шарпланинче	ʃarpɫanint͡ʃɛ
двечки	dvɛt͡ʃki
гукнува	ɡuknuva
кактус	kaktus
координација	kɔɔrdinat͡sija
поддршка	pɔddr̩ʃka
ренде	rɛndɛ
жар	ʒar
гајди	ɡajdi
депонија	dɛpɔnija
глагол	ɡɫaɡɔɫ
изменува	izmɛnuva
пролетоска	prɔlɛtɔska
испокара	ispɔkaɾa
цол	t͡sɔɫ
нерасположеност	nɛɾaspɔɫɔʒɛnɔst
индексен	indɛksɛn
неприфатен	nɛprifatɛn
шапкарка	ʃapkarka
ништо	niʃtɔ
жртва	ʒr̩tva
тие	tijɛ
поднамали	pɔdnamali
магливост	maɡlivɔst
тактичност	taktit͡ʃnɔst
пропие	prɔpijɛ
изолациски	izɔɫat͡siski
беќарство	bɛcarstvɔ
орјатин	ɔrjatin
субвенција	subvɛnt͡sija
црногорец	t͡sr̩nɔɡɔɾɛt͡s
замазнува	zamaznuva
веројатно	vɛrɔjatnɔ
договори	dɔɡɔvɔɾi
кршливост	kr̩ʃlivɔst
јас	jas
чело	t͡ʃɛɫɔ
безбројност	bɛzbrɔjnɔst
вилин	vilin
методологија	mɛtɔdɔɫɔɡija
безглавост	bɛzɡɫavɔst
витез	vitɛs
афазија	afazija
близначе	bliznat͡ʃɛ
прслук	pr̩sɫuk
транзиција	tranzit͡sija
прегладни	prɛɡɫadni
поседник	pɔsɛdnik
и	i
кремен	krɛmɛn
бут	but
рекичка	rɛkit͡ʃka
шиптар	ʃiptar
чедност	t͡ʃɛdnɔst
премачкува	prɛmat͡ʃkuva
заштедува	zaʃtɛduva
’рчи	r̩t͡ʃi
ѕе	d͡zæ
јасминов	jasminɔf
проповедница	prɔpɔvɛdnit͡sa
литература	litɛɾatuɾa
орјатски	ɔrjatski
преодност	prɛɔdnɔst
џигерче	d͡ʒiɡɛrt͡ʃɛ
внатрешен	vnatrɛʃɛn
ослоански	ɔsɫɔanski
противзаконски	prɔtivzakɔnski
пазарче	pazart͡ʃɛ
згаснува	zɡasnuva
избраник	izbranik
пребирливост	prɛbirlivɔst
ластиче	ɫastit͡ʃɛ
преоптовареност	prɛɔptɔvaɾɛnɔst
авторизација	aftɔɾizat͡sija
благотворност	bɫaɡɔtvɔrnɔst
копанче	kɔpant͡ʃɛ
пискавост	piskavɔst
свеќичка	svɛcit͡ʃka
живот	ʒivɔt
образование	ɔbrazɔvanijɛ
пупунец	pupunɛt͡s
авиолинија	avijɔlinija
јаде	jadɛ
даночник	danɔt͡ʃnik
побркува	pɔbr̩kuva
јадничок	jadnit͡ʃɔk
стабилност	stabiɫnɔst
замирисува	zamirisuva
предикација	prɛdikat͡sija
ортопедија	ɔrtɔpɛdija
процветува	prɔt͡svɛtuva
пиштолче	piʃtɔɫt͡ʃɛ
превласт	prɛvɫast
може	mɔʒɛ
шмат	ʃmat
испооговара	ispɔɔɡɔvaɾa
мушмула	muʃmuɫa
телесност	tɛlɛsnɔst
сувост	suvɔst
сопатничка	sɔpatnit͡ʃka
грло	ɡr̩ɫɔ
пишуваме	piʃuvamɛ
тројца	trɔjt͡sa
аукција	aukt͡sija
заспие	zaspijɛ
снесува	snɛsuva
варварин	varvaɾin
учкур	ut͡ʃkur
заржува	zarʒuva
овенува	ɔvɛnuva
деменција	dɛmɛnt͡sija
узурпаторски	uzurpatɔrski
па	pa
ракав	rakaf
зеленчук	zɛlɛnt͡ʃuk
неизлупен	nɛizɫupɛn
дивизма	divizma
просјачки	prɔsjat͡ʃki
неумност	nɛumnɔst
фанатичен	fanatit͡ʃɛn
комика	kɔmika
денеска	dɛnɛska
актерство	aktɛrstvɔ
едренце	ɛdrɛnt͡sɛ
наочарчиња	naɔt͡ʃart͡ʃiɲa
препакува	prɛpakuva
игла	iɡɫa
рекатегоризација	rɛkatɛɡɔɾizat͡sija
вторник	ftɔrnik
непосредност	nɛpɔsrɛdnɔst
археолог	arxɛɔɫɔk
гори	ɡɔɾi
читателка	t͡ʃitatɛɫka
џакарта	d͡ʒakarta
бетер	bɛtɛr
неприкриен	nɛprikrijɛn
информатика	iɱfɔrmatika
совпадливост	sɔfpadlivɔst
брестов	brɛstɔf
биполарност	bipɔɫarnɔst
преврска	prɛvr̩ska
вреќиште	vrɛciʃtɛ
пролазува	prɔɫazuva
ѓубри	ɟubri
сметка	smɛtka
соларен	sɔɫaɾɛn
ја	ja
енклитика	ɛnklitika
вилнуски	viɫnuski
дакански	dakanski
дафинов	dafinɔf
смрчак	smr̩t͡ʃak
дипли	dipli
бескрајност	bɛskrajnɔst
надоградува	nadɔɡraduva
момиче	mɔmit͡ʃɛ
срце	sr̩t͡sɛ
предводник	prɛdvɔdnik
отпакува	ɔtpakuva
супичка	supit͡ʃka
испообеси	ispɔɔbɛsi
симпозиум	simpɔzijum
чума	t͡ʃuma
јазовичар	jazɔvit͡ʃar
благајничка	bɫaɡajnit͡ʃka
колокациски	kɔɫɔkat͡siski
пластичарски	pɫastit͡ʃarski
поцрнетост	pɔt͡sr̩nɛtɔst
спојка	spɔjka
казненик	kaznɛnik
нечесност	nɛt͡ʃɛsnɔst
оптимистичност	ɔptimistit͡ʃnɔst
посвири	pɔsviɾi
грмушест	ɡr̩muʃɛst
забодува	zabɔduva
вилнус	viɫnus
испоуништи	ispɔuniʃti
перо	pɛɾɔ
сечило	sɛt͡ʃiɫɔ
труд	trut
нужност	nuʒnɔst
младоликост	mɫadɔlikɔst
набира	nabiɾa
народен	naɾɔdɛn
поморски	pɔmɔrski
денешен	dɛnɛʃɛn
скулптурен	skuɫptuɾɛn
маков	makɔf
тбилиси	dbilisi
трауматичност	traumatit͡ʃnɔst
беспорочност	bɛspɔɾɔt͡ʃnɔst
учебен	ut͡ʃɛbɛn
превртува	prɛvr̩tuva
веровит	vɛɾɔvit
сочувствителност	sɔt͡ʃufstvitɛɫnɔst
сполај	spɔɫaj
ѕидина	d͡zidina
достудува	dɔstuduva
семестар	sɛmɛstar
исцртува	ist͡sr̩tuva
јагнуле	jaɡnulɛ
портрет	pɔrtrɛt
градина	ɡradina
акустика	akustika
дарителка	daritɛɫka
ѓеврече	ɟɛvrɛt͡ʃɛ
музичарка	muzit͡ʃarka
џиновски	d͡ʒinɔfski
ергенува	ɛrɡɛnuva
забележителност	zabɛlɛʒitɛɫnɔst
купче	kupt͡ʃɛ
изведба	izvɛdba
црешов	t͡srɛʃɔf
подвиткува	pɔdvitkuva
забавност	zabavnɔst
немиен	nɛmijɛn
соединетост	sɔɛdinɛtɔst
израел	izraɛɫ
пекиншки	pɛkinʃki
противвоспалителен	prɔtivvɔspalitɛlɛn
наочари	naɔt͡ʃaɾi
шпорет	ʃpɔɾɛt
шашавост	ʃaʃavɔst
провинциски	prɔvint͡siski
непрочитан	nɛprɔt͡ʃitan
подистури	pɔdistuɾi
напротив	naprɔtif
владар	vɫadar
чајџилница	t͡ʃajd͡ʒiɫnit͡sa
катче	katt͡ʃɛ
килимарство	kilimarstvɔ
бујност	bujnɔst
влакнест	vɫaknɛst
бебуле	bɛbulɛ
слушателка	sɫuʃatɛɫka
медарски	mɛdarski
фитнес	fitnɛs
мечувалство	mɛt͡ʃuvaɫstvɔ
малкуцка	maɫkut͡ska
споредлив	spɔɾɛdlif
депортација	dɛpɔrtat͡sija
допливува	dɔplivuva
подмножество	pɔdmnɔʒɛstvɔ
непријателка	nɛprijatɛɫka
карта	karta
компјутеризација	kɔmpjutɛɾizat͡sija
дендрохронологија	dɛndrɔxrɔnɔɫɔɡija
цикличност	t͡siklit͡ʃnɔst
инвестициски	iɱvɛstit͡siski
стопеност	stɔpɛnɔst
задутре	zadutrɛ
варшава	varʃava
замастува	zamastuva
ццц	ǀǀǀ
токио	tɔkijɔ
ломотење	ɫɔmɔtɛɲɛ
телефон	tɛlɛfɔn
наспроти	nasprɔti
змијуле	zmijulɛ
мечувалки	mɛt͡ʃuvaɫki
конексија	kɔnɛksija
неотстранливост	nɛɔtstranlivɔst
поднови	pɔdnɔvi
глобализација	ɡɫɔbalizat͡sija
вообичајува	vɔɔbit͡ʃajuva
лук	ɫuk
аљкавост	alkavɔst
ветрови	vɛtrɔvi
бунтовништво	buntɔvniʃtvɔ
тупав	tupaf
шегобиство	ʃɛɡɔbistvɔ
процедува	prɔt͡sɛduva
такса	taksa
изврива	izvriva
шеснаесет	ʃɛsnaɛsɛt
изнаготви	iznaɡɔtvi
кале	kalɛ
одважност	ɔdvaʒnɔst
пренапрегнатост	prɛnaprɛɡnatɔst
челенки	t͡ʃɛlɛŋki
чистачки	t͡ʃistat͡ʃki
загризува	zaɡrizuva
ербиум	ɛrbijum
барателка	baratɛɫka
благоглаголивост	bɫaɡɔɡɫaɡɔlivɔst
балон	baɫɔn
уфрлен	ufr̩lɛn
таблица	tablit͡sa
повратност	pɔvratnɔst
дно	dnɔ
жени	ʒɛni
утро	utrɔ
наследност	naslɛdnɔst
бестија	bɛstija
замразува	zamrazuva
недоискажан	nɛdɔiskaʒan
гадливост	ɡadlivɔst
догорува	dɔɡɔɾuva
лажност	ɫaʒnɔst
му	mu
модуларен	mɔduɫaɾɛn
клема	klɛma
еж	ɛʃ
јадец	jadɛt͡s
батак	batak
извидник	izvidnik
бојлер	bɔjlɛr
вазал	vazaɫ
дотолчува	dɔtɔɫt͡ʃuva
јадровит	jadrɔvit
поплука	pɔpɫuka
голтнички	ɡɔɫtnit͡ʃki
благозвучност	bɫaɡɔzvut͡ʃnɔst
прочитува	prɔt͡ʃituva
водете	vɔdɛtɛ
претне	prɛtnɛ
смет	smɛt
презасити	prɛzasiti
поларност	pɔɫarnɔst
претпразничен	prɛtpraznit͡ʃɛn
педерастија	pɛdɛrastija
арамиски	aramiski
душа	duʃa
проникливост	prɔniklivɔst
здодевност	zdɔdɛvnɔst
печурче	pɛt͡ʃurt͡ʃɛ
газенце	ɡazɛnt͡sɛ
преброи	prɛbrɔi
плиткост	plitkɔst
дооблекува	dɔɔblɛkuva
наклонетост	nakɫɔnɛtɔst
храбар	xrabar
циметов	t͡simɛtɔf
влакно	vɫaknɔ
смрдливост	smr̩dlivɔst
осамне	ɔsamnɛ
колкав	kɔɫkaf
огноотпорност	ɔɡnɔɔtpɔrnɔst
потточка	pɔttɔt͡ʃka
белград	bɛɫɡrat
снеже	snɛʒɛ
непровидност	nɛprɔvidnɔst
шумичка	ʃumit͡ʃka
лиценце	lit͡sɛnt͡sɛ
ненасаден	nɛnasadɛn
алегорија	alɛɡɔɾija
оцет	ɔt͡sɛt
златарство	zɫatarstvɔ
платненце	pɫatnɛnt͡sɛ
шилест	ʃilɛst
лихварство	lixvarstvɔ
иницијаторка	init͡sijatɔrka
насилничка	nasiɫnit͡ʃka
епилепсија	ɛpilɛpsija
испоколе	ispɔkɔlɛ
костимче	kɔstimt͡ʃɛ
навреденост	navrɛdɛnɔst
промрморува	prɔmr̩mɔɾuva
кнежевства	knɛʒɛfstva
ѓум	ɟum
подои	pɔdɔi
маскенбал	maskɛmbaɫ
врева	vrɛva
ѕвонче	d͡zvɔnt͡ʃɛ
дену	dɛnu
трици	trit͡si
немечко	nɛmɛt͡ʃkɔ
ѕвездалија	d͡zvɛzdalija
текстил	tɛkstiɫ
крилце	kriɫt͡sɛ
запржува	zapr̩ʒuva
државичка	dr̩ʒavit͡ʃka
марка	marka
бранов	branɔf
закаже	zakaʒɛ
уво	uvɔ
ветерче	vɛtɛrt͡ʃɛ
добие	dɔbijɛ
братче	bratt͡ʃɛ
онде	ɔndɛ
единство	ɛdinstvɔ
неоздравен	nɛɔzdravɛn
стакленички	staklɛnit͡ʃki
ледник	lɛdnik
плик	plik
потркала	pɔtr̩kaɫa
степенува	stɛpɛnuva
деверов	dɛvɛɾɔf
одработува	ɔdrabɔtuva
маска	maska
божественост	bɔʒɛstvɛnɔst
приватизација	privatizat͡sija
одмерува	ɔdmɛɾuva
затајува	zatajuva
лешинарски	lɛʃinarski
дихотомија	dixɔtɔmija
препород	prɛpɔɾɔt
дремнува	drɛmnuva
вечерашен	vɛt͡ʃɛɾaʃɛn
грк	ɡr̩k
одбива	ɔdbiva
желбен	ʒɛɫbɛn
раскрепости	raskrɛpɔsti
испукува	ispukuva
мажов	maʒɔf
набрашни	nabraʃni
пријателче	prijatɛɫt͡ʃɛ
ѓомлезе	ɟɔmlɛzɛ
соколар	sɔkɔɫar
град	ɡrat
унгарија	unɡaɾija
оптегнатост	ɔptɛɡnatɔst
таксирлија	taksirlija
привременост	privrɛmɛnɔst
пречувствителност	prɛt͡ʃufstvitɛɫnɔst
воздух	vɔzdux
излижува	izliʒuva
бугар	buɡar
изнемоштеност	iznɛmɔʃtɛnɔst
берберство	bɛrbɛrstvɔ
цап	t͡sap
бубаче	bubat͡ʃɛ
акцентираност	akt͡sɛntiɾanɔst
њоки	ɲɔki
иконописец	ikɔnɔpisɛt͡s
метличе	mɛtlit͡ʃɛ
уредничка	urɛdnit͡ʃka
дехидрација	dɛxidrat͡sija
зачешла	zat͡ʃɛʃɫa
достоинственост	dɔstɔinstvɛnɔst
канберски	kambɛrski
изнасади	iznasadi
џбунови	d͡ʒbunɔvi
прегризува	prɛɡrizuva
сојузништво	sɔjuzniʃtvɔ
лепрозен	lɛprɔzɛn
баба	baba
ургентен	urɡɛntɛn
габеров	ɡabɛɾɔf
команда	kɔmanda
современост	sɔvrɛmɛnɔst
септички	sɛptit͡ʃki
шегаџиски	ʃɛɡad͡ʒiski
чифлиг	t͡ʃiflik
разблажува	razbɫaʒuva
азбука	azbuka
два	dva
желкин	ʒɛɫkin
еленче	ɛlɛnt͡ʃɛ
одметник	ɔdmɛtnik
ласица	ɫasit͡sa
потстопли	pɔtstɔpli
забест	zabɛst
индија	indija
брзак	br̩zak
капнатост	kapnatɔst
затворски	zatvɔrski
политика	pɔlitika
технологија	tɛxnɔɫɔɡija
еднобојност	ɛdnɔbɔjnɔst
наводенува	navɔdɛnuva
несразмерност	nɛsrazmɛrnɔst
провалничка	prɔvaɫnit͡ʃka
таму	tamu
различност	razlit͡ʃnɔst
сопственички	sɔpstvɛnit͡ʃki
џин	d͡ʒin
изгали	izɡali
расчешла	raʃt͡ʃɛʃɫa
дете	dɛtɛ
похотливост	pɔxɔtlivɔst
оса	ɔsa
скита	skita
набрашнува	nabraʃnuva
човеку	t͡ʃɔvɛku
орнитологија	ɔrnitɔɫɔɡija
дистопија	distɔpija
стакларка	stakɫarka
учење	ut͡ʃɛɲɛ
прерија	prɛɾija
прорти	prɔrti
реторика	rɛtɔɾika
спорност	spɔrnɔst
скокнува	skɔknuva
презира	prɛziɾa
генералисимус	ɡɛnɛɾalisimus
нараторски	naratɔrski
интерен	intɛɾɛn
свињарка	sviɲarka
ведрост	vɛdrɔst
застапнички	zastapnit͡ʃki
загинува	zaɡinuva
дупчуле	dupt͡ʃulɛ
испливува	isplivuva
потрошува	pɔtrɔʃuva
македонки	makɛdɔŋki
сланиница	sɫaninit͡sa
напрашува	napraʃuva
ненавикнат	nɛnaviknat
овдека	ɔvdɛka
реставрација	rɛstavrat͡sija
зголеменост	zɡɔlɛmɛnɔst
чорбичка	t͡ʃɔrbit͡ʃka
недооценет	nɛdɔɔt͡sɛnɛt
извиднички	izvidnit͡ʃki
голем	ɡɔlɛm
фиксација	fiksat͡sija
егзотичност	ɛɡzɔtit͡ʃnɔst
кај	kaj
крволочност	kr̩vɔɫɔt͡ʃnɔst
безболност	bɛzbɔɫnɔst
малинов	malinɔf
симетрија	simɛtrija
маџуроански	mad͡ʒuɾɔanski
бунтови	buntɔvi
недоткаен	nɛdɔtkaɛn
напудри	napudri
дабје	dabjɛ
самодејност	samɔdɛjnɔst
запомнува	zapɔmnuva
напрегнатост	naprɛɡnatɔst
потпивнува	pɔtpivnuva
клати	kɫati
метла	mɛtɫa
кравар	kravar
шнајдер	ʃnajdɛr
пронаоѓач	prɔnaɔɟat͡ʃ
цутка	t͡sutka
ограда	ɔɡrada
операциски	ɔpɛrat͡siski
млечност	mlɛt͡ʃnɔst
ѓаконски	ɟakɔnski
наивност	naivnɔst
пцовисува	pt͡sɔvisuva
барабанче	barabant͡ʃɛ
излудува	izɫuduva
пршка	pr̩ʃka
рандеву	randɛvu
ниво	nivɔ
југославија	juɡɔsɫavija
дотепува	dɔtɛpuva
париски	paɾiski
крекнува	krɛknuva
струи	strui
петмина	pɛtmina
прелистувачи	prɛlistuvat͡ʃi
запче	zapt͡ʃɛ
колаченце	kɔɫat͡ʃɛnt͡sɛ
чудност	t͡ʃudnɔst
комар	kɔmar
султанов	suɫtanɔf
базука	bazuka
исфрлен	isfr̩lɛn
витештво	vitɛʃtvɔ
катанец	katanɛt͡s
сталоженост	staɫɔʒɛnɔst
циник	t͡sinik
клише	kliʃɛ
ортак	ɔrtak
битност	bitnɔst
препржи	prɛpr̩ʒi
синап	sinap
валенција	valɛnt͡sija
дудлец	dudlɛt͡s
деветнаесет	dɛvɛtnaɛsɛt
дречливост	drɛt͡ʃlivɔst
долина	dɔlina
папучарски	paput͡ʃarski
забулува	zabuɫuva
читател	t͡ʃitatɛɫ
каци	kat͡si
штрафче	ʃtraft͡ʃɛ
гради	ɡradi
кифличка	kiflit͡ʃka
изустува	izustuva
несправедливост	nɛspravɛdlivɔst
заострува	zaɔstruva
претплатник	prɛtpɫatnik
косачка	kɔsat͡ʃka
столица	stɔlit͡sa
детски	dɛtski
дрворед	dr̩vɔɾɛt
конверзација	kɔɱvɛrzat͡sija
товар	tɔvar
жабичка	ʒabit͡ʃka
патор	patɔr
кумов	kumɔf
фосилен	fɔsilɛn
разурнатост	razurnatɔst
сталешки	stalɛʃki
пород	pɔɾɔt
езерце	ɛzɛrt͡sɛ
засакува	zasakuva
кучиња	kut͡ʃiɲa
бибер	bibɛr
доле	dɔlɛ
погрешува	pɔɡrɛʃuva
тореадорски	tɔɾɛadɔrski
необјаснивост	nɛɔbjasnivɔst
ескалација	ɛskaɫat͡sija
восприемчивост	vɔsprijɛmt͡ʃivɔst
орден	ɔrdɛn
вмрежува	vmrɛʒuva
развиеност	razvijɛnɔst
тастатура	tastatuɾa
друг	druk
списание	spisanijɛ
берба	bɛrba
бесчовечност	bɛʃt͡ʃɔvɛt͡ʃnɔst
летач	lɛtat͡ʃ
загриженост	zaɡriʒɛnɔst
шарпланинец	ʃarpɫaninɛt͡s
призвук	prizvuk
далекоисточен	dalɛkɔistɔt͡ʃɛn
раскрвавеност	raskr̩vavɛnɔst
дваж	dvaʃ
бркови	br̩kɔvi
виуличав	vijulit͡ʃaf
крвожедност	kr̩vɔʒɛdnɔst
загатливост	zaɡatlivɔst
поџвака	pɔd͡ʒvaka
решеност	rɛʃɛnɔst
премаленост	prɛmalɛnɔst
пошта	pɔʃta
дуќан	ducan
недонесен	nɛdɔnɛsɛn
прегорува	prɛɡɔɾuva
раскрене	raskrɛnɛ
штедливост	ʃtɛdlivɔst
враќе	vracɛ
салата	saɫata
западњак	zapadɲak
пазар	pazar
лекувачка	lɛkuvat͡ʃka
историчарка	istɔrit͡ʃarka
синџирче	sind͡ʒirt͡ʃɛ
пресними	prɛsnimi
дента	dɛnta
гладува	ɡɫaduva
дигитализација	diɡitalizat͡sija
оџачарство	ɔd͡ʒat͡ʃarstvɔ
проблематичност	prɔblɛmatit͡ʃnɔst
целосност	t͡sɛɫɔsnɔst
натпросечност	natprɔsɛt͡ʃnɔst
дошиша	dɔʃiʃa
братислава	bratisɫava
напредност	naprɛdnɔst
грбови	ɡr̩bɔvi
џеб	d͡ʒɛp
зрее	zrɛɛ
тиква	tikva
пукот	pukɔt
лаленце	ɫalɛnt͡sɛ
ронливост	rɔnlivɔst
ѓубриво	ɟubrivɔ
кофа	kɔfa
постапен	pɔstapɛn
здруженост	zdruʒɛnɔst
наведнува	navɛdnuva
трезвеник	trɛzvɛnik
дувне	duvnɛ
крило	kriɫɔ
крпче	kr̩pt͡ʃɛ
пишуваш	piʃuvaʃ
должински	dɔɫʒinski
нераскинливост	nɛɾaskinlivɔst
специјализација	spɛt͡sijalizat͡sija
трупа	trupa
њујорк	ɲujɔrk
видра	vidra
недоготвен	nɛdɔɡɔtvɛn
урологија	uɾɔɫɔɡija
коренче	kɔɾɛnt͡ʃɛ
распределеност	rasprɛdɛlɛnɔst
незабележливост	nɛzabɛlɛʒlivɔst
регенерација	rɛɡɛnɛrat͡sija
глекав	ɡlɛkaf
пример	primɛr
челенка	t͡ʃɛlɛŋka
ѝ	i
метарски	mɛtarski
ненадарен	nɛnadaɾɛn
одмазднички	ɔdmazdnit͡ʃki
инспекциски	inspɛkt͡siski
незаштитен	nɛzaʃtitɛn
скокотливост	skɔkɔtlivɔst
мирисливост	mirislivɔst
неподносливост	nɛpɔdnɔslivɔst
вдовство	vdɔfstvɔ
дезинформација	dɛziɱfɔrmat͡sija
сомничавост	sɔmnit͡ʃavɔst
брашнен	braʃnɛn
изнаоблече	iznaɔblɛt͡ʃɛ
поварди	pɔvardi
искача	iskat͡ʃa
ѕвек	d͡zvɛk
наводени	navɔdɛni
краток	kratɔk
испохефта	ispɔxɛfta
отавјански	ɔtavjanski
десетмина	dɛsɛtmina
млекце	mlɛkt͡sɛ
метеорологија	mɛtɛɔɾɔɫɔɡija
сопружништво	sɔpruʒniʃtvɔ
неприлагоден	nɛpriɫaɡɔdɛn
кифла	kifɫa
недоречен	nɛdɔɾɛt͡ʃɛn
утопија	utɔpija
кабул	kabuɫ
ден	dɛn
моторика	mɔtɔɾika
расуди	rasudi
рапсодија	rapsɔdija
млитавост	mlitavɔst
накопа	nakɔpa
освојувачки	ɔsvɔjuvat͡ʃki
ординарија	ɔrdinaɾija
предоговори	prɛdɔɡɔvɔɾi
мелник	mɛɫnik
сурутка	suɾutka
прегази	prɛɡazi
одведува	ɔdvɛduva
поскока	pɔskɔka
легија	lɛɡija
притиснува	pritisnuva
око	ɔkɔ
врбов	vr̩bɔf
безопасност	bɛzɔpasnɔst
пресолува	prɛsɔɫuva
луленце	ɫulɛnt͡sɛ
ковчест	kɔft͡ʃɛst
затилок	zatiɫɔk
капинов	kapinɔf
пантомимичарка	pantɔmimit͡ʃarka
определеност	ɔprɛdɛlɛnɔst
математики	matɛmatiki
зограф	zɔɡraf
мече	mɛt͡ʃɛ
претстои	prɛtstɔi
авторка	aftɔrka
свастика	svastika
ораторски	ɔratɔrski
расправа	rasprava
покука	pɔkuka
устав	ustaf
леунка	lɛuŋka
спонтаност	spɔntanɔst
намотува	namɔtuva
демонстрација	dɛmɔnstrat͡sija
повикува	pɔvikuva
лед	lɛt
фаќа	faca
огламник	ɔɡɫamnik
ебам	ɛbam
јогурт	jɔɡurt
влашко	vɫaʃkɔ
летово	lɛtɔvɔ
мај	maj
епископија	ɛpiskɔpija
ѕверови	d͡zvɛɾɔvi
гушав	ɡuʃaf
наклеветува	naklɛvɛtuva
гнасотилак	ɡnasɔtiɫak
кадија	kadija
газ	ɡas
чудо	t͡ʃudɔ
оседлува	ɔsɛdɫuva
бељаџија	bɛlad͡ʒija
кондуктерка	kɔnduktɛrka
дерматологија	dɛrmatɔɫɔɡija
тврдост	tvr̩dɔst
испобрка	ispɔbr̩ka
јаренце	jaɾɛnt͡sɛ
поп	pɔp
човекон	t͡ʃɔvɛkɔn
загушливост	zaɡuʃlivɔst
потропа	pɔtrɔpa
диграф	diɡraf
подзасипне	pɔdzasipnɛ
заптија	zaptija
еврејство	ɛvrɛjstvɔ
чедо	t͡ʃɛdɔ
справа	sprava
усрдност	usr̩dnɔst
млад	mɫat
пастеризација	pastɛɾizat͡sija
дрво	dr̩vɔ
бесмисленост	bɛsmislɛnɔst
проѕирка	prɔd͡zirka
име	imɛ
татенце	tatɛnt͡sɛ
касиерка	kasijɛrka
филмче	fiɫm̩t͡ʃɛ
прозвучува	prɔzvut͡ʃuva
луѓе	ɫuɟɛ
книжарка	kniʒarka
преведува	prɛvɛduva
соодветство	sɔɔdvɛtstvɔ
недосечен	nɛdɔsɛt͡ʃɛn
пловност	pɫɔvnɔst
следбеничка	slɛdbɛnit͡ʃka
модул	mɔduɫ
мастилен	mastilɛn
благ	bɫak
загрижувачки	zaɡriʒuvat͡ʃki
децана	dɛt͡sana
муцка	mut͡ska
црква	t͡sr̩kva
мажа	maʒa
стакленце	staklɛnt͡sɛ
замисленост	zamislɛnɔst
пепелник	pɛpɛɫnik
допушува	dɔpuʃuva
акумулација	akumuɫat͡sija
омекнувач	ɔmɛknuvat͡ʃ
завеса	zavɛsa
брада	brada
хеликоптер	xɛlikɔptɛr
прежива	prɛʒiva
мувливост	muvlivɔst
распространетост	rasprɔstranɛtɔst
дотура	dɔtuɾa
настани	nastani
допржува	dɔpr̩ʒuva
денов	dɛnɔf
изречен	izrɛt͡ʃɛn
нагазува	naɡazuva
доварува	dɔvaɾuva
размер	razmɛr
женине	ʒɛninɛ
камионче	kamijɔnt͡ʃɛ
сноп	snɔp
чиниче	t͡ʃinit͡ʃɛ
ѓакон	ɟakɔn
никаквец	nikakvɛt͡s
височина	visɔt͡ʃina
извидува	izviduva
полисемија	pɔlisɛmija
неоладен	nɛɔɫadɛn
легализација	lɛɡalizat͡sija
почука	pɔt͡ʃuka
предводи	prɛdvɔdi
авенија	avɛnija
луна	ɫuna
ѓавол	ɟavɔɫ
јаглерод	jaɡlɛɾɔt
госпоѓа	ɡɔspɔɟa
ненаправен	nɛnapravɛn
трнка	tr̩n̩ka
закркорува	zakr̩kɔɾuva
намрштеност	namr̩ʃtɛnɔst
одвојува	ɔdvɔjuva
крадец	kradɛt͡s
блуз	bɫus
бели	bɛli
отпловува	ɔtpɫɔvuva
необновливост	nɛɔbnɔvlivɔst
капак	kapak
инаетчија	inaɛtt͡ʃija
снеговит	snɛɡɔvit
крои	krɔi
снопче	snɔpt͡ʃɛ
граматикализација	ɡramatikalizat͡sija
небеса	nɛbɛsa
делбен	dɛɫbɛn
чукало	t͡ʃukaɫɔ
обврзник	ɔbvr̩znik
аквариум	akvaɾijum
куповен	kupɔvɛn
засипнатост	zasipnatɔst
ние	nijɛ
алат	aɫat
лавчиња	ɫaft͡ʃiɲa
чудесија	t͡ʃudɛsija
порта	pɔrta
рудник	rudnik
’рскавичен	r̩skavit͡ʃɛn
итрина	itrina
распис	raspis
напоменува	napɔmɛnuva
самрачен	samrat͡ʃɛn
едногласност	ɛdnɔɡɫasnɔst
ровкост	rɔfkɔst
џагор	d͡ʒaɡɔr
задорко	zadɔrkɔ
ливада	livada
замесува	zamɛsuva
цигарче	t͡siɡart͡ʃɛ
парчуле	part͡ʃulɛ
пристрасност	pristrasnɔst
елка	ɛɫka
јаве	javɛ
самовластие	samɔvɫastijɛ
само	samɔ
множеник	mnɔʒɛnik
подлизне	pɔdliznɛ
штрајк	ʃtrajk
непроветрен	nɛprɔvɛtrɛn
држава	dr̩ʒava
доработува	dɔɾabɔtuva
одговор	ɔdɡɔvɔr
гнилост	ɡniɫɔst
тригонометрија	triɡɔnɔmɛtrija
четири	t͡ʃɛtiɾi
пљампа	plampa
одбојка	ɔdbɔjka
вклучителност	fkɫut͡ʃitɛɫnɔst
сеприсутност	sɛprisutnɔst
џинови	d͡ʒinɔvi
пеперутче	pɛpɛɾutt͡ʃɛ
кравче	kraft͡ʃɛ
пробој	prɔbɔj
пајаков	pajakɔf
неа	nɛa
глоса	ɡɫɔsa
исплатливост	ispɫatlivɔst
контурен	kɔntuɾɛn
фаличност	falit͡ʃnɔst
безмалку	bɛzmaɫku
ничкум	nit͡ʃkum
снегулче	snɛɡuɫt͡ʃɛ
кошарка	kɔʃarka
биро	birɔ
зимурливост	zimurlivɔst
нагостува	naɡɔstuva
работник	rabɔtnik
бок	bɔk
загорува	zaɡɔɾuva
хамбургер	xamburɡɛr
високообразовен	visɔkɔɔbrazɔvɛn
трансфобија	transfɔbija
во	vɔ
декември	dɛkɛɱvri
бротче	brɔtt͡ʃɛ
шаткин	ʃatkin
ласка	ɫaska
почестува	pɔt͡ʃɛstuva
дедов	dɛdɔf
скришност	skriʃnɔst
клавичембало	kɫavit͡ʃɛmbaɫɔ
опашува	ɔpaʃuva
уникатност	unikatnɔst
џакартски	d͡ʒakartski
кибернетика	kibɛrnɛtika
невалиден	nɛvalidɛn
фармација	farmat͡sija
прсте	pr̩stɛ
монах	mɔnax
однесува	ɔdnɛsuva
раби	rabi
глина	ɡlina
негостопримливост	nɛɡɔstɔprimlivɔst
мачорски	mat͡ʃɔrski
тих	tix
редакција	rɛdakt͡sija
ентропија	ɛntrɔpija
мирта	mirta
слива	sliva
сердарски	sɛrdarski
расели	rasɛli
неуспех	nɛuspɛx
репрезентација	rɛprɛzɛntat͡sija
негов	nɛɡɔf
словенка	sɫɔvɛŋka
турчинка	turt͡ʃiŋka
олабави	ɔɫabavi
избирачки	izbiɾat͡ʃki
поклати	pɔkɫati
минливост	minlivɔst
домат	dɔmat
нивје	nivjɛ
ресичен	rɛsit͡ʃɛn
стадо	stadɔ
трескот	trɛskɔt
в’лтава	vəɫtava
матичен	matit͡ʃɛn
џуџе	d͡ʒud͡ʒɛ
подзаборави	pɔdzabɔɾavi
осуммина	ɔsummina
прастар	prastar
деновине	dɛnɔvinɛ
потсече	pɔtsɛt͡ʃɛ
децата	dɛt͡sata
одгризува	ɔdɡrizuva
ноќ	nɔc
стави	stavi
жабји	ʒabji
напнува	napnuva
натопорува	natɔpɔɾuva
жолтило	ʒɔɫtiɫɔ
вујче	vujt͡ʃɛ
ѓаволче	ɟavɔɫt͡ʃɛ
дрдорко	dr̩dɔrkɔ
содржаен	sɔdr̩ʒaɛn
ѕвер	d͡zvɛr
љубљански	lublanski
мачка	mat͡ʃka
пикадо	pikadɔ
забрзаност	zabr̩zanɔst
печурка	pɛt͡ʃurka
озарува	ɔzaɾuva
скопјанка	skɔpjaŋka
мал	maɫ
крцнува	kr̩t͡snuva
подмрдне	pɔdmr̩dnɛ
апелациски	apɛɫat͡siski
лидер	lidɛr
в	və
волан	vɔɫan
заклокотува	zakɫɔkɔtuva
кина	kina
кралоубиство	kraɫɔubistvɔ
менторство	mɛntɔrstvɔ
виена	vijɛna
необјаснив	nɛɔbjasnif
измрзнува	izmr̩znuva
курвинство	kurvinstvɔ
вулгаризација	vuɫɡaɾizat͡sija
всушност	fsuʃnɔst
гнасотија	ɡnasɔtija
закрпува	zakr̩puva
бескарактерност	bɛskaraktɛrnɔst
аргументација	arɡumɛntat͡sija
заклучен	zakɫut͡ʃɛn
истрелува	istrɛɫuva
поулавува	pɔuɫavuva
оториноларингологија	ɔtɔɾinɔɫaɾiŋɡɔɫɔɡija
пишувам	piʃuvam
предава	prɛdava
змиски	zmiski
деградација	dɛɡradat͡sija
блеснува	blɛsnuva
нерешен	nɛɾɛʃɛn
испупченост	ispupt͡ʃɛnɔst
жонглерски	ʒɔŋɡlɛrski
ајвани	ajvani
седумнаесет	sɛdumnaɛsɛt
безгрижност	bɛzɡriʒnɔst
лондон	ɫɔndɔn
надвикува	nadvikuva
габа	ɡaba
теза	tɛza
неусогласеност	nɛusɔɡɫasɛnɔst
свикува	svikuva
недопечен	nɛdɔpɛt͡ʃɛn
гнезденце	ɡnɛzdɛnt͡sɛ
мирољубивост	miɾɔlubivɔst
многу	nɔɡu
избувливост	izbuvlivɔst
клетка	klɛtka
кошничка	kɔʃnit͡ʃka
избацува	izbat͡suva
коцка	kɔt͡ska
снаодливост	snaɔdlivɔst
платина	pɫatina
грамаѓе	ɡramaɟɛ
испокорне	ispɔkɔrnɛ
релација	rɛɫat͡sija
трансформација	transfɔrmat͡sija
разбушавеност	razbuʃavɛnɔst
надреденост	nadrɛdɛnɔst
поѕвечи	pɔd͡zvɛt͡ʃi
јатрвин	jatr̩vin
население	nasɛlɛnijɛ
повиси	pɔvisi
неразјаснетост	nɛɾazjasnɛtɔst
ајде	ajdɛ
воѓе	vɔɟɛ
стилизација	stilizat͡sija
непогрешливост	nɛpɔɡrɛʃlivɔst
усмртува	usmr̩tuva
изнавитка	iznavitka
непреодност	nɛprɛɔdnɔst
древен	drɛvɛn
одвратност	ɔdvratnɔst
едноумие	ɛdnɔumijɛ
анафора	anafɔɾa
стопува	stɔpuva
близу	blizu
кумулација	kumuɫat͡sija
’рбетен	r̩bɛtɛn
довикува	dɔvikuva
носталгичност	nɔstaɫɡit͡ʃnɔst
симетричност	simɛtrit͡ʃnɔst
тенденција	tɛndɛnt͡sija
напорност	napɔrnɔst
ноќе	nɔcɛ
наплеска	naplɛska
пермутација	pɛrmutat͡sija
ѓаволест	ɟavɔlɛst
исфаќа	isfaca
мост	mɔst
изложбен	izɫɔʒbɛn
аристократија	aɾistɔkratija
враг	vrak
разузданост	razuzdanɔst
опера	ɔpɛɾa
превива	prɛviva
љубљана	lublana
гусарство	ɡusarstvɔ
археологија	arxɛɔɫɔɡija
докачи	dɔkat͡ʃi
пивар	pivar
попати	pɔpati
москва	mɔskva
самохран	samɔxran
русе	rusɛ
забележливост	zabɛlɛʒlivɔst
бејрутски	bɛjrutski
замрсува	zamr̩suva
згодност	zɡɔdnɔst
осцилациски	ɔst͡siɫat͡siski
брод	brɔt
дисквалификација	diskvalifikat͡sija
милион	milijɔn
април	apriɫ
поевтинува	pɔɛftinuva
растројство	rastrɔjstvɔ
славеј	sɫavɛj
окрвавува	ɔkr̩vavuva
нафрла	nafr̩ɫa
музика	muzika
изнаголта	iznaɡɔɫta
шеќерче	ʃɛcɛrt͡ʃɛ
грутка	ɡrutka
прозвучи	prɔzvut͡ʃi
гостилница	ɡɔstiɫnit͡sa
одредиште	ɔdrɛdiʃtɛ
окупаторски	ɔkupatɔrski
копула	kɔpuɫa
глаголица	ɡɫaɡɔlit͡sa
нас	nas
рано	ranɔ
невооружан	nɛvɔɔɾuʒan
писнува	pisnuva
изненадност	iznɛnadnɔst
душкало	duʃkaɫɔ
зглоб	zɡɫɔp
ралник	raɫnik
јажарски	jaʒarski
необоснованост	nɛɔbɔsnɔvanɔst
згрозеност	zɡrɔzɛnɔst
заразност	zaɾaznɔst
натприродност	natpriɾɔdnɔst
топ	tɔp
именце	imɛnt͡sɛ
подзалади	pɔdzaɫadi
матерка	matɛrka
новина	nɔvina
авиоиндустрија	avijɔindustrija
елек	ɛlɛk
згазнува	zɡaznuva
исчистува	iʃt͡ʃistuva
згуснатост	zɡusnatɔst
лимонов	limɔnɔf
сплеткар	splɛtkar
изнаака	iznaaka
изназеме	iznazɛmɛ
снеможува	snɛmɔʒuva
осумнаесет	ɔsumnaɛsɛt
недоследност	nɛdɔslɛdnɔst
адаптација	adaptat͡sija
шајка	ʃajka
евакуација	ɛvakuat͡sija
бумбарче	bumbart͡ʃɛ
заобленост	zaɔblɛnɔst
физиотерапија	fizijɔtɛrapija
нога	nɔɡa
претприемништво	prɛtprijɛmniʃtvɔ
лакрдија	ɫakr̩dija
соучеснички	sɔut͡ʃɛsnit͡ʃki
легален	lɛɡalɛn
полски	pɔɫski
преземе	prɛzɛmɛ
дваесет	dvaɛsɛt
овој	ɔvɔj
мнение	mnɛnijɛ
урбанизација	urbanizat͡sija
ослободеност	ɔsɫɔbɔdɛnɔst
ограниченост	ɔɡranit͡ʃɛnɔst
абонент	abɔnɛnt
набљудувачки	nabluduvat͡ʃki
усвојлив	usvɔjlif
распаќе	raspacɛ
клинички	klinit͡ʃki
варна	varna
моминство	mɔminstvɔ
цаблан	t͡sabɫan
издолженост	izdɔɫʒɛnɔst
лезбејски	lɛzbɛjski
разголеност	razɡɔlɛnɔst
благо	bɫaɡɔ
погмечи	pɔɡmɛt͡ʃi
еднообразност	ɛdnɔɔbraznɔst
цимоли	t͡simɔli
сврзаност	svr̩zanɔst
самострел	samɔstrɛɫ
трагикомичен	traɡikɔmit͡ʃɛn
чека	t͡ʃɛka
чевел	t͡ʃɛvɛɫ
подзголеми	pɔdzɡɔlɛmi
змијулест	zmijulɛst
киев	kijɛf
крст	kr̩st
прв	pr̩f
магарица	maɡaɾit͡sa
мразулец	mrazulɛt͡s
зачудувачки	zat͡ʃuduvat͡ʃki
ѕвонар	d͡zvɔnar
извршен	izvr̩ʃɛn
етнографија	ɛtnɔɡrafija
повраќа	pɔvraca
пингвин	piŋɡvin
подрашири	pɔdraʃiɾi
откинува	ɔtkinuva
неподмитливост	nɛpɔdmitlivɔst
осило	ɔsiɫɔ
лаптоп	ɫaptɔp
свињарство	sviɲarstvɔ
така	taka
препливува	prɛplivuva
заповед	zapɔvɛt
пинјин	pinjin
венечен	vɛnɛt͡ʃɛn
прегризе	prɛɡrizɛ
шишуле	ʃiʃulɛ
пекарство	pɛkarstvɔ
задушува	zaduʃuva
песна	pɛsna
чумен	t͡ʃumɛn
миленик	milɛnik
допива	dɔpiva
бессовесност	bɛssɔvɛsnɔst
час	t͡ʃas
меченце	mɛt͡ʃɛnt͡sɛ
бејрут	bɛjrut
афикс	afiks
недоправен	nɛdɔpravɛn
изворче	izvɔrt͡ʃɛ
фармерки	farmɛrki
њујорчанка	ɲujɔrt͡ʃaŋka
венеција	vɛnɛt͡sija
драматичност	dramatit͡ʃnɔst
танцов	tant͡sɔf
признаница	priznanit͡sa
дисертациски	disɛrtat͡siski
романтичарка	rɔmantit͡ʃarka
впрочем	fprɔt͡ʃɛm
арно	arnɔ
перфидност	pɛrfidnɔst
вез	vɛs
подзаобли	pɔdzaɔbli
ѓоа	ɟɔa
разреже	razrɛʒɛ
жупа	ʒupa
’рбет	r̩bɛt
винарство	vinarstvɔ
последок	pɔslɛdɔk
краварство	kravarstvɔ
безвизен	bɛzvizɛn
испокубе	ispɔkubɛ
колку	kɔɫku
те	tɛ
бродоградилиште	brɔdɔɡradiliʃtɛ
двајца	dvajt͡sa
аберација	abɛrat͡sija
освежувач	ɔsvɛʒuvat͡ʃ
убиство	ubistvɔ
вестителка	vɛstitɛɫka
питомост	pitɔmɔst
германка	ɡɛrmaŋka
четириесет	t͡ʃɛtirijɛsɛt
безименост	bɛzimɛnɔst
книжуле	kniʒulɛ
трезорски	trɛzɔrski
уста	usta
дака	daka
ископува	iskɔpuva
оревче	ɔɾɛft͡ʃɛ
неразделност	nɛrazdɛɫnɔst
сенаторски	sɛnatɔrski
согорување	sɔɡɔruvaɲɛ
житарство	ʒitarstvɔ
британија	britanija
неприлика	nɛprilika
самоубиствен	samɔubistvɛn
внуков	vnukɔf
сомнение	sɔmnɛnijɛ
заслепителен	zaslɛpitɛlɛn
дизентерија	dizɛntɛɾija
пакистан	pakistan
влепи	vlɛpi
добојува	dɔbɔjuva
неизбришан	nɛizbriʃan
подисчисти	pɔdiʃt͡ʃisti
онаму	ɔnamu
ров	rɔf
навраќа	navraca
прозорец	prɔzɔɾɛt͡s
сон	sɔn
варварка	varvarka
лепче	lɛpt͡ʃɛ
четкичка	t͡ʃɛtkit͡ʃka
резбарски	rɛzbarski
месечарство	mɛsɛt͡ʃarstvɔ
нокшир	nɔkʃir
гурабија	ɡurabija
зајдисонце	zajdisɔnt͡sɛ
јунешки	junɛʃki
раменце	ramɛnt͡sɛ
заврнува	zavr̩nuva
лопата	ɫɔpata
библиотека	biblijɔtɛka
поклечи	pɔklɛt͡ʃi
јаден	jadɛn
париз	paɾis
непокажан	nɛpɔkaʒan
потпржува	pɔtpr̩ʒuva
ранозрелост	ranɔzrɛɫɔst
котларски	kɔtɫarski
време	vrɛmɛ
крајречен	krajrɛt͡ʃɛn
формулација	fɔrmuɫat͡sija
фала	faɫa
испотутка	ispɔtutka
шушкав	ʃuʃkaf
жарче	ʒart͡ʃɛ
седенка	sɛdɛŋka
регулација	rɛɡuɫat͡sija
ситнурија	sitnuɾija
изнацепи	iznat͡sɛpi
редакциски	rɛdakt͡siski
високосен	visɔkɔsɛn
половичност	pɔɫɔvit͡ʃnɔst
размерлив	razmɛrlif
безобразност	bɛzɔbraznɔst
конотација	kɔnɔtat͡sija
желудец	ʒɛɫudɛt͡s
местоположба	mɛstɔpɔɫɔʒba
згаденост	zɡadɛnɔst
фасцинација	fast͡sinat͡sija
ранец	ranɛt͡s
дискриминација	diskriminat͡sija
зошо	zɔʃɔ
мачиња	mat͡ʃiɲa
целовит	t͡sɛɫɔvit
двапати	dvapati
закон	zakɔn
чембалистки	t͡ʃɛmbalistki
оклоп	ɔkɫɔp
испита	ispita
девиза	dɛviza
брегови	brɛɡɔvi
лав	ɫaf
гризе	ɡrizɛ
владика	vɫadika
прељубник	prɛlubnik
осин	ɔsin
удобност	udɔbnɔst
грнец	ɡr̩nɛt͡s
префикс	prɛfiks
далечност	dalɛt͡ʃnɔst
роковник	rɔkɔvnik
пердувче	pɛrduft͡ʃɛ
поток	pɔtɔk
мајчин	majt͡ʃin
месец	mɛsɛt͡s
цвеќуле	t͡svɛculɛ
сразмер	srazmɛr
банализација	banalizat͡sija
водата	vɔdata
сводништво	svɔdniʃtvɔ
јадеж	jadɛʃ
брат	brat
достоинство	dɔstɔinstvɔ
изнаброи	iznabrɔi
дотови	dɔtɔvi
неповторливост	nɛpɔftɔrlivɔst
фронт	frɔnt
оладува	ɔɫaduva
костенов	kɔstɛnɔf
планинарски	pɫaninarski
куфер	kufɛr
луѓено	ɫuɟɛnɔ
подоткрие	pɔdɔtkrijɛ
потргне	pɔtr̩ɡnɛ
хемотерапија	xɛmɔtɛrapija
ама	ama
бранителство	branitɛɫstvɔ
острина	ɔstrina
лекторски	lɛktɔrski
мајстор	majstɔr
фондација	fɔndat͡sija
касметлија	kasmɛtlija
виножито	vinɔʒitɔ
вратарка	vratarka
клунка	kɫuŋka
зближува	zbliʒuva
поплаче	pɔpɫat͡ʃɛ
доуништува	dɔuniʃtuva
поточе	pɔtɔt͡ʃɛ
феудализам	fɛudalizam
потсетник	pɔtsɛtnik
тврдоглавост	tvr̩dɔɡɫavɔst
број	brɔj
чаршаф	t͡ʃarʃaf
екранизација	ɛkranizat͡sija
огласник	ɔɡɫasnik
малверзациски	maɫvɛrzat͡siski
амбасадорка	ambasadɔrka
недвижнини	nɛdviʒnini
стокхолм	stɔkxɔɫm̩
роса	rɔsa
изгрев	izɡrɛf
делумно	dɛɫumnɔ
бројност	brɔjnɔst
пустиник	pustinik
амански	amanski
дорушува	dɔruʃuva
ревност	rɛvnɔst
недотриен	nɛdɔtrijɛn
изминува	izminuva
фетиш	fɛtiʃ
јазовец	jazɔvɛt͡s
едро	ɛdrɔ
вбројува	vbrɔjuva
славејче	sɫavɛjt͡ʃɛ
домота	dɔmɔta
побеснува	pɔbɛsnuva
ѓубренце	ɟubrɛnt͡sɛ
ненадминатост	nɛnadminatɔst
самољубивост	samɔlubivɔst
неорганизираност	nɛɔrɡaniziɾanɔst
демонски	dɛmɔnski
снобовски	snɔbɔfski
вулкан	vuɫkan
ненавикнатост	nɛnaviknatɔst
композиторски	kɔmpɔzitɔrski
ќесичка	cɛsit͡ʃka
маса	masa
отшрафува	ɔtʃrafuva
старец	staɾɛt͡s
раскошност	raskɔʃnɔst
амвон	aɱvɔn
ракета	rakɛta
лајно	ɫajnɔ
водам	vɔdam
несфатливост	nɛsfatlivɔst
култивација	kuɫtivat͡sija
разбојнички	razbɔjnit͡ʃki
гракнува	ɡraknuva
дирек	diɾɛk
докажливост	dɔkaʒlivɔst
филтерски	fiɫtɛrski
волшебник	vɔɫʃɛbnik
зарипнатост	zaripnatɔst
ајван	ajvan
кабел	kabɛɫ
есеноска	ɛsɛnɔska
застрашувачки	zastraʃuvat͡ʃki
приближност	pribliʒnɔst
апија	apija
забие	zabijɛ
детонациски	dɛtɔnat͡siski
крошничка	krɔʃnit͡ʃka
вечера	vɛt͡ʃɛɾa
релјефен	rɛljɛfɛn
бичува	bit͡ʃuva
колосек	kɔɫɔsɛk
масиче	masit͡ʃɛ
библиски	bibliski
загаденост	zaɡadɛnɔst
наситува	nasituva
пребројува	prɛbrɔjuva
форма	fɔrma
ксенофобичен	ksɛnɔfɔbit͡ʃɛn
свињарник	sviɲarnik
поклопец	pɔkɫɔpɛt͡s
денот	dɛnɔt
србинка	sr̩biŋka
одгатнува	ɔdɡatnuva
задувува	zaduvuva
гулаб	ɡuɫap
денари	dɛnaɾi
изнафрла	iznafr̩ɫa
лисабонски	lisabɔnski
машинерија	maʃinɛɾija
обостраност	ɔbɔstranɔst
коси	kɔsi
војник	vɔjnik
чотра	t͡ʃɔtra
братучедов	bratut͡ʃɛdɔf
побутнува	pɔbutnuva
кинематографија	kinɛmatɔɡrafija
трајност	trajnɔst
подослаби	pɔdɔsɫabi
непотполност	nɛpɔtpɔɫnɔst
коњица	kɔɲit͡sa
тирана	tirana
тимбуски	timbuski
бајач	bajat͡ʃ
допрва	dɔpr̩va
прераспредели	prɛɾasprɛdɛli
поднаучи	pɔdnaut͡ʃi
усогласеност	usɔɡɫasɛnɔst
симпатичност	simpatit͡ʃnɔst
свиларка	sviɫarka
краткотрајност	kratkɔtrajnɔst
косичка	kɔsit͡ʃka
бигоросува	biɡɔrɔsuva
доучува	dɔut͡ʃuva
другпат	drukpat
ветришта	vɛtriʃta
старолик	staɾɔlik
задуманост	zadumanɔst
автархија	aftarxija
култура	kuɫtuɾa
пивце	pift͡sɛ
краставичка	krastavit͡ʃka
домерува	dɔmɛɾuva
љубовџија	lubɔvd͡ʒija
келнерка	kɛɫnɛrka
новинарка	nɔvinarka
сопружничка	sɔpruʒnit͡ʃka
правда	pravda
ќошеви	cɔʃɛvi
железо	ʒɛlɛzɔ
подизлиже	pɔdizliʒɛ
извисува	izvisuva
популација	pɔpuɫat͡sija
мислител	mislitɛɫ
ученик	ut͡ʃɛnik
божиќ	bɔʒic
елече	ɛlɛt͡ʃɛ
рог	rɔk
нешта	nɛʃta
обезоружува	ɔbɛzɔruʒuva
предодреденост	prɛdɔdrɛdɛnɔst
огромност	ɔɡrɔmnɔst
племе	plɛmɛ
ангелче	aŋɡɛɫt͡ʃɛ
неоправдан	nɛɔpravdan
немарност	nɛmarnɔst
удолу	udɔɫu
модулација	mɔduɫat͡sija
старче	start͡ʃɛ
богат	bɔɡat
базуки	bazuki
ексцентричност	ɛkst͡sɛntrit͡ʃnɔst
битолчанче	bitɔɫt͡ʃant͡ʃɛ
вљубеност	vlubɛnɔst
масло	masɫɔ
глинен	ɡlinɛn
рак	rak
куче	kut͡ʃɛ
прибраност	pribranɔst
оној	ɔnɔj
квас	kvas
ираде	iɾadɛ
сребрен	srɛbrɛn
додаток	dɔdatɔk
утрина	utrina
бездруго	bɛzdruɡɔ
отпара	ɔtpaɾa
поднаостри	pɔdnaɔstri
крал	kraɫ
дожд	dɔʃt
неверојатност	nɛvɛrɔjatnɔst
болник	bɔɫnik
девица	dɛvit͡sa
непроодност	nɛprɔɔdnɔst
сферичност	sfɛɾit͡ʃnɔst
воглавно	vɔɡɫavnɔ
тавтологија	taftɔɫɔɡija
циркулација	t͡sirkuɫat͡sija
докопува	dɔkɔpuva
жило	ʒiɫɔ
персонификација	pɛrsɔnifikat͡sija
водоотпорност	vɔdɔɔtpɔrnɔst
последователност	pɔslɛdɔvatɛɫnɔst
мрзливост	mr̩zlivɔst
безусловност	bɛzusɫɔvnɔst
емиграциски	ɛmiɡrat͡siski
решето	rɛʃɛtɔ
ќумур	cumur
рабоќе	rabɔcɛ
мандарински	mandarinski
зандански	zandanski
тимар	timar
дочитува	dɔt͡ʃituva
девет	dɛvɛt
презентира	prɛzɛntiɾa
заграденост	zaɡradɛnɔst
засмева	zasmɛva
авганистан	avɡanistan
килимче	kilimt͡ʃɛ
симфонија	simfɔnija
дигнатост	diɡnatɔst
недотрошен	nɛdɔtrɔʃɛn
бастунче	bastunt͡ʃɛ
хипопотомонстросесквипедалиофобија	xipɔpɔtɔmɔnstrɔsɛskvipɛdalijɔfɔbija
замрсеност	zamr̩sɛnɔst
вовед	vɔvɛt
скротум	skrotum
интернационален	intɛrnat͡sijɔnalɛn
предвидува	prɛdviduva
хонијарски	xɔnijarski
магистерски	maɡistɛrski
поспаност	pɔspanɔst
напоредност	napɔɾɛdnɔst
њујорчанец	ɲujɔrt͡ʃanɛt͡s
отшелник	ɔtʃɛɫnik
подиспече	pɔdispɛt͡ʃɛ
заглушува	zaɡɫuʃuva
надничарка	nadnit͡ʃarka
споменица	spɔmɛnit͡sa
вики	viki
причина	prit͡ʃina
изнапреде	iznaprɛdɛ
раководителка	rakɔvɔditɛɫka
олабавува	ɔɫabavuva
каталог	kataɫɔk
исповедалница	ispɔvɛdaɫnit͡sa
репа	rɛpa
орален	ɔɾalɛn
потребност	pɔtrɛbnɔst
дрнда	dr̩nda
запегла	zapɛɡɫa
навиткува	navitkuva
занимливост	zanimlivɔst
алати	aɫati
регистраторски	rɛɡistratɔrski
пасош	pasɔʃ
дочистува	dɔt͡ʃistuva
саможивност	samɔʒivnɔst
летен	lɛtɛn
кајсиичка	kajsiit͡ʃka
нагризува	naɡrizuva
нула	nuɫa
прокобница	prɔkɔbnit͡sa
змииште	zmiiʃtɛ
синоќа	sinɔca
задршка	zadr̩ʃka
доктор	dɔktɔr
истишува	istiʃuva
синтетика	sintɛtika
страничка	stranit͡ʃka
струга	struɡa
исползи	ispɔɫzi
заложница	zaɫɔʒnit͡sa
наемен	naɛmɛn
извор	izvɔr
тикварник	tikvarnik
твид	tvit
дворче	dvɔrt͡ʃɛ
погазува	pɔɡazuva
облаче	ɔbɫat͡ʃɛ
изнакити	iznakiti
догмечува	dɔɡmɛt͡ʃuva
нерешителност	nɛɾɛʃitɛɫnɔst
концизност	kɔnt͡siznɔst
празник	praznik
беспределност	bɛsprɛdɛɫnɔst
ќофте	cɔftɛ
доличност	dɔlit͡ʃnɔst
дизајнер	dizajnɛr
тржество	tr̩ʒɛstvɔ
препродаде	prɛprɔdadɛ
радиостаница	radijɔstanit͡sa
трансформатор	transfɔrmatɔr
кат	kat
кумува	kumuva
шеговит	ʃɛɡɔvit
шеријат	ʃɛɾijat
презиме	prɛzimɛ
преиспитува	prɛispituva
јазичен	jazit͡ʃɛn
аздисува	azdisuva
месест	mɛsɛst
триделен	tridɛlɛn
царува	t͡saɾuva
поколва	pɔkɔɫva
замагленост	zamaɡlɛnɔst
мислителка	mislitɛɫka
завојува	zavɔjuva
лете	lɛtɛ
оќелавува	ɔcɛɫavuva
епифора	ɛpifɔɾa
ѕвончест	d͡zvɔnt͡ʃɛst
планета	pɫanɛta
ласкавост	ɫaskavɔst
добања	dɔbaɲa
тефтерче	tɛftɛrt͡ʃɛ
начекува	nat͡ʃɛkuva
полуотворен	pɔɫuɔtvɔɾɛn
ѕевгар	d͡zɛvɡar
вреќа	vrɛca
ракавица	rakavit͡sa
поквачи	pɔkvat͡ʃi
парк	park
поддржател	pɔddr̩ʒatɛɫ
богословија	bɔɡɔsɫɔvija
унија	unija
копнува	kɔpnuva
рубрика	rubrika
ополномоштеник	ɔpɔɫnɔmɔʃtɛnik
свиња	sviɲa
синоптички	sinɔptit͡ʃki
мечок	mɛt͡ʃɔk
престапништво	prɛstapniʃtvɔ
баднички	badnit͡ʃki
бушилка	buʃiɫka
распрденост	raspr̩dɛnɔst
недоразвиеност	nɛdɔɾazvijɛnɔst
разрани	razrani
која	kɔja
прилог	priɫɔk
подготвеност	pɔdɡɔtvɛnɔst
испреплетеност	isprɛplɛtɛnɔst
предвиди	prɛdvidi
дежурство	dɛʒurstvɔ
кркнува	kr̩knuva
ноќева	nɔcɛva
јагленисува	jaɡlɛnisuva
пердаши	pɛrdaʃi
месингов	mɛsiŋɡɔf
оревокршачка	ɔɾɛvɔkr̩ʃat͡ʃka
олимпиец	ɔlimpijɛt͡s
сооднос	sɔɔdnɔs
винарка	vinarka
лудачки	ɫudat͡ʃki
критика	kritika
шише	ʃiʃɛ
таџикистан	tad͡ʒikistan
ѕвечка	d͡zvɛt͡ʃka
вратиче	vratit͡ʃɛ
обвинителски	ɔbvinitɛɫski
повереничка	pɔvɛrɛnit͡ʃka
монархиски	mɔnarxiski
орле	ɔrlɛ
еднојазичност	ɛdnɔjazit͡ʃnɔst
затапеност	zatapɛnɔst
препреденост	prɛprɛdɛnɔst
неугледност	nɛuɡlɛdnɔst
ненапишан	nɛnapiʃan
одмаздољубивост	ɔdmazdɔlubivɔst
недоварен	nɛdɔvaɾɛn
загрозеност	zaɡrɔzɛnɔst
бадемче	badɛmt͡ʃɛ
завртува	zavr̩tuva
пловдив	pɫɔvdif
офталмологија	ɔftaɫmɔɫɔɡija
мирува	miɾuva
неизмерност	nɛizmɛrnɔst
креда	krɛda
непоштеден	nɛpɔʃtɛdɛn
литија	litija
рационализација	rat͡sijɔnalizat͡sija
земја	zɛmja
рус	rus
дописник	dɔpisnik
мамутски	mamutski
оваму	ɔvamu
филтрација	fiɫtrat͡sija
наводнува	navɔdnuva
задолженост	zadɔɫʒɛnɔst
сколовранец	skɔɫɔvranɛt͡s
главен	ɡɫavɛn
авион	avijɔn
крзнарски	kr̩znarski
трошочен	trɔʃɔt͡ʃɛn
намеле	namɛlɛ
кимнува	kimnuva
распоредба	raspɔɾɛdba
доопремува	dɔɔprɛmuva
ќерки	cɛrki
бугарски	buɡarski
го	ɡɔ
изнајмува	iznajmuva
меѓународен	mɛɟunaɾɔdɛn
буква	bukva
алкохоличарка	aɫkɔxɔlit͡ʃarka
извлекува	izvlɛkuva
мавзолеј	mavzɔlɛj
доодговара	dɔɔdɡɔvaɾa
реконструкција	rɛkɔnstrukt͡sija
опредметува	ɔprɛdmɛtuva
робот	rɔbɔt
крошна	krɔʃna
осцилација	ɔst͡siɫat͡sija
гнаси	ɡnasi
кугличка	kuɡlit͡ʃka
чупе	t͡ʃupɛ
кажигаз	kaʒiɡas
мазност	maznɔst
пролет	prɔlɛt
онади	ɔnadi
полигамија	pɔliɡamija
зажлеби	zaʒlɛbi
световност	svɛtɔvnɔst
неподобност	nɛpɔdɔbnɔst
гатачки	ɡatat͡ʃki
прилегнува	prilɛɡnuva
проширува	prɔʃiɾuva
снопје	snɔpjɛ
старешинство	starɛʃinstvɔ
поточен	pɔtɔt͡ʃɛn
ораница	ɔranit͡sa
полусвест	pɔɫusvɛst
оган	ɔɡan
коса	kɔsa
сестриче	sɛstrit͡ʃɛ
книгиве	kniɡivɛ
согласка	sɔɡɫaska
отпатува	ɔtpatuva
плод	pɫɔt
клитика	klitika
ѕврцне	d͡zvr̩t͡snɛ
трева	trɛva
моногамија	mɔnɔɡamija
недугавост	nɛduɡavɔst
шеширче	ʃɛʃirt͡ʃɛ
надвозник	nadvɔznik
идентификација	idɛntifikat͡sija
могила	mɔɡiɫa
загубува	zaɡubuva
ненадминат	nɛnadminat
предизвикува	prɛdizvikuva
безѕвезден	bɛzd͡zvɛzdɛn
престол	prɛstɔɫ
целувка	t͡sɛɫufka
бабулест	babulɛst
презрее	prɛzrɛɛ
кучуле	kut͡ʃulɛ
поборништво	pɔbɔrniʃtvɔ
испосништво	ispɔsniʃtvɔ
мајмун	majmun
федерација	fɛdɛrat͡sija
иглест	iɡlɛst
послужува	pɔsɫuʒuva
извидувач	izviduvat͡ʃ
зашо	zaʃɔ
непропустливост	nɛprɔpustlivɔst
словенски	sɫɔvɛnski
седумка	sɛdumka
мранѕул	mrand͡zuɫ
стврднатост	stvr̩dnatɔst
морнарство	mɔrnarstvɔ
пушти	puʃti
гавранов	ɡavranɔf
бандарски	bandarski
полуспроводник	pɔɫusprɔvɔdnik
интерпункциски	intɛrpuŋkt͡siski
кутнува	kutnuva
пелена	pɛlɛna
присебност	prisɛbnɔst
човекот	t͡ʃɔvɛkɔt
зрно	zr̩nɔ
деветстотини	dɛvɛtstɔtini
разбојничка	razbɔjnit͡ʃka
гравитациски	ɡravitat͡siski
калиум	kalijum
граната	ɡranata
шарпланинци	ʃarpɫanint͡si
дрка	dr̩ka
аирлија	airlija
немилост	nɛmiɫɔst
винов	vinɔf
истресува	istrɛsuva
домеша	dɔmɛʃa
сигурност	siɡurnɔst
гихт	ɡixt
вампир	vampir
бивш	bifʃ
дипломски	dipɫɔmski
монахува	mɔnaxuva
ѓаур	ɟaur
космологија	kɔsmɔɫɔɡija
оцрт	ɔt͡sr̩t
рига	riɡa
крпа	kr̩pa
конфискација	kɔɱfiskat͡sija
абдал	abdaɫ
настран	nastran
бродови	brɔdɔvi
амстердамски	amstɛrdamski
координаторка	kɔɔrdinatɔrka
накодошува	nakɔdɔʃuva
ти	ti
боичка	bɔit͡ʃka
човеков	t͡ʃɔvɛkɔf
грешка	ɡrɛʃka
брливост	br̩livɔst
компарација	kɔmparat͡sija
калкан	kaɫkan
престапен	prɛstapɛn
бодови	bɔdɔvi
метафизика	mɛtafizika
план	pɫan
забрадува	zabraduva
доредува	dɔrɛduva
играч	iɡrat͡ʃ
презакопа	prɛzakɔpa
цицач	t͡sit͡sat͡ʃ
отров	ɔtrɔf
подивеност	pɔdivɛnɔst
крчмарски	kr̩t͡ʃmarski
мангуп	maŋɡup
нимфоманија	niɱfɔmanija
бистрина	bistrina
неумешност	nɛumɛʃnɔst
кенгурче	kɛŋɡurt͡ʃɛ
ноември	nɔɛɱvri
властољубивост	vɫastɔlubivɔst
градителка	ɡraditɛɫka
веселост	vɛsɛɫɔst
зажлебува	zaʒlɛbuva
стерилизациски	stɛɾilizat͡siski
изнавреѓа	iznavrɛɟa
аниматорка	animatɔrka
рамност	ramnɔst
секторски	sɛktɔrski
забновенечен	zabnɔvɛnɛt͡ʃɛn
непогодност	nɛpɔɡɔdnɔst
подмолност	pɔdmɔɫnɔst
недолепен	nɛdɔlɛpɛn
брут	brut
заложнички	zaɫɔʒnit͡ʃki
бугарка	buɡarka
шарпланинчиња	ʃarpɫanint͡ʃiɲa
пробојност	prɔbɔjnɔst
извикува	izvikuva
надзорничка	nadzɔrnit͡ʃka
поткупувач	pɔtkupuvat͡ʃ
умува	umuva
камион	kamijɔn
дарежливост	darɛʒlivɔst
подмладок	pɔdmɫadɔk
раскол	raskɔɫ
сопче	sɔpt͡ʃɛ
квебек	kvɛbɛk
черга	t͡ʃɛrɡa
локатив	ɫɔkatif
воскоса	vɔskɔsa
растрепереност	rastrɛpɛɾɛnɔst
објавувач	ɔbjavuvat͡ʃ
муле	mulɛ
грозје	ɡrɔzjɛ
поткара	pɔtkaɾa
неопределеност	nɛɔprɛdɛlɛnɔst
’рка	r̩ka
притвореничка	pritvɔrɛnit͡ʃka
скелетен	skɛlɛtɛn
распостеле	raspɔstɛlɛ
заќутува	zacutuva
зрнест	zr̩nɛst
јавач	javat͡ʃ
патче	patt͡ʃɛ
сад	sat
соучесница	sɔut͡ʃɛsnit͡sa
иридиум	iridijum
повеќејазичност	pɔvɛcɛjazit͡ʃnɔst
туморски	tumɔrski
пеленче	pɛlɛnt͡ʃɛ
регулациски	rɛɡuɫat͡siski
брашнест	braʃnɛst
испомажи	ispɔmaʒi
експлозија	ɛkspɫɔzija
аритметика	aɾitmɛtika
згрбавеност	zɡr̩bavɛnɔst
поцрта	pɔt͡sr̩ta
септември	sɛptɛɱvri
стагнација	staɡnat͡sija
пакет	pakɛt
везден	vɛzdɛn
полази	pɔɫazi
ишмукува	iʃmukuva
изналепи	iznalɛpi
практика	praktika
кора	kɔɾa
беџови	bɛd͡ʒɔvi
земе	zɛmɛ
доистребува	dɔistrɛbuva
заспива	zaspiva
сабота	sabɔta
аеродинамика	aɛɾɔdinamika
жиг	ʒik
станбен	stambɛn
пишувајте	piʃuvajtɛ
чури	t͡ʃuɾi
жубор	ʒubɔr
шатка	ʃatka
мачеништво	mat͡ʃɛniʃtvɔ
вибрација	vibrat͡sija
подиспраша	pɔdispraʃa
пушка	puʃka
шефовство	ʃɛfɔfstvɔ
изгушка	izɡuʃka
будалест	budalɛst
проповедник	prɔpɔvɛdnik
ѕиври	d͡zivri
златце	zɫatt͡sɛ
депилациски	dɛpiɫat͡siski
радар	radar
испразнува	ispraznuva
бебенце	bɛbɛnt͡sɛ
ноќница	nɔcnit͡sa
недомесен	nɛdɔmɛsɛn
ганѕало	ɡand͡zaɫɔ
рутински	rutinski
дата	data
лифт	lift
дозрева	dɔzrɛva
прекитува	prɛkituva
јагне	jaɡnɛ
дрдорење	dr̩dɔɾɛɲɛ
драстичност	drastit͡ʃnɔst
лаворов	ɫavɔɾɔf
сламен	sɫamɛn
пламен	pɫamɛn
изнапика	iznapika
просторност	prɔstɔrnɔst
вреднувач	vrɛdnuvat͡ʃ
проверлив	prɔvɛrlif
кочина	kɔt͡ʃina
еротика	ɛrɔtika
тројче	trɔjt͡ʃɛ
мртвило	mr̩tviɫɔ
дотка	dɔtka
дефлација	dɛfɫat͡sija
мечувалци	mɛt͡ʃuvaɫt͡si
смотаност	smɔtanɔst
кутија	kutija
ветриште	vɛtriʃtɛ
чаеви	t͡ʃaɛvi
малост	maɫɔst
суштественост	suʃtɛstvɛnɔst
’рж	r̩ʃ
бреза	brɛza
обезнадежува	ɔbɛznadɛʒuva
презаспие	prɛzaspijɛ
редакторство	rɛdaktɔrstvɔ
грмушка	ɡr̩muʃka
настојчивост	nastɔjt͡ʃivɔst
истумба	istumba
пратеништво	pratɛniʃtvɔ
бранови	branɔvi
раскали	raskali
преса	prɛsa
у	u
власец	vɫasɛt͡s
бугарин	buɡaɾin
лабилност	ɫabiɫnɔst
интонација	intɔnat͡sija
вадуц	vadut͡s
новинар	nɔvinar
превоспита	prɛvɔspita
двојник	dvɔjnik
говедо	ɡɔvɛdɔ
улица	ulit͡sa
расудност	rasudnɔst
вино	vinɔ
лема	lɛma
германец	ɡɛrmanɛt͡s
ѓезве	ɟɛzvɛ
бран	bran
ѕунлив	d͡zunlif
четник	t͡ʃɛtnik
подградец	pɔdɡradɛt͡s
грбоносен	ɡr̩bɔnɔsɛn
несакан	nɛsakan
чевличка	t͡ʃɛvlit͡ʃka
недостојност	nɛdɔstɔjnɔst
лаѓа	ɫaɟa
неизјаснет	nɛizjasnɛt
фрижидер	friʒidɛr
ножици	nɔʒit͡si
анестетичарка	anɛstɛtit͡ʃarka
торта	tɔrta
исповади	ispɔvadi
гужва	ɡuʒva
везирство	vɛzirstvɔ
изнадава	iznadava
азербајџан	azɛrbajd͡ʒan
русин	rusin
подгорица	pɔdɡɔɾit͡sa
недобричен	nɛdɔbrit͡ʃɛn
свршенички	svr̩ʃɛnit͡ʃki
пиварство	pivarstvɔ
безрбетник	bɛzr̩bɛtnik
летало	lɛtaɫɔ
штава	ʃtava
чедоубиство	t͡ʃɛdɔubistvɔ
гласачки	ɡɫasat͡ʃki
перничка	pɛrnit͡ʃka
курвиче	kurvit͡ʃɛ
местенце	mɛstɛnt͡sɛ
сиот	sijɔt
поткастри	pɔtkastri
недопиен	nɛdɔpijɛn
проектен	prɔɛktɛn
динамичност	dinamit͡ʃnɔst
лицемерство	lit͡sɛmɛrstvɔ
недосушен	nɛdɔsuʃɛn
извршителка	izvr̩ʃitɛɫka
богови	bɔɡɔvi
кал	kaɫ
нашара	naʃaɾa
готвачка	ɡɔtvat͡ʃka
нерешливост	nɛrɛʃlivɔst
шарпланинки	ʃarpɫaniŋki
гостопримливост	ɡɔstɔprimlivɔst
доразгледува	dɔɾazɡlɛduva
незаинтересираност	nɛzaintɛɾɛsiɾanɔst
пномпенски	pnɔmpɛnski
раб	rap
симпатичен	simpatit͡ʃɛn
циглен	t͡siɡlɛn
безбожност	bɛzbɔʒnɔst
фунафутиски	funafutiski
делка	dɛɫka
длабок	dɫabɔk
куќа	kuca
пура	puɾa
проточен	prɔtɔt͡ʃɛn
мајсторија	majstɔɾija
мека	mɛka
клистир	klistir
подгорички	pɔdɡɔɾit͡ʃki
фенер	fɛnɛr
мостови	mɔstɔvi
валиден	validɛn
нејзе	nɛjzɛ
подзакрпи	pɔdzakr̩pi
ирак	irak
недотресен	nɛdɔtrɛsɛn
ѕвечлив	d͡zvɛt͡ʃlif
брифинг	brifiŋk
бубачка	bubat͡ʃka
членува	t͡ʃlɛnuva
дошива	dɔʃiva
испише	ispiʃɛ
транзитен	tranzitɛn
исповедник	ispɔvɛdnik
поградец	pɔɡradɛt͡s
фобија	fɔbija
извезувач	izvɛzuvat͡ʃ
галебов	ɡalɛbɔf
успаниченост	uspanit͡ʃɛnɔst
ригански	riɡanski
другарче	druɡart͡ʃɛ
подзагрижи	pɔdzaɡriʒi
изнаполни	iznapɔɫni
потпис	pɔtpis
сура	suɾa
ѓубре	ɟubrɛ
белградски	bɛɫɡratski
печалбарски	pɛt͡ʃaɫbarski
неразбраност	nɛrazbranɔst
мир	mir
вашингтонски	vaʃiŋktɔnski
зимоска	zimɔska
деклинациски	dɛklinat͡siski
ателје	atɛljɛ
еугеника	ɛuɡɛnika
надуеност	naduɛnɔst
флорети	fɫɔrɛti
куќуле	kuculɛ
преболува	prɛbɔɫuva
труден	trudɛn
ѕуница	d͡zunit͡sa
спринтерка	sprintɛrka
коморач	kɔmɔɾat͡ʃ
шапкарски	ʃapkarski
српски	sr̩pski
стокхолмски	stɔkxɔɫm̩ski
врата	vrata
божем	bɔʒɛm
скитничка	skitnit͡ʃka
дорамнува	dɔramnuva
греотичка	ɡrɛɔtit͡ʃka
њутн	ɲutn̩
кодош	kɔdɔʃ
животинка	ʒivɔtiŋka
љубителка	lubitɛɫka
ајвари	ajvaɾi
непрозрачност	nɛprɔzrat͡ʃnɔst
пињола	piɲɔɫa
децава	dɛt͡sava
човек	t͡ʃɔvɛk
злосторница	zɫɔstɔrnit͡sa
заситеност	zasitɛnɔst
кусок	kusɔk
прошепотува	prɔʃɛpɔtuva
совладливост	sɔvɫadlivɔst
песма	pɛsma
пичка	pit͡ʃka
недруштвеност	nɛdruʃtvɛnɔst
њуделхиски	ɲudɛɫxiski
произлегува	prɔizlɛɡuva
вошливост	vɔʃlivɔst
осмиум	ɔsmijum
копан	kɔpan
пробушува	prɔbuʃuva
хералди	xɛɾaɫdi
пол	pɔɫ
нива	niva
скробен	skrɔbɛn
прекршочен	prɛkr̩ʃɔt͡ʃɛn
задолжителност	zadɔɫʒitɛɫnɔst
член	t͡ʃlɛn
реч	rɛt͡ʃ
корне	kɔrnɛ
мажине	maʒinɛ
прифатеност	prifatɛnɔst
бербер	bɛrbɛr
занемареност	zanɛmaɾɛnɔst
преведе	prɛvɛdɛ
охрид	ɔxrit
спасувачки	spasuvat͡ʃki
множество	mnɔʒɛstvɔ
летала	lɛtaɫa
турнува	turnuva
преклоп	prɛkɫɔp
неоштетен	nɛɔʃtɛtɛn
погрицка	pɔɡrit͡ska
министерски	ministɛrski
зашилува	zaʃiɫuva
инсталација	instaɫat͡sija
веда	vɛda
квалификација	kvalifikat͡sija
вретенце	vrɛtɛnt͡sɛ
’рѓав	r̩ɟaf
откупува	ɔtkupuva
период	pɛɾijɔt
анкета	ankɛta
жетварка	ʒɛtvarka
нокти	nɔkti
споцрка	spɔt͡sr̩ka
затекнува	zatɛknuva
бегов	bɛɡɔf
зазвучи	zazvut͡ʃi
допраша	dɔpraʃa
орелски	ɔɾɛɫski
пенкало	pɛŋkaɫɔ
сеструле	sɛstrulɛ
естетичарка	ɛstɛtit͡ʃarka
веднаш	vɛdnaʃ
слава	sɫava
ташна	taʃna
јазичиште	jazit͡ʃiʃtɛ
лев	lɛf
одгледувач	ɔdɡlɛduvat͡ʃ
одговори	ɔdɡɔvɔɾi
поти	pɔti
тоа	tɔa
оганче	ɔɡant͡ʃɛ
закуска	zakuska
пристапност	pristapnɔst
ивичи	ivit͡ʃi
дали	dali
више	viʃɛ
ѕенѕа	d͡zɛnd͡za
зграпчува	zɡrapt͡ʃuva
штитенички	ʃtitɛnit͡ʃki
дестилациски	dɛstiɫat͡siski
непосакуван	nɛpɔsakuvan
замешува	zamɛʃuva
бесцелност	bɛst͡sɛɫnɔst
книжарница	kniʒarnit͡sa
дрзне	dr̩znɛ
снајпер	snajpɛr
играчка	iɡrat͡ʃka
преврти	prɛvr̩ti
џем	d͡ʒɛm
единственост	ɛdinstvɛnɔst
излечивост	izlɛt͡ʃivɔst
непотребност	nɛpɔtrɛbnɔst
слонче	sɫɔnt͡ʃɛ
копје	kɔpjɛ
смлачи	smɫat͡ʃi
прибор	pribɔr
бамбусов	bambusɔf
писателство	pisatɛɫstvɔ
сликовен	slikɔvɛn
веќе	vɛcɛ
обезвучи	ɔbɛzvut͡ʃi
излетува	izlɛtuva
беспризорност	bɛsprizɔrnɔst
поделува	pɔdɛɫuva
цеѓ	tsɛc
ѕидар	d͡zidar
закопа	zakɔpa
патеник	patɛnik
кондензација	kɔndɛnzat͡sija
преплетува	prɛplɛtuva
поштарка	pɔʃtarka
неизметен	nɛizmɛtɛn
поротник	pɔɾɔtnik
ајкула	ajkuɫa
евра	ɛvra
свеќарка	svɛcarka
формациски	fɔrmat͡siski
верничка	vɛrnit͡ʃka
искра	iskra
заквичува	zakvit͡ʃuva
палец	palɛt͡s
добро	dɔbrɔ
почитувач	pɔt͡ʃituvat͡ʃ
натрапува	natrapuva
журнал	ʒurnaɫ
ѕвезден	d͡zvɛzdɛn
поврне	pɔvr̩nɛ
петок	pɛtɔk
недограден	nɛdɔɡradɛn
зоврива	zɔvriva
ситничарство	sitnit͡ʃarstvɔ
џигер	d͡ʒiɡɛr
помавта	pɔmafta
нокт	nɔkt
волчиште	vɔɫt͡ʃiʃtɛ
долгометражен	dɔɫɡɔmɛtraʒɛn
девојчинство	dɛvɔjt͡ʃinstvɔ
индикација	indikat͡sija
носорог	nɔsɔɾɔk
јуни	juni
износеност	iznɔsɛnɔst
клекнува	klɛknuva
дрвоса	dr̩vɔsa
досекува	dɔsɛkuva
кораб	kɔɾap
благајник	bɫaɡajnik
срна	sr̩na
рокерка	rɔkɛrka
кумче	kumt͡ʃɛ
претходничка	prɛtxɔdnit͡ʃka
трачар	trat͡ʃar
замоци	zamɔt͡si
хајка	xajka
меланхолија	mɛɫanxɔlija
угар	uɡar
неактивност	nɛaktivnɔst
хармонизација	xarmɔnizat͡sija
мелничарка	mɛɫnit͡ʃarka
пријател	prijatɛɫ
крајморски	krajmɔrski
еуфонија	ɛufɔnija
бундичка	bundit͡ʃka
деликатност	dɛlikatnɔst
опнува	ɔpnuva
коричка	kɔɾit͡ʃka
своина	svɔina
пички	pit͡ʃki
сеприсутен	sɛprisutɛn
разбира	razbiɾa
вентилација	vɛntiɫat͡sija
синче	sint͡ʃɛ
непреводливост	nɛprɛvɔdlivɔst
дихтува	dixtuva
неарно	nɛarnɔ
господ	ɡɔspɔt
испитувач	ispituvat͡ʃ
стратификација	stratifikat͡sija
витлер	vitlɛr
назализација	nazalizat͡sija
негостољубивост	nɛɡɔstɔlubivɔst
кишињевски	kiʃiɲɛfski
неразумност	nɛrazumnɔst
ѓумови	ɟumɔvi
чкрта	t͡ʃkr̩ta
испосече	ispɔsɛt͡ʃɛ
подлост	pɔdɫɔst
росичка	rɔsit͡ʃka
тужба	tuʒba
филантропија	fiɫantrɔpija
изнаплете	iznaplɛtɛ
самокритичност	samɔkritit͡ʃnɔst
хаотичност	xaɔtit͡ʃnɔst
викенд	vikɛnt
управничка	upravnit͡ʃka
ксенофоб	ksɛnɔfɔp
етимологија	ɛtimɔɫɔɡija
налепи	nalɛpi
палатализација	paɫatalizat͡sija
сараево	saraɛvɔ
погалами	pɔɡaɫami
кое	kɔɛ
демонстраторка	dɛmɔnstratɔrka
дозволивост	dɔzvɔlivɔst
недругарски	nɛdruɡarski
натрапник	natrapnik
кишињев	kiʃiɲɛf
јубилеј	jubilɛj
новинарство	nɔvinarstvɔ
реа	rɛa
пие	pijɛ
ротациски	rɔtat͡siski
шмата	ʃmata
ќерка	cɛrka
разбирливост	razbirlivɔst
подрипнува	pɔdripnuva
голф	ɡɔɫf
опустошува	ɔpustɔʃuva
дообработува	dɔɔbrabɔtuva
психијатрија	psixijatrija
рипче	ript͡ʃɛ
подробност	pɔdrɔbnɔst
полубог	pɔɫubɔk
невеста	nɛvɛsta
избор	izbɔr
обвинителка	ɔbvinitɛɫka
вран	vran
исповрти	ispɔvr̩ti
синхронизација	sinxrɔnizat͡sija
осветленост	ɔsvɛtlɛnɔst
запрепастеност	zaprɛpastɛnɔst
наврти	navr̩ti
подреме	pɔdrɛmɛ
тунис	tunis
ригидност	riɡidnɔst
мажи	maʒi
знаменосец	znamɛnɔsɛt͡s
арзухал	arzuxaɫ
банка	baŋka
предочи	prɛdɔt͡ʃi
соучество	sɔut͡ʃɛstvɔ
зелје	zɛljɛ
зашива	zaʃiva
звучност	zvut͡ʃnɔst
спикер	spikɛr
уставност	ustavnɔst
севкупност	sɛfkupnɔst
шарпланинка	ʃarpɫaniŋka
нѐ	nɛ
разведрува	razvɛdruva
заплакува	zapɫakuva
каша	kaʃa
изопаченик	izɔpat͡ʃɛnik
бршленов	br̩ʃlɛnɔf
ѕемне	d͡zɛmnɛ
зајадливост	zajadlivɔst
шаман	ʃaman
винце	vint͡sɛ
противнички	prɔtivnit͡ʃki
задишаност	zadiʃanɔst
ајдучки	ajdut͡ʃki
недоѕидан	nɛdɔd͡zidan
мамут	mamut
ергенство	ɛrɡɛnstvɔ
пиварски	pivarski
насловува	nasɫɔvuva
здоболува	zdɔbɔɫuva
кукла	kukɫa
кралски	kraɫski
фабрика	fabrika
днине	dninɛ
кадра	kadra
нечујност	nɛt͡ʃujnɔst
север	sɛvɛr
извидничка	izvidnit͡ʃka
закочува	zakɔt͡ʃuva
посетителка	pɔsɛtitɛɫka
леќа	lɛca
запекува	zapɛkuva
расчовечи	raʃt͡ʃɔvɛt͡ʃi
маде	madɛ
сланина	sɫanina
пршки	pr̩ʃki
информатичарски	iɱfɔrmatit͡ʃarski
приправник	pripravnik
па	pʰa
овчаров	ɔft͡ʃaɾɔf
лековитост	lɛkɔvitɔst
реалистичност	rɛalistit͡ʃnɔst
заслепеност	zaslɛpɛnɔst
јоргански	jɔrɡanski
целисходност	t͡sɛlisxɔdnɔst
жуборење	ʒubɔɾɛɲɛ
егзистенција	ɛɡzistɛnt͡sija
калфа	kaɫfa
безумност	bɛzumnɔst
аболиција	abɔlit͡sija
петокрак	pɛtɔkrak
прописен	prɔpisɛn
прикладност	prikɫadnɔst
оспособеност	ɔspɔsɔbɛnɔst
испупчува	ispupt͡ʃuva
радио	radijɔ
заздравува	zazdravuva
завчера	zaft͡ʃɛɾa
светост	svɛtɔst
наточува	natɔt͡ʃuva
триста	trista
суштество	suʃtɛstvɔ
претплата	prɛtpɫata
конечно	kɔnɛt͡ʃnɔ
нему	nɛmu
мајкоубиство	majkɔubistvɔ
полае	pɔɫaɛ
голтнува	ɡɔɫtnuva
цензор	t͡sɛnzɔr
тантал	tantaɫ
раздвоеност	razdvɔɛnɔst
заточеништво	zatɔt͡ʃɛniʃtvɔ
тепач	tɛpat͡ʃ
к’смет	kəsmɛt
таа	taa
лексикологија	lɛksikɔɫɔɡija
дошара	dɔʃaɾa
штурче	ʃturt͡ʃɛ
метропола	mɛtrɔpɔɫa
страда	strada
брише	briʃɛ
изнацрпи	iznat͡sr̩pi
грбоносци	ɡr̩bɔnɔst͡si
валидност	validnɔst
залудност	zaɫudnɔst
сапунарство	sapunarstvɔ
плевен	plɛvɛn
надарува	nadaɾuva
ќофтенце	cɔftɛnt͡sɛ
подопијани	pɔdɔpijani
фстаци	fstat͡si
ономастика	ɔnɔmastika
недолупен	nɛdɔɫupɛn
скршнува	skr̩ʃnuva
станче	stant͡ʃɛ
балонче	baɫɔnt͡ʃɛ
кука	kuka
република	rɛpublika
лапачка	ɫapat͡ʃka
касичка	kasit͡ʃka
штедар	ʃtɛdar
чекмеџе	t͡ʃɛkmɛd͡ʒɛ
носивост	nɔsivɔst
нехуманост	nɛxumanɔst
испокрпи	ispɔkr̩pi
скапост	skapɔst
безизразен	bɛzizrazɛn
угнетеност	uɡnɛtɛnɔst
јагнешки	jaɡnɛʃki
растапка	rastapka
угари	uɡaɾi
пекинг	pɛkiŋk
преплете	prɛplɛtɛ
заемност	zaɛmnɔst
црви	t͡sr̩vi
манџичка	mand͡ʒit͡ʃka
династички	dinastit͡ʃki
господарство	ɡɔspɔdarstvɔ
повереник	pɔvɛɾɛnik
преговара	prɛɡɔvaɾa
учкури	ut͡ʃkuɾi
зачуденост	zat͡ʃudɛnɔst
сликичка	slikit͡ʃka
асимилациски	asimiɫat͡siski
нека	nɛka
зацврчува	zat͡svr̩t͡ʃuva
изработувач	izrabɔtuvat͡ʃ
чутура	t͡ʃutuɾa
извештаченост	izvɛʃtat͡ʃɛnɔst
беспогрешност	bɛspɔɡrɛʃnɔst
бадник	badnik
предупреди	prɛduprɛdi
пренагласи	prɛnaɡɫasi
заговор	zaɡɔvɔr
локна	ɫɔkna
бискупија	biskupija
сожителство	sɔʒitɛɫstvɔ
благородност	bɫaɡɔɾɔdnɔst
изразитост	izrazitɔst
нагрнува	naɡr̩nuva
страчкин	strat͡ʃkin
зеница	zɛnit͡sa
грнче	ɡr̩n̩t͡ʃɛ
покрека	pɔkrɛka
депо	dɛpɔ
соплеменица	sɔplɛmɛnit͡sa
затрпа	zatr̩pa
расположливост	raspɔɫɔʒlivɔst
премива	prɛmiva
аболира	abɔliɾa
зачестеност	zat͡ʃɛstɛnɔst
престапничка	prɛstapnit͡ʃka
исцрпеност	ist͡sr̩pɛnɔst
лакомство	ɫakɔmstvɔ
злоупотреба	zɫɔupɔtrɛba
преживува	prɛʒivuva
заматкува	zamatkuva
кумин	kumin
изнашара	iznaʃaɾa
засукува	zasukuva
македонски	makɛdɔnski
испокупи	ispɔkupi
повози	pɔvɔzi
херцеговина	xɛrt͡sɛɡɔvina
ледина	lɛdina
трогателност	trɔɡatɛɫnɔst
свињарница	sviɲarnit͡sa
ѕрцки	d͡zr̩t͡ski
дена	dɛna
накострешува	nakɔstrɛʃuva
молкома	mɔɫkɔma
сито	sitɔ
зачадува	zat͡ʃaduva
стравотен	stravɔtɛn
птичка	ptit͡ʃka
овде	ɔvdɛ
неизмиен	nɛizmijɛn
насече	nasɛt͡ʃɛ
неморалност	nɛmɔɾaɫnɔst
купопродажба	kupɔprɔdaʒba
врзоп	vr̩zɔp
џвакање	d͡ʒvakaɲɛ
своевидност	svɔɛvidnɔst
цигара	t͡siɡaɾa
окленд	ɔklɛnt
комплицираност	kɔmplit͡siɾanɔst
рударка	rudarka
дерман	dɛrman
додуша	dɔduʃa
закупничка	zakupnit͡ʃka
мачуле	mat͡ʃulɛ
ќуп	cup
престрои	prɛstrɔi
селотејп	sɛɫɔtɛjp
рагби	raɡbi
заболекарка	zabɔlɛkarka
ваш	vaʃ
ногопис	nɔɡɔpis
наврапитост	navrapitɔst
хонијара	xɔnijaɾa
алкален	aɫkalɛn
испоруга	ispɔɾuɡa
непријавен	nɛprijavɛn
сокачки	sɔkat͡ʃki
барокен	baɾɔkɛn
засекогаш	zasɛkɔɡaʃ
кукларство	kukɫarstvɔ
бездомништво	bɛzdɔmniʃtvɔ
надежност	nadɛʒnɔst
апликација	aplikat͡sija
поруменува	pɔɾumɛnuva
дома	dɔma
прежали	prɛʒali
неповрзан	nɛpɔvr̩zan
подрдори	pɔdr̩dɔɾi
реформаторка	rɛfɔrmatɔrka
младолик	mɫadɔlik
разлабавеност	razɫabavɛnɔst
сокаче	sɔkat͡ʃɛ
лански	ɫanski
недобоен	nɛdɔbɔɛn
кибритче	kibritt͡ʃɛ
агломер	aɡɫɔmɛr
достега	dɔstɛɡa
пресложи	prɛsɫɔʒi
мртов	mr̩tɔf
црево	t͡srɛvɔ
папсува	papsuva
нападност	napadnɔst
скиснатост	skisnatɔst
беспрекорност	bɛsprɛkɔrnɔst
пренатрупа	prɛnatrupa
цифра	t͡sifra
маѓарско	maɟarskɔ
изведувачка	izvɛduvat͡ʃka
бездомнички	bɛzdɔmnit͡ʃki
вработувач	vrabɔtuvat͡ʃ
надежен	nadɛʒɛn
советничка	sɔvɛtnit͡ʃka
ѕвездичка	d͡zvɛzdit͡ʃka
обезбојува	ɔbɛzbɔjuva
жената	ʒɛnata
снајперка	snajpɛrka
деновиве	dɛnɔvivɛ
наменски	namɛnski
подразвесели	pɔdrazvɛsɛli
исклучиво	iskɫut͡ʃivɔ
сугестија	suɡɛstija
бакујски	bakujski
сатира	satiɾa
кондиција	kɔndit͡sija
комичарски	kɔmit͡ʃarski
предимство	prɛdimstvɔ
испоотвори	ispɔɔtvɔɾi
дојка	dɔjka
освен	ɔsvɛn
милозвучност	miɫɔzvut͡ʃnɔst
обединетост	ɔbɛdinɛtɔst
зиме	zimɛ
запева	zapɛva
наквасува	nakvasuva
змиин	zmiin
стражарка	straʒarka
делегациска	dɛlɛɡat͡siska
море	mɔɾɛ
царство	t͡sarstvɔ
столарство	stɔɫarstvɔ
крадешкум	kradɛʃkum
записник	zapisnik
математичарски	matɛmatit͡ʃarski
класика	kɫasika
книгата	kniɡata
групичка	ɡrupit͡ʃka
скржавост	skr̩ʒavɔst
славољубивост	sɫavɔlubivɔst
прасуле	prasulɛ
мравји	mravji
лента	lɛnta
ѓаволштина	ɟavɔɫʃtina
подзадоцни	pɔdzadɔt͡sni
испокаса	ispɔkasa
осигурител	ɔsiɡuɾitɛɫ
внук	vnuk
погодува	pɔɡɔduva
би	bi
увод	uvɔt
гостољубивост	ɡɔstɔlubivɔst
засводува	zasvɔduva
меѓуетнички	mɛɟuɛtnit͡ʃki
достиска	dɔstiska
намирисува	namirisuva
вилица	vilit͡sa
подзарасне	pɔdzaɾasnɛ
воспита	vɔspita
очигледност	ɔt͡ʃiɡlɛdnɔst
полузатворен	pɔɫuzatvɔɾɛn
разбушавува	razbuʃavuva
налета	nalɛta
елкичка	ɛɫkit͡ʃka
буржоазија	burʒɔazija
плејбек	plɛjbɛk
обожавателка	ɔbɔʒavatɛɫka
