porowini	pˌɔrɔwˈini
tohea	tɔhˈea
Tīreni	tiːrˈeni
wehe	wˈehe
mārena	maːrˈena
Hāmoa	haːmˈɔa
rokohanga	rˌɔkɔhˈaŋa
pononga	pɔnˈɔŋa
koikoi	kˈo͡ɪko͡ɪ
moemoehia	mwˌemwehˈia
kakara	kakˈara
Martin	mˈartin
arorangi	ˌarɔrˈaŋi
Titiro	titˈirɔ
auaha	ˌau"ˈaha
Anō	ˈanɔː
pōtitanga	pˌɔːtitˈaŋa
Patāriana	pˌataːriˈana
werohanga	wˌerɔhˈaŋa
Horowhenua	hˌɔrɔfenˈu"a
whiriwhirihia	fˌirifˌirihˈia
whakatokia	fˌakatɔkˈia
Riki	rˈiki
Maungapohatu	mˌau"ŋˌapɔhˈatu"
tāruaruatia	tˌaːru"ˌaru"atˈia
Kimi	kˈimi
tuawha	tu"ˈafa
ngaku	ŋˈaku"
whanatu	fanˈatu"
II	ˈii
mumura	mu"mˈu"ra
whakahe	fakˈahe
Nōna	nˈɔːna
Tirohanga	tˌirɔhˈaŋa
Patapātai	pˌatapˈaːta͡ɪ
matauranga	mˌatau"rˈaŋa
ei	ˈei
Nā	nˈaː
ekenga	ekˈeŋa
riri	rˈiri
neherā	nehˈeraː
mātinitini	mˌaːtinitˈini
Ako	ˈakɔ
Tokotoru	tˌɔkɔtˈɔru"
poutama	pˌou"tˈama
minita	minˈita
pekapeka	pˌekapˈeka
ihi	ˈihi
nama	nˈama
moata	mɔˈata
Perohuka	pˌerɔhˈu"ka
kohuke	kɔhˈu"ke
Meri	mˈeri
tio	tˈiɔ
taurite	tˌau"rˈite
Ruataupare	rˌu"atˌau"pˈare
Poutūterangi	pˌou"tˌu"ːterˈaŋi
whakawehi	fˌakawˈehi
pipiri	pipˈiri
Pera	pˈera
nehe	nˈehe
puare	pu"ˈare
Wāhine	waːhˈine
Waikare	wa͡ɪkˈare
Waru	wˈaru"
Kīia	kiːˈia
hungawai	hu"ŋˈawa͡ɪ
āniwaniwa	ˌaːniwanˈiwa
koropupū	kˌɔrɔpˈu"pu"ː
Tawhito	tafˈitɔ
hīkoi	hˈiːko͡ɪ
Tekapo	tekˈapɔ
Ngoingoi	ŋˈo͡ɪŋo͡ɪ
whakaupoko	fˌakau"pˈɔkɔ
whakaohooho	fˌaka͡ʊhɔˈɔhɔ
tuaiwa	tu"ˈa͡ɪwa
arahi	arˈahi
hākinakina	hˌaːkinakˈina
Kōpae	kˈɔːpa͡ɪ
Hīkoi	hˈiːko͡ɪ
whakaurunga	fˌakau"rˈu"ŋa
pihikete	pˌihikˈete
peia	peˈia
Toa	tˈɔa
Kōwae	kˈɔːwa͡ɪ
Pewhairangi	pˌefa͡ɪrˈaŋi
tanumia	tˌanu"mˈia
Akuhata	ˌaku"hˈata
Māku	mˈaːku"
riu	rˈiu"
whariki	farˈiki
kōmiti	kɔːmˈiti
tūrangawaewae	tˌu"ːraŋawˈa͡ɪwa͡ɪ
Himiona	hˌimiˈɔna
Hato	hˈatɔ
kotia	kɔtˈia
korakora	kˌɔrakˈɔra
haukoti	hˌau"kˈɔti
whakawhitia	fˌakafitˈia
mirimiri	mˌirimˈiri
runga	rˈu"ŋa
maoa	mˈa͡ʊa
Kīhai	kˈiːha͡ɪ
pōro	pˈɔːrɔ
Murihiku	mˌu"rihˈiku"
tukua	tu"kˈu"a
nekehanga	nˌekehˈaŋa
kīrehe	kiːrˈehe
tautōhito	tˌau"tɔːhˈitɔ
tangohanga	tˌaŋɔhˈaŋa
Pakiwaitara	pˌakiwa͡ɪtˈara
ota	ˈɔta
Tūrei	tu"ːrˈei
pāmahana	pˌaːmahˈana
karaihe	karˈa͡ɪhe
kāti	kˈaːti
whakamaoritanga	fˌakamˌa͡ʊritˈaŋa
pītau	piːtˈau"
tangohia	tˌaŋɔhˈia
whakamāori	fˌakamaːˈɔri
paunga	paˈu"ŋa
Hoani	hɔˈani
maroke	marˈɔke
wharau	farˈau"
pāngia	paːŋˈia
pakoko	pakˈɔkɔ
not	nˈɔt
rerenga	rerˈeŋa
Rongomaurikura	rˌɔŋɔmˌau"rikˈu"ra
puea	pu"ˈea
Uniana	ˌu"niˈana
Toihau	to͡ɪhˈau"
whakawahia	fˌakawahˈia
Hokianga	hˌɔkiˈaŋa
tuanui	tˌu"anˈu"i
Mahi	mˈahi
whakamāramatanga	fˌakamˌaːramatˈaŋa
Poroumata	pˌɔrou"mˈata
tauwhitiwhitinga	tˌau"fˌitifitˈiŋa
whakataua	fˌakataˈu"a
rūri	rˈu"ːri
Tarahiti	tˌarahˈiti
au	ˈau"
Mark	mˈark
Wherowhero	fˌerɔfˈerɔ
tāmure	taːmˈu"re
iana	iˈana
huatau	hˌu"atˈau"
Koutou	kˌou"tˈou"
whakaakona	fˌakaakˈɔna
whakarawe	fˌakarˈawe
ākina	aːkˈina
waahana	wˌaahˈana
mātāwaka	mˌaːtaːwˈaka
Raumati	rˌau"mˈati
kapua	kapˈu"a
ūnga	ˈu"ːŋa
kēmu	kˈeːmu"
kori	kˈɔri
tëtahi	tetˈahi
Rikiriki	rˌikirˈiki
Rūnanga	ru"ːnˈaŋa
mārama	maːrˈama
konganuku	kˌɔŋanˈu"ku"
hāereere	hˌaːereˈere
nau	nˈau"
hangarua	hˌaŋarˈu"a
hēoi	hˈeːo͡ɪ
hongere	hɔŋˈere
Tūroa	tu"ːrˈɔa
rōpere	rɔːpˈere
tohutohu	tˌɔhu"tˈɔhu"
Moana	mɔˈana
horahanga	hˌɔrahˈaŋa
whakamoea	fˌakamwˈea
hari	hˈari
Penei	penˈei
rangatiratanga	rˌaŋatˌiratˈaŋa
Tipa	tˈipa
Hira	hˈira
Aha	ˈaha
pukana	pu"kˈana
wheketere	fˌeketˈere
tuarima	tˌu"arˈima
mira	mˈira
Huanga	hu"ˈaŋa
hiahia	hˌiahˈia
rimurimu	rˌimu"rˈimu"
tatari	tatˈari
pūtahi	pu"ːtˈahi
Tahuri	tahˈu"ri
kui	kˈu"i
tītaha	tiːtˈaha
Wehea	wehˈea
Ōtaki	ɔːtˈaki
nehera	nehˈera
Rakiura	rˌakiˈu"ra
whia	fˈia
manaaki	mˌanaˈaki
waimarie	wˌa͡ɪmarˈie
arai	ˈara͡ɪ
Tōna	tˈɔːna
Kotahitanga	kˌɔtahitˈaŋa
kiromita	kˌirɔmˈita
Reanga	reˈaŋa
korikori	kˌɔrikˈɔri
maramatanga	mˌaramatˈaŋa
akuanei	ˌaku"anˈei
rimurapa	rˌimu"rˈapa
or	ˈɔr
ata	ˈata
Karipori	kˌaripˈɔri
Whakatāne	fˌakatˈaːne
rōrahi	rɔːrˈahi
henemita	hˌenemˈita
pēne	pˈeːne
rārangi	raːrˈaŋi
Raka	rˈaka
Tairāwhiti	tˌa͡ɪraːfˈiti
wiriwiri	wˌiriwˈiri
whiriwhiri	fˌirifˈiri
ihupuku	ˌihu"pˈu"ku"
u	ˈu"
rätou	ratˈou"
Moehau	mwehˈau"
Kawana	kawˈana
mahea	mahˈea
Pīra	pˈiːra
iahiko	ˌiahˈikɔ
taurangi	tˌau"rˈaŋi
kingi	kˈiŋi
nāwai	nˈaːwa͡ɪ
Awa	ˈawa
Ahumahi	ˌahu"mˈahi
hoariri	hˌɔarˈiri
Hakihea	hˌakihˈea
pure	pˈu"re
putiputi	pˌu"tipˈu"ti
para	pˈara
rāhuitia	rˌaːhu"itˈia
Panuitia	pˌanu"itˈia
pepe	pˈepe
taringa	tarˈiŋa
Kirihi	kirˈihi
Heamana	hˌeamˈana
kōhauhau	kˌɔːhau"hˈau"
mahora	mahˈɔra
panoni	panˈɔni
auare	ˌau"ˈare
Ratapu	ratˈapu"
tēneti	teːnˈeti
Koira	kˈo͡ɪra
mita	mˈita
Hikareia	hˌikareˈia
tuku	tˈu"ku"
tiakareti	tˌiakarˈeti
hāpaitia	hˌaːpa͡ɪtˈia
Kōrero	kˈɔːrerˌɔ
whakatutukihia	fˌakatˌu"tu"kihˈia
weropepahia	wˌerɔpˌepahˈia
koukou	kˌou"kˈou"
hourua	hˌou"rˈu"a
Tātaki	taːtˈaki
whakatō	fakˈatɔː
oati	ɔˈati
wahia	wahˈia
waihoe	wˈa͡ɪhwe
pakupaku	pˌaku"pˈaku"
Rangihoua	rˌaŋihoˈu"a
tuaiwi	tu"ˈa͡ɪwi
tēhea	teːhˈea
Kawau	kawˈau"
tāke	tˈaːke
pēhia	peːhˈia
katinga	katˈiŋa
Roopū	rɔˈɔpu"ː
amuamu	ˌamu"ˈamu"
Taika	tˈa͡ɪka
iramutu	ˌiramˈu"tu"
onepū	ɔnˈepu"ː
tūwatawata	tˌu"ːwatawˈata
reo	rˈeɔ
whakapotonga	fˌakapɔtˈɔŋa
tamāhine	tˌamaːhˈine
uhi	ˈu"hi
whakamanatia	fˌakamˌanatˈia
māpere	maːpˈere
hautipua	hˌau"tipˈu"a
kaiarahi	kˌa͡ɪarˈahi
hirahira	hˌirahˈira
Tokaanu	tˌɔkaˈanu"
tü	tˈu"
Point	pˈo͡ɪnt
ropu	rˈɔpu"
tahumaero	tˌahu"mˈa͡ɪrɔ
marama	marˈama
tāhei	taːhˈei
pūāhua	pˌu"ːaːhˈu"a
tuturu	tu"tˈu"ru"
Koianei	kˌo͡ɪanˈei
Ture	tˈu"re
Porou	pɔrˈou"
manene	manˈene
pīrangitia	pˌiːraŋitˈia
maro	mˈarɔ
mätou	matˈou"
Irirangi	ˌirirˈaŋi
pirihi	pirˈihi
i	ˈi
tarukino	tˌaru"kˈinɔ
whakamōhio	fˌakamɔːhˈiɔ
tūranga	tu"ːrˈaŋa
tokowaru	tˌɔkɔwˈaru"
arongia	ˌarɔŋˈia
whaitua	fa͡ɪtˈu"a
petihana	pˌetihˈana
mākū	mˈaːku"ː
hōmai	hˈɔːma͡ɪ
ōkiko	ɔːkˈikɔ
Pau	pˈau"
Pitopito	pˌitɔpˈitɔ
ārahina	ˌaːrahˈina
Mane	mˈane
whakarōpū	fˌakarˈɔːpu"ː
mania	manˈia
ruihi	ru"ˈihi
Haumaru	hˌau"mˈaru"
Mua	mˈu"a
whakapaipai	fˌakapˈa͡ɪpa͡ɪ
taona	tˈa͡ʊna
whakarongo	fˌakarˈɔŋɔ
matataunga	mˌatataˈu"ŋa
huanui	hˌu"anˈu"i
hahae	hˈaha͡ɪ
poti	pˈɔti
pūata	pu"ːˈata
Tari	tˈari
Here	hˈere
whakarahi	fˌakarˈahi
kahurangi	kˌahu"rˈaŋi
Whakapiki	fˌakapˈiki
rārangitanga	rˌaːraŋitˈaŋa
mataku	matˈaku"
Taiwhenua	tˌa͡ɪfenˈu"a
tākai	tˈaːka͡ɪ
tūpāpaku	tˌu"ːpaːpˈaku"
ahua	ahˈu"a
teretere	tˌeretˈere
taupori	tˌau"pˈɔri
Uawa	u"ˈawa
whakatauākī	fˌakatˌau"ˈaːkiː
karahipi	kˌarahˈipi
Arataki	ˌaratˈaki
pakanga	pakˈaŋa
whakareri	fˌakarˈeri
Ngāpuhi	ŋaːpˈu"hi
āraia	aːrˈa͡ɪa
rongopai	rɔŋˈɔpa͡ɪ
pono	pˈɔnɔ
uri	ˈu"ri
taura	taˈu"ra
Kaiwhakarite	kˌa͡ɪfakarˈite
tapuwae	tapˈu"wa͡ɪ
rapa	rˈapa
reti	rˈeti
Whakawhitinga	fˌakafitˈiŋa
koroputa	kˌɔrɔpˈu"ta
ākonga	aːkˈɔŋa
ērā	ˈeːraː
Poroporoaki	pˌɔrɔpˌɔrɔˈaki
Paeko	pˈa͡ɪkɔ
Mita	mˈita
Whatahoro	fˌatahˈɔrɔ
ori	ˈɔri
whakaongaonga	fˌaka͡ʊŋˈa͡ʊŋa
Ingarani	ˌiŋarˈani
ngaa	ŋˈaa
maunga	maˈu"ŋa
hāhi	hˈaːhi
Whakamahia	fˌakamahˈia
whakapaua	fˌakapaˈu"a
tamata	tamˈata
aorangi	a͡ʊrˈaŋi
maori	mˈa͡ʊri
Au	ˈau"
whakapākehātia	fˌakapˌaːkehaːtˈia
whāngote	faːŋˈɔte
huripoki	hˌu"ripˈɔki
ārahitanga	ˌaːrahitˈaŋa
Tinana	tinˈana
whakarihariha	fˌakarˌiharˈiha
whakapai	fakˈapa͡ɪ
kaipāho	ka͡ɪpˈaːhɔ
rāngai	rˈaːŋa͡ɪ
hori	hˈɔri
muri	mˈu"ri
Whangaroa	fˌaŋarˈɔa
Awherika	ˌaferˈika
tiwai	tˈiwa͡ɪ
whakaū	fakˈau"ː
kuputuhi	kˌu"pu"tˈu"hi
tonuhia	tˌɔnu"hˈia
Raupapahia	rˌau"pˌapahˈia
murunga	mu"rˈu"ŋa
tautō	taˈu"tɔː
Puritia	pˌu"ritˈia
Tokowaru	tˌɔkɔwˈaru"
Rangitāne	rˌaŋitˈaːne
paitia	pa͡ɪtˈia
whakarewaina	fˌakarewˈa͡ɪna
pūeru	pu"ːˈeru"
kaiwhaiwhai	ka͡ɪfˈa͡ɪfa͡ɪ
rara	rˈara
whakatu	fakˈatu"
Tiamana	tˌiamˈana
hihiko	hihˈikɔ
puoru	pu"ˈɔru"
Tahua	tahˈu"a
whakatipuria	fˌakatˌipu"rˈia
mautohe	mˌau"tˈɔhe
koru	kˈɔru"
whakaara	fˌakaˈara
Katia	katˈia
peita	peˈita
rēhitatia	rˌeːhitatˈia
Ngā	ŋˈaː
hikitia	hˌikitˈia
mamao	mˈama͡ʊ
ohaoha	ɔhˈa͡ʊha
hautoru	hˌau"tˈɔru"
whakato	fakˈatɔ
whakarei	fˌakarˈei
paerua	pa͡ɪrˈu"a
tahā	tˈahaː
whakatenatenahia	fˌakatˌenatˌenahˈia
Mahinga	mahˈiŋa
Tua	tˈu"a
Tatū	tˈatu"ː
Tuarua	tˌu"arˈu"a
maatauranga	mˌaatˌau"rˈaŋa
papaka	papˈaka
āpiha	aːpˈiha
kiko	kˈikɔ
Tāngia	taːŋˈia
tainga	tˈa͡ɪŋa
Whakaingoatia	fˌaka͡ɪŋˌɔatˈia
whakarangatira	fˌakarˌaŋatˈira
inanahi	ˌinanˈahi
māwhitiwhiti	mˌaːfitifˈiti
kāpene	kaːpˈene
Pai	pˈa͡ɪ
Tāpiri	taːpˈiri
tuhipoka	tˌu"hipˈɔka
mahaki	mahˈaki
whakahau	fˌakahˈau"
whakapae	fakˈapa͡ɪ
Kirihimete	kˌirihimˈete
Tonu	tˈɔnu"
honoa	hɔnˈɔa
whano	fˈanɔ
ke	kˈe
tapu	tˈapu"
Atu	ˈatu"
patu	pˈatu"
Tarawera	tˌarawˈera
takatāpui	tˌakataːpˈu"i
Te	tˈe
koroke	kɔrˈɔke
mahana	mahˈana
poua	poˈu"a
Taki	tˈaki
hiahiatia	hˌiahˌiatˈia
whutupōro	fˌu"tu"pˈɔːrɔ
tutua	tu"tˈu"a
Hokinga	hɔkˈiŋa
Pani	pˈani
Toku	tˈɔku"
whakaranua	fˌakaranˈu"a
kakaho	kakˈahɔ
hīanga	hiːˈaŋa
mōhiohio	mˌɔːhiɔhˈiɔ
Tērā	tˈeːraː
Kōhanga	kɔːhˈaŋa
karakiatia	kˌarakˌiatˈia
arohia	ˌarɔhˈia
kaituhituhi	kˌa͡ɪtu"hitˈu"hi
kakau	kakˈau"
hua	hˈu"a
uhia	u"hˈia
tohe	tˈɔhe
Rauropi	rˌau"rˈɔpi
Kaumatua	kˌau"matˈu"a
Rakera	rakˈera
Whare	fˈare
Manu	mˈanu"
hiako	hiˈakɔ
Nepia	nepˈia
Hoko	hˈɔkɔ
mako	mˈakɔ
Tui	tˈu"i
Ano	ˈanɔ
Kohia	kɔhˈia
taatau	tˌaatˈau"
Mahaki	mahˈaki
haka	hˈaka
whakaputa	fˌakapˈu"ta
whakapiri	fˌakapˈiri
pahūtanga	pˌahu"ːtˈaŋa
kōtahi	kɔːtˈahi
huaketo	hˌu"akˈetɔ
hopu	hˈɔpu"
rauemi	rˌau"ˈemi
whakamataku	fˌakamatˈaku"
pokapu	pɔkˈapu"
tuhituhia	tˌu"hitu"hˈia
tōrunga	tɔːrˈu"ŋa
rawaka	rawˈaka
whakarerekētanga	fˌakarˌerekeːtˈaŋa
koroua	kˌɔroˈu"a
tope	tˈɔpe
ahuareka	ˌahu"arˈeka
p	p
Tatauranga	tˌatau"rˈaŋa
mōkihi	mɔːkˈihi
whakamaheretia	fˌakamˌaheretˈia
whakaurua	fˌakau"rˈu"a
riha	rˈiha
Tāmaki	taːmˈaki
maihea	ma͡ɪhˈea
ii	ˈii
Ararau	ˌararˈau"
Ha	hˈa
whakawhanakehia	fˌakafˌanakehˈia
haruru	harˈu"ru"
Whakawhitiwhiti	fˌakafˌitifˈiti
ramarama	rˌamarˈama
Hari	hˈari
whakakotahitia	fˌakakˌɔtahitˈia
hopua	hɔpˈu"a
whānako	faːnˈakɔ
Waimate	wa͡ɪmˈate
To	tˈɔ
Katerina	kˌaterˈina
whakamatau	fˌakamatˈau"
kaiparau	kˌa͡ɪparˈau"
haumi	haˈu"mi
kanohi	kanˈɔhi
whakamahere	fˌakamahˈere
aronui	ˌarɔnˈu"i
Mata	mˈata
Karanga	karˈaŋa
kaumoana	kˌau"mɔˈana
tūpuhi	tu"ːpˈu"hi
Hawaii	hawˈa͡ɪi
piringa	pirˈiŋa
kawea	kawˈea
hoki	hˈɔki
kaiwhakatakoto	kˌa͡ɪfakˌatakˈɔtɔ
whakatauira	fˌakatˌau"ˈira
haukū	haˈu"ku"ː
Whakatairitea	fˌakatˌa͡ɪritˈea
whakatangihia	fˌakatˌaŋihˈia
Hēkeretari	hˌeːkeretˈari
raruraru	ɹˈaɹuɹˌaɹu
Matahi	matˈahi
mokete	mɔkˈete
karakia	kˌarakˈia
akona	akˈɔna
Kim	kˈim
whawhaitanga	fˌafa͡ɪtˈaŋa
kaiāwhina	kˌa͡ɪaːfˈina
kawau	kawˈau"
Whakaako	fˌakaˈakɔ
Rukuwai	ru"kˈu"wa͡ɪ
Maunga	maˈu"ŋa
Tr	tr
Take	tˈake
runanga	ru"nˈaŋa
pari	pˈari
kāhore	kaːhˈɔre
ekore	ekˈɔre
pukapukaNgā	pˌu"kapˈu"kaŋˈaː
whakamaherehere	fˌakamˌaherehˈere
panuitia	pˌanu"itˈia
Whakaaro	fˌakaˈarɔ
pupuhi	pu"pˈu"hi
pēhitanga	pˌeːhitˈaŋa
ripo	rˈipɔ
waipiro	wa͡ɪpˈirɔ
kaiwhakatairanga	kˌa͡ɪfakˌata͡ɪrˈaŋa
mātaki	maːtˈaki
Whiro	fˈirɔ
taurewa	tˌau"rˈewa
whakamārama	fˌakamaːrˈama
konā	kˈɔnaː
Porowini	pˌɔrɔwˈini
ā	ˈaː
tēina	teːˈina
tūpono	tu"ːpˈɔnɔ
Kiwa	kˈiwa
mätauranga	mˌatau"rˈaŋa
rarua	rarˈu"a
manomanotia	mˌanɔmˌanɔtˈia
wīra	wˈiːra
rongohia	rˌɔŋɔhˈia
mei	mˈei
rōnaki	rɔːnˈaki
tēra	tˈeːra
kaikauwhau	kˌa͡ɪkau"fˈau"
Komene	kɔmˈene
Rūaumoko	rˌu"ːau"mˈɔkɔ
whaiti	fˈa͡ɪti
whakamatautau	fˌakamˌatau"tˈau"
NIWA	nˈiwa
hautaka	hˌau"tˈaka
pūmotu	pu"ːmˈɔtu"
motuhenga	mˌɔtu"hˈeŋa
Reri	rˈeri
tāwharau	tˌaːfarˈau"
kaihaka	ka͡ɪhˈaka
ngongo	ŋˈɔŋɔ
Tohutoro	tˌɔhu"tˈɔrɔ
Kare	kˈare
hoia	hˈo͡ɪa
Marae	mˈara͡ɪ
pūoru	pu"ːˈɔru"
Moemiti	mwemˈiti
Kuini	ku"ˈini
Whanui	fanˈu"i
Tāhei	taːhˈei
Heretaunga	hˌeretaˈu"ŋa
aue	aˈu"e
raua	raˈu"a
Manawa	manˈawa
Matiu	matˈiu"
parenga	parˈeŋa
Karaitiana	kˌara͡ɪtiˈana
Haumiatiketike	hˌau"mˌiatˌiketˈike
Momo	mˈɔmɔ
Waihi	wˈa͡ɪhi
tūhurangia	tˌu"ːhu"raŋˈia
kakahi	kakˈahi
piunga	piˈu"ŋa
maina	mˈa͡ɪna
ronaki	rɔnˈaki
taima	tˈa͡ɪma
whakamahinga	fˌakamahˈiŋa
kaiwhakarite	kˌa͡ɪfakarˈite
rōpinepine	rˌɔːpinepˈine
Mea	mˈea
penei	penˈei
Pāho	pˈaːhɔ
taiopenga	tˌa͡ɪɔpˈeŋa
mo	mˈɔ
kapu	kˈapu"
Kara	kˈara
ru	rˈu"
wāhi	wˈaːhi
Muturangi	mˌu"tu"rˈaŋi
whanga	fˈaŋa
kōtui	kɔːtˈu"i
poapoa	pˌɔapˈɔa
Piki	pˈiki
kukuti	ku"kˈu"ti
mm	mm
hōpara	hɔːpˈara
takirua	tˌakirˈu"a
miniti	minˈiti
waikura	wa͡ɪkˈu"ra
kaiwhakaako	kˌa͡ɪfakaˈakɔ
rironga	rirˈɔŋa
aroha	arˈɔha
tuatara	tˌu"atˈara
Rongopai	rɔŋˈɔpa͡ɪ
waikano	wa͡ɪkˈanɔ
ture	tˈu"re
Whanake	fanˈake
taku	tˈaku"
Ira	ˈira
titi	tˈiti
hunuku	hu"nˈu"ku"
her	hˈer
whainga	fˈa͡ɪŋa
Opotiki	ˌɔpɔtˈiki
māhanga	maːhˈaŋa
hōu	hˈɔːu"
takatakahi	tˌakatakˈahi
Pomare	pɔmˈare
roia	rˈo͡ɪa
kaimātai	ka͡ɪmˈaːta͡ɪ
pakiwaitara	pˌakiwa͡ɪtˈara
maumaharatanga	mˌau"mˌaharatˈaŋa
taonga	tˈa͡ʊŋa
whakama	fakˈama
papamahi	pˌapamˈahi
Manakotanga	mˌanakɔtˈaŋa
Takiwā	takˈiwaː
Nōku	nˈɔːku"
Paetahi	pa͡ɪtˈahi
mārie	maːrˈie
e	ˈe
Koirā	kˈo͡ɪraː
Poutini	pˌou"tˈini
Paraone	parˈa͡ʊne
uku	ˈu"ku"
Me	mˈe
taumanu	tˌau"mˈanu"
huti	hˈu"ti
PōtiNgāwari	pˈɔːtiŋaːwˈari
arapū	arˈapu"ː
orokohanga	ˌɔrɔkɔhˈaŋa
māhana	maːhˈana
Itari	itˈari
Tā	tˈaː
uiuitanga	ˌu"iˌu"itˈaŋa
Kaiwhakawā	kˌa͡ɪfakˈawaː
Tāmakimakaurau	tˌaːmakˌimakˌau"rˈau"
wa	wˈa
Whitu	fˈitu"
raupatutia	rˌau"pˌatu"tˈia
ngutu	ŋˈu"tu"
Whakangungu	fˌakaŋˈu"ŋu"
okioki	ˌɔkiˈɔki
Paerau	pa͡ɪrˈau"
pahemo	pahˈemɔ
tumuaki	tˌu"mu"ˈaki
tohetohe	tˌɔhetˈɔhe
whārua	faːrˈu"a
puku	pˈu"ku"
ekea	ekˈea
rangi	rˈaŋi
pātara	paːtˈara
whākōkī	faːkˈɔːkiː
kuraina	ku"rˈa͡ɪna
Iho	ˈihɔ
Hinewai	hinˈewa͡ɪ
manomita	mˌanɔmˈita
Kei	kˈei
momoho	mɔmˈɔhɔ
ātanga	aːtˈaŋa
āputa	aːpˈu"ta
matemateaone	mˌatemˌateˈa͡ʊne
Taihoa	ta͡ɪhˈɔa
Ahupūngao	ˌahu"pˈu"ːŋa͡ʊ
paihere	pa͡ɪhˈere
Whakamārama	fˌakamaːrˈama
TKKM	tkkm
Tuna	tˈu"na
taniwha	tanˈifa
nou	nˈou"
Hikitia	hˌikitˈia
whakamutu	fˌakamˈu"tu"
heketea	hˌeketˈea
Rupe	rˈu"pe
kaitirotiro	kˌa͡ɪtirɔtˈirɔ
Kaati	kaˈati
Tiki	tˈiki
Huia	hu"ˈia
rohe	rˈɔhe
tuaka	tu"ˈaka
Ruanui	rˌu"anˈu"i
hokohoko	hˌɔkɔhˈɔkɔ
Ngaruawahia	ŋˌaru"ˌawahˈia
Kawhia	kafˈia
Korokī	kɔrˈɔkiː
Ahurei	ˌahu"rˈei
arowhai	arˈɔfa͡ɪ
nukunuku	nˌu"ku"nˈu"ku"
rumaki	ru"mˈaki
Kaimahi	ka͡ɪmˈahi
Kuri	kˈu"ri
Tauanga	tˌau"ˈaŋa
pahū	pˈahu"ː
mākete	maːkˈete
pēpi	pˈeːpi
Mō	mˈɔː
hikohiko	hˌikɔhˈikɔ
Tahiti	tahˈiti
whakakeke	fˌakakˈeke
taimaha	ta͡ɪmˈaha
kaieke	ka͡ɪˈeke
Taiohi	ta͡ɪˈɔhi
oku	ˈɔku"
whā	fˈaː
matakuikui	mˌatakˌu"ikˈu"i
ngaru	ŋˈaru"
arotau	ˌarɔtˈau"
Tāne	tˈaːne
whakamomori	fˌakamɔmˈɔri
whakamohio	fˌakamɔhˈiɔ
whara	fˈara
with	wˈith
Poutāpeta	pˌou"taːpˈeta
tīni	tˈiːni
whakawhāitihia	fˌakafˌaːitihˈia
waihotia	wˌa͡ɪhɔtˈia
Kaitātaki	kˌa͡ɪtaːtˈaki
kōingo	kɔːˈiŋɔ
km	km
Kawea	kawˈea
ERO	ˈerɔ
wetekina	wˌetekˈina
pikau	pikˈau"
Tākuta	taːkˈu"ta
Mahuru	mahˈu"ru"
Hāre	hˈaːre
Mākarini	mˌaːkarˈini
hotoke	hɔtˈɔke
ngoikoretanga	ŋˌo͡ɪkɔretˈaŋa
wani	wˈani
muramura	mˌu"ramˈu"ra
kape	kˈape
whakangungu	fˌakaŋˈu"ŋu"
Rongowhakaata	rˌɔŋɔfˌakaˈata
oropuare	ˌɔrɔpu"ˈare
Teitei	tˌeitˈei
pāhekeheke	pˌaːhekehˈeke
ura	ˈu"ra
kanae	kˈana͡ɪ
Paraire	parˈa͡ɪre
whakamanatanga	fˌakamˌanatˈaŋa
hei	hˈei
Nene	nˈene
Hinewhaitiri	hˌinefa͡ɪtˈiri
tōtā	tˈɔːtaː
uma	ˈu"ma
Tokerau	tˌɔkerˈau"
hōhonutanga	hˌɔːhɔnu"tˈaŋa
hū	hˈu"ː
tongi	tˈɔŋi
mauria	mˌau"rˈia
Mā	mˈaː
taiwhenua	tˌa͡ɪfenˈu"a
Hon	hˈɔn
tāporowhita	tˌaːpɔrɔfˈita
Ake	ˈake
Ngahiwi	ŋahˈiwi
kawenata	kˌawenˈata
patai	pˈata͡ɪ
rahinga	rahˈiŋa
Poronihana	pˌɔrɔnihˈana
He	hˈe
kaaore	kaˈa͡ʊre
orooro	ˌɔrɔˈɔrɔ
pūhou	pu"ːhˈou"
a	ˈa
inea	inˈea
Takoto	takˈɔtɔ
kaipāmu	ka͡ɪpˈaːmu"
whakatakotoria	fˌakatˌakɔtɔrˈia
Ngatiporou	ŋˌatipɔrˈou"
paihana	pa͡ɪhˈana
Tūtarawānanga	tˌu"ːtarˌawaːnˈaŋa
Hauāuru	hˌau"aːˈu"ru"
Wharekura	fˌarekˈu"ra
Port	pˈɔrt
rangirua	rˌaŋirˈu"a
hēki	hˈeːki
miharo	mihˈarɔ
kē	kˈeː
kaho	kˈahɔ
nuitanga	nˌu"itˈaŋa
Waitangi	wa͡ɪtˈaŋi
Matariki	mˌatarˈiki
kapa	kˈapa
whakahou	fˌakahˈou"
popo	pˈɔpɔ
Hurae	hˈu"ra͡ɪ
Manuka	manˈu"ka
haehaea	ha͡ɪhˈa͡ɪa
mekemeke	mˌekemˈeke
rangona	raŋˈɔna
taumau	tˌau"mˈau"
Whakatairanga	fˌakata͡ɪrˈaŋa
kaiwhiwhi	ka͡ɪfˈifi
nuitia	nˌu"itˈia
kōrari	kɔːrˈari
kupenga	ku"pˈeŋa
motika	mɔtˈika
hōanga	hɔːˈaŋa
Ngoi	ŋˈo͡ɪ
aha	ˈaha
haea	hˈa͡ɪa
hōrapa	hɔːrˈapa
wawe	wˈawe
Amorangi	ˌamɔrˈaŋi
ra	rˈa
hainatia	hˌa͡ɪnatˈia
māhorahora	mˌaːhɔrahˈɔra
hikareti	hˌikarˈeti
parera	parˈera
Hanuere	hˌanu"ˈere
turi	tˈu"ri
wharepukapuka	fˌarepˌu"kapˈu"ka
Tutekohi	tˌu"tekˈɔhi
ngata	ŋˈata
rito	rˈitɔ
Whina	fˈina
Whakawhetai	fˌakafˈeta͡ɪ
Mārire	maːrˈire
Rauparaha	rˌau"parˈaha
Hautau	hˌau"tˈau"
pāwera	paːwˈera
temepara	tˌemepˈara
Toro	tˈɔrɔ
hāpara	haːpˈara
kāo	kˈaːɔ
Mātua	maːtˈu"a
māna	mˈaːna
pūoro	pu"ːˈɔrɔ
Whitinga	fitˈiŋa
Haere	hˈa͡ɪre
ipu	ˈipu"
paremata	pˌaremˈata
tuhituhinga	tˌu"hitu"hˈiŋa
karoro	karˈɔrɔ
Puni	pˈu"ni
kānga	kˈaːŋa
ngāi	ŋˈaːi
turuturu	tˌu"ru"tˈu"ru"
Rereroa	rˌererˈɔa
Whatu	fˈatu"
moutere	mˌou"tˈere
pōtiki	pɔːtˈiki
Rōpū	rˈɔːpu"ː
Waiora	wa͡ɪˈɔra
Taiao	tˈa͡ɪa͡ʊ
rehu	rˈehu"
taiaha	ta͡ɪˈaha
taratahi	tˌaratˈahi
Kamupene	kˌamu"pˈene
pohewa	pɔhˈewa
kopu	kˈɔpu"
kītanga	kiːtˈaŋa
matihiko	mˌatihˈikɔ
hea	hˈea
whakaputaina	fˌakapu"tˈa͡ɪna
kōwhiria	kˌɔːfirˈia
korerotia	kˌɔrerɔtˈia
motukā	mɔtˈu"kaː
wahi	wˈahi
kaiwhakangungu	kˌa͡ɪfakaŋˈu"ŋu"
rengarenga	rˌeŋarˈeŋa
paruparu	pˌaru"pˈaru"
tauparapara	tˌau"pˌarapˈara
pātītī	paːtˈiːtiː
karaitiana	kˌara͡ɪtiˈana
Toroa	tɔrˈɔa
MP	mp
umere	u"mˈere
more	mˈɔre
ope	ˈɔpe
Mātaiako	mˌaːta͡ɪˈakɔ
wāpu	wˈaːpu"
ōu	ˈɔːu"
hoea	hwˈea
Waiapu	wa͡ɪˈapu"
rēmana	reːmˈana
waahanga	wˌaahˈaŋa
neke	nˈeke
tōpana	tɔːpˈana
pūrēhua	pˌu"ːreːhˈu"a
nē	nˈeː
Whakaari	fˌakaˈari
toka	tˈɔka
takahia	tˌakahˈia
Hopukina	hˌɔpu"kˈina
whakamāoritanga	fˌakamˌaːɔritˈaŋa
kaumatua	kˌau"matˈu"a
aromatawai	ˌarɔmatˈawa͡ɪ
nōhia	nɔːhˈia
kaore	kˈa͡ʊre
parau	parˈau"
kaihoko	ka͡ɪhˈɔkɔ
tautohu	tˌau"tˈɔhu"
Whaitua	fa͡ɪtˈu"a
hangarite	hˌaŋarˈite
Kāhui	kaːhˈu"i
tohatoha	tˌɔhatˈɔha
tareka	tarˈeka
tāwara	taːwˈara
tuki	tˈu"ki
angitū	aŋˈitu"ː
paepae	pˈa͡ɪpa͡ɪ
koutou	kˌou"tˈou"
tupunga	tu"pˈu"ŋa
whānuitanga	fˌaːnu"itˈaŋa
rima	rˈima
Runga	rˈu"ŋa
taratara	tˌaratˈara
pupuri	pu"pˈu"ri
whitianga	fˌitiˈaŋa
purua	pu"rˈu"a
maharahara	mˌaharahˈara
Whakamoemiti	fˌakamwemˈiti
naianei	nˌa͡ɪanˈei
taupā	taˈu"paː
hara	hˈara
Heikōkō	hˌeikˈɔːkɔː
tūī	tˈu"ːiː
Ūropi	u"ːrˈɔpi
Minita	minˈita
hōtaka	hɔːtˈaka
Whetū	fˈetu"ː
taupua	tˌau"pˈu"a
rāpoi	rˈaːpo͡ɪ
Kumeroa	kˌu"merˈɔa
Makaurau	mˌakau"rˈau"
patua	patˈu"a
we	wˈe
Aronui	ˌarɔnˈu"i
Kaihauturu	kˌa͡ɪhau"tˈu"ru"
Mātenga	maːtˈeŋa
hoiho	hˈo͡ɪhɔ
whakairia	fˌaka͡ɪrˈia
hōhonu	hɔːhˈɔnu"
Rongomātāne	rˌɔŋɔmaːtˈaːne
matewhawhati	mˌatefafˈati
peke	pˈeke
tāngia	taːŋˈia
Hāhi	hˈaːhi
Erueti	ˌeru"ˈeti
pākehā	paːkˈehaː
whakatenetene	fˌakatˌenetˈene
Peehi	peˈehi
aua	aˈu"a
whakamanahia	fˌakamˌanahˈia
hahau	hahˈau"
Nei	nˈei
Kuaha	ku"ˈaha
whakaemi	fakˈa͡ɪmi
Irihāpeti	ˌirihaːpˈeti
poro	pˈɔrɔ
Whā	fˈaː
kokoraho	kˌɔkɔrˈahɔ
ngahuru	ŋahˈu"ru"
heoi	hˈeo͡ɪ
kākā	kˈaːkaː
kaitarai	ka͡ɪtˈara͡ɪ
waa	wˈaa
wetewete	wˌetewˈete
ēra	ˈeːra
puri	pˈu"ri
whakaaetanga	fˌakaa͡ɪtˈaŋa
ihiihi	ˌihiˈihi
tuihono	tˌu"ihˈɔnɔ
ringatoi	riŋˈato͡ɪ
nui	nˈu"i
takatū	takˈatu"ː
whāia	faːˈia
wiri	wˈiri
whakatutukitanga	fˌakatˌu"tu"kitˈaŋa
Whena	fˈena
Pākeha	paːkˈeha
Ao	ˈa͡ʊ
Hoahoatia	hˌɔahˌɔatˈia
whakatikaina	fˌakatikˈa͡ɪna
Kōti	kˈɔːti
whakangaromia	fˌakaŋˌarɔmˈia
Taura	taˈu"ra
maia	mˈa͡ɪa
Tēnei	teːnˈei
Tihei	tihˈei
kāmera	kaːmˈera
Taranga	tarˈaŋa
ngangahau	ŋˌaŋahˈau"
tukituki	tˌu"kitˈu"ki
Kaipara	ka͡ɪpˈara
hupa	hˈu"pa
tepu	tˈepu"
uniana	ˌu"niˈana
rangitaki	rˌaŋitˈaki
pānga	pˈaːŋa
nohoia	nɔhˈo͡ɪa
teetahi	tˌeetˈahi
Takirua	tˌakirˈu"a
Poronīhia	pˌɔrɔniːhˈia
Tūrongo	tu"ːrˈɔŋɔ
tatauranga	tˌatau"rˈaŋa
tutuki	tu"tˈu"ki
whakatūngia	fˌakatu"ːŋˈia
whiri	fˈiri
tāpaetanga	tˌaːpa͡ɪtˈaŋa
whakatakoto	fˌakatakˈɔtɔ
Raukōkore	rˌau"kɔːkˈɔre
ehara	ehˈara
Kaihoko	ka͡ɪhˈɔkɔ
parakatihi	pˌarakatˈihi
Mōhiotanga	mˌɔːhiɔtˈaŋa
Akuanei	ˌaku"anˈei
Ripoata	rˌipɔˈata
kapia	kapˈia
Ahorangi	ˌahɔrˈaŋi
Para	pˈara
noaiho	nɔˈa͡ɪhɔ
maatou	mˌaatˈou"
whakautu	fˌakaˈu"tu"
Paepae	pˈa͡ɪpa͡ɪ
rehe	rˈehe
oriori	ˌɔriˈɔri
tēnei	teːnˈei
Turanga	tu"rˈaŋa
haumaru	hˌau"mˈaru"
ngū	ŋˈu"ː
whakatutuki	fˌakatu"tˈu"ki
whakamau	fˌakamˈau"
tāroa	taːrˈɔa
paea	pˈa͡ɪa
pātata	paːtˈata
Pēhea	peːhˈea
rau	rˈau"
pakihiwi	pˌakihˈiwi
Mangu	mˈaŋu"
murua	mu"rˈu"a
Koiora	ko͡ɪˈɔra
whakataungia	fˌakatˌau"ŋˈia
kohanga	kɔhˈaŋa
where	fˈere
Ngai	ŋˈa͡ɪ
Ingoa	iŋˈɔa
rino	rˈinɔ
whakawhānui	fˌakafaːnˈu"i
kamera	kamˈera
Aperira	ˌaperˈira
mataurangamaori	mˌataˌu"raŋamˈa͡ʊri
nanakia	nˌanakˈia
tikaka	tikˈaka
Hōtaka	hɔːtˈaka
Tona	tˈɔna
inumia	ˌinu"mˈia
ngaua	ŋaˈu"a
whakairihia	fˌaka͡ɪrihˈia
Kaipōti	ka͡ɪpˈɔːti
whakarerenga	fˌakarerˈeŋa
nei	nˈei
Tangi	tˈaŋi
arotakengia	ˌarɔtˌakeŋˈia
toharite	tˌɔharˈite
Kia	kˈia
Whakangahau	fˌakaŋahˈau"
tipuranga	tˌipu"rˈaŋa
Oketopa	ˌɔketˈɔpa
turoro	tu"rˈɔrɔ
puka	pˈu"ka
Rarohenga	rˌarɔhˈeŋa
arahina	ˌarahˈina
Rangatira	rˌaŋatˈira
whakatūria	fˌakatu"ːrˈia
taane	taˈane
Matt	mˈatt
Papakupu	pˌapakˈu"pu"
ngā	ŋˈaː
kaiao	kˈa͡ɪa͡ʊ
whakahouhia	fˌakahˌou"hˈia
ripa	rˈipa
that	thˈat
tēna	tˈeːna
āhuatanga	ˌaːhu"atˈaŋa
whanake	fanˈake
katoatia	kˌatɔatˈia
Tongarewa	tˌɔŋarˈewa
Turei	tu"rˈei
Panuku	panˈu"ku"
Nākahi	naːkˈahi
whakairohia	fˌaka͡ɪrɔhˈia
Taha	tˈaha
ahurea	ˌahu"rˈea
tinana	tinˈana
kareti	karˈeti
mōkito	mɔːkˈitɔ
poto	pˈɔtɔ
Hēnare	heːnˈare
ngāwhā	ŋˈaːfaː
Porirua	pˌɔrirˈu"a
tuawhenua	tˌu"afenˈu"a
rika	rˈika
Ropu	rˈɔpu"
rīpoata	rˌiːpɔˈata
kauri	kaˈu"ri
Whangamata	fˌaŋamˈata
whakamaumahara	fˌakamˌau"mahˈara
āwhinatanga	ˌaːfinatˈaŋa
maheni	mahˈeni
tiaki	tiˈaki
Pourangahua	pˌou"rˌaŋahˈu"a
Pirīmia	pˌiriːmˈia
eenei	ˌeenˈei
mana	mˈana
tākuta	taːkˈu"ta
TKI	tkˈi
haumano	hˌau"mˈanɔ
whakawā	fakˈawaː
reka	rˈeka
ēnā	ˈeːnaː
kiia	kiˈia
Parahaki	pˌarahˈaki
Whakapapa	fˌakapˈapa
Network	nˈetwɔrk
taau	taˈau"
tāhū	tˈaːhu"ː
purutia	pˌu"ru"tˈia
whakatinanatanga	fˌakatˌinanatˈaŋa
kiriuhi	kˌiriˈu"hi
mōhiotia	mˌɔːhiɔtˈia
ngohe	ŋˈɔhe
pea	pˈea
Kino	kˈinɔ
pakaruhia	pˌakaru"hˈia
riihi	riˈihi
whakatau	fˌakatˈau"
Whakahirahira	fˌakahˌirahˈira
hūware	hu"ːwˈare
whēkau	feːkˈau"
Rewa	rˈewa
tāruarua	tˌaːru"arˈu"a
Hoa	hˈɔa
ne	nˈe
tuatangata	tˌu"ataŋˈata
puru	pˈu"ru"
ōkawa	ɔːkˈawa
Tumuaki	tˌu"mu"ˈaki
Maku	mˈaku"
Āpitihanga	ˌaːpitihˈaŋa
Ururoa	ˌu"ru"rˈɔa
Aromatawai	ˌarɔmatˈawa͡ɪ
paru	pˈaru"
whakamohiotia	fˌakamˌɔhiɔtˈia
Paoa	pˈa͡ʊa
rāwhiti	raːfˈiti
Kaiwhakahaere	kˌa͡ɪfakahˈa͡ɪre
whakarerea	fˌakarerˈea
toru	tˈɔru"
Tūhoe	tˈu"ːhwe
Whakamana	fˌakamˈana
Pokapū	pɔkˈapu"ː
Iwi	ˈiwi
koko	kˈɔkɔ
kōpiro	kɔːpˈirɔ
tomokanga	tˌɔmɔkˈaŋa
Takiuru	tˌakiˈu"ru"
konumohe	kˌɔnu"mˈɔhe
mārō	mˈaːrɔː
Hemana	hemˈana
mōrehu	mɔːrˈehu"
pānui	paːnˈu"i
Whakatane	fˌakatˈane
puawai	pu"ˈawa͡ɪ
huihuinga	hˌu"ihu"ˈiŋa
tārai	tˈaːra͡ɪ
matarau	mˌatarˈau"
purākau	pˌu"raːkˈau"
tukutahi	tˌu"ku"tˈahi
Waitara	wa͡ɪtˈara
whakawhirinaki	fˌakafˌirinˈaki
Amerika	ˌamerˈika
Kuhuna	ku"hˈu"na
up	ˈu"p
Maraea	marˈa͡ɪa
ringa	rˈiŋa
Whātaitai	faːtˈa͡ɪta͡ɪ
uka	ˈu"ka
tereina	tˌereˈina
whiunga	fiˈu"ŋa
kaikawe	ka͡ɪkˈawe
āna	ˈaːna
panana	panˈana
mārakerake	mˌaːrakerˈake
porohe	pɔrˈɔhe
Wananga	wanˈaŋa
tuakiri	tˌu"akˈiri
Urewera	ˌu"rewˈera
ahurewa	ˌahu"rˈewa
Rāpata	raːpˈata
Aitanga	a͡ɪtˈaŋa
kirihou	kˌirihˈou"
Moore	mɔˈɔre
whakamaroke	fˌakamarˈɔke
pāpā	pˈaːpaː
mēnā	mˈeːnaː
haha	hˈaha
Waihanga	wa͡ɪhˈaŋa
Mena	mˈena
Ataata	ˌataˈata
tāku	tˈaːku"
Tomokanga	tˌɔmɔkˈaŋa
tuari	tu"ˈari
Pēpuere	pˌeːpu"ˈere
Matenga	matˈeŋa
mokai	mˈɔka͡ɪ
kau	kˈau"
ngaio	ŋˈa͡ɪɔ
Kahukura	kˌahu"kˈu"ra
mokowhiti	mˌɔkɔfˈiti
Āhea	aːhˈea
tātaki	taːtˈaki
Tupu	tˈu"pu"
hopi	hˈɔpi
tē	tˈeː
Ōrākei	ˌɔːraːkˈei
kaupae	kaˈu"pa͡ɪ
Whāingaroa	fˌaːiŋarˈɔa
ākau	aːkˈau"
kauhau	kˌau"hˈau"
Tuhinga	tu"hˈiŋa
whakapāho	fˌakapˈaːhɔ
Kuia	ku"ˈia
mātou	maːtˈou"
paingia	pa͡ɪŋˈia
kōhua	kɔːhˈu"a
tapeke	tapˈeke
matawai	matˈawa͡ɪ
Mātāmua	mˌaːtaːmˈu"a
Maria	marˈia
hukihuki	hˌu"kihˈu"ki
ngoikore	ŋo͡ɪkˈɔre
inu	ˈinu"
Kīngitanga	kˌiːŋitˈaŋa
Kākāriki	kˌaːkaːrˈiki
Whāia	faːˈia
tarau	tarˈau"
haerea	ha͡ɪrˈea
Matū	mˈatu"ː
tauwehe	tˌau"wˈehe
Nga	ŋˈa
puritia	pˌu"ritˈia
Arahura	ˌarahˈu"ra
tawhito	tafˈitɔ
kaupapahere	kˌau"pˌapahˈere
kohikohia	kˌɔhikɔhˈia
matā	mˈataː
Hōhepa	hɔːhˈepa
ate	ˈate
rïroa	rirˈɔa
ē	ˈeː
whakamatea	fˌakamatˈea
pūhui	pu"ːhˈu"i
hāunga	haːˈu"ŋa
Rāapa	raːˈapa
waiu	wˈa͡ɪu"
punga	pˈu"ŋa
pūhihi	pu"ːhˈihi
Hine	hˈine
Paeroa	pa͡ɪrˈɔa
whakatauria	fˌakatˌau"rˈia
hinaki	hinˈaki
Puhi	pˈu"hi
pūtirotiro	pˌu"ːtirɔtˈirɔ
Mr	mr
Heoti	heˈɔti
Hiko	hˈikɔ
takakino	tˌakakˈinɔ
hāpai	hˈaːpa͡ɪ
motopaika	mˌɔtɔpˈa͡ɪka
Hiranga	hirˈaŋa
āhuru	aːhˈu"ru"
kainoho	ka͡ɪnˈɔhɔ
weheruatanga	wˌeherˌu"atˈaŋa
Rite	rˈite
waero	wˈa͡ɪrɔ
pukepuke	pˌu"kepˈu"ke
Ngahere	ŋahˈere
whakairotia	fˌaka͡ɪrɔtˈia
whatumanawa	fˌatu"manˈawa
Moe	mwˈe
whakapainga	fˌakapˈa͡ɪŋa
piki	pˈiki
Whakaraparapatia	fˌakarˌaparˌapatˈia
hīkina	hiːkˈina
kēhi	kˈeːhi
kirikiti	kˌirikˈiti
Ahitereiria	ˌahitˌereirˈia
whakatetonga	fˌakatetˈɔŋa
Mike	mˈike
aranga	arˈaŋa
pakitau	pˌakitˈau"
Hiruharama	hˌiru"harˈama
tāwhai	tˈaːfa͡ɪ
Tera	tˈera
katia	katˈia
whawhaitia	fˌafa͡ɪtˈia
paemahana	pˌa͡ɪmahˈana
kakenga	kakˈeŋa
tupua	tu"pˈu"a
kaiwhakamārama	kˌa͡ɪfakˌamaːrˈama
papā	pˈapaː
Mātakitaki	mˌaːtakitˈaki
mitarau	mˌitarˈau"
Tātou	taːtˈou"
mou	mˈou"
rīki	rˈiːki
tū	tˈu"ː
rererangi	rˌererˈaŋi
paetuku	pa͡ɪtˈu"ku"
piua	piˈu"a
whakarārangitia	fˌakarˌaːraŋitˈia
Kōwhiringa	kˌɔːfirˈiŋa
whakakapi	fˌakakˈapi
Kōmihana	kˌɔːmihˈana
whakahawea	fˌakahawˈea
purapura	pˌu"rapˈu"ra
Kimihia	kˌimihˈia
roa	rˈɔa
Intent	ˈintent
tukupū	tu"kˈu"pu"ː
Mina	mˈina
Raki	rˈaki
whaia	fˈa͡ɪa
whiriwhiria	fˌirifirˈia
pūtakenga	pˌu"ːtakˈeŋa
mehemea	mˌehemˈea
kore	kˈɔre
tungane	tu"ŋˈane
kaiwhakautu	kˌa͡ɪfakaˈu"tu"
Wāhanga	waːhˈaŋa
whakapūmautia	fˌakapˌu"ːmau"tˈia
pouako	pˌou"ˈakɔ
whakawaho	fˌakawˈahɔ
kotahi	kɔtˈahi
ki	kˈi
moko	mˈɔkɔ
Karen	kˈaren
kūaha	ku"ːˈaha
tī	tˈiː
tōrangapū	tˌɔːraŋˈapu"ː
hore	hˈɔre
tere	tˈere
ioio	iˈo͡ɪɔ
ohu	ˈɔhu"
Ra	rˈa
pārekareka	pˌaːrekarˈeka
whakawhiwhia	fˌakafifˈia
poutū	poˈu"tu"ː
tauwhāiti	tˌau"faːˈiti
Hauiti	hˌau"ˈiti
rāwaho	raːwˈahɔ
kaiwhakatere	kˌa͡ɪfakatˈere
mauritau	mˌau"ritˈau"
otiia	ˌɔtiˈia
upoko	u"pˈɔkɔ
Matauranga	mˌatau"rˈaŋa
Pūrongo	pu"ːrˈɔŋɔ
kiritaki	kˌiritˈaki
harakeke	hˌarakˈeke
nekenekehanga	nˌekenˌekehˈaŋa
Whakatau	fˌakatˈau"
hauwhā	haˈu"faː
whakanui	fˌakanˈu"i
Kairangi	ka͡ɪrˈaŋi
waka	wˈaka
ngangare	ŋaŋˈare
whakahoutanga	fˌakahˌou"tˈaŋa
tohutō	tɔhˈu"tɔː
Maungapōhatu	mˌau"ŋˌapɔːhˈatu"
Kaha	kˈaha
Taka	tˈaka
Rukupō	ru"kˈu"pɔː
Kiritaki	kˌiritˈaki
rongonga	rɔŋˈɔŋa
pihi	pˈihi
takitahi	tˌakitˈahi
tūtohutanga	tˌu"ːtɔhu"tˈaŋa
raupatunga	rˌau"patˈu"ŋa
Kaitiaki	kˌa͡ɪtiˈaki
Hēoi	hˈeːo͡ɪ
whakamōhiotia	fˌakamˌɔːhiɔtˈia
rongoā	rɔŋˈɔaː
Pōtae	pˈɔːta͡ɪ
Mihinare	mˌihinˈare
pūkenga	pu"ːkˈeŋa
inā	ˈinaː
whakahauhau	fˌakahˌau"hˈau"
whakamanawa	fˌakamanˈawa
kaiwhakamahi	kˌa͡ɪfakamˈahi
whaikorero	fˌa͡ɪkɔrˈerɔ
Uru	ˈu"ru"
tūmau	tu"ːmˈau"
tauwhāinga	tˌau"faːˈiŋa
mapi	mˈapi
uia	u"ˈia
Kea	kˈea
matewai	matˈewa͡ɪ
Matakite	mˌatakˈite
kaitakawaenga	kˌa͡ɪtakawˈa͡ɪŋa
hokonga	hɔkˈɔŋa
whakatangitangi	fˌakatˌaŋitˈaŋi
tatua	tatˈu"a
hōia	hɔːˈia
hai	hˈa͡ɪ
otirā	ɔtˈiraː
MakaawhioTe	mˌakaafˈiɔtˈe
paparinga	pˌaparˈiŋa
pērātia	pˌeːraːtˈia
matomato	mˌatɔmˈatɔ
Tai	tˈa͡ɪ
Tūrangawaewae	tˌu"ːraŋawˈa͡ɪwa͡ɪ
Pēhi	pˈeːhi
Kirikiriroa	kˌirikˌirirˈɔa
tāpiria	tˌaːpirˈia
pātū	pˈaːtu"ː
whakawai	fakˈawa͡ɪ
mate	mˈate
eetahi	ˌeetˈahi
whakaaro	fˌakaˈarɔ
ti	tˈi
tūruhi	tu"ːrˈu"hi
iroiro	irˈo͡ɪrɔ
mōu	mˈɔːu"
hautekau	hˌau"tekˈau"
whakaotinga	fˌaka͡ʊtˈiŋa
pukai	pˈu"ka͡ɪ
perana	perˈana
whakaatungia	fˌakaˌatu"ŋˈia
Awhina	afˈina
pūmautanga	pˌu"ːmau"tˈaŋa
Hērangi	heːrˈaŋi
whakamāramatia	fˌakamˌaːramatˈia
Maunganui	mˌau"ŋanˈu"i
Pōti	pˈɔːti
arotahi	ˌarɔtˈahi
kunenga	ku"nˈeŋa
hu	hˈu"
whakarērea	fˌakareːrˈea
Rangahautia	rˌaŋahˌau"tˈia
whakatakariri	fˌakatˌakarˈiri
hangaia	haŋˈa͡ɪa
Ruawharo	rˌu"afˈarɔ
taro	tˈarɔ
Awarua	ˌawarˈu"a
Rātapu	raːtˈapu"
Taupiri	tˌau"pˈiri
tonutia	tˌɔnu"tˈia
Kapu	kˈapu"
maurea	mˌau"rˈea
kaipōti	ka͡ɪpˈɔːti
whakamihia	fˌakamihˈia
whakawhanake	fˌakafanˈake
ngaiotanga	ŋˌa͡ɪɔtˈaŋa
Kahurangi	kˌahu"rˈaŋi
whakamātautau	fˌakamˌaːtau"tˈau"
kamo	kˈamɔ
whakaputu	fˌakapˈu"tu"
Rangitihi	rˌaŋitˈihi
kai	kˈa͡ɪ
hōhā	hˈɔːhaː
ruahine	rˌu"ahˈine
tautuhia	tˌau"tu"hˈia
kame	kˈame
inaki	inˈaki
whakaheke	fˌakahˈeke
Konohi	kɔnˈɔhi
aki	ˈaki
paki	pˈaki
waitohu	wa͡ɪtˈɔhu"
whakapaunga	fˌakapaˈu"ŋa
Ngohe	ŋˈɔhe
tokoiti	tɔkˈo͡ɪti
tātou	taːtˈou"
Aua	aˈu"a
whakapuakitanga	fˌakapˌu"akitˈaŋa
Otirā	ɔtˈiraː
maakete	mˌaakˈete
tuatahitanga	tˌu"atˌahitˈaŋa
papānga	papˈaːŋa
mitamano	mˌitamˈanɔ
Apirana	ˌapirˈana
Pono	pˈɔnɔ
imu	ˈimu"
mātua	maːtˈu"a
kit	kˈit
tu	tˈu"
Māia	maːˈia
wairewa	wa͡ɪrˈewa
panui	panˈu"i
whakakite	fˌakakˈite
kīia	kiːˈia
ohooho	ˌɔhɔˈɔhɔ
haora	hˈa͡ʊra
whakakorikori	fˌakakˌɔrikˈɔri
pupuhihia	pˌu"pu"hihˈia
Hīroa	hiːrˈɔa
karaipi	karˈa͡ɪpi
oioi	ˈo͡ɪo͡ɪ
rawakore	rˌawakˈɔre
mātaitai	maːtˈa͡ɪta͡ɪ
Maehe	mˈa͡ɪhe
whakahekenga	fˌakahekˈeŋa
urutā	u"rˈu"taː
Mutu	mˈu"tu"
Moni	mˈɔni
Home	hˈɔme
hauauru	hˌau"aˈu"ru"
Māmā	mˈaːmaː
Horoi	hˈɔro͡ɪ
waaawa	wˌaaˈawa
kaiārahitanga	kˌa͡ɪaːrˌahitˈaŋa
mokemoke	mˌɔkemˈɔke
whakahirahira	fˌakahˌirahˈira
umu	ˈu"mu"
warewaretia	wˌarewˌaretˈia
taiohi	ta͡ɪˈɔhi
whatinga	fatˈiŋa
mango	mˈaŋɔ
Waimarie	wˌa͡ɪmarˈie
taupānga	tˌau"pˈaːŋa
Ihaka	ihˈaka
whutuporo	fˌu"tu"pˈɔrɔ
poriro	pɔrˈirɔ
Whakaminenga	fˌakaminˈeŋa
kuru	kˈu"ru"
tauihu	tˌau"ˈihu"
kauanga	kˌau"ˈaŋa
hā	hˈaː
Tipu	tˈipu"
Ngata	ŋˈata
Peti	pˈeti
ware	wˈare
paina	pˈa͡ɪna
Rēhita	reːhˈita
whakatara	fˌakatˈara
Whakatōhea	fˌakatɔːhˈea
taero	tˈa͡ɪrɔ
otira	ɔtˈira
pāpaka	paːpˈaka
Hoahoa	hˌɔahˈɔa
Tēnā	tˈeːnaː
Whāriki	faːrˈiki
Reipa	reˈipa
tūtohu	tu"ːtˈɔhu"
Pakihi	pakˈihi
Pukemiro	pˌu"kemˈirɔ
Rēkohu	reːkˈɔhu"
āpiti	aːpˈiti
Niwa	nˈiwa
whare	fˈare
tōnga	tˈɔːŋa
waerehe	wa͡ɪrˈehe
Ākina	aːkˈina
era	ˈera
arohaehae	ˌarɔhˈa͡ɪha͡ɪ
whakaahuahanga	fˌakaˌahu"ahˈaŋa
whakanekeneke	fˌakanˌekenˈeke
Waiariki	wˌa͡ɪarˈiki
hoahoa	hˌɔahˈɔa
nuinga	nu"ˈiŋa
Mangōroa	mˌaŋɔːrˈɔa
tenei	tenˈei
kahu	kˈahu"
Kaikōura	kˌa͡ɪkɔːˈu"ra
wewete	wewˈete
taera	tˈa͡ɪra
kororia	kˌɔrɔrˈia
Tapu	tˈapu"
kaihautu	kˌa͡ɪhaˈu"tu"
ōna	ˈɔːna
whakahere	fˌakahˈere
Tikanga	tikˈaŋa
īngoa	iːŋˈɔa
tātaitai	taːtˈa͡ɪta͡ɪ
poupoutanga	pˌou"pˌou"tˈaŋa
Tauranga	tˌau"rˈaŋa
Whakarea	fˌakarˈea
Uia	u"ˈia
hūnga	hˈu"ːŋa
takoha	takˈɔha
manuhiri	mˌanu"hˈiri
whakaruru	fˌakarˈu"ru"
hauropi	hˌau"rˈɔpi
takere	takˈere
whakairinga	fˌaka͡ɪrˈiŋa
whakarāpopoto	fˌakarˌaːpɔpˈɔtɔ
pāpaku	paːpˈaku"
wh	wh
neketai	nekˈeta͡ɪ
rangahautia	rˌaŋahˌau"tˈia
mātanga	maːtˈaŋa
pōhēhē	pɔːhˈeːheː
hamama	hamˈama
pūtaiao	pu"ːtˈa͡ɪa͡ʊ
Rongomai	rɔŋˈɔma͡ɪ
raatau	rˌaatˈau"
rangahau	rˌaŋahˈau"
ngira	ŋˈira
Paraparaumu	pˌarapˌaraˈu"mu"
he	hˈe
tangihanga	tˌaŋihˈaŋa
Tomo	tˈɔmɔ
N	n
kīhai	kˈiːha͡ɪ
nōna	nˈɔːna
Mākino	maːkˈinɔ
Wairau	wa͡ɪrˈau"
ano	ˈanɔ
Wero	wˈerɔ
Tumatauenga	tˌu"matˌau"ˈeŋa
pīataata	pˌiːataˈata
takune	takˈu"ne
hiko	hˈikɔ
Taipa	tˈa͡ɪpa
Kupu	kˈu"pu"
whakatina	fˌakatˈina
tutu	tˈu"tu"
whakaratoa	fˌakaratˈɔa
Kotahi	kɔtˈahi
haukāinga	hˌau"kaːˈiŋa
pouaka	pˌou"ˈaka
Kōhungahunga	kˌɔːhu"ŋahˈu"ŋa
pūngao	pˈu"ːŋa͡ʊ
nona	nˈɔna
punua	pu"nˈu"a
ngaro	ŋˈarɔ
tauiwi	tˌau"ˈiwi
Mātāwai	maːtˈaːwa͡ɪ
Topeora	tˌɔpeˈɔra
pūhuruhurutanga	pˌu"ːhu"rˌu"hu"ru"tˈaŋa
pāhekoheko	pˌaːhekɔhˈekɔ
Whetu	fˈetu"
whakapehapeha	fˌakapˌehapˈeha
mauī	maˈu"iː
ruaki	ru"ˈaki
tākoha	taːkˈɔha
hēhē	hˈeːheː
Wanaka	wanˈaka
tūtohinga	tˌu"ːtɔhˈiŋa
motokā	mɔtˈɔkaː
timatanga	tˌimatˈaŋa
māmā	mˈaːmaː
Ruatara	rˌu"atˈara
whētui	feːtˈu"i
Puia	pu"ˈia
whaanui	fˌaanˈu"i
maminga	mamˈiŋa
arahau	ˌarahˈau"
Tamanuiterā	tˌamanˌu"itˈeraː
ae	ˈa͡ɪ
pūrama	pu"ːrˈama
ona	ˈɔna
Wai	wˈa͡ɪ
whakamanaia	fˌakamanˈa͡ɪa
Āe	ˈaːe
taea	tˈa͡ɪa
Tamatea	tˌamatˈea
toroa	tɔrˈɔa
ou	ˈou"
te	tˈe
miro	mˈirɔ
Āperahama	ˌaːperahˈama
mahunga	mahˈu"ŋa
anana	anˈana
pirinoa	pˌirinˈɔa
Katoa	katˈɔa
papapaki	pˌapapˈaki
Hōne	hˈɔːne
matakite	mˌatakˈite
manatū	manˈatu"ː
reia	reˈia
Whakaatu	fˌakaˈatu"
pukapuka	pˌu"kapˈu"ka
makawe	makˈawe
Tame	tˈame
ataata	ˌataˈata
kaiuiui	kˌa͡ɪu"iˈu"i
punanga	pu"nˈaŋa
manukanuka	mˌanu"kanˈu"ka
mōrahi	mɔːrˈahi
pohehe	pɔhˈehe
makuku	makˈu"ku"
Tūhono	tu"ːhˈɔnɔ
turaki	tu"rˈaki
Rūnaka	ru"ːnˈaka
karu	kˈaru"
pura	pˈu"ra
waewae	wˈa͡ɪwa͡ɪ
rērere	reːrˈere
Āpiti	aːpˈiti
uara	u"ˈara
takahi	takˈahi
kakahu	kakˈahu"
Keepa	keˈepa
kōhine	kɔːhˈine
nukua	nu"kˈu"a
kōpaka	kɔːpˈaka
Whakarewarewa	fˌakarˌewarˈewa
Tiamani	tˌiamˈani
marea	marˈea
haeretanga	hˌa͡ɪretˈaŋa
Tikitiki	tˌikitˈiki
tautono	tˌau"tˈɔnɔ
pōwhiri	pɔːfˈiri
katipoo	kˌatipˈɔɔ
mōwhiti	mɔːfˈiti
tepe	tˈepe
whakamātao	fˌakamˈaːta͡ʊ
whakakorenga	fˌakakɔrˈeŋa
pipi	pˈipi
mohio	mɔhˈiɔ
reorua	rˌeɔrˈu"a
Hana	hˈana
tānga	tˈaːŋa
hokinga	hɔkˈiŋa
Whakamahinga	fˌakamahˈiŋa
kaiwhakamāori	kˌa͡ɪfakˌamaːˈɔri
maramataka	mˌaramatˈaka
rāpihi	raːpˈihi
hāngū	hˈaːŋu"ː
whakatuwheratanga	fˌakatˌu"feratˈaŋa
hewa	hˈewa
Uara	u"ˈara
titoa	titˈɔa
pitopito	pˌitɔpˈitɔ
Tāpiritanga	tˌaːpiritˈaŋa
taetae	tˈa͡ɪta͡ɪ
Mātaatua	mˌaːtaatˈu"a
mohiotanga	mˌɔhiɔtˈaŋa
hukahuka	hˌu"kahˈu"ka
kirirarau	kˌirirarˈau"
Neke	nˈeke
ngaarara	ŋˌaarˈara
turu	tˈu"ru"
pūrongo	pu"ːrˈɔŋɔ
pīrangi	piːrˈaŋi
nga	ŋˈa
kaporeihana	kˌapɔrˌeihˈana
kati	kˈati
Takawaenga	tˌakawˈa͡ɪŋa
pāpono	paːpˈɔnɔ
tūponotanga	tˌu"ːpɔnɔtˈaŋa
kaiwawao	ka͡ɪwˈawa͡ʊ
huamoni	hˌu"amˈɔni
aho	ˈahɔ
maire	mˈa͡ɪre
Whaiaro	fa͡ɪˈarɔ
harore	harˈɔre
Rapanga	rapˈaŋa
tuara	tu"ˈara
whakatā	fakˈataː
Haimona	ha͡ɪmˈɔna
Tara	tˈara
Waka	wˈaka
hapū	hˈapu"ː
aroturuki	ˌarɔtu"rˈu"ki
Ruapekapeka	rˌu"apˌekapˈeka
Rerenga	rerˈeŋa
Uropi	u"rˈɔpi
hoatu	hɔˈatu"
Ratana	ratˈana
Ruma	rˈu"ma
omaoma	ɔmˈa͡ʊma
Io	ˈiɔ
Ian	ˈian
pia	pˈia
raihana	ra͡ɪhˈana
Kainga	kˈa͡ɪŋa
tapere	tapˈere
Opening	ɔpˈeniŋ
ētehi	eːtˈehi
taote	tˈa͡ʊte
Kawanatanga	kˌawanatˈaŋa
tohungia	tˌɔhu"ŋˈia
mahau	mahˈau"
panga	pˈaŋa
haerenga	ha͡ɪrˈeŋa
kaitono	ka͡ɪtˈɔnɔ
houhia	hˌou"hˈia
Pipi	pˈipi
mirumiru	mˌiru"mˈiru"
ngohengohe	ŋˌɔheŋˈɔhe
porotiti	pˌɔrɔtˈiti
ngātahi	ŋaːtˈahi
whakauru	fˌakaˈu"ru"
Purapura	pˌu"rapˈu"ra
kaute	kaˈu"te
takuta	takˈu"ta
tūtuki	tu"ːtˈu"ki
ngāherehere	ŋˌaːherehˈere
Poneke	pɔnˈeke
maioha	ma͡ɪˈɔha
whakapā	fakˈapaː
takiuru	tˌakiˈu"ru"
tākiri	taːkˈiri
pākeke	paːkˈeke
whakaroto	fˌakarˈɔtɔ
tahataha	tˌahatˈaha
Hangarau	hˌaŋarˈau"
kōrua	kɔːrˈu"a
Marau	marˈau"
Ingarangi	ˌiŋarˈaŋi
ritamano	rˌitamˈanɔ
kōkōwai	kɔːkˈɔːwa͡ɪ
pēnā	pˈeːnaː
Meiha	meˈiha
meneti	menˈeti
whakarākei	fˌakaraːkˈei
kī	kˈiː
matapae	matˈapa͡ɪ
wāwāhitanga	wˌaːwaːhitˈaŋa
matao	mˈata͡ʊ
Kurī	kˈu"riː
raumati	rˌau"mˈati
Otautahi	ˌɔtau"tˈahi
matarua	mˌatarˈu"a
rakatira	rˌakatˈira
kawa	kˈawa
pupuritia	pˌu"pu"ritˈia
uriuri	ˌu"riˈu"ri
Waharoa	wˌaharˈɔa
tākupu	taːkˈu"pu"
pūmahara	pˌu"ːmahˈara
hiwa	hˈiwa
pito	pˈitɔ
Wiki	wˈiki
rare	rˈare
rerehua	rˌerehˈu"a
Katahi	katˈahi
one	ˈɔne
Whiu	fˈiu"
taupoki	tˌau"pˈɔki
Korea	kɔrˈea
pōuri	pɔːˈu"ri
tūtakitanga	tˌu"ːtakitˈaŋa
īnoi	ˈiːno͡ɪ
Kāinga	kaːˈiŋa
whakatauki	fˌakataˈu"ki
Rokohanga	rˌɔkɔhˈaŋa
Rapu	rˈapu"
Muaūpoko	mˌu"au"ːpˈɔkɔ
pirihimana	pˌirihimˈana
Tīpene	tiːpˈene
mihia	mihˈia
karukaru	kˌaru"kˈaru"
Tautoru	tˌau"tˈɔru"
kaka	kˈaka
hanumi	hanˈu"mi
Inā	ˈinaː
horapa	hɔrˈapa
toanga	tɔˈaŋa
pakiwaituhi	pˌakiwa͡ɪtˈu"hi
whakahēngia	fˌakaheːŋˈia
whakatematau	fˌakatˌematˈau"
ngoi	ŋˈo͡ɪ
ritenga	ritˈeŋa
Matua	matˈu"a
takawaenga	tˌakawˈa͡ɪŋa
Work	wˈɔrk
Roroa	rɔrˈɔa
rahui	rahˈu"i
māwhaiwhai	maːfˈa͡ɪfa͡ɪ
hararei	hˌararˈei
Ruatāhuna	rˌu"ataːhˈu"na
Timoti	timˈɔti
tāmia	taːmˈia
Waihau	wa͡ɪhˈau"
weriweri	wˌeriwˈeri
tangata	taŋˈata
whatu	fˈatu"
hōiho	hɔːˈihɔ
iro	ˈirɔ
tokowhitu	tˌɔkɔfˈitu"
Maia	mˈa͡ɪa
Ihu	ˈihu"
ohinga	ɔhˈiŋa
whakawhiwhinga	fˌakafifˈiŋa
whanaketanga	fˌanaketˈaŋa
huahua	hˌu"ahˈu"a
Komiti	kɔmˈiti
pīni	pˈiːni
tautitotito	tˌau"tˌitɔtˈitɔ
tokowhā	tɔkˈɔfaː
whakawhiti	fˌakafˈiti
Taake	taˈake
whakatūpato	fˌakatu"ːpˈatɔ
poupou	pˌou"pˈou"
tautohetohe	tˌau"tˌɔhetˈɔhe
Pīpī	pˈiːpiː
whakahoahoa	fˌakahˌɔahˈɔa
Waaka	waˈaka
tokohia	tˌɔkɔhˈia
huakore	hˌu"akˈɔre
hāngi	hˈaːŋi
pakaru	pakˈaru"
Paetae	pˈa͡ɪta͡ɪ
matenga	matˈeŋa
Whakapā	fakˈapaː
unga	ˈu"ŋa
pātai	pˈaːta͡ɪ
whakaawe	fˌakaˈawe
Rāngai	rˈaːŋa͡ɪ
kaurori	kˌau"rˈɔri
hautanga	hˌau"tˈaŋa
taunekeneke	tˌau"nˌekenˈeke
whakawhiwhi	fˌakafˈifi
urupare	ˌu"ru"pˈare
ārani	aːrˈani
wanawana	wˌanawˈana
whakaarotia	fˌakaˌarɔtˈia
Nāna	nˈaːna
Piripi	pirˈipi
Māramatanga	mˌaːramatˈaŋa
whakamātauria	fˌakamˌaːtau"rˈia
wawetia	wˌawetˈia
Hūrae	hˈu"ːra͡ɪ
onamata	ˌɔnamˈata
ngutuawa	ŋˌu"tu"ˈawa
Atua	atˈu"a
whakae	fˈaka͡ɪ
Whakauru	fˌakaˈu"ru"
tineia	tˌineˈia
Panguru	paŋˈu"ru"
Pere	pˈere
retireti	rˌetirˈeti
rarangi	rarˈaŋi
Tiro	tˈirɔ
Mahia	mahˈia
Kitea	kitˈea
raho	rˈahɔ
hēkeretari	hˌeːkeretˈari
huru	hˈu"ru"
hapa	hˈapa
Puta	pˈu"ta
Tohunga	tɔhˈu"ŋa
Manawatū	mˌanawˈatu"ː
hiranga	hirˈaŋa
tuatini	tˌu"atˈini
Peihopa	pˌeihˈɔpa
Whakaue	fˌakaˈu"e
Makaawhio	mˌakaafˈiɔ
Nau	nˈau"
Miro	mˈirɔ
rekoata	rˌekɔˈata
Kihai	kˈiha͡ɪ
puna	pˈu"na
Rito	rˈitɔ
Rātana	raːtˈana
Tamihana	tˌamihˈana
kaiahuwhenua	kˌa͡ɪahˌu"fenˈu"a
māia	maːˈia
akiaki	ˌakiˈaki
aroaro	ˌarɔˈarɔ
hinonga	hinˈɔŋa
inati	inˈati
tunutunu	tˌu"nu"tˈu"nu"
tōpū	tˈɔːpu"ː
whānau	faːnˈau"
Pāremata	pˌaːremˈata
tuituia	tˌu"itu"ˈia
o	ˈɔ
muka	mˈu"ka
huarākau	hˌu"araːkˈau"
Whakahoki	fˌakahˈɔki
waiwai	wˈa͡ɪwa͡ɪ
whakawhāiti	fˌakafaːˈiti
aria	arˈia
aa	ˈaa
Kiekie	kˌiekˈie
tuu	tˈu"u"
karo	kˈarɔ
tuia	tu"ˈia
poroporoaki	pˌɔrɔpˌɔrɔˈaki
whakapeto	fˌakapˈetɔ
pakeke	pakˈeke
hekenga	hekˈeŋa
wahie	wahˈie
kōanga	kɔːˈaŋa
mawehe	mawˈehe
Karu	kˈaru"
tūmataiti	tˌu"ːmatˈa͡ɪti
Kāi	kˈaːi
whakarite	fˌakarˈite
pōhara	pɔːhˈara
Ngake	ŋˈake
matimati	mˌatimˈati
wūru	wˈu"ːru"
paari	paˈari
notemea	nˌɔtemˈea
pākiki	paːkˈiki
rakau	rakˈau"
tūkinotia	tˌu"ːkinɔtˈia
Pā	pˈaː
raiti	rˈa͡ɪti
huri	hˈu"ri
Whanau	fanˈau"
ho	hˈɔ
manahau	mˌanahˈau"
tohora	tɔhˈɔra
Tāke	tˈaːke
Rukuhia	rˌu"ku"hˈia
Maui	maˈu"i
kake	kˈake
Whakaurua	fˌakau"rˈu"a
karetao	karˈeta͡ʊ
rēhita	reːhˈita
whakahī	fakˈahiː
Pēnei	peːnˈei
wahapū	wahˈapu"ː
Taea	tˈa͡ɪa
Whakaae	fakˈaa͡ɪ
paitini	pa͡ɪtˈini
Ākarana	ˌaːkarˈana
tūtaki	tu"ːtˈaki
Parihaka	pˌarihˈaka
Wenerei	wˌenerˈei
mounu	moˈu"nu"
houra	hoˈu"ra
Kāreti	kaːrˈeti
Tama	tˈama
Maritime	mˌaritˈime
tumu	tˈu"mu"
kapahaka	kˌapahˈaka
Tuakana	tˌu"akˈana
Māna	mˈaːna
kāpō	kˈaːpɔː
kōwhaiwhai	kɔːfˈa͡ɪfa͡ɪ
orokati	ˌɔrɔkˈati
nohopuku	nˌɔhɔpˈu"ku"
kōkiritanga	kˌɔːkiritˈaŋa
tetahi	tetˈahi
Kohinga	kɔhˈiŋa
haunga	haˈu"ŋa
wha	fˈa
whakakāhore	fˌakakaːhˈɔre
pōuritanga	pˌɔːu"ritˈaŋa
pupuru	pu"pˈu"ru"
pūira	pu"ːˈira
ikeike	ˌikeˈike
nōhanga	nɔːhˈaŋa
koiwi	kˈo͡ɪwi
tae	tˈa͡ɪ
takohanga	tˌakɔhˈaŋa
Tuatahi	tˌu"atˈahi
Ākuhata	ˌaːku"hˈata
taone	tˈa͡ʊne
tīkina	tiːkˈina
rautō	raˈu"tɔː
marino	marˈinɔ
tautau	tˌau"tˈau"
iriiri	ˌiriˈiri
raweke	rawˈeke
taitai	tˈa͡ɪta͡ɪ
ina	ˈina
Totara	tɔtˈara
Whārangi	faːrˈaŋi
apu	ˈapu"
Rāniera	rˌaːniˈera
tatahi	tatˈahi
nawai	nˈawa͡ɪ
ngare	ŋˈare
pūrere	pu"ːrˈere
awatea	ˌawatˈea
Oro	ˈɔrɔ
tāroaroa	tˌaːrɔarˈɔa
Aho	ˈahɔ
kawenga	kawˈeŋa
PouakoHe	pˌou"ˈakɔhˈe
pūtoi	pˈu"ːto͡ɪ
raupapa	rˌau"pˈapa
kererū	kerˈeru"ː
rorohiko	rˌɔrɔhˈikɔ
whakatinanahia	fˌakatˌinanahˈia
Whātua	faːtˈu"a
whakahihi	fˌakahˈihi
raupapatanga	rˌau"pˌapatˈaŋa
koke	kˈɔke
mōhio	mɔːhˈiɔ
an	ˈan
ātaahua	ˌaːtaahˈu"a
Papa	pˈapa
whakamāherehere	fˌakamˌaːherehˈere
the	thˈe
mö	mˈɔ
Ruka	rˈu"ka
Whanganui	fˌaŋanˈu"i
tirotiro	tˌirɔtˈirɔ
matou	matˈou"
Hau	hˈau"
ha	hˈa
hurumanu	hˌu"ru"mˈanu"
rāua	raːˈu"a
kuao	kˈu"a͡ʊ
motupaika	mˌɔtu"pˈa͡ɪka
kakati	kakˈati
maka	mˈaka
whakawa	fakˈawa
ohonga	ɔhˈɔŋa
Tenei	tenˈei
amorangi	ˌamɔrˈaŋi
whakahokia	fˌakahɔkˈia
toronga	tɔrˈɔŋa
Tokowhitu	tˌɔkɔfˈitu"
korero	kɔrˈerɔ
whakarerekē	fˌakarerˈekeː
tauākī	tˌau"ˈaːkiː
pare	pˈare
tuhia	tu"hˈia
timu	tˈimu"
kawana	kawˈana
taunaki	tˌau"nˈaki
Waihou	wa͡ɪhˈou"
koanga	kɔˈaŋa
meka	mˈeka
Taonui	ta͡ʊnˈu"i
matikara	mˌatikˈara
kaipūrongo	kˌa͡ɪpu"ːrˈɔŋɔ
whakaoho	fakˈa͡ʊhɔ
whakapuakina	fˌakapˌu"akˈina
whakamamae	fˌakamˈama͡ɪ
puhuruhurutanga	pˌu"hu"rˌu"hu"ru"tˈaŋa
Tautake	tˌau"tˈake
whakaea	fakˈa͡ɪa
oma	ˈɔma
waiū	wˈa͡ɪu"ː
hīmene	hiːmˈene
hunga	hˈu"ŋa
koinā	kˈo͡ɪnaː
whakangungua	fˌakaŋu"ŋˈu"a
teneti	tenˈeti
ahau	ahˈau"
whiu	fˈiu"
Māori	maːˈɔri
nunumi	nu"nˈu"mi
āhuarangi	ˌaːhu"arˈaŋi
whakaangi	fˌakaˈaŋi
Rangahau	rˌaŋahˈau"
taiao	tˈa͡ɪa͡ʊ
Roopu	rɔˈɔpu"
aukati	ˌau"kˈati
take	tˈake
Kiki	kˈiki
Matapakia	mˌatapakˈia
whakamuri	fˌakamˈu"ri
tonutanga	tˌɔnu"tˈaŋa
Waimamaku	wˌa͡ɪmamˈaku"
ahumoana	ˌahu"mɔˈana
whakaingoa	fˌaka͡ɪŋˈɔa
püoru	pu"ˈɔru"
Kauwhata	kˌau"fˈata
hāwhe	hˈaːfe
motumotu	mˌɔtu"mˈɔtu"
pūataata	pˌu"ːataˈata
ka	kˈa
tapahi	tapˈahi
Tāhūhū	taːhˈu"ːhu"ː
Hami	hˈami
moumou	mˌou"mˈou"
hohoro	hɔhˈɔrɔ
papatuhituhi	pˌapatˌu"hitˈu"hi
haria	harˈia
kīhini	kiːhˈini
maungārongo	mˌau"ŋaːrˈɔŋɔ
Kōmiti	kɔːmˈiti
ūhia	u"ːhˈia
Hongi	hˈɔŋi
matua	matˈu"a
Ruatapu	rˌu"atˈapu"
amio	amˈiɔ
Hauauru	hˌau"aˈu"ru"
takitoru	tˌakitˈɔru"
Tiwhikete	tˌifikˈete
Kānata	kaːnˈata
ranga	rˈaŋa
raumata	rˌau"mˈata
arotahinga	ˌarɔtahˈiŋa
pūmua	pu"ːmˈu"a
hiringa	hirˈiŋa
Ohu	ˈɔhu"
pūnaha	pu"ːnˈaha
pūkoro	pu"ːkˈɔrɔ
timata	timˈata
tāia	taːˈia
tuawhā	tu"ˈafaː
Kāore	kaːˈɔre
rēhia	reːhˈia
nāianei	nˌaːianˈei
whakatupuranga	fˌakatˌu"pu"rˈaŋa
mataora	matˈa͡ʊra
Hore	hˈɔre
Tīmoti	tiːmˈɔti
on	ˈɔn
wāhitanga	wˌaːhitˈaŋa
whakapuaki	fˌakapu"ˈaki
tupu	tˈu"pu"
pēhea	peːhˈea
raki	rˈaki
Pepuere	pˌepu"ˈere
methamphetamine	mˌethamphˌetamˈine
no	nˈɔ
maikuku	ma͡ɪkˈu"ku"
pürongo	pu"rˈɔŋɔ
Hei	hˈei
tokotoru	tˌɔkɔtˈɔru"
hukea	hu"kˈea
kiri	kˈiri
paipa	pˈa͡ɪpa
Whakamātauria	fˌakamˌaːtau"rˈia
ngeri	ŋˈeri
Whakarae	fakˈara͡ɪ
Iron	ˈirɔn
Opera	ɔpˈera
hakinakina	hˌakinakˈina
Tino	tˈinɔ
Inia	inˈia
puni	pˈu"ni
Ma	mˈa
ōritenga	ˌɔːritˈeŋa
Arthur	ˈarthu"r
Poutama	pˌou"tˈama
Union	u"nˈiɔn
Nihoniho	nˌihɔnˈihɔ
Tangata	taŋˈata
Haratua	hˌaratˈu"a
Wharekahika	fˌarekahˈika
Mate	mˈate
Whakautua	fˌakau"tˈu"a
pekepeke	pˌekepˈeke
ānō	ˈaːnɔː
mua	mˈu"a
Waea	wˈa͡ɪa
Ngāti	ŋˈaːti
tua	tˈu"a
titia	titˈia
mau	mˈau"
Tangihōro	tˌaŋihˈɔːrɔ
meremere	mˌeremˈere
Whakaaetanga	fˌakaa͡ɪtˈaŋa
mataara	mˌataˈara
heeki	heˈeki
whakapaea	fˌakapˈa͡ɪa
tūhonotanga	tˌu"ːhɔnɔtˈaŋa
mohoao	mɔhˈɔa͡ʊ
pāpātanga	pˌaːpaːtˈaŋa
whakawakanga	fˌakawakˈaŋa
whakakotahitanga	fˌakakˌɔtahitˈaŋa
nuku	nˈu"ku"
kirikā	kirˈikaː
out	ˈou"t
hoake	hɔˈake
Rangatahi	rˌaŋatˈahi
whakaakongia	fˌakaˌakɔŋˈia
tāpoi	tˈaːpo͡ɪ
puihi	pu"ˈihi
rautaki	rˌau"tˈaki
Taurangi	tˌau"rˈaŋi
Maru	mˈaru"
tino	tˈinɔ
whaiaro	fa͡ɪˈarɔ
pāpāhua	pˌaːpaːhˈu"a
tāniko	taːnˈikɔ
whakaoranga	fˌaka͡ʊrˈaŋa
korenga	kɔrˈeŋa
Kerikeri	kˌerikˈeri
Makino	makˈinɔ
Turi	tˈu"ri
Emma	ˈemma
Inaianei	ˌina͡ɪanˈei
Aupouri	ˌau"poˈu"ri
mimiti	mimˈiti
Aratohu	ˌaratˈɔhu"
tāngata	taːŋˈata
Pōwhiri	pɔːfˈiri
poipoia	po͡ɪpˈo͡ɪa
Puketeraki	pˌu"keterˈaki
tokomaha	tˌɔkɔmˈaha
whakapākehātanga	fˌakapˌaːkehaːtˈaŋa
whakawehenga	fˌakawehˈeŋa
koia	kˈo͡ɪa
Tē	tˈeː
kōpu	kˈɔːpu"
tūhura	tu"ːhˈu"ra
korerorero	kˌɔrerɔrˈerɔ
poropiti	pˌɔrɔpˈiti
Tainui	ta͡ɪnˈu"i
kōwae	kˈɔːwa͡ɪ
ēngari	eːŋˈari
whakawhiu	fˌakafˈiu"
weri	wˈeri
whakamaua	fˌakamaˈu"a
pāuna	paːˈu"na
huaina	hu"ˈa͡ɪna
parehe	parˈehe
Ahakoa	ˌahakˈɔa
pakihi	pakˈihi
whakakai	fakˈaka͡ɪ
whāwhā	fˈaːfaː
Hape	hˈape
Kerēme	kerˈeːme
Noema	nwˈema
Ēngari	eːŋˈari
takotoranga	tˌakɔtɔrˈaŋa
ngētehi	ŋeːtˈehi
whakaawhiwhi	fˌakaafˈifi
kātua	kaːtˈu"a
niu	nˈiu"
tōia	tɔːˈia
whāki	fˈaːki
kaitohu	ka͡ɪtˈɔhu"
tana	tˈana
ōnā	ˈɔːnaː
Tamaiti	tamˈa͡ɪti
pahore	pahˈɔre
whāea	faːˈea
powhiri	pɔfˈiri
kōhungahunga	kˌɔːhu"ŋahˈu"ŋa
mā	mˈaː
KO	kˈɔ
āmati	aːmˈati
NEMP	nˈemp
kakano	kakˈanɔ
roko	rˈɔkɔ
Uri	ˈu"ri
whakakitea	fˌakakitˈea
Ae	ˈa͡ɪ
ngaherehere	ŋˌaherehˈere
iranga	irˈaŋa
penihana	pˌenihˈana
aratakina	ˌaratakˈina
Rāwhiti	raːfˈiti
matatau	mˌatatˈau"
kumara	ku"mˈara
kōhao	kˈɔːha͡ʊ
It	ˈit
Hauora	hˌau"ˈɔra
Hītori	hiːtˈɔri
whakaekenga	fˌaka͡ɪkˈeŋa
matahuhua	mˌatahu"hˈu"a
Pehi	pˈehi
parekareka	pˌarekarˈeka
Tāwhirimātea	tˌaːfirˌimaːtˈea
Tatari	tatˈari
arataki	ˌaratˈaki
Tangohanga	tˌaŋɔhˈaŋa
pūkei	pu"ːkˈei
ngota	ŋˈɔta
tātahi	taːtˈahi
toku	tˈɔku"
waenganui	wˌa͡ɪŋanˈu"i
whakaekea	fˌaka͡ɪkˈea
Kāwana	kaːwˈana
kaokao	kˈa͡ʊka͡ʊ
tekau	tekˈau"
whakapaingia	fˌakapa͡ɪŋˈia
āhukahuka	ˌaːhu"kahˈu"ka
Māoritanga	mˌaːɔritˈaŋa
Pūrehuroa	pˌu"ːrehu"rˈɔa
hīkoikoi	hiːkˈo͡ɪko͡ɪ
Power	pˈɔwer
taria	tarˈia
pūtau	pu"ːtˈau"
kaimoana	kˌa͡ɪmɔˈana
kōiwi	kɔːˈiwi
Pēnā	pˈeːnaː
horo	hˈɔrɔ
rua	rˈu"a
tūroa	tu"ːrˈɔa
tango	tˈaŋɔ
konohete	kˌɔnɔhˈete
matawhenua	mˌatafenˈu"a
pūkohu	pu"ːkˈɔhu"
kihai	kˈiha͡ɪ
raatou	rˌaatˈou"
Ōtākou	ˌɔːtaːkˈou"
kākahu	kaːkˈahu"
Hāpara	haːpˈara
tete	tˈete
Koura	koˈu"ra
repo	rˈepɔ
Wanganui	wˌaŋanˈu"i
aio	ˈa͡ɪɔ
whānui	faːnˈu"i
Tini	tˈini
Pāora	paːˈɔra
Tatou	tatˈou"
Whāngārā	faːŋˈaːraː
kapi	kˈapi
The	thˈe
Wera	wˈera
whakaritenga	fˌakaritˈeŋa
whakamauru	fˌakamaˈu"ru"
ākona	aːkˈɔna
ahiahi	ˌahiˈahi
pangarau	pˌaŋarˈau"
whakatikatikahia	fˌakatˌikatˌikahˈia
matara	matˈara
tahitia	tˌahitˈia
Raihania	rˌa͡ɪhanˈia
Tāmati	taːmˈati
mō	mˈɔː
kokoti	kɔkˈɔti
huhua	hu"hˈu"a
Kopu	kˈɔpu"
Aurere	ˌau"rˈere
Whakarewa	fˌakarˈewa
huka	hˈu"ka
Puhiwahine	pˌu"hiwahˈine
kapoa	kapˈɔa
whakamahia	fˌakamahˈia
kōharinga	kˌɔːharˈiŋa
māua	maːˈu"a
Pakeha	pakˈeha
Kumara	ku"mˈara
tama	tˈama
tonu	tˈɔnu"
Herewini	hˌerewˈini
Kaua	kaˈu"a
kōwhai	kˈɔːfa͡ɪ
uaratanga	ˌu"aratˈaŋa
hine	hˈine
Awakairangi	ˌawaka͡ɪrˈaŋi
horoia	hɔrˈo͡ɪa
Mataora	matˈa͡ʊra
Pākehā	paːkˈehaː
waahi	waˈahi
moemoea	mwemwˈea
Whakataetae	fˌakatˈa͡ɪta͡ɪ
angitūtanga	ˌaŋitu"ːtˈaŋa
tautohetia	tˌau"tˌɔhetˈia
whakawhitihia	fˌakafˌitihˈia
iii	iˈii
Hapani	hapˈani
pūmatua	pˌu"ːmatˈu"a
angaanga	ˌaŋaˈaŋa
konutai	kɔnˈu"ta͡ɪ
kaingākau	kˌa͡ɪŋaːkˈau"
Nāwai	nˈaːwa͡ɪ
punaha	pu"nˈaha
hoenga	hwˈeŋa
Akau	akˈau"
More	mˈɔre
Mei	mˈei
hurihuri	hˌu"rihˈu"ri
paku	pˈaku"
patupaiarehe	pˌatu"pˌa͡ɪarˈehe
ririki	rirˈiki
whakahaeretia	fˌakahˌa͡ɪretˈia
koi	kˈo͡ɪ
atamai	atˈama͡ɪ
tare	tˈare
Weka	wˈeka
tari	tˈari
akina	akˈina
tuarua	tˌu"arˈu"a
katahi	katˈahi
Nohotima	nˌɔhɔtˈima
tö	tˈɔ
aromātai	ˌarɔmˈaːta͡ɪ
anō	ˈanɔː
puta	pˈu"ta
Puanga	pu"ˈaŋa
whakarārangi	fˌakaraːrˈaŋi
koeko	kwˈekɔ
kaitā	kˈa͡ɪtaː
Whakatohea	fˌakatɔhˈea
Haki	hˈaki
Erangi	erˈaŋi
ngana	ŋˈana
hākari	haːkˈari
ama	ˈama
Mangere	maŋˈere
Maioha	ma͡ɪˈɔha
kāwai	kˈaːwa͡ɪ
Ākene	aːkˈene
Rangiātea	rˌaŋiaːtˈea
pekanga	pekˈaŋa
pania	panˈia
tētē	tˈeːteː
Ema	ˈema
tuhinga	tu"hˈiŋa
Hokowhitu	hˌɔkɔfˈitu"
whakapakari	fˌakapakˈari
reiti	reˈiti
Timi	tˈimi
hī	hˈiː
mea	mˈea
Parker	pˈarker
kotahitanga	kˌɔtahitˈaŋa
maui	maˈu"i
Pōkiha	pɔːkˈiha
mahitahi	mˌahitˈahi
hāpori	haːpˈɔri
rewena	rewˈena
totoka	tɔtˈɔka
Tere	tˈere
Huata	hu"ˈata
tauhohe	tˌau"hˈɔhe
whakahiki	fˌakahˈiki
kitehia	kˌitehˈia
Rāwhitiroa	rˌaːfitirˈɔa
three	thrˈee
Noho	nˈɔhɔ
main	mˈa͡ɪn
hira	hˈira
werohia	wˌerɔhˈia
waihoki	wa͡ɪhˈɔki
Kawenga	kawˈeŋa
mēra	mˈeːra
whātoro	faːtˈɔrɔ
Ipurangi	ˌipu"rˈaŋi
koropuku	kˌɔrɔpˈu"ku"
kōrerorero	kˌɔːrerɔrˈerɔ
Whakawhiti	fˌakafˈiti
ohanga	ɔhˈaŋa
tahia	tahˈia
awheawhe	ˌafeˈafe
Pine	pˈine
hainahia	hˌa͡ɪnahˈia
Kaimai	kˈa͡ɪma͡ɪ
hātepe	haːtˈepe
Ōtautahi	ˌɔːtau"tˈahi
peenei	pˌeenˈei
takea	takˈea
tini	tˈini
maatau	mˌaatˈau"
wairehu	wa͡ɪrˈehu"
āpitihanga	ˌaːpitihˈaŋa
kimi	kˈimi
tiwhikete	tˌifikˈete
Hāriata	hˌaːriˈata
hauwai	haˈu"wa͡ɪ
whānuitia	fˌaːnu"itˈia
hui	hˈu"i
Peter	pˈeter
whakatairite	fˌakata͡ɪrˈite
horahia	hˌɔrahˈia
ngari	ŋˈari
Koroni	kɔrˈɔni
pungapunga	pˌu"ŋapˈu"ŋa
tūhāhā	tu"ːhˈaːhaː
kōwhiringa	kˌɔːfirˈiŋa
Taurahere	tˌau"rahˈere
hokihoki	hˌɔkihˈɔki
atamira	ˌatamˈira
Tireiniamu	tˌireˌiniˈamu"
Tihema	tihˈema
Tina	tˈina
Tāpiripiri	tˌaːpiripˈiri
mihimihi	mˌihimˈihi
Kao	kˈa͡ʊ
Otiia	ˌɔtiˈia
haerehia	hˌa͡ɪrehˈia
īnanga	iːnˈaŋa
huapae	hu"ˈapa͡ɪ
kaiako	ka͡ɪˈakɔ
pēwhea	peːfˈea
mānukanuka	mˌaːnu"kanˈu"ka
Mārama	maːrˈama
Kōwhiri	kɔːfˈiri
taaea	taˈa͡ɪa
whakahihiko	fˌakahihˈikɔ
Anau	anˈau"
kee	kˈee
Whitireia	fˌitireˈia
tapoko	tapˈɔkɔ
Rewi	rˈewi
mihini	mihˈini
Ripeka	ripˈeka
Ahurea	ˌahu"rˈea
Kahungunu	kˌahu"ŋˈu"nu"
nō	nˈɔː
aronga	arˈɔŋa
tara	tˈara
taapiri	tˌaapˈiri
ahurei	ˌahu"rˈei
whati	fˈati
Wharehuia	fˌarehu"ˈia
whakau	fakˈau"
wehi	wˈehi
ātete	aːtˈete
kotikoti	kˌɔtikˈɔti
whakamana	fˌakamˈana
Atiawa	ˌatiˈawa
Pāpā	pˈaːpaː
Tuini	tu"ˈini
Riu	rˈiu"
whanautanga	fˌanau"tˈaŋa
whakapiria	fˌakapirˈia
maumahara	mˌau"mahˈara
Ōtepoti	ˌɔːtepˈɔti
whakatinanatia	fˌakatˌinanatˈia
wheke	fˈeke
pänui	panˈu"i
karangahia	kˌaraŋahˈia
tanga	tˈaŋa
Otira	ɔtˈira
engari	eŋˈari
māhere	maːhˈere
Tirohia	tˌirɔhˈia
wānangatia	wˌaːnaŋatˈia
ētita	eːtˈita
kāpā	kˈaːpaː
waiora	wa͡ɪˈɔra
ahatia	ˌahatˈia
tuna	tˈu"na
pihanga	pihˈaŋa
tākaro	taːkˈarɔ
waiho	wˈa͡ɪhɔ
Motueka	mˌɔtu"ˈeka
Anaru	anˈaru"
Putanga	pu"tˈaŋa
tuohu	tu"ˈɔhu"
Poihākena	pˌo͡ɪhaːkˈena
pewhea	pefˈea
apataki	ˌapatˈaki
mataono	matˈa͡ʊnɔ
taumāhekeheke	tˌau"mˌaːhekehˈeke
pi	pˈi
me	mˈe
hapainga	hapˈa͡ɪŋa
tiakina	tˌiakˈina
Takuta	takˈu"ta
A	ˈa
kēkē	kˈeːkeː
moohio	mˌɔɔhˈiɔ
hemo	hˈemɔ
taru	tˈaru"
ahupūngao	ˌahu"pˈu"ːŋa͡ʊ
angitu	aŋˈitu"
Tapere	tapˈere
taina	tˈa͡ɪna
konihi	kɔnˈihi
ake	ˈake
whakanoa	fˌakanˈɔa
Whiting	fˈitiŋ
tao	tˈa͡ʊ
Whakaarohia	fˌakaˌarɔhˈia
Maihi	mˈa͡ɪhi
Koohi	kɔˈɔhi
Park	pˈark
tētehi	teːtˈehi
rō	rˈɔː
whakatatū	fˌakatˈatu"ː
totohu	tɔtˈɔhu"
nana	nˈana
Tāwhaki	taːfˈaki
whakahōu	fˌakahˈɔːu"
Pāngarau	pˌaːŋarˈau"
whāiti	faːˈiti
manaia	manˈa͡ɪa
ranunga	ranˈu"ŋa
Putea	pu"tˈea
meake	meˈake
tukanga	tu"kˈaŋa
miraka	mirˈaka
weera	weˈera
kapakapa	kˌapakˈapa
kiki	kˈiki
tawahi	tawˈahi
Pipiri	pipˈiri
ana	ˈana
heke	hˈeke
Oranga	ɔrˈaŋa
Tamehana	tˌamehˈana
kahawai	kahˈawa͡ɪ
motuhake	mˌɔtu"hˈake
tukitukia	tˌu"kitu"kˈia
wae	wˈa͡ɪ
Koinei	ko͡ɪnˈei
Kani	kˈani
tuarā	tu"ˈaraː
arā	ˈaraː
kaikerēme	kˌa͡ɪkerˈeːme
wehewehea	wˌehewehˈea
am	ˈam
pouri	poˈu"ri
week	wˈeek
kōawa	kɔːˈawa
hopukanga	hˌɔpu"kˈaŋa
taiora	ta͡ɪˈɔra
Apopo	apˈɔpɔ
koiri	kˈo͡ɪri
pēnei	peːnˈei
rūma	rˈu"ːma
whakanuitanga	fˌakanˌu"itˈaŋa
maha	mˈaha
ruma	rˈu"ma
papakupu	pˌapakˈu"pu"
hapūtanga	hˌapu"ːtˈaŋa
toko	tˈɔkɔ
Akoranga	ˌakɔrˈaŋa
whakarere	fˌakarˈere
Manawatu	mˌanawˈatu"
tohua	tɔhˈu"a
nakunaku	nˌaku"nˈaku"
ngangau	ŋaŋˈau"
whakatairanga	fˌakata͡ɪrˈaŋa
whāngaia	faːŋˈa͡ɪa
ia	ˈia
Hinemoa	hˌinemˈɔa
tūhuratia	tˌu"ːhu"ratˈia
toe	twˈe
takanga	takˈaŋa
ngaringari	ŋˌariŋˈari
tūāpapa	tˌu"ːaːpˈapa
kirīmi	kirˈiːmi
winika	winˈika
tāruatia	tˌaːru"atˈia
tāpiritanga	tˌaːpiritˈaŋa
wera	wˈera
hauwarea	hˌau"warˈea
Kahu	kˈahu"
poutiriao	pˌou"tirˈia͡ʊ
whakapaparanga	fˌakapˌaparˈaŋa
pūoho	pu"ːˈɔhɔ
haurau	hˌau"rˈau"
Pūtahi	pu"ːtˈahi
hauora	hˌau"ˈɔra
whawha	fˈafa
tuemi	tu"ˈemi
Kaitohutohu	kˌa͡ɪtɔhu"tˈɔhu"
Kaa	kˈaa
MauHe	mˈau"hˈe
Mangakāhia	mˌaŋakaːhˈia
haereere	hˌa͡ɪreˈere
Taketake	tˌaketˈake
topa	tˈɔpa
huarahi	hˌu"arˈahi
kīa	kˈiːa
Tahu	tˈahu"
whawhai	fˈafa͡ɪ
āraitia	ˌaːra͡ɪtˈia
motu	mˈɔtu"
karekau	kˌarekˈau"
motoka	mɔtˈɔka
tīmatanga	tˌiːmatˈaŋa
Tuwharetoa	tˌu"faretˈɔa
Heeni	heˈeni
kapohia	kˌapɔhˈia
kï	kˈi
taurea	tˌau"rˈea
rama	rˈama
Tirikātene	tˌirikaːtˈene
Manukau	mˌanu"kˈau"
anö	ˈanɔ
Hōngongoi	hɔːŋˈɔŋo͡ɪ
whakaparahako	fˌakapˌarahˈakɔ
mauherea	mˌau"herˈea
Ta	tˈa
Kōwhiria	kˌɔːfirˈia
kaukau	kˌau"kˈau"
pūtaketanga	pˌu"ːtaketˈaŋa
rārangitia	rˌaːraŋitˈia
Matuku	matˈu"ku"
tiu	tˈiu"
Hua	hˈu"a
tuatoru	tˌu"atˈɔru"
tāpirihia	tˌaːpirihˈia
ruirui	rˌu"irˈu"i
taihemahema	tˌa͡ɪhemahˈema
Pīhopa	piːhˈɔpa
waiata	wa͡ɪˈata
torongū	tɔrˈɔŋu"ː
parakuihi	pˌaraku"ˈihi
tuitui	tˌu"itˈu"i
āhea	aːhˈea
irirangi	ˌirirˈaŋi
puhia	pu"hˈia
Kapua	kapˈu"a
tātau	taːtˈau"
Tonoa	tɔnˈɔa
pārongo	paːrˈɔŋɔ
wananga	wanˈaŋa
tima	tˈima
Mapi	mˈapi
Hākinakina	hˌaːkinakˈina
auau	ˌau"ˈau"
ingoa	iŋˈɔa
tupeka	tu"pˈeka
io	ˈiɔ
kohikohinga	kˌɔhikɔhˈiŋa
tatanga	tatˈaŋa
miihini	mˌiihˈini
Whenua	fenˈu"a
whakaraupapahia	fˌakarˌau"pˌapahˈia
whiti	fˈiti
toki	tˈɔki
putunga	pu"tˈu"ŋa
arotakenga	ˌarɔtakˈeŋa
poipoi	pˈo͡ɪpo͡ɪ
poutāpeta	pˌou"taːpˈeta
kōkuhu	kɔːkˈu"hu"
kaiwhakataetae	kˌa͡ɪfakatˈa͡ɪta͡ɪ
wātea	waːtˈea
Pūkeko	pu"ːkˈekɔ
Iharaira	ˌiharˈa͡ɪra
ati	ˈati
Ora	ˈɔra
hauhake	hˌau"hˈake
whakarauora	fˌakarˌau"ˈɔra
kaingia	ka͡ɪŋˈia
Aute	aˈu"te
tūemi	tu"ːˈemi
kaiārahi	kˌa͡ɪaːrˈahi
poho	pˈɔhɔ
Akarana	ˌakarˈana
Koata	kɔˈata
kahui	kahˈu"i
nupepa	nu"pˈepa
pere	pˈere
autaia	ˌau"tˈa͡ɪa
ngākaunui	ŋˌaːkau"nˈu"i
Whakaata	fˌakaˈata
horopaki	hˌɔrɔpˈaki
punahiko	pˌu"nahˈikɔ
pukenga	pu"kˈeŋa
hūmarie	hˌu"ːmarˈie
tāpiri	taːpˈiri
pepa	pˈepa
Matahiko	mˌatahˈikɔ
taiapa	ta͡ɪˈapa
tūnga	tˈu"ːŋa
ngaronga	ŋarˈɔŋa
ku	kˈu"
hurihanga	hˌu"rihˈaŋa
their	thˈeir
aianei	ˌa͡ɪanˈei
whakatere	fˌakatˈere
Tonga	tˈɔŋa
ipurangi	ˌipu"rˈaŋi
tēnehi	teːnˈehi
anamata	ˌanamˈata
Kapa	kˈapa
tono	tˈɔnɔ
roro	rˈɔrɔ
pātapa	paːtˈapa
Tauira	tˌau"ˈira
hihiri	hihˈiri
Ope	ˈɔpe
kapukapu	kˌapu"kˈapu"
raa	rˈaa
takiri	takˈiri
rapanga	rapˈaŋa
paraharaha	pˌaraharˈaha
Tamati	tamˈati
pukupuku	pˌu"ku"pˈu"ku"
patunga	patˈu"ŋa
pehea	pehˈea
kakapa	kakˈapa
new	nˈew
ea	ˈea
tānekaha	tˌaːnekˈaha
kōwhatu	kɔːfˈatu"
taa	tˈaa
koro	kˈɔrɔ
pāho	pˈaːhɔ
māramatanga	mˌaːramatˈaŋa
takahuri	tˌakahˈu"ri
tatū	tˈatu"ː
Oreore	ˌɔreˈɔre
aute	aˈu"te
Toru	tˈɔru"
Kohikohinga	kˌɔhikɔhˈiŋa
koe	kwˈe
rangatira	rˌaŋatˈira
hēkona	heːkˈɔna
Tapuika	tˌapu"ˈika
Tom	tˈɔm
whitia	fitˈia
Ākonga	aːkˈɔŋa
mātai	mˈaːta͡ɪ
pepeke	pepˈeke
māku	mˈaːku"
Hongoeka	hɔŋwˈeka
tangotango	tˌaŋɔtˈaŋɔ
taurekareka	tˌau"rˌekarˈeka
Manukura	mˌanu"kˈu"ra
Mutunga	mu"tˈu"ŋa
Ataarangi	ˌataarˈaŋi
kaitohutohu	kˌa͡ɪtɔhu"tˈɔhu"
tuakana	tˌu"akˈana
Waitohi	wa͡ɪtˈɔhi
Muriwai	mu"rˈiwa͡ɪ
Pukapuka	pˌu"kapˈu"ka
Korero	kɔrˈerɔ
whakarārangitanga	fˌakarˌaːraŋitˈaŋa
Kate	kˈate
tuatahi	tˌu"atˈahi
tuhi	tˈu"hi
Patu	pˈatu"
Taria	tarˈia
Hera	hˈera
Wātaka	waːtˈaka
tiriti	tirˈiti
pātaka	paːtˈaka
tūātipu	tˌu"ːaːtˈipu"
in	ˈin
hina	hˈina
Rata	rˈata
ua	ˈu"a
whaka	fˈaka
auahatanga	ˌau"ˌahatˈaŋa
ono	ˈɔnɔ
whakahōnore	fˌakahɔːnˈɔre
rawatia	rˌawatˈia
hīkoitanga	hˌiːko͡ɪtˈaŋa
ahotakakame	ˌahɔtˌakakˈame
tane	tˈane
wākena	waːkˈena
whakaahuru	fˌakaahˈu"ru"
aka	ˈaka
Heke	hˈeke
Ngātoroirangi	ŋˌaːtɔro͡ɪrˈaŋi
whakahuihui	fˌakahˌu"ihˈu"i
tā	tˈaː
noti	nˈɔti
Pūmotu	pu"ːmˈɔtu"
kauruku	kˌau"rˈu"ku"
inarā	inˈaraː
whakakīia	fˌakakiːˈia
kata	kˈata
wānanga	waːnˈaŋa
ēhara	eːhˈara
tāonga	taːˈɔŋa
tōtika	tɔːtˈika
waehere	wa͡ɪhˈere
Apiata	ˌapiˈata
Mokena	mɔkˈena
puehu	pu"ˈehu"
Rawhiti	rafˈiti
ū	ˈu"ː
tatau	tatˈau"
kariri	karˈiri
An	ˈan
kaiwhakawā	kˌa͡ɪfakˈawaː
Pene	pˈene
Tamarau	tˌamarˈau"
Raraunga	rˌaraˈu"ŋa
mimi	mˈimi
Patua	patˈu"a
kii	kˈii
Makere	makˈere
Waiata	wa͡ɪˈata
pokai	pˈɔka͡ɪ
korou	kɔrˈou"
tautohe	tˌau"tˈɔhe
noke	nˈɔke
tāwāhi	taːwˈaːhi
wētahi	weːtˈahi
tātari	taːtˈari
waia	wˈa͡ɪa
aukatia	ˌau"katˈia
hotu	hˈɔtu"
totika	tɔtˈika
Pēhia	peːhˈia
whakakī	fakˈakiː
huānga	hu"ˈaːŋa
Ngāruawāhia	ŋˌaːru"ˌawaːhˈia
moo	mˈɔɔ
Kawekawe	kˌawekˈawe
Ānō	ˈaːnɔː
rere	rˈere
Temara	temˈara
whakahuatanga	fˌakahˌu"atˈaŋa
tauoti	tˌau"ˈɔti
painga	pˈa͡ɪŋa
haurangi	hˌau"rˈaŋi
hangā	hˈaŋaː
hopukina	hˌɔpu"kˈina
Whakaritea	fˌakaritˈea
tāwere	taːwˈere
TTR	ttr
mahi	mˈahi
kaipatu	ka͡ɪpˈatu"
korerohia	kˌɔrerɔhˈia
kētia	keːtˈia
hāngī	hˈaːŋiː
whakauruhia	fˌakaˌu"ru"hˈia
kaihoahoa	kˌa͡ɪhɔahˈɔa
whiua	fiˈu"a
waenga	wˈa͡ɪŋa
Wahawaha	wˌahawˈaha
Tūmatanui	tˌu"ːmatanˈu"i
mānu	mˈaːnu"
ao	ˈa͡ʊ
whakahuahua	fˌakahˌu"ahˈu"a
toke	tˈɔke
kura	kˈu"ra
tataunga	tˌataˈu"ŋa
apopo	apˈɔpɔ
tipuna	tipˈu"na
morehu	mɔrˈehu"
whakapaetia	fˌakapa͡ɪtˈia
pītara	piːtˈara
whakapuakanga	fˌakapˌu"akˈaŋa
hakahaka	hˌakahˈaka
Maranga	marˈaŋa
Tatauria	tˌatau"rˈia
tāima	taːˈima
tieki	tiˈeki
Whangarei	fˌaŋarˈei
rawe	rˈawe
taupatupatu	tˌau"pˌatu"pˈatu"
Teko	tˈekɔ
tiima	tiˈima
pa	pˈa
tihi	tˈihi
whakawāteatia	fˌakawˌaːteatˈia
pūrua	pu"ːrˈu"a
Ā	ˈaː
karia	karˈia
keria	kerˈia
takurua	tˌaku"rˈu"a
titonga	titˈɔŋa
tuumomo	tˌu"u"mˈɔmɔ
Mohi	mˈɔhi
kaitaka	ka͡ɪtˈaka
koroheke	kˌɔrɔhˈeke
Matene	matˈene
totara	tɔtˈara
rātau	raːtˈau"
Kaiwhakaako	kˌa͡ɪfakaˈakɔ
ëtahi	etˈahi
pokanoa	pˌɔkanˈɔa
māka	mˈaːka
Whanaketanga	fˌanaketˈaŋa
Hirini	hirˈini
ratau	ratˈau"
haumanu	hˌau"mˈanu"
taraka	tarˈaka
Pārongo	paːrˈɔŋɔ
takupu	takˈu"pu"
Aroha	arˈɔha
tahi	tˈahi
arotakehia	ˌarɔtˌakehˈia
Pūhipi	pu"ːhˈipi
parapara	pˌarapˈara
huritau	hˌu"ritˈau"
tēnā	tˈeːnaː
koranehe	kˌɔranˈehe
rotarota	rˌɔtarˈɔta
tātarihia	tˌaːtarihˈia
herea	herˈea
auahi	ˌau"ˈahi
poaka	pɔˈaka
Matapihi	mˌatapˈihi
Pātiti	paːtˈiti
hae	hˈa͡ɪ
matawhānui	mˌatafaːnˈu"i
whiwhinga	fifˈiŋa
Mokopuna	mˌɔkɔpˈu"na
tokowha	tɔkˈɔfa
Mauri	maˈu"ri
Huakina	hˌu"akˈina
whakatapu	fˌakatˈapu"
Āniwaniwa	ˌaːniwanˈiwa
matamua	mˌatamˈu"a
whakatenatena	fˌakatˌenatˈena
Arikinui	ˌarikinˈu"i
Kawiti	kawˈiti
hoahoatia	hˌɔahˌɔatˈia
reinga	reˈiŋa
Tana	tˈana
Ihenga	ihˈeŋa
waru	wˈaru"
paihikara	pˌa͡ɪhikˈara
Muri	mˈu"ri
ōhanga	ɔːhˈaŋa
teihana	tˌeihˈana
I	ˈi
whakatairitea	fˌakatˌa͡ɪritˈea
māori	maːˈɔri
maimai	mˈa͡ɪma͡ɪ
Whakatu	fakˈatu"
pirangi	pirˈaŋi
Pouako	pˌou"ˈakɔ
pakirehua	pˌakirehˈu"a
War	wˈar
mahue	mahˈu"e
whakarewatanga	fˌakarˌewatˈaŋa
tata	tˈata
Ata	ˈata
hoka	hˈɔka
kopae	kˈɔpa͡ɪ
Kaihautū	kˌa͡ɪhaˈu"tu"ː
whakaraupapa	fˌakarˌau"pˈapa
whakatoko	fˌakatˈɔkɔ
tawa	tˈawa
mahere	mahˈere
RTM	rtm
ngārara	ŋaːrˈara
whakarato	fˌakarˈatɔ
Awanuiārangi	ˌawanˌu"iaːrˈaŋi
whetū	fˈetu"ː
kawe	kˈawe
ukauka	ˌu"kaˈu"ka
Tarakawa	tˌarakˈawa
tātea	taːtˈea
whae	fˈa͡ɪ
papaneke	pˌapanˈeke
pae	pˈa͡ɪ
whakapumautia	fˌakapˌu"mau"tˈia
kaikanikani	kˌa͡ɪkanikˈani
käore	kˈa͡ʊre
tena	tˈena
taara	taˈara
kina	kˈina
whakapūmau	fˌakapu"ːmˈau"
Whiria	firˈia
pato	pˈatɔ
tahitahi	tˌahitˈahi
takapau	tˌakapˈau"
Tane	tˈane
wāwāhia	wˌaːwaːhˈia
Rawiri	rawˈiri
Erihana	ˌerihˈana
pūranga	pu"ːrˈaŋa
whakanoho	fˌakanˈɔhɔ
Ngatoro	ŋatˈɔrɔ
Aro	ˈarɔ
ngeetehi	ŋˌeetˈehi
kiwi	kˈiwi
pikitia	pˌikitˈia
ratarata	rˌatarˈata
taana	taˈana
tokorua	tˌɔkɔrˈu"a
whanui	fanˈu"i
haupū	haˈu"pu"ː
Mareikura	mˌareikˈu"ra
Ngunguru	ŋu"ŋˈu"ru"
whakaaturia	fˌakaˌatu"rˈia
takiwā	takˈiwaː
pahua	pahˈu"a
tītī	tˈiːtiː
papariki	pˌaparˈiki
aroā	arˈɔaː
kōtiti	kɔːtˈiti
Hoatu	hɔˈatu"
tauhono	tˌau"hˈɔnɔ
Rangihaeata	rˌaŋiha͡ɪˈata
hāpiripiri	hˌaːpiripˈiri
Whakaahua	fˌakaahˈu"a
Tāpirihia	tˌaːpirihˈia
Hatupatu	hˌatu"pˈatu"
huringa	hu"rˈiŋa
whakarata	fˌakarˈata
arero	arˈerɔ
Rau	rˈau"
manawa	manˈawa
whakatūturu	fˌakatu"ːtˈu"ru"
Koroki	kɔrˈɔki
pūtea	pu"ːtˈea
Hauraki	hˌau"rˈaki
kohikohi	kˌɔhikˈɔhi
tērā	tˈeːraː
Kō	kˈɔː
Maketu	makˈetu"
toona	tɔˈɔna
tirohia	tˌirɔhˈia
tūāhuatanga	tˌu"ːaːhˌu"atˈaŋa
iwa	ˈiwa
ika	ˈika
kohurutia	kˌɔhu"ru"tˈia
puke	pˈu"ke
mātakitaki	mˌaːtakitˈaki
whakawera	fˌakawˈera
rauna	raˈu"na
nekehia	nˌekehˈia
ruku	rˈu"ku"
Takurua	tˌaku"rˈu"a
akitu	akˈitu"
whitiwhiti	fˌitifˈiti
Hainamana	hˌa͡ɪnamˈana
Īhu	ˈiːhu"
kāinga	kaːˈiŋa
kaunihera	kˌau"nihˈera
whanau	fanˈau"
maimoatanga	mˌa͡ɪmɔatˈaŋa
tārua	taːrˈu"a
Taraipiunara	tˌara͡ɪpˌiu"nˈara
karawhiua	kˌarafiˈu"a
pātengi	paːtˈeŋi
whakaahuatanga	fˌakaˌahu"atˈaŋa
kōnae	kˈɔːna͡ɪ
teka	tˈeka
kiripuaki	kˌiripu"ˈaki
tīmata	tiːmˈata
whakaawhiwhia	fˌakaˌafifˈia
Wā	wˈaː
rerewē	rerˈeweː
hianga	hiˈaŋa
Kaihokohoko	kˌa͡ɪhɔkɔhˈɔkɔ
kōura	kɔːˈu"ra
kaihauturu	kˌa͡ɪhau"tˈu"ru"
kāhui	kaːhˈu"i
TPK	tpk
Tae	tˈa͡ɪ
tukino	tu"kˈinɔ
pākawa	paːkˈawa
wawahi	wawˈahi
whakatairangatia	fˌakatˌa͡ɪraŋatˈia
Tawhiao	tafˈia͡ʊ
Karahipi	kˌarahˈipi
tupapaku	tˌu"papˈaku"
ihirangi	ˌihirˈaŋi
pao	pˈa͡ʊ
Patariana	pˌatariˈana
Whakatū	fakˈatu"ː
ro	rˈɔ
whakamātūtū	fˌakamaːtˈu"ːtu"ː
kohia	kɔhˈia
Ngarimu	ŋarˈimu"
haki	hˈaki
whatiwhati	fˌatifˈati
whakatupatohia	fˌakatˌu"patɔhˈia
Hapū	hˈapu"ː
Pari	pˈari
tatu	tˈatu"
mahimahi	mˌahimˈahi
raina	rˈa͡ɪna
tautika	tˌau"tˈika
ngakau	ŋakˈau"
wharangi	farˈaŋi
heri	hˈeri
utauta	ˌu"taˈu"ta
rongona	rɔŋˈɔna
iringa	irˈiŋa
rokiroki	rˌɔkirˈɔki
riterite	rˌiterˈite
tahae	tˈaha͡ɪ
Nina	nˈina
Torere	tɔrˈere
raupō	raˈu"pɔː
momona	mɔmˈɔna
Hema	hˈema
tapuae	tapˈu"a͡ɪ
nāna	nˈaːna
Ranginui	rˌaŋinˈu"i
Pita	pˈita
pakapaka	pˌakapˈaka
Tatau	tatˈau"
pona	pˈɔna
noku	nˈɔku"
mōna	mˈɔːna
āku	ˈaːku"
manakohia	mˌanakɔhˈia
Taite	tˈa͡ɪte
rangatū	raŋˈatu"ː
Tūtira	tu"ːtˈira
mutunga	mu"tˈu"ŋa
Tūhourangi	tˌu"ːhou"rˈaŋi
Tata	tˈata
Prime	prˈime
rata	rˈata
kamupene	kˌamu"pˈene
kemu	kˈemu"
kawanatanga	kˌawanatˈaŋa
kaipānui	kˌa͡ɪpaːnˈu"i
paoho	pˈa͡ʊhɔ
tāne	tˈaːne
tioro	tiˈɔrɔ
Uiui	ˌu"iˈu"i
hongi	hˈɔŋi
matea	matˈea
moea	mwˈea
kaipuke	ka͡ɪpˈu"ke
rapunga	rapˈu"ŋa
pāmu	pˈaːmu"
kūare	ku"ːˈare
whakatupu	fˌakatˈu"pu"
uaua	ˌu"aˈu"a
kounga	koˈu"ŋa
whakawāngia	fˌakawaːŋˈia
Raina	rˈa͡ɪna
maunu	maˈu"nu"
Whakataki	fˌakatˈaki
oo	ˈɔɔ
Noa	nˈɔa
pakari	pakˈari
eka	ˈeka
Rakaumangamanga	rˌakaˌu"maŋamˈaŋa
ngākau	ŋaːkˈau"
hou	hˈou"
Whakawhanake	fˌakafanˈake
kumea	ku"mˈea
kurī	kˈu"riː
hokomaha	hˌɔkɔmˈaha
Ngohi	ŋˈɔhi
anu	ˈanu"
pāngarau	pˌaːŋarˈau"
kātahi	kaːtˈahi
Mōteatea	mˌɔːteatˈea
Puoro	pu"ˈɔrɔ
mīhini	miːhˈini
paraihe	parˈa͡ɪhe
whakaaehia	fˌakaa͡ɪhˈia
whakarāpopototanga	fˌakarˌaːpɔpˌɔtɔtˈaŋa
tauārai	tˌau"ˈaːra͡ɪ
Ki	kˈi
whakapono	fˌakapˈɔnɔ
Maungatautari	mˌau"ŋˌatau"tˈari
Na	nˈa
Papatuanuku	pˌapatˌu"anˈu"ku"
mīharo	miːhˈarɔ
tupato	tu"pˈatɔ
raurau	rˌau"rˈau"
Āwherika	ˌaːferˈika
Porourangi	pˌɔrou"rˈaŋi
whakahoungia	fˌakahˌou"ŋˈia
mokopuna	mˌɔkɔpˈu"na
Kanawa	kanˈawa
whāngaihia	fˌaːŋa͡ɪhˈia
whakamahuki	fˌakamahˈu"ki
whakapapa	fˌakapˈapa
whakapuakihia	fˌakapˌu"akihˈia
putea	pu"tˈea
ngarongaro	ŋˌarɔŋˈarɔ
piu	pˈiu"
paahitia	pˌaahitˈia
utunga	u"tˈu"ŋa
pitomata	pˌitɔmˈata
Tāwhiao	taːfˈia͡ʊ
whakaarotanga	fˌakaˌarɔtˈaŋa
pütea	pu"tˈea
Muriwhenua	mˌu"rifenˈu"a
raupua	rˌau"pˈu"a
kaiora	ka͡ɪˈɔra
tapatoru	tˌapatˈɔru"
kaituhi	ka͡ɪtˈu"hi
niho	nˈihɔ
ngāngara	ŋaːŋˈara
Anei	anˈei
whakatūtū	fˌakatˈu"ːtu"ː
whanaungatanga	fˌanaˌu"ŋatˈaŋa
hīkaka	hiːkˈaka
K	k
tāneke	taːnˈeke
UN	ˈu"n
Taumata	tˌau"mˈata
hurihia	hˌu"rihˈia
ngarara	ŋarˈara
Āpiha	aːpˈiha
Wīwī	wˈiːwiː
koura	koˈu"ra
pū	pˈu"ː
ito	ˈitɔ
mātāmua	mˌaːtaːmˈu"a
whakamiharo	fˌakamihˈarɔ
ārainga	aːrˈa͡ɪŋa
Rahui	rahˈu"i
Mataatua	mˌataatˈu"a
Teina	teˈina
poka	pˈɔka
Kanikani	kˌanikˈani
North	nˈɔrth
Taua	taˈu"a
huaki	hu"ˈaki
wānaka	waːnˈaka
whakareka	fˌakarˈeka
Wa	wˈa
poraka	pɔrˈaka
Maiharanui	mˌa͡ɪharanˈu"i
Rangiwewehi	rˌaŋiwewˈehi
Mātai	mˈaːta͡ɪ
Rānana	raːnˈana
honi	hˈɔni
Waikanae	wa͡ɪkˈana͡ɪ
pānuitanga	pˌaːnu"itˈaŋa
tāpiripiri	tˌaːpiripˈiri
kauaka	kˌau"ˈaka
taipitopito	tˌa͡ɪpitɔpˈitɔ
hēneti	heːnˈeti
Ama	ˈama
manaakitanga	mˌanaˌakitˈaŋa
turituri	tˌu"ritˈu"ri
pūkahukahu	pˌu"ːkahu"kˈahu"
Tīkina	tiːkˈina
kaipūtaiao	kˌa͡ɪpu"ːtˈa͡ɪa͡ʊ
āwhā	ˈaːfaː
matapōkere	mˌatapɔːkˈere
Tūturu	tu"ːtˈu"ru"
mārika	maːrˈika
Pūkenga	pu"ːkˈeŋa
rangapū	raŋˈapu"ː
paetara	pa͡ɪtˈara
mahia	mahˈia
Hunga	hˈu"ŋa
Āperira	ˌaːperˈira
ihotanga	ˌihɔtˈaŋa
hokona	hɔkˈɔna
whakahāngai	fˌakahˈaːŋa͡ɪ
whakawākia	fˌakawaːkˈia
ngangahu	ŋaŋˈahu"
hakari	hakˈari
Toitū	tˈo͡ɪtu"ː
tūhonoa	tˌu"ːhɔnˈɔa
Nui	nˈu"i
kite	kˈite
koroni	kɔrˈɔni
Taumārere	tˌau"maːrˈere
Matatini	mˌatatˈini
maranga	marˈaŋa
Paari	paˈari
tautuhi	tˌau"tˈu"hi
kairangi	ka͡ɪrˈaŋi
whakangau	fˌakaŋˈau"
whakamutua	fˌakamu"tˈu"a
Tamatoa	tˌamatˈɔa
penapena	pˌenapˈena
pōraruraru	pˌɔːraru"rˈaru"
whakarauika	fˌakarˌau"ˈika
Pahi	pˈahi
Kereama	kˌereˈama
Huka	hˈu"ka
mona	mˈɔna
puiaki	pˌu"iˈaki
Taiwhanga	ta͡ɪfˈaŋa
matatika	mˌatatˈika
awhitia	ˌafitˈia
māu	mˈaːu"
taraute	tˌaraˈu"te
whakahoutia	fˌakahˌou"tˈia
TE	tˈe
pā	pˈaː
Mema	mˈema
kaihāpai	ka͡ɪhˈaːpa͡ɪ
reta	rˈeta
tuaahu	tˌu"aˈahu"
Pem	pˈem
whakapiripiri	fˌakapˌiripˈiri
atarau	ˌatarˈau"
Whakareatia	fˌakarˌeatˈia
pena	pˈena
Tuahiwi	tˌu"ahˈiwi
haurua	hˌau"rˈu"a
tërä	tˈera
tiakarete	tˌiakarˈete
papaki	papˈaki
Wairaka	wa͡ɪrˈaka
whakarerekēngia	fˌakarˌerekeːŋˈia
tōu	tˈɔːu"
nunui	nu"nˈu"i
Toi	tˈo͡ɪ
TEETH	tˈeeth
whakamihi	fˌakamˈihi
atu	ˈatu"
wāhanga	waːhˈaŋa
ōwehenga	ˌɔːwehˈeŋa
Whakapono	fˌakapˈɔnɔ
wana	wˈana
kūmara	ku"ːmˈara
tahanga	tahˈaŋa
unuhia	ˌu"nu"hˈia
kaitoro	ka͡ɪtˈɔrɔ
kēne	kˈeːne
Hone	hˈɔne
pangia	paŋˈia
oha	ˈɔha
tonoa	tɔnˈɔa
kaiwhakawa	kˌa͡ɪfakˈawa
Tētahi	teːtˈahi
Taonga	tˈa͡ʊŋa
Week	wˈeek
Hāunga	haːˈu"ŋa
purakau	pˌu"rakˈau"
Haina	hˈa͡ɪna
Kura	kˈu"ra
tarewa	tarˈewa
hoi	hˈo͡ɪ
kuku	kˈu"ku"
karamu	karˈamu"
kapene	kapˈene
mati	mˈati
tukuna	tu"kˈu"na
marau	marˈau"
Pōtitanga	pˌɔːtitˈaŋa
tumanakohia	tˌu"manˌakɔhˈia
kaiwhakaatu	kˌa͡ɪfakaˈatu"
whakaotia	fˌaka͡ʊtˈia
whawhati	fafˈati
In	ˈin
whakakotahi	fˌakakɔtˈahi
Rangatiratanga	rˌaŋatˌiratˈaŋa
whakairoiro	fˌaka͡ɪrˈo͡ɪrɔ
whakahokinga	fˌakahɔkˈiŋa
whaiāipo	fˌa͡ɪaːˈipɔ
kawai	kˈawa͡ɪ
uauatanga	ˌu"aˌu"atˈaŋa
Tirotiro	tˌirɔtˈirɔ
tāiri	taːˈiri
Rehunga	rehˈu"ŋa
tatou	tatˈou"
marena	marˈena
rekareka	rˌekarˈeka
karaipiture	kˌara͡ɪpitˈu"re
akoranga	ˌakɔrˈaŋa
mihingare	mˌihiŋˈare
Niho	nˈihɔ
whakamutunga	fˌakamu"tˈu"ŋa
tou	tˈou"
topuni	tɔpˈu"ni
Tetahi	tetˈahi
Our	ˈou"r
pōkākā	pɔːkˈaːkaː
Pīngao	pˈiːŋa͡ʊ
tiamana	tˌiamˈana
kuia	ku"ˈia
raupatu	rˌau"pˈatu"
tōpito	tɔːpˈitɔ
hihi	hˈihi
tohenga	tɔhˈeŋa
panuku	panˈu"ku"
ārahi	aːrˈahi
Waiorua	wˌa͡ɪɔrˈu"a
tīpune	tiːpˈu"ne
awe	ˈawe
ngō	ŋˈɔː
īmēra	iːmˈeːra
Raukawa	rˌau"kˈawa
whakatika	fˌakatˈika
Roa	rˈɔa
taitara	ta͡ɪtˈara
teenei	tˌeenˈei
tūturu	tu"ːtˈu"ru"
Arotake	ˌarɔtˈake
We	wˈe
tapaina	tapˈa͡ɪna
Naku	nˈaku"
potaka	pɔtˈaka
waro	wˈarɔ
tohutoro	tˌɔhu"tˈɔrɔ
wē	wˈeː
rīhi	rˈiːhi
tutū	tˈu"tu"ː
haina	hˈa͡ɪna
wiwi	wˈiwi
Āhua	aːhˈu"a
whakatūpatotanga	fˌakatˌu"ːpatɔtˈaŋa
kuri	kˈu"ri
hukapapa	hˌu"kapˈapa
rangitahi	rˌaŋitˈahi
raorao	rˈa͡ʊra͡ʊ
Nana	nˈana
mihinare	mˌihinˈare
haua	haˈu"a
aunoa	ˌau"nˈɔa
Taupō	taˈu"pɔː
kōhatu	kɔːhˈatu"
Mihingare	mˌihiŋˈare
NIR	nˈir
īmera	iːmˈera
pau	pˈau"
whakatautau	fˌakatˌau"tˈau"
huarere	hˌu"arˈere
teina	teˈina
tuakiritanga	tˌu"akˌiritˈaŋa
Pango	pˈaŋɔ
Pāwhiri	paːfˈiri
Uhia	u"hˈia
pōnānā	pɔːnˈaːnaː
Aperahama	ˌaperahˈama
Tira	tˈira
wā	wˈaː
moka	mˈɔka
ënei	enˈei
whakawaia	fˌakawˈa͡ɪa
whakaharahara	fˌakahˌarahˈara
tera	tˈera
tamariki	tˌamarˈiki
Mere	mˈere
Korimako	kˌɔrimˈakɔ
whakakaha	fˌakakˈaha
mauheretia	mˌau"hˌeretˈia
tauanga	tˌau"ˈaŋa
whakaatu	fˌakaˈatu"
hītori	hiːtˈɔri
Hakawau	hˌakawˈau"
Korowai	kɔrˈɔwa͡ɪ
manako	manˈakɔ
tatai	tˈata͡ɪ
Hawaiki	hawˈa͡ɪki
Kaiapoi	ka͡ɪˈapo͡ɪ
kāuta	kaːˈu"ta
tuuturu	tˌu"u"tˈu"ru"
ātārangi	ˌaːtaːrˈaŋi
Wehi	wˈehi
nāku	nˈaːku"
Wī	wˈiː
Airani	a͡ɪrˈani
puia	pu"ˈia
ira	ˈira
Ia	ˈia
koraha	kɔrˈaha
pēhanga	peːhˈaŋa
wehea	wehˈea
matawaka	mˌatawˈaka
kaitukumahi	kˌa͡ɪtu"ku"mˈahi
ripanga	ripˈaŋa
awhina	afˈina
homai	hˈɔma͡ɪ
arotake	ˌarɔtˈake
kapiheihana	kˌapihˌeihˈana
Pirihimana	pˌirihimˈana
whakamaru	fˌakamˈaru"
whakataurite	fˌakatˌau"rˈite
pīkau	piːkˈau"
Raukura	rˌau"kˈu"ra
irāmutu	ˌiraːmˈu"tu"
Nuku	nˈu"ku"
whakahekea	fˌakahekˈea
tewhatewha	tˌefatˈefa
horonga	hɔrˈɔŋa
Whakatauiratia	fˌakatˌau"ˌiratˈia
Puketapu	pˌu"ketˈapu"
Tīmata	tiːmˈata
Whanga	fˈaŋa
whakarōpūtanga	fˌakarˌɔːpu"ːtˈaŋa
tahua	tahˈu"a
tiria	tirˈia
ta	tˈa
rangahaua	rˌaŋahaˈu"a
tāpaea	taːpˈa͡ɪa
tai	tˈa͡ɪ
Pounamu	pˌou"nˈamu"
hahi	hˈahi
itiiti	ˌitiˈiti
whakatupuria	fˌakatˌu"pu"rˈia
herenga	herˈeŋa
roopu	rɔˈɔpu"
māhita	maːhˈita
kākano	kaːkˈanɔ
āpōpō	aːpˈɔːpɔː
tapa	tˈapa
ōritetanga	ˌɔːritetˈaŋa
harikoa	hˌarikˈɔa
namata	namˈata
mara	mˈara
kaitoi	kˈa͡ɪto͡ɪ
kōpae	kˈɔːpa͡ɪ
aahua	ˌaahˈu"a
whakaatangia	fˌakaˌataŋˈia
ngawhere	ŋafˈere
hīnau	hiːnˈau"
Awanui	ˌawanˈu"i
Pirimia	pˌirimˈia
Wairarapa	wˌa͡ɪrarˈapa
whakaturia	fˌakatu"rˈia
ārai	ˈaːra͡ɪ
Waahi	waˈahi
One	ˈɔne
whakairo	fakˈa͡ɪrɔ
kaa	kˈaa
rerekētanga	rˌerekeːtˈaŋa
waireka	wa͡ɪrˈeka
Kingi	kˈiŋi
māti	mˈaːti
Rahi	rˈahi
huruhuru	hˌu"ru"hˈu"ru"
kōrero	kˈɔːrerˌɔ
heru	hˈeru"
wahanga	wahˈaŋa
turia	tu"rˈia
mātātoa	mˌaːtaːtˈɔa
rēhitatanga	rˌeːhitatˈaŋa
pātuhi	paːtˈu"hi
Whakairia	fˌaka͡ɪrˈia
Arā	ˈaraː
huinga	hu"ˈiŋa
Koutu	koˈu"tu"
MMP	mmp
tawhiti	tafˈiti
matū	mˈatu"ː
pātahi	paːtˈahi
whaihua	fa͡ɪhˈu"a
whakatuu	fˌakatˈu"u"
Hoi	hˈo͡ɪ
urungi	u"rˈu"ŋi
karakara	kˌarakˈara
tiro	tˈirɔ
Whakarapa	fˌakarˈapa
anga	ˈaŋa
tauria	tˌau"rˈia
porowhita	pˌɔrɔfˈita
tahuna	tahˈu"na
Patea	patˈea
tāra	tˈaːra
hika	hˈika
kaki	kˈaki
Part	pˈart
Hōnore	hɔːnˈɔre
rerekē	rerˈekeː
Wiremu	wirˈemu"
whāriki	faːrˈiki
kekeno	kekˈenɔ
whaihanga	fa͡ɪhˈaŋa
tūmahi	tu"ːmˈahi
huakina	hˌu"akˈina
Tītokowaru	tˌiːtɔkɔwˈaru"
whakarewahia	fˌakarˌewahˈia
putaputa	pˌu"tapˈu"ta
moenga	mwˈeŋa
Pōtiki	pɔːtˈiki
nohonga	nɔhˈɔŋa
Roera	rwˈera
tau	tˈau"
Tuwhakairiora	tˌu"fakˌa͡ɪriˈɔra
Wahi	wˈahi
Herangi	herˈaŋi
kohinga	kɔhˈiŋa
waiariki	wˌa͡ɪarˈiki
wira	wˈira
Iāri	iˈaːri
Teira	teˈira
whakaiti	fakˈa͡ɪti
marara	marˈara
whakamatauria	fˌakamˌatau"rˈia
Punarua	pˌu"narˈu"a
whakahihiri	fˌakahihˈiri
tīpako	tiːpˈakɔ
pane	pˈane
Katorika	kˌatɔrˈika
pakitara	pˌakitˈara
Uira	u"ˈira
Onehunga	ˌɔnehˈu"ŋa
mawhiti	mafˈiti
taraiwa	tarˈa͡ɪwa
tunga	tˈu"ŋa
Itāriana	ˌitaːriˈana
Tuhoro	tu"hˈɔrɔ
rapua	rapˈu"a
Tukuna	tu"kˈu"na
rahaki	rahˈaki
Tapuwae	tapˈu"wa͡ɪ
Whakanui	fˌakanˈu"i
Mai	mˈa͡ɪ
puninga	pu"nˈiŋa
kōhanga	kɔːhˈaŋa
uira	u"ˈira
tirotirohanga	tˌirɔtˌirɔhˈaŋa
karihi	karˈihi
Maoritanga	mˌa͡ʊritˈaŋa
whakatakotoranga	fˌakatˌakɔtɔrˈaŋa
hononga	hɔnˈɔŋa
Ana	ˈana
Nathan	nˈathan
Honoa	hɔnˈɔa
kuhunga	ku"hˈu"ŋa
tawatawa	tˌawatˈawa
pōhiri	pɔːhˈiri
Āwhinatia	ˌaːfinatˈia
Henrietta	hˌenriˈetta
whakawhānuihia	fˌakafˌaːnu"ihˈia
koka	kˈɔka
pēke	pˈeːke
Toia	tˈo͡ɪa
marangai	marˈaŋa͡ɪ
Tūhuratia	tˌu"ːhu"ratˈia
Waihangatia	wˌa͡ɪhaŋatˈia
hohou	hɔhˈou"
awhi	ˈafi
kōhari	kɔːhˈari
Awatere	ˌawatˈere
tātua	taːtˈu"a
Karakia	kˌarakˈia
Emepaea	ˌemepˈa͡ɪa
tūwhera	tu"ːfˈera
Ehara	ehˈara
Taraia	tarˈa͡ɪa
Maaui	mˌaaˈu"i
Koina	kˈo͡ɪna
Tāwhai	tˈaːfa͡ɪ
Mēnā	mˈeːnaː
ketia	ketˈia
uru	ˈu"ru"
ruri	rˈu"ri
pani	pˈani
matatapu	mˌatatˈapu"
Korowaitanga	kˌɔrɔwa͡ɪtˈaŋa
kuhuna	ku"hˈu"na
weka	wˈeka
papai	pˈapa͡ɪ
ai	ˈa͡ɪ
hōtoke	hɔːtˈɔke
tomo	tˈɔmɔ
kōtuitui	kˌɔːtu"itˈu"i
Whangaparaoa	fˌaŋaparˈa͡ʊa
O	ˈɔ
tirohanga	tˌirɔhˈaŋa
Pitiroi	pitˈiro͡ɪ
kaitiakitanga	kˌa͡ɪtiˌakitˈaŋa
kauwhata	kˌau"fˈata
taipakeke	tˌa͡ɪpakˈeke
Wikitōria	wˌikitɔːrˈia
mārire	maːrˈire
pērā	pˈeːraː
ahuwhenua	ˌahu"fenˈu"a
Pātai	pˈaːta͡ɪ
huanga	hu"ˈaŋa
kanorau	kˌanɔrˈau"
whakanikoniko	fˌakanˌikɔnˈikɔ
matakitaki	mˌatakitˈaki
mata	mˈata
W	w
Kāpene	kaːpˈene
kauneke	kˌau"nˈeke
MāoriHe	maːˈɔrihˈe
Ngāwai	ŋˈaːwa͡ɪ
miriona	mˌiriˈɔna
porihanga	pˌɔrihˈaŋa
pikitanga	pˌikitˈaŋa
Kaikoura	kˌa͡ɪkoˈu"ra
Hahi	hˈahi
utu	ˈu"tu"
Ngati	ŋˈati
Taitokerau	tˌa͡ɪtɔkerˈau"
takahurihuri	tˌakahˌu"rihˈu"ri
Horo	hˈɔrɔ
ngawha	ŋˈafa
tikina	tikˈina
whakarereketanga	fˌakarˌereketˈaŋa
whakamā	fakˈamaː
pākete	paːkˈete
iraoho	irˈa͡ʊhɔ
āporo	aːpˈɔrɔ
whiringa	firˈiŋa
oneone	ˌɔneˈɔne
whakapaoho	fˌakapˈa͡ʊhɔ
rīriri	riːrˈiri
Rumaki	ru"mˈaki
tohumate	tˌɔhu"mˈate
Hotunui	hˌɔtu"nˈu"i
umanga	u"mˈaŋa
poroa	pɔrˈɔa
Karihi	karˈihi
Manatū	manˈatu"ː
MāoriTe	maːˈɔritˈe
takuhe	takˈu"he
Māhuri	maːhˈu"ri
Kunenga	ku"nˈeŋa
Rangitāke	rˌaŋitˈaːke
hoa	hˈɔa
teitei	tˌeitˈei
Mo	mˈɔ
Moriori	mˌɔriˈɔri
Tikipunga	tˌikipˈu"ŋa
hoko	hˈɔkɔ
hamumu	hamˈu"mu"
taumahi	tˌau"mˈahi
Nawai	nˈawa͡ɪ
Ina	ˈina
Mango	mˈaŋɔ
tarāwaho	tˌaraːwˈahɔ
Ipukarea	ˌipu"karˈea
tangihia	tˌaŋihˈia
parekura	pˌarekˈu"ra
hangi	hˈaŋi
rangimārie	rˌaŋimaːrˈie
tāhuna	taːhˈu"na
Whata	fˈata
haeretia	hˌa͡ɪretˈia
kaitiaki	kˌa͡ɪtiˈaki
motuka	mɔtˈu"ka
hohonu	hɔhˈɔnu"
Paki	pˈaki
Mīharo	miːhˈarɔ
pāpori	paːpˈɔri
Hika	hˈika
tīkiti	tiːkˈiti
tātaitanga	tˌaːta͡ɪtˈaŋa
Panoni	panˈɔni
haere	hˈa͡ɪre
patuki	patˈu"ki
watea	watˈea
whaea	fˈa͡ɪa
tutakina	tˌu"takˈina
tito	tˈitɔ
E	ˈe
roha	rˈɔha
mamae	mˈama͡ɪ
Aratakina	ˌaratakˈina
tukatuka	tˌu"katˈu"ka
porohita	pˌɔrɔhˈita
ngoto	ŋˈɔtɔ
whakahoki	fˌakahˈɔki
Hēmi	hˈeːmi
whāngai	fˈaːŋa͡ɪ
Manaia	manˈa͡ɪa
poutokomanawa	pˌou"tˌɔkɔmanˈawa
pūkeko	pu"ːkˈekɔ
turakina	tˌu"rakˈina
taurua	tˌau"rˈu"a
Marangai	marˈaŋa͡ɪ
hauota	hˌau"ˈɔta
kōpū	kˈɔːpu"ː
hōpua	hɔːpˈu"a
piri	pˈiri
Rārangi	raːrˈaŋi
taenga	tˈa͡ɪŋa
Papatūānuku	pˌapatˌu"ːaːnˈu"ku"
humarie	hˌu"marˈie
maihi	mˈa͡ɪhi
peha	pˈeha
whakatūwhera	fˌakatu"ːfˈera
paparau	pˌaparˈau"
kaihanga	ka͡ɪhˈaŋa
Pihinga	pihˈiŋa
ena	ˈena
pera	pˈera
nōu	nˈɔːu"
Poto	pˈɔtɔ
paerewa	pa͡ɪrˈewa
Tangihanga	tˌaŋihˈaŋa
Harakeke	hˌarakˈeke
mātau	maːtˈau"
muru	mˈu"ru"
wahapu	wahˈapu"
ïnanga	inˈaŋa
keke	kˈeke
Tūhurahia	tˌu"ːhu"rahˈia
Rangihiroa	rˌaŋihirˈɔa
whakatakotohia	fˌakatˌakɔtɔhˈia
ariā	arˈiaː
tarutaru	tˌaru"tˈaru"
kaiuru	ka͡ɪˈu"ru"
Upoko	u"pˈɔkɔ
Aromātai	ˌarɔmˈaːta͡ɪ
kaitaunaki	kˌa͡ɪtau"nˈaki
moroiti	mɔrˈo͡ɪti
ara	ˈara
Tāpiritia	tˌaːpiritˈia
Kerei	kerˈei
whanonga	fanˈɔŋa
whakatītina	fˌakatiːtˈina
Roto	rˈɔtɔ
aata	aˈata
rūmaki	ru"ːmˈaki
Pōkeka	pɔːkˈeka
kōhure	kɔːhˈu"re
ngarahu	ŋarˈahu"
nā	nˈaː
hao	hˈa͡ʊ
kaupapa	kˌau"pˈapa
whakahaua	fˌakahaˈu"a
Hune	hˈu"ne
tūmatanui	tˌu"ːmatanˈu"i
uta	ˈu"ta
Nōu	nˈɔːu"
Pa	pˈa
Kōkiri	kɔːkˈiri
tuhituhi	tˌu"hitˈu"hi
ratonga	ratˈɔŋa
kāwanatanga	kˌaːwanatˈaŋa
māharahara	mˌaːharahˈara
Tikina	tikˈina
nōku	nˈɔːku"
haratau	hˌaratˈau"
tamatāne	tˌamatˈaːne
kārangaranga	kˌaːraŋarˈaŋa
whakawehe	fˌakawˈehe
Paipera	pa͡ɪpˈera
Kuaka	ku"ˈaka
paheko	pahˈekɔ
hora	hˈɔra
Kore	kˈɔre
memeha	memˈeha
enei	enˈei
whakamāmā	fˌakamˈaːmaː
ōpaki	ɔːpˈaki
Taku	tˈaku"
tauwhitiwhiti	tˌau"fˌitifˈiti
oro	ˈɔrɔ
makau	makˈau"
Tuia	tu"ˈia
moana	mɔˈana
äkonga	akˈɔŋa
Māehe	maːˈehe
pirau	pirˈau"
kōnui	kɔːnˈu"i
pehia	pehˈia
Huirapa	hˌu"irˈapa
Nu	nˈu"
werawera	wˌerawˈera
hauā	haˈu"aː
anōtia	ˌanɔːtˈia
kokowai	kɔkˈɔwa͡ɪ
putake	pu"tˈake
whakaae	fakˈaa͡ɪ
Whakairo	fakˈa͡ɪrɔ
Kawenata	kˌawenˈata
raparapa	rˌaparˈapa
pūkana	pu"ːkˈana
tapawha	tapˈafa
tēpu	tˈeːpu"
nahanaha	nˌahanˈaha
Whaea	fˈa͡ɪa
tohorā	tɔhˈɔraː
mohoa	mɔhˈɔa
paetae	pˈa͡ɪta͡ɪ
whakawhitiwhitinga	fˌakafˌitifitˈiŋa
tūpato	tu"ːpˈatɔ
Huhuti	hu"hˈu"ti
miere	miˈere
maipi	mˈa͡ɪpi
Kaiako	ka͡ɪˈakɔ
tauāki	tˌau"ˈaːki
pāwhiri	paːfˈiri
Āhuahanga	ˌaːhu"ahˈaŋa
Tahi	tˈahi
poitūkohu	pˌo͡ɪtu"ːkˈɔhu"
pakeha	pakˈeha
kōkiritia	kˌɔːkiritˈia
ko	kˈɔ
Tono	tˈɔnɔ
Moutere	mˌou"tˈere
hoihoi	hˈo͡ɪho͡ɪ
whakatapua	fˌakatapˈu"a
Aoniwaho	ˌa͡ʊniwˈahɔ
Kāwhia	kaːfˈia
Kaikohe	ka͡ɪkˈɔhe
nūpepa	nu"ːpˈepa
tōku	tˈɔːku"
Rongoā	rɔŋˈɔaː
ngāwari	ŋaːwˈari
unahi	u"nˈahi
kuaha	ku"ˈaha
Wāwāhi	waːwˈaːhi
maringi	marˈiŋi
kirikiri	kˌirikˈiri
Tuhia	tu"hˈia
māraurau	mˌaːrau"rˈau"
kōhinu	kɔːhˈinu"
Tairawhiti	tˌa͡ɪrafˈiti
kia	kˈia
whakarewa	fˌakarˈewa
maiangi	ma͡ɪˈaŋi
Marautanga	mˌarau"tˈaŋa
tuunga	tu"ˈu"ŋa
Ngāmotu	ŋaːmˈɔtu"
Whakaputanga	fˌakapu"tˈaŋa
kararehe	kˌararˈehe
tetehi	tetˈehi
pepeha	pepˈeha
taputapu	tˌapu"tˈapu"
Ō	ˈɔː
Pēke	pˈeːke
whakaaroaro	fˌakaˌarɔˈarɔ
Whakamāramatia	fˌakamˌaːramatˈia
pūtoru	pu"ːtˈɔru"
taumahatanga	tˌau"mˌahatˈaŋa
kiato	kiˈatɔ
wero	wˈerɔ
rehurehu	rˌehu"rˈehu"
haupapa	hˌau"pˈapa
rikarika	rˌikarˈika
whakamāoritia	fˌakamˌaːɔritˈia
porangi	pɔrˈaŋi
toa	tˈɔa
whakamanamana	fˌakamˌanamˈana
pāhotia	pˌaːhɔtˈia
kairangahau	kˌa͡ɪraŋahˈau"
kuhua	ku"hˈu"a
raima	rˈa͡ɪma
paura	paˈu"ra
tautokona	tˌau"tɔkˈɔna
Ara	ˈara
matapaki	mˌatapˈaki
pūare	pu"ːˈare
rānei	raːnˈei
whaanau	fˌaanˈau"
Koia	kˈo͡ɪa
Tawhaki	tafˈaki
tīpakohia	tˌiːpakɔhˈia
whakatahi	fˌakatˈahi
whangai	fˈaŋa͡ɪ
kongakonga	kˌɔŋakˈɔŋa
pō	pˈɔː
haoa	hˈa͡ʊa
tāone	taːˈɔne
panaia	panˈa͡ɪa
whakatūranga	fˌakatu"ːrˈaŋa
harakoa	hˌarakˈɔa
whakaarahia	fˌakaˌarahˈia
tahaki	tahˈaki
tuākana	tˌu"aːkˈana
Ko	kˈɔ
Kawa	kˈawa
koinei	ko͡ɪnˈei
Āpirana	ˌaːpirˈana
kohua	kɔhˈu"a
whanaunga	fˌanaˈu"ŋa
ākene	aːkˈene
ahuatanga	ˌahu"atˈaŋa
tene	tˈene
akau	akˈau"
Kuki	kˈu"ki
urunga	u"rˈu"ŋa
whakahaere	fˌakahˈa͡ɪre
akonga	akˈɔŋa
wehewehe	wˌehewˈehe
Āhia	aːhˈia
oi	ˈo͡ɪ
nohanga	nɔhˈaŋa
kaihoe	kˈa͡ɪhwe
kauwae	kaˈu"wa͡ɪ
inaianei	ˌina͡ɪanˈei
tōmua	tɔːmˈu"a
whakawhanaunga	fˌakafˌanaˈu"ŋa
Hou	hˈou"
tāutuhia	tˌaːu"tu"hˈia
Rongo	rˈɔŋɔ
Two	twˈɔ
torutoru	tˌɔru"tˈɔru"
Ka	kˈa
tīmataria	tˌiːmatarˈia
wetereo	wˌeterˈeɔ
rori	rˈɔri
Pehea	pehˈea
Kaporeihana	kˌapɔrˌeihˈana
Whaanga	faˈaŋa
Tekau	tekˈau"
hoehoe	hwˈehwe
tūrama	tu"ːrˈama
Rangitaiki	rˌaŋitˈa͡ɪki
Waiho	wˈa͡ɪhɔ
whakararu	fˌakarˈaru"
Whakarōpūhia	fˌakarˌɔːpu"ːhˈia
rawa	rˈawa
unu	ˈu"nu"
Mahere	mahˈere
Rāhiri	raːhˈiri
raraunga	rˌaraˈu"ŋa
whakawakia	fˌakawakˈia
arumoni	ˌaru"mˈɔni
Kohimarama	kˌɔhimarˈama
Whakatō	fakˈatɔː
Rarotonga	rˌarɔtˈɔŋa
Karere	karˈere
whakaorangia	fˌaka͡ʊraŋˈia
totohe	tɔtˈɔhe
paua	paˈu"a
titaha	titˈaha
mangu	mˈaŋu"
titikaha	tˌitikˈaha
Hutt	hˈu"tt
weherua	wˌeherˈu"a
kano	kˈanɔ
print	prˈint
pōtitia	pˌɔːtitˈia
Tamure	tamˈu"re
Pū	pˈu"ː
kuhu	kˈu"hu"
tumau	tu"mˈau"
whakaruruhau	fˌakarˌu"ru"hˈau"
whakahaeretanga	fˌakahˌa͡ɪretˈaŋa
Rāhoroi	raːhˈɔro͡ɪ
pātene	paːtˈene
ratou	ratˈou"
Rāwiri	raːwˈiri
TMoA	tmˈɔˈa
takina	takˈina
Tūmatauenga	tˌu"ːmatˌau"ˈeŋa
aratohu	ˌaratˈɔhu"
tapatapahi	tˌapatapˈahi
iri	ˈiri
Women	wˈɔmen
aia	ˈa͡ɪa
weroa	werˈɔa
awhinatia	ˌafinatˈia
Whaia	fˈa͡ɪa
tūhuratanga	tˌu"ːhu"ratˈaŋa
whakawhanaketia	fˌakafˌanaketˈia
Kati	kˈati
ripoata	rˌipɔˈata
Tianara	tˌianˈara
Marangaranga	mˌaraŋarˈaŋa
whakahaerea	fˌakaha͡ɪrˈea
Whai	fˈa͡ɪ
Itāria	ˌitaːrˈia
whakawhānau	fˌakafaːnˈau"
Tokowhā	tɔkˈɔfaː
whitiki	fitˈiki
tautohua	tˌau"tɔhˈu"a
hiku	hˈiku"
tāpui	taːpˈu"i
ruarua	rˌu"arˈu"a
kohuru	kɔhˈu"ru"
Wiwi	wˈiwi
uwha	ˈu"fa
Kahawai	kahˈawa͡ɪ
wharenui	fˌarenˈu"i
maioro	ma͡ɪˈɔrɔ
Ūpoko	u"ːpˈɔkɔ
Ratonga	ratˈɔŋa
whēnā	fˈeːnaː
rangatahi	rˌaŋatˈahi
hapuu	hapˈu"u"
Whiriwhiria	fˌirifirˈia
Mahuta	mahˈu"ta
tōnā	tˈɔːnaː
pūtohu	pu"ːtˈɔhu"
moe	mwˈe
taramea	tˌaramˈea
whakatikanga	fˌakatikˈaŋa
hē	hˈeː
Whakamāramahia	fˌakamˌaːramahˈia
urupā	uɹˈupaː
Karaiti	karˈa͡ɪti
koeke	kwˈeke
whakamōmona	fˌakamɔːmˈɔna
whakangao	fakˈaŋa͡ʊ
tāruatanga	tˌaːru"atˈaŋa
utanga	u"tˈaŋa
Hapori	hapˈɔri
tātaihia	tˌaːta͡ɪhˈia
Ariki	arˈiki
kukume	ku"kˈu"me
wāwāhi	waːwˈaːhi
Ahau	ahˈau"
tunu	tˈu"nu"
taketake	tˌaketˈake
paiheneti	pˌa͡ɪhenˈeti
kairūri	ka͡ɪrˈu"ːri
kaiurungi	kˌa͡ɪu"rˈu"ŋi
Ārai	ˈaːra͡ɪ
piritahi	pˌiritˈahi
whata	fˈata
haramai	harˈama͡ɪ
Wharekauri	fˌarekaˈu"ri
whakatepe	fˌakatˈepe
tūmomo	tu"ːmˈɔmɔ
pakipūmeka	pˌakipu"ːmˈeka
tātaritanga	tˌaːtaritˈaŋa
pūtoro	pu"ːtˈɔrɔ
paa	pˈaa
Runtime	ru"ntˈime
wairākau	wˌa͡ɪraːkˈau"
tukinga	tu"kˈiŋa
Maramataka	mˌaramatˈaka
uiui	ˌu"iˈu"i
pire	pˈire
Kororāreka	kˌɔrɔraːrˈeka
taihoa	ta͡ɪhˈɔa
mare	mˈare
whakamate	fˌakamˈate
waitohua	wˌa͡ɪtɔhˈu"a
Rangimarie	rˌaŋimarˈie
Mihi	mˈihi
Rona	rˈɔna
arawhata	ˌarafˈata
tia	tˈia
pukumahi	pˌu"ku"mˈahi
pōwhiritia	pˌɔːfiritˈia
raupapahia	rˌau"pˌapahˈia
pango	pˈaŋɔ
Motu	mˈɔtu"
ure	ˈu"re
teenaa	tˌeenˈaa
rūnanga	ru"ːnˈaŋa
hiraka	hirˈaka
M	m
witi	wˈiti
tāruke	taːrˈu"ke
tui	tˈu"i
haumarutanga	hˌau"mˌaru"tˈaŋa
matapakihia	mˌatapˌakihˈia
Waipounamu	wˌa͡ɪpou"nˈamu"
Tohutohu	tˌɔhu"tˈɔhu"
tārewa	taːrˈewa
wawatatia	wˌawatatˈia
Rāpare	raːpˈare
Mauao	maˈu"a͡ʊ
Ōpōtiki	ˌɔːpɔːtˈiki
Pae	pˈa͡ɪ
Hare	hˈare
Hohepa	hɔhˈepa
Whakaaturanga	fˌakaˌatu"rˈaŋa
wä	wˈa
Ötautahi	ˌɔtau"tˈahi
whakarua	fˌakarˈu"a
tūkino	tu"ːkˈinɔ
Wēteriana	wˌeːteriˈana
parepare	pˌarepˈare
Pātaka	paːtˈaka
Pumi	pˈu"mi
pine	pˈine
Hautanga	hˌau"tˈaŋa
Kahore	kahˈɔre
tautoko	tˌau"tˈɔkɔ
into	ˈintɔ
tungāne	tu"ŋˈaːne
āwhio	aːfˈiɔ
Whakahau	fˌakahˈau"
Pare	pˈare
Eke	ˈeke
Ine	ˈine
Rīpeka	riːpˈeka
kitenga	kitˈeŋa
Whakaruruhau	fˌakarˌu"ru"hˈau"
papatau	pˌapatˈau"
whakatuwhera	fˌakatu"fˈera
whänui	fanˈu"i
mahuetanga	mˌahu"etˈaŋa
Whenuanui	fˌenu"anˈu"i
Huringa	hu"rˈiŋa
amotai	amˈɔta͡ɪ
meatia	mˌeatˈia
hono	hˈɔnɔ
Kai	kˈa͡ɪ
Aoraki	a͡ʊrˈaki
wehenga	wehˈeŋa
Pērā	pˈeːraː
kiihia	kˌiihˈia
Hinerangi	hˌinerˈaŋi
whakapānga	fˌakapˈaːŋa
anake	anˈake
whakakorehia	fˌakakˌɔrehˈia
rekereke	rˌekerˈeke
koki	kˈɔki
White	fˈite
whiwhia	fifˈia
awa	ˈawa
āio	aːˈiɔ
āwhina	aːfˈina
mene	mˈene
Kāo	kˈaːɔ
rōpū	rˈɔːpu"ː
torea	tɔrˈea
wheako	feˈakɔ
mapu	mˈapu"
tupono	tu"pˈɔnɔ
Waitaha	wa͡ɪtˈaha
rapuhia	rˌapu"hˈia
ngä	ŋˈa
Kohanga	kɔhˈaŋa
Kereone	kˌereˈɔne
pütaiao	pu"tˈa͡ɪa͡ʊ
Kiwi	kˈiwi
Wahanga	wahˈaŋa
Tireni	tirˈeni
kōrerotia	kˌɔːrerɔtˈia
Rarawa	rarˈawa
whakawehea	fˌakawehˈea
Mt	mt
konei	kɔnˈei
kīwaha	kiːwˈaha
Kete	kˈete
tote	tˈɔte
inenga	inˈeŋa
mōkai	mˈɔːka͡ɪ
āki	ˈaːki
Pire	pˈire
tukuruatia	tˌu"ku"rˌu"atˈia
rongonui	rˌɔŋɔnˈu"i
tuke	tˈu"ke
rano	rˈanɔ
oti	ˈɔti
hohoko	hɔhˈɔkɔ
noo	nˈɔɔ
pumau	pu"mˈau"
kei	kˈei
kapo	kˈapɔ
Mauria	mˌau"rˈia
whānautanga	fˌaːnau"tˈaŋa
tauā	taˈu"aː
Team	tˈeam
Homai	hˈɔma͡ɪ
whakaari	fˌakaˈari
Tāia	taːˈia
ngātahitia	ŋˌaːtahitˈia
Inea	inˈea
whakaniko	fˌakanˈikɔ
ngāhau	ŋaːhˈau"
kōrerotanga	kˌɔːrerɔtˈaŋa
kuaore	ku"ˈa͡ʊre
kāre	kˈaːre
Kaumātua	kˌau"maːtˈu"a
whakanao	fakˈana͡ʊ
tūtohi	tu"ːtˈɔhi
tapuhi	tapˈu"hi
tapahanga	tˌapahˈaŋa
whika	fˈika
rongoa	rɔŋˈɔa
pana	pˈana
paanga	paˈaŋa
Iwikau	ˌiwikˈau"
pahikara	pˌahikˈara
tuatahitia	tˌu"atˌahitˈia
tuahine	tˌu"ahˈine
Matewhawhati	mˌatefafˈati
Henare	henˈare
Nama	nˈama
poke	pˈɔke
taukumekume	tˌau"kˌu"mekˈu"me
Maketū	makˈetu"ː
Tiati	tiˈati
Karauna	kˌaraˈu"na
whakapūmautanga	fˌakapˌu"ːmau"tˈaŋa
Tauiwi	tˌau"ˈiwi
Rehua	rehˈu"a
raranga	rarˈaŋa
kūhuka	ku"ːhˈu"ka
hākona	haːkˈɔna
whaimana	fa͡ɪmˈana
tamarikitanga	tˌamarˌikitˈaŋa
taiaki	ta͡ɪˈaki
Amohau	ˌamɔhˈau"
waho	wˈahɔ
kōpura	kɔːpˈu"ra
m	m
takinga	takˈiŋa
hoha	hˈɔha
wheua	feˈu"a
kaiwhakaora	kˌa͡ɪfakˈa͡ʊra
tuarongo	tˌu"arˈɔŋɔ
whakamoe	fakˈamwe
at	ˈat
na	nˈa
Turanganui	tˌu"raŋanˈu"i
tāutu	taːˈu"tu"
papa	pˈapa
kowhatu	kɔfˈatu"
mama	mˈama
tumeke	tu"mˈeke
NA	nˈa
tika	tˈika
onāianei	ˌɔnaːˌianˈei
Wi	wˈi
hautū	haˈu"tu"ː
Hepetema	hˌepetˈema
whakatū	fakˈatu"ː
Kapiti	kapˈiti
mokomoko	mˌɔkɔmˈɔkɔ
hōtera	hɔːtˈera
Tokomaru	tˌɔkɔmˈaru"
Ōpango	ɔːpˈaŋɔ
Kaore	kˈa͡ʊre
Taumarere	tˌau"marˈere
takenga	takˈeŋa
tea	tˈea
ngakinga	ŋakˈiŋa
whakakīa	fˌakakˈiːa
Rima	rˈima
āe	ˈaːe
kao	kˈa͡ʊ
Kererū	kerˈeru"ː
Wāhi	wˈaːhi
roroa	rɔrˈɔa
Ngahue	ŋahˈu"e
Wātene	waːtˈene
kokonga	kɔkˈɔŋa
tiaho	tiˈahɔ
whārangi	faːrˈaŋi
Haane	haˈane
mē	mˈeː
mauhere	mˌau"hˈere
hipi	hˈipi
pereti	perˈeti
ngohi	ŋˈɔhi
Ihipa	ihˈipa
mātārere	mˌaːtaːrˈere
Moerewa	mwerˈewa
koa	kˈɔa
pēneitia	pˌeːneitˈia
Tamaki	tamˈaki
kāpehu	kaːpˈehu"
papaku	papˈaku"
kāta	kˈaːta
uiuia	ˌu"iu"ˈia
mangere	maŋˈere
Puke	pˈu"ke
papatahi	pˌapatˈahi
whakaakoranga	fˌakaˌakɔrˈaŋa
Tohua	tɔhˈu"a
kauhanga	kˌau"hˈaŋa
Whakatakotoria	fˌakatˌakɔtɔrˈia
whakapaitanga	fˌakapa͡ɪtˈaŋa
whāinga	faːˈiŋa
whakarauoratanga	fˌakarˌau"ˌɔratˈaŋa
Mete	mˈete
Kā	kˈaː
maru	mˈaru"
Hemi	hˈemi
Tirani	tirˈani
aromatawaihia	ˌarɔmˌatawa͡ɪhˈia
peeke	peˈeke
Kauaka	kˌau"ˈaka
Pānuihia	pˌaːnu"ihˈia
Po	pˈɔ
Rawa	rˈawa
Takiwa	takˈiwa
tipu	tˈipu"
Hunia	hu"nˈia
arohaina	ˌarɔhˈa͡ɪna
kaitātaki	kˌa͡ɪtaːtˈaki
hanganga	haŋˈaŋa
Putumōhio	pˌu"tu"mɔːhˈiɔ
tënei	tenˈei
tahuri	tahˈu"ri
märama	marˈama
Tōku	tˈɔːku"
karaka	karˈaka
hōngere	hɔːŋˈere
Tauihu	tˌau"ˈihu"
huihui	hˌu"ihˈu"i
hohonutanga	hˌɔhɔnu"tˈaŋa
Ahuriri	ˌahu"rˈiri
Kātahi	kaːtˈahi
inihua	ˌinihˈu"a
kea	kˈea
aitanga	a͡ɪtˈaŋa
Tiakina	tˌiakˈina
kāwana	kaːwˈana
whakahīhī	fˌakahˈiːhiː
Kokiri	kɔkˈiri
heria	herˈia
raweketia	rˌaweketˈia
kaiarataki	kˌa͡ɪaratˈaki
ōrite	ɔːrˈite
kauhoe	kaˈu"hwe
Pōmare	pɔːmˈare
Tātaihia	tˌaːta͡ɪhˈia
kanga	kˈaŋa
Kua	kˈu"a
pokapū	pɔkˈapu"ː
Pouherenga	pˌou"herˈeŋa
rehita	rehˈita
whitu	fˈitu"
nanao	nˈana͡ʊ
mauri	maˈu"ri
Kāti	kˈaːti
kīnaki	kiːnˈaki
Pēwhairangi	pˌeːfa͡ɪrˈaŋi
Ahu	ˈahu"
tauaki	tˌau"ˈaki
Whakarawea	fˌakarawˈea
Tamariki	tˌamarˈiki
kaitito	ka͡ɪtˈitɔ
tūmanakohia	tˌu"ːmanˌakɔhˈia
tāraia	taːrˈa͡ɪa
whakamaramatia	fˌakamˌaramatˈia
reri	rˈeri
haurongo	hˌau"rˈɔŋɔ
whakatinana	fˌakatinˈana
toha	tˈɔha
whakapiki	fˌakapˈiki
Tokohia	tˌɔkɔhˈia
nuka	nˈu"ka
kapiti	kapˈiti
rohenga	rɔhˈeŋa
rauropi	rˌau"rˈɔpi
huia	hu"ˈia
anahe	anˈahe
raau	raˈau"
whakataukī	fˌakataˈu"kiː
whakatūnga	fˌakatˈu"ːŋa
hinganga	hiŋˈaŋa
herehere	hˌerehˈere
tōkeke	tɔːkˈeke
manapori	mˌanapˈɔri
kaua	kaˈu"a
Manaakitanga	mˌanaˌakitˈaŋa
Rangahaua	rˌaŋahaˈu"a
hikoi	hˈiko͡ɪ
auē	aˈu"eː
horoi	hˈɔro͡ɪ
h	h
Ngawai	ŋˈawa͡ɪ
putu	pˈu"tu"
pūwāhi	pu"ːwˈaːhi
rahi	rˈahi
H	h
whakaahuatia	fˌakaˌahu"atˈia
oona	ɔˈɔna
tauhou	tˌau"hˈou"
Kōhure	kɔːhˈu"re
pata	pˈata
Mōhio	mɔːhˈiɔ
Kēnana	keːnˈana
mangai	mˈaŋa͡ɪ
whakamaharatanga	fˌakamˌaharatˈaŋa
Moeraki	mwerˈaki
whakatauranga	fˌakatˌau"rˈaŋa
pīpīwai	piːpˈiːwa͡ɪ
Whakatauritea	fˌakatˌau"ritˈea
whatitiri	fˌatitˈiri
whakatuwheratia	fˌakatˌu"feratˈia
hinga	hˈiŋa
whakangā	fakˈaŋaː
Whaitiri	fa͡ɪtˈiri
whakawhitinga	fˌakafitˈiŋa
whakamarumaru	fˌakamˌaru"mˈaru"
whakarau	fˌakarˈau"
ahi	ˈahi
Whakahaere	fˌakahˈa͡ɪre
tikitiki	tˌikitˈiki
whaitake	fa͡ɪtˈake
other	ˈɔther
rereketanga	rˌereketˈaŋa
marere	marˈere
koronga	kɔrˈɔŋa
waihanga	wa͡ɪhˈaŋa
whakawhanaketanga	fˌakafˌanaketˈaŋa
whero	fˈerɔ
tangi	tˈaŋi
aruhe	arˈu"he
pungarehu	pˌu"ŋarˈehu"
Ringatū	riŋˈatu"ː
kuare	ku"ˈare
kuini	ku"ˈini
Irawaru	ˌirawˈaru"
Hinemoana	hˌinemɔˈana
kakama	kakˈama
Wairua	wa͡ɪrˈu"a
Tutanekai	tˌu"tanˈeka͡ɪ
whaikōrero	fˌa͡ɪkɔːrˈerɔ
korowai	kɔrˈɔwa͡ɪ
Tukua	tu"kˈu"a
manawataki	mˌanawatˈaki
tira	tˈira
Pūtaiao	pu"ːtˈa͡ɪa͡ʊ
pitihana	pˌitihˈana
kaingārahu	kˌa͡ɪŋaːrˈahu"
wairuatanga	wˌa͡ɪru"atˈaŋa
Hea	hˈea
rore	rˈɔre
nehu	nˈehu"
Taro	tˈarɔ
aru	ˈaru"
whakaraerae	fˌakarˈa͡ɪra͡ɪ
kāpia	kaːpˈia
aromatawaia	ˌarɔmˌatawˈa͡ɪa
Ōhinemutu	ˌɔːhinemˈu"tu"
Engari	eŋˈari
haurehu	hˌau"rˈehu"
whakangahau	fˌakaŋahˈau"
Rapua	rapˈu"a
Taniwha	tanˈifa
tūtae	tˈu"ːta͡ɪ
pikinga	pikˈiŋa
kukune	ku"kˈu"ne
whakaatuhia	fˌakaˌatu"hˈia
piko	pˈikɔ
whakataki	fˌakatˈaki
whakaako	fˌakaˈakɔ
matau	matˈau"
niao	nˈia͡ʊ
whakatauritea	fˌakatˌau"ritˈea
New	nˈew
tēneki	teːnˈeki
Rēhia	reːhˈia
tūhonohono	tˌu"ːhɔnɔhˈɔnɔ
Paengawhāwhā	pˌa͡ɪŋafˈaːfaː
tātai	tˈaːta͡ɪ
Anga	ˈaŋa
piripiri	pˌiripˈiri
kāore	kaːˈɔre
miramira	mˌiramˈira
tamaiti	tamˈa͡ɪti
utaina	u"tˈa͡ɪna
kora	kˈɔra
rarahi	rarˈahi
whakarerekētia	fˌakarˌerekeːtˈia
Takitahi	tˌakitˈahi
waku	wˈaku"
mōrearea	mˌɔːrearˈea
Mana	mˈana
whakahaerehia	fˌakahˌa͡ɪrehˈia
Aku	ˈaku"
whatitoka	fˌatitˈɔka
raurēkau	rˌau"reːkˈau"
hahana	hahˈana
rea	rˈea
māuiui	mˌaːu"iˈu"i
ohia	ɔhˈia
Harata	harˈata
Horomona	hˌɔrɔmˈɔna
huakita	hˌu"akˈita
whakahua	fˌakahˈu"a
paraoa	parˈa͡ʊa
Ngaiterangi	ŋˌa͡ɪterˈaŋi
takitini	tˌakitˈini
Katikati	kˌatikˈati
Paremata	pˌaremˈata
motukore	mˌɔtu"kˈɔre
tarai	tˈara͡ɪ
Whawhai	fˈafa͡ɪ
kīngi	kˈiːŋi
tāpaetia	tˌaːpa͡ɪtˈia
orite	ɔrˈite
takaroa	tˌakarˈɔa
whirinaki	fˌirinˈaki
Tōia	tɔːˈia
Tāhū	tˈaːhu"ː
Kīngi	kˈiːŋi
whakakaupapa	fˌakakˌau"pˈapa
patohanga	pˌatɔhˈaŋa
tukutuku	tˌu"ku"tˈu"ku"
pukuhohe	pˌu"ku"hˈɔhe
araa	arˈaa
tutaki	tu"tˈaki
marathon	marˈathɔn
Tawhiuau	tˌafiu"ˈau"
tōmuatanga	tˌɔːmu"atˈaŋa
hiakai	hiˈaka͡ɪ
Tuwhakararo	tˌu"fakarˈarɔ
Unit	ˈu"nit
wikitōria	wˌikitɔːrˈia
tina	tˈina
niupepa	nˌiu"pˈepa
muna	mˈu"na
tikiake	tˌikiˈake
takaro	takˈarɔ
haumako	hˌau"mˈakɔ
po	pˈɔ
taokete	ta͡ʊkˈete
takaia	takˈa͡ɪa
maramara	mˌaramˈara
whiore	fiˈɔre
Whakaakoranga	fˌakaˌakɔrˈaŋa
koropupu	kˌɔrɔpˈu"pu"
koiora	ko͡ɪˈɔra
whakawhetai	fˌakafˈeta͡ɪ
Pangarau	pˌaŋarˈau"
Apanui	ˌapanˈu"i
Motuhake	mˌɔtu"hˈake
manatārua	mˌanataːrˈu"a
māra	mˈaːra
hi	hˈi
kaitango	ka͡ɪtˈaŋɔ
Wikitoria	wˌikitɔrˈia
panonitanga	pˌanɔnitˈaŋa
taupū	taˈu"pu"ː
Tokorima	tˌɔkɔrˈima
kauta	kaˈu"ta
Papamoa	pˌapamˈɔa
kohatu	kɔhˈatu"
piriti	pirˈiti
pukuriri	pˌu"ku"rˈiri
taparau	tˌaparˈau"
ngunguru	ŋu"ŋˈu"ru"
Puea	pu"ˈea
Tura	tˈu"ra
rātaka	raːtˈaka
tūpuna	tu"ːpˈu"na
taitamariki	tˌa͡ɪtamarˈiki
maitai	mˈa͡ɪta͡ɪ
wherawhera	fˌerafˈera
kohine	kɔhˈine
whakatōpū	fˌakatˈɔːpu"ː
Whiri	fˈiri
Impromptu	imprˈɔmptu"
pūrerehua	pˌu"ːrerehˈu"a
pouaru	pˌou"ˈaru"
Poihana	po͡ɪhˈana
whakawhanaungatanga	fˌakafˌanaˌu"ŋatˈaŋa
Whatatutu	fˌatatˈu"tu"
hohipera	hˌɔhipˈera
Whakaora	fakˈa͡ʊra
komiti	kɔmˈiti
ngeru	ŋˈeru"
korekore	kˌɔrekˈɔre
pauna	paˈu"na
ora	ˈɔra
whakataetae	fˌakatˈa͡ɪta͡ɪ
hauāuru	hˌau"aːˈu"ru"
pä	pˈa
takahanga	tˌakahˈaŋa
t	t
kereru	kerˈeru"
tupuna	tu"pˈu"na
mema	mˈema
Rauru	raˈu"ru"
whakaata	fˌakaˈata
pāorooro	pˌaːɔrɔˈɔrɔ
mihi	mˈihi
tokoono	tˌɔkɔˈɔnɔ
Whāinga	faːˈiŋa
Māmoe	mˈaːmwe
piupiu	pˌiu"pˈiu"
kaiwhakaari	kˌa͡ɪfakaˈari
areare	ˌareˈare
Ua	ˈu"a
whakahuatia	fˌakahˌu"atˈia
whutupaoro	fˌu"tu"pˈa͡ʊrɔ
Papahurihia	pˌapahˌu"rihˈia
tōtara	tɔːtˈara
rapu	rˈapu"
rerewhenua	rˌerefenˈu"a
rīpene	riːpˈene
Riri	rˈiri
Maori	mˈa͡ʊri
repe	rˈepe
Riro	rˈirɔ
ripi	rˈipi
Araroa	ˌararˈɔa
Tākaro	taːkˈarɔ
rāwekeweke	rˌaːwekewˈeke
maa	mˈaa
toheroa	tˌɔherˈɔa
nawe	nˈawe
kiore	kiˈɔre
tūru	tˈu"ːru"
mauhia	mˌau"hˈia
tanuku	tanˈu"ku"
pūtake	pu"ːtˈake
rawhiti	rafˈiti
tūroro	tu"ːrˈɔrɔ
ataahua	ˌataahˈu"a
kōpaki	kɔːpˈaki
Rāhina	raːhˈina
tautokohia	tˌau"tˌɔkɔhˈia
Ruatoki	rˌu"atˈɔki
Tīmatanga	tˌiːmatˈaŋa
pūhia	pu"ːhˈia
whakakāhoretia	fˌakakˌaːhɔretˈia
Tuatoru	tˌu"atˈɔru"
marire	marˈire
hangai	hˈaŋa͡ɪ
tapae	tˈapa͡ɪ
kōkiri	kɔːkˈiri
inoi	ˈino͡ɪ
Kohai	kˈɔha͡ɪ
rātonga	raːtˈɔŋa
hinu	hˈinu"
Makau	makˈau"
whakarahinga	fˌakarahˈiŋa
purotu	pu"rˈɔtu"
whakakīkī	fˌakakˈiːkiː
makariri	mˌakarˈiri
kaihautū	kˌa͡ɪhaˈu"tu"ː
taatou	tˌaatˈou"
pāpāho	paːpˈaːhɔ
rākau	raːkˈau"
ngārahu	ŋaːrˈahu"
whakawaiwai	fˌakawˈa͡ɪwa͡ɪ
tūturutanga	tˌu"ːtu"ru"tˈaŋa
waimeha	wa͡ɪmˈeha
urutomo	ˌu"ru"tˈɔmɔ
nēhi	nˈeːhi
whakateraki	fˌakaterˈaki
tētahi	teːtˈahi
papakāinga	pˌapakaːˈiŋa
whakaratohia	fˌakarˌatɔhˈia
tohuhia	tˌɔhu"hˈia
Reo	rˈeɔ
Tūmanako	tˌu"ːmanˈakɔ
tautiaki	tˌau"tiˈaki
patapatai	pˌatapˈata͡ɪ
tāna	tˈaːna
karangatanga	kˌaraŋatˈaŋa
kaiwhakarato	kˌa͡ɪfakarˈatɔ
Mano	mˈanɔ
rīpeka	riːpˈeka
puāwai	pu"ˈaːwa͡ɪ
tohungatanga	tˌɔhu"ŋatˈaŋa
kapuni	kapˈu"ni
Rautaki	rˌau"tˈaki
Koinā	kˈo͡ɪnaː
mākutu	maːkˈu"tu"
Tuhoe	tˈu"hwe
manga	mˈaŋa
mātao	mˈaːta͡ʊ
Aorangi	a͡ʊrˈaŋi
aku	ˈaku"
Kāterina	kˌaːterˈina
Matatika	mˌatatˈika
kōeke	kɔːˈeke
karauna	kˌaraˈu"na
torotoro	tˌɔrɔtˈɔrɔ
to	tˈɔ
parāoa	pˌaraːˈɔa
Roimata	ro͡ɪmˈata
Ngapuhi	ŋapˈu"hi
Kairēhita	kˌa͡ɪreːhˈita
kaha	kˈaha
hōhipera	hˌɔːhipˈera
körero	kɔrˈerɔ
kupu	kˈu"pu"
puranga	pu"rˈaŋa
tirotirohia	tˌirɔtˌirɔhˈia
okiokinga	ˌɔkiɔkˈiŋa
ngakia	ŋakˈia
whakawākanga	fˌakawaːkˈaŋa
Puka	pˈu"ka
Tiriti	tirˈiti
tōmuri	tɔːmˈu"ri
ränei	ranˈei
mete	mˈete
titiro	titˈirɔ
mōmona	mɔːmˈɔna
Aranga	arˈaŋa
Tangohia	tˌaŋɔhˈia
kākāriki	kˌaːkaːrˈiki
tauranga	tˌau"rˈaŋa
parae	pˈara͡ɪ
maara	maˈara
māhunga	maːhˈu"ŋa
marumaru	mˌaru"mˈaru"
Rārangihia	rˌaːraŋihˈia
whakarōpūtia	fˌakarˌɔːpu"ːtˈia
pataka	patˈaka
Hāpai	hˈaːpa͡ɪ
Hōri	hˈɔːri
Tīhema	tiːhˈema
rōpu	rˈɔːpu"
whakaaotanga	fˌakaa͡ʊtˈaŋa
Kae	kˈa͡ɪ
IT	ˈit
Nainoa	na͡ɪnˈɔa
toenga	twˈeŋa
riringi	rirˈiŋi
hokowhitu	hˌɔkɔfˈitu"
whakamua	fˌakamˈu"a
Maimoatanga	mˌa͡ɪmɔatˈaŋa
āwangawanga	ˌaːwaŋawˈaŋa
Aotaki	a͡ʊtˈaki
kukupa	ku"kˈu"pa
nehua	nehˈu"a
wharekai	farˈeka͡ɪ
Nāu	nˈaːu"
Kapene	kapˈene
mano	mˈanɔ
inanga	inˈaŋa
Hekeretari	hˌekeretˈari
kari	kˈari
whakarara	fˌakarˈara
ūngeri	u"ːŋˈeri
Anā	ˈanaː
Paerewa	pa͡ɪrˈewa
taikaha	ta͡ɪkˈaha
whakamahara	fˌakamahˈara
matapihi	mˌatapˈihi
Air	ˈa͡ɪr
poari	pɔˈari
whakaputahia	fˌakapˌu"tahˈia
kō	kˈɔː
tawhio	tafˈiɔ
tuarangi	tˌu"arˈaŋi
auraki	ˌau"rˈaki
ngahoro	ŋahˈɔrɔ
wāhine	waːhˈine
potiki	pɔtˈiki
piriona	pˌiriˈɔna
Taranaki	tˌaranˈaki
Mau	mˈau"
whai	fˈa͡ɪ
whakaminenga	fˌakaminˈeŋa
pm	pm
Hurihia	hˌu"rihˈia
whakaharatau	fˌakahˌaratˈau"
Komihana	kˌɔmihˈana
Hongongoi	hɔŋˈɔŋo͡ɪ
keehi	keˈehi
kutu	kˈu"tu"
karapoti	kˌarapˈɔti
etahi	etˈahi
pēpē	pˈeːpeː
Hekenukumai	hˌekenu"kˈu"ma͡ɪ
Ani	ˈani
Winiata	wˌiniˈata
whakapakaritia	fˌakapˌakaritˈia
marae	mˈara͡ɪ
papatipu	pˌapatˈipu"
atawhai	atˈafa͡ɪ
whakamaramatanga	fˌakamˌaramatˈaŋa
Koi	kˈo͡ɪ
rerekore	rˌerekˈɔre
waituhi	wa͡ɪtˈu"hi
kaioraora	kˌa͡ɪɔrˈa͡ʊra
ohotata	ˌɔhɔtˈata
whakatoi	fakˈato͡ɪ
pūngāwerewere	pˌu"ːŋaːwˌerewˈere
Kite	kˈite
Whāiti	faːˈiti
tuawhitu	tˌu"afˈitu"
angawaho	ˌaŋawˈahɔ
werowero	wˌerɔwˈerɔ
Himi	hˈimi
ita	ˈita
ō	ˈɔː
pahi	pˈahi
aituā	a͡ɪtˈu"aː
mānuka	maːnˈu"ka
Takiura	tˌakiˈu"ra
Huinga	hu"ˈiŋa
hikina	hikˈina
pua	pˈu"a
tahatika	tˌahatˈika
Kāwanatanga	kˌaːwanatˈaŋa
Ngaheu	ŋahˈeu"
it	ˈit
Panui	panˈu"i
Tawhirimatea	tˌafirˌimatˈea
Tangaere	taŋˈa͡ɪre
kaiwhakanoho	kˌa͡ɪfakanˈɔhɔ
Hānuere	hˌaːnu"ˈere
kauwhau	kˌau"fˈau"
Waititi	wa͡ɪtˈiti
tekoteko	tˌekɔtˈekɔ
urutaunga	ˌu"ru"taˈu"ŋa
Akona	akˈɔna
taunaha	tˌau"nˈaha
Tauwhao	taˈu"fa͡ʊ
Ngaro	ŋˈarɔ
Rangitukutuku	rˌaŋitˌu"ku"tˈu"ku"
Piri	pˈiri
pāka	pˈaːka
puhi	pˈu"hi
kimihia	kˌimihˈia
Toko	tˈɔkɔ
whakawātea	fˌakawaːtˈea
tapanga	tapˈaŋa
kaihokohoko	kˌa͡ɪhɔkɔhˈɔkɔ
patipati	pˌatipˈati
huatanga	hˌu"atˈaŋa
korokoro	kˌɔrɔkˈɔrɔ
atua	atˈu"a
korua	kɔrˈu"a
taotu	tˈa͡ʊtu"
tūhono	tu"ːhˈɔnɔ
makutu	makˈu"tu"
rangimarie	rˌaŋimarˈie
ināianei	ˌinaːˌianˈei
pukohu	pu"kˈɔhu"
horu	hˈɔru"
AUT	ˈau"t
tauhohenga	tˌau"hɔhˈeŋa
miti	mˈiti
whakaora	fakˈa͡ʊra
utua	u"tˈu"a
hāngaitanga	hˌaːŋa͡ɪtˈaŋa
hanga	hˈaŋa
karere	karˈere
hekeretari	hˌekeretˈari
hinengaro	hˌineŋˈarɔ
taua	taˈu"a
ētahi	eːtˈahi
puaki	pu"ˈaki
tatauria	tˌatau"rˈia
peka	pˈeka
pīrori	piːrˈɔri
raka	rˈaka
Marama	marˈama
karawhiu	kˌarafˈiu"
tutukitanga	tˌu"tu"kitˈaŋa
pikopiko	pˌikɔpˈikɔ
taiepa	ta͡ɪˈepa
āniwhaniwha	ˌaːnifanˈifa
Pānga	pˈaːŋa
mahanga	mahˈaŋa
Hētana	heːtˈana
tūtei	tu"ːtˈei
manu	mˈanu"
tūtata	tu"ːtˈata
kāika	kaːˈika
whangaia	faŋˈa͡ɪa
īpae	ˈiːpa͡ɪ
uha	ˈu"ha
pūtahitanga	pˌu"ːtahitˈaŋa
Pūreta	pu"ːrˈeta
wähanga	wahˈaŋa
pounamu	pˌou"nˈamu"
Paora	pˈa͡ʊra
tukurua	tˌu"ku"rˈu"a
Rere	rˈere
Ika	ˈika
Rongomaraeroa	rˌɔŋɔmˌara͡ɪrˈɔa
tipi	tˈipi
ūpoko	u"ːpˈɔkɔ
karangaranga	kˌaraŋarˈaŋa
karengo	karˈeŋɔ
Karaka	karˈaka
riki	rˈiki
hāngai	hˈaːŋa͡ɪ
whakanōhia	fˌakanɔːhˈia
Haramai	harˈama͡ɪ
whakamātau	fˌakamaːtˈau"
kaponga	kapˈɔŋa
Pō	pˈɔː
whakamoemiti	fˌakamwemˈiti
tohutao	tɔhˈu"ta͡ʊ
rita	rˈita
Arihia	ˌarihˈia
whakahautia	fˌakahˌau"tˈia
Rotorua	rˌɔtɔrˈu"a
Whakarongo	fˌakarˈɔŋɔ
koromatua	kˌɔrɔmatˈu"a
whakaputanga	fˌakapu"tˈaŋa
Ipu	ˈipu"
taumaha	tˌau"mˈaha
tohi	tˈɔhi
Manaaki	mˌanaˈaki
taunga	taˈu"ŋa
Ngahuru	ŋahˈu"ru"
raakau	rˌaakˈau"
tahuhu	tahˈu"hu"
whakarunga	fˌakarˈu"ŋa
Kāre	kˈaːre
whakaroa	fˌakarˈɔa
Waitematā	wˌa͡ɪtemˈataː
whakatupato	fˌakatu"pˈatɔ
whakaritea	fˌakaritˈea
tamahine	tˌamahˈine
paoa	pˈa͡ʊa
hauwaru	hˌau"wˈaru"
tēwhea	teːfˈea
wharepaku	fˌarepˈaku"
tapiri	tapˈiri
Rīpera	riːpˈera
tīpuna	tiːpˈu"na
Koro	kˈɔrɔ
Tokorua	tˌɔkɔrˈu"a
minenga	minˈeŋa
hoe	hwˈe
nāu	nˈaːu"
parirau	pˌarirˈau"
kitea	kitˈea
Matau	matˈau"
waina	wˈa͡ɪna
raanei	rˌaanˈei
kaipupuri	kˌa͡ɪpu"pˈu"ri
whakanohoia	fˌakanɔhˈo͡ɪa
pāremata	pˌaːremˈata
Kōhine	kɔːhˈine
whakararo	fˌakarˈarɔ
poitarawhiti	pˌo͡ɪtarafˈiti
Tena	tˈena
tuaono	tu"ˈa͡ʊnɔ
teetehi	tˌeetˈehi
Whakatika	fˌakatˈika
hangarau	hˌaŋarˈau"
tumanako	tˌu"manˈakɔ
Paenga	pˈa͡ɪŋa
awhikiri	ˌafikˈiri
whenua	fenˈu"a
Waihoki	wa͡ɪhˈɔki
tūmatarau	tˌu"ːmatarˈau"
pūhiko	pu"ːhˈikɔ
Kōeke	kɔːˈeke
Horror	hˈɔrrɔr
Hapanihi	hˌapanˈihi
meinga	meˈiŋa
kāreti	kaːrˈeti
Uenuku	ˌu"enˈu"ku"
Whakamahi	fˌakamˈahi
Tangotango	tˌaŋɔtˈaŋɔ
Tiaki	tiˈaki
Rangitīkei	rˌaŋitiːkˈei
whakatipu	fˌakatˈipu"
tīwhiri	tiːfˈiri
ārikarika	ˌaːrikarˈika
whakapoke	fˌakapˈɔke
parai	pˈara͡ɪ
hau	hˈau"
pōkai	pˈɔːka͡ɪ
man	mˈan
mōteatea	mˌɔːteatˈea
ngēnei	ŋeːnˈei
Hēni	hˈeːni
whakaranu	fˌakarˈanu"
Moteatea	mˌɔteatˈea
Āta	ˈaːta
reanga	reˈaŋa
Herenga	herˈeŋa
wai	wˈa͡ɪ
whakaaraara	fˌakaˌaraˈara
kirimana	kˌirimˈana
Kawakawa	kˌawakˈawa
Māu	mˈaːu"
Tānerore	tˌaːnerˈɔre
haehae	hˈa͡ɪha͡ɪ
rawekehia	rˌawekehˈia
kētanga	keːtˈaŋa
onge	ˈɔŋe
Hereturikōkā	hˌeretˌu"rikˈɔːkaː
kutikuti	kˌu"tikˈu"ti
tūmanako	tˌu"ːmanˈakɔ
haepapa	ha͡ɪpˈapa
Rohe	rˈɔhe
taumarumaru	tˌau"mˌaru"mˈaru"
toto	tˈɔtɔ
kāri	kˈaːri
whakatata	fˌakatˈata
ngawari	ŋawˈari
whakawhānuitia	fˌakafˌaːnu"itˈia
pāti	pˈaːti
wareware	wˌarewˈare
Tautohua	tˌau"tɔhˈu"a
autōhiko	ˌau"tɔːhˈikɔ
Haria	harˈia
Tinirau	tˌinirˈau"
kawekawe	kˌawekˈawe
whakairi	fakˈa͡ɪri
two	twˈɔ
rarau	rarˈau"
ngaki	ŋˈaki
huraina	hu"rˈa͡ɪna
paopao	pˈa͡ʊpa͡ʊ
ihu	ˈihu"
pupu	pˈu"pu"
kino	kˈinɔ
Aotea	a͡ʊtˈea
nohoanga	nˌɔhɔˈaŋa
Kooti	kɔˈɔti
Kaupapa	kˌau"pˈapa
whakahoa	fˌakahˈɔa
Kōkiritia	kˌɔːkiritˈia
whakarea	fˌakarˈea
MPI	mpˈi
moemoeā	mwemwˈeaː
tīmatatanga	tˌiːmatatˈaŋa
Heteroptera	hˌeterɔptˈera
Rātou	raːtˈou"
whakaingoatia	fˌaka͡ɪŋˌɔatˈia
whaa	fˈaa
Parore	parˈɔre
ngote	ŋˈɔte
Hori	hˈɔri
pene	pˈene
pirepire	pˌirepˈire
kainga	kˈa͡ɪŋa
tōkena	tɔːkˈena
Whakaritenga	fˌakaritˈeŋa
purere	pu"rˈere
kinaki	kinˈaki
whakahiato	fˌakahiˈatɔ
waha	wˈaha
whakatipuranga	fˌakatˌipu"rˈaŋa
Pouaka	pˌou"ˈaka
Ingarihi	ˌiŋarˈihi
Tāngata	taːŋˈata
mai	mˈa͡ɪ
Hui	hˈu"i
taha	tˈaha
hoahoatanga	hˌɔahˌɔatˈaŋa
kaiwhakarongo	kˌa͡ɪfakarˈɔŋɔ
koorero	kˌɔɔrˈerɔ
pakimaero	pˌakimˈa͡ɪrɔ
etehi	etˈehi
Morehu	mɔrˈehu"
Pōkai	pˈɔːka͡ɪ
Māui	maːˈu"i
kakā	kˈakaː
whakakao	fakˈaka͡ʊ
tarea	tarˈea
Wheke	fˈeke
takitaki	tˌakitˈaki
tapawhā	tapˈafaː
mauru	maˈu"ru"
kanikani	kˌanikˈani
kaitākaro	kˌa͡ɪtaːkˈarɔ
Pikiao	pikˈia͡ʊ
tō	tˈɔː
huhu	hˈu"hu"
taatai	taˈata͡ɪ
anoo	anˈɔɔ
kōmihana	kˌɔːmihˈana
whakamarama	fˌakamarˈama
Apa	ˈapa
Hinetūāhōanga	hˌinetˌu"ːaːhɔːˈaŋa
pararopi	pˌararˈɔpi
whakamahana	fˌakamahˈana
waikawa	wa͡ɪkˈawa
manawanui	mˌanawanˈu"i
ngau	ŋˈau"
whitinga	fitˈiŋa
Rā	rˈaː
Matangi	matˈaŋi
wānangahia	wˌaːnaŋahˈia
Hurihuri	hˌu"rihˈu"ri
kōhi	kˈɔːhi
ihumanea	ˌihu"manˈea
Waikano	wa͡ɪkˈanɔ
Āti	ˈaːti
rongo	rˈɔŋɔ
mohe	mˈɔhe
hapai	hˈapa͡ɪ
haurima	hˌau"rˈima
Hopa	hˈɔpa
wawa	wˈawa
rourou	rˌou"rˈou"
mōku	mˈɔːku"
TMOAHe	tmɔˈahe
tīma	tˈiːma
Tūwharetoa	tˌu"ːfaretˈɔa
whakareatanga	fˌakarˌeatˈaŋa
māro	mˈaːrɔ
Rahoroi	rahˈɔro͡ɪ
āheinga	ˌaːheˈiŋa
tiketike	tˌiketˈike
karaehe	karˈa͡ɪhe
Arowhenua	ˌarɔfenˈu"a
mena	mˈena
hāora	haːˈɔra
Manawanui	mˌanawanˈu"i
pereki	perˈeki
purenga	pu"rˈeŋa
Maniapoto	mˌaniapˈɔtɔ
kua	kˈu"a
pāwhiria	pˌaːfirˈia
waiatatia	wˌa͡ɪatatˈia
āwhata	aːfˈata
roimata	ro͡ɪmˈata
Pi	pˈi
pānuihia	pˌaːnu"ihˈia
Mahue	mahˈu"e
tākihi	taːkˈihi
Kawariki	kˌawarˈiki
TP	tp
rauawa	rˌau"ˈawa
manaakitia	mˌanaˌakitˈia
kānapanapa	kˌaːnapanˈapa
pohatu	pɔhˈatu"
King	kˈiŋ
Erima	erˈima
kauae	kaˈu"a͡ɪ
kitakita	kˌitakˈita
wahangū	wahˈaŋu"ː
pānuitia	pˌaːnu"itˈia
horekau	hˌɔrekˈau"
pou	pˈou"
maua	maˈu"a
kūpapa	ku"ːpˈapa
Whakaaturia	fˌakaˌatu"rˈia
whakaeke	fakˈa͡ɪke
tāpiritia	tˌaːpiritˈia
wawata	wawˈata
kohu	kˈɔhu"
Ponga	pˈɔŋa
mura	mˈu"ra
Kāpehu	kaːpˈehu"
poihau	po͡ɪhˈau"
kohi	kˈɔhi
Pāwhiria	pˌaːfirˈia
ahu	ˈahu"
whakapākehā	fˌakapaːkˈehaː
puoro	pu"ˈɔrɔ
Ākona	aːkˈɔna
Whānau	faːnˈau"
Aue	aˈu"e
ohorere	ˌɔhɔrˈere
rimu	rˈimu"
moheni	mɔhˈeni
mātāpono	mˌaːtaːpˈɔnɔ
tāu	tˈaːu"
Tautoko	tˌau"tˈɔkɔ
whakawhitiwhiti	fˌakafˌitifˈiti
ahei	ahˈei
Ringa	rˈiŋa
iho	ˈihɔ
kurikuri	kˌu"rikˈu"ri
tapoi	tˈapo͡ɪ
Whenu	fˈenu"
kahupapa	kˌahu"pˈapa
kaituku	ka͡ɪtˈu"ku"
kautia	kˌau"tˈia
toi	tˈo͡ɪ
kono	kˈɔnɔ
tä	tˈa
Tangaroa	tˌaŋarˈɔa
onepu	ɔnˈepu"
kaiwhakauru	kˌa͡ɪfakaˈu"ru"
Karekau	kˌarekˈau"
tuahu	tu"ˈahu"
Huarahi	hˌu"arˈahi
muia	mu"ˈia
toia	tˈo͡ɪa
whakaihiihi	fˌaka͡ɪhiˈihi
Pakanga	pakˈaŋa
mariko	marˈikɔ
whao	fˈa͡ʊ
whakamahi	fˌakamˈahi
whakatōngia	fˌakatɔːŋˈia
Moko	mˈɔkɔ
āhua	aːhˈu"a
Whakarite	fˌakarˈite
whiriwhiringa	fˌirifirˈiŋa
Peretānia	pˌeretaːnˈia
papare	papˈare
tokotoko	tˌɔkɔtˈɔkɔ
Waimakariri	wˌa͡ɪmakarˈiri
pati	pˈati
toetoe	twˈetwe
Pūnaha	pu"ːnˈaha
whaiwhai	fˈa͡ɪfa͡ɪ
roto	rˈɔtɔ
whakapāha	fˌakapˈaːha
ruia	ru"ˈia
anei	anˈei
Hineahuone	hˌineˌahu"ˈɔne
Nohinohi	nˌɔhinˈɔhi
Āhitana	ˌaːhitˈana
Akomanga	ˌakɔmˈaŋa
whakaarohia	fˌakaˌarɔhˈia
tukunga	tu"kˈu"ŋa
tōna	tˈɔːna
Mātāpono	mˌaːtaːpˈɔnɔ
tuwhera	tu"fˈera
papatono	pˌapatˈɔnɔ
Manahi	manˈahi
karangatia	kˌaraŋatˈia
Hopihona	hˌɔpihˈɔna
Rākau	raːkˈau"
Parata	parˈata
toitū	tˈo͡ɪtu"ː
kōaro	kɔːˈarɔ
ui	ˈu"i
Tuku	tˈu"ku"
Tipene	tipˈene
Nōema	nɔːˈema
Āhuatanga	ˌaːhu"atˈaŋa
kete	kˈete
kaikorero	kˌa͡ɪkɔrˈerɔ
ngâ	ŋˈa
Hikurangi	hˌiku"rˈaŋi
kokiri	kɔkˈiri
kōrerohia	kˌɔːrerɔhˈia
whakatikahia	fˌakatˌikahˈia
tōpūtanga	tˌɔːpu"ːtˈaŋa
Tarata	tarˈata
Hao	hˈa͡ʊ
pī	pˈiː
Aka	ˈaka
Tāpiria	tˌaːpirˈia
ngaunga	ŋaˈu"ŋa
Ētahi	eːtˈahi
Kararaina	kˌararˈa͡ɪna
Maraenui	mˌara͡ɪnˈu"i
Hakinakina	hˌakinakˈina
raru	ɹˈaɹu
wāriu	waːrˈiu"
Orion	ɔrˈiɔn
hautau	hˌau"tˈau"
Kohitātea	kˌɔhitaːtˈea
Kaitirotiro	kˌa͡ɪtirɔtˈirɔ
kaitōrangapū	kˌa͡ɪtɔːraŋˈapu"ː
warowaihā	wˌarɔwˈa͡ɪhaː
mīhana	miːhˈana
pakipaki	pˌakipˈaki
whiwhi	fˈifi
tokarewa	tˌɔkarˈewa
Whakawhitiwhitinga	fˌakafˌitifitˈiŋa
heipū	heˈipu"ː
Arapeta	ˌarapˈeta
pohutukawa	pˌɔhu"tu"kˈawa
paparahi	pˌaparˈahi
huawhenua	hˌu"afenˈu"a
whakatūhia	fˌakatu"ːhˈia
kaati	kaˈati
tohaina	tɔhˈa͡ɪna
oanahi	ˌɔanˈahi
Mäori	mˈa͡ʊri
Taute	taˈu"te
Murirangawhenua	mˌu"rirˌaŋafenˈu"a
Rāmere	raːmˈere
kara	kˈara
Tāmihana	tˌaːmihˈana
kotiro	kɔtˈirɔ
No	nˈɔ
Area	arˈea
pakiaka	pˌakiˈaka
Kaunihera	kˌau"nihˈera
anā	ˈanaː
Meinga	meˈiŋa
kahikatea	kˌahikatˈea
Hurinui	hˌu"rinˈu"i
whakaaetia	fˌakaa͡ɪtˈia
takiwa	takˈiwa
ranei	ranˈei
whakatauhia	fˌakatˌau"hˈia
whakaminea	fˌakaminˈea
maero	mˈa͡ɪrɔ
tahu	tˈahu"
toro	tˈɔrɔ
Heuheu	hˌeu"hˈeu"
māhaki	maːhˈaki
anuanu	ˌanu"ˈanu"
pokea	pɔkˈea
tikanga	tikˈaŋa
hängai	hˈaŋa͡ɪ
hue	hˈu"e
mīti	mˈiːti
pehi	pˈehi
tōraro	tɔːrˈarɔ
kotuku	kɔtˈu"ku"
tīhi	tˈiːhi
Whakanoho	fˌakanˈɔhɔ
akomanga	ˌakɔmˈaŋa
rautau	rˌau"tˈau"
hia	hˈia
Poari	pɔˈari
Rākaipaaka	rˌaːka͡ɪpaˈaka
katoa	katˈɔa
Tahupōtiki	tˌahu"pɔːtˈiki
Pōneke	pɔːnˈeke
heihei	hˌeihˈei
kooti	kɔˈɔti
Tika	tˈika
pāua	paːˈu"a
Whāngārei	fˌaːŋaːrˈei
atahanga	ˌatahˈaŋa
Aotearoa	ˌa͡ʊtearˈɔa
mutu	mˈu"tu"
Pūtea	pu"ːtˈea
pu	pˈu"
whakatōkia	fˌakatɔːkˈia
karanga	karˈaŋa
Akaroa	ˌakarˈɔa
Ati	ˈati
āhei	aːhˈei
hekaheka	hˌekahˈeka
maaka	maˈaka
whakatairangahia	fˌakatˌa͡ɪraŋahˈia
Kahui	kahˈu"i
P	p
kare	kˈare
Rotoiti	rɔtˈo͡ɪti
wähi	wˈahi
whēnei	feːnˈei
piana	piˈana
ngao	ŋˈa͡ʊ
tonga	tˈɔŋa
ngatahi	ŋatˈahi
Rawinia	rˌawinˈia
matika	matˈika
kiriata	kˌiriˈata
UK	ˈu"k
Paerua	pa͡ɪrˈu"a
wairangi	wa͡ɪrˈaŋi
taki	tˈaki
āwhinatia	ˌaːfinatˈia
kani	kˈani
pokanga	pɔkˈaŋa
uiuinga	ˌu"iu"ˈiŋa
wiki	wˈiki
pakia	pakˈia
whakaahua	fˌakaahˈu"a
kōkopu	kɔːkˈɔpu"
were	wˈere
eke	ˈeke
tiki	tˈiki
kaiaka	ka͡ɪˈaka
Tāhuhu	taːhˈu"hu"
Pei	pˈei
mahinga	mahˈiŋa
akohia	ˌakɔhˈia
Ruahine	rˌu"ahˈine
Paraihe	parˈa͡ɪhe
marika	marˈika
wao	wˈa͡ʊ
whakamaumaharatanga	fˌakamˌau"mˌaharatˈaŋa
Taiaroa	tˌa͡ɪarˈɔa
Taiopenga	tˌa͡ɪɔpˈeŋa
mahingia	mˌahiŋˈia
tauaro	tˌau"ˈarɔ
Papaioea	pˌapa͡ɪwˈea
Pāti	pˈaːti
whakatangi	fˌakatˈaŋi
pupū	pˈu"pu"ː
naku	nˈaku"
whakapumau	fˌakapu"mˈau"
hikaka	hikˈaka
waiaro	wa͡ɪˈarɔ
marie	marˈie
Ngārimu	ŋaːrˈimu"
āta	ˈaːta
Art	ˈart
Matihiko	mˌatihˈikɔ
