ସହଯୋଗୀ	sɔhɔd͡ʒogi
ବହିଟା	bɔhiʈaː
ଠାକୁର	ʈʰaːkuɾɔ
ଦ୍ଵାର	d̪uaːɾɔ
ଧାଡ଼ିଏ	d̪ʱaːɽie
ସହାୟକ	sɔhaːjɔkɔ
ଚୁଲିଟା	t͡ʃuliʈaː
ଚିକ୍	t͡ʃik
ଚଳିବାକୁ	t͡ʃɔl̪ibaːku
ରସାଳ	ɾɔsaːl̪ɔ
ଷଟକୋଣ	sɔʈɔkoɳɔ
ଭୁତାଣୁ	bʱut̪aːɳu
ଜୀବଟି	d͡ʒibɔʈi
ସକ	sɔkɔ
କୋଳରେ	kol̪ɔre
ଖୁବ୍	kʰub
ଚଷମାରେ	t͡ʃɔsɔmaːre
କରିଲେଣି	kɔrileɳi
କରାଇଥିଲେ	kɔraːit̪ʰile
ମୃତ୍ୟୁ	mrut̪ju
ଚାଲିପାରେ	t͡ʃaːlipaːre
ପହଁରୁ	pɔhɔ̃ru
ଚାହେଁ	t͡ʃaːhẽ
ସେଗୁଡାକ	seguɖaːkɔ
ଶୁଣେନି	suɳeni
ବୁଝିପାରୁଛି	bud͡ʒʱipaːrut͡ʃʰi
କବାଡ଼ିବାଲା	kɔbaːɽibaːlaː
ତୁଳନାରେ	t̪ul̪ɔnaːre
ଅବୋଧ	ɔbod̪ʱɔ
ଚାଲ	t͡ʃaːlɔ
ନଈକୂଳରେ	nɔikul̪ɔre
ମାସ	maːsɔ
ଅବସ୍ଥିତ	ɔbɔst̪ʰit̪ɔ
ବାଦଲଟିଏ	baːd̪ɔlɔʈie
ଝାଡ଼ଖଣ୍ଡ	d͡ʒʱaːɖɔkʰɔɳɖɔ
ନାଚିପାରେ	naːt͡ʃipaːre
ପୁଅ	puɔ
ମାହାତ୍ମାଗାନ୍ଧୀଙ୍କର	maːhaːt̪maːgaːnd̪ʱiŋkɔɾɔ
ପାଣି	paːɳi
ଗୁଳି	gul̪i
ବିତିଗଲା	bit̪iɡɔlaː
ଆଃ	aːh
ବଞ୍ଚିପାରନ୍ତି	bɔɲt͡ʃipaːɾɔnt̪i
ବିବାହ	bibaːhɔ
ହାଡ	haːɖɔ
ସମ୍ବଲପୁରୀ	sɔmbɔlɔpuri
ଲଗେଇଲା	lɔgeilaː
ବ୍ୟକ୍ତିଗଣ	bjɔkt̪iɡɔɳɔ
କାର୍ତ୍ତିକ	kaːrt̪t̪ikɔ
ମାନଙ୍କର	maːnɔŋkɔɾɔ
ଗୋଟିଏ	goʈie
ଆପତ୍ତି	aːpɔt̪t̪i
ଦୃଷ୍ଟି	d̪rusʈi
ବାହାଦୁରି	baːhaːd̪uri
ଗଛ	ɡɔt͡ʃʰɔ
ସିଲ୍	sil
ବିଚାରା	bit͡ʃaːraː
କନେକ୍ଟିକଟ	kɔnekʈikɔʈɔ
ମିଳି	mil̪i
ଖାଇଲାନି	kʰaːilaːni
ନବରାତ୍ରୀ	nɔbɔraːt̪ri
ଅଭାବ	ɔbʱaːbɔ
ନେଳି	nel̪i
ଦୌଡ଼ିଲା	d̪ɔuɽilaː
ଭାରତ	bʱaːɾɔt̪ɔ
ଚଳ	t͡ʃɔl̪ɔ
ସାରେ	saːre
ଫୁଲରେ	pʰulɔre
ନିରୀକ୍ଷଣ	nirikʰjɔɳɔ
ଖବର	kʰɔbɔɾɔ
ମେ	me
ପ୍ରତିମା	pɾɔt̪imaː
ଧରିବି	d̪ʱɔribi
ସାମାଜିକ	saːmaːd͡ʒikɔ
ସବାଶେଷ	sɔbaːsesɔ
ରଞ୍ଜନ	ɾɔɲd͡ʒɔnɔ
ପକେଇଲା	pɔkeilaː
ବୋହିଯିବ	bohid͡ʒibɔ
ଯାହାକି	d͡ʒaːhaːki
ଏବେ	ebe
ବଳଭଦ୍ର	bɔl̪ɔbʰɔd̪ɾɔ
ଶୁଣିଲା	suɳilaː
ଆଉଜଣେ	aːud͡ʒɔɳe
ପଡ଼ିଥିଲା	pɔɽit̪ʰilaː
ଡରୁଆ	ɖɔruaː
ଥୋଇଦେଇ	t̪ʰoid̪ei
ସୀଲଟ୍	silɔʈ
ଲାଗିଯାନ୍ତି	laːgid͡ʒaːnt̪i
ଧଳାମେଘ	d̪ʱɔl̪aːmeɡʱɔ
ସୁରେନ୍ଦ୍ର	surend̪ɾɔ
ତୁମେ	t̪ume
ଖାଇଲା	kʰaːilaː
ରୋଇବାରେ	roibaːre
ଆସୁନୁ	aːsunu
ଚାରିଆଡ଼କୁ	t͡ʃaːriaːɽɔku
ଆପ୍ପା	aːppaː
ରଖିବି	ɾɔkʰibi
ବିକାଶ	bikaːsɔ
ଦଣ୍ଡ	d̪ɔɳɖɔ
ସହସା	sɔhɔsaː
ଦୁମଦୁମ୍	d̪umɔd̪um
ରଖୁଥିବାବେଳେ	ɾɔkʰut̪ʰibaːbel̪e
ରାସାୟନ	raːsaːjɔnɔ
ମୂଲ୍ୟବାନ	muljɔbaːnɔ
ବିଧି	bid̪ʱi
ପଶିଗଲା	pɔsiɡɔlaː
ହର	hɔɾɔ
କିଏ	kie
ଆଶ୍ଚର୍ଯ୍ୟ	aːst͡ʃɔrd͡ʒjɔ
ଜୀବଜଗତ	d͡ʒibɔd͡ʒɔɡɔt̪ɔ
ଗଡି	ɡɔɖi
ଚିନ୍ତାମଣି	t͡ʃint̪aːmɔɳi
ଏମିତିକି	emit̪iki
ଚାଲିଲା	t͡ʃaːlilaː
ରଙ୍ଗଣୀ	ɾɔŋɡɔɳi
କମ୍ପନ	kɔmpɔnɔ
କାନ୍ଦୁକାନ୍ଦୁ	kaːnd̪ukaːnd̪u
ଧୂଆଁ	d̪ʱuaː̃
ରାଜସ୍ଥାନ	raːd͡ʒɔst̪ʰaːnɔ
ଏସିଆର	esiaːɾɔ
ରୁଟି	ruʈi
ଆମ୍ମା	aːmmaː
ଅବକାଶ	ɔbɔkaːsɔ
ବେଳାଭୂମି	bel̪aːbʱumi
କହିବା	kɔhibaː
ଝିଅଟି	d͡ʒʱiɔʈi
ଚୁଲିରେ	t͡ʃulire
ତହାମଧ୍ୟ	t̪ɔhaːmɔd̪ʱjɔ
ପଛଗୋଡ଼ରେ	pɔt͡ʃʰɔgoɽɔre
ପାହାଞ୍ଚ	paːhaːɲt͡ʃɔ
ଡର	ɖɔɾɔ
ଶୁଆଟିଏ	suaːʈie
ଖ୍ରୀଷ୍ଟପୂର୍ବ	kʰrisʈɔpurbɔ
ଲାଞକୁ	laːɲɔku
କବାଟ୍	kɔbaːʈ
ବୋକା	bokaː
ଏଗୁଡ଼ିକ	eguɽikɔ
ଛତୁରୁ	t͡ʃʰɔt̪uru
ବେଶରେ	besɔre
ଏକା	ekaː
ଦିଲ୍ଲୀରେ	d̪illire
ପୂଜା	pud͡ʒaː
ନଖାଇ	nɔkʰaːi
ରଖିବା	ɾɔkʰibaː
ସଂକ୍ଷିପ୍ତ	sɔŋkʰipt̪ɔ
କହୁଛନ୍ତି	kɔhut͡ʃʰɔnt̪i
ପହଁରି	pɔhɔ̃ri
ମା	maː
ଅକ୍ଟୋବର	ɔkʈobɔɾɔ
ଥରହର	t̪ʰɔɾɔhɔɾɔ
ଜୋର୍	d͡ʒor
ଉଦ୍ଭାବନ	ud̪bʱaːbɔnɔ
ଅନାଇଲା	ɔnaːilaː
ମିହିର	mihiɾɔ
ଅମାବାସ୍ୟା	ɔmaːbaːsjaː
ହେବା	hebaː
ବଡ଼-ବଡ଼	bɔɽɔ-bɔɽɔ
ପହଁରୁଥିଲେ	pɔhɔ̃rut̪ʰile
ଟୋପି	ʈopi
ମାଝି	maːd͡ʒʱi
କରାଗଲା	kɔraːɡɔlaː
ବାରମାସୀ	baːɾɔmaːsi
ସାଙ୍ଗମାନଙ୍କୁ	saːŋɡɔmaːnɔŋku
ଡଙ୍ଗାର	ɖɔŋgaːɾɔ
ପ୍ରଥମ	pɾɔt̪ʰɔmɔ
ଫାଳିଆରେ	pʰaːl̪iaːre
ପା	paː
ଅଷ୍ଟମ	ɔsʈɔmɔ
ରୁ	ru
ଡାଳରୁ	ɖaːl̪ɔru
ବୀର	biɾɔ
ଯେଉଁ	d͡ʒeũ
ଶୀତରୁ	sit̪ɔru
ବିଭକ୍ତ	bibʰɔkt̪ɔ
ସତ	sɔt̪ɔ
ଫାଳିଆ	pʰaːl̪iaː
ଅଟୁ	ɔʈu
ପାରିବିକି	paːribiki
ସଦର	sɔd̪ɔɾɔ
ଆଜ୍ଞା	aːd͡ʒɲaː
ବତଉଚି	bɔt̪ɔut͡ʃi
ପକେଇକି	pɔkeiki
ଅପେକ୍ଷା	ɔpekʰjaː
ଛତୁଗୁଡ଼ିକ	t͡ʃʰɔt̪uguɽikɔ
ମିଠାର	miʈʰaːɾɔ
ପେଟକୁ	peʈɔku
ଢୋକେ	ɖʱoke
ତିନିକୋଣିଆ	t̪inikoɳiaː
ଲେଖିଥିଲେ	lekʰit̪ʰile
ନଭେମ୍ବର	nɔbʱembɔɾɔ
ଢାଳି	ɖʱaːl̪i
ବୁଢ଼ା	buɽʱaː
କୋଉଠି	kouʈʰi
ୟେଲ୍ଲୁ	jellu
ଯାଇଥାଏ	d͡ʒaːit̪ʰaːe
ଖରାଦିନିଆ	kʰɔraːd̪iniaː
କାଳୀନ	kaːl̪inɔ
ଡାକ୍ଟରଙ୍କ	ɖaːkʈɔɾɔŋkɔ
ପଟିଟି	pɔʈiʈi
ସାଧିବା	saːd̪ʱibaː
ବୈଶାଖ	bɔisaːkʰɔ
କହୁ	kɔhu
ଚେର	t͡ʃeɾɔ
ଲେଣି	leɳi
ଅସରପା	ɔsɔɾɔpaː
ରାଜକୀୟ	raːd͡ʒɔkijɔ
ତୋଲିଲା	t̪olilaː
ଜ୍ଞାନକୋଷ	d͡ʒɲaːnɔkosɔ
ଷ୍ଟୁଲ୍	sʈul
ତିନି	t̪ini
ଚିହ୍ନ	t͡ʃihnɔ
ସଂସ୍କୃତରେ	sɔŋskrut̪ɔre
ପରସ୍ପରକୁ	pɔɾɔspɔɾɔku
ଗରିବ	ɡɔribɔ
ପଡ଼ିଆ	pɔɽiaː
ବୃକ୍ଷ	brukʰjɔ
ଓଡ଼ିଆ	oɽiaː
ରୁମ୍	rum
ନଈରେ	nɔire
ୱାଡା	uaːɖaː
ଦଶ	d̪ɔsɔ
ସବୁଦିଗକୁ	sɔbud̪iɡɔku
ମକଚିଲା	mɔkɔt͡ʃilaː
ପାଟି	paːʈi
କରିକି	kɔriki
ପ୍ରସ୍ତୁତି	pɾɔst̪ut̪i
ଗଙ୍ଗାଧର	ɡɔŋgaːd̪ʱɔɾɔ
ଇଣ୍ଡିଆ	iɳɖiaː
ଚିଡ଼ାଇଲା	t͡ʃiɽaːilaː
ମାଆମାନେ	maːaːmaːne
ଦେଖିଲ	d̪ekʰilɔ
ପଥରରେ	pɔt̪ʰɔɾɔre
ସ୍କୁଲରେ	skulɔre
ସିଝିବ	sid͡ʒʱibɔ
କାଲି	kaːli
ଅଣ	ɔɳɔ
ଖୋଜନ୍ତି	kʰod͡ʒɔnt̪i
କହେ	kɔhe
କରିପାରିବ	kɔripaːribɔ
କାମ	kaːmɔ
ଫଳମାନେ	pʰɔl̪ɔmaːne
ପାଳିବୁ	paːl̪ibu
ଗୁଣ୍ଡ	guɳɖɔ
ବୁମ୍ମ୍	bumm
ପାହାରେ	paːhaːre
ଖାଲି	kʰaːli
ପୋଖରୀଟି	pokʰɔriʈi
ଖାଇବାକୁ	kʰaːibaːku
ଧାଇଁଲା	d̪ʱaːĩlaː
ଦହି	d̪ɔhi
ରଖୁଥିଲା	ɾɔkʰut̪ʰilaː
ସୈନିକ	sɔinikɔ
ବାଜାଟିକୁ	baːd͡ʒaːʈiku
କହିଦେ	kɔhid̪e
ରଥରେ	ɾɔt̪ʰɔre
ଜିଲାପି	d͡ʒilaːpi
ସେମାନଙ୍କୁ	semaːnɔŋku
ଡିଆଁ	ɖiaː̃
ପୁଜା	pud͡ʒaː
କଥାରେ	kɔt̪ʰaːre
ଅନ୍ୟାନ୍ୟ	ɔnjaːnjɔ
ପେଡ଼ି	peɽi
ସମ୍ବନ୍ଧରେ	sɔmbɔnd̪ʱɔre
ପ୍ରସଙ୍ଗରେ	pɾɔsɔŋɡɔre
ଗୁଣୁଗୁଣୁ	guɳuguɳu
ଫୁଟେଇବା	pʰuʈeibaː
ଦୁଇଦିନ	d̪uid̪inɔ
ହଉଛି	hɔut͡ʃʰi
ଶିଖାଇଦେଲେ	sikʰaːid̪ele
ଆସିଥାଏଇମ୍ମା	aːsit̪ʰaːeimmaː
ଧରିଲାଣି	d̪ʱɔrilaːɳi
ହୋଇଥିଲେ	hoit̪ʰile
ହରଣ	hɔɾɔɳɔ
କେକ୍‌	kek
ଆଣିବୁ	aːɳibu
ଭାବିପାରୁ	bʱaːbipaːru
ଡିଭାଇଡର୍‌ରେ	ɖibʱaːiɖɔrre
କହିଲିକି	kɔhiliki
ସଂଗ୍ରାମୀ	sɔŋgraːmi
ମିଠା	miʈʰaː
ଗାଲିଚାଠାରୁ	gaːlit͡ʃaːʈʰaːru
ପୃଷ୍ଠା	prusʈʰaː
ବଲବ୍	bɔlɔb
ବାହାରିଯିବ	baːhaːrid͡ʒibɔ
ରହିଗଲି	ɾɔhiɡɔli
ଗ୍ରହଣ	gɾɔhɔɳɔ
ଗଢ଼ଣଟି	ɡɔɽʱɔɳɔʈi
ମୁଣି	muɳi
ଅଦ୍ୱିତୀୟ	ɔd̪uit̪ijɔ
ପ୍ରାନ୍ତରୁ	praːnt̪ɔru
ଆସୁ	aːsu
ବାଲାଙ୍କ	baːlaːŋkɔ
ମଣିପୁରୀ	mɔɳipuri
ନିର୍ଦ୍ଦେଶନାରେ	nird̪d̪esɔnaːre
ରାଜୁ	raːd͡ʒu
ଅତିଥିଙ୍କ	ɔt̪it̪ʰiŋkɔ
ପୁଅକୁ	puɔku
ବିକୃତ	bikrut̪ɔ
ପୁଡିଆ	puɖiaː
ଚେୟାର	t͡ʃejaːɾɔ
ଜୀବନରେ	d͡ʒibɔnɔre
ତୁମଠାରୁ	t̪umɔʈʰaːru
ବିହାରର	bihaːɾɔɾɔ
ଗୁଣ୍ଡୁଚି	guɳɖut͡ʃi
ଥାଆନ୍ତି	t̪ʰaːaːnt̪i
ଗଲି	ɡɔli
ପକାଇଲା	pɔkaːilaː
ଏବିଷୟରେ	ebisɔjɔre
ଶ୍ରୀମନ୍ଦିରରେ	srimɔnd̪iɾɔre
ଡାକ	ɖaːkɔ
ସ୍ଵପ୍ନ	suɔpnɔ
ପ୍ରତ୍ୟେକ	pɾɔt̪jekɔ
ତାରିଖ	t̪aːrikʰɔ
ରଚନାବଳୀ	ɾɔt͡ʃɔnaːbɔl̪i
ଜୟ	d͡ʒɔjɔ
କାହିଁକି	kaːhĩki
ଚଢି	t͡ʃɔɖʱi
ବୃହତ୍ତମ	bruhɔt̪t̪ɔmɔ
ପାଳିଛି	paːl̪it͡ʃʰi
ମି	mi
ଆଗାମୀ	aːgaːmi
ଦୁଇଜଣ	d̪uid͡ʒɔɳɔ
ନିର୍ବାଚିତ	nirbaːt͡ʃit̪ɔ
କାରଖାନା	kaːɾɔkʰaːnaː
ନିଗମ	niɡɔmɔ
ଭାଙ୍ଗ	bʱaːŋɡɔ
ପହଞ୍ଚିଗଲେ	pɔhɔɲt͡ʃiɡɔle
ବାହାରିଛୁ	baːhaːrit͡ʃʰu
ପାଟିରୁ	paːʈiru
ଆକାଶବାଣୀ	aːkaːsɔbaːɳi
ଲିଫ୍‌ଟରେ	lipʰʈɔre
ମହୁ	mɔhu
କାଟୋକୁ	kaːʈoku
ସାନ	saːnɔ
ଅଭିନୀତ	ɔbʱinit̪ɔ
ତନ୍ମଧ୍ୟରୁ	t̪ɔnmɔd̪ʱjɔru
ମନୋରମ	mɔnoɾɔmɔ
ମାସେ	maːse
ଧପ୍	d̪ʱɔp
ଗୁଡ଼	guɽɔ
ଶ୍ରୀରାମ	sriraːmɔ
କଅଁଳ	kɔɔ̃l̪ɔ
କଲ	kɔlɔ
ମମତା	mɔmɔt̪aː
ଭେନୁ	bʱenu
ବଟ୍	bɔʈ
ନିର୍ଜନ	nird͡ʒɔnɔ
ପଛରେ	pɔt͡ʃʰɔre
ମାଟି	maːʈi
ୟିବା	jibaː
ଜଗନ୍ନାଥ	d͡ʒɔɡɔnnaːt̪ʰɔ
ତାର	t̪aːɾɔ
ଲୁଣ	luɳɔ
ରହ	ɾɔhɔ
ଘୋଡାରୁ	gʰoɖaːru
ଛୋଳି	t͡ʃʰol̪i
ନହେଲେ	nɔhele
ପରିଷଦ	pɔrisɔd̪ɔ
ଚାଲିପାରିବେନି	t͡ʃaːlipaːribeni
ପଟ	pɔʈɔ
ହେଇପାରେ	heipaːre
ଟାଣିଲା	ʈaːɳilaː
ଭିଜେଇ	bʱid͡ʒei
ମୀରା	miraː
ଜିଲ୍ଲା	d͡ʒillaː
ଗାତ	gaːt̪ɔ
ଲାର୍ଭା	laːrbʱaː
ସମ୍ପୃକ୍ତ	sɔmprukt̪ɔ
ସାଗର	saːɡɔɾɔ
ଲଗେଇବାକୁ	lɔgeibaːku
ଯାଉଯାଉ	d͡ʒaːud͡ʒaːu
ରଂଗର	ɾɔŋɡɔɾɔ
ଗଛଟିଏ	ɡɔt͡ʃʰɔʈie
ଲାଗିଲାଣି	laːgilaːɳi
ସ୍ଵାସ୍ଥ୍ୟ	suaːst̪ʰjɔ
ଇଂରାଜୀରେ	iŋraːd͡ʒire
ଅଭିନୟରେ	ɔbʱinɔjɔre
ଇମ୍ମାଙ୍କ	immaːŋkɔ
ଯାହାଙ୍କ	d͡ʒaːhaːŋkɔ
ଦିଶୁଥିବା	d̪isut̪ʰibaː
କରିପାରିଲା	kɔripaːrilaː
ଧର୍ମର	d̪ʱɔrmɔɾɔ
ଭରିଚାଲିଲା	bʰɔrit͡ʃaːlilaː
କହିଲେନି	kɔhileni
ପଳାଉଥିଲେ	pɔl̪aːut̪ʰile
ସଉଦା	sɔud̪aː
ପକାଇଲି	pɔkaːili
କହିବୁନି	kɔhibuni
ମିନିଟ୍	miniʈ
ସବୁଠାରୁ	sɔbuʈʰaːru
ପେଟେ	peʈe
ବିହାର	bihaːɾɔ
ବିଶେଷତା	bisesɔt̪aː
ବାକ୍ସଟିକୁ	baːksɔʈiku
ଉଦୟଗିରି	ud̪ɔjɔgiri
ହାଲକା	haːlɔkaː
ପିଁ	pĩ
ଫ୍ରକ୍	pʰɾɔk
ଗାଉଛନ୍ତି	gaːut͡ʃʰɔnt̪i
ଡାଇନୋସରଟି	ɖaːinosɔɾɔʈi
ଧରିତ୍ରୀ	d̪ʱɔrit̪ri
ବିଜୁଳି	bid͡ʒul̪i
ମାରିବି	maːribi
ପଡିଗଲାଣି	pɔɖiɡɔlaːɳi
ଟାଙ୍କି	ʈaːŋki
କମରପଟି	kɔmɔɾɔpɔʈi
କଲେ	kɔle
ସମାଧାନ	sɔmaːd̪ʱaːnɔ
ବାସ୍ନା	baːsnaː
ଦକ୍ଷିଣ	d̪ɔkʰiɳɔ
ସିନେ	sine
ଓଡ଼ିଶାରେ	oɽisaːre
ଅଂଶୁମାନ	ɔŋsumaːnɔ
ବିଗ୍ରହ	bigɾɔhɔ
ଖଣ୍ଡିଏ	kʰɔɳɖie
ବୁଣିବି	buɳibi
ବ୍ଲକ	blɔkɔ
ଉଡ଼େଇ	uɽei
ଖେଳାଳି	kʰel̪aːl̪i
ସୁବାସ	subaːsɔ
ଜଣାଯାଉଛି	d͡ʒɔɳaːd͡ʒaːut͡ʃʰi
ପଳେଇ	pɔl̪ei
ଶୁଣିପାର	suɳipaːɾɔ
ହାଇଦ୍ରାବାଦ	haːid̪raːbaːd̪ɔ
ଭିଜି	bʱid͡ʒi
ବଗିଚା	bɔgit͡ʃaː
ଝରଣାଟିଏ	d͡ʒʱɔɾɔɳaːʈie
ବରକୁ	bɔɾɔku
ଦଂଶ	d̪ɔŋsɔ
ଏହା	ehaː
ଜଗନ୍ନାଥଙ୍କ	d͡ʒɔɡɔnnaːt̪ʰɔŋkɔ
ହେଲାଣି	helaːɳi
ସାହସ	saːhɔsɔ
ଉଁ	ũ
ଗଡ଼ଗଡ଼	ɡɔɽɔɡɔɽɔ
ଚମକିବାକୁ	t͡ʃɔmɔkibaːku
ଶୂଚନା	sut͡ʃɔnaː
ପରିମାଣର	pɔrimaːɳɔɾɔ
ରହିବ	ɾɔhibɔ
ତୁମର	t̪umɔɾɔ
ଯଦିଓ	d͡ʒɔd̪io
ସ୍ଥାନ	st̪ʰaːnɔ
ବଦଳ	bɔd̪ɔl̪ɔ
ମଣ୍ଡଳ	mɔɳɖɔl̪ɔ
ହ୍ୟାପୀ	hjaːpi
ଦସ୍ତାନ	d̪ɔst̪aːnɔ
ଚାଲି	t͡ʃaːli
ଜଗତସିଂହପୁର	d͡ʒɔɡɔt̪ɔsiŋhɔpuɾɔ
ଠିପି	ʈʰipi
ଓଟ	oʈɔ
ଜି	d͡ʒi
ଗୁଲି	guli
ପଥରକୁ	pɔt̪ʰɔɾɔku
କୁହା	kuhaː
ତୁଳାର	t̪ul̪aːɾɔ
ଡରିଗଲା	ɖɔriɡɔlaː
କୁଖ୍ୟାତି	kukʰjaːt̪i
ଜାଣୁ	d͡ʒaːɳu
କାମଟି	kaːmɔʈi
ଆଧୁନିକ	aːd̪ʱunikɔ
ପିଲାଟିର	pilaːʈiɾɔ
ଆଇ	aːi
ଉଡ଼ିଚାଲ	uɽit͡ʃaːlɔ
ଝାଉଁଳି	d͡ʒʱaːũl̪i
ଲାଜୁଆ	laːd͡ʒuaː
ମଣିଷମାନଙ୍କ	mɔɳisɔmaːnɔŋkɔ
ଦୁଷ୍ଟ	d̪usʈɔ
କଲମ	kɔlɔmɔ
ଛତୁଗୁଡ଼ିକୁ	t͡ʃʰɔt̪uguɽiku
ପ୍ରଣାମ	pɾɔɳaːmɔ
ନୌକାଟେ	nɔukaːʈe
ଫୁର୍-ଫୁର୍	pʰur-pʰur
ନେବି	nebi
ଥଣ୍ଡା	t̪ʰɔɳɖaː
ଫେରିଲେନି	pʰerileni
ଆଗୁଆ	aːguaː
ରାଷ୍ଟ୍ର	raːsʈɾɔ
କୋଉ	kou
ଲୋକସଭା	lokɔsɔbʱaː
ରାଜ୍ୟରେ	raːd͡ʒjɔre
ପଡ଼ିଆରେ	pɔɽiaːre
ବୋଧହୁଏ	bod̪ʱɔhue
ଯତ୍ନରେ	d͡ʒɔt̪nɔre
ଲୁସିଫେରାସ୍	lusipʰeraːs
ଖେଳିବା	kʰel̪ibaː
ଗୁଜରାଟ	gud͡ʒɔraːʈɔ
ହସିବାକୁ	hɔsibaːku
ଋତୁରେ	rut̪ure
କଷ୍ଟ	kɔsʈɔ
ମୁହାଁ	muhaː̃
ଜୀବନର	d͡ʒibɔnɔɾɔ
କୁସ୍ତି	kust̪i
ପାନିପଥ	paːnipɔt̪ʰɔ
ଜିନିଷକୁ	d͡ʒinisɔku
ଉଡିବୁଲିବାକୁ	uɖibulibaːku
କମଳା	kɔmɔl̪aː
ସନ୍ତାନ	sɔnt̪aːnɔ
ହଜିଥିବା	hɔd͡ʒit̪ʰibaː
ଜହ୍ନ	d͡ʒɔhnɔ
ପାଳିତ	paːl̪it̪ɔ
ସମ୍ପୁର୍ଣ୍ଣ	sɔmpurɳɳɔ
ନିମୋନିଆ	nimoniaː
ବାମନ	baːmɔnɔ
ଅଧାଗଢା	ɔd̪ʱaːɡɔɖʱaː
ନୂଆପଡ଼ା	nuaːpɔɽaː
କୋଷ	kosɔ
ପତାକା	pɔt̪aːkaː
ଟିକିଏ	ʈikie
ଗୋଡ଼ି	goɽi
ତକିଆ	t̪ɔkiaː
ସାମ୍ରାଜ୍ୟ	saːmraːd͡ʒjɔ
ତେଢ଼ାମେଢ଼ା	t̪eɽʱaːmeɽʱaː
ଅସଲରେ	ɔsɔlɔre
ବସିଗଲେ	bɔsiɡɔle
ଗୁମ୍ଫା	gumpʰaː
ପେଟରେ	peʈɔre
ବୟସର	bɔjɔsɔɾɔ
ପଡେନାହିଁ	pɔɖenaːhĩ
ବ୍ରସ୍	bɾɔs
ଘାସ	gʰaːsɔ
ବିଷୟ	bisɔjɔ
ଟଙ୍କାରେ	ʈɔŋkaːre
କୁ	ku
ହୁଅନ୍ତିନି	huɔnt̪ini
ସିନେମା	sinemaː
ପିନ୍ଧିଛି	pind̪ʱit͡ʃʰi
ଅଜଣା	ɔd͡ʒɔɳaː
ଯାଆନ୍ତି	d͡ʒaːaːnt̪i
ସାମାନ୍ୟ	saːmaːnjɔ
ପର୍ଯ୍ୟଟନ	pɔrd͡ʒjɔʈɔnɔ
ଗ୍ରାମରେ	graːmɔre
କରନ୍ତି	kɔɾɔnt̪i
ସମସ୍ତ	sɔmɔst̪ɔ
ଧ୍ୟାନମଗ୍ନ	d̪ʱjaːnɔmɔgnɔ
ବାସନା	baːsɔnaː
ଲୁହା	luhaː
ସୋଫାରେ	sopʰaːre
ଚାଲିଯାଇଛନ୍ତି	t͡ʃaːlid͡ʒaːit͡ʃʰɔnt̪i
ସାରିଥିଲା	saːrit̪ʰilaː
ଭୂଖଣ୍ଡ	bʱukʰɔɳɖɔ
ଥିଲାଇମ୍ମା	t̪ʰilaːimmaː
ଖୁସିରେ	kʰusire
ଆବଶ୍ୟକ	aːbɔsjɔkɔ
ସଂଳାପ	sɔŋl̪aːpɔ
ସଙ୍ଗେ	sɔŋge
ବହିଗୁଡ଼ିକ	bɔhiguɽikɔ
ଜେଜେବାପା	d͡ʒed͡ʒebaːpaː
ଯାହାହେଉ	d͡ʒaːhaːheu
ଲାଗୁନି	laːguni
ନାୟକ	naːjɔkɔ
ଉନ୍ନତି	unnɔt̪i
ଚିବୁକ	t͡ʃibukɔ
ଆମ୍ବ	aːmbɔ
ଟପିଲେ	ʈɔpile
ମଷ୍ତିଷ୍କ	mɔst̪iskɔ
ମହିଳା	mɔhil̪aː
ବୁଜି	bud͡ʒi
ନିର୍ମଳ	nirmɔl̪ɔ
ଯାଇଥିଲେ	d͡ʒaːit̪ʰile
ଦେବ	d̪ebɔ
ଧନ୍ୟବାଦ	d̪ʱɔnjɔbaːd̪ɔ
ହାଃ	haːh
ଶୁଣାନ୍ତି	suɳaːnt̪i
ବରୁଣ	bɔruɳɔ
ସିନ୍ଦୂର	sind̪uɾɔ
କିଣ	kiɳɔ
କାନର	kaːnɔɾɔ
ହଜୁର୍	hɔd͡ʒur
ସେତେବେଳେ	set̪ebel̪e
ଦାମ୍	d̪aːm
ଘୁରୁଥିଲା	gʰurut̪ʰilaː
ପୁରୁଣା	puruɳaː
ମାଲୟାଲମ	maːlɔjaːlɔmɔ
ଗାଇପାରୁଥିବ	gaːipaːrut̪ʰibɔ
ରେଭେନ୍ସା	rebʱensaː
ରୋହନ	rohɔnɔ
ନିଅନ୍ତୁ	niɔnt̪u
ପଢ଼ିବା	pɔɽʱibaː
ଆଗରେ	aːɡɔre
ଉତ୍କଳ	ut̪kɔl̪ɔ
ବାହାରନ୍ତେ	baːhaːɾɔnt̪e
ଦେଖାଇ	d̪ekʰaːi
କଢ଼େଇ	kɔɽʱei
ବସେ	bɔse
ବିଜୁଳିର	bid͡ʒul̪iɾɔ
ଆଗ୍ରହରେ	aːgɾɔhɔre
ଲାଗିଲାନି	laːgilaːni
ପରୀ	pɔri
ଆପଣତ	aːpɔɳɔt̪ɔ
ଟୋକେଇରେ	ʈokeire
ଉପମା	upɔmaː
ବହିର	bɔhiɾɔ
ଗଞ୍ଜାମ	ɡɔɲd͡ʒaːmɔ
କୁମ୍ଭାରୁଣୀ	kumbʱaːruɳi
କ୍ଷତ	kʰjɔt̪ɔ
ନଡ଼ିଆ	nɔɽiaː
ଧାଡ଼ି	d̪ʱaːɽi
ଆକ୍ରମଣ	aːkɾɔmɔɳɔ
ଘଷୁଥିଲେ	ɡʱɔsut̪ʰile
ପାଳି	paːl̪i
ଚାହୁଁନଥିଲା	t͡ʃaːhũnɔt̪ʰilaː
ସହରକୁ	sɔhɔɾɔku
ମସ୍ତିଷ୍କ	mɔst̪iskɔ
କାଳେ	kaːl̪e
ମନମୋହନ	mɔnɔmohɔnɔ
ପାଇଯିବା	paːid͡ʒibaː
ଜନ	d͡ʒɔnɔ
ସ୍ମୃତି	smrut̪i
ସଂସଦ	sɔŋsɔd̪ɔ
ପକାଇବା	pɔkaːibaː
ଜୀବନୀ	d͡ʒibɔni
ଚାରିପଟେ	t͡ʃaːripɔʈe
ଭି	bʱi
ଏଠାରେ	eʈʰaːre
ପାଟିରେ	paːʈire
ତାହାକୁ	t̪aːhaːku
ବଜାରରୁ	bɔd͡ʒaːɾɔru
ଚୋରଙ୍କୁ	t͡ʃoɾɔŋku
ମିଶେଇ	misei
ଗଲାବେଳେ	ɡɔlaːbel̪e
ଚାଷୀଟି	t͡ʃaːsiʈi
ହଲନ୍ତି	hɔlɔnt̪i
ଧରି	d̪ʱɔri
ଜାଲନେଇ	d͡ʒaːlɔnei
ମାଡ଼	maːɽɔ
ଭାଷା	bʱaːsaː
କପଡା	kɔpɔɖaː
ଏକାଡେମି	ekaːɖemi
ଲଢିବ	lɔɖʱibɔ
ଜ୍ଞାନ	d͡ʒɲaːnɔ
ରାଜାଂକ	raːd͡ʒaːŋkɔ
ଦୋକାନ	d̪okaːnɔ
ଡେଇଁବୁ	ɖeĩbu
ଲାଗିଯାଅ	laːgid͡ʒaːɔ
ପହଂଚିଲେ	pɔhɔŋt͡ʃile
ଶ୍ରୀଲଙ୍କା	srilɔŋkaː
ଆକାଶକୁ	aːkaːsɔku
ଗପ୍ପୁ	ɡɔppu
ବୁଲୁଥିଲେ	bulut̪ʰile
କୃମି	krumi
ପଡ଼ିବ	pɔɽibɔ
ପାଇଲେନି	paːileni
ଚିଠି	t͡ʃiʈʰi
ହୋଇ	hoi
ଆକାଶର	aːkaːsɔɾɔ
ଠା	ʈʰaː
ପରତ	pɔɾɔt̪ɔ
ବ୍ୟାୟାମ	bjaːjaːmɔ
ଭୁଲ୍	bʱul
ଚମକୁ	t͡ʃɔmɔku
ନାଚେ	naːt͡ʃe
ପୋଷକ	posɔkɔ
ଟିଭି	ʈibʱi
ମଟରସାଇକେଲ	mɔʈɔɾɔsaːikelɔ
ହସୁଛନ୍ତି	hɔsut͡ʃʰɔnt̪i
ଦିଅନ୍ତୁ	d̪iɔnt̪u
ପାଚେର	paːt͡ʃeɾɔ
ଥକି	t̪ʰɔki
ପିମ୍ପୁଡ଼ି	pimpuɽi
ଶାଗୁଆ	saːguaː
ଏଇନା	einaː
ସ୍ଵରୂପ	suɔrupɔ
ପୁତ୍ର	put̪ɾɔ
ଦୌଡୁଥିଲା	d̪ɔuɖut̪ʰilaː
ଶୁଂଘି	suŋgʰi
କୋର୍ଟଟି	korʈɔʈi
ଚିକିମିକିଆ	t͡ʃikimikiaː
ମୁଣ୍ଡଭିତରେ	muɳɖɔbʱit̪ɔre
ଦଳର	d̪ɔl̪ɔɾɔ
ଚିହ୍ନବର୍ଣ୍ଣ	t͡ʃihnɔbɔrɳɳɔ
ଇବୋକ୍	ibok
ଅବରୁଦ୍ଧ	ɔbɔrud̪d̪ʱɔ
ପଡ଼ିବନି	pɔɽibɔni
ରଖା	ɾɔkʰaː
ଜଳନ୍ତି	d͡ʒɔl̪ɔnt̪i
ଭୁକି	bʱuki
ଯତ୍ନର	d͡ʒɔt̪nɔɾɔ
ମରୁଭୂମିର	mɔrubʱumiɾɔ
ଏହାଯୋଗୁଁ	ehaːd͡ʒogũ
ଆଶୁତୋଷ	aːsut̪osɔ
ପଛ	pɔt͡ʃʰɔ
ଗେଟ୍	geʈ
ଲାଗୁଥାଏ	laːgut̪ʰaːe
ଚାହିଁଲା	t͡ʃaːhĩlaː
କାଠିର	kaːʈʰiɾɔ
ବାଲି	baːli
ଦିଶୁଥିଲେ	d̪isut̪ʰile
ଚଷମା	t͡ʃɔsɔmaː
ଖଂଜିତ	kʰɔŋd͡ʒit̪ɔ
ଦାନ	d̪aːnɔ
ମୋବାଇଲ	mobaːilɔ
ଅବସ୍ଥା	ɔbɔst̪ʰaː
ଅନ୍ଧକାର	ɔnd̪ʱɔkaːɾɔ
ଦେଲେ	d̪ele
ଗୀତ	git̪ɔ
ବ୍ୟବହାରରେ	bjɔbɔhaːɾɔre
କହୁଥାନ୍ତି	kɔhut̪ʰaːnt̪i
ତରଳ	t̪ɔɾɔl̪ɔ
ରଙ୍ଗମଞ୍ଚରେ	ɾɔŋɡɔmɔɲt͡ʃɔre
ଆସିଥିଲେ	aːsit̪ʰile
ଶୁଣା	suɳaː
ବାଣୀକୁ	baːɳiku
ପ୍ରଚଳନ	pɾɔt͡ʃɔl̪ɔnɔ
ଲୁସିଅସ୍	lusiɔs
କରନା	kɔɾɔnaː
ଓହ୍ଲାଇବା	ohlaːibaː
ବିଭାଗରେ	bibʱaːɡɔre
ବେଳେବେଳେ	bel̪ebel̪e
କୁହାଯାଇଥାଏ	kuhaːd͡ʒaːit̪ʰaːe
ବିଧାନ	bid̪ʱaːnɔ
ଖୁଆଇବାକୁ	kʰuaːibaːku
ହାରାହାରି	haːraːhaːri
ନୂଆ	nuaː
ଗୁଣନ	guɳɔnɔ
କାହାଠୁ	kaːhaːʈʰu
ବାଜିଲାଣି	baːd͡ʒilaːɳi
ଚୂଲିରୁ	t͡ʃuliru
ଠାରୁ	ʈʰaːru
ଜାହାନାରା	d͡ʒaːhaːnaːraː
ରୋମ	romɔ
ବିନା	binaː
ସାମୁଦ୍ରିକ	saːmud̪rikɔ
ଆଦିରେ	aːd̪ire
କଷ୍ଟରେ	kɔsʈɔre
ପ୍ରତିଦିନ	pɾɔt̪id̪inɔ
କଶ୍ମିରୀ	kɔsmiri
ସ୍ୱରରେ	suɔɾɔre
ମୋହନ	mohɔnɔ
ଆଶ୍ରମବାସୀ	aːsɾɔmɔbaːsi
ଏପଟ-ସେପଟ	epɔʈɔ-sepɔʈɔ
ରଖିଗଲା	ɾɔkʰiɡɔlaː
ପଡ଼ିଛି	pɔɽit͡ʃʰi
ବେସିନ୍	besin
ରହିଥିବା	ɾɔhit̪ʰibaː
ପଟି	pɔʈi
ସ୍ଵଳ୍ପ	suɔl̪pɔ
ହେଲା	helaː
ଖାଇବାଠାରୁ	kʰaːibaːʈʰaːru
ତୋତା	t̪ot̪aː
ମୋଗଲ	moɡɔlɔ
କଚକଚିଆ	kɔt͡ʃɔkɔt͡ʃiaː
ପୋଷାକକୁ	posaːkɔku
ପୁରୁଣାପତ୍ରିକା	puruɳaːpɔt̪rikaː
କୃଷ୍ଣଚନ୍ଦ୍ର	krusɳɔt͡ʃɔnd̪ɾɔ
ପବିତ୍ର	pɔbit̪ɾɔ
ମିଳାଇ	mil̪aːi
କଟିଲା	kɔʈilaː
ଏଭଳି	ebʰɔl̪i
କାନ୍ଦୁଛି	kaːnd̪ut͡ʃʰi
ଶୀତରେ	sit̪ɔre
ନଥାନ୍ତି	nɔt̪ʰaːnt̪i
ନାମ	naːmɔ
ଶିକ୍ଷକଙ୍କ	sikʰjɔkɔŋkɔ
ଟି	ʈi
ଥପା	t̪ʰɔpaː
ଯାଇପାରିବେ	d͡ʒaːipaːribe
ଲାଗିଯିବ	laːgid͡ʒibɔ
ପାଠାଗାର	paːʈʰaːgaːɾɔ
ଶତାବ୍ଦୀର	sɔt̪aːbd̪iɾɔ
ବଗିଚାରୁ	bɔgit͡ʃaːru
ରାମାୟଣ	raːmaːjɔɳɔ
ଛିଃ	t͡ʃʰih
ଶସ୍ୟ	sɔsjɔ
ଦେଖିବୁ	d̪ekʰibu
ସୀତା	sit̪aː
ହୋଇଥାନ୍ତି	hoit̪ʰaːnt̪i
ଗର୍ବର	ɡɔrbɔɾɔ
ପଦ୍ମଶ୍ରୀ	pɔd̪mɔsri
ବୁଝିଯାଇଥିବ	bud͡ʒʱid͡ʒaːit̪ʰibɔ
ବନ୍ଧ	bɔnd̪ʱɔ
ଭାବୁଥିଲା	bʱaːbut̪ʰilaː
ଚଢନ୍ତି	t͡ʃɔɖʱɔnt̪i
ସ୍କୁଲର	skulɔɾɔ
ପୂର୍ଣ୍ଣଚନ୍ଦ୍ର	purɳɳɔt͡ʃɔnd̪ɾɔ
ଜନନୀ	d͡ʒɔnɔni
ମିସ୍	mis
ଚାରିକୋଣିଆ	t͡ʃaːrikoɳiaː
ଦୁଧ	d̪ud̪ʱɔ
ଫୁଟା	pʰuʈaː
ନାକକୁ	naːkɔku
ଆଙ୍ଗୁଠିମାନେ	aːŋguʈʰimaːne
ଶେଖର	sekʰɔɾɔ
ହାଡ଼ଟିକୁ	haːɽɔʈiku
ବିଶାଳ	bisaːl̪ɔ
ଗଧିଆମାନେ	ɡɔd̪ʱiaːmaːne
ସେଇଟା	seiʈaː
ଖୋଳିବା	kʰol̪ibaː
ଦୌଡୁ	d̪ɔuɖu
ମହାନ୍ତି	mɔhaːnt̪i
ଦେଖିବାକୁ	d̪ekʰibaːku
ମହଲାରୁ	mɔhɔlaːru
ରଖାଯାଏ	ɾɔkʰaːd͡ʒaːe
ତୁତିର	t̪ut̪iɾɔ
ଆଖିରେ	aːkʰire
ପ୍ରମୁଖ	pɾɔmukʰɔ
ଆଲୋକିତ	aːlokit̪ɔ
ପେଟରୁ	peʈɔru
ଧାଇଁ	d̪ʱaːĩ
ପିଆଜ	piaːd͡ʒɔ
ଜାଣ	d͡ʒaːɳɔ
ଖାଉ	kʰaːu
କରୁଛ	kɔrut͡ʃʰɔ
ସାବଧାନତା	saːbɔd̪ʱaːnɔt̪aː
ଗୁପ୍ତଚର	gupt̪ɔt͡ʃɔɾɔ
ବଡ଼ମାଛ	bɔɽɔmaːt͡ʃʰɔ
ବସୁଥିଲେ	bɔsut̪ʰile
ବାପା-ବିଲେଇ	baːpaː-bilei
କୁହାଯାଏ	kuhaːd͡ʒaːe
ପିନ୍ଧିବା	pind̪ʱibaː
ଖେଳେ	kʰel̪e
ମାସରେ	maːsɔre
ଯେଉଁଟା	d͡ʒeũʈaː
ତମର	t̪ɔmɔɾɔ
ସ୍ଥାପିତ	st̪ʰaːpit̪ɔ
ପରିଚାଳନା	pɔrit͡ʃaːl̪ɔnaː
ହାରିନଥିଲେ	haːrinɔt̪ʰile
ଧଳା	d̪ʱɔl̪aː
ବଗିଚାରେ	bɔgit͡ʃaːre
ନବମୀ	nɔbɔmi
ଥିବାବେଳେ	t̪ʰibaːbel̪e
ପୃଥିବୀ	prut̪ʰibi
ବର୍ଫି	bɔrpʰi
ବେଞ୍ଚ	beɲt͡ʃɔ
ସାମନାରଠିଆ	saːmɔnaːɾɔʈʰiaː
ଆଲମାରୀ	aːlɔmaːri
ଭାଂଗୀ	bʱaːŋgi
ତୋର	t̪oɾɔ
ପ୍ରେସ	presɔ
ତାରେ	t̪aːre
ତେଲ	t̪elɔ
ଭୁବନେଶ୍ଵର	bʱubɔnesuɔɾɔ
ପ୍ରକୃତି	pɾɔkrut̪i
ଭିଡ଼	bʱiɽɔ
ଘଡ଼	ɡʱɔɽɔ
ମନୁଷ୍ୟ	mɔnusjɔ
ଭାଇକୁ	bʱaːiku
ଆଣ୍ଟାରେ	aːɳʈaːre
ପାଣିକୁ	paːɳiku
କ୍ରମେ	kɾɔme
ଦୌଡ଼ିଗଲା	d̪ɔuɽiɡɔlaː
ଦେଖାଯାଉଛନ୍ତି	d̪ekʰaːd͡ʒaːut͡ʃʰɔnt̪i
ଡ଼େଇଁ	ɽeĩ
ହଲାଇଲେ	hɔlaːile
ଜଣକରୁ	d͡ʒɔɳɔkɔru
ତଳୁ	t̪ɔl̪u
ସାସ୍ଥ୍ୟ	saːst̪ʰjɔ
ସାତଟା	saːt̪ɔʈaː
ପରିଶ୍ରମରେ	pɔrisɾɔmɔre
ଶେଷକୁ	sesɔku
ଟୁଲୁ	ʈulu
ଦୁଃସାହସ	d̪uhsaːhɔsɔ
କରାଯାଉଥିଲା	kɔraːd͡ʒaːut̪ʰilaː
ନୂତନ	nut̪ɔnɔ
ମାପିକି	maːpiki
ଦାସ	d̪aːsɔ
ଦୀପାବଳି	d̪ipaːbɔl̪i
ସ୍ବାଦିଷ୍ଟ	sbaːd̪isʈɔ
ରଥ	ɾɔt̪ʰɔ
ତାକଥା	t̪aːkɔt̪ʰaː
ପୋଷ୍ଟମ୍ୟାନ୍	posʈɔmjaːn
ଫଟା	pʰɔʈaː
କଲି	kɔli
ଫଳିଆ	pʰɔl̪iaː
ଉଚ୍ଚ	ut͡ʃt͡ʃɔ
ଜନଜାତି	d͡ʒɔnɔd͡ʒaːt̪i
ଫିଙ୍ଗି	pʰiŋgi
ଅସଂଖ୍ୟ	ɔsɔŋkʰjɔ
କଚ୍	kɔt͡ʃ
ଚାରିଆଡ	t͡ʃaːriaːɖɔ
ଶାସନକାଳ	saːsɔnɔkaːl̪ɔ
ଭାଗ୍ୟ	bʱaːgjɔ
ଦୌଡ଼ିଲି	d̪ɔuɽili
ପାହାଚ	paːhaːt͡ʃɔ
ବିଲେଇଛୁଆ	bileit͡ʃʰuaː
ଜାଳିଥିଲେ	d͡ʒaːl̪it̪ʰile
ଆଣିବା	aːɳibaː
ଦରୁଆନଟି	d̪ɔruaːnɔʈi
ବିରିୟାନି	birijaːni
ଦୌଡ଼ାଇଲା	d̪ɔuɽaːilaː
ଏଚ	et͡ʃɔ
ବୁଲିଲେ	bulile
ଫେଣା	pʰeɳaː
ମୁଚକ	mut͡ʃɔkɔ
ମିଶ୍ର	misɾɔ
ବୋହୁଛି	bohut͡ʃʰi
ପ୍ରାଣୀ	praːɳi
ଛୋଟ	t͡ʃʰoʈɔ
ଉପରୁ	upɔru
ଜଳାଇ	d͡ʒɔl̪aːi
ଧାଇଁଲେ	d̪ʱaːĩle
ଆଣିଲ	aːɳilɔ
ତୀବ୍ରତର	t̪ibɾɔt̪ɔɾɔ
ପ୍ରବଳ	pɾɔbɔl̪ɔ
କୌଣସି	kouɳɔsi
ସବୁଠୁ	sɔbuʈʰu
ଚାଲିଛି	t͡ʃaːlit͡ʃʰi
ଶରତ	sɔɾɔt̪ɔ
ବହିଲା	bɔhilaː
ଦେହସାରା	d̪ehɔsaːraː
କାନ୍ଦିଉଠିଲା	kaːnd̪iuʈʰilaː
ଉଚିତ	ut͡ʃit̪ɔ
ସିଲେଇରେ	sileire
ଗଙ୍ଗା	ɡɔŋgaː
ବ୍ୟଞ୍ଜନ	bjɔɲd͡ʒɔnɔ
ବାଜିଲା	baːd͡ʒilaː
ଫୁଲଟିଏ	pʰulɔʈie
ଗଳିରେ	ɡɔl̪ire
ମାଷ୍ଟ୍ରେଙ୍କ	maːsʈreŋkɔ
ଗୁଣା	guɳaː
କୋଠା	koʈʰaː
ଖୋଲିଦିଅ	kʰolid̪iɔ
ଥରେ	t̪ʰɔre
ଉପଲବ୍ଧ	upɔlɔbd̪ʱɔ
କରାମାତି	kɔraːmaːt̪i
ବାଦାମବାଲା	baːd̪aːmɔbaːlaː
ଆଣି	aːɳi
ଲାଗିବା	laːgibaː
ଯୁକ୍ତ	d͡ʒukt̪ɔ
ମାତ୍ର	maːt̪ɾɔ
ପଡ଼ିବା	pɔɽibaː
ରଡିଛାଡିଲା	ɾɔɖit͡ʃʰaːɖilaː
ସାଇକେଲ	saːikelɔ
ସରସ୍ଵତୀ	sɔɾɔsuɔt̪i
ରାଧା	raːd̪ʱaː
ଦୁଃଖୀ	d̪uhkʰi
ମାଲୁ	maːlu
ବାନ୍ଧ	baːnd̪ʱɔ
ଖସି	kʰɔsi
ତତ୍କାଳୀନ	t̪ɔt̪kaːl̪inɔ
ପାଖେ	paːkʰe
ଶିଖ	sikʰɔ
ଭାବେ	bʱaːbe
ପାଳନ	paːl̪ɔnɔ
ସେମାନଙ୍କ	semaːnɔŋkɔ
ଓଜନ	od͡ʒɔnɔ
ଭଲ	bʰɔlɔ
ମାନସିକ	maːnɔsikɔ
ତୋଳୁଥିଲା	t̪ol̪ut̪ʰilaː
ହାଣ୍ଡିକୁ	haːɳɖiku
ହାତୀଠୁ	haːt̪iʈʰu
ବହୁଥର	bɔhut̪ʰɔɾɔ
କିଛିଟା	kit͡ʃʰiʈaː
ଭାରତରେ	bʱaːɾɔt̪ɔre
ପ୍ରତିବର୍ଷ	pɾɔt̪ibɔrsɔ
ପେଚାର	pet͡ʃaːɾɔ
ଖାଆନ୍ତି	kʰaːaːnt̪i
ଡରିଗଲେ	ɖɔriɡɔle
ସେଗୁଡ଼ାକ	seguɽaːkɔ
ହୁଇସିଲ	huisilɔ
ଯିବେ	d͡ʒibe
ଭାଦ୍ରବ	bʱaːd̪ɾɔbɔ
ବିଜ୍ଞାପିତ	bid͡ʒɲaːpit̪ɔ
କରୁଛନ୍ତି	kɔrut͡ʃʰɔnt̪i
ଶହେ	sɔhe
ମାତା	maːt̪aː
ଗୋଲ୍	gol
କରୁ	kɔru
କାଇଁ	kaːĩ
ଖହିଲା	kʰɔhilaː
ଅଗଷ୍ଟ	ɔɡɔsʈɔ
ଦେଖାଯାଉଛି	d̪ekʰaːd͡ʒaːut͡ʃʰi
ମିଳିଲେ	mil̪ile
ପୂର୍ବ	purbɔ
ସ୍ଵାଧୀନ	suaːd̪ʱinɔ
ଅସୁବିଧା	ɔsubid̪ʱaː
ହିନ୍ଦୁ	hind̪u
ସିଲକ୍	silɔk
ବୋକାଙ୍କ	bokaːŋkɔ
ଭୀମାର	bʱimaːɾɔ
ପିଠା	piʈʰaː
କଟିବାକୁ	kɔʈibaːku
କୁଡ଼ୁମୁଡ଼ି	kuɽumuɽi
ମୂହୁର୍ତ୍ତ	muhurt̪t̪ɔ
ଶରୀର	sɔriɾɔ
ଦରଜିର	d̪ɔɾɔd͡ʒiɾɔ
ପରଯୁକ୍ତ	pɔɾɔd͡ʒukt̪ɔ
ଆକାର	aːkaːɾɔ
ଜାଣିଛି	d͡ʒaːɳit͡ʃʰi
ଲଳିତା	lɔl̪it̪aː
କଠୋରିରେ	kɔʈʰorire
ନିକଟରେ	nikɔʈɔre
ଅଲ୍ପନା	ɔlpɔnaː
ଠୁ	ʈʰu
ଶ୍ରେଣୀକକ୍ଷ	sreɳikɔkʰjɔ
ରୁଟିକୁ	ruʈiku
ବାନ୍ଧିଦେ	baːnd̪ʱid̪e
କହିବିନି	kɔhibini
ରାଜବଂଶର	raːd͡ʒɔbɔŋsɔɾɔ
କଲୁ	kɔlu
ନାଚିବି	naːt͡ʃibi
ଦେଖୁ	d̪ekʰu
ସ୍ଥାନୀୟ	st̪ʰaːnijɔ
ସ୍ନାତକ	snaːt̪ɔkɔ
ଆରବ	aːɾɔbɔ
ସ୍ଵାଧୀନତା	suaːd̪ʱinɔt̪aː
ହୋଇପଡ଼ିଲା	hoipɔɽilaː
ଲୋହିତ	lohit̪ɔ
ମାର୍ଚ୍ଚ	maːrt͡ʃt͡ʃɔ
ପ୍ରାୟ	praːjɔ
ବିନିକୁ	biniku
ପାରୁନଥାନ୍ତି	paːrunɔt̪ʰaːnt̪i
ହଲେଇବାକୁ	hɔleibaːku
ସଂଗମ	sɔŋɡɔmɔ
ବନ୍ଧୁ	bɔnd̪ʱu
ଘଷା	ɡʱɔsaː
ବସି	bɔsi
ଛାତରେ	t͡ʃʰaːt̪ɔre
ପରଠା	pɔɾɔʈʰaː
ଚାରି	t͡ʃaːri
ପୂର୍ଣ୍ଣଛେଦ	purɳɳɔt͡ʃʰed̪ɔ
ଆଫ୍ରିକା	aːpʰrikaː
ହସିଲେ	hɔsile
ହାଇ	haːi
କରିଲେ	kɔrile
ସଞ୍ଚାରିତ	sɔɲt͡ʃaːrit̪ɔ
ବଞ୍ଚାଅ	bɔɲt͡ʃaːɔ
ଜେ	d͡ʒe
ଶୁଭୁଥିଲା	subʱut̪ʰilaː
ପ୍ରକାରର	pɾɔkaːɾɔɾɔ
ଘଣ୍ଟାଟିଏ	ɡʱɔɳʈaːʈie
ନୋବେଲ	nobelɔ
ଦଳଗତ	d̪ɔl̪ɔɡɔt̪ɔ
ସଂଗରେ	sɔŋɡɔre
ଯା	d͡ʒaː
ଖାଇବୁ	kʰaːibu
ବିଲେଇ	bilei
ହୋଇଗଲେ	hoiɡɔle
ଚୁମ୍ବକରେ	t͡ʃumbɔkɔre
ହେବନି	hebɔni
ଅପାଂକୁ	ɔpaːŋku
ବିଛଣା	bit͡ʃʰɔɳaː
ଉତ୍ସୁକ	ut̪sukɔ
ଆଡ଼କୁ	aːɽɔku,aːɖɔku
ଗୀତିକାର	git̪ikaːɾɔ
ଛୁଟି	t͡ʃʰuʈi
ପିଠିରେ	piʈʰire
ଗଛତଳେ	ɡɔt͡ʃʰɔt̪ɔl̪e
ମନେ	mɔne
ରାଗିକି	raːgiki
ନେବା	nebaː
ଥରକେ	t̪ʰɔɾɔke
ଅମ୍ଳଜାନ	ɔml̪ɔd͡ʒaːnɔ
ସପ୍ତାହର	sɔpt̪aːhɔɾɔ
ମନୁ	mɔnu
ଊଟି	uʈi
ଆଟୁ	aːʈu
ପିନ୍ଧିଲେ	pind̪ʱile
ଲୋକମାନେ	lokɔmaːne
ଭଜା	bʰɔd͡ʒaː
ବର୍ଣ୍ଣିତ	bɔrɳɳit̪ɔ
ଟୋପିଟିଏ	ʈopiʈie
କର୍ମଠ	kɔrmɔʈʰɔ
ଟେସୁ	ʈesu
ଆରେ	aːre
ଗଧ	ɡɔd̪ʱɔ
ଭର୍ତ୍ତା	bʰɔrt̪t̪aː
କିନ୍	kin
ଆଣେ	aːɳe
ବଞ୍ଚନ୍ତି	bɔɲt͡ʃɔnt̪i
ପଠାନ୍ତି	pɔʈʰaːnt̪i
ବଢିଆ	bɔɖʱiaː
ଅନନ୍ତ	ɔnɔnt̪ɔ
ପ୍ରତ୍ୟେକେ	pɾɔt̪jeke
ମୟୂରଭଞ୍ଜ	mɔjuɾɔbʰɔɲd͡ʒɔ
ଇଟାର	iʈaːɾɔ
ଷୀର	siɾɔ
ଫୁସଫୁସ	pʰusɔpʰusɔ
ଛେଳିର	t͡ʃʰel̪iɾɔ
କେତେବେଳୁ	ket̪ebel̪u
ସଫ୍ଟୱେର	sɔpʰʈɔueɾɔ
ଗୁର୍ରର୍ରର୍ର	gurɾɔrɾɔrɾɔ
ପତଳା	pɔt̪ɔl̪aː
ରହେ	ɾɔhe
ଜଳ	d͡ʒɔl̪ɔ
ଜୟପୁର	d͡ʒɔjɔpuɾɔ
ଜୟଦେବ	d͡ʒɔjɔd̪ebɔ
ଙ୍କ	ŋkɔ
ଦେଖା	d̪ekʰaː
ସମ୍ପାଦନ	sɔmpaːd̪ɔnɔ
ଥାଉ	t̪ʰaːu
ଅନିତା	ɔnit̪aː
କାମଟେ	kaːmɔʈe
ବଗିଚାକୁ	bɔgit͡ʃaːku
ଜଣା	d͡ʒɔɳaː
ଯୋଜନା	d͡ʒod͡ʒɔnaː
ଯାଜପୁର	d͡ʒaːd͡ʒɔpuɾɔ
ସନ୍ଧିରେ	sɔnd̪ʱire
ବାଣୀର	baːɳiɾɔ
ରଘୁନାଥ	ɾɔgʰunaːt̪ʰɔ
ମିଳିଲା	mil̪ilaː
ପ୍ରକାଶନ	pɾɔkaːsɔnɔ
କହୁଥିଲେ	kɔhut̪ʰile
ଜୟୀରାମ	d͡ʒɔjiraːmɔ
ଉଷୁମ	usumɔ
ସୁଭଦ୍ରା	subʰɔd̪raː
ସୀଢ଼ୀରେ	siɽʱire
ପଛେ	pɔt͡ʃʰe
ଖଣ୍ଡିକୁ	kʰɔɳɖiku
କଦାପି	kɔd̪aːpi
ଘଟଣା	ɡʱɔʈɔɳaː
ପେଟର	peʈɔɾɔ
କ୍ଲାସରେ	klaːsɔre
କନ୍ୟା	kɔnjaː
ବନ୍ଦକରି	bɔnd̪ɔkɔri
ନିମନ୍ତେ	nimɔnt̪e
ବଢ଼ିଲାଣି	bɔɽʱilaːɳi
ସକାଳେ	sɔkaːl̪e
ପାଦ	paːd̪ɔ
ସମ୍ମାନ	sɔmmaːnɔ
ଭଲଲାଗେ	bʰɔlɔlaːge
ଏଚ୍	et͡ʃ
କଳାପଟା	kɔl̪aːpɔʈaː
ଫେରେଇନେଲା	pʰereinelaː
ଆଘାତ	aːgʰaːt̪ɔ
ଚାରିଟା	t͡ʃaːriʈaː
ଜନ୍ମିତ	d͡ʒɔnmit̪ɔ
ମଜାଲାଗେ	mɔd͡ʒaːlaːge
ତରଭୁଜ	t̪ɔɾɔbʱud͡ʒɔ
ଦିଲ୍ଲୀ	d̪illi
ବାପାଙ୍କୁ	baːpaːŋku
ବିଛେଇ	bit͡ʃʰei
ଭଙ୍ଗା	bʰɔŋgaː
ବା	baː
ବାରମ୍ବାର	baːɾɔmbaːɾɔ
ଗଣିଲା	ɡɔɳilaː
ବାମ	baːmɔ
ବାସୁଦେବ	baːsud̪ebɔ
ସ୍ଵେଟର	sueʈɔɾɔ
ଗଣ୍ଠଲି	ɡɔɳʈʰɔli
ପୃଷ୍ଠାଟି	prusʈʰaːʈi
ଦିଆଯାଇଥିଲା	d̪iaːd͡ʒaːit̪ʰilaː
ଆଉଗୋଟେ	aːugoʈe
ଖେଳି	kʰel̪i
ବିଜେ	bid͡ʒe
ବୈଷ୍ଣବ	bɔisɳɔbɔ
ମାଳୀ	maːl̪i
ଭାଙ୍ଗି	bʱaːŋgi
ଚେଷ୍ଟାକର	t͡ʃesʈaːkɔɾɔ
ବେଳେବେଳେଏହି	bel̪ebel̪eehi
ତରଙ୍ଗ	t̪ɔɾɔŋɡɔ
ଗୋଲ	golɔ
ମୂଖ୍ୟ	mukʰjɔ
କାର୍ଡରେ	kaːrɖɔre
ଯେଉଁଠି	d͡ʒeũʈʰi
ଆସିଥାଏ	aːsit̪ʰaːe
ନିର୍ଭର	nirbʰɔɾɔ
ଏମ	emɔ
ଗାଈ	gaːi
ସମ୍ରାଟ୍	sɔmraːʈ
ଝରଣା	d͡ʒʱɔɾɔɳaː
ପାଣିକଢ଼ା	paːɳikɔɽʱaː
ହସିଲି	hɔsili
ମାଂସାଶୀ	maːŋsaːsi
ପାଠକ	paːʈʰɔkɔ
କାଟିବାରେ	kaːʈibaːre
ଲଗାଇଥାନ୍ତି	lɔgaːit̪ʰaːnt̪i
ରାନ୍ଧିଲା	raːnd̪ʱilaː
ଦେଇଥିଲେ	d̪eit̪ʰile
ଦେଉଳ	d̪eul̪ɔ
ବିସ୍ତାର	bist̪aːɾɔ
ମୟୁର	mɔjuɾɔ
ପୋଙ୍ଖ	poŋkʰɔ
ଗପ୍ପୁକୁ	ɡɔppuku
ସୂତାର	sut̪aːɾɔ
ନାଳକୁ	naːl̪ɔku
କରିଥିବା	kɔrit̪ʰibaː
ଅନ୍ୟତମ	ɔnjɔt̪ɔmɔ
କରିଦେବା	kɔrid̪ebaː
ଉପରବେଳା	upɔɾɔbel̪aː
ବିଶ୍ୱରେ	bisuɔre
ବର୍ଷରୁ	bɔrsɔru
କାଟୁଥିଲେ	kaːʈut̪ʰile
ଶୁଣିପାରିଲେ	suɳipaːrile
ନୌକା	nɔukaː
ଆସିଲ	aːsilɔ
ହୁଏତ	huet̪ɔ
ପିଲାଙ୍କୁ	pilaːŋku
ଅତ୍ୟନ୍ତ	ɔt̪jɔnt̪ɔ
ସିକ୍ରି	sikri
ପାଇପାରିବ	paːipaːribɔ
ବାପାଙ୍କ	baːpaːŋkɔ
ମୁଣ୍ଡ	muɳɖɔ
ମହାଶୟ	mɔhaːsɔjɔ
ଡେଉଁ	ɖeũ
ରଖିଲେ	ɾɔkʰile
ଓଡ଼ିଆରେ	oɽiaːre
କୋଟି	koʈi
ଇଣ୍ଡେକ୍ସ	iɳɖeksɔ
ଅନୁଷ୍ଠିତ	ɔnusʈʰit̪ɔ
ନିର୍ଜୀବ	nird͡ʒibɔ
ଜାଗାରେ	d͡ʒaːgaːre
ରାସ୍ତା	raːst̪aː
ପଠେଇ	pɔʈʰei
ଫାର୍	pʰaːr
ବୁଝାନ୍ତି	bud͡ʒʱaːnt̪i
ସାଙ୍ଗମାନଙ୍କ	saːŋɡɔmaːnɔŋkɔ
କେଜାଣି	ked͡ʒaːɳi
ଆଦେଶ	aːd̪esɔ
ବଜାୟ	bɔd͡ʒaːjɔ
ରାନ୍ଧି	raːnd̪ʱi
ତାମିଲ	t̪aːmilɔ
ଦେଉଥିଲେ	d̪eut̪ʰile
ସଂଯୁକ୍ତ	sɔŋd͡ʒukt̪ɔ
ବିରଜା	biɾɔd͡ʒaː
ବଙ୍କାକରି	bɔŋkaːkɔri
ଗୁଡିକର	guɖikɔɾɔ
ସକାଶେ	sɔkaːse
କାଢ଼ିଲା	kaːɽʱilaː
ହୋଇଉଠେ	hoiuʈʰe
ଦିନ	d̪inɔ
ହେଇଯାଆନ୍ତି	heid͡ʒaːaːnt̪i
କାଳୀ	kaːl̪i
ବହିଗୁଡ଼ାକ	bɔhiguɽaːkɔ
ଚାହାଣୀ	t͡ʃaːhaːɳi
ରହୁ	ɾɔhu
ଯେପରିକି	d͡ʒepɔriki
ସଂଯୋଗ	sɔŋd͡ʒoɡɔ
ନାବିକ	naːbikɔ
ସେନାପତି	senaːpɔt̪i
ଜାମା	d͡ʒaːmaː
ଲୁଗାଧୁଆ	lugaːd̪ʱuaː
ଲାଗିଥିବା	laːgit̪ʰibaː
ଖମ୍ବ	kʰɔmbɔ
କାର୍ଟନ୍	kaːrʈɔn
ପରାସ୍ତ	pɔraːst̪ɔ
ମଣ୍ଡେଲା	mɔɳɖelaː
ନରେନ୍ଦ୍ର	nɔrend̪ɾɔ
ଫାଉଣ୍ଡେସନ	pʰaːuɳɖesɔnɔ
କୁହନ୍ତି	kuhɔnt̪i
ମୁଢ଼ୀ	muɽʱi
ପଲାଉ	pɔlaːu
ସୋରିଷ	sorisɔ
ଗୁଡ଼ାକ	guɽaːkɔ
ହୈଦରାବାଦ	hɔid̪ɔraːbaːd̪ɔ
ଜନ୍ମଦିନ	d͡ʒɔnmɔd̪inɔ
ବୁଝାଇଥାଏ	bud͡ʒʱaːit̪ʰaːe
ଜର୍ଜ	d͡ʒɔrd͡ʒɔ
ପରତରେ	pɔɾɔt̪ɔre
ଘିଅ	gʰiɔ
ପକାଇବାକୁ	pɔkaːibaːku
ଚାହୁଁ	t͡ʃaːhũ
କେଶରୀ	kesɔri
ବିଜୁ	bid͡ʒu
ଦେଇଛନ୍ତି	d̪eit͡ʃʰɔnt̪i
ଙ୍କର	ŋkɔɾɔ
ଆନ୍ଧ୍ର	aːnd̪ʱɾɔ
ଟଗର	ʈɔɡɔɾɔ
କାନ୍ଦିଲି	kaːnd̪ili
ଡାକୁଥିବାର	ɖaːkut̪ʰibaːɾɔ
ଖରାଦିନେ	kʰɔraːd̪ine
ବକ୍ସ	bɔksɔ
ପ୍ରିୟ	prijɔ
ଗାଢରଙ୍ଗର	gaːɖʱɔɾɔŋɡɔɾɔ
କପଡ଼ା	kɔpɔɽaː
ପାଦରେ	paːd̪ɔre
ସହଯୋଗ	sɔhɔd͡ʒoɡɔ
ହୋଇଯିବେ	hoid͡ʒibe
ବିକିକରି	bikikɔri
କଞ୍ଚା	kɔɲt͡ʃaː
ଉପରଭାଗରେ	upɔɾɔbʱaːɡɔre
ଜର୍ମାନୀ	d͡ʒɔrmaːni
ସ୍ତ୍ରୀ	st̪ri
ଶିବମନ୍ଦିର	sibɔmɔnd̪iɾɔ
ଠକିବ	ʈʰɔkibɔ
ଆଛାଦିତ	aːt͡ʃʰaːd̪it̪ɔ
କନ୍ୟାକୁ	kɔnjaːku
ହସଟିଏ	hɔsɔʈie
ସାରିଲାଣି	saːrilaːɳi
ରସାୟନ	ɾɔsaːjɔnɔ
ଓଡିଶା	oɖisaː
ଡାଇନୋସର	ɖaːinosɔɾɔ
ଚେଷ୍ଟା	t͡ʃesʈaː
ଆସିଲି	aːsili
ଉଜ୍ଜ୍ୱଳ	ud͡ʒd͡ʒuɔl̪ɔ
କଳିଙ୍ଗ	kɔl̪iŋɡɔ
ଅନିଷ୍ଟ	ɔnisʈɔ
ଦୂରାବସ୍ଥା	d̪uraːbɔst̪ʰaː
କହନ୍ତି	kɔhɔnt̪i
ଟାକୁ	ʈaːku
ମଝିରେ	mɔd͡ʒʱire
ହଜାର	hɔd͡ʒaːɾɔ
କଳାହାଣ୍ଡି	kɔl̪aːhaːɳɖi
ମନୁଆକୁ	mɔnuaːku
ଜଳୁନି	d͡ʒɔl̪uni
ସେବାଟେ	sebaːʈe
ଲଗାଉଥିଲା	lɔgaːut̪ʰilaː
ଅଣନିଃଶ୍ୱାସୀ	ɔɳɔnihsuaːsi
ନେଇଆସି	neiaːsi
ହଇରାଣ	hɔiraːɳɔ
ସୁରଥ	suɾɔt̪ʰɔ
ବକ୍‌ବକ୍‌	bɔkbɔk
ପକ୍ଷୀ	pɔkʰi
ଚାଲିଥାଏ	t͡ʃaːlit̪ʰaːe
ଆହୁରି	aːhuri
ବୈଷୟିକ	bɔisɔjikɔ
ଡାକିବାକୁ	ɖaːkibaːku
ଲେଖି	lekʰi
ଛୋଟରୁ	t͡ʃʰoʈɔru
ଲାଗି	laːgi
କୁକୁର	kukuɾɔ
ଦିଶୁଥିଲା	d̪isut̪ʰilaː
ଆଞ୍ଚଳିକ	aːɲt͡ʃɔl̪ikɔ
ଅଭିନୟ	ɔbʱinɔjɔ
ପୃଥିବୀରେ	prut̪ʰibire
ନିଶ୍ୱାସ	nisuaːsɔ
ହତାଶ	hɔt̪aːsɔ
ଛେଳି	t͡ʃʰel̪i
ବସିପଡିଲା	bɔsipɔɖilaː
ଠେଲାରୁ	ʈʰelaːru
ଦାନ୍ତବିଂଧା	d̪aːnt̪ɔbiŋd̪ʱaː
ପାଇଲାନି	paːilaːni
ସକ୍ରିୟ	sɔkrijɔ
ରାନ୍ଧୁଛି	raːnd̪ʱut͡ʃʰi
ଚିହ୍ନି	t͡ʃihni
ମରିଚ	mɔrit͡ʃɔ
ପିନ୍ଧା	pind̪ʱaː
ପୁରୁଷୋତ୍ତମ	purusot̪t̪ɔmɔ
ସୁଶୀଳାକୁ	susil̪aːku
ଦୁଃଖରେ	d̪uhkʰɔre
ଠେଲାଗାଡ଼ି	ʈʰelaːgaːɽi
ବାଷାରଆତ୍ମବିଶ୍ୱାସବଢ଼ିବାରେ	baːsaːɾɔaːt̪mɔbisuaːsɔbɔɽʱibaːre
ପୋଂଗଲ୍	poŋɡɔl
ବାରବାଟି	baːɾɔbaːʈi
ଯାଏଁ	d͡ʒaːẽ
ବିକୁଥିଲେ	bikut̪ʰile
ଶୀତଦିନ	sit̪ɔd̪inɔ
ଦିଶୁ	d̪isu
ବିଧାୟକଗଣ	bid̪ʱaːjɔkɔɡɔɳɔ
ରହିଲେ	ɾɔhile
ଏଥିରୁ	et̪ʰiru
ଉଡ଼ିପାର	uɽipaːɾɔ
ମୁହଁଟା	muhɔ̃ʈaː
କରୁଛି	kɔrut͡ʃʰi
ଅସିବାକୁ	ɔsibaːku
ମଠ	mɔʈʰɔ
ଥିବାରୁ	t̪ʰibaːru
ବାଦଲ	baːd̪ɔlɔ
ଉତ୍ସବ	ut̪sɔbɔ
ତତ୍ତ୍ଵ	t̪ɔt̪t̪uɔ
ବିଲରୁ	bilɔru
ଢିଙ୍କି	ɖʱiŋki
ପାପ	paːpɔ
ଲୀଳା	lil̪aː
ଯଥା	d͡ʒɔt̪ʰaː
ଐତିହ୍ୟ	ɔit̪ihjɔ
ପ୍ରେମ	premɔ
ପାଇଲଟ୍	paːilɔʈ
ଗୁଣ୍ଡିଚା	guɳɖit͡ʃaː
ସାରିଲା	saːrilaː
ପୋଷାକଟିକୁ	posaːkɔʈiku
ବିଭାଜିତ	bibʱaːd͡ʒit̪ɔ
ଗୌରୀ	gouri
ପିଲାସହ	pilaːsɔhɔ
ଶିକାରୀ	sikaːri
ରଖିଥିଲା	ɾɔkʰit̪ʰilaː
ତାମିଲ୍	t̪aːmil
ନରସିଂହ	nɔɾɔsiŋhɔ
ଧନୀକୁ	d̪ʱɔniku
ଶେଷମୁଣ୍ଡଟି	sesɔmuɳɖɔʈi
ଜୀରା	d͡ʒiraː
ମଣିଷମାନେ	mɔɳisɔmaːne
ଗୋବର	gobɔɾɔ
ଅବସ୍ଥାରେ	ɔbɔst̪ʰaːre
ଭୋରରୁ	bʱoɾɔru
ମଜାଳିଆ	mɔd͡ʒaːl̪iaː
ଦେଖିବା	d̪ekʰibaː
ସାଧନା	saːd̪ʱɔnaː
ଏତେ	et̪e
ଗୋଲାପି	golaːpi
ପକୁଡି	pɔkuɖi
ଯେହେତୁ	d͡ʒehet̪u
ବାଣୀ	baːɳi
ନଥିବାରୁ	nɔt̪ʰibaːru
ଅର୍ଥ	ɔrt̪ʰɔ
ଯାକ	d͡ʒaːkɔ
ଆଣିଛ	aːɳit͡ʃʰɔ
ଚାରିଟାକୁ	t͡ʃaːriʈaːku
ଅପରାହ୍ନରେ	ɔpɔraːhnɔre
ସର୍ବ	sɔrbɔ
ପରାଗ	pɔraːɡɔ
ଫଳିଥିବା	pʰɔl̪it̪ʰibaː
ବାଳକ	baːl̪ɔkɔ
ଥରିଥରି	t̪ʰɔrit̪ʰɔri
ଜଣ	d͡ʒɔɳɔ
ଜେନା	d͡ʒenaː
ଏସବୁକୁ	esɔbuku
ସହରରେ	sɔhɔɾɔre
ଅଭିନେତା	ɔbʱinet̪aː
ବସିଥିବା	bɔsit̪ʰibaː
ପସନ୍ଦର	pɔsɔnd̪ɔɾɔ
ଚାଟୁ	t͡ʃaːʈu
ପେପେ	pepe
ମିଳିବ	mil̪ibɔ
କୁନି	kuni
ରହିଅଛି	ɾɔhiɔt͡ʃʰi
ଆଙ୍ଗୁଠିରେ	aːŋguʈʰire
ମହୁଫେଣା	mɔhupʰeɳaː
ପିଲାଗୁଡ଼ିକ	pilaːguɽikɔ
ଚୁମ୍ବକଟିକୁ	t͡ʃumbɔkɔʈiku
ଉଡ଼େଇବା	uɽeibaː
ଗେଣ୍ତା	geɳt̪aː
ସଞ୍ଚୟ	sɔɲt͡ʃɔjɔ
ଭିକି	bʱiki
ନୁହନ୍ତି	nuhɔnt̪i
ଅଂଶ	ɔŋsɔ
ଚିନ୍ତିତ	t͡ʃint̪it̪ɔ
ପଡ଼ୁଥିବ	pɔɽut̪ʰibɔ
ହଉ	hɔu
ଦୁଇଜଣକର	d̪uid͡ʒɔɳɔkɔɾɔ
ପ୍ରତିକ୍ରିୟା	pɾɔt̪ikrijaː
ଅଶୋକ	ɔsokɔ
ଡାଲଚିନି	ɖaːlɔt͡ʃini
ଧାତୁରେ	d̪ʱaːt̪ure
ରାସ୍ତାରେ	raːst̪aːre
ଭୋଗ	bʱoɡɔ
ଭେଣ୍ଡି	bʱeɳɖi
ଏମାନେ	emaːne
ଉଠୁଥିଲା	uʈʰut̪ʰilaː
କରନ୍ତୁ	kɔɾɔnt̪u
ବନ୍ଧା	bɔnd̪ʱaː
ରହିପାରିବିନି	ɾɔhipaːribini
ବହିରୁ	bɔhiru
ଶୋଷିବାକୁ	sosibaːku
ଫେରିଆସିଲା	pʰeriaːsilaː
ଭ୍ରମଣ	bʱɾɔmɔɳɔ
ସେତେଟା	set̪eʈaː
ପ୍ରତିପତ୍ତି	pɾɔt̪ipɔt̪t̪i
ଇତ୍ୟାଦି	it̪jaːd̪i
ଶୁଙ୍ଘିବାକୁ	suŋgʰibaːku
ପିଲାଟିଏ	pilaːʈie
ଘେରି	gʰeri
ପ୍ରତିକୃତି	pɾɔt̪ikrut̪i
ତାଙ୍କୁ	t̪aːŋku
କଠିନ	kɔʈʰinɔ
ସଙ୍କେତ	sɔŋket̪ɔ
ପକାଇଲେ	pɔkaːile
ଉଦୟ	ud̪ɔjɔ
ପାଇଲିନି	paːilini
ଶୁଣିବ	suɳibɔ
ପାର	paːɾɔ
ଆକବର	aːkɔbɔɾɔ
ଡରୁ	ɖɔru
ଭାଗ	bʱaːɡɔ
ଝୁଲୁଥାଅ	d͡ʒʱulut̪ʰaːɔ
ଦୈନିକ	d̪ɔinikɔ
ମୂଲ୍ୟ	muljɔ
ନେତା	net̪aː
ଉତ୍ତର	ut̪t̪ɔɾɔ
ଘୁଞ୍ଚିବା	gʰuɲt͡ʃibaː
ଗମନାଗମନ	ɡɔmɔnaːɡɔmɔnɔ
ବେଲ୍‌	bel
ତୁଳା	t̪ul̪aː
ଜଳବାୟୁରେ	d͡ʒɔl̪ɔbaːjure
କାଦୁଅ	kaːd̪uɔ
ଦେଲା	d̪elaː
ସମୀରାକୁ	sɔmiraːku
କଷୁଥିଲା	kɔsut̪ʰilaː
ହୋଇଥିବାରୁ	hoit̪ʰibaːru
ମାହାତ୍ମାଗାନ୍ଧୀଙ୍କ	maːhaːt̪maːgaːnd̪ʱiŋkɔ
ଟାଙ୍ଗୁ	ʈaːŋgu
ବାଜାଟି	baːd͡ʒaːʈi
ନାଟ୍ୟକାର	naːʈjɔkaːɾɔ
ଆସିଲେ	aːsile
ହଲାଉ	hɔlaːu
ଗର୍ତ୍ତ	ɡɔrt̪t̪ɔ
କଣ୍ଠରେ	kɔɳʈʰɔre
ଗ୍ରୀକ	grikɔ
ପିନ୍ଧିବି	pind̪ʱibi
ସେପାଖରୁ	sepaːkʰɔru
ଜ୍ଵର	d͡ʒuɔɾɔ
ଚାମଚରେ	t͡ʃaːmɔt͡ʃɔre
ବହୁମୂଲ୍ୟ	bɔhumuljɔ
ସେଇକଥା	seikɔt̪ʰaː
ଛୁଆ	t͡ʃʰuaː
ପେପେକୁ	pepeku
ଚନ୍ଦ୍ରଶେଖର	t͡ʃɔnd̪ɾɔsekʰɔɾɔ
ଶାଗ	saːɡɔ
ରହୁଥିବା	ɾɔhut̪ʰibaː
ଜରୁରି	d͡ʒɔruri
ପାଞ୍ଜି	paːɲd͡ʒi
ବିଦ୍ୟା	bid̪jaː
ଚାଲାକ୍	t͡ʃaːlaːk
ଝରକାରେ	d͡ʒʱɔɾɔkaːre
ଭାବି	bʱaːbi
ଦରଜି	d̪ɔɾɔd͡ʒi
ଅଛି	ɔt͡ʃʰi
ବାଃ	baːh
ଶିକ୍ଷିତା	sikʰit̪aː
ନେଇଯାନ୍ତି	neid͡ʒaːnt̪i
ଆପଣଙ୍କ	aːpɔɳɔŋkɔ
ନିୟମିତ	nijɔmit̪ɔ
ଅର୍ଥନୀତି	ɔrt̪ʰɔnit̪i
ବିନି	bini
ମଇଳ	mɔil̪ɔ
ଦଉଡି	d̪ɔuɖi
ମୋଡ଼ି	moɽi
ପ୍ରଫେସର	pɾɔpʰesɔɾɔ
ବିଶ୍ଵର	bisuɔɾɔ
ଦରକାରୀ	d̪ɔɾɔkaːri
ଆପଣାଇ	aːpɔɳaːi
ରାବୁଥିଲେ	raːbut̪ʰile
ବୁଲୁଥିଲା	bulut̪ʰilaː
ବାଇଗଣୀ	baːiɡɔɳi
ବିଷୟରେ	bisɔjɔre
ଘୁଡୁ	gʰuɖu
ଉଠୁଥିବା	uʈʰut̪ʰibaː
ପିମ୍ପୁଡ଼ିମାନେ	pimpuɽimaːne
ମାରୁଥିଲା	maːrut̪ʰilaː
ପକ୍ଷରୁ	pɔkʰjɔru
ଦୋକାନରୁ	d̪okaːnɔru
ବୈଧ	bɔid̪ʱɔ
ମାସର	maːsɔɾɔ
ରହିଥିଲେ	ɾɔhit̪ʰile
ପରିମାଣ	pɔrimaːɳɔ
ଦରଜୀ	d̪ɔɾɔd͡ʒi
ରୋଗରେ	roɡɔre
ଓଃ	oh
ଟେଲିଭିଜନ	ʈelibʱid͡ʒɔnɔ
ରହିବା	ɾɔhibaː
ହା	haː
ଯକୃତ	d͡ʒɔkrut̪ɔ
ବନେଇବା	bɔneibaː
କହିଥାନ୍ତି	kɔhit̪ʰaːnt̪i
ସଙ୍ଗୀତ	sɔŋgit̪ɔ
ଗିରଫ୍	giɾɔpʰ
ତୁଳୀ	t̪ul̪i
ବେଳକି	bel̪ɔki
ସଂସ୍କରଣ	sɔŋskɔɾɔɳɔ
ଦମ୍ଭରେ	d̪ɔmbʰɔre
ସମ୍ରାଟଙ୍କୁ	sɔmraːʈɔŋku
ପକାଏ	pɔkaːe
ପୁରାଯାଉଛି	puraːd͡ʒaːut͡ʃʰi
କଇଁଫୁଲରେ	kɔĩpʰulɔre
ଟିମି	ʈimi
ଭଲଭାବେ	bʰɔlɔbʱaːbe
ଚଢ଼ି	t͡ʃɔɽʱi
ସଂକ୍ରମିତ	sɔŋkɾɔmit̪ɔ
ସଭାପତି	sɔbʱaːpɔt̪i
ମିଳିଛି	mil̪it͡ʃʰi
ଫହୁ	pʰɔhu
ଗୋଟେ	goʈe
ଧୈର୍ଯ୍ୟର	d̪ʱɔird͡ʒjɔɾɔ
ଦେଲି	d̪eli
ମିଶାଇ	misaːi
ଯାଉ	d͡ʒaːu
ହୁକୁମ	hukumɔ
ଖଞ୍ଜିବା	kʰɔɲd͡ʒibaː
ସଂସ୍କୃତ	sɔŋskrut̪ɔ
ଗଛକୁ	ɡɔt͡ʃʰɔku
ପୃଷ୍ଠାଗୁଡ଼ିକ	prusʈʰaːguɽikɔ
ଠିକ	ʈʰikɔ
ବେଶ	besɔ
ଥକିଗଲା	t̪ʰɔkiɡɔlaː
ଯାବୁଡ଼ି	d͡ʒaːbuɽi
ଫେବୃଆରିର	pʰebruaːriɾɔ
ବୃନ୍ଦାବନ	brund̪aːbɔnɔ
ଅସିଗଲା	ɔsiɡɔlaː
ମୁଖି	mukʰi
ଫୋପାଡ଼ି	pʰopaːɽi
ସୁଯୋଗ	sud͡ʒoɡɔ
ନିଜଉପରେ	nid͡ʒɔupɔre
ଆଣିଛି	aːɳit͡ʃʰi
ମାତ୍ରେ	maːt̪re
ପୁଷ୍ପ	puspɔ
ପାରି	paːri
ଚୂଲି	t͡ʃuli
ରାଜ୍ୟ	raːd͡ʒjɔ
ଟିଏ	ʈie
ଆସିଛନ୍ତି	aːsit͡ʃʰɔnt̪i
ପଡ଼େ	pɔɽe
ଉକ୍ତ	ukt̪ɔ
ଅଳିଆ	ɔl̪iaː
ଭଲରେ	bʰɔlɔre
ସୂର୍ଯ୍ୟଙ୍କ	surd͡ʒjɔŋkɔ
ପ୍ରଦାନ	pɾɔd̪aːnɔ
ପାଣିଗ୍ରାହୀ	paːɳigraːhi
ଡି	ɖi
ସୂତାକାଟି	sut̪aːkaːʈi
ଐତିହାସିକ	ɔit̪ihaːsikɔ
ବାସ	baːsɔ
ଛାତରୁ	t͡ʃʰaːt̪ɔru
ପାଖକୁ	paːkʰɔku
ଭାବୁଥିବା	bʱaːbut̪ʰibaː
ଗାଁ	gaː̃
ଅନୁଯାଇ	ɔnud͡ʒaːi
ବ୍ରତ	bɾɔt̪ɔ
ମସିହାର	mɔsihaːɾɔ
ପିନ୍ଧିଲୁ	pind̪ʱilu
ଗଣେଶ	ɡɔɳesɔ
ଚଲାନ୍ତି	t͡ʃɔlaːnt̪i
ଭକ୍ତି	bʰɔkt̪i
ରୁହ	ruhɔ
ଯାଏ	d͡ʒaːe
କଲେମଧ୍ୟ	kɔlemɔd̪ʱjɔ
ପ୍ରସଙ୍ଗ	pɾɔsɔŋɡɔ
ଆଗ୍ରହ	aːgɾɔhɔ
ସତର୍କ	sɔt̪ɔrkɔ
ସ୍ଵାମୀ	suaːmi
ମାଆ	maːaː
ପରମାଣୁ	pɔɾɔmaːɳu
କୀଟପତଙ୍ଗ	kiʈɔpɔt̪ɔŋɡɔ
ବାହାରିଲେ	baːhaːrile
ପାଚେରୀରେ	paːt͡ʃerire
ସମ୍ମାନିତ	sɔmmaːnit̪ɔ
ଡବା	ɖɔbaː
ମାଙ୍କଡ଼	maːŋkɔɽɔ
ସୁବିଧା	subid̪ʱaː
ସେଠାରେ	seʈʰaːre
ପିଲାମାନଙ୍କୁ	pilaːmaːnɔŋku
ଏମ୍	em
ସବୁବେଳେ	sɔbubel̪e
ସ୍ୱାଧୀନତା	suaːd̪ʱinɔt̪aː
ନାଚୁଥିବାର	naːt͡ʃut̪ʰibaːɾɔ
ପ୍ରତିରୋଧ	pɾɔt̪irod̪ʱɔ
ବାଜା	baːd͡ʒaː
ଶିକ୍ଷକ	sikʰjɔkɔ
ହିସାବରେ	hisaːbɔre
ଭେଟିବ	bʱeʈibɔ
ଦେ	d̪e
ସାହୁ	saːhu
କଳାଟା	kɔl̪aːʈaː
ସେଠୀ	seʈʰi
ପିଇଲା	piilaː
ଅଙ୍ଗରକ୍ଷକ	ɔŋɡɔɾɔkʰjɔkɔ
ଭଲପାନ୍ତି	bʰɔlɔpaːnt̪i
ପିଟି	piʈi
ଥିଲେ	t̪ʰile
ଝଡି	d͡ʒʱɔɖi
ହରି	hɔri
ପଞ୍ଚମୀ	pɔɲt͡ʃɔmi
କବିତା	kɔbit̪aː
ସମୟର	sɔmɔjɔɾɔ
ସ୍ୱତନ୍ତ୍ର	suɔt̪ɔnt̪ɾɔ
କଣ୍ଢେଇ	kɔɳɖʱei
ପତି	pɔt̪i
ଧିରେ	d̪ʱire
ହେଉଛି	heut͡ʃʰi
ରନ୍ଧାଶାଳ	ɾɔnd̪ʱaːsaːl̪ɔ
ଆପଣମାନେ	aːpɔɳɔmaːne
ଏତିକି	et̪iki
ଅଞ୍ଚଳ	ɔɲt͡ʃɔl̪ɔ
ରଥଯାତ୍ରା	ɾɔt̪ʰɔd͡ʒaːt̪raː
ଏଇଲେ	eile
ପୋଡନ୍ତି	poɖɔnt̪i
ନାଟ	naːʈɔ
ଚଳାଇ	t͡ʃɔl̪aːi
ଲଙ୍କା	lɔŋkaː
ସେତିକି	set̪iki
ଭାସିପାର	bʱaːsipaːɾɔ
ଭାବିବାକୁ	bʱaːbibaːku
ଗାଇଲା	gaːilaː
ମନୁଆର	mɔnuaːɾɔ
ଗୁଡ଼ିଏ	guɽie
ସମ୍ଭବ	sɔmbʰɔbɔ
ପ୍ରାର୍ଥନା	praːrt̪ʰɔnaː
ଭଗାଂଘର	bʰɔgaːŋɡʱɔɾɔ
ଅବା	ɔbaː
ଓଲଟା	olɔʈaː
ପଢ଼ୁଥିଲେ	pɔɽʱut̪ʰile
ଦେଶର	d̪esɔɾɔ
ବାଳକଣ	baːl̪ɔkɔɳɔ
ଶୋଇଛନ୍ତି	soit͡ʃʰɔnt̪i
ଘୁଞ୍ଚାଇଲେ	gʰuɲt͡ʃaːile
ବାକିଥିଲା	baːkit̪ʰilaː
ଯିବା	d͡ʒibaː
ଇଛା	it͡ʃʰaː
ପହଞ୍ଚି	pɔhɔɲt͡ʃi
ପ୍ରଦାହ	pɾɔd̪aːhɔ
ବନେଇ	bɔnei
ଆନନ୍ଦିତ	aːnɔnd̪it̪ɔ
ବିରୁଦ୍ଧରେ	birud̪d̪ʱɔre
ଦେଖାଯାନ୍ତି	d̪ekʰaːd͡ʒaːnt̪i
ପ୍ରାଦେଶିକ	praːd̪esikɔ
ସୁଜି	sud͡ʒi
ବିରକ୍ତ	biɾɔkt̪ɔ
ହାଏ	haːe
ଯୁବ	d͡ʒubɔ
ଦୋଷ	d̪osɔ
ଆଜିକାଲି	aːd͡ʒikaːli
କାଳ	kaːl̪ɔ
ପାରୁଛ	paːrut͡ʃʰɔ
ଉତ୍ତରକୁ	ut̪t̪ɔɾɔku
ଯୋଡ଼ିକ	d͡ʒoɽikɔ
ପୁରାପୁରି	puraːpuri
କ୍ରିୟା	krijaː
କାଢୁଛି	kaːɖʱut͡ʃʰi
ନିତାଇ	nit̪aːi
ଗୋଲୁ	golu
ମୁହଁକୁ	muhɔ̃ku
ଶୁଭା	subʱaː
ପରପୃଷ୍ଠା	pɔɾɔprusʈʰaː
ଅଙ୍କ	ɔŋkɔ
କାବା	kaːbaː
ବାହାରିଆସିବ	baːhaːriaːsibɔ
ପରୀକ୍ଷା	pɔrikʰjaː
ସୁଁ	sũ
ଅଧ୍ୟକ୍ଷ	ɔd̪ʱjɔkʰjɔ
ହାଡ଼	haːɖɔ,haːɽɔ
ପାନ	paːnɔ
ରଖି	ɾɔkʰi
ଜାଣିନଥିଲା	d͡ʒaːɳinɔt̪ʰilaː
ପଟିଟିଏ	pɔʈiʈie
ବସ୍ତୁ	bɔst̪u
ହୋଇଯାଉଥିଲା	hoid͡ʒaːut̪ʰilaː
ଯିବ	d͡ʒibɔ
ପାରିବୁ	paːribu
ଖୁଣ୍ଟରେ	kʰuɳʈɔre
ରୋଡ଼	roɖɔ
ବିଭୋର	bibʱoɾɔ
ଇବ୍ରାହିମ୍	ibraːhim
ପଟକୁ	pɔʈɔku
ମୂନିଆ	muniaː
ଏଃ	eh
ବଢ଼ିଯାଇଛି	bɔɽʱid͡ʒaːit͡ʃʰi
ଭାଜପା	bʱaːd͡ʒɔpaː
ଦୂରତା	d̪uɾɔt̪aː
ବହିଟେ	bɔhiʈe
ଗତିକୁ	ɡɔt̪iku
ପାରନ୍ତି	paːɾɔnt̪i
ଦେଖିବି	d̪ekʰibi
ବାଟି	baːʈi
ଜ୍ଞାନପୀଠ	d͡ʒɲaːnɔpiʈʰɔ
ଛୁଇଁ	t͡ʃʰuĩ
ଭୟଙ୍କର	bʰɔjɔŋkɔɾɔ
କୃଷି	krusi
ପୂର୍ବତନ	purbɔt̪ɔnɔ
ସମ୍ପନ୍ନ	sɔmpɔnnɔ
ଖାଇନୁ	kʰaːinu
ସାବରମତି	saːbɔɾɔmɔt̪i
ଇଙ୍ଗିତ	iŋgit̪ɔ
ଉଠେଇ	uʈʰei
କହିଲୁ	kɔhilu
ନିର୍ବାଚନମଣ୍ଡଳୀ	nirbaːt͡ʃɔnɔmɔɳɖɔl̪i
ସ୍ୱର୍ଗ	suɔrɡɔ
ଖାଉଛନ୍ତି	kʰaːut͡ʃʰɔnt̪i
କରିନି	kɔrini
ଘନ	ɡʱɔnɔ
ସ୍ୱାଗତ	suaːɡɔt̪ɔ
ଶାରଳା	saːɾɔl̪aː
ପ୍ରତିଭା	pɾɔt̪ibʱaː
ଆଫ୍ରିକୀୟ	aːpʰrikijɔ
ମହାରାଷ୍ଟ୍ରର	mɔhaːraːsʈɾɔɾɔ
ମାତାପିତା	maːt̪aːpit̪aː
ମନ୍ଦିରରେ	mɔnd̪iɾɔre
ଉପଭୋଗ	upɔbʱoɡɔ
ଯନ୍ତ୍ର	d͡ʒɔnt̪ɾɔ
ବହୁ	bɔhu
ବାଡ଼ିରେ	baːɽire
ଭଉଣୀର	bʰɔuɳiɾɔ
କାଉଟିଏ	kaːuʈie
ଅବସରରେ	ɔbɔsɔɾɔre
ସପ୍ତମୀ	sɔpt̪ɔmi
ପ୍ରବୀଣ	pɾɔbiɳɔ
ଚାଉଳ-ଚୁନାରୁ	t͡ʃaːul̪ɔ-t͡ʃunaːru
ଧାର୍ମିକ	d̪ʱaːrmikɔ
ପ୍ରଥମେ	pɾɔt̪ʰɔme
ହେଇସାରିଥିଲା	heisaːrit̪ʰilaː
କରୁଥିବା	kɔrut̪ʰibaː
ବୁଝାଇଲେ	bud͡ʒʱaːile
ଶୀତ	sit̪ɔ
ଭୀଷଣ	bʱisɔɳɔ
ଥର	t̪ʰɔɾɔ
କହିପାରିବୁନି	kɔhipaːribuni
କର୍କଟ	kɔrkɔʈɔ
ଲକ୍ଷ୍ମଣ	lɔkʰmɔɳɔ
ଚାଟସଭା	t͡ʃaːʈɔsɔbʱaː
ପ୍ରାରମ୍ଭିକ	praːɾɔmbʱikɔ
ପୀଠ	piʈʰɔ
ପାଟିକରି	paːʈikɔri
ସଂଖ୍ୟାମାନେ	sɔŋkʰjaːmaːne
ଚିପା	t͡ʃipaː
ଅନୁଷ୍ଠାନ	ɔnusʈʰaːnɔ
ବର୍ଚ୍ଛାଧରି	bɔrt͡ʃt͡ʃʰaːd̪ʱɔri
ଖଞ୍ଜିବାରେ	kʰɔɲd͡ʒibaːre
ଛୁଆଟି	t͡ʃʰuaːʈi
ଛାର	t͡ʃʰaːɾɔ
ଦାଦା	d̪aːd̪aː
ପୋଷାକରେ	posaːkɔre
ଋତୁର	rut̪uɾɔ
ରୋଗାନ୍	rogaːn
ଅପଲକ	ɔpɔlɔkɔ
ପ୍ରଭୁ	pɾɔbʱu
ବିରଙ୍ଗପରିବା	biɾɔŋɡɔpɔribaː
ଉପସ୍ଥାପନା	upɔst̪ʰaːpɔnaː
ପ୍ରଯୁକ୍ତି	pɾɔd͡ʒukt̪i
କାନ୍ଦୁଥିଲା	kaːnd̪ut̪ʰilaː
ରୁହେ	ruhe
ନ୍ୟାପ୍	njaːp
ପାଳିବାକୁ	paːl̪ibaːku
ବିଲୁପ୍ତ	bilupt̪ɔ
ଜୁରାସିକ	d͡ʒuraːsikɔ
ସୋନୁ	sonu
ସ୍	s
ଖୋଦେଇ	kʰod̪ei
ଚୌକିରେ	t͡ʃɔukire
ମାନଙ୍କରେ	maːnɔŋkɔre
କ୍ଷୟ	kʰjɔjɔ
ମତ	mɔt̪ɔ
ସାତ	saːt̪ɔ
ଲମ୍ୱୁ	lɔmu
ଏପରିକି	epɔriki
ରଙ୍ଗୀନ	ɾɔŋginɔ
ମହାପ୍ରଭୁଙ୍କ	mɔhaːpɾɔbʱuŋkɔ
କହି	kɔhi
ଶ୍ରୀକୃଷ୍ଣ	srikrusɳɔ
ରଚନା	ɾɔt͡ʃɔnaː
ପକଉଛି	pɔkɔut͡ʃʰi
ମାରନ୍ତି	maːɾɔnt̪i
ହୋଇରହିଗଲେ	hoiɾɔhiɡɔle
ହେଲୁ	helu
ବୁଢୀ	buɖʱi
ସୁଶାନ୍ତ	susaːnt̪ɔ
ମାଢି	maːɖʱi
ଲେମ୍ବୁ	lembu
ଇନଷ୍ଟିଚ୍ୟୁଟ	inɔsʈit͡ʃjuʈɔ
ପୋକକୁ	pokɔku
ମିଠା-ମିଠା	miʈʰaː-miʈʰaː
ଆଉଁଷି	aːũisi
ପଡ଼ିଆଟେ	pɔɽiaːʈe
ଓହ୍ଲଉଥିବା	ohlɔut̪ʰibaː
ପ୍ରଦର୍ଶନ	pɾɔd̪ɔrsɔnɔ
ହଟାଗଲା	hɔʈaːɡɔlaː
ଡାକିବା	ɖaːkibaː
ଆମେ	aːme
ପାଉଁଶିଆ	paːũsiaː
ବାପାଂକୁ	baːpaːŋku
ସ୍କୁଲ	skulɔ
ଧକ୍‌	d̪ʱɔk
ବିରୟାନି	biɾɔjaːni
ଧର୍ମ	d̪ʱɔrmɔ
ମୋହମବତୀ	mohɔmɔbɔt̪i
ଦୋକାନକୁ	d̪okaːnɔku
ସେବା	sebaː
ସତେ	sɔt̪e
ପଶା	pɔsaː
କରୁଥିଲେ	kɔrut̪ʰile
ଚାହୁଁଥିଲା	t͡ʃaːhũt̪ʰilaː
ରାଓ	raːo
ହାତ	haːt̪ɔ
ରାତିରେ	raːt̪ire
ପିନ୍ଧିବାରେ	pind̪ʱibaːre
ଚାଲିଲି	t͡ʃaːlili
କୋଳ	kol̪ɔ
ଧକ୍କା	d̪ʱɔkkaː
ଚଉଡ଼ା	t͡ʃɔuɽaː
କୋଣକୁ	koɳɔku
ସମ୍ବାଦ	sɔmbaːd̪ɔ
ଚୌକିଟିଏ	t͡ʃɔukiʈie
ବନେଇଥାନ୍ତି	bɔneit̪ʰaːnt̪i
ବୋଝ	bod͡ʒʱɔ
କାନଭାସରେ	kaːnɔbʱaːsɔre
ନନ୍ଦୀ	nɔnd̪i
ଧରିଲା	d̪ʱɔrilaː
ଖୋଲିଦେଇ	kʰolid̪ei
କାନ୍ଦନା	kaːnd̪ɔnaː
ଭଲପାଆନ୍ତି	bʰɔlɔpaːaːnt̪i
ଯବକାଚ	d͡ʒɔbɔkaːt͡ʃɔ
ଦେଖୁଥିଲା	d̪ekʰut̪ʰilaː
ଏହି	ehi
ଅଙ୍ଗରକ୍ଷା	ɔŋɡɔɾɔkʰjaː
ରସର	ɾɔsɔɾɔ
ବହିଥିଲା	bɔhit̪ʰilaː
କାଟୋ	kaːʈo
ଏଠାକାର	eʈʰaːkaːɾɔ
କୁମ୍ଭୀରମାନଙ୍କୁ	kumbʱiɾɔmaːnɔŋku
ପ୍ରଫୁଲ୍ଲ	pɾɔpʰullɔ
ଜାମାକୁ	d͡ʒaːmaːku
ମାରୁ	maːru
କାହାନ୍ତି	kaːhaːnt̪i
ଖାଇ	kʰaːi
ପଇସା	pɔisaː
ଉପାଦାନ	upaːd̪aːnɔ
କଥାବାର୍ତ୍ତା	kɔt̪ʰaːbaːrt̪t̪aː
ବାଦାମୀ	baːd̪aːmi
ମହୁମାଛି	mɔhumaːt͡ʃʰi
ବୟସରେ	bɔjɔsɔre
ପାଇଲା	paːilaː
ପ୍ରମାଣ	pɾɔmaːɳɔ
ସନ୍ତସନ୍ତିଆ	sɔnt̪ɔsɔnt̪iaː
ଖୋଜିଲେ	kʰod͡ʒile
ଖଣ୍ଡିଆ	kʰɔɳɖiaː
ବାଳକଟା	baːl̪ɔkɔʈaː
କରାଯିବ	kɔraːd͡ʒibɔ
ସୁନା	sunaː
ଜୈବସନ୍ଦିପ୍ତ	d͡ʒɔibɔsɔnd̪ipt̪ɔ
ପର୍ଯ୍ୟାୟ	pɔrd͡ʒjaːjɔ
ଶିମିଳି	simil̪i
ଖାଦ୍ୟ	kʰaːd̪jɔ
ଝରକାର	d͡ʒʱɔɾɔkaːɾɔ
ନିଶୁଣୀ	nisuɳi
ଭାବୁଛନ୍ତି	bʱaːbut͡ʃʰɔnt̪i
ବିଚିତ୍ର	bit͡ʃit̪ɾɔ
ଡ୍ରମ	ɖɾɔmɔ
ଆସିପାରିଲାନି	aːsipaːrilaːni
ପାଟିକଲେ	paːʈikɔle
ବାକ୍ସରେ	baːksɔre
କରିପାରନ୍ତି	kɔripaːɾɔnt̪i
କୋମଳ	komɔl̪ɔ
ଗିଳି	gil̪i
ବାଘଟି	baːɡʱɔʈi
କଣ	kɔɳɔ
ନୁହେଁ	nuhẽ
ହାତରେ	haːt̪ɔre
କଲାପରେ	kɔlaːpɔre
ଦୁଇପଟକୁ	d̪uipɔʈɔku
ଆଇନ	aːinɔ
ଅଫ୍	ɔpʰ
କହୁଛି	kɔhut͡ʃʰi
ତନ୍ତୁଯୁକ୍ତ	t̪ɔnt̪ud͡ʒukt̪ɔ
ଜନ୍ମହୋଇ	d͡ʒɔnmɔhoi
ଯେବେ	d͡ʒebe
ବାଟ	baːʈɔ
ଜାଣିଛନ୍ତି	d͡ʒaːɳit͡ʃʰɔnt̪i
ପୁରାଣ	puraːɳɔ
ମହିମା	mɔhimaː
ପାଟିକଲା	paːʈikɔlaː
ଝାଳ	d͡ʒʱaːl̪ɔ
ଚାଲ୍	t͡ʃaːl
ଖଞା	kʰɔɲaː
ମଣ୍ଡଳୀ	mɔɳɖɔl̪i
ପାଉଡର	paːuɖɔɾɔ
ବାହାପିଆ	baːhaːpiaː
ଚାଖି	t͡ʃaːkʰi
ଗୁଡ଼େଇ	guɽei
ମାନଙ୍କ	maːnɔŋkɔ
ଆଛା	aːt͡ʃʰaː
କୁଡ଼ିଆ	kuɽiaː
ଗଛରୁ	ɡɔt͡ʃʰɔru
ଅାରେ	ɔre
ମଙ୍ଗଳ	mɔŋɡɔl̪ɔ
ବିହାରୀ	bihaːri
ସଙ୍ଗାତ	sɔŋgaːt̪ɔ
ଯାଉଚୁ	d͡ʒaːut͡ʃu
ଛୁଞ୍ଚିଟା	t͡ʃʰuɲt͡ʃiʈaː
ରାଜନୀତି	raːd͡ʒɔnit̪i
ହେଲାବେଳେ	helaːbel̪e
ବାବଦରେ	baːbɔd̪ɔre
ଚାନ୍ଦୁଆ	t͡ʃaːnd̪uaː
ପର୍ବପର୍ବାଣୀ	pɔrbɔpɔrbaːɳi
ସ୍ୱପ୍ନ	suɔpnɔ
ଟ୍ରାଇଆସିକ	ʈraːiaːsikɔ
ହାଣ୍ଡିଟିକୁ	haːɳɖiʈiku
ଶଙ୍କର	sɔŋkɔɾɔ
ଆଣ୍ଟି	aːɳʈi
ବୁଝିଗଲୁ	bud͡ʒʱiɡɔlu
ହୋଲି	holi
ଦେଖେ	d̪ekʰe
ଆୟ	aːjɔ
ତେଲେଙ୍ଗାନା	t̪eleŋgaːnaː
ସାଥିରେ	saːt̪ʰire
ବର୍ଷ	bɔrsɔ
ପିନ୍ଧିଛନ୍ତି	pind̪ʱit͡ʃʰɔnt̪i
ଦେଖିପାରିବେ	d̪ekʰipaːribe
ଝପଟିଗଲା	d͡ʒʱɔpɔʈiɡɔlaː
ହେଇଯିବ	heid͡ʒibɔ
ଏଗୁଡ଼ାକ	eguɽaːkɔ
ନିଶକୁ	nisɔku
ଚିଡ଼େଇବାକୁ	t͡ʃiɽeibaːku
ପଟିକୁ	pɔʈiku
କାଢ଼ିକି	kaːɽʱiki
ବସିବାକୁ	bɔsibaːku
ଯୋଡିବା	d͡ʒoɖibaː
ଶାଖା	saːkʰaː
ଦୂର	d̪uɾɔ
ଭରିଯାଇଥିଲା	bʰɔrid͡ʒaːit̪ʰilaː
ଚୈତନ୍ୟ	t͡ʃɔit̪ɔnjɔ
ବେଂଗ	beŋɡɔ
ଭାଜିବାକୁ	bʱaːd͡ʒibaːku
ଦାଶ	d̪aːsɔ
ଉପଯୋଗ	upɔd͡ʒoɡɔ
ସୀମା	simaː
ଦେଖେଇ	d̪ekʰei
ସେମାନଙ୍କର	semaːnɔŋkɔɾɔ
ସବୁଠି	sɔbuʈʰi
ମୌଳିକ	moul̪ikɔ
ରଖିବାକୁ	ɾɔkʰibaːku
ଚାହୁଁଛି	t͡ʃaːhũt͡ʃʰi
ଅଞ୍ଚଳରେ	ɔɲt͡ʃɔl̪ɔre
ବଦଳରେ	bɔd̪ɔl̪ɔre
ରାବିଲା	raːbilaː
ଧାରା	d̪ʱaːraː
ଡଙ୍ଗା	ɖɔŋgaː
ଘେରା	gʰeraː
ସମ୍ରାଟ	sɔmraːʈɔ
ପିଇ	pii
ଡରେଇ	ɖɔrei
ଚାହିଁ	t͡ʃaːhĩ
ଭାବନା	bʱaːbɔnaː
ଉଠେଇଲି	uʈʰeili
ଗଚ୍ଛ	ɡɔt͡ʃt͡ʃʰɔ
କୁଡ଼ିଆକୁ	kuɽiaːku
ତିଆରିକଲେ	t̪iaːrikɔle
ଯୁଦ୍ଧରେ	d͡ʒud̪d̪ʱɔre
ବ୍ଳକର	bl̪ɔkɔɾɔ
କାଜରୀ	kaːd͡ʒɔri
ବସ	bɔsɔ
ନାଚ	naːt͡ʃɔ
ପୋଷାକର	posaːkɔɾɔ
ବାବରଙ୍କ	baːbɔɾɔŋkɔ
ସେଥିରୁ	set̪ʰiru
ଦର୍ଶନ	d̪ɔrsɔnɔ
ଚିତାବାଘ	t͡ʃit̪aːbaːɡʱɔ
ଥାଆନ୍ତା	t̪ʰaːaːnt̪aː
ଅଟୋରିକ୍ସା	ɔʈoriksaː
ଦେବୀ	d̪ebi
ନଇଁ	nɔĩ
ନାପସନ୍ଦ	naːpɔsɔnd̪ɔ
ମହାରାଜ	mɔhaːraːd͡ʒɔ
କରାମତି	kɔraːmɔt̪i
ଯବକାଚଟିଏ	d͡ʒɔbɔkaːt͡ʃɔʈie
ଇଟା	iʈaː
ସହଜକାମ	sɔhɔd͡ʒɔkaːmɔ
ଥାକର	t̪ʰaːkɔɾɔ
ହି	hi
କରିପାରିବେ	kɔripaːribe
ହଳଦିଆ	hɔl̪ɔd̪iaː
ଲୋକମାନଙ୍କୁ	lokɔmaːnɔŋku
ପିଲାକୁ	pilaːku
ବଧ	bɔd̪ʱɔ
ଭଦ୍ରକ	bʰɔd̪ɾɔkɔ
କାଟିବି	kaːʈibi
ବିରାଡ଼ି	biraːɽi
ହୋମ୍-ୱର୍କ	hom-uɔrkɔ
ଶବ୍ଦକୁ	sɔbd̪ɔku
ସେଇୟା	seijaː
ନାନା	naːnaː
ଅସିମୀୟା	ɔsimijaː
ତାରାମାନେ	t̪aːraːmaːne
ଢିଲା	ɖʱilaː
ପୃଷ୍ଠାର	prusʈʰaːɾɔ
ସ୍କୁଲଟିଏ	skulɔʈie
ତଳର	t̪ɔl̪ɔɾɔ
ଯୋରରେ	d͡ʒoɾɔre
କିଣିଲେ	kiɳile
ଡରୁଥିଲା	ɖɔrut̪ʰilaː
ପଢନ୍ତୁ	pɔɖʱɔnt̪u
ନିଶ୍ଚିତ	nist͡ʃit̪ɔ
ଧାରଣ	d̪ʱaːɾɔɳɔ
ଆଣୁଥିଲେ	aːɳut̪ʰile
ଶ୍ରୀନିବାସ	srinibaːsɔ
ସ୍କୁଲରୁ	skulɔru
ଆକାଶରେ	aːkaːsɔre
ଶୋଷିବା	sosibaː
ଗାଲିଚା	gaːlit͡ʃaː
କରିଦିଅନ୍ତି	kɔrid̪iɔnt̪i
ଡବାଟି	ɖɔbaːʈi
ମୂଷା	musaː
ପକୁଡ଼ି	pɔkuɽi
ଘଣ୍ଟିଟିଏ	ɡʱɔɳʈiʈie
ରାନ୍ଧୁଥିବା	raːnd̪ʱut̪ʰibaː
ନାକକିଛି	naːkɔkit͡ʃʰi
ମାଛଟିଏ	maːt͡ʃʰɔʈie
ମନୋଜ	mɔnod͡ʒɔ
ବେହେରା	beheraː
ଭରା	bʰɔraː
ପାରିବନି	paːribɔni
ଶାଢ଼ୀ	saːɽʱi
ନଚେଇବାରେ	nɔt͡ʃeibaːre
ଆଈ	aːi
ଗ୍ରନ୍ଥ	gɾɔnt̪ʰɔ
ବସେଇ	bɔsei
ଚଢ଼େଇଟିଏ	t͡ʃɔɽʱeiʈie
ମୋଗଲାଇ	moɡɔlaːi
ଆମେରିକୀୟ	aːmerikijɔ
ଗଣ୍ଠି	ɡɔɳʈʰi
ତାଂକ	t̪aːŋkɔ
କହିଛନ୍ତି	kɔhit͡ʃʰɔnt̪i
କେତେଗୁଡ଼ିଏ	ket̪eguɽie
ଡିଗ୍ରୀ	ɖigri
ଯୁକ୍ତରାଷ୍ଟ୍ର	d͡ʒukt̪ɔraːsʈɾɔ
ଭିତରକୁ	bʱit̪ɔɾɔku
ପଡିଲା	pɔɖilaː
ଭିତର	bʱit̪ɔɾɔ
କାନ୍ଦି	kaːnd̪i
ଫୁଟୁଥିବା	pʰuʈut̪ʰibaː
ଶିଡ଼ିରେ	siɽire
ତେବେବି	t̪ebebi
ଫିଟାଇ	pʰiʈaːi
ଆସ	aːsɔ
ପଚାରିଲି	pɔt͡ʃaːrili
ଚଷମାଟି	t͡ʃɔsɔmaːʈi
ପଚାରୁନଥିଲେ	pɔt͡ʃaːrunɔt̪ʰile
ଦେଖ୍	d̪ekʰ
ଜାରରେ	d͡ʒaːɾɔre
କାଉ	kaːu
ଚାଲାକ୍‌	t͡ʃaːlaːk
ଅଂକା	ɔŋkaː
ପ୍ରଣାଳୀ	pɾɔɳaːl̪i
ନୂଆଁ	nuaː̃
ସାଂଗେ	saːŋge
କିସ	kisɔ
କାୱଁ	kaːuɔ̃
ଡାକ୍ଟରଙ୍କର	ɖaːkʈɔɾɔŋkɔɾɔ
ଜଣାଯାଏ	d͡ʒɔɳaːd͡ʒaːe
ତହସିଲ	t̪ɔhɔsilɔ
ପୋର୍ଟାଲ	porʈaːlɔ
ପିନ୍ଧନ୍ତି	pind̪ʱɔnt̪i
ପାଞ୍ଚ	paːɲt͡ʃɔ
ଗଛମାନଙ୍କ	ɡɔt͡ʃʰɔmaːnɔŋkɔ
ଦାନ୍ତବିନ୍ଧା	d̪aːnt̪ɔbind̪ʱaː
ବସାଇ	bɔsaːi
ଚୁଡ଼ି	t͡ʃuɽi
ନୀଳରର	nil̪ɔɾɔɾɔ
ଚାଲୁ	t͡ʃaːlu
ବାନ୍ଧିବା	baːnd̪ʱibaː
ଜାଗାକୁ	d͡ʒaːgaːku
ଯାତ୍ରାରେ	d͡ʒaːt̪raːre
ଓହଳି	ohɔl̪i
ସଙ୍ଗଠନ	sɔŋɡɔʈʰɔnɔ
ବେଗ	beɡɔ
ଦ୍ୱିତୀୟ	d̪uit̪ijɔ
ପ୍ରାର୍ଥୀ	praːrt̪ʰi
ପଳାଅ	pɔl̪aːɔ
କାଟୁଥିବାବେଳେ	kaːʈut̪ʰibaːbel̪e
କିଶୋର	kisoɾɔ
ଲିଙ୍ଗରାଜ	liŋɡɔraːd͡ʒɔ
ମା-ବିଲେଇ	maː-bilei
ସପ୍ତାହ	sɔpt̪aːhɔ
ମାଆକୁ	maːaːku
ଗୋଲାପଜାମୁ	golaːpɔd͡ʒaːmu
ମୂର୍ତ୍ତି	murt̪t̪i
ମୋ	mo
ପକେଟରୁ	pɔkeʈɔru
ଅନିଲ	ɔnilɔ
କରାଯାଇଥିବା	kɔraːd͡ʒaːit̪ʰibaː
ବର୍ଷା	bɔrsaː
ଥିଲୁ	t̪ʰilu
ଆଣିବାଡୁ	aːɳibaːɖu
ଭୋଓଓ	bʱooo
ପଶ୍ଚିମ	pɔst͡ʃimɔ
ହଁ	hɔ̃
ନିଆଁରେ	niaː̃re
ଖୁଆଇ	kʰuaːi
ବର୍ଷର	bɔrsɔɾɔ
ସବୁତକ	sɔbut̪ɔkɔ
ଧାତୁ	d̪ʱaːt̪u
ରାନ୍ଧ	raːnd̪ʱɔ
ବିଚରା	bit͡ʃɔraː
ରହିଗଲା	ɾɔhiɡɔlaː
ଉପସ୍ଥିତି	upɔst̪ʰit̪i
ଉନ୍ନି	unni
ପାର୍ବତୀ	paːrbɔt̪i
ଅଟେ	ɔʈe
ତରୁଲତା	t̪ɔrulɔt̪aː
ହେଇଥାଏ	heit̪ʰaːe
ସାରଳା	saːɾɔl̪aː
ମୁସଲମାନ	musɔlɔmaːnɔ
ଖରାପ୍	kʰɔraːp
ଶିଥିଳ	sit̪ʰil̪ɔ
ବସ୍ତା	bɔst̪aː
ପାଦଶବ୍ଦ	paːd̪ɔsɔbd̪ɔ
ରକ୍ଷା	ɾɔkʰjaː
କଷିବାକୁ	kɔsibaːku
ଅବନ୍ତୀକୁ	ɔbɔnt̪iku
ପାଉନି	paːuni
ଆସୁଥିବା	aːsut̪ʰibaː
ସ୍ନିଫଲ୍ସର	snipʰɔlsɔɾɔ
ଟାପରା	ʈaːpɔraː
ଯାନ୍ତି	d͡ʒaːnt̪i
ଆସିବ	aːsibɔ
ସଂଖ୍ୟା-ଗଣତି	sɔŋkʰjaː-ɡɔɳɔt̪i
ପଚାରି	pɔt͡ʃaːri
ପଚାରିଲା	pɔt͡ʃaːrilaː
ଜଣାଶୁଣା	d͡ʒɔɳaːsuɳaː
ଆଗରୁ	aːɡɔru
ରୁପେ	rupe
ଲୋକଙ୍କୁ	lokɔŋku
ଫଳରେ	pʰɔl̪ɔre
ସିଏ	sie
ତୋ	t̪o
ଜାଲରେ	d͡ʒaːlɔre
ପିନ୍ଧି	pind̪ʱi
ଆଣିବାକୁ	aːɳibaːku
ପରଶିବା	pɔɾɔsibaː
ପଶ୍ଚିମରେ	pɔst͡ʃimɔre
ପାର୍ଶି	paːrsi
ପିଅନ୍ତି	piɔnt̪i
ଶତାବ୍ଦୀରେ	sɔt̪aːbd̪ire
ଯେତେ	d͡ʒet̪e
ଘୋଡାରେ	gʰoɖaːre
ନିର୍ଦ୍ଦେଶନା	nird̪d̪esɔnaː
କାଢ଼ି	kaːɽʱi
ଲା	laː
ସୁଜାତା	sud͡ʒaːt̪aː
ଉଞ୍ଚା	uɲt͡ʃaː
ବିନ୍	bin
ଫେରିବା	pʰeribaː
ଗୋଡ	goɖɔ
ନାନ	naːnɔ
ଛତିଶଗଡ଼	t͡ʃʰɔt̪isɔɡɔɖɔ
ଲିଖନ	likʰɔnɔ
ବଡ	bɔɖɔ
ଏକମାତ୍ର	ekɔmaːt̪ɾɔ
ଦୁଃଖି	d̪uhkʰi
ଖେଳନ୍ତି	kʰel̪ɔnt̪i
ଭୋଜନ	bʱod͡ʒɔnɔ
ପ୍ରସିଦ୍ଧ	pɾɔsid̪d̪ʱɔ
ମେଘାଲୟ	megʰaːlɔjɔ
କୁଣ୍ଡାଇ	kuɳɖaːi
ଇଂଲଣ୍ଡ	iŋlɔɳɖɔ
ସନ୍ତାନକୁ	sɔnt̪aːnɔku
ଚଢ଼ିବାକୁ	t͡ʃɔɽʱibaːku
ବଂଶ	bɔŋsɔ
ପ୍ରଦେଶ	pɾɔd̪esɔ
ଉଡୁଥିବା	uɖut̪ʰibaː
ପଡ଼ିଯାଏ	pɔɽid͡ʒaːe
ପଢ଼ା	pɔɽʱaː
ଫନିକୁ	pʰɔniku
ନିଜକଥା	nid͡ʒɔkɔt̪ʰaː
ମ୍ୟାଜିକ	mjaːd͡ʒikɔ
ଉଡ଼େଇଲା	uɽeilaː
ଦୟାରେ	d̪ɔjaːre
କାନ୍ଥ	kaːnt̪ʰɔ
ଅଭ୍ୟସ୍ତ	ɔbʱjɔst̪ɔ
ବର୍ଷେ	bɔrse
ଯୁଗର	d͡ʒuɡɔɾɔ
ବେଳ	bel̪ɔ
ବୁଲିପଡ଼ି	bulipɔɽi
ଖାଇଲେ	kʰaːile
ଗଲାବେଳକୁ	ɡɔlaːbel̪ɔku
କଥାଟା	kɔt̪ʰaːʈaː
ଇଉରୋପ	iuropɔ
ସରବତ	sɔɾɔbɔt̪ɔ
କାଟିବାକୁ	kaːʈibaːku
ରାଜନୈତିକ	raːd͡ʒɔnɔit̪ikɔ
ସାର	saːɾɔ
ହଜିଗଲା	hɔd͡ʒiɡɔlaː
ଦିଆଯାଏ	d̪iaːd͡ʒaːe
ରନ୍ଧାଘର	ɾɔnd̪ʱaːɡʱɔɾɔ
ସାହିଲ୍	saːhil
ଗାଧୋଇ	gaːd̪ʱoi
ଏକୁଟିଆ	ekuʈiaː
ଏକଦମ୍‌	ekɔd̪ɔm
ନିରସ	niɾɔsɔ
ଓସ୍ତଗଛରେ	ost̪ɔɡɔt͡ʃʰɔre
ଧରନ୍ତି	d̪ʱɔɾɔnt̪i
ରୋଗୀ	rogi
ଦେଖାଗଲା	d̪ekʰaːɡɔlaː
ଗାନ୍ଧୀଜୀଙ୍କ	gaːnd̪ʱid͡ʒiŋkɔ
ଭାରତୀୟ	bʱaːɾɔt̪ijɔ
ଧନ୍ଦା	d̪ʱɔnd̪aː
ରୁଟିଟି	ruʈiʈi
ମୁଚକକୁ	mut͡ʃɔkɔku
ସକାଳୁ	sɔkaːl̪u
ଦଉଡ଼ି	d̪ɔuɽi
ଟପିଗଲା	ʈɔpiɡɔlaː
କେରଳ	keɾɔl̪ɔ
ଙ୍କୁ	ŋku
ଉଭାନ୍	ubʱaːn
କିଣୁଥିଲେ	kiɳut̪ʰile
ଶିଖିବୁ	sikʰibu
ବଦଳୁ	bɔd̪ɔl̪u
ଜଳି	d͡ʒɔl̪i
ରହିଛି	ɾɔhit͡ʃʰi
ସୂର୍ଯ୍ୟ	surd͡ʒjɔ
ରହମତ୍	ɾɔhɔmɔt̪
କମ୍ପ୍ୟୁଟର	kɔmpjuʈɔɾɔ
ଆୟୋଜନ	aːjod͡ʒɔnɔ
ଗୁଜରାଟୀ	gud͡ʒɔraːʈi
ବେଶୀ	besi
ଚିନାବାଦାମ-ଯାତ୍ରା	t͡ʃinaːbaːd̪aːmɔ-d͡ʒaːt̪raː
ପୁରି	puri
ଲକ୍ଷଣ	lɔkʰjɔɳɔ
ଖାଉଖାଉ	kʰaːukʰaːu
ବଞ୍ଚେଇବା	bɔɲt͡ʃeibaː
ପରସ୍ପର	pɔɾɔspɔɾɔ
ଲାଲା	laːlaː
ଆଖୁ	aːkʰu
ଛୁଅଁନା	t͡ʃʰuɔ̃naː
ବିଶେଷତଃ	bisesɔt̪ɔh
ପାଢ଼ୀ	paːɽʱi
ସତରେ	sɔt̪ɔre
ବୟସ୍କ	bɔjɔskɔ
ପ୍ରାଣେ	praːɳe
ରାଶିଗୁଡ଼	raːsiguɽɔ
ପ୍ରାଣ	praːɳɔ
ନାମକରଣ	naːmɔkɔɾɔɳɔ
କ୍ଲିକ	klikɔ
ଦେଖାଯାଏ	d̪ekʰaːd͡ʒaːe
ସମ୍ପୂର୍ଣ୍ଣ	sɔmpurɳɳɔ
ଛାଞ୍ଚ	t͡ʃʰaːɲt͡ʃɔ
ଶୁଂଘିଦେଲା	suŋgʰid̪elaː
ଦାଲଚିନି	d̪aːlɔt͡ʃini
ଅନ୍ଧକାରରେ	ɔnd̪ʱɔkaːɾɔre
ହୋଇସାରିଛି	hoisaːrit͡ʃʰi
ଜଲାଲୁଦ୍ଦିନ	d͡ʒɔlaːlud̪d̪inɔ
ନେଇଛନ୍ତି	neit͡ʃʰɔnt̪i
ପୃଷ୍ଠାଟିଏ	prusʈʰaːʈie
ହେଇଯାଇଛି	heid͡ʒaːit͡ʃʰi
ଚାଲନ୍ତି	t͡ʃaːlɔnt̪i
ଯାହାର	d͡ʒaːhaːɾɔ
ଉପକାର	upɔkaːɾɔ
ଦର୍ଶନୀୟ	d̪ɔrsɔnijɔ
ଗଧିଆର	ɡɔd̪ʱiaːɾɔ
କେବେ	kebe
ମାଗିଲେ	maːgile
ଖୋଳୁଛି	kʰol̪ut͡ʃʰi
ବାନାର୍ଜୀ	baːnaːrd͡ʒi
ବଂଶାନୁଗତ	bɔŋsaːnuɡɔt̪ɔ
ପିଇବାରେ	piibaːre
ଯୋଗସୂତ୍ର	d͡ʒoɡɔsut̪ɾɔ
ଏଇଟା	eiʈaː
ଶବ୍ଦ	sɔbd̪ɔ
ମହାନ	mɔhaːnɔ
ଗଭୀରକୁ	ɡɔbʱiɾɔku
ଭୋକ	bʱokɔ
କାନ୍ଦେ	kaːnd̪e
ଆଣ୍ଡ	aːɳɖɔ
ସୁଦର୍ଶନ	sud̪ɔrsɔnɔ
ଅଦ୍ଭୁତ	ɔd̪bʱut̪ɔ
ଭ୍ରମର	bʱɾɔmɔɾɔ
ଆସ୍ତେକରି	aːst̪ekɔri
କୋଳେଇ	kol̪ei
କହିଦେଇ	kɔhid̪ei
ସର୍ବତ	sɔrbɔt̪ɔ
ଜିଲ୍ଲାର	d͡ʒillaːɾɔ
ଦେଇଦେଲେ	d̪eid̪ele
ନେଇଯିବାକୁ	neid͡ʒibaːku
ଜୁଲାଇ	d͡ʒulaːi
ବୋଷ	bosɔ
ସାଙ୍ଗ	saːŋɡɔ
ମରାମତି	mɔraːmɔt̪i
ଆଡ଼େ	aːɽe
ତଥ୍ୟ	t̪ɔt̪ʰjɔ
ଛବି	t͡ʃʰɔbi
ସିମେଣ୍ଟ	simeɳʈɔ
ଖେଳଣା	kʰel̪ɔɳaː
କରି	kɔri
ଏଠୁ	eʈʰu
କ୍ଷଣକ	kʰjɔɳɔkɔ
ପଦ	pɔd̪ɔ
କରିଥାଏ	kɔrit̪ʰaːe
କୂଳର	kul̪ɔɾɔ
ପିନ୍ଧିଥିଲା	pind̪ʱit̪ʰilaː
ତାନସେନ	t̪aːnɔsenɔ
ଖୋଇସାରି	kʰoisaːri
ଲିପି	lipi
ମୟୁୁର	mɔjuɾɔ
ଜାଣିପାରୁଛି	d͡ʒaːɳipaːrut͡ʃʰi
ବସିଥାନ୍ତି	bɔsit̪ʰaːnt̪i
ରୂପ	rupɔ
ଓଲ୍ହାଇ	olhaːi
ଫନିର	pʰɔniɾɔ
ପରଟା	pɔɾɔʈaː
ତରାଟି	t̪ɔraːʈi
ମାସିକ	maːsikɔ
ବିରାଟ	biraːʈɔ
ଦିୱାନ୍	d̪iuaːn
ଜନ୍ମତିଥି	d͡ʒɔnmɔt̪it̪ʰi
ଦୋକାନସବୁ	d̪okaːnɔsɔbu
ନିଶଥିବା	nisɔt̪ʰibaː
ଉପେନ୍ଦ୍ର	upend̪ɾɔ
ପିନ୍ଧିଥିବା	pind̪ʱit̪ʰibaː
ସଜାଇ	sɔd͡ʒaːi
ଭାବୁଛ	bʱaːbut͡ʃʰɔ
ଦେଖିସାରିଥିଲା	d̪ekʰisaːrit̪ʰilaː
ଓଦା	od̪aː
ଖଣ୍ଡେ	kʰɔɳɖe
ସମସାମୟିକ	sɔmɔsaːmɔjikɔ
କେଡେ	keɖe
ଦୋକାନଟିକୁ	d̪okaːnɔʈiku
ମଞ୍ଚସ୍ଥ	mɔɲt͡ʃɔst̪ʰɔ
ଉତ୍ପନ୍ନର	ut̪pɔnnɔɾɔ
ଅଧାଖିଆ	ɔd̪ʱaːkʰiaː
ପାରୁନାଁହ	paːrunaː̃hɔ
କହିବୁ	kɔhibu
ସ୍କୁଟର	skuʈɔɾɔ
ଲମ୍ୱାବାଳ	lɔmuaːbaːl̪ɔ
ଉଡ଼ିଗଲା	uɽiɡɔlaː
ଶାନ୍ତି	saːnt̪i
ରାଜଦରବାରକୁ	raːd͡ʒɔd̪ɔɾɔbaːɾɔku
ଲାଗୁଛି	laːgut͡ʃʰi
ହେବାପରେ	hebaːpɔre
ବଦଳେଇବା	bɔd̪ɔl̪eibaː
ରୋଗର	roɡɔɾɔ
ଠିକଣା	ʈʰikɔɳaː
ବ୍ରହ୍ମପୁର	bɾɔhmɔpuɾɔ
ଅଧିକାଂଶ	ɔd̪ʱikaːŋsɔ
ନିରନ୍ତର	niɾɔnt̪ɔɾɔ
ହିରନ୍	hiɾɔn
ଏସ୍	es
ଯିବି	d͡ʒibi
ଚିଡ଼ିଆଖାନା	t͡ʃiɽiaːkʰaːnaː
ସାଥୀରେ	saːt̪ʰire
ସେବକ	sebɔkɔ
ଟିକେ	ʈike
ଉଙ୍କି	uŋki
ଗୋଲୁର	goluɾɔ
ପଡିଲେ	pɔɖile
ଆଖିରୁ	aːkʰiru
ଖରା	kʰɔraː
ଉଠାଇଲେ	uʈʰaːile
ମହାଭାରତ	mɔhaːbʱaːɾɔt̪ɔ
ଶଂକରର	sɔŋkɔɾɔɾɔ
କିସମିସ୍	kisɔmis
ହିନ୍ଦୀ	hind̪i
ଘରକୁ	ɡʱɔɾɔku
ପ୍ରାଚୀନ	praːt͡ʃinɔ
ନିର୍ମାତା	nirmaːt̪aː
ସମୂହ	sɔmuhɔ
ଗଣତିର	ɡɔɳɔt̪iɾɔ
ସେପଟ	sepɔʈɔ
ପଡ଼ୁଛି	pɔɽut͡ʃʰi
ଖାଇବ	kʰaːibɔ
ଜୀବାଶ୍ମ	d͡ʒibaːsmɔ
ମଧୁର	mɔd̪ʱuɾɔ
ଗ୍ରୀଷ୍ମ	grismɔ
ପଦଯାତ୍ରୀର	pɔd̪ɔd͡ʒaːt̪riɾɔ
ରାଜ୍ୟପାଳ	raːd͡ʒjɔpaːl̪ɔ
ଜନ୍ମଗ୍ରହଣ	d͡ʒɔnmɔgɾɔhɔɳɔ
ଖୋଲିଲେ	kʰolile
ଆଖିଥିଲା	aːkʰit̪ʰilaː
ରଖୁ	ɾɔkʰu
ପରିବାର	pɔribaːɾɔ
ଅବସ୍ଥାନ	ɔbɔst̪ʰaːnɔ
ବୋର୍ଡ଼	borɖɔ
ଅସୁସ୍ଥ	ɔsust̪ʰɔ
ଦି	d̪i
ବାକି	baːki
ଲଡ୍ଡୁ	lɔɖɖu
ଖାବରା	kʰaːbɔraː
ଛାଡିଦେଲେ	t͡ʃʰaːɖid̪ele
ପାନୀୟ	paːnijɔ
ଲୋକକଳା	lokɔkɔl̪aː
ଖାଉନୁ	kʰaːunu
ମଣ୍ଡଳି	mɔɳɖɔl̪i
ମୋଡ଼ିଦେଲା	moɽid̪elaː
ଆଖିବୁଜି	aːkʰibud͡ʒi
ଆସିନାହିଁ	aːsinaːhĩ
ମନୋନୟନ	mɔnonɔjɔnɔ
ଚତୁର୍ଥ	t͡ʃɔt̪urt̪ʰɔ
ପଖାଳ	pɔkʰaːl̪ɔ
ଲାଲରଙ୍ଗର	laːlɔɾɔŋɡɔɾɔ
ବନ୍ଦ	bɔnd̪ɔ
ଚାପି	t͡ʃaːpi
ମାଙ୍କଡ଼ଟିଏ	maːŋkɔɽɔʈie
ଅଧା	ɔd̪ʱaː
ଉପରକୁ	upɔɾɔku
ଅବଶ୍ୟ	ɔbɔsjɔ
ଭୂମି	bʱumi
ଠେକୁଆଠୁ	ʈʰekuaːʈʰu
ଗୋଳା	gol̪aː
ଫୁଂକାରେ	pʰuŋkaːre
ଏଠି	eʈʰi
ସମ୍ବନ୍ଧୀୟ	sɔmbɔnd̪ʱijɔ
ଜାତିର	d͡ʒaːt̪iɾɔ
ଦେଉ	d̪eu
ଜୋର୍‌ରେ	d͡ʒorre
ରଖ	ɾɔkʰɔ
ନୁହଁ	nuhɔ̃
ବିଜଦ	bid͡ʒɔd̪ɔ
ଗାନ୍ଧିଜୀଙ୍କୁ	gaːnd̪ʱid͡ʒiŋku
ତା	t̪aː
ଅଫିସ	ɔpʰisɔ
ପଢୁଥିଲା	pɔɖʱut̪ʰilaː
ପଡ଼ିଯାଇଥିଲା	pɔɽid͡ʒaːit̪ʰilaː
ଆସିଲା	aːsilaː
ପାଣିଗାହି	paːɳigaːhi
ଆଗେ	aːge
ଅଳଙ୍କାର	ɔl̪ɔŋkaːɾɔ
ଟ୍ରେନରେ	ʈrenɔre
ମଷ୍ତିସ୍କ	mɔst̪iskɔ
ପୂର୍ତ୍ତି	purt̪t̪i
ମାନେ	maːne
ଗୋପାଳ	gopaːl̪ɔ
ଲୁହଦାଗ	luhɔd̪aːɡɔ
ଜେଜେବାପାଙ୍କର	d͡ʒed͡ʒebaːpaːŋkɔɾɔ
ସେଗୁଡିକର	seguɖikɔɾɔ
ହୋଇଛନ୍ତି	hoit͡ʃʰɔnt̪i
ବଣ	bɔɳɔ
ସେଥି	set̪ʰi
ଶ୍ରୀଙ୍ଗେରୀ	sriŋgeri
ମୁ	mu
ଗାଳ୍ପିକ	gaːl̪pikɔ
ତୋତେ	t̪ot̪e
ରାତି	raːt̪i
ସେମିତି	semit̪i
ଚଢ଼େଇମାନେ	t͡ʃɔɽʱeimaːne
ଶୁଭଂକର	subʰɔŋkɔɾɔ
କାଶୁ	kaːsu
ଦେଖିଥିବ	d̪ekʰit̪ʰibɔ
ବିହନ	bihɔnɔ
ଚାହାନ୍ତି	t͡ʃaːhaːnt̪i
ବୋତଲଟିର	bot̪ɔlɔʈiɾɔ
ଦିଆ	d̪iaː
ବୁଝାଇ	bud͡ʒʱaːi
ବାକୁ	baːku
ସମର୍ଥନ	sɔmɔrt̪ʰɔnɔ
କାଲିଆ	kaːliaː
ଏହିଦିନ	ehid̪inɔ
ଅଟକିଗଲେ	ɔʈɔkiɡɔle
ଆବର୍ଦ୍ଧକ	aːbɔrd̪d̪ʱɔkɔ
ପୁସ୍ତକ	pust̪ɔkɔ
ଚରିତ୍ର	t͡ʃɔrit̪ɾɔ
ହେବାରୁ	hebaːru
ବୁଲୁ	bulu
ମେଲେଇ	melei
ଶ୍ୱାସ	suaːsɔ
ପରିବାବାଲା	pɔribaːbaːlaː
ଚାଲୁଥିଲା	t͡ʃaːlut̪ʰilaː
ଦାୟିତ୍ଵ	d̪aːjit̪uɔ
ପ୍ରଶ୍ନର	pɾɔsnɔɾɔ
ବାରଣ୍ତାରେ	baːɾɔɳt̪aːre
କଟକରେ	kɔʈɔkɔre
କୁକୁରକୁ	kukuɾɔku
ବି	bi
ଘୋଷାରି	gʰosaːri
ନୌକାଠୁ	nɔukaːʈʰu
ନେଉଥିଲା	neut̪ʰilaː
ଶତକଡ଼ା	sɔt̪ɔkɔɽaː
ସୋନପୁର	sonɔpuɾɔ
ଚାଲିକି	t͡ʃaːliki
ଟ୍ରେନ୍	ʈren
ହୋଇଗଲିଣି	hoiɡɔliɳi
ଅଟଳ	ɔʈɔl̪ɔ
ନର୍ସୀ	nɔrsi
ମୁଖ୍ୟମନ୍ତ୍ରୀ	mukʰjɔmɔnt̪ri
ଜେଜେଙ୍କର	d͡ʒed͡ʒeŋkɔɾɔ
ବାକ୍ସରୁ	baːksɔru
ତାପରେ	t̪aːpɔre
ଅଫ	ɔpʰɔ
ଦ୍ଵୀପପୁଞ୍ଜ	d̪uipɔpuɲd͡ʒɔ
କ୍ରୀକ୍	krik
ଜଙ୍ଗଲରେ	d͡ʒɔŋɡɔlɔre
ବୁଝିବା	bud͡ʒʱibaː
କରିଥିଲା	kɔrit̪ʰilaː
ଛାଡୁଥିଲା	t͡ʃʰaːɖut̪ʰilaː
ହୃଦୟ	hɔrud̪ɔjɔ
ଗଣ	ɡɔɳɔ
ଗଣ୍ଠିର	ɡɔɳʈʰiɾɔ
ଗୋଧୁଳୀ	god̪ʱul̪i
ରେଶମ	resɔmɔ
ଚନ୍ଦ୍ରହୀନ	t͡ʃɔnd̪ɾɔhinɔ
କରୁଥିଲି	kɔrut̪ʰili
ଛୁଆକୁ	t͡ʃʰuaːku
ଅନୁଭବ	ɔnubʰɔbɔ
ପାରିବେ	paːribe
କକା	kɔkaː
ହେଉଥିଲେ	heut̪ʰile
ରାକ୍ଷସ	raːkʰjɔsɔ
ସୁସ୍ଥ	sust̪ʰɔ
ଡିସେମ୍ବର	ɖisembɔɾɔ
କରିବାର	kɔribaːɾɔ
ଖରଣାଟି	kʰɔɾɔɳaːʈi
ଡାହାଣକୁ	ɖaːhaːɳɔku
କଥାକୁ	kɔt̪ʰaːku
ଟିପ୍ପଣୀ	ʈippɔɳi
ଅନୁଗାମୀ	ɔnugaːmi
ସେହି	sehi
ଆନନ୍ଦଦାୟକ	aːnɔnd̪ɔd̪aːjɔkɔ
ଚାରିବର୍ଷର	t͡ʃaːribɔrsɔɾɔ
ନିଶୁଆ	nisuaː
ଲାଗିଲେ	laːgile
ମାଛିଙ୍କ	maːt͡ʃʰiŋkɔ
ଲଡୁଟିଏ	lɔɖuʈie
ଟେବୁଲ୍	ʈebul
ରାଜି	raːd͡ʒi
ତୃତୀୟ	t̪rut̪ijɔ
ଉଡ଼ିବୁଲନ୍ତି	uɽibulɔnt̪i
ଭର୍ତ୍ତି	bʰɔrt̪t̪i
ଫନି	pʰɔni
ସେଠିବି	seʈʰibi
ତେଣୁ	t̪eɳu
ଫିକା	pʰikaː
ପେଣ୍ଡୁରେ	peɳɖure
ଲେଖା	lekʰaː
ଆସୁଛି	aːsut͡ʃʰi
ହୋଇଯାଉଛି	hoid͡ʒaːut͡ʃʰi
ବାୟ	baːjɔ
ଗାଉଛି	gaːut͡ʃʰi
କାନ୍ଧଥିଲା	kaːnd̪ʱɔt̪ʰilaː
ଉତ୍ପନ୍ନ	ut̪pɔnnɔ
ଅବାଗିଆ	ɔbaːgiaː
ନାକର	naːkɔɾɔ
ସରକାରୀ	sɔɾɔkaːri
ଆକାଶ	aːkaːsɔ
ଭାବିଲେ	bʱaːbile
ଭାଙ୍ଗିକି	bʱaːŋgiki
ସହର	sɔhɔɾɔ
ତାଟିଆରେ	t̪aːʈiaːre
ଦୁଷ୍ଟାମୀ	d̪usʈaːmi
ମହମବତୀ	mɔhɔmɔbɔt̪i
ଗୁହାରୀ	guhaːri
କ୍ଷଣି	kʰjɔɳi
କେବେବି	kebebi
ଘୋଷ	gʰosɔ
ଦେଇଥିଲା	d̪eit̪ʰilaː
ଠିଆ	ʈʰiaː
ରାୟ	raːjɔ
ଫେସବୁକ	pʰesɔbukɔ
କ୍ରିକେଟ	krikeʈɔ
ତ୍ରିପାଠୀ	t̪ripaːʈʰi
ଦଶହରା	d̪ɔsɔhɔraː
ବିନ୍ୟାସ	binjaːsɔ
ଚାରିଆଡ଼େ	t͡ʃaːriaːɽe
ଅଣ୍ଟିରେ	ɔɳʈire
କନ୍ଧମାଳ	kɔnd̪ʱɔmaːl̪ɔ
ପୂର୍ଣ୍ଣିମା	purɳɳimaː
କାମରେ	kaːmɔre
ଜାତୀୟ	d͡ʒaːt̪ijɔ
ଆମ୍ବାସୁର	aːmbaːsuɾɔ
ଆଙ୍ଗୁଠି	aːŋguʈʰi
ଭାଙ୍ଗିବା	bʱaːŋgibaː
ଯାଉଥଲେ	d͡ʒaːut̪ʰɔle
ପକ୍ଷ	pɔkʰjɔ
କୃଷ୍ଣ	krusɳɔ
ଶ୍ରୀନିବାସର	srinibaːsɔɾɔ
ଖୋଳୁଥିଲା	kʰol̪ut̪ʰilaː
ରାସ୍ତାର	raːst̪aːɾɔ
ବ୍ୟର୍ଥ	bjɔrt̪ʰɔ
ବନେଇଲେ	bɔneile
ଅକ୍ଷର	ɔkʰjɔɾɔ
ସମୟେ	sɔmɔje
କରାଯାଇ	kɔraːd͡ʒaːi
ଇଚ୍ଛା	it͡ʃt͡ʃʰaː
କୃଷକ	krusɔkɔ
ମିସ୍‌	mis
ଟାଣି	ʈaːɳi
ବୁଦ୍ଧିଆ	bud̪d̪ʱiaː
ଶିଳ୍ପ	sil̪pɔ
ସ୍ଥଳ	st̪ʰɔl̪ɔ
ସମସ୍ତଙ୍କର	sɔmɔst̪ɔŋkɔɾɔ
ଯାଉଛନ୍ତି	d͡ʒaːut͡ʃʰɔnt̪i
ସେନା	senaː
ଆପଣଙ୍କୁ	aːpɔɳɔŋku
ନେଇଆସିବୁ	neiaːsibu
ଓହଳେଇ	ohɔl̪ei
ବାଗେଇ	baːgei
କୁକୁଡ଼ା	kukuɽaː
ତୁ	t̪u
ପଳାଇଲା	pɔl̪aːilaː
ପୁରିଥିବା	purit̪ʰibaː
ନିଦ	nid̪ɔ
ସାକ୍ଷରତା	saːkʰjɔɾɔt̪aː
ଶୀଘ୍ର	sigʰɾɔ
ଶାହୀ	saːhi
ଲାଗନ୍ତି	laːɡɔnt̪i
ପଡ଼ୋଶୀ	pɔɽosi
ଜାଣିଥିଲା	d͡ʒaːɳit̪ʰilaː
କାଠି	kaːʈʰi
କିଲୋ	kilo
ଶକ୍ତି	sɔkt̪i
ଗୁରୁ	guru
ଉଦ୍ୟାନ	ud̪jaːnɔ
କର	kɔɾɔ
ସଙ୍ଗୀତକାର	sɔŋgit̪ɔkaːɾɔ
ଶିଖାଇଦେବେ	sikʰaːid̪ebe
ସେଇଟାକୁ	seiʈaːku
ଥାନ୍ତା	t̪ʰaːnt̪aː
ଜାଳିବାକୁ	d͡ʒaːl̪ibaːku
ମିଳିଗଲା	mil̪iɡɔlaː
ପାଇଲେ	paːile
ଘୋଡଣୀ	gʰoɖɔɳi
ଫଟକ	pʰɔʈɔkɔ
ହେବାରେ	hebaːre
ମହାରାଷ୍ଟ୍ର	mɔhaːraːsʈɾɔ
ନେଲା	nelaː
ଖରାପଡୁଥିବା	kʰɔraːpɔɖut̪ʰibaː
ରଜ	ɾɔd͡ʒɔ
ଓଣମ୍	oɳɔm
ଦେଖୁଥାଏ	d̪ekʰut̪ʰaːe
ଫେଣରେ	pʰeɳɔre
ଲବଙ୍ଗ	lɔbɔŋɡɔ
ବିନିର	biniɾɔ
ଗହଣା	ɡɔhɔɳaː
ବଜାର୍	bɔd͡ʒaːr
ଯୋଦ୍ଧା	d͡ʒod̪d̪ʱaː
ଶିକ୍ଷଣ	sikʰjɔɳɔ
ବସନ୍ତ	bɔsɔnt̪ɔ
କହିଦେବୁ	kɔhid̪ebu
ଫେରୁଛି	pʰerut͡ʃʰi
ପ୍ରଭାବିତ	pɾɔbʱaːbit̪ɔ
ଅପ୍ରେଲ	ɔprelɔ
ସଠିକ	sɔʈʰikɔ
ଜାର୍	d͡ʒaːr
ଚାଦର	t͡ʃaːd̪ɔɾɔ
କାନ୍ଦିବ	kaːnd̪ibɔ
ପାକିସ୍ତାନ	paːkist̪aːnɔ
ନିଏ	nie
ବ୍ୟବହାରକାରୀ	bjɔbɔhaːɾɔkaːri
ମଜାକିଆ	mɔd͡ʒaːkiaː
କେଳୁଚରଣ	kel̪ut͡ʃɔɾɔɳɔ
ଗଣନା	ɡɔɳɔnaː
ସୁକୁଟା	sukuʈaː
ଖୋଜି	kʰod͡ʒi
ବାହାରନ୍ତି	baːhaːɾɔnt̪i
ଶଙ୍ଖ	sɔŋkʰɔ
ଜଳୁଥିବା	d͡ʒɔl̪ut̪ʰibaː
ଫାଟକ	pʰaːʈɔkɔ
ଘୋଡ଼ାଇ	gʰoɽaːi
ନାଚିଲା	naːt͡ʃilaː
ଶାସ୍ତ୍ର	saːst̪ɾɔ
ଖୋଲିଦେଲେ	kʰolid̪ele
ମହାଦେଶରେ	mɔhaːd̪esɔre
କୁମ୍ଭୀରଟେ	kumbʱiɾɔʈe
କରିବାକୁ	kɔribaːku
ମରିଗଲିଣି	mɔriɡɔliɳi
ଘରେ	ɡʱɔre
ଟ୍ୟୁବ୍	ʈjub
ଉଠ୍	uʈʰ
ଶ୍ରୀନଗର	srinɔɡɔɾɔ
ପୁରୁଷ	purusɔ
ଢୋକିପାରିଲା	ɖʱokipaːrilaː
ବଂଶୀ	bɔŋsi
ଚାଲୁଥିବା	t͡ʃaːlut̪ʰibaː
ଖଣ୍ଡ	kʰɔɳɖɔ
ଗର୍ବିତ	ɡɔrbit̪ɔ
ବ୍ୟାଣ୍ଡ୍	bjaːɳɖ
ଶୀତୋଷ୍ଣ	sit̪osɳɔ
ଗୁଣି	guɳi
ମସିହାରେ	mɔsihaːre
କମ୍ୟୁନିଷ୍ଟ	kɔmjunisʈɔ
ମୋରେ	more
ମଧ୍ୟ	mɔd̪ʱjɔ
ଯାଉଥିଲା	d͡ʒaːut̪ʰilaː
ଆଗ୍ରହୀ	aːgɾɔhi
ଚିନ୍ତା	t͡ʃint̪aː
ଦେଖୁଛନ୍ତି	d̪ekʰut͡ʃʰɔnt̪i
ଶୋଇବା	soibaː
ମେଲେଇଦିଅ	meleid̪iɔ
ପରିବେଷଣ	pɔribesɔɳɔ
ଚୋବାଉ	t͡ʃobaːu
ଶହରର	sɔhɔɾɔɾɔ
ତପସ୍ୟା	t̪ɔpɔsjaː
ଚାଚାଙ୍କୁ	t͡ʃaːt͡ʃaːŋku
ହୋଇଅଛି	hoiɔt͡ʃʰi
ପ୍ରହରୀଟି	pɾɔhɔriʈi
ରଫୁ	ɾɔpʰu
କମ୍	kɔm
ଡାକୁଥିଲେ	ɖaːkut̪ʰile
କ୍ଷମତା	kʰjɔmɔt̪aː
ମହମ୍ମଦ	mɔhɔmmɔd̪ɔ
ମୟୂର	mɔjuɾɔ
ଭାବନାରେ	bʱaːbɔnaːre
ଯେମିତିକି	d͡ʒemit̪iki
ସନ୍ଧ୍ୟାରେ	sɔnd̪ʱjaːre
ଦିଶନ୍ତି	d̪isɔnt̪i
ଅସହଯୋଗ	ɔsɔhɔd͡ʒoɡɔ
ଏପଟକୁ	epɔʈɔku
ରାନ୍ଧିବାରେ	raːnd̪ʱibaːre
ଦୂରକୁ	d̪uɾɔku
ସଜା	sɔd͡ʒaː
ତଥାପି	t̪ɔt̪ʰaːpi
ଦେବି	d̪ebi
ବସିଲେ	bɔsile
ମାଉସ	maːusɔ
ବଳ	bɔl̪ɔ
ଟିକା	ʈikaː
ଏଫୁଲରୁ	epʰulɔru
ଗୁଡ଼ିକ	guɽikɔ
ଗୋପବନ୍ଧୁ	gopɔbɔnd̪ʱu
ମାଛ	maːt͡ʃʰɔ
ସବୁ	sɔbu
ବୁଲୁବୁଲୁ	bulubulu
ଆଉଥରେ	aːut̪ʰɔre
ଆଣିଦେବ	aːɳid̪ebɔ
ଚୌକି	t͡ʃɔuki
ପରି	pɔri
ମୋଟ	moʈɔ
ସାଧୁ	saːd̪ʱu
ଫରହାନ	pʰɔɾɔhaːnɔ
ଲୋକକୁ	lokɔku
ଯାହାହେଲେ	d͡ʒaːhaːhele
ବାହାରିଥିଲା	baːhaːrit̪ʰilaː
ଥାନ୍ତି	t̪ʰaːnt̪i
ପଚାକାଠ	pɔt͡ʃaːkaːʈʰɔ
କୁଆଡ଼େ	kuaːɽe
ତୀବ୍ର	t̪ibɾɔ
ମାନଚିତ୍ର	maːnɔt͡ʃit̪ɾɔ
ସୂର୍ଯ୍ୟକୀରଣ	surd͡ʒjɔkiɾɔɳɔ
ପକାଇଥାନ୍ତି	pɔkaːit̪ʰaːnt̪i
ଛଅ	t͡ʃʰɔɔ
କୁମାରୀ	kumaːri
ଛାତ୍ର	t͡ʃʰaːt̪ɾɔ
ରାଧାନାଥ	raːd̪ʱaːnaːt̪ʰɔ
ନାକରେ	naːkɔre
ଜାଲ	d͡ʒaːlɔ
ସମ୍ଭାଳି	sɔmbʱaːl̪i
ଆଙ୍ଗୁଳି	aːŋgul̪i
ତେବେ	t̪ebe
ଦୁଃଖିତ	d̪uhkʰit̪ɔ
ତାଙ୍କର	t̪aːŋkɔɾɔ
ଜଣକୁ	d͡ʒɔɳɔku
ଡେ	ɖe
କଦଳୀ	kɔd̪ɔl̪i
ଉତ୍ସାହିତ	ut̪saːhit̪ɔ
ସିଦ୍ଧାନ୍ତ	sid̪d̪ʱaːnt̪ɔ
ଘୋଡାକୁ	gʰoɖaːku
ନେଲେ	nele
ସାନପିଲା	saːnɔpilaː
ଭିଜାଇ	bʱid͡ʒaːi
ଖେଳୁ	kʰel̪u
କାଠିକୁ	kaːʈʰiku
ମଜ୍ଜା	mɔd͡ʒd͡ʒaː
ଭଞ୍ଜ	bʰɔɲd͡ʒɔ
ପିଢ଼ି	piɽʱi
ସଙ୍କଳନ	sɔŋkɔl̪ɔnɔ
ମାମୁଁ	maːmũ
ଝରଣାରୁ	d͡ʒʱɔɾɔɳaːru
ମୁଖ୍ୟ	mukʰjɔ
ବୋଉ	bou
ଚୌକପୁର୍ଣ	t͡ʃɔukɔpurɳɔ
ଲାଲ୍‌	laːl
ଥୁଆ	t̪ʰuaː
ବୈଠକଖାନା	bɔiʈʰɔkɔkʰaːnaː
ପାଇବୁ	paːibu
ପାଣିର	paːɳiɾɔ
ବାର୍ଷିକ	baːrsikɔ
ବାର୍ଥ୍	baːrt̪ʰ
ପଡ଼	pɔɽɔ
ରାଜାଙ୍କୁ	raːd͡ʒaːŋku
କାରଣରୁ	kaːɾɔɳɔru
ଧୀରେ	d̪ʱire
ବିଶେଷ	bisesɔ
ଖିଅର	kʰiɔɾɔ
ମହାରାଜା	mɔhaːraːd͡ʒaː
ମିଳିଯିବ	mil̪id͡ʒibɔ
ଶୀତୁଆ	sit̪uaː
ପ୍ରଜାପତି	pɾɔd͡ʒaːpɔt̪i
ଖୋର୍ଦ୍ଧା	kʰord̪d̪ʱaː
ଭଲା	bʰɔlaː
ବୁଲାଇ	bulaːi
ଜସମିତ	d͡ʒɔsɔmit̪ɔ
ନାହିଁକି	naːhĩki
ଟୁଥପେଷ୍ଟ	ʈut̪ʰɔpesʈɔ
ବସ୍ତାନି	bɔst̪aːni
ଜୈନ	d͡ʒɔinɔ
ଚିତା	t͡ʃit̪aː
ଭେଷଜ	bʱesɔd͡ʒɔ
ସାବଧାନ	saːbɔd̪ʱaːnɔ
ଖୋଲିଲା	kʰolilaː
କ୍ୟାଣ୍ଡିର	kjaːɳɖiɾɔ
ବଟା	bɔʈaː
ସରକାରଙ୍କ	sɔɾɔkaːɾɔŋkɔ
କଟକ	kɔʈɔkɔ
ଡରେ	ɖɔre
କାହାଣୀ	kaːhaːɳi
ଥୀରି	t̪ʰiri
ଅବତାର	ɔbɔt̪aːɾɔ
କରୁଥାନ୍ତି	kɔrut̪ʰaːnt̪i
ବାଁ	baː̃
କାଳୁ	kaːl̪u
ଠିକ୍‌	ʈʰik
ନିଆଯାଏ	niaːd͡ʒaːe
ଅନ୍ଧାର	ɔnd̪ʱaːɾɔ
କଅଁଳିଆ	kɔɔ̃l̪iaː
ହୁଅ	huɔ
ପ୍ରାପ୍ତ	praːpt̪ɔ
ଦଳ	d̪ɔl̪ɔ
ଗୋଡ଼ାଇବାକୁ	goɽaːibaːku
ଫୋନ୍	pʰon
ଦୁହେଁ	d̪uhẽ
କପ୍‌ର	kɔpɾɔ
ଗୋଇନ୍ଦା	goind̪aː
କୋର୍ଟକୁ	korʈɔku
ବିମାନ	bimaːnɔ
ପଚାରିବା	pɔt͡ʃaːribaː
ବାଲୁ	baːlu
ନଳୀ	nɔl̪i
ଯାଇପାରନ୍ତି	d͡ʒaːipaːɾɔnt̪i
ଚିଣ୍ଟୁ	t͡ʃiɳʈu
ସେଗୁଡ଼ିକ	seguɽikɔ
ତୁମମାନଙ୍କର	t̪umɔmaːnɔŋkɔɾɔ
ଫୁଟନ୍ତା	pʰuʈɔnt̪aː
ଚିତ୍କାର	t͡ʃit̪kaːɾɔ
ଗୀତା	git̪aː
ଜହ୍ନଟି	d͡ʒɔhnɔʈi
ଆସିଲାଣି	aːsilaːɳi
ମାହାତ୍ମାଜୀ	maːhaːt̪maːd͡ʒi
ଜଣାଇଲା	d͡ʒɔɳaːilaː
କ୍ଲାସରୁମ	klaːsɔrumɔ
ଉତ୍ତରରେ	ut̪t̪ɔɾɔre
ପରଶି	pɔɾɔsi
କାଗଜ	kaːɡɔd͡ʒɔ
କାମକୁ	kaːmɔku
ପଶୁପକ୍ଷୀ	pɔsupɔkʰi
ଜୀବାଣୁ	d͡ʒibaːɳu
ବୁଲୁଥିବା	bulut̪ʰibaː
ଲୋଭ	lobʰɔ
ଶକ୍ତିପୀଠ	sɔkt̪ipiʈʰɔ
ଆନନ୍ଦରେ	aːnɔnd̪ɔre
ବ୍ୟବହୃତ	bjɔbɔhɔrut̪ɔ
ଉଭୟ	ubʰɔjɔ
ଅଳେଇଚ	ɔl̪eit͡ʃɔ
ଅଛନ୍ତି	ɔt͡ʃʰɔnt̪i
ମହା	mɔhaː
ବଢାଉ	bɔɖʱaːu
ସ୍ନିଫଲ୍ସକୁ	snipʰɔlsɔku
ପଞ୍ଚାୟତ	pɔɲt͡ʃaːjɔt̪ɔ
ସେଥିରେ	set̪ʰire
କୁହାଯିବ	kuhaːd͡ʒibɔ
ସବୁଜ	sɔbud͡ʒɔ
ପଶ୍ଚିମବଙ୍ଗ	pɔst͡ʃimɔbɔŋɡɔ
ପଟ୍ଟନାୟକ	pɔʈʈɔnaːjɔkɔ
ଶିଖିଯାଅ	sikʰid͡ʒaːɔ
କଇଁଚିଟିରେ	kɔĩt͡ʃiʈire
ଭାତ	bʱaːt̪ɔ
ନିଉଲଣ୍ଡନ	niulɔɳɖɔnɔ
ଆଉରି	aːuri
ପାତ	paːt̪ɔ
ଦେଖୁଥିଲେ	d̪ekʰut̪ʰile
ଆସିବାକୁ	aːsibaːku
ପ୍ରତିଯୋଗିତା	pɾɔt̪id͡ʒogit̪aː
ରନ୍ଧା	ɾɔnd̪ʱaː
ଦେଖୁଥିଲି	d̪ekʰut̪ʰili
ଦଉଛି	d̪ɔut͡ʃʰi
କୁଶଳତାକୁ	kusɔl̪ɔt̪aːku
ବ୍ୟବସାୟ	bjɔbɔsaːjɔ
ପିନ୍ଧିବାକୁ	pind̪ʱibaːku
ମିଶି	misi
ଙ୍କଠାରୁ	ŋkɔʈʰaːru
ଗୁଡିକ	guɖikɔ
କନଭେୟାର୍	kɔnɔbʱejaːr
ସାଥୀମାନଙ୍କୁ	saːt̪ʰimaːnɔŋku
ଝୋଟି	d͡ʒʱoʈi
ଥଣ୍ଟରେ	t̪ʰɔɳʈɔre
ବାଟୋଇମାନଙ୍କୁ	baːʈoimaːnɔŋku
ଭଗ୍ନ	bʰɔgnɔ
ପୂର୍ବରୁ	purbɔru
ଅଧାରନ୍ଧା	ɔd̪ʱaːɾɔnd̪ʱaː
ମାଧ୍ୟମିକ	maːd̪ʱjɔmikɔ
ଢାଳିଲେ	ɖʱaːl̪ile
ହେଉଥିଲା	heut̪ʰilaː
ଉଡ଼ାଇବାକୁ	uɽaːibaːku
ଗୋପାଳପୁର	gopaːl̪ɔpuɾɔ
ଦରି	d̪ɔri
ଯେଉଁଥିରେ	d͡ʒeũt̪ʰire
ଆରମ୍ଭ	aːɾɔmbʰɔ
ଦମ୍-ଦମା-ଦମ୍	d̪ɔm-d̪ɔmaː-d̪ɔm
କାହାଣୀଟିଏ	kaːhaːɳiʈie
ଗଲା	ɡɔlaː
ଶ୍ରେଣୀରେ	sreɳire
ପ୍ରଶ୍ନ	pɾɔsnɔ
ବଜାଇବାକୁ	bɔd͡ʒaːibaːku
ଟାଇପ	ʈaːipɔ
ଯୁବକମାନେ	d͡ʒubɔkɔmaːne
ନୌକାକୁ	nɔukaːku
ଫୁଲଭର୍ତ୍ତି	pʰulɔbʰɔrt̪t̪i
ଶୋଭାଯାତ୍ରାରେ	sobʱaːd͡ʒaːt̪raːre
ସୂତାକାମ	sut̪aːkaːmɔ
ଏସିଆ	esiaː
ଆଶ୍ରମର	aːsɾɔmɔɾɔ
ଝରକା	d͡ʒʱɔɾɔkaː
ବିନ୍ଦୁ	bind̪u
ଆଜ୍‌ମା	aːd͡ʒmaː
ତରତର	t̪ɔɾɔt̪ɔɾɔ
ଶ୍ରେଣୀ	sreɳi
ଦିଏ	d̪ie
ସଫଳତା	sɔpʰɔl̪ɔt̪aː
ହେଇଥିଲା	heit̪ʰilaː
ରଖନ୍ତି	ɾɔkʰɔnt̪i
ବାପାର	baːpaːɾɔ
ସଜାଇବା	sɔd͡ʒaːibaː
ବିଜ୍ଞାନୀ	bid͡ʒɲaːni
ରଖାଯାଇଛି	ɾɔkʰaːd͡ʒaːit͡ʃʰi
କୁଞ୍ଚିଆ	kuɲt͡ʃiaː
ଲାଗୁଥିଲେ	laːgut̪ʰile
ବୁଝିଲ	bud͡ʒʱilɔ
ଏଥରକ	et̪ʰɔɾɔkɔ
ବାରିବାକୁ	baːribaːku
ଆସିବା	aːsibaː
କୀରଣ	kiɾɔɳɔ
ବୋଧେ	bod̪ʱe
ଗଦା	ɡɔd̪aː
ଯୋଗ	d͡ʒoɡɔ
ସ୍ଵପ୍ନକୁ	suɔpnɔku
ଆସିଗଲେ	aːsiɡɔle
ଦେଖିପାରେନି	d̪ekʰipaːreni
ମାଛି	maːt͡ʃʰi
ଉପବାସ	upɔbaːsɔ
ଭେଟିବା	bʱeʈibaː
ଧାନୀ	d̪ʱaːni
ନାରାୟଣ	naːraːjɔɳɔ
ଅଳ୍ପଦିନ	ɔl̪pɔd̪inɔ
ବର୍ଗ	bɔrɡɔ
ରାନ୍ଧିବାକୁ	raːnd̪ʱibaːku
ଅନ୍ତର୍ଭୁକ୍ତ	ɔnt̪ɔrbʱukt̪ɔ
ଉପାଡ଼ିବ	upaːɽibɔ
ଦୌଡିଆସି	d̪ɔuɖiaːsi
ମନଦୁଃଖ	mɔnɔd̪uhkʰɔ
ପ୍ରାଥମିକ	praːt̪ʰɔmikɔ
ତରୁଣ	t̪ɔruɳɔ
ଅଜାଂକୁ	ɔd͡ʒaːŋku
ବ୍ୟକ୍ତିଗତ	bjɔkt̪iɡɔt̪ɔ
ଯୋଗଦାନ	d͡ʒoɡɔd̪aːnɔ
ଡାଳମାନେ	ɖaːl̪ɔmaːne
ଗରମ	ɡɔɾɔmɔ
ମାଷ୍ଟ୍ରେ	maːsʈre
ଅଥବା	ɔt̪ʰɔbaː
ପରଖିନେବେ	pɔɾɔkʰinebe
ଭାଷାରେ	bʱaːsaːre
ଭୋଜି	bʱod͡ʒi
ଆମ୍ମୀ	aːmmi
ବହନ	bɔhɔnɔ
ଯିଏ	d͡ʒie
ରଖାଯାଉଥିବା	ɾɔkʰaːd͡ʒaːut̪ʰibaː
ଜାଣେ	d͡ʒaːɳe
ତାଳିର	t̪aːl̪iɾɔ
କ୍ଳାନ୍ତ	kl̪aːnt̪ɔ
କେଶର	kesɔɾɔ
ମାନଙ୍କୁ	maːnɔŋku
ହସୁ	hɔsu
ଲାଇଟ	laːiʈɔ
ପାଉ	paːu
ପ୍ରଧାନମନ୍ତ୍ରୀ	pɾɔd̪ʱaːnɔmɔnt̪ri
କରିପାରିଲି	kɔripaːrili
କେନ୍ଦ୍ରଶାସିତ	kend̪ɾɔsaːsit̪ɔ
ଡାଳରେ	ɖaːl̪ɔre
ଦାଣ୍ତି	d̪aːɳt̪i
ଟେବୁଲରେ	ʈebulɔre
ସ୍ୱାଦ	suaːd̪ɔ
ପ୍ରକୃତ	pɾɔkrut̪ɔ
ଖିଲାବି	kʰilaːbi
ନିଃଶ୍ୱାସର	nihsuaːsɔɾɔ
କିଛି	kit͡ʃʰi
କଣ୍ଠଦାନ	kɔɳʈʰɔd̪aːnɔ
ବୁଲି	buli
ସମୁଦାୟ	sɔmud̪aːjɔ
ବେଳେ	bel̪e
ମାଆର	maːaːɾɔ
ଜନସଂଖ୍ୟା	d͡ʒɔnɔsɔŋkʰjaː
ବୃତ୍ତି	brut̪t̪i
ଛାନିଆଁ	t͡ʃʰaːniaː̃
ବାଜାବାଲାଙ୍କୁ	baːd͡ʒaːbaːlaːŋku
ଅନ୍ତତଃ	ɔnt̪ɔt̪ɔh
ସଭ୍ୟ	sɔbʱjɔ
ଡରିକି	ɖɔriki
ପଠେଇଛି	pɔʈʰeit͡ʃʰi
ହଳଦୀ	hɔl̪ɔd̪i
ରଖିପାରୁନଥିଲା	ɾɔkʰipaːrunɔt̪ʰilaː
କମର	kɔmɔɾɔ
ନାଆଁ	naːaː̃
ସଂଗୃହିତ	sɔŋgruhit̪ɔ
ପରିବର୍ତ୍ତିତ	pɔribɔrt̪t̪it̪ɔ
ମନେରଖ	mɔneɾɔkʰɔ
ଗରମ୍	ɡɔɾɔm
ପଡ଼ିନାହିଁ	pɔɽinaːhĩ
ଜଗତ	d͡ʒɔɡɔt̪ɔ
ମଣିଷ	mɔɳisɔ
ସୋମାନେ	somaːne
ଲେଖିବା	lekʰibaː
ଗଭୀର	ɡɔbʱiɾɔ
ପ୍ରବେଶ	pɾɔbesɔ
ମିକ୍	mik
ଶ୍ରାବଣ	sraːbɔɳɔ
ସଂଗୀତ	sɔŋgit̪ɔ
ବିଶ୍ଵାସ	bisuaːsɔ
ବେଣା	beɳaː
ହରିଣ	hɔriɳɔ
ନିଜେ	nid͡ʒe
ସ୍ଥିତ	st̪ʰit̪ɔ
ଶୌକିନିଆ	sɔukiniaː
ଚିଗିଡି	t͡ʃigiɖi
ଡିଜାଇନ	ɖid͡ʒaːinɔ
ଆମ୍ମୀକୁ	aːmmiku
ଶୈଳୀ	sɔil̪i
ଧରିଛି	d̪ʱɔrit͡ʃʰi
ଅତିକ୍ରମ	ɔt̪ikɾɔmɔ
ପୂଜାରୀ	pud͡ʒaːri
ଗୁଡାଏ	guɖaːe
ଭକ୍ତ	bʰɔkt̪ɔ
ପ୍ରସନ୍ନ	pɾɔsɔnnɔ
ମାହାତ୍ମାଗାନ୍ଧୀ	maːhaːt̪maːgaːnd̪ʱi
ଚୋବାଇଲା	t͡ʃobaːilaː
ଭୁବନେଶ୍ୱର	bʱubɔnesuɔɾɔ
ସତେଜ	sɔt̪ed͡ʒɔ
ଛଳ-ଛଳ	t͡ʃʰɔl̪ɔ-t͡ʃʰɔl̪ɔ
ରାତ୍ରୀ	raːt̪ri
ଏଣ୍ଡ	eɳɖɔ
ଖୋଜାଗିରି	kʰod͡ʒaːgiri
ବିଚଳିତ	bit͡ʃɔl̪it̪ɔ
କେବେହେଲେ	kebehele
ବିଶ୍ଵାଳ	bisuaːl̪ɔ
ଜାତ	d͡ʒaːt̪ɔ
କୁନିମାଛ	kunimaːt͡ʃʰɔ
ଗିନା	ginaː
ମହାରାଜଙ୍କ	mɔhaːraːd͡ʒɔŋkɔ
ଲେଖିଲେ	lekʰile
ମାଂସପେଶୀ	maːŋsɔpesi
ପାଇବେ	paːibe
ସ୍ଵର	suɔɾɔ
ଫ୍ୟୁଜ୍	pʰjud͡ʒ
ନଥିଲି	nɔt̪ʰili
ସମୟରେ	sɔmɔjɔre
ପାଉଛନ୍ତି	paːut͡ʃʰɔnt̪i
ବୈତରଣୀ	bɔit̪ɔɾɔɳi
ଅଟା	ɔʈaː
ଝୁଙ୍କିପଡ଼ି	d͡ʒʱuŋkipɔɽi
ଥିଲା	t̪ʰilaː
ସାଂଗମାନଂକ	saːŋɡɔmaːnɔŋkɔ
ହାଇଁ	haːĩ
ଯୁଗରେ	d͡ʒuɡɔre
ପୁରାଯିବ	puraːd͡ʒibɔ
ଓଡ଼ିଶୀ	oɽisi
ହଅ	hɔɔ
ଦୀପ	d̪ipɔ
ଶାନ୍ତ	saːnt̪ɔ
ତଥା	t̪ɔt̪ʰaː
ଶୁଆ	suaː
ଫେରିବାକୁ	pʰeribaːku
ନୟାଗଡ଼	nɔjaːɡɔɖɔ
ଖ୍ରୀଷ୍ଟ	kʰrisʈɔ
ଏଥିରେ	et̪ʰire
ପକୃତରେ	pɔkrut̪ɔre
ଗୁଡିଏ	guɖie
ଯୋର	d͡ʒoɾɔ
ଅଟନ୍ତି	ɔʈɔnt̪i
ଦେହାନ୍ତ	d̪ehaːnt̪ɔ
ମିଆଁ	miaː̃
ବହି	bɔhi
ନୈଶିନ	nɔisinɔ
ବ୍ୟାକୁଳ	bjaːkul̪ɔ
ସହଜ	sɔhɔd͡ʒɔ
ଚକ୍‌	t͡ʃɔk
ଉପାୟଟି	upaːjɔʈi
ଫେବୃଆରୀ	pʰebruaːri
ସୁଗନ୍ଧ	suɡɔnd̪ʱɔ
ଲେଖାରେ	lekʰaːre
ହେମନ୍ତ	hemɔnt̪ɔ
କୁଞ୍ଚି	kuɲt͡ʃi
ସି	si
ପଡ଼ିଗଲା	pɔɽiɡɔlaː
ସାଇ	saːi
ଲାଂଜ	laːŋd͡ʒɔ
ସ୍ୱେଚ୍ଚାସେବୀ	suet͡ʃt͡ʃaːsebi
ଭଳିଆ	bʰɔl̪iaː
ଏମିତିରେ	emit̪ire
ଦୃଶ୍ୟ	d̪rusjɔ
ଜଙ୍ଗଲଟିର	d͡ʒɔŋɡɔlɔʈiɾɔ
ଖିରି	kʰiri
କମ୍ବଳ	kɔmbɔl̪ɔ
ଘଡ଼ଘଡ଼ି	ɡʱɔɽɔɡʱɔɽi
ଉଦ୍ଭିଦ	ud̪bʱid̪ɔ
ପ୍ରଫୁଲ୍ଲିତ	pɾɔpʰullit̪ɔ
ସହରଟିଏ	sɔhɔɾɔʈie
ସାଙ୍ଗେ	saːŋge
ଇନ୍ଦ୍ର	ind̪ɾɔ
ସାଧନ	saːd̪ʱɔnɔ
ଚତୁର୍ଭୁଜ	t͡ʃɔt̪urbʱud͡ʒɔ
ପିନ୍ଧିଲା	pind̪ʱilaː
ଖଞ୍ଜେ	kʰɔɲd͡ʒe
ରହୁଥିଲା	ɾɔhut̪ʰilaː
ଡାଲି	ɖaːli
ଶୋଇପଡ଼ିଲା	soipɔɽilaː
ସଜୀବ	sɔd͡ʒibɔ
ନଦୀ	nɔd̪i
ନଥିଲା	nɔt̪ʰilaː
ଅବଦାନ	ɔbɔd̪aːnɔ
ପଦାର୍ଥ	pɔd̪aːrt̪ʰɔ
ପ୍ରସ୍ତାବ	pɾɔst̪aːbɔ
ହୋଇଯିବ	hoid͡ʒibɔ
ନେବ	nebɔ
ଗର୍ଭ	ɡɔrbʰɔ
ଭାରତର	bʱaːɾɔt̪ɔɾɔ
ବାରାଣସୀ	baːraːɳɔsi
ଦଉଡ଼ିଲା	d̪ɔuɽilaː
ମାନ୍ୟତା	maːnjɔt̪aː
ଅବସର	ɔbɔsɔɾɔ
ଦୁର୍ଗର	d̪urɡɔɾɔ
ଅଧ୍ୟୟନ	ɔd̪ʱjɔjɔnɔ
ଲିଭାଇ	libʱaːi
ଛାଡ଼ିଲା	t͡ʃʰaːɽilaː
ପ୍ରକାଶ	pɾɔkaːsɔ
ଡିଏଁ	ɖiẽ
ଭାଇସରୟଙ୍କୁ	bʱaːisɔɾɔjɔŋku
ବ୍ୟସ୍ତ	bjɔst̪ɔ
ମାନବ	maːnɔbɔ
ବେଶି	besi
କରେ	kɔre
କାନପାଖେ	kaːnɔpaːkʰe
ଶ୍ରୀମନ୍ଦିର	srimɔnd̪iɾɔ
ଜାଣିଛ	d͡ʒaːɳit͡ʃʰɔ
ଯେମିତି	d͡ʒemit̪i
ନିରୁତ୍ସାହ	nirut̪saːhɔ
ଗାନ୍ଧିଜୀ	gaːnd̪ʱid͡ʒi
ଛେଚା	t͡ʃʰet͡ʃaː
ଯଥେଷ୍ଟ	d͡ʒɔt̪ʰesʈɔ
ମଲହାର	mɔlɔhaːɾɔ
ଦ୍ଵାରା	d̪uaːraː
ଲତା	lɔt̪aː
ରକ୍ତଚାପ	ɾɔkt̪ɔt͡ʃaːpɔ
ସାଙ୍କେତିକ	saːŋket̪ikɔ
ସବୁଥର	sɔbut̪ʰɔɾɔ
ଜାଗର	d͡ʒaːɡɔɾɔ
ଶୋଇଲି	soili
ଯୋଡ଼ିବେ	d͡ʒoɽibe
ପଟାରେ	pɔʈaːre
ବାଲାଙ୍କୁ	baːlaːŋku
ଗାଆଁଟି	gaːaː̃ʈi
ବସିଲି	bɔsili
ଫିଙ୍ଗିବି	pʰiŋgibi
ଆସିଗଲା	aːsiɡɔlaː
ଖୋଲିବାକୁ	kʰolibaːku
ଲାଗିଲେଣି	laːgileɳi
ପିଠି	piʈʰi
ପ୍ରୟୋଗ	pɾɔjoɡɔ
ବୋଲି	boli
ଶ୍ରୀନିବାସକୁ	srinibaːsɔku
ବିବେକାନନ୍ଦ	bibekaːnɔnd̪ɔ
ମେଲାଇ	melaːi
ପାନିଆଟିଏ	paːniaːʈie
ଦ୍ରବ୍ୟ	d̪ɾɔbjɔ
ଇଂଜିନିୟରିଂ	iŋd͡ʒinijɔriŋ
କାରଣ	kaːɾɔɳɔ
ହୁଅନି	huɔni
ବଦମାଶ୍	bɔd̪ɔmaːs
କାନାଡାରେ	kaːnaːɖaːre
ସଞ୍ଜୟ	sɔɲd͡ʒɔjɔ
ଓଲିଉଡ଼	oliuɖɔ
କଟା	kɔʈaː
ଥକିଗଲେ	t̪ʰɔkiɡɔle
ପ୍ରବନ୍ଧ	pɾɔbɔnd̪ʱɔ
ରାସ୍ତାଟିଏ	raːst̪aːʈie
ଓଠ	oʈʰɔ
କରା	kɔraː
ଜୁଇ	d͡ʒui
ପହେଲମାନ	pɔhelɔmaːnɔ
ପ୍ରସଙ୍ଗର	pɾɔsɔŋɡɔɾɔ
ଛତା	t͡ʃʰɔt̪aː
ବଲ୍	bɔl
ନୀତି	nit̪i
ଦୌଡ଼	d̪ɔuɽɔ
ନଅର	nɔɔɾɔ
ଚିଲ୍ଲେଇ	t͡ʃillei
ଗାଇ	gaːi
ଜାଣି	d͡ʒaːɳi
ବେଦ	bed̪ɔ
ଚାରିଦିଗେ	t͡ʃaːrid̪ige
ପୁଅଟିର	puɔʈiɾɔ
ମୃଦଙ୍ଗମ	mrud̪ɔŋɡɔmɔ
କିପରି	kipɔri
ଛାଡି	t͡ʃʰaːɖi
କରିବା	kɔribaː
କାଗଜ଼	kaːɡɔd͡ʒɔ
ଏସବୁ	esɔbu
ଯେତେଥର	d͡ʒet̪et̪ʰɔɾɔ
ମକର	mɔkɔɾɔ
ଭୌତିକ	bʱout̪ikɔ
ଡିଆଁଇ	ɖiaː̃i
ଗଲେ	ɡɔle
ଏହାର	ehaːɾɔ
ଅଷ୍ଟମୀ	ɔsʈɔmi
ଚିକିତ୍ସାକଙ୍କ	t͡ʃikit̪saːkɔŋkɔ
ଛାଡ଼ିଗଲେ	t͡ʃʰaːɽiɡɔle
ବିନୋଦ	binod̪ɔ
କଳାପଟାରେ	kɔl̪aːpɔʈaːre
ଗାଁରେ	gaː̃re
ବିନ୍ଦା	bind̪aː
ହିଁ	hĩ
ବଳରାମ	bɔl̪ɔraːmɔ
ପାରିଲେନି	paːrileni
ଅନୁକୁ	ɔnuku
ପରିବାହକ	pɔribaːhɔkɔ
ବଢ଼ିବ	bɔɽʱibɔ
ବଙ୍ଗ	bɔŋɡɔ
ପହଞ୍ଚିପାରିବା	pɔhɔɲt͡ʃipaːribaː
ବ୍ଲକ୍	blɔk
ଭିଡିଓ	bʱiɖio
କେଇ	kei
ମହାଦେଶ	mɔhaːd̪esɔ
ବାନ୍ତି	baːnt̪i
ଘୋଡାଟିକୁ	gʰoɖaːʈiku
ସାହାଜାନାବାଦ	saːhaːd͡ʒaːnaːbaːd̪ɔ
ଚୀଲ	t͡ʃilɔ
କୋରାପୁଟ	koraːpuʈɔ
ଶୋଷ	sosɔ
ଢାକି	ɖʱaːki
ଦୁଇପଟୁ	d̪uipɔʈu
ସଂଗ୍ରହ	sɔŋgɾɔhɔ
ଡରନ୍ତିନି	ɖɔɾɔnt̪ini
ସର୍ବୋଚ୍ଚ	sɔrbot͡ʃt͡ʃɔ
ବେଣୀ	beɳi
କରୁନଥିଲା	kɔrunɔt̪ʰilaː
ପ୍ରସାଧନ	pɾɔsaːd̪ʱɔnɔ
ଏବେବି	ebebi
ବିଶ୍ରାମ	bisraːmɔ
ସକାଳ	sɔkaːl̪ɔ
ହେଇଛି	heit͡ʃʰi
ପସନ୍ଦ	pɔsɔnd̪ɔ
ମୁଣ୍ତକୁ	muɳt̪ɔku
ବାହାର	baːhaːɾɔ
ଥାଳିରେ	t̪ʰaːl̪ire
ହଲେ	hɔle
କରିଥିଲେ	kɔrit̪ʰile
ମାଟିରୁ	maːʈiru
ଗାଏ	gaːe
ଅଧ୍ୟାପକ	ɔd̪ʱjaːpɔkɔ
ପ୍ରତିଶତ	pɾɔt̪isɔt̪ɔ
ଲେଉଟାଣି	leuʈaːɳi
ଖାତା	kʰaːt̪aː
କୁମାର	kumaːɾɔ
ଦେଖାଯିବେ	d̪ekʰaːd͡ʒibe
କହୁନୁ	kɔhunu
ବ୍ୟାପିବାକୁ	bjaːpibaːku
ଅନେକାନେକ	ɔnekaːnekɔ
ଖେଳିବି	kʰel̪ibi
ନାଇଁ	naːĩ
ଚାକିରି	t͡ʃaːkiri
ପଗଡ଼ିଟିଏ	pɔɡɔɽiʈie
ଘୁଞ୍ଚାଇଦିଆଗଲା	gʰuɲt͡ʃaːid̪iaːɡɔlaː
ପକେଇବା	pɔkeibaː
ଛୁଆଟେ	t͡ʃʰuaːʈe
ପାଉଥିଲେ	paːut̪ʰile
ଦୁଇଟି	d̪uiʈi
ଛଡ଼ା	t͡ʃʰɔɽaː
ହେ	he
ଜନ୍ମ	d͡ʒɔnmɔ
ରୋଟି	roʈi
ଅତିରିକ୍ତ	ɔt̪irikt̪ɔ
ଲାଙ୍ଗଲେନ	laːŋɡɔlenɔ
ଧରିନେଇଥିଲା	d̪ʱɔrineit̪ʰilaː
ମୁକ୍ତ	mukt̪ɔ
ଅନୁଯାୟୀ	ɔnud͡ʒaːji
ସମିରା	sɔmiraː
ନେଇକି	neiki
ଆସୁଛନ୍ତି	aːsut͡ʃʰɔnt̪i
ତାହାହେଲେ	t̪aːhaːhele
ରୁପା	rupaː
ହୋଇଯାନ୍ତି	hoid͡ʒaːnt̪i
କାରୁକାର୍ଯ୍ୟଭରା	kaːrukaːrd͡ʒjɔbʰɔraː
ଖବରକାଗଜ	kʰɔbɔɾɔkaːɡɔd͡ʒɔ
ଛତୁର	t͡ʃʰɔt̪uɾɔ
ସାମନ୍ତ	saːmɔnt̪ɔ
ନାହାଁନ୍ତି	naːhaː̃nt̪i
ମୃ-ଦ-ଙ୍ଗ-ମ	mru-d̪ɔ-ŋɡɔ-mɔ
ସଂକ୍ରମଣ	sɔŋkɾɔmɔɳɔ
ମହାପ୍ରଭୁ	mɔhaːpɾɔbʱu
ଆସନି	aːsɔni
ଅଟକେଇ	ɔʈɔkei
ସ୍ଵାଗତମ୍	suaːɡɔt̪ɔm
ବିଛଣାରୁ	bit͡ʃʰɔɳaːru
କାଢି	kaːɖʱi
ନଡ଼ିଆଟେ	nɔɽiaːʈe
ବନ୍ଧନ	bɔnd̪ʱɔnɔ
ଆଂକି	aːŋki
ଅର୍ପଣ	ɔrpɔɳɔ
ଗାଜର	gaːd͡ʒɔɾɔ
ପିୟାଜ	pijaːd͡ʒɔ
ଆଣିଥାଏ	aːɳit̪ʰaːe
ଯନ୍ତ୍ରଣା	d͡ʒɔnt̪ɾɔɳaː
ମହାରଣା	mɔhaːɾɔɳaː
ଗଦ	ɡɔd̪ɔ
ଚିତ୍ରଥିବା	t͡ʃit̪ɾɔt̪ʰibaː
ବନାଏ	bɔnaːe
ଗୋବିନ୍ଦ	gobind̪ɔ
ଭରୁ	bʰɔru
ଭୂଗୋଳ	bʱugol̪ɔ
ଇଉରୋପୀୟ	iuropijɔ
ଚୁପ୍‌	t͡ʃup
ବାହ୍ୟ	baːhjɔ
ମେଳା	mel̪aː
ନୁଆ	nuaː
ନାମରେ	naːmɔre
କିମ୍ବଦନ୍ତୀ	kimbɔd̪ɔnt̪i
ଦେଉଛି	d̪eut͡ʃʰi
ବୋହୁଥିଲା	bohut̪ʰilaː
ଓହ୍ଲାଇ	ohlaːi
ଅଧୀନରେ	ɔd̪ʱinɔre
ଜଂଗଲ	d͡ʒɔŋɡɔlɔ
ଉଠିଲା	uʈʰilaː
ଦେଇଦିଅ	d̪eid̪iɔ
କରାଇଛନ୍ତି	kɔraːit͡ʃʰɔnt̪i
ଖାନ୍	kʰaːn
ଖେଳରେ	kʰel̪ɔre
ମଧ୍ୟରୁ	mɔd̪ʱjɔru
ଭାସୁଛି	bʱaːsut͡ʃʰi
ତିଥିରେ	t̪it̪ʰire
ପିଲାଟିକୁ	pilaːʈiku
ଖୋଜିବା	kʰod͡ʒibaː
କୋଣିଆ	koɳiaː
ରାଉତରାୟ	raːut̪ɔraːjɔ
ଉଠିଲି	uʈʰili
ସଂଖ୍ୟାମାନଂକ	sɔŋkʰjaːmaːnɔŋkɔ
କିଣିବା	kiɳibaː
ଅବନ୍ତୀ	ɔbɔnt̪i
ବିବିଧ	bibid̪ʱɔ
ମକ୍କା	mɔkkaː
ଅତି	ɔt̪i
କହିଲେ	kɔhile
କରିପାରିବି	kɔripaːribi
ଛୁଇଁବ	t͡ʃʰuĩbɔ
ମନମତାଣିଆ	mɔnɔmɔt̪aːɳiaː
ଘାସଠୁ	gʰaːsɔʈʰu
ପୋଷାକଟି	posaːkɔʈi
ଶୀତଦିନେ	sit̪ɔd̪ine
ଜନତା	d͡ʒɔnɔt̪aː
ନାମିତ	naːmit̪ɔ
ରାମ	raːmɔ
ଯୁଗ	d͡ʒuɡɔ
ତିନିଥର	t̪init̪ʰɔɾɔ
ଆପଣଂକୁ	aːpɔɳɔŋku
ମୁବାରକ	mubaːɾɔkɔ
ସାହାଯ୍ୟ	saːhaːd͡ʒjɔ
ସାରଣୀ	saːɾɔɳi
ତମେ	t̪ɔme
ସୁନ୍ଦରତା	sund̪ɔɾɔt̪aː
ପଣ୍ଡା	pɔɳɖaː
ରାଗ	raːɡɔ
ଫେରାଇ	pʰeraːi
ଆଲୋଚନା	aːlot͡ʃɔnaː
ବିଶ୍ୱର	bisuɔɾɔ
ଜ୍ୱର	d͡ʒuɔɾɔ
ଯେପରି	d͡ʒepɔri
ସମର୍ଥକ	sɔmɔrt̪ʰɔkɔ
ଠାରେ	ʈʰaːre
ଚିନୁକୁ	t͡ʃinuku
ଫିଙ୍ଗନ୍ତି	pʰiŋɡɔnt̪i
ସମସ୍ୟା	sɔmɔsjaː
ଢୋଲଟେ	ɖʱolɔʈe
ଗୋଟାଇବା	goʈaːibaː
ସୁବର୍ଣ୍ଣପୁର	subɔrɳɳɔpuɾɔ
ଜାଣିଥିଲି	d͡ʒaːɳit̪ʰili
କାହିଁ	kaːhĩ
ଆସିବି	aːsibi
ଭଗବାନ	bʰɔɡɔbaːnɔ
ନାନାଦି	naːnaːd̪i
ଚାଲିଛ	t͡ʃaːlit͡ʃʰɔ
ଚାଲିଯାଇଛି	t͡ʃaːlid͡ʒaːit͡ʃʰi
ଦିଶନ୍ତେ	d̪isɔnt̪e
ଠେକୁଆଙ୍କୁ	ʈʰekuaːŋku
ସିଦ୍ଧ	sid̪d̪ʱɔ
ମାଢ଼ିକୁ	maːɽʱiku
ଉଚ୍ଚାରଣ	ut͡ʃt͡ʃaːɾɔɳɔ
କମିଯାଏ	kɔmid͡ʒaːe
କଲା	kɔlaː
ବସିବାପାଇଁ	bɔsibaːpaːĩ
ସମ୍ବଲପୁର	sɔmbɔlɔpuɾɔ
ଶିଡ଼ି-ଚଢ଼ା	siɽi-t͡ʃɔɽʱaː
ଡେଇଁବି	ɖeĩbi
ଚାହିଁଲେ	t͡ʃaːhĩle
ଧରଣର	d̪ʱɔɾɔɳɔɾɔ
ନନ୍ଦ	nɔnd̪ɔ
ଭାଂଗିବା	bʱaːŋgibaː
ଭରି	bʰɔri
ପିଇବାକୁ	piibaːku
ଇତ୍ଯାଦି	it̪d͡ʒaːd̪i
ପୁଣିଥରେ	puɳit̪ʰɔre
ଲାଗେ	laːge
ଛୋଟିଆ	t͡ʃʰoʈiaː
ସବା	sɔbaː
ବିଖ୍ୟାତ	bikʰjaːt̪ɔ
ନାମକ	naːmɔkɔ
ବାଷାକୁ	baːsaːku
ଉଦ୍ଧାର	ud̪d̪ʱaːɾɔ
ରଡ୍	ɾɔɖ
ପଡ଼ିଥାଏ	pɔɽit̪ʰaːe
ନଦୀକୂଳକୁ	nɔd̪ikul̪ɔku
ଦ୍ଵାରରେ	d̪uaːɾɔre
କରାଯାଉଥିବା	kɔraːd͡ʒaːut̪ʰibaː
ଚଟାଣ	t͡ʃɔʈaːɳɔ
ହଟାନ୍ତୁ	hɔʈaːnt̪u
ଝିଅ	d͡ʒʱiɔ
ପତନ	pɔt̪ɔnɔ
ଯାଉଥିଲି	d͡ʒaːut̪ʰili
ଖଞ୍ଜି	kʰɔɲd͡ʒi
ଅହମଦାବାଦ	ɔhɔmɔd̪aːbaːd̪ɔ
ଭୋଅଅଅ	bʱoɔɔɔ
ରାଜେନ୍ଦ୍ର	raːd͡ʒend̪ɾɔ
ଚେୟାର୍	t͡ʃejaːr
ହୋଇଗଲା	hoiɡɔlaː
ହସାନ୍ତି	hɔsaːnt̪i
ଶାନ୍ତିରେ	saːnt̪ire
ପ୍ରସ୍ତୁତ	pɾɔst̪ut̪ɔ
ଚିଲିକା	t͡ʃilikaː
ଯିଏକି	d͡ʒieki
ଆଖି	aːkʰi
ବାବୁ	baːbu
କୁହ	kuhɔ
ରଗଡ଼ୁ	ɾɔɡɔɽu
ଜାଣିପାରିବ	d͡ʒaːɳipaːribɔ
ଏଠାକୁ	eʈʰaːku
ରଖିଛି	ɾɔkʰit͡ʃʰi
ରାଜକୁମାରୀ	raːd͡ʒɔkumaːri
ମ୍ୟାଲେରିଆ	mjaːleriaː
ସେଓ	seo
କିମି	kimi
ଫାଲୁଦା	pʰaːlud̪aː
ଯେଭଳି	d͡ʒebʰɔl̪i
ହକି	hɔki
ବହୁତ	bɔhut̪ɔ
ରାଗିଛି	raːgit͡ʃʰi
ଶୀତଳ	sit̪ɔl̪ɔ
ସର୍ବତରୁ	sɔrbɔt̪ɔru
ଡୁଡୁମ୍	ɖuɖum
ଭୟ	bʰɔjɔ
ହୁଅନା	huɔnaː
ସେହିପରି	sehipɔri
ସମୀରା	sɔmiraː
ଯାହା	d͡ʒaːhaː
ଅତ୍ୟଧିକ	ɔt̪jɔd̪ʱikɔ
ନିଦରେ	nid̪ɔre
ଯୋଗୁଁ	d͡ʒogũ
ସେତିକିବେଳେ	set̪ikibel̪e
ପଢ଼ି	pɔɽʱi
ସଞ୍ଜରେ	sɔɲd͡ʒɔre
ଆକ	aːkɔ
ବଟ	bɔʈɔ
ଉଡ଼ି	uɽi
ଥଣ୍ଡାରେ	t̪ʰɔɳɖaːre
ଶ୍ରୀଜଗନ୍ନାଥ	srid͡ʒɔɡɔnnaːt̪ʰɔ
ଧୂଳିଆ	d̪ʱul̪iaː
ଗାଇବାକୁ	gaːibaːku
ଖୋଲିବି	kʰolibi
ଦେଶ	d̪esɔ
ନୌକାଭଳି	nɔukaːbʰɔl̪i
ପାଇଥିଲା	paːit̪ʰilaː
ରସାୟନିକ	ɾɔsaːjɔnikɔ
ଲକ୍ଷ୍ମୀ	lɔkʰmi
ଲେଖାଏଁ	lekʰaːẽ
ଗର୍ଜନ	ɡɔrd͡ʒɔnɔ
ପୋକ	pokɔ
ବିଧାନସଭା	bid̪ʱaːnɔsɔbʱaː
ବୋତଲ୍	bot̪ɔl
ହରିହର	hɔrihɔɾɔ
ଚିରି	t͡ʃiri
ସ୍ମୃତିର	smrut̪iɾɔ
ମାଂକଡ଼	maːŋkɔɽɔ
ଭାଷାର	bʱaːsaːɾɔ
ଆର୍ଥିକ	aːrt̪ʰikɔ
ପଚାଶପଟ	pɔt͡ʃaːsɔpɔʈɔ
ଜନସଂଚାର	d͡ʒɔnɔsɔŋt͡ʃaːɾɔ
ଦିଶୁଛୁ	d̪isut͡ʃʰu
ପୁରୁଖା	purukʰaː
ଆଦିତ୍ୟ	aːd̪it̪jɔ
ଆଂକିବ	aːŋkibɔ
ଧରୁଥିବା	d̪ʱɔrut̪ʰibaː
ଚମଡ଼ା	t͡ʃɔmɔɽaː
ପାରିବିନି	paːribini
ଫିସ୍	pʰis
ଗୋଲାମୁଣ୍ଡା	golaːmuɳɖaː
ମାଟିଆ	maːʈiaː
ତଳୁ-ଉପର	t̪ɔl̪u-upɔɾɔ
ଦାମିକିଆ	d̪aːmikiaː
ପରିଜା	pɔrid͡ʒaː
ପ୍ରାକୃତିକ	praːkrut̪ikɔ
ଭାବୁଛି	bʱaːbut͡ʃʰi
ଅଂଚଳରେ	ɔŋt͡ʃɔl̪ɔre
ଦୌଡ଼ିଯାଇ	d̪ɔuɽid͡ʒaːi
ସମସ୍ତେ	sɔmɔst̪e
ଛୁଞ୍ଚିଟି	t͡ʃʰuɲt͡ʃiʈi
ଶୁଣାଇଥାନ୍ତି	suɳaːit̪ʰaːnt̪i
ଗଳି	ɡɔl̪i
ଫେରିଲା	pʰerilaː
ପୂକାଲାମ୍	pukaːlaːm
ଅନ୍ତର୍ଗତ	ɔnt̪ɔrɡɔt̪ɔ
କେତେବେଳେ	ket̪ebel̪e
ଖୋଜିବାକୁ	kʰod͡ʒibaːku
ସିଂହର	siŋhɔɾɔ
ସତ୍ୟ	sɔt̪jɔ
ନେବତ	nebɔt̪ɔ
ଏତେଜଣ	et̪ed͡ʒɔɳɔ
ବେଙ୍ଗଳୁରୁ	beŋɡɔl̪uru
ଢେଙ୍କାନାଳ	ɖʱeŋkaːnaːl̪ɔ
କଥାଚିତ୍ର	kɔt̪ʰaːt͡ʃit̪ɾɔ
କରିନେଲେ	kɔrinele
ଜନମ	d͡ʒɔnɔmɔ
ଆଲିଙ୍ଗନ	aːliŋɡɔnɔ
ବୋହିନେଉଥିବା	bohineut̪ʰibaː
ଖଟ	kʰɔʈɔ
ଚିବୁକରେ	t͡ʃibukɔre
ଝୁଙ୍କେଇ	d͡ʒʱuŋkei
ଖାତିର	kʰaːt̪iɾɔ
ଏବେକାର	ebekaːɾɔ
ନାଚୁଥିଲେ	naːt͡ʃut̪ʰile
ଧରିବାକୁ	d̪ʱɔribaːku
ହାଲିଆ	haːliaː
ଗୋଡରେ	goɖɔre
ଇଣ୍ଟରନେଟ	iɳʈɔɾɔneʈɔ
ପାରିଲା	paːrilaː
ଚିତ୍ରାଙ୍କନ	t͡ʃit̪raːŋkɔnɔ
ସେଇଟି	seiʈi
କ୍ଷତିକାରକ	kʰjɔt̪ikaːɾɔkɔ
ଆଜି	aːd͡ʒi
ଚୋର	t͡ʃoɾɔ
ନାଗରା	naːɡɔraː
କ୍ରମରେ	kɾɔmɔre
ତାୱା	t̪aːuaː
ମଜାରେ	mɔd͡ʒaːre
ଶାସ୍ତ୍ରିୟ	saːst̪rijɔ
କରାଯାଏ	kɔraːd͡ʒaːe
ଚିପ୍‌ସ୍‌	t͡ʃips
ଦୋଳିଟିଏ	d̪ol̪iʈie
ଖେଳୁଥିବା	kʰel̪ut̪ʰibaː
ନାଥ	naːt̪ʰɔ
ଆଣିଲା	aːɳilaː
ଧନୀଜୀଙ୍କର	d̪ʱɔnid͡ʒiŋkɔɾɔ
ସାମ୍ନାରେ	saːmnaːre
ସଂଘ	sɔŋɡʱɔ
ବୋର୍ଡ଼ରେ	borɽɔre
ବିଶ୍ଵନାଥ	bisuɔnaːt̪ʰɔ
କରୁଛୁ	kɔrut͡ʃʰu
ସଂଖ୍ୟା	sɔŋkʰjaː
ପଛୁଆ	pɔt͡ʃʰuaː
ପାରୁଛି	paːrut͡ʃʰi
ମାରିବା	maːribaː
ଅଭିନେତ୍ରୀ	ɔbʱinet̪ri
ହେବାକୁ	hebaːku
ଆଖିର	aːkʰiɾɔ
ସଫାକଲା	sɔpʰaːkɔlaː
ଗୋଲେଇ	golei
ଛୋଟପିଲାମାନଙ୍କୁ	t͡ʃʰoʈɔpilaːmaːnɔŋku
ଗୁମ୍ପା	gumpaː
ବାନ୍ଧିଥିଲା	baːnd̪ʱit̪ʰilaː
ଭାଜି	bʱaːd͡ʒi
ଛାଣି	t͡ʃʰaːɳi
ଭୀମା	bʱimaː
ସବୁଠୁଁ	sɔbuʈʰũ
ଜ୍ୟାକେଟ୍	d͡ʒjaːkeʈ
ଏସୀୟ	esijɔ
ରହି	ɾɔhi
ନରମ	nɔɾɔmɔ
ଗୁଣେ	guɳe
ଲାଭଦାୟକ	laːbʰɔd̪aːjɔkɔ
ଲାଗେନି	laːgeni
ଚମକ	t͡ʃɔmɔkɔ
କୋଣାର୍କ	koɳaːrkɔ
ଦ୍ୱାରା	d̪uaːraː
ପ୍ଲାଷ୍ଟିକ୍	plaːsʈik
ମହକୁମା	mɔhɔkumaː
ଲାଗୁଥିଲା	laːgut̪ʰilaː
କରିଥାନ୍ତି	kɔrit̪ʰaːnt̪i
ସମ୍ରାଟଙ୍କ	sɔmraːʈɔŋkɔ
ମରାଠି	mɔraːʈʰi
ମହତାବ	mɔhɔt̪aːbɔ
ପୁଦିନା	pud̪inaː
ବିଂଧୁଛି	biŋd̪ʱut͡ʃʰi
ଗଳା	ɡɔl̪aː
ତୃତୀୟା	t̪rut̪ijaː
ହ୍ରଦ	hɾɔd̪ɔ
ଆସିବାର	aːsibaːɾɔ
କେତେ	ket̪e
ଖାଏ	kʰaːe
ପ୍ରସଙ୍ଗଟି	pɾɔsɔŋɡɔʈi
ହେବେ	hebe
ଭାଷାକୋଷ	bʱaːsaːkosɔ
ଥକିଯାଉଥାଏ	t̪ʰɔkid͡ʒaːut̪ʰaːe
ଭୋ	bʱo
ତେଲୁଗୁ	t̪elugu
ଝାଳରେ	d͡ʒʱaːl̪ɔre
ପଗଡ଼ିରେ	pɔɡɔɽire
ଦୁରରେ	d̪uɾɔre
ପାଠ	paːʈʰɔ
ଏଇଠି	eiʈʰi
ବଲ୍ଲଭ	bɔllɔbʰɔ
କୋଲମ୍	kolɔm
ବ୍ୟତିବ୍ୟସ୍ତ	bjɔt̪ibjɔst̪ɔ
ଘୋଡାଇ	gʰoɖaːi
ପ୍ରଭାବ	pɾɔbʱaːbɔ
ବୁଦ୍ଧୁ	bud̪d̪ʱu
ପୁଣି	puɳi
କରାଯାଇଛି	kɔraːd͡ʒaːit͡ʃʰi
ବାଛୁଥିଲେ	baːt͡ʃʰut̪ʰile
କେତେକ	ket̪ekɔ
ବୁଲନ୍ତି	bulɔnt̪i
ଯତ୍ନ	d͡ʒɔt̪nɔ
କୋଡ଼	koɖɔ
ଆକାଶରୁ	aːkaːsɔru
ରାଷ୍ଟ୍ରୀୟ	raːsʈrijɔ
ଗୁଡୁମ	guɖumɔ
ଏକଥା	ekɔt̪ʰaː
ଆସିଛି	aːsit͡ʃʰi
ଫିଲ୍ମ	pʰilmɔ
ବରଷା	bɔɾɔsaː
ବାନ୍ଧି	baːnd̪ʱi
କାଉଟି	kaːuʈi
ବାହାରୁ	baːhaːru
ହୁଅନ୍ତି	huɔnt̪i
ପତ୍ରକୁ	pɔt̪ɾɔku
ଫୁଙ୍କୁଥିଲେ	pʰuŋkut̪ʰile
ପାଇସାରିଥିଲା	paːisaːrit̪ʰilaː
ସବୁଜରଙ୍ଗର	sɔbud͡ʒɔɾɔŋɡɔɾɔ
ଜଂଗଲର	d͡ʒɔŋɡɔlɔɾɔ
ମଞ୍ଚର	mɔɲt͡ʃɔɾɔ
ଛିଂକୁ	t͡ʃʰiŋku
ଉର୍ଦ୍ଦୁ	urd̪d̪u
ଜାଣିବା	d͡ʒaːɳibaː
ନାଚିବା	naːt͡ʃibaː
ବୁଲିବା	bulibaː
ପଡେ	pɔɖe
ପାର୍ଟି	paːrʈi
ଜାଗା	d͡ʒaːgaː
ଚରଖାରେ	t͡ʃɔɾɔkʰaːre
ଏମୁଣ୍ଡରୁ	emuɳɖɔru
ହେଇ	hei
ପିନ୍ଧୁଥିବା	pind̪ʱut̪ʰibaː
କହିଥିଲା	kɔhit̪ʰilaː
ହ୍ରାସ	hraːsɔ
ସର୍ବଦା	sɔrbɔd̪aː
ଖାତିର୍	kʰaːt̪ir
ପ୍ରଧାନ	pɾɔd̪ʱaːnɔ
ପିଲାଙ୍କ	pilaːŋkɔ
ଆପେ	aːpe
ନିତାନ୍ତ	nit̪aːnt̪ɔ
ହେଉଥିବା	heut̪ʰibaː
ବୋକାଟି	bokaːʈi
ନାହିଁ	naːhĩ
ରଖିଥିବା	ɾɔkʰit̪ʰibaː
ଖୋଲିଦେଲା	kʰolid̪elaː
ପାତ୍ରର	paːt̪ɾɔɾɔ
କାଟୁଛନ୍ତି	kaːʈut͡ʃʰɔnt̪i
ଦେଖନ୍ତୁ	d̪ekʰɔnt̪u
ପଡିଥାଏ	pɔɖit̪ʰaːe
ବାଜିବା	baːd͡ʒibaː
ରରେ	ɾɔre
ଛଟାଣ	t͡ʃʰɔʈaːɳɔ
ଫୁଂକିବାକୁ	pʰuŋkibaːku
ଚାନ୍ଦୁଆତଳେ	t͡ʃaːnd̪uaːt̪ɔl̪e
ପିତା	pit̪aː
ମହାଦେବ	mɔhaːd̪ebɔ
ତଳେ	t̪ɔl̪e
ଗାନ୍ଧି	gaːnd̪ʱi
ଆଗ	aːɡɔ
ଧମ	d̪ʱɔmɔ
ଭାଗ୍ୟବାନ	bʱaːgjɔbaːnɔ
ମିନିଟ	miniʈɔ
ଗାଆଁଠାରୁ	gaːaː̃ʈʰaːru
ବାଡ଼ାନି	baːɽaːni
ଅଜିତ	ɔd͡ʒit̪ɔ
ବଣ୍ଟା	bɔɳʈaː
ବଜେଇବାକୁ	bɔd͡ʒeibaːku
ଆସିବେ	aːsibe
ଅଳ୍ପ	ɔl̪pɔ
ଝଟ୍	d͡ʒʱɔʈ
ଚକ୍	t͡ʃɔk
କର୍ଣ୍ଣାଟକ	kɔrɳɳaːʈɔkɔ
ତେଜ	t̪ed͡ʒɔ
କୁଶଳୀ	kusɔl̪i
ଲେଖ	lekʰɔ
ଅଗ୍ନି	ɔgni
ଗୋଇଠା	goiʈʰaː
ସାନ୍ତ୍ୱନା	saːnt̪uɔnaː
ଚୁନାରିଆ	t͡ʃunaːriaː
ମୁକ୍ତି	mukt̪i
ରୂପରେ	rupɔre
ସମ୍ପାଦନା	sɔmpaːd̪ɔnaː
କଡ଼ରେ	kɔɽɔre
ପାରୁଥିବା	paːrut̪ʰibaː
ଜଣକ	d͡ʒɔɳɔkɔ
ପେଷ୍ଟ୍	pesʈ
କଣ୍ଟାରେ	kɔɳʈaːre
ବିସ୍ତୃତ	bist̪rut̪ɔ
ଯାଆଁଳା	d͡ʒaːaː̃l̪aː
ଦିନଯାକ	d̪inɔd͡ʒaːkɔ
ଲାଗିବ	laːgibɔ
ବାଡ଼େଇଲି	baːɽeili
ଛୁଇଁବାକୁ	t͡ʃʰuĩbaːku
ପଦ୍ଧତି	pɔd̪d̪ʱɔt̪i
ମସିହାରୁ	mɔsihaːru
ହଲାଇଲା	hɔlaːilaː
ଓଡ଼ିଶା	oɽisaː
ଜଲେବି	d͡ʒɔlebi
ମିଳିଥାଏ	mil̪it̪ʰaːe
ଉଠୁ	uʈʰu
ବସିଥାଏ	bɔsit̪ʰaːe
ସିଷ୍ଟମ	sisʈɔmɔ
ମନ୍ଦିର	mɔnd̪iɾɔ
ଜଳରେ	d͡ʒɔl̪ɔre
ତାପମାତ୍ରା	t̪aːpɔmaːt̪raː
ଆଠମଲ୍ଲିକ	aːʈʰɔmɔllikɔ
ନୀଳମଣି	nil̪ɔmɔɳi
ମହାବିଦ୍ୟାଳୟ	mɔhaːbid̪jaːl̪ɔjɔ
ତାଜା	t̪aːd͡ʒaː
କରିବାପାଇଁ	kɔribaːpaːĩ
ତାମିଲନାଡୁ	t̪aːmilɔnaːɖu
ଭୂଷଣ	bʱusɔɳɔ
ପାରମ୍ପରିକ	paːɾɔmpɔrikɔ
ବିଲ	bilɔ
ପ୍ରଜାପତିମାନେ	pɾɔd͡ʒaːpɔt̪imaːne
ଭଲପାଏ	bʰɔlɔpaːe
ନିଜର	nid͡ʒɔɾɔ
କରାଏ	kɔraːe
କରିଥଲେ	kɔrit̪ʰɔle
ଟିକି	ʈiki
କମିଲାନି	kɔmilaːni
ଚପଲ	t͡ʃɔpɔlɔ
ଓଠରେ	oʈʰɔre
ଭାସିବାକୁ	bʱaːsibaːku
ସଙ୍ଘ	sɔŋɡʱɔ
ଫ୍ରିଜ୍	pʰrid͡ʒ
ଆସୁଥିଲା	aːsut̪ʰilaː
ଛାଣୁଥିବା	t͡ʃʰaːɳut̪ʰibaː
ବାହାଦୁର	baːhaːd̪uɾɔ
ହେଲି	heli
ଏତେବେଳେ	et̪ebel̪e
ବରଫ	bɔɾɔpʰɔ
ଆଶ୍ଚର୍ଯ଼୍ୟ	aːst͡ʃɔrd͡ʒɔjɔ
ମୋତି	mot̪i
ମଣିମାଙ୍କ	mɔɳimaːŋkɔ
ସାହୀ-ପଡ଼ିଶାରେ	saːhi-pɔɽisaːre
ୟାକୁ	jaːku
ଉଡ଼ୁଛନ୍ତି	uɽut͡ʃʰɔnt̪i
ପାଗ	paːɡɔ
ରାଜାଙ୍କ	raːd͡ʒaːŋkɔ
ଖୋଜ	kʰod͡ʒɔ
ହିମାଚଳ	himaːt͡ʃɔl̪ɔ
ଯୁବକ	d͡ʒubɔkɔ
ବରଷିଲା	bɔɾɔsilaː
ଲକ୍ଷ	lɔkʰjɔ
କଟକର	kɔʈɔkɔɾɔ
ଜନଗଣନା	d͡ʒɔnɔɡɔɳɔnaː
ଆଖ	aːkʰɔ
ସଂସ୍କୃତି	sɔŋskrut̪i
ଚାଷୀ	t͡ʃaːsi
ଗତକାଲି	ɡɔt̪ɔkaːli
ନୌକାରେ	nɔukaːre
ନୌକାର	nɔukaːɾɔ
ବାସନ୍ଦ	baːsɔnd̪ɔ
ମାଛମାନେ	maːt͡ʃʰɔmaːne
ଜୀବନ	d͡ʒibɔnɔ
ଲେଖୁନ	lekʰunɔ
କବାଟ	kɔbaːʈɔ
ଟୀକା	ʈikaː
ମିଳିଥିଲା	mil̪it̪ʰilaː
ତାଙ୍କ	t̪aːŋkɔ
ଥା	t̪ʰaː
ନିୟୁତ	nijut̪ɔ
ମାରିଲା	maːrilaː
ଡରିଡରି	ɖɔriɖɔri
ବୁଝେଇ	bud͡ʒʱei
ପାରେକି	paːreki
ବିକ୍ରିକରି	bikrikɔri
ପ୍ରକୃତରେ	pɾɔkrut̪ɔre
ବହୁବିକଳ୍ପ	bɔhubikɔl̪pɔ
ଗ୍ରାମ	graːmɔ
ହସିଲା	hɔsilaː
ବଦଳେରେ	bɔd̪ɔl̪ere
ମହୁଫେଣ	mɔhupʰeɳɔ
ପ୍ରତିଥର	pɾɔt̪it̪ʰɔɾɔ
କରିବିନି	kɔribini
ନାଲି	naːli
ରୁପେଲି	rupeli
ତୁରନ୍ତ	t̪uɾɔnt̪ɔ
ସିଂହକୁ	siŋhɔku
ଖୋଲି	kʰoli
ମାଇଁ	maːĩ
ପାଞ୍ଚମିନିଟ୍‌	paːɲt͡ʃɔminiʈ
ଦୌଡ଼ିକରି	d̪ɔuɽikɔri
ଜାଣିଲା	d͡ʒaːɳilaː
ସଂରକ୍ଷିତ	sɔŋɾɔkʰit̪ɔ
ତିଥି	t̪it̪ʰi
ନିରବ	niɾɔbɔ
ଉପାଧି	upaːd̪ʱi
ଖରାରେ	kʰɔraːre
କୌଶିକ	kɔusikɔ
ଲିଭେ	libʱe
ବାହାରେ	baːhaːre
ଭିଡ଼ିବାରେ	bʱiɽibaːre
ବାହାଘରୁ	baːhaːɡʱɔru
ଶୈନାବୀ	sɔinaːbi
ଲୋକଟି	lokɔʈi
ନଷ୍ଟ	nɔsʈɔ
ଧୂଆଁରେ	d̪ʱuaː̃re
ଲମ୍ବା	lɔmbaː
ପାରିବେନି	paːribeni
ପାଚେରୀରୁ	paːt͡ʃeriru
ଟେଁପଲେଟ	ʈẽpɔleʈɔ
ଯୋଦ୍ଧାମାନଙ୍କର	d͡ʒod̪d̪ʱaːmaːnɔŋkɔɾɔ
ନଅ	nɔɔ
ଠାକୁରାଣୀ	ʈʰaːkuraːɳi
ଉଚ୍ଚତା	ut͡ʃt͡ʃɔt̪aː
ଚିନାବାଦାମ	t͡ʃinaːbaːd̪aːmɔ
ଫଟାଇ	pʰɔʈaːi
ଭଲିଆ	bʰɔliaː
ବ୍ରିଟିଶ	briʈisɔ
ତୋଟା	t̪oʈaː
ଚଲାଇବା	t͡ʃɔlaːibaː
କୁତୁକୁତୁ	kut̪ukut̪u
ହିସାବ	hisaːbɔ
ପୁଳେ	pul̪e
ଯାଇଥିଲା	d͡ʒaːit̪ʰilaː
ସପ୍ତାହରେ	sɔpt̪aːhɔre
ପ୍ରକାଶିତ	pɾɔkaːsit̪ɔ
ଅଧିକା	ɔd̪ʱikaː
କାଆ	kaːaː
ସମେତ	sɔmet̪ɔ
ରାଜଧାନୀ	raːd͡ʒɔd̪ʱaːni
ଶୁଣ	suɳɔ
ଛାତି	t͡ʃʰaːt̪i
ରାଜଦରବାର	raːd͡ʒɔd̪ɔɾɔbaːɾɔ
ନାଚି	naːt͡ʃi
ବୈଜ୍ଞାନିକ	bɔid͡ʒɲaːnikɔ
ଆଣିବି	aːɳibi
ଜାଣିଗଲ	d͡ʒaːɳiɡɔlɔ
ଚାଷ	t͡ʃaːsɔ
କଷ୍ଟକର	kɔsʈɔkɔɾɔ
ବାଷ୍ପ	baːspɔ
ପ୍ରତିଷ୍ଠିତ	pɾɔt̪isʈʰit̪ɔ
ଓଷା	osaː
ବୁଲେଇ	bulei
ଯାଚିଲେ	d͡ʒaːt͡ʃile
ନିଜକୁ	nid͡ʒɔku
ଦୌଡ଼ିକି	d̪ɔuɽiki
ନାହାନ୍ତି	naːhaːnt̪i
ଛାତ	t͡ʃʰaːt̪ɔ
ଗଣିତରେ	ɡɔɳit̪ɔre
ଦାଣ୍ତିରେ	d̪aːɳt̪ire
ସାଙ୍ଗେସାଙ୍ଗେ	saːŋgesaːŋge
ଅନ୍ତ	ɔnt̪ɔ
ପଡିଯାଏ	pɔɖid͡ʒaːe
ଶେଷ	sesɔ
ସାବାସ୍	saːbaːs
ଟାଣିଦେଲେ	ʈaːɳid̪ele
ଦରବାରରେ	d̪ɔɾɔbaːɾɔre
ଟିଂ	ʈiŋ
ଆଲୋକ	aːlokɔ
ବିଗଳିତ	biɡɔl̪it̪ɔ
ମସଲା	mɔsɔlaː
ବସ୍ତ୍ର	bɔst̪ɾɔ
ଧିମା	d̪ʱimaː
ଉପଯୁକ୍ତ	upɔd͡ʒukt̪ɔ
ଆଚାର୍ଯ୍ୟ	aːt͡ʃaːrd͡ʒjɔ
କୁକୁରଟିଏ	kukuɾɔʈie
ହୋଇପଡ଼ିଲେ	hoipɔɽile
ହୁଁ	hũ
ମିଳିତ	mil̪it̪ɔ
ଭୟଂକର	bʰɔjɔŋkɔɾɔ
ଢଳ-ଢଳ	ɖʱɔl̪ɔ-ɖʱɔl̪ɔ
କେମିତି	kemit̪i
ଆଣିଛନ୍ତି	aːɳit͡ʃʰɔnt̪i
ପରିଣତ	pɔriɳɔt̪ɔ
ବରଂ	bɔɾɔŋ
ପଶିବାବେଳେ	pɔsibaːbel̪e
ଏସିଡ	esiɖɔ
ହୋଇଯିବା	hoid͡ʒibaː
ଚିନୁର	t͡ʃinuɾɔ
ସ୍ଥାପନ	st̪ʰaːpɔnɔ
ଦରକାର	d̪ɔɾɔkaːɾɔ
ଫୁଲମାନେ	pʰulɔmaːne
ସେପ୍ଟେମ୍ବର	sepʈembɔɾɔ
ସ୍ନାତକୋତ୍ତର	snaːt̪ɔkot̪t̪ɔɾɔ
ରସୁଣ	ɾɔsuɳɔ
ଅଛୁ	ɔt͡ʃʰu
ଚଢ଼ିବା	t͡ʃɔɽʱibaː
ନିମ୍ବ	nimbɔ
ଥରି	t̪ʰɔri
ଉଠିପଡି	uʈʰipɔɖi
ଉପର	upɔɾɔ
ଘୁରି	gʰuri
ଓଡ଼ିଶାର	oɽisaːɾɔ
ଅଞ୍ଚଳର	ɔɲt͡ʃɔl̪ɔɾɔ
ରଙ୍ଗୋଲି	ɾɔŋgoli
ପାଳୁଛି	paːl̪ut͡ʃʰi
ହୃଦୟର	hɔrud̪ɔjɔɾɔ
ବାଣ୍ଟିଲା	baːɳʈilaː
ପକ୍ଷେ	pɔkʰe
ବନ୍ଦର	bɔnd̪ɔɾɔ
ଯିବିନି	d͡ʒibini
ସେତେ	set̪e
ରାମକୃଷ୍ଣ	raːmɔkrusɳɔ
ସହାୟତା	sɔhaːjɔt̪aː
ଜେରା	d͡ʒeraː
ରାଜାକୁ	raːd͡ʒaːku
ଦିନକୁ	d̪inɔku
ତାରିଖରେ	t̪aːrikʰɔre
ଚାମଚ	t͡ʃaːmɔt͡ʃɔ
ନାକ	naːkɔ
ଅଜଗର	ɔd͡ʒɔɡɔɾɔ
ତରଫରୁ	t̪ɔɾɔpʰɔru
ଚୁଲୀ	t͡ʃuli
ପୁରୀ	puri
ଜାଣିନି	d͡ʒaːɳini
ପଳେଇଗଲା	pɔl̪eiɡɔlaː
ଦ୍ବାରା	d̪baːraː
ପକାଇ	pɔkaːi
ସମତଳ	sɔmɔt̪ɔl̪ɔ
ମାରି	maːri
ଫୁଲ	pʰulɔ
ନୁହଁକି	nuhɔ̃ki
ଓଡିଆ	oɖiaː
ସଂପୂର୍ଣ୍ଣ	sɔŋpurɳɳɔ
ତନ୍ତ୍ର	t̪ɔnt̪ɾɔ
ପହେଲମାନର	pɔhelɔmaːnɔɾɔ
ଭାରି	bʱaːri
କରିଦେବି	kɔrid̪ebi
ପଳାନ୍ତି	pɔl̪aːnt̪i
ଇଞ୍ଜିନିୟରିଂ	iɲd͡ʒinijɔriŋ
ଚାଲୁଥିଲେ	t͡ʃaːlut̪ʰile
ଗେରୁଆ	geruaː
ବଦଳି	bɔd̪ɔl̪i
ବୟସ	bɔjɔsɔ
ମୁଗ୍ଗୁ	muggu
ପିତାଙ୍କ	pit̪aːŋkɔ
ଉପସ୍ଥିତ	upɔst̪ʰit̪ɔ
କୂଳରେ	kul̪ɔre
କେତୋଟି	ket̪oʈi
ଅଭିଲେଖ	ɔbʱilekʰɔ
ଫଳଟି	pʰɔl̪ɔʈi
ମାନୁ	maːnu
ଖର୍ଚ୍ଚ	kʰɔrt͡ʃt͡ʃɔ
କଙ୍କି	kɔŋki
ଅକାଶରେ	ɔkaːsɔre
ରୋଗ	roɡɔ
ବୃଦ୍ଧି	brud̪d̪ʱi
ପୌରାଣିକ	pouraːɳikɔ
ବଡ଼	bɔɖɔ,bɔɽɔ
ଅକ୍ଷୟ	ɔkʰjɔjɔ
ରେଣୁ	reɳu
ନିଯୁକ୍ତ	nid͡ʒukt̪ɔ
ବୁଡ଼ି	buɽi
ବର୍ଷୁଥିବା	bɔrsut̪ʰibaː
ଗାଲ	gaːlɔ
କିମ୍ବା	kimbaː
ନଥିଲେ	nɔt̪ʰile
କାଳରେ	kaːl̪ɔre
ମଣି	mɔɳi
ଏଥର	et̪ʰɔɾɔ
ଗାଡ଼ିଆରେ	gaːɽiaːre
ଦର୍ପଣରେ	d̪ɔrpɔɳɔre
ମନମୋହକ	mɔnɔmohɔkɔ
ବାଘ	baːɡʱɔ
ସ୍କୁଲ୍	skul
ମୂଳ	mul̪ɔ
ହିଁଠିକ୍	hĩʈʰik
ଜାକି	d͡ʒaːki
ଦେଶରେ	d̪esɔre
ବିସ୍କୁଟଟିଏ	biskuʈɔʈie
ବେକ	bekɔ
ହେଉ	heu
ରାଜାର	raːd͡ʒaːɾɔ
ସ୍ୱିଚ	suit͡ʃɔ
ମାର୍ଚ	maːrt͡ʃɔ
ବାବା	baːbaː
ବଡ଼ି	bɔɽi
ମୟ	mɔjɔ
ହେଇନି	heini
ସାହସୀ	saːhɔsi
ଆଦିବାସୀ	aːd̪ibaːsi
ପିଲାମାନଙ୍କ	pilaːmaːnɔŋkɔ
ନିର୍ଣ୍ଣୟ	nirɳɳɔjɔ
ବିରାଡ଼ିଟି	biraːɽiʈi
ପଟେ	pɔʈe
ଶିଶିର	sisiɾɔ
କର୍ମଶାଳାରେ	kɔrmɔsaːl̪aːre
ଥାକରେ	t̪ʰaːkɔre
ତନ୍ତୁ	t̪ɔnt̪u
ଶ୍ଵାସ	suaːsɔ
ମାଘ	maːɡʱɔ
ସ୍କୁଲବ୍ୟାଗ	skulɔbjaːɡɔ
ରନ୍ଧାଣିଆ	ɾɔnd̪ʱaːɳiaː
ଯାଦୁ	d͡ʒaːd̪u
ହେବୁନି	hebuni
ଗୁଡ଼ିରେ	guɽire
ପଳେଇଲା	pɔl̪eilaː
ବୁଝାଇଲା	bud͡ʒʱaːilaː
କରିଦେଲା	kɔrid̪elaː
ରଖାଯାଇଥିବା	ɾɔkʰaːd͡ʒaːit̪ʰibaː
ଚାହିଁବା	t͡ʃaːhĩbaː
ଖାଇପକେଇଲା	kʰaːipɔkeilaː
ପହଁଚିବା	pɔhɔ̃t͡ʃibaː
ଭଲଲାଗୁ	bʰɔlɔlaːgu
ଜାଣିବାକୁ	d͡ʒaːɳibaːku
ସିରିଞ	siriɲɔ
ଜାଗାର	d͡ʒaːgaːɾɔ
ଅଧୀର	ɔd̪ʱiɾɔ
ଯାହାକୁ	d͡ʒaːhaːku
ପାଆନ୍ତି	paːaːnt̪i
ପ୍ୟାକେଟ୍	pjaːkeʈ
ଡାକ୍ତର	ɖaːkt̪ɔɾɔ
କ୍ଷେତ୍ରରେ	kʰet̪ɾɔre
ମାଙ୍କ	maːŋkɔ
ଷଷ୍ଠୀ	sɔsʈʰi
ଏପରି	epɔri
ପଢ଼େ	pɔɽʱe
ଖୋଜୁଛି	kʰod͡ʒut͡ʃʰi
କଲାତ୍ମକ	kɔlaːt̪mɔkɔ
ଅପରାଜିତା	ɔpɔraːd͡ʒit̪aː
ପିଲାମାନେ	pilaːmaːne
ବାଜରା	baːd͡ʒɔraː
ଲୁହ	luhɔ
ମଣିମା	mɔɳimaː
କ୍ଷତି	kʰjɔt̪i
ପ୍ରତିଷ୍ଠା	pɾɔt̪isʈʰaː
ଚଉତିଶା	t͡ʃɔut̪isaː
ସୁରାଗଟିଏ	suraːɡɔʈie
ହୋଇନାହିଁ	hoinaːhĩ
ବେଲଟ୍	belɔʈ
ବୁଢା	buɖʱaː
ତମ	t̪ɔmɔ
ସ୍ନାୟୁ	snaːju
ନାଁ	naː̃
ହୋଇଥାନ୍ତା	hoit̪ʰaːnt̪aː
ଗୋଲକ	golɔkɔ
ଶାରୀରିକ	saːririkɔ
ସଂଗ୍ରହାଳୟ	sɔŋgɾɔhaːl̪ɔjɔ
ଚଢ଼ିଗଲୁ	t͡ʃɔɽʱiɡɔlu
ସୁନେଲୀ	suneli
ଦାନ୍ତର	d̪aːnt̪ɔɾɔ
ମାନଂକୁ	maːnɔŋku
ମାଲିକାଣୀ	maːlikaːɳi
ଲୁଣିଆ	luɳiaː
ବସିପଡ଼ି	bɔsipɔɽi
କରିବି	kɔribi
ବରାଦ	bɔraːd̪ɔ
ସିଝାଅ	sid͡ʒʱaːɔ
ଦେଖିପାରିବ	d̪ekʰipaːribɔ
ଘଡ଼ି	ɡʱɔɽi
ଲମ୍ବ	lɔmbɔ
ଓହୋ	oho
ଜଳିବାରେ	d͡ʒɔl̪ibaːre
ତାଳଚେର	t̪aːl̪ɔt͡ʃeɾɔ
ଠେକୁଆ	ʈʰekuaː
ସୂର୍ଯ୍ୟଙ୍କର	surd͡ʒjɔŋkɔɾɔ
ବନ୍ଧୁଙ୍କୁ	bɔnd̪ʱuŋku
ଶିମଲା	simɔlaː
ଶୁଣିବାକୁ	suɳibaːku
ବାନ୍ଧଣୀ	baːnd̪ʱɔɳi
ମହୁମାଛିଙ୍କୁ	mɔhumaːt͡ʃʰiŋku
ପହଞ୍ଚାଇଲା	pɔhɔɲt͡ʃaːilaː
ହପ୍	hɔp
ଲାଗିଛି	laːgit͡ʃʰi
ସିଢ଼ି	siɽʱi
ପରିବାରର	pɔribaːɾɔɾɔ
ଶାକାହାରୀ	saːkaːhaːri
ଚାପ	t͡ʃaːpɔ
ସ୍ଥିର	st̪ʰiɾɔ
ଖେଳିବୁ	kʰel̪ibu
ପିନ୍ଧାଇବାକୁ	pind̪ʱaːibaːku
ମାଡ଼ି	maːɽi
ଗାଲରେ	gaːlɔre
ଡେରି	ɖeri
ଖୋଲା	kʰolaː
ସନ୍ଧ୍ୟା	sɔnd̪ʱjaː
ଲାଞ	laːɲɔ
ମାରିବାକୁ	maːribaːku
ବିକଳରେ	bikɔl̪ɔre
କପଡ଼ାରେ	kɔpɔɽaːre
ତୋଳା	t̪ol̪aː
ଅନତି	ɔnɔt̪i
ନଥାନ୍ତା	nɔt̪ʰaːnt̪aː
ସ୍ୱାଧୀନତାର	suaːd̪ʱinɔt̪aːɾɔ
ଫେରି	pʰeri
ଝୁଲି	d͡ʒʱuli
ମହାପାତ୍ର	mɔhaːpaːt̪ɾɔ
ବାଡ଼ି	baːɽi
ସୁକ୍ଷ୍ମ	sukʰmɔ
ଏହାପରେ	ehaːpɔre
ତିଆରି	t̪iaːri
ବିନତି	binɔt̪i
ଆସିଯାଇଥିଲା	aːsid͡ʒaːit̪ʰilaː
ଟେକି	ʈeki
ହଂସଟିଏ	hɔŋsɔʈie
ଏବାଟେ	ebaːʈe
ଥପ୍‌	t̪ʰɔp
ଚାଲିଗଲା	t͡ʃaːliɡɔlaː
ଚଢ଼େଇ	t͡ʃɔɽʱei
ଡରାଉ	ɖɔraːu
ଭଜନ	bʰɔd͡ʒɔnɔ
ପ୍ରଶାନ୍ତ	pɾɔsaːnt̪ɔ
ଶିବ	sibɔ
ବୋବାଉଥିଲେ	bobaːut̪ʰile
କାନ୍ଦ	kaːnd̪ɔ
ବିହୀନ	bihinɔ
ପ୍ରଥା	pɾɔt̪ʰaː
କେତେଥର	ket̪et̪ʰɔɾɔ
ଅଟକି	ɔʈɔki
ଅତିଥିଙ୍କୁ	ɔt̪it̪ʰiŋku
ଶିଖାଇବ	sikʰaːibɔ
ଅଲିମ୍ପିକ	ɔlimpikɔ
ଶିଖୁଥିଲେ	sikʰut̪ʰile
ଚଟାଇ	t͡ʃɔʈaːi
ସଉକିଆ	sɔukiaː
ସତର	sɔt̪ɔɾɔ
କଲିକତା	kɔlikɔt̪aː
ଜଣେଇ	d͡ʒɔɳei
ବିଲ୍	bil
ନେଇଗଲା	neiɡɔlaː
ପଢ଼ନ୍ତୁ	pɔɖʱɔnt̪u
ବ୍ୟବହାର	bjɔbɔhaːɾɔ
ଜାନୁ	d͡ʒaːnu
ଭାସି	bʱaːsi
ସଙ୍ଗରେ	sɔŋɡɔre
କାଜୁ	kaːd͡ʒu
ବିଶ୍ଵ	bisuɔ
ମୋତେ	mot̪e
ଦେଖିଛି	d̪ekʰit͡ʃʰi
ବନ୍ଧାକୋବି	bɔnd̪ʱaːkobi
ବାଉଳା	baːul̪aː
ଉଡ଼ା-ଜାହାଜକୁ	uɽaː-d͡ʒaːhaːd͡ʒɔku
ଦୋକାନୀକୁ	d̪okaːniku
ମାଧ୍ୟମରେ	maːd̪ʱjɔmɔre
ଲାଲ	laːlɔ
ସୂଚନା	sut͡ʃɔnaː
ରଖୁଛି	ɾɔkʰut͡ʃʰi
ସୂକ୍ଷ୍ମ	sukʰmɔ
ବିନତୀ	binɔt̪i
ଲୁସିଫେରିନ	lusipʰerinɔ
ମାନ	maːnɔ
ସହରର	sɔhɔɾɔɾɔ
ପଣ୍ଡିତ	pɔɳɖit̪ɔ
ପାଟ	paːʈɔ
ମେସୋଜୋଇକ	mesod͡ʒoikɔ
ଦଶଜଣ	d̪ɔsɔd͡ʒɔɳɔ
ଯାଇଥିବା	d͡ʒaːit̪ʰibaː
ହରେକୃଷ୍ଣ	hɔrekrusɳɔ
ବେଙ୍ଗାଳୁରୁ	beŋgaːl̪uru
ଭାଂଗିବାର	bʱaːŋgibaːɾɔ
ଟର୍ଚ୍	ʈɔrt͡ʃ
ପ୍ରଯୋଜକ	pɾɔd͡ʒod͡ʒɔkɔ
ସର୍ବାଧିକ	sɔrbaːd̪ʱikɔ
ପଢ଼ିବାକୁ	pɔɽʱibaːku
ମାଆଙ୍କ	maːaːŋkɔ
ଲିଙ୍କ	liŋkɔ
ଜୀବିତ	d͡ʒibit̪ɔ
ଦୁଇ	d̪ui
ଉଷ୍ଣଜଲବାୟୁ	usɳɔd͡ʒɔlɔbaːju
ପରର	pɔɾɔɾɔ
ସ୍ଵତନ୍ତ୍ର	suɔt̪ɔnt̪ɾɔ
ଦାନ୍ତ	d̪aːnt̪ɔ
ଅନୁସରଣ	ɔnusɔɾɔɳɔ
କହିବାକୁ	kɔhibaːku
ଆଣୁଛି	aːɳut͡ʃʰi
ଆସୁଥିବାର	aːsut̪ʰibaːɾɔ
ଶିବରାତ୍ରି	sibɔraːt̪ri
ଲୋକପ୍ରିୟ	lokɔprijɔ
କଲେଜ	kɔled͡ʒɔ
କରିପାରିବୁ	kɔripaːribu
ଖାଉଛି	kʰaːut͡ʃʰi
ଲଗାନ୍ତି	lɔgaːnt̪i
ନାରୀ	naːri
ଆକବରଙ୍କୁ	aːkɔbɔɾɔŋku
ହେଲେବି	helebi
ପରେ	pɔre
ଅଧିକ	ɔd̪ʱikɔ
ସିଝୁ	sid͡ʒʱu
ହସିଉଠୁଥିଲା	hɔsiuʈʰut̪ʰilaː
ଗହମ	ɡɔhɔmɔ
ଚଢ଼ିଲେ	t͡ʃɔɽʱile
ଯାଉଛୁ	d͡ʒaːut͡ʃʰu
ଖୁସି	kʰusi
ରନ୍ଧାଶାଳରୁ	ɾɔnd̪ʱaːsaːl̪ɔru
ଦିଅନ୍ତି	d̪iɔnt̪i
ଆକାରର	aːkaːɾɔɾɔ
ମଞି	mɔɲi
ପଗଡ଼ିଟି	pɔɡɔɽiʈi
ଧୀମା	d̪ʱimaː
ଦିଅ	d̪iɔ
ରୋଷେଇ	rosei
ଦମ୍	d̪ɔm
ଚୁଲି	t͡ʃuli
ଖାଇପାରିବନି	kʰaːipaːribɔni
ଦ୍ଵିତୀୟ	d̪uit̪ijɔ
ଗତି	ɡɔt̪i
ଘଷିବା	ɡʱɔsibaː
ଔଷଧୀୟ	ɔusɔd̪ʱijɔ
ଅଭିବାଦନ	ɔbʱibaːd̪ɔnɔ
ପାଇଗଲି	paːiɡɔli
ରାତିର	raːt̪iɾɔ
ଭାବୁଥିଲେ	bʱaːbut̪ʰile
ମିଟର	miʈɔɾɔ
ଜଗତର	d͡ʒɔɡɔt̪ɔɾɔ
ବାଦାମ	baːd̪aːmɔ
ଖାଇବା	kʰaːibaː
ଶୁଭ	subʰɔ
ତୋଳିଲା	t̪ol̪ilaː
ଚୁପ୍	t͡ʃup
ଚୋବେଇଲା	t͡ʃobeilaː
ସାବିତ୍ରୀ	saːbit̪ri
ମିଳୁଥିବା	mil̪ut̪ʰibaː
ଆକବରଙ୍କ	aːkɔbɔɾɔŋkɔ
ପୁରାତନ	puraːt̪ɔnɔ
ଜଳୁ	d͡ʒɔl̪u
କାଶି	kaːsi
ଔଷଧ	ɔusɔd̪ʱɔ
ମାଷ୍ଟ୍ରେଙ୍କର	maːsʈreŋkɔɾɔ
ଆସ୍ତେ	aːst̪e
ଲଗାଉଥିଲେ	lɔgaːut̪ʰile
ନାକଟା	naːkɔʈaː
ଝାଡ଼ିଲା	d͡ʒʱaːɽilaː
ଦେବଗଡ଼	d̪ebɔɡɔɖɔ
ହୋଇପାରେ	hoipaːre
ସାବୁନ	saːbunɔ
ଚାଲିଗଲେ	t͡ʃaːliɡɔle
ଜୟସାମଲେର୍	d͡ʒɔjɔsaːmɔler
କହିଲି	kɔhili
ଆମେରିକାର	aːmerikaːɾɔ
ନିଅନ୍ତି	niɔnt̪i
ମଞ୍ଜି	mɔɲd͡ʒi
ଅର୍ଜୁନ	ɔrd͡ʒunɔ
ଖାଇକି	kʰaːiki
ଗୋପୀନାଥ	gopinaːt̪ʰɔ
ରେ	re
ଲୋକେ	loke
ଡେଇଁକି	ɖeĩki
ମଧ୍ୟମ	mɔd̪ʱjɔmɔ
ଚଢ଼େଇଟି	t͡ʃɔɽʱeiʈi
ବୋତଲ	bot̪ɔlɔ
ବାବର	baːbɔɾɔ
ପାଇକ	paːikɔ
ଖେଳ	kʰel̪ɔ
ହାଣ୍ଡି	haːɳɖi
କଣାଯୁକ୍ତ	kɔɳaːd͡ʒukt̪ɔ
ସିଝା	sid͡ʒʱaː
ଗଡ଼ି	ɡɔɽi
ବେଗରେ	beɡɔre
ପାଖରୁ	paːkʰɔru
କରନି	kɔɾɔni
ଉତ୍ପାଦନ	ut̪paːd̪ɔnɔ
କୌତୁକିଆ	kɔut̪ukiaː
ତାଂକୁ	t̪aːŋku
ହିସାବ୍	hisaːb
ନାଗ	naːɡɔ
କଉତୁକିଆ	kɔut̪ukiaː
ସ୍ନିଫଲସ	snipʰɔlɔsɔ
ବିଲକୁଲ୍	bilɔkul
ମହାଶ୍ୱେତା	mɔhaːsuet̪aː
ହସୁଥିଲେ	hɔsut̪ʰile
ବିଦ୍ୟୁତ	bid̪jut̪ɔ
ଜିନିଷଟି	d͡ʒinisɔʈi
ସାଂଗରେ	saːŋɡɔre
ଶୋଇଥାନ୍ତି	soit̪ʰaːnt̪i
କୋତରା	kot̪ɔraː
କରିବ	kɔribɔ
ପରିମାଣରେ	pɔrimaːɳɔre
ଟିମ୍-ଟିମ୍	ʈim-ʈim
ଅନୁସୂଚିତ	ɔnusut͡ʃit̪ɔ
ବାସନ୍ତୀ	baːsɔnt̪i
ଆଦୌ	aːd̪ɔu
ଆଶ୍ରମରେ	aːsɾɔmɔre
ଟୁକୁଡ଼ା	ʈukuɽaː
ବନ୍ୟଜନ୍ତୁ	bɔnjɔd͡ʒɔnt̪u
ତାଠୁଁ	t̪aːʈʰũ
ଫତେପୁର	pʰɔt̪epuɾɔ
ବାଇଗଣ	baːiɡɔɳɔ
ରାଜ	raːd͡ʒɔ
କାଠିରେ	kaːʈʰire
ଗାଳି	gaːl̪i
ଶୁଖେଇବାକୁ	sukʰeibaːku
ଥରୁଥିଲେ	t̪ʰɔrut̪ʰile
ଓଢ଼ଣୀ	oɽʱɔɳi
ଅନୁସାରେ	ɔnusaːre
କୋଟ୍	koʈ
ଦାନ୍ତକୁ	d̪aːnt̪ɔku
ଖ୍ୱାବଗାହ୍	kʰuaːbɔgaːh
ଯୋଗାଡ଼	d͡ʒogaːɽɔ
ଆସନ	aːsɔnɔ
ପଢ଼ୁଛନ୍ତି	pɔɽʱut͡ʃʰɔnt̪i
ଆଠ	aːʈʰɔ
ନାଟକ	naːʈɔkɔ
ବଢ଼ି	bɔɽʱi
ଦୋକାନର	d̪okaːnɔɾɔ
ଟୋକେଇକୁ	ʈokeiku
ପିୟାଜକୁ	pijaːd͡ʒɔku
ସିନା	sinaː
ଆକାରରେ	aːkaːɾɔre
ନାଡୁରେ	naːɖure
ବାନ୍ଧିଦେଲା	baːnd̪ʱid̪elaː
ଧାନ	d̪ʱaːnɔ
କହିଦେବି	kɔhid̪ebi
ଚାରା	t͡ʃaːraː
ସଜ୍ଜିତ	sɔd͡ʒd͡ʒit̪ɔ
ଲଡୁ	lɔɖu
ମଧୁସୂଦନ	mɔd̪ʱusud̪ɔnɔ
ଭେଟିବି	bʱeʈibi
ଛାଡ଼ିଲାଣି	t͡ʃʰaːɽilaːɳi
ଉଡନ୍ତି	uɖɔnt̪i
ଯାଇପାରେ	d͡ʒaːipaːre
ଜର	d͡ʒɔɾɔ
ଆଡକୁ	aːɖɔku
ଧୂଳି	d̪ʱul̪i
ବିଜୟୀ	bid͡ʒɔji
କରାଯାଇଥିଲା	kɔraːd͡ʒaːit̪ʰilaː
ରାଜପୁତ	raːd͡ʒɔput̪ɔ
ଲାଞ୍ଜ	laːɲd͡ʒɔ
ସ୍ତରରେ	st̪ɔɾɔre
ପତ୍ରମାନେ	pɔt̪ɾɔmaːne
ପିଲାଏ	pilaːe
ଗଛମୂଳେ	ɡɔt͡ʃʰɔmul̪e
କହିପାରିବ	kɔhipaːribɔ
ରାଗି	raːgi
ଗୋତେ	got̪e
ବାଜାବାଲା	baːd͡ʒaːbaːlaː
ଅମ୍ମୁ	ɔmmu
ଶକ୍ତ	sɔkt̪ɔ
କାନ୍ଦୁଥାଏ	kaːnd̪ut̪ʰaːe
ପଗଡ଼ିକୁ	pɔɡɔɽiku
ବାନ୍ଧିଲା	baːnd̪ʱilaː
ସାଥେ	saːt̪ʰe
ଟେନିସ	ʈenisɔ
କୋଙ୍କଣୀ	koŋkɔɳi
ବାଉଁଶରେ	baːũsɔre
ଶୋଇ	soi
ଅଦୃଶ୍ୟ	ɔd̪rusjɔ
ଶିଖୁଛି	sikʰut͡ʃʰi
ଯୋଦ୍ଧାବାଇଙ୍କ	d͡ʒod̪d̪ʱaːbaːiŋkɔ
ଦେଇ	d̪ei
ଇଂରେଜ	iŋred͡ʒɔ
ପର୍ଯ୍ୟନ୍ତ	pɔrd͡ʒjɔnt̪ɔ
ଲାଗିଯାଇଛି	laːgid͡ʒaːit͡ʃʰi
ଘଷି	ɡʱɔsi
ଦଶଥର	d̪ɔsɔt̪ʰɔɾɔ
ମାଳୁ	maːl̪u
ଇଣ୍ଡିଆନ	iɳɖiaːnɔ
ଗୋଲମରିଚ	golɔmɔrit͡ʃɔ
ଚିନି	t͡ʃini
ଯିବାବେଳେ	d͡ʒibaːbel̪e
ମଇ	mɔi
ବଜାର	bɔd͡ʒaːɾɔ
ଚମକି	t͡ʃɔmɔki
ନିୟନ୍ତ୍ରଣ	nijɔnt̪ɾɔɳɔ
ବାର	baːɾɔ
କୁଣ୍ଢାଇ	kuɳɖʱaːi
ପାକଶାଳାରେ	paːkɔsaːl̪aːre
ଥଟ୍ଟା	t̪ʰɔʈʈaː
ପୂର୍ବେ	purbe
ରାଶି	raːsi
ବ୍ୟତୀତ	bjɔt̪it̪ɔ
ଗୁଜରାତ	gud͡ʒɔraːt̪ɔ
ଶୟନଗୃହ	sɔjɔnɔgruhɔ
ପ୍ରଭୃତି	pɾɔbʱrut̪i
ୟାଠୁ	jaːʈʰu
ବୋକାମୀ	bokaːmi
ଶୁଖି	sukʰi
ନୃସିଂହ	nrusiŋhɔ
ନିର୍ମିତ	nirmit̪ɔ
ବୁଝି	bud͡ʒʱi
ମୀନୁ	minu
ଦେବତା	d̪ebɔt̪aː
ଅରୁଣ	ɔruɳɔ
ଆସେ	aːse
ଧରିଲେ	d̪ʱɔrile
ସଂସ୍ଥା	sɔŋst̪ʰaː
ଓସ୍ତଗଛ	ost̪ɔɡɔt͡ʃʰɔ
ଗାଢ଼	gaːɽʱɔ
ପଥରମାନ	pɔt̪ʰɔɾɔmaːnɔ
ବିଶିଷ୍ଟ	bisisʈɔ
ଫଳ	pʰɔl̪ɔ
ପାତ୍ରରୁ	paːt̪ɾɔru
ହସନ୍ତି	hɔsɔnt̪i
ଆଦର	aːd̪ɔɾɔ
ଇଏ	ie
ଖଟରେ	kʰɔʈɔre
ଚାଲୁଥାଏ	t͡ʃaːlut̪ʰaːe
ପଢ଼ୁ	pɔɽʱu
ସ୍ଥାନରେ	st̪ʰaːnɔre
ଗଲାଣି	ɡɔlaːɳi
କହିଥିଲେ	kɔhit̪ʰile
ଦାନ୍ତକାଠିରେ	d̪aːnt̪ɔkaːʈʰire
ସମୃଦ୍ଧ	sɔmrud̪d̪ʱɔ
ସବୁକୁ	sɔbuku
ରଚିତ	ɾɔt͡ʃit̪ɔ
ମାଉସୀ	maːusi
ବେଗମ୍	beɡɔm
ନ୍ତି	nt̪i
ମତରେ	mɔt̪ɔre
ମୁମ୍ବାଇ	mumbaːi
ରକ୍ଷାକର	ɾɔkʰjaːkɔɾɔ
ହେଉଛନ୍ତି	heut͡ʃʰɔnt̪i
ମାଟିରେ	maːʈire
ରହିବୁ	ɾɔhibu
ହୋଲିକା	holikaː
ପ୍ରସ୍ତୁତିରେ	pɾɔst̪ut̪ire
ବଦଳାଇବା	bɔd̪ɔl̪aːibaː
ରଖିଦେଲେ	ɾɔkʰid̪ele
ପଗଡ଼ି	pɔɡɔɽi
ତିନୋଟି	t̪inoʈi
ସିନ୍ଦୁର	sind̪uɾɔ
ବର	bɔɾɔ
ଦୋକାନି	d̪okaːni
ଜୟସାଲମେର	d͡ʒɔjɔsaːlɔmeɾɔ
ବୁଝେଇଲା	bud͡ʒʱeilaː
ବନାନ	bɔnaːnɔ
ଅପ୍ପା-ଇମ୍ମାଙ୍କ	ɔppaː-immaːŋkɔ
କ୍ଷୁଦ୍ର	kʰjud̪ɾɔ
ମିନିଟ୍‌	miniʈ
ଫକୀର	pʰɔkiɾɔ
ମନେପଡ଼ିଲା	mɔnepɔɽilaː
ଦାୟକ	d̪aːjɔkɔ
ଶ୍ରୀ	sri
ଦିନରେ	d̪inɔre
ଆଇସ୍‌କ୍ରିମ୍‌	aːiskrim
ଦିଶେ	d̪ise
ରକ୍ତ	ɾɔkt̪ɔ
ହୋଇଥାଏ	hoit̪ʰaːe
ଶୁଣି	suɳi
ଆଣ	aːɳɔ
ଧନ୍ୟବାଦ୍	d̪ʱɔnjɔbaːd̪
ତଳଥାକ	t̪ɔl̪ɔt̪ʰaːkɔ
ପ୍ରକଳ୍ପ	pɾɔkɔl̪pɔ
ଟିକୁ	ʈiku
ରାଜପୁତ୍	raːd͡ʒɔput̪
ୱର୍ଷା	uɔrsaː
ଫୁସୁଲାନ୍ତି	pʰusulaːnt̪i
ଲେଖାଗଲା	lekʰaːɡɔlaː
ଧନ୍ଦି	d̪ʱɔnd̪i
ବଂଶର	bɔŋsɔɾɔ
ଦେବାକୁ	d̪ebaːku
ଯେ	d͡ʒe
ବସିଛନ୍ତି	bɔsit͡ʃʰɔnt̪i
ଚକ୍‌ଚକ୍‌	t͡ʃɔkt͡ʃɔk
ପ୍ରସାଦ	pɾɔsaːd̪ɔ
ଭାବ	bʱaːbɔ
ଅଣ୍ଡା	ɔɳɖaː
ବିଜ୍ଞାନ	bid͡ʒɲaːnɔ
ଅନ୍ୟଟି	ɔnjɔʈi
ଗାଈମାନଙ୍କୁ	gaːimaːnɔŋku
ମନ୍ତ୍ରୀ	mɔnt̪ri
ଶୁଭିଲା	subʱilaː
କାଚଗ୍ଲାସ	kaːt͡ʃɔglaːsɔ
ବାଟରେ	baːʈɔre
କାନ୍ଦିଲା	kaːnd̪ilaː
ସପ୍ତାହେ	sɔpt̪aːhe
ଓହଳାଇ	ohɔl̪aːi
ଲାଇନ୍	laːin
ଅଛା	ɔt͡ʃʰaː
ଉଡି	uɖi
ସଂସାର	sɔŋsaːɾɔ
କୁଦାରେ	kud̪aːre
ବଜାଇବା	bɔd͡ʒaːibaː
ପେନ୍ସିଲ୍	pensil
ସାହିତ୍ୟରେ	saːhit̪jɔre
ସବୁଆଡ଼କୁ	sɔbuaːɽɔku
ମହାମହିମ	mɔhaːmɔhimɔ
ବାରିକ	baːrikɔ
ଅଗ	ɔɡɔ
କେଉଁଠି	keũʈʰi
ସବୁକିଛି	sɔbukit͡ʃʰi
ଆସିଲେନି	aːsileni
ଆଉ	aːu
ଯୋଗିନୀ	d͡ʒogini
ଟିଚର	ʈit͡ʃɔɾɔ
ତାହାର	t̪aːhaːɾɔ
ଅନ୍ୟମାନଂକୁ	ɔnjɔmaːnɔŋku
ଶୋଇକି	soiki
ଜାଣିଥିଲେ	d͡ʒaːɳit̪ʰile
ହୋଇଥିବାର	hoit̪ʰibaːɾɔ
ରକ୍ତକୁ	ɾɔkt̪ɔku
ଅଣସର	ɔɳɔsɔɾɔ
ହଜୁର	hɔd͡ʒuɾɔ
ମିଶାଏ	misaːe
ଯିବୁନି	d͡ʒibuni
ପ୍ରଜାପତିମାନଙ୍କୁ	pɾɔd͡ʒaːpɔt̪imaːnɔŋku
ତ୍ୟାଗ	t̪jaːɡɔ
ସେପଟେମ୍ବର	sepɔʈembɔɾɔ
ଚାହୁଁଥିଲେ	t͡ʃaːhũt̪ʰile
ଜର୍ମାନୀର	d͡ʒɔrmaːniɾɔ
ଛତୁରେ	t͡ʃʰɔt̪ure
ରାଗିଛନ୍ତି	raːgit͡ʃʰɔnt̪i
ଏପ୍ରିଲ	eprilɔ
କରେନାହିଁ	kɔrenaːhĩ
ଚୌକି-ଟେବୁଲ୍	t͡ʃɔuki-ʈebul
ଭୁଲ	bʱulɔ
ପ୍ରତିଷ୍ଠାତା	pɾɔt̪isʈʰaːt̪aː
କୋରମା	koɾɔmaː
ଗୋଡ଼	goɽɔ
ପାଚିଲା	paːt͡ʃilaː
ଗଠିତ	ɡɔʈʰit̪ɔ
ଭିନ୍ନ	bʱinnɔ
ଘର	ɡʱɔɾɔ
ସମ୍ଭାଳୁ	sɔmbʱaːl̪u
ଅବଶେଷ	ɔbɔsesɔ
ଉପହାର	upɔhaːɾɔ
ତୁମ	t̪umɔ
ମାଷ୍ଟ୍ରେଙ୍କୁ	maːsʈreŋku
ଆଜିର	aːd͡ʒiɾɔ
କାବୁଲର	kaːbulɔɾɔ
ବଜାରକୁ	bɔd͡ʒaːɾɔku
ନଇଁକି	nɔĩki
ପଡ଼ିଥିବା	pɔɽit̪ʰibaː
ଆଗ୍ରା	aːgraː
ନଥିଲୁ	nɔt̪ʰilu
ସୁନ୍ଦରଗଡ଼	sund̪ɔɾɔɡɔɖɔ
ଏମିତି	emit̪i
ଫୁଲଗୁଡ଼ିକ	pʰulɔguɽikɔ
ବାଟେ	baːʈe
ଭାଗରେ	bʱaːɡɔre
ପରିବେଶ	pɔribesɔ
ସୈରା	sɔiraː
କାଟେ	kaːʈe
ବସ୍ତାନୀ	bɔst̪aːni
କରିପାର	kɔripaːɾɔ
ବୁଡନ୍ତି	buɖɔnt̪i
ପ୍ରଚ୍ଛଦପଟ	pɾɔt͡ʃt͡ʃʰɔd̪ɔpɔʈɔ
ସେକି	seki
ଆଳୁସବୁ	aːl̪usɔbu
ଫସଲ	pʰɔsɔlɔ
ଜଳେ	d͡ʒɔl̪e
ମୁଣ୍ଡଟା	muɳɖɔʈaː
ଚାବି	t͡ʃaːbi
ଜଣାଇଥାନ୍ତି	d͡ʒɔɳaːit̪ʰaːnt̪i
ବର୍ଣ୍ଣନା	bɔrɳɳɔnaː
ପ୍ରଶଂସା	pɾɔsɔŋsaː
ଗଧିଆଙ୍କୁ	ɡɔd̪ʱiaːŋku
ଭୁଲିଗଲ	bʱuliɡɔlɔ
କାହାରି	kaːhaːri
ନିଃଶ୍ୱାସକୁ	nihsuaːsɔku
ମୁଦ୍ରା	mud̪raː
ଟା	ʈaː
ପଡ଼ିବେ	pɔɽibe
ପୂରେଇବ	pureibɔ
ବାପା-ବିଲେଇର	baːpaː-bileiɾɔ
ପଞ୍ଚମ	pɔɲt͡ʃɔmɔ
ଗ୍ରହ	gɾɔhɔ
ଏତେବେଳ	et̪ebel̪ɔ
ଫୁଲଗୁଚ୍ଛାଟିଏ	pʰulɔgut͡ʃt͡ʃʰaːʈie
ପର୍ବ	pɔrbɔ
ଟୋକା	ʈokaː
ସ୍ୱାଦିଷ୍ଟ	suaːd̪isʈɔ
ଉପରେ	upɔre
ପଢ଼ାଇଲେ	pɔɽʱaːile
ମାଟିର	maːʈiɾɔ
ବାଦଲ୍‌	baːd̪ɔl
ପ୍ରଶାସନିକ	pɾɔsaːsɔnikɔ
ବହେ	bɔhe
ତାଳ	t̪aːl̪ɔ
ନାତି	naːt̪i
ଗୋଡ଼ରେ	goɽɔre
ଆଣିପାର	aːɳipaːɾɔ
ନଷ୍ଟକାରୀ	nɔsʈɔkaːri
ପଥର	pɔt̪ʰɔɾɔ
ପଞ୍ଜାବୀ	pɔɲd͡ʒaːbi
କୁହେ	kuhe
ଆମେରିକା	aːmerikaː
ପାରୁ	paːru
ସାହିତ୍ୟ	saːhit̪jɔ
ସୁଶୀଳା	susil̪aː
କାର୍ଯ୍ୟାଳୟ	kaːrd͡ʒjaːl̪ɔjɔ
ଖାଦ୍ୟମଧ୍ୟରୁ	kʰaːd̪jɔmɔd̪ʱjɔru
ଭିଡ଼ିକି	bʱiɽiki
ଗେଲ୍ହା	gelhaː
ପଢ଼	pɔɽʱɔ
କିଣିବି	kiɳibi
ଦୋଳି	d̪ol̪i
ଗାଈଟିଏ	gaːiʈie
ଛଣା	t͡ʃʰɔɳaː
ପଢ଼ିଲେ	pɔɽʱile
ଗୁରୁବାର	gurubaːɾɔ
ପୃଥକ୍	prut̪ʰɔk
ମୁଣ୍ଡକୁ	muɳɖɔku
ଘରଟିଏ	ɡʱɔɾɔʈie
ବୋଲିଲା	bolilaː
ଅର୍ଜନ	ɔrd͡ʒɔnɔ
ଜାନକୀ	d͡ʒaːnɔki
ଉଡିବା	uɖibaː
ବୃଦ୍ଧାଙ୍କୁ	brud̪d̪ʱaːŋku
ଶୁକ୍ଳ	sukl̪ɔ
ଧକ୍‌-ଧକ୍‌	d̪ʱɔk-d̪ʱɔk
ଗ୍ରାମର	graːmɔɾɔ
ଫୁଂକିବା	pʰuŋkibaː
ପାରେ	paːre
ଚତୁର୍ଥୀ	t͡ʃɔt̪urt̪ʰi
ପଳେଇଲେ	pɔl̪eile
ସ୍ଥାପନା	st̪ʰaːpɔnaː
ହୁଅନ୍ତା	huɔnt̪aː
ବଛା	bɔt͡ʃʰaː
ନିଅ	niɔ
ଅଙ୍କାବଙ୍କା	ɔŋkaːbɔŋkaː
ଦେଖିବିନି	d̪ekʰibini
ଦିନଟି	d̪inɔʈi
ବିଦ୍ର	bid̪ɾɔ
ନିଜନିଜର	nid͡ʒɔnid͡ʒɔɾɔ
କହିଥିଲି	kɔhit̪ʰili
ପଣା	pɔɳaː
ନକଲ୍	nɔkɔl
ମିଠେଇ-ରସଗୋଲା	miʈʰei-ɾɔsɔgolaː
ବରା	bɔraː
ଯୁଦ୍ଧ	d͡ʒud̪d̪ʱɔ
ପରସ୍ପରର	pɔɾɔspɔɾɔɾɔ
ଲୋକଜଣଂକ	lokɔd͡ʒɔɳɔŋkɔ
କରାଯାଉଛି	kɔraːd͡ʒaːut͡ʃʰi
ବଜାଉଛନ୍ତି	bɔd͡ʒaːut͡ʃʰɔnt̪i
ଚାରିପାଖ	t͡ʃaːripaːkʰɔ
ପିଟାରା	piʈaːraː
ସମ୍ରାଟଙ୍କର	sɔmraːʈɔŋkɔɾɔ
ଶୁଣ୍ତକୁ	suɳt̪ɔku
ବାକ୍ୟ	baːkjɔ
ହାଇସ୍କୁଲ	haːiskulɔ
ଚୌଧୁରୀ	t͡ʃoud̪ʱuri
ବିଲେଇର	bileiɾɔ
ରଂଗ	ɾɔŋɡɔ
ଆଶ୍ୱିନ	aːsuinɔ
ମାଙ୍କଡ଼ାଚିତ୍	maːŋkɔɽaːt͡ʃit̪
ଦୁଇମିନିଟ୍‌	d̪uiminiʈ
ମିଆଁଉ	miaː̃u
ଜହ୍ନର	d͡ʒɔhnɔɾɔ
ବିସ୍ମୟକର	bismɔjɔkɔɾɔ
ଟେବୁଲ	ʈebulɔ
ପତ୍ର	pɔt̪ɾɔ
ଦୁର୍ଗା	d̪urgaː
ଝୁଡ଼ି	d͡ʒʱuɽi
ଶୁଣିପାରେ	suɳipaːre
ହସି	hɔsi
ରକମର	ɾɔkɔmɔɾɔ
କଥାଚିତ୍ରରେ	kɔt̪ʰaːt͡ʃit̪ɾɔre
ଗୁହାଳ	guhaːl̪ɔ
ପୁରାଇବା	puraːibaː
ବ୍ୟଞନ	bjɔɲɔnɔ
ଚିପି	t͡ʃipi
କ୍ରମିକ	kɾɔmikɔ
ଘୁଞ୍ଚାଗଲା	gʰuɲt͡ʃaːɡɔlaː
ପିଲାମାନଙ୍କର	pilaːmaːnɔŋkɔɾɔ
କଳାମେଘ	kɔl̪aːmeɡʱɔ
ବସନ୍ତି	bɔsɔnt̪i
ଲାଗିଲା	laːgilaː
ରାନ୍ଧିବା	raːnd̪ʱibaː
ଘଷିବାକୁ	ɡʱɔsibaːku
ହଜେଇ	hɔd͡ʒei
ସାଂସଦ	saːŋsɔd̪ɔ
ଥପ	t̪ʰɔpɔ
ଦେବେନି	d̪ebeni
ଧର୍ମପିତା	d̪ʱɔrmɔpit̪aː
ଭୋଟର	bʱoʈɔɾɔ
ଚାଲିଚାଲି	t͡ʃaːlit͡ʃaːli
କଥାଟାକୁ	kɔt̪ʰaːʈaːku
ବିଜୟ	bid͡ʒɔjɔ
ସୂତାରେ	sut̪aːre
ପୂର୍ବକ	purbɔkɔ
ପଚାରିଲେ	pɔt͡ʃaːrile
ବୌଦ୍ଧ	boud̪d̪ʱɔ
ଗାନ୍ଧୀ	gaːnd̪ʱi
ଜ୍ୟୋତିର୍ଲିଙ୍ଗ	d͡ʒjot̪irliŋɡɔ
ହେଣ୍ଡା-ଏଗୁଡ଼ିକ	heɳɖaː-eguɽikɔ
ଦୌଡ଼ିବାକୁ	d̪ɔuɽibaːku
ବଢ଼ିଆ	bɔɽʱiaː
ଚିକିତ୍ସାବିଜ୍ଞାନ	t͡ʃikit̪saːbid͡ʒɲaːnɔ
ଚକାମାରି	t͡ʃɔkaːmaːri
ଘରଠୁ	ɡʱɔɾɔʈʰu
ସାଂଗ	saːŋɡɔ
ଖାଇବି	kʰaːibi
ଲୁଚି	lut͡ʃi
କାର୍ଯ୍ୟ	kaːrd͡ʒjɔ
ଚୁମୁଟି	t͡ʃumuʈi
ଦିଶୁଥାନ୍ତି	d̪isut̪ʰaːnt̪i
ସିଧା	sid̪ʱaː
ଦେବେ	d̪ebe
ଦାସଙ୍କ	d̪aːsɔŋkɔ
ଅନୁଗୋଳ	ɔnugol̪ɔ
ଯେତେବେଳେ	d͡ʒet̪ebel̪e
ଛୋଟୁ	t͡ʃʰoʈu
ସମାପ୍ତ	sɔmaːpt̪ɔ
ରାନ୍ଧଣା	raːnd̪ʱɔɳaː
ଯାଆ	d͡ʒaːaː
ବୋହି	bohi
ଅଷ୍ଟ୍ରେଲିଆ	ɔsʈreliaː
ବିଚାର	bit͡ʃaːɾɔ
ଖାଉଥିଲେ	kʰaːut̪ʰile
ଛାଣିବାକୁ	t͡ʃʰaːɳibaːku
ଯୁବକୁ	d͡ʒubɔku
ତାହେଲେ	t̪aːhele
ଜମିଯାଇଛି	d͡ʒɔmid͡ʒaːit͡ʃʰi
ସୁଲତାନ୍	sulɔt̪aːn
କାର୍‌ଟି	kaːrʈi
ଆୟୋଜିତ	aːjod͡ʒit̪ɔ
ଦେଖେଇଲା	d̪ekʰeilaː
ସଂକ୍ରାନ୍ତି	sɔŋkraːnt̪i
ସବୁଗୁଡ଼ିକ	sɔbuguɽikɔ
ମନେହୁଏ	mɔnehue
ଭୌଂ	bʱɔuŋ
ଶହ	sɔhɔ
ଶିଶୁ	sisu
ମୁଁ	mũ
ଲାଲରଙ୍ଗ	laːlɔɾɔŋɡɔ
ଆଶୀର୍ବାଦ	aːsirbaːd̪ɔ
ଆଫ୍ରିକାର	aːpʰrikaːɾɔ
ହେବାର	hebaːɾɔ
ନା	naː
ପରିଷ୍କାର	pɔriskaːɾɔ
ଖେଳାଳୀ	kʰel̪aːl̪i
ବିଶାକ୍ତ	bisaːkt̪ɔ
ବୁଝିଲୁ	bud͡ʒʱilu
ପିଅ	piɔ
ବନେଇଛନ୍ତି	bɔneit͡ʃʰɔnt̪i
ବୁଦ୍ଧ	bud̪d̪ʱɔ
ପୌର	pouɾɔ
ଲୋକସଂଖ୍ୟା	lokɔsɔŋkʰjaː
ଟଙ୍କା	ʈɔŋkaː
ଛିଁ	t͡ʃʰĩ
ଦେବୀଙ୍କ	d̪ebiŋkɔ
ବଡ଼ରୁ	bɔɽɔru
ଦାଦାଙ୍କ	d̪aːd̪aːŋkɔ
ରସ	ɾɔsɔ
ପାଚିଗଲା	paːt͡ʃiɡɔlaː
କୁଶଳ	kusɔl̪ɔ
ସିଲେଇ	silei
କାନ	kaːnɔ
ଏହାକୁ	ehaːku
ଦେହ	d̪ehɔ
ବରର	bɔɾɔɾɔ
ପାଚେରୀ	paːt͡ʃeri
ଯାଉଛି	d͡ʒaːut͡ʃʰi
ଅଜ୍ଞାତ	ɔd͡ʒɲaːt̪ɔ
ସାରା	saːraː
ଢାଳ	ɖʱaːl̪ɔ
ଜାତି	d͡ʒaːt̪i
ଫଟୋ	pʰɔʈo
ଆଛୁ	aːt͡ʃʰu
ପଡ଼ିଲେ	pɔɽile
ପୋକ-ଜୋକ	pokɔ-d͡ʒokɔ
କରିଛି	kɔrit͡ʃʰi
ବିଶ୍ୱବିଦ୍ୟାଳୟ	bisuɔbid̪jaːl̪ɔjɔ
ପର୍ଦ୍ଦା	pɔrd̪d̪aː
ଛଡା	t͡ʃʰɔɖaː
ବାହାରି	baːhaːri
କିନ୍ତୁ	kint̪u
ବଡ଼ପାଟିରେ	bɔɽɔpaːʈire
ପର୍ଶୁରାମ	pɔrsuraːmɔ
ଜଣାଇଦେଇଛନ୍ତି	d͡ʒɔɳaːid̪eit͡ʃʰɔnt̪i
ଗୋଟେଇ	goʈei
ପାରିବ	paːribɔ
ଅସନା	ɔsɔnaː
ଚଢ଼ିବି	t͡ʃɔɽʱibi
ସରକାର	sɔɾɔkaːɾɔ
ଯିବୁ	d͡ʒibu
ସିଂଗଡ଼ା	siŋɡɔɽaː
ଉଡ଼େଇବାକୁ	uɽeibaːku
ବ୍ୟତିତ	bjɔt̪it̪ɔ
ଅସୀମ	ɔsimɔ
ଗଲୁ	ɡɔlu
କେଉଁ	keũ
ପାଇଛି	paːit͡ʃʰi
ଆଣିଲେ	aːɳile
ଦେବା	d̪ebaː
ଜିଲ୍ଲାମାନଙ୍କର	d͡ʒillaːmaːnɔŋkɔɾɔ
ଆଉକିଛି	aːukit͡ʃʰi
ହାଲୁଆ	haːluaː
ଗୋଲୁରେ	golure
ଟାଣିନେଲେ	ʈaːɳinele
ଟ୍ରକ	ʈɾɔkɔ
ଧନୀ	d̪ʱɔni
କୁମ୍ଭୀର	kumbʱiɾɔ
ପାଇଥିଲ	paːit̪ʰilɔ
ଠକ୍‌	ʈʰɔk
ଚୁଡ଼ିଦାର	t͡ʃuɽid̪aːɾɔ
ରାସାୟନିକ	raːsaːjɔnikɔ
ପଦ୍ମ	pɔd̪mɔ
ଭିଟାମିନ	bʱiʈaːminɔ
କିଭଳି	kibʰɔl̪i
ରୋବଟ୍‌	robɔʈ
ରାଜପୁତମାନେ	raːd͡ʒɔput̪ɔmaːne
ସେଥିପାଇଁ	set̪ʰipaːĩ
ବ୍ରାହ୍ମଣ	braːhmɔɳɔ
ପାଣିଭିତରୁ	paːɳibʱit̪ɔru
ଡେଣା	ɖeɳaː
ଆନ୍ଦୋଳନ	aːnd̪ol̪ɔnɔ
ସଫାକରିବା	sɔpʰaːkɔribaː
ହାସଲ	haːsɔlɔ
କଂଗ୍ରେସ	kɔŋgresɔ
ନିଆଁ	niaː̃
ଗୋଟି	goʈi
ଲୋଦିଙ୍କୁ	lod̪iŋku
ଦୁର୍ବଳ	d̪urbɔl̪ɔ
ହସିହସି	hɔsihɔsi
ଶୁଣିଲେ	suɳile
ଖିଲାଣକରା	kʰilaːɳɔkɔraː
ଫୁଟିଥିଲା	pʰuʈit̪ʰilaː
ରଙ୍ଗର	ɾɔŋɡɔɾɔ
ସଫା	sɔpʰaː
ମାମୁ	maːmu
ଗାନ୍ଧୀଜୀ	gaːnd̪ʱid͡ʒi
ପିଲାଟି	pilaːʈi
ଲୋଗୋ	logo
କ୍ରେଟାସିଅସ	kreʈaːsiɔsɔ
ଅପାଂକ	ɔpaːŋkɔ
ରଡ଼ି	ɾɔɽi
ଘୋଡାଟିଏ	gʰoɖaːʈie
ରାନ୍ଧିହେବ	raːnd̪ʱihebɔ
ବାସ୍	baːs
ମୁଣ୍ଡଟି	muɳɖɔʈi
ଠିକ୍	ʈʰik
ଗାନ	gaːnɔ
ଚରଣ	t͡ʃɔɾɔɳɔ
କ୍ଷେତ୍ର	kʰet̪ɾɔ
ଭାଜ	bʱaːd͡ʒɔ
ଲିନକ୍ସ	linɔksɔ
ଲୋକ	lokɔ
ଫାଇଲ	pʰaːilɔ
ଗୁମୁରୁଥିଲେ	gumurut̪ʰile
ଉଡିଯାଏ	uɖid͡ʒaːe
ବାହାରିଲା	baːhaːrilaː
ରଷୋଇ	ɾɔsoi
ତନ୍ଦ୍ରା	t̪ɔnd̪raː
କହୁଥିଲା	kɔhut̪ʰilaː
ଟମାଟୋ	ʈɔmaːʈo
ଭାଲୁ	bʱaːlu
ପିନ୍ଧନ୍ତେ	pind̪ʱɔnt̪e
କଣ୍ଟା	kɔɳʈaː
ହଲି	hɔli
କାହାଳୀଟି	kaːhaːl̪iʈi
ଚାହୁଁଥିଲି	t͡ʃaːhũt̪ʰili
ବୁଲେ	bule
ଫୁଲର	pʰulɔɾɔ
ଭୋକି	bʱoki
ଯାଉନି	d͡ʒaːuni
ହାତକୁ	haːt̪ɔku
ଆନନ୍ଦ	aːnɔnd̪ɔ
ପାଉଁରୁଟି	paːũruʈi
ଦୁର୍ଗ	d̪urɡɔ
ଖାତାକୁ	kʰaːt̪aːku
ଲୋକଙ୍କ	lokɔŋkɔ
ତଳପଟେ	t̪ɔl̪ɔpɔʈe
ପାରା	paːraː
କୁହୁଡ଼ି	kuhuɽi
ନୀଳରଙ୍ଗର	nil̪ɔɾɔŋɡɔɾɔ
ରାଣୀ	raːɳi
ଅସ୍ଥି	ɔst̪ʰi
ସମସ୍ତଙ୍କୁ	sɔmɔst̪ɔŋku
ଠାଣିରେ	ʈʰaːɳire
ପିଲାମାନଂକୁ	pilaːmaːnɔŋku
ଅଳାଇଚ	ɔl̪aːit͡ʃɔ
ବସିପଡ଼ିଲା	bɔsipɔɽilaː
ପୃ	pru
ଦୌଡିଯାଇ	d̪ɔuɖid͡ʒaːi
ମଜା	mɔd͡ʒaː
ଇଷ୍	is
ବିଧାୟକ	bid̪ʱaːjɔkɔ
ପ୍ରତୀକ	pɾɔt̪ikɔ
ପାଖ	paːkʰɔ
ବସନ୍ତରେ	bɔsɔnt̪ɔre
ବିତି	bit̪i
ଦେବୁ	d̪ebu
ଅନୁମାନ	ɔnumaːnɔ
ପୋତିଲୁ	pot̪ilu
ଖଞ୍ଜିଲା	kʰɔɲd͡ʒilaː
ଋତୁକୁ	rut̪uku
ନିମନ୍ତ୍ରଣ	nimɔnt̪ɾɔɳɔ
ଇମ୍ମା	immaː
ଯେଉଁମାନେ	d͡ʒeũmaːne
ଜଙ୍ଗଲ	d͡ʒɔŋɡɔlɔ
ସ୍ପଷ୍ଟ	spɔsʈɔ
ଗଣିବାକୁ	ɡɔɳibaːku
ଅପରେଶନ	ɔpɔresɔnɔ
ଜିଲ୍ଲାରେ	d͡ʒillaːre
ନିର୍ଦ୍ଦେଶକ	nird̪d̪esɔkɔ
ପଶୁ	pɔsu
ଚିଡ଼ିଗଲା	t͡ʃiɽiɡɔlaː
ଦେଖିଲା	d̪ekʰilaː
ଦେହକୁ	d̪ehɔku
ରବିବାର	ɾɔbibaːɾɔ
ଇଲେକଟ୍ରିକ୍	ilekɔʈrik
ସ୍ତମ୍ଭ	st̪ɔmbʰɔ
ଶିଡ଼ି	siɽi
ଆଧ୍ୟାତ୍ମିକ	aːd̪ʱjaːt̪mikɔ
ମୁଁହ	mũhɔ
ଉଡ଼ିପାରେ	uɽipaːre
ମନାନ୍ତି	mɔnaːnt̪i
ଗତ	ɡɔt̪ɔ
କ୍ରିକେଟ୍	krikeʈ
ସଫଳ	sɔpʰɔl̪ɔ
ଘଣ୍ଟା	ɡʱɔɳʈaː
ବଞ୍ଚିବା	bɔɲt͡ʃibaː
ପିଆଜି	piaːd͡ʒi
ରହୁଥିଲେ	ɾɔhut̪ʰile
ଦିନସାରା	d̪inɔsaːraː
ଆକର୍ଷଣ	aːkɔrsɔɳɔ
ଲୁହାର	luhaːɾɔ
ଝିଅଟିଏ	d͡ʒʱiɔʈie
ବିରଙ୍ଗ	biɾɔŋɡɔ
ଏକାଦଶୀ	ekaːd̪ɔsi
ବାହାଘରକୁ	baːhaːɡʱɔɾɔku
ଏମାନଙ୍କୁ	emaːnɔŋku
ଗୁଣ	guɳɔ
ଅଧିକାରୀ	ɔd̪ʱikaːri
ସମାଜ	sɔmaːd͡ʒɔ
ଆମକୁ	aːmɔku
ଖାଇଥାନ୍ତି	kʰaːit̪ʰaːnt̪i
ଭିତରେ	bʱit̪ɔre
ଗଛରେ	ɡɔt͡ʃʰɔre
ପୁରାଇ	puraːi
କରିବାରେ	kɔribaːre
ହୋଇଯାଏ	hoid͡ʒaːe
ଦିଆଗଲା	d̪iaːɡɔlaː
ବର୍ଣ୍ଣନାକାରୀ	bɔrɳɳɔnaːkaːri
ଫାଟି	pʰaːʈi
ଆବିଷ୍କାର	aːbiskaːɾɔ
ଗୁଡ଼ିକର	guɽikɔɾɔ
କଣିକା	kɔɳikaː
ଶିଖିଗଲି	sikʰiɡɔli
ବିଶ୍ୱାସ	bisuaːsɔ
ଗୁଡ଼ିକୁ	guɽiku
ସିଡ଼ି	siɽi
ନୃତ୍ୟ	nrut̪jɔ
ଖୁବ୍‌	kʰub
କୁମ୍ଭୀରମାନେ	kumbʱiɾɔmaːne
ବୁଦା	bud̪aː
ଗଳ୍ପ	ɡɔl̪pɔ
ଚାଲିବାରେ	t͡ʃaːlibaːre
ମାପ	maːpɔ
ଅଧାକିଲୋ	ɔd̪ʱaːkilo
ମୁଣ୍ତ	muɳt̪ɔ
ଚଂଚଳ	t͡ʃɔŋt͡ʃɔl̪ɔ
ଦେଖୁଛି	d̪ekʰut͡ʃʰi
ଚଢ଼ିଗଲା	t͡ʃɔɽʱiɡɔlaː
ବନାନ୍ତି	bɔnaːnt̪i
କାଟିଦେବାକୁ	kaːʈid̪ebaːku
ସାର୍	saːr
ନିଯୁକ୍ତି	nid͡ʒukt̪i
ଯାଅ	d͡ʒaːɔ
ରଜନୀ	ɾɔd͡ʒɔni
ଭାବୁଥିବ	bʱaːbut̪ʰibɔ
ହସରେ	hɔsɔre
ମନଦୁଃଖରେ	mɔnɔd̪uhkʰɔre
ତରକାରୀ	t̪ɔɾɔkaːri
ଆଗକୁ	aːɡɔku
ପାରିବି	paːribi
ଟେମ୍ପଲେଟ	ʈempɔleʈɔ
ସେଠି	seʈʰi
ଉପେକ୍ଷା	upekʰjaː
କମ	kɔmɔ
କେନ୍ଦ୍ରାପଡ଼ା	kend̪raːpɔɽaː
ଯାଇ	d͡ʒaːi
କୂଅଁ	kuɔ̃
ରାଷ୍ଟ୍ରପତି	raːsʈɾɔpɔt̪i
ମାଂସ	maːŋsɔ
ଉଠି	uʈʰi
ବତାଶ	bɔt̪aːsɔ
ଅବଦୁଲ୍	ɔbɔd̪ul
ସମୁଦ୍ର	sɔmud̪ɾɔ
ବିଭାଜନ	bibʱaːd͡ʒɔnɔ
କେସର	kesɔɾɔ
କଳ୍ପନା	kɔl̪pɔnaː
ଡେଉଁଥିଲେ	ɖeũt̪ʰile
ବ୍ୟାଟ	bjaːʈɔ
କହୁଛୁ	kɔhut͡ʃʰu
ସିଂର	siŋɾɔ
ଚର୍ମ	t͡ʃɔrmɔ
ଗଡ଼ାଣିରେ	ɡɔɽaːɳire
ଆବଶ୍ୟକତା	aːbɔsjɔkɔt̪aː
ମାରିବେ	maːribe
ତାକୁତ	t̪aːkut̪ɔ
ଏହିପରି	ehipɔri
ଲାଇଟ୍	laːiʈ
ରଗେଇବ	ɾɔgeibɔ
ରକ୍ତରେ	ɾɔkt̪ɔre
ଏକାଠି	ekaːʈʰi
ଖୋଲିଦେଖିଲା	kʰolid̪ekʰilaː
ୟା	jaː
ଏକାଧିକ	ekaːd̪ʱikɔ
ଆଣିଦିଅ	aːɳid̪iɔ
ରାଜପ୍ରାସାଦ	raːd͡ʒɔpraːsaːd̪ɔ
ଆସିଯିବ	aːsid͡ʒibɔ
ଜୀବ	d͡ʒibɔ
ଝଡିବା	d͡ʒʱɔɖibaː
ଛାଡ଼ିଦେବା	t͡ʃʰaːɽid̪ebaː
ଏଗୁଡିକ	eguɖikɔ
ଝୁଲା	d͡ʒʱulaː
ହସୁଥିବା	hɔsut̪ʰibaː
ଉଇଁଲା	uĩlaː
କଟି	kɔʈi
ଦେଖିଲୁ	d̪ekʰilu
ଆଣିଲି	aːɳili
ଚିତ୍ରକାର	t͡ʃit̪ɾɔkaːɾɔ
କରିପାରି	kɔripaːri
କେମ୍ପିଙ୍ଗ	kempiŋɡɔ
ଶିଖିବାକୁ	sikʰibaːku
କବାଟରେ	kɔbaːʈɔre
ମୁହଁ	muhɔ̃
ପୁପୁ	pupu
ସାହାଜାନଙ୍କ	saːhaːd͡ʒaːnɔŋkɔ
ଚେହେରା	t͡ʃeheraː
ଚଢିବା	t͡ʃɔɖʱibaː
ପକାଇବ	pɔkaːibɔ
ସ୍ଵପ୍ନଟେ	suɔpnɔʈe
କାଚ	kaːt͡ʃɔ
ଜୁନ	d͡ʒunɔ
ମଙ୍ଗଳବାର	mɔŋɡɔl̪ɔbaːɾɔ
ଅଦା	ɔd̪aː
ଜଣେ	d͡ʒɔɳe
ଚରଖା	t͡ʃɔɾɔkʰaː
ଫୁଉସ୍	pʰuus
ସିଂହାସନ	siŋhaːsɔnɔ
ସାରକଥା	saːɾɔkɔt̪ʰaː
ବାଣ	baːɳɔ
ପଦକ	pɔd̪ɔkɔ
ରହମତ	ɾɔhɔmɔt̪ɔ
ଭରିଗଲା	bʰɔriɡɔlaː
ଉଠାଇ	uʈʰaːi
ଆମଭଳି	aːmɔbʰɔl̪i
କାଶ	kaːsɔ
ବିଭାଗର	bibʱaːɡɔɾɔ
ଭାଙ୍ଗିଦେଲେ	bʱaːŋgid̪ele
ସବୁଦିନ	sɔbud̪inɔ
ଏଥିର	et̪ʰiɾɔ
ଅଫିସ୍	ɔpʰis
ଜିଲା	d͡ʒilaː
ନମ୍ବର୍	nɔmbɔr
ସେ	se
ପହଞ୍ଚିବ	pɔhɔɲt͡ʃibɔ
ପାଖରେ	paːkʰɔre
କୋଣରେ	koɳɔre
ଦେଖନ୍ତି	d̪ekʰɔnt̪i
ପ୍ରତି	pɾɔt̪i
ପରିବାରରୁ	pɔribaːɾɔru
ଡାକ୍ଟର	ɖaːkʈɔɾɔ
ଦୁହିଁଙ୍କୁ	d̪uhĩŋku
ଆଇକୁ	aːiku
ଧନୀଜୀ	d̪ʱɔnid͡ʒi
ଦେଇଛି	d̪eit͡ʃʰi
ଆରପଟେ	aːɾɔpɔʈe
ଖେଳୁଛନ୍ତି	kʰel̪ut͡ʃʰɔnt̪i
ହୋଇଯାଇଛି	hoid͡ʒaːit͡ʃʰi
ସହସ୍ର	sɔhɔsɾɔ
ରାଗିଯାଇ	raːgid͡ʒaːi
କେନ୍ଦ୍ର	kend̪ɾɔ
ଯିବାକୁ	d͡ʒibaːku
ବଢ଼େଇ	bɔɽʱei
ବରଯାତ୍ରୀ	bɔɾɔd͡ʒaːt̪ri
ସମଯରେ	sɔmɔd͡ʒɔre
କୋଠରୀ	koʈʰɔri
ଦିବସ	d̪ibɔsɔ
ଦିଶିଲା	d̪isilaː
ସ୍ଵାଇଁ	suaːĩ
ଦଶମୀ	d̪ɔsɔmi
ସନ୍ତୁଷ୍ଟ	sɔnt̪usʈɔ
ଅବନ୍ତୀର	ɔbɔnt̪iɾɔ
କୋଇଲି	koili
ଅଜବ	ɔd͡ʒɔbɔ
ପାଲିତ	paːlit̪ɔ
ଉପାସନା	upaːsɔnaː
ସମ୍ପର୍କ	sɔmpɔrkɔ
ଡିଆଁମାରି	ɖiaː̃maːri
ଜେଜେମା	d͡ʒed͡ʒemaː
କାବ୍ୟ	kaːbjɔ
ପୁନପ୍ରେରଣ	punɔpreɾɔɳɔ
ମଜବୁତ	mɔd͡ʒɔbut̪ɔ
ଦୌଡ଼ି	d̪ɔuɽi
ମିଳେ	mil̪e
ଭାବିଲା	bʱaːbilaː
ଅଜା	ɔd͡ʒaː
ବାହାରକୁ	baːhaːɾɔku
କିଲୋମିଟର	kilomiʈɔɾɔ
କାହାକୁ	kaːhaːku
ଫେଡ଼େ	pʰeɽe
ରୋମାଞ୍ଚକ	romaːɲt͡ʃɔkɔ
ଜଣକର	d͡ʒɔɳɔkɔɾɔ
ପରିବା	pɔribaː
ନିର୍ଦ୍ଦିଷ୍ଟ	nird̪d̪isʈɔ
ପ୍ରତାପ	pɾɔt̪aːpɔ
କୁଣ୍ଡାଇବା	kuɳɖaːibaː
ହେଇପଡ଼ିଥାଏ	heipɔɽit̪ʰaːe
ପ୍ରବାହିତ	pɾɔbaːhit̪ɔ
ଶୁଣିଲଣି	suɳilɔɳi
ଆସିଛ	aːsit͡ʃʰɔ
ବରଷିବାକୁ	bɔɾɔsibaːku
ଗର୍ବରେ	ɡɔrbɔre
ଖାଲିବସ୍ତା	kʰaːlibɔst̪aː
ଜେଜେବାପାଙ୍କ	d͡ʒed͡ʒebaːpaːŋkɔ
ପଦଯାତ୍ରା	pɔd̪ɔd͡ʒaːt̪raː
ଦେଓ	d̪eo
ଦେଇଥାଏ	d̪eit̪ʰaːe
ହୋଇଛି	hoit͡ʃʰi
କୋଳି	kol̪i
ବିଜେତା	bid͡ʒet̪aː
ହୋଇଥିବା	hoit̪ʰibaː
ଦେଖିଥିଲା	d̪ekʰit̪ʰilaː
ନେଇଥିଲେ	neit̪ʰile
ଆସନ୍ତା	aːsɔnt̪aː
ଖାଇଦେଲା	kʰaːid̪elaː
ପାଇଲି	paːili
ଗଣିତ	ɡɔɳit̪ɔ
ଡାକିଲେ	ɖaːkile
ଅଗଣାକୁ	ɔɡɔɳaːku
ମିଳିମିଶି	mil̪imisi
ଲୋ	lo
ଲେମ୍ବୁସର୍ବତ	lembusɔrbɔt̪ɔ
ଯୋଡି	d͡ʒoɖi
ଗ୍ରେଗୋରି	gregori
ଦୂରରେ	d̪uɾɔre
ଘୋଷଣା	gʰosɔɳaː
ପୂରା	puraː
ଜଳପ୍ରପାତ	d͡ʒɔl̪ɔpɾɔpaːt̪ɔ
ଚନ୍ଦନ	t͡ʃɔnd̪ɔnɔ
ଅନ୍ୟ	ɔnjɔ
ପ୍ରହରାଜ	pɾɔhɔraːd͡ʒɔ
ନାନି	naːni
ରାଗିନି	raːgini
ମୋଟେ	moʈe
ଥାଇ	t̪ʰaːi
ସିମେଇ	simei
ଶିଖିଯିବ	sikʰid͡ʒibɔ
ନିଘୋଡ଼	nigʰoɽɔ
ନାଡ଼ିର	naːɽiɾɔ
ଆପଣଙ୍କର	aːpɔɳɔŋkɔɾɔ
ମାତ୍ରା	maːt̪raː
ପାକୁଳି	paːkul̪i
ଶୁକ୍ଳପକ୍ଷ	sukl̪ɔpɔkʰjɔ
ଶୈଳୀରେ	sɔil̪ire
ଲଗାଇଛ	lɔgaːit͡ʃʰɔ
ବାଲେଶ୍ୱର	baːlesuɔɾɔ
ହଂସ	hɔŋsɔ
ଗୁଡିକୁ	guɖiku
ଦୋକାନରେ	d̪okaːnɔre
ପିରାମିଡ	piraːmiɖɔ
ଲୁଗା	lugaː
କରୁଥିବାର	kɔrut̪ʰibaːɾɔ
ପଡ଼ିଶାଘର	pɔɽisaːɡʱɔɾɔ
କାହାଳୀ	kaːhaːl̪i
ଦେଖାଇଲେ	d̪ekʰaːile
କରିଦେବକି	kɔrid̪ebɔki
ଲଢ଼ୁଛୁ	lɔɽʱut͡ʃʰu
ଆଶ୍ଚର୍ଯ୍ୟଚକିତ	aːst͡ʃɔrd͡ʒjɔt͡ʃɔkit̪ɔ
ଧନ	d̪ʱɔnɔ
ସୂକ୍ଷ୍ମରେଣୁ	sukʰmɔreɳu
ଧାଉଁଥିଲା	d̪ʱaːũt̪ʰilaː
ପଥ	pɔt̪ʰɔ
ଗପବହି	ɡɔpɔbɔhi
ଦାଣ୍ତିକୁ	d̪aːɳt̪iku
ଜ୍ୟେଷ୍ଠ	d͡ʒjesʈʰɔ
ଅଧେ	ɔd̪ʱe
ସକାସେ	sɔkaːse
କଲେଣି	kɔleɳi
କବାଟକୁ	kɔbaːʈɔku
କେଫେନ୍	kepʰen
କରିଦେଲେ	kɔrid̪ele
ସୁଶୀଳାର	susil̪aːɾɔ
ଦେଖ	d̪ekʰɔ
ଯାଉନଥିଲେ	d͡ʒaːunɔt̪ʰile
ଯୋଗୁ	d͡ʒogu
ଶିତିକଣ୍ଠ	sit̪ikɔɳʈʰɔ
ଦାଣ୍ତିଯାତ୍ରାର	d̪aːɳt̪id͡ʒaːt̪raːɾɔ
ଖ୍ରୀ	kʰri
ଧୂର୍ତ୍ତ	d̪ʱurt̪t̪ɔ
ଠେଲା	ʈʰelaː
ପ୍ଲାସ୍ଟିକ୍	plaːsʈik
ତତେ	t̪ɔt̪e
ହସିଦେଲା	hɔsid̪elaː
କଳାଛିଟ	kɔl̪aːt͡ʃʰiʈɔ
ପାତ୍ରକୁ	paːt̪ɾɔku
ଶୁଖିଲା	sukʰilaː
ତାଲିକା	t̪aːlikaː
ୱସନ୍ତ	uɔsɔnt̪ɔ
ଗଳିପଡ଼ିଲା	ɡɔl̪ipɔɽilaː
ନୀଳଗିରି	nil̪ɔgiri
ଝୁଲେଇ	d͡ʒʱulei
ଅର୍ଥାତ	ɔrt̪ʰaːt̪ɔ
ଦୌଡ଼ିଲେ	d̪ɔuɽile
ଆଣିଥିଲା	aːɳit̪ʰilaː
ମନୋରଞ୍ଜନ	mɔnoɾɔɲd͡ʒɔnɔ
ଏକାଡେମୀ	ekaːɖemi
ବଞ୍ଚୁଥିବା	bɔɲt͡ʃut̪ʰibaː
ପଦଯାତ୍ରାରେ	pɔd̪ɔd͡ʒaːt̪raːre
କ୍ରମାଙ୍କ	kɾɔmaːŋkɔ
ସ୍ନାନ	snaːnɔ
ରାଣ	raːɳɔ
କୋଣ	koɳɔ
ଛାଡ଼ି	t͡ʃʰaːɽi
ଦରଜ	d̪ɔɾɔd͡ʒɔ
ତୋରଣ	t̪oɾɔɳɔ
ଶିଖିଥିଲା	sikʰit̪ʰilaː
ଆରାମରେ	aːraːmɔre
କଳାକାର	kɔl̪aːkaːɾɔ
ଗପସପ	ɡɔpɔsɔpɔ
ଶିଖିବା	sikʰibaː
ରାଉତ	raːut̪ɔ
ଉଡ଼	uɽɔ
ମସିହା	mɔsihaː
ସେଇ	sei
ଚାହୁଁଥାଏ	t͡ʃaːhũt̪ʰaːe
ଡାକବାକ୍ସରେ	ɖaːkɔbaːksɔre
ଉପ	upɔ
ଚାଲିବାକୁ	t͡ʃaːlibaːku
ସୁବୁଠୁ	subuʈʰu
ସଂଶୋଧନ	sɔŋsod̪ʱɔnɔ
ବଗୀଚା	bɔgit͡ʃaː
ଲସ୍ସି	lɔssi
ରହିପାରିବ	ɾɔhipaːribɔ
ଗୁଡ଼ି	guɽi
ଚତୁର୍ଦ୍ଦଶୀ	t͡ʃɔt̪urd̪d̪ɔsi
ଫୁଲକୁ	pʰulɔku
ଅନେକ	ɔnekɔ
ଜିରା	d͡ʒiraː
ଓଜନିଆ	od͡ʒɔniaː
ନଗର	nɔɡɔɾɔ
ଗାର	gaːɾɔ
କରିଥାନ୍ତ	kɔrit̪ʰaːnt̪ɔ
ନିରାପଦରେ	niraːpɔd̪ɔre
ମାଛଙ୍କୁବି	maːt͡ʃʰɔŋkubi
ଆଣିବେ	aːɳibe
ସବୁପିଲାଙ୍କ	sɔbupilaːŋkɔ
ମଟର	mɔʈɔɾɔ
ବସିବା	bɔsibaː
ହସେ-ଚିତ୍ର	hɔse-t͡ʃit̪ɾɔ
ପୃଥିବୀର	prut̪ʰibiɾɔ
ଲାଙ୍ଗଲେନର	laːŋɡɔlenɔɾɔ
ଆସି	aːsi
ନିର୍ବାଚନ	nirbaːt͡ʃɔnɔ
ସମସ୍ତଙ୍କ	sɔmɔst̪ɔŋkɔ
ନିଦୁଆ	nid̪uaː
କର୍ମ	kɔrmɔ
ରେଶମରେ	resɔmɔre
ସାମନାରେ	saːmɔnaːre
ସମ୍ୱାଦ	sɔmuaːd̪ɔ
ହୁଏ	hue
ଝୁଲୁଥିଲା	d͡ʒʱulut̪ʰilaː
ସ୍ଥିତି	st̪ʰit̪i
ଚୁମ୍ବକ	t͡ʃumbɔkɔ
ରାସ୍ଥାରେ	raːst̪ʰaːre
ଲଡୁର	lɔɖuɾɔ
ଆମ୍ୱ	aːmuɔ
ରହୁଥଲା	ɾɔhut̪ʰɔlaː
ଶାନ୍ତଥିଲା	saːnt̪ɔt̪ʰilaː
ପୁରା	puraː
ସେଇଠି	seiʈʰi
ଆଳୁ	aːl̪u
କାର୍ଯ୍ୟକ୍ରମ	kaːrd͡ʒjɔkɾɔmɔ
ପହଣ୍ଡି	pɔhɔɳɖi
ବ୍ଳକ	bl̪ɔkɔ
ସରୁ	sɔru
ହସ	hɔsɔ
ଖାତାରୁ	kʰaːt̪aːru
ସମାନ	sɔmaːnɔ
ଉନ୍ନତ	unnɔt̪ɔ
କଳାଜାଇଟିଏ	kɔl̪aːd͡ʒaːiʈie
ଗୁଜୁରାଟ	gud͡ʒuraːʈɔ
ଗଠନ	ɡɔʈʰɔnɔ
ଖୋଜୁଛ	kʰod͡ʒut͡ʃʰɔ
କ୍ଷୀରି	kʰiri
ତାରାଭଳି	t̪aːraːbʰɔl̪i
ସର	sɔɾɔ
କଇଁଚ	kɔĩt͡ʃɔ
ଶରୀରର	sɔriɾɔɾɔ
ଲାଭ	laːbʰɔ
ମନୁଆ	mɔnuaː
ଦୁଇଜଣଙ୍କୁ	d̪uid͡ʒɔɳɔŋku
ପାହାଡ଼	paːhaːɽɔ,paːhaːɖɔ
ଗଡିପଡିଲା	ɡɔɖipɔɖilaː
ରହିଲା	ɾɔhilaː
ପାରିନି	paːrini
ଲାଗିପାରେ	laːgipaːre
ଗଣତି	ɡɔɳɔt̪i
ଆଧାରିତ	aːd̪ʱaːrit̪ɔ
ପ୍ରଦେଶର	pɾɔd̪esɔɾɔ
ହସିଲୁ	hɔsilu
ଉଦ୍ଦେଶ୍ୟରେ	ud̪d̪esjɔre
ପରାପ୍ପୁ	pɔraːppu
ଆସିଛୁ	aːsit͡ʃʰu
ଖୋଲ	kʰolɔ
ଚକମକିଆ	t͡ʃɔkɔmɔkiaː
ଲୁହାରେ	luhaːre
ଦେହରେ	d̪ehɔre
କହିବେ	kɔhibe
ଚିନାମାଟିରେ	t͡ʃinaːmaːʈire
ୟୁ	ju
କାଗଜବାଲା	kaːɡɔd͡ʒɔbaːlaː
ରଖାହୋଇଥିବା	ɾɔkʰaːhoit̪ʰibaː
ଆଇିମ	aːimɔ
କାର	kaːɾɔ
ଛୁଟିରେ	t͡ʃʰuʈire
ଦାନ୍ତରେ	d̪aːnt̪ɔre
ସ୍ନିଫଲ୍ସ	snipʰɔlsɔ
ଓସ୍ତ	ost̪ɔ
ଦ୍ରଷ୍ଟବ୍ୟ	d̪ɾɔsʈɔbjɔ
ପାଣିରଖି	paːɳiɾɔkʰi
ସିଂ	siŋ
ପୋଷ୍ଟାଲ	posʈaːlɔ
ମତେ	mɔt̪e
ହସୁଥିଲା	hɔsut̪ʰilaː
ଖୋଜନ୍ତୁ	kʰod͡ʒɔnt̪u
ନାକଟି	naːkɔʈi
ଧୂପ	d̪ʱupɔ
ଲାଲ୍	laːl
ଶୁଣିପାରିବି	suɳipaːribi
ହଠାତ୍	hɔʈʰaːt̪
ପତ୍ରିକା	pɔt̪rikaː
ଡାକୁଛି	ɖaːkut͡ʃʰi
କେ	ke
ତଳକୁ	t̪ɔl̪ɔku
ଫେରିଆସିଲେ	pʰeriaːsile
ପର	pɔɾɔ
ସିଝେଇବା	sid͡ʒʱeibaː
ମୁଣ୍ଡା	muɳɖaː
ବାଳ	baːl̪ɔ
କରିଛ	kɔrit͡ʃʰɔ
ଝିଅକୁ	d͡ʒʱiɔku
ପଶୁମାନଙ୍କ	pɔsumaːnɔŋkɔ
ପାରୁଥିଲେ	paːrut̪ʰile
ଫୁଲରୁ	pʰulɔru
ଜେଜେ	d͡ʒed͡ʒe
ଘୋଡା	gʰoɖaː
ପାଲଟି	paːlɔʈi
ଦୌଡ଼ା	d̪ɔuɽaː
ନାହଁ	naːhɔ̃
ମେଘ	meɡʱɔ
ପଞ୍ଜାବ	pɔɲd͡ʒaːbɔ
ସ୍ୱରୂପ	suɔrupɔ
ଲାଞ୍ଜକୁ	laːɲd͡ʒɔku
ବାପା-ମା	baːpaː-maː
ଜୁଳୁଜୁଳିଆ	d͡ʒul̪ud͡ʒul̪iaː
ଗାଢ	gaːɖʱɔ
ବର୍ଷରେ	bɔrsɔre
ଝର୍କା	d͡ʒʱɔrkaː
ଭିତରୁ	bʱit̪ɔru
ଦୁଷ୍ଟାମି	d̪usʈaːmi
ପଡ଼ିଲା	pɔɽilaː
ପଞ୍ଚକୁ	pɔɲt͡ʃɔku
ଗୁଳ୍ମ	gul̪mɔ
କପାଳ	kɔpaːl̪ɔ
ଛମ୍-ଛମ୍-ଛମ୍	t͡ʃʰɔm-t͡ʃʰɔm-t͡ʃʰɔm
ପୃଷ୍ଠାରେ	prusʈʰaːre
ଜାଣିନୁ	d͡ʒaːɳinu
ପର୍ବାଣୀ	pɔrbaːɳi
ବଜାଇ	bɔd͡ʒaːi
ଶନିବାର	sɔnibaːɾɔ
ଥିବା	t̪ʰibaː
ସାଧ୍ୟ	saːd̪ʱjɔ
ଘରୁ	ɡʱɔru
ବାଟଦେଇ	baːʈɔd̪ei
ଆଂକିବାକୁ	aːŋkibaːku
ଘଣ୍ଟି	ɡʱɔɳʈi
ହେତୁ	het̪u
କଥା	kɔt̪ʰaː
ହେବ	hebɔ
କରିଉଠିଲେ	kɔriuʈʰile
ପହଞ୍ଚିବାକୁ	pɔhɔɲt͡ʃibaːku
ଲୁଚିଗଲା	lut͡ʃiɡɔlaː
ଲୋକର	lokɔɾɔ
ଝିଙ୍କ	d͡ʒʱiŋkɔ
ଗଢିବାରେ	ɡɔɖʱibaːre
ପାଇଁ	paːĩ
ଡେଣାର	ɖeɳaːɾɔ
ସୁଦ୍ଧା	sud̪d̪ʱaː
ବିଛା	bit͡ʃʰaː
ପଶି	pɔsi
ଟୋପିକୁ	ʈopiku
ଲେଖକ	lekʰɔkɔ
ଟିଙ୍ଗୁ	ʈiŋgu
ପାରୁନାହିଁ	paːrunaːhĩ
ଫୁଟିଛି	pʰuʈit͡ʃʰi
ମାରିପାରନ୍ତି	maːripaːɾɔnt̪i
ତୁମଠୁ	t̪umɔʈʰu
ଛତୁ	t͡ʃʰɔt̪u
ସରିଗଲା	sɔriɡɔlaː
ଲେମ୍ୱୁ	lemu
ରନ୍ଧାଘରେ	ɾɔnd̪ʱaːɡʱɔre
ଶତାବ୍ଦୀ	sɔt̪aːbd̪i
ରବର	ɾɔbɔɾɔ
ହେଇଗଲା	heiɡɔlaː
ଉତ୍ତମ	ut̪t̪ɔmɔ
ମହାକାଶ	mɔhaːkaːsɔ
ନଥିବା	nɔt̪ʰibaː
କେଡ଼େ	keɽe
ନିଶ୍ଚେ	nist͡ʃe
ହୋଇଛ	hoit͡ʃʰɔ
ଧୂପକାଠି	d̪ʱupɔkaːʈʰi
ବାକ୍ସ	baːksɔ
ଯଦି	d͡ʒɔd̪i
ହବାକୁ	hɔbaːku
କର୍ମଶାଳା	kɔrmɔsaːl̪aː
ପୂ	pu
ଶବ୍ଦର	sɔbd̪ɔɾɔ
ଦେହର	d̪ehɔɾɔ
ଟୋପା	ʈopaː
ବ୍ୟକ୍ତି	bjɔkt̪i
ଆସେନି	aːseni
କୁମ୍ଭୀରଙ୍କ	kumbʱiɾɔŋkɔ
ନବୀନ	nɔbinɔ
ଉଚିତ୍	ut͡ʃit̪
କମ୍ପିଲା	kɔmpilaː
ଚୁମ୍ବକଟି	t͡ʃumbɔkɔʈi
କୋଉଠୁ	kouʈʰu
ସାହାଜାନ	saːhaːd͡ʒaːnɔ
ଚାହାଁନ୍ତି	t͡ʃaːhaː̃nt̪i
ଆସିଲେଣି	aːsileɳi
କାନ୍ଦିବାକୁ	kaːnd̪ibaːku
ଭୂମିକା	bʱumikaː
ନେବାକୁ	nebaːku
ରାତିଟିରେ	raːt̪iʈire
ବୁଦ୍ଧିମାନ୍	bud̪d̪ʱimaːn
କଉଡ଼ି	kɔuɽi
ସ୍ଟୋଭ୍	sʈobʱ
ଛାଇ	t͡ʃʰaːi
ପୋଖରୀ	pokʰɔri
ସହିତ	sɔhit̪ɔ
ପାଣିରେ	paːɳire
ନିଜ	nid͡ʒɔ
ପର୍ଯ୍ୟାପ୍ତ	pɔrd͡ʒjaːpt̪ɔ
ଅପ୍ପା	ɔppaː
ଆଲୁଅ	aːluɔ
ପଢ଼ିଲୁ	pɔɽʱilu
ତାତି	t̪aːt̪i
ଦକ୍ଷ	d̪ɔkʰjɔ
ଅନୂସୁଚିତ	ɔnusut͡ʃit̪ɔ
ଶାସନ	saːsɔnɔ
ଆଦାୟକୁ	aːd̪aːjɔku
ସାଙ୍ଗମାନେ	saːŋɡɔmaːne
ପରିଶ୍ରମ	pɔrisɾɔmɔ
ସଂଗଠନ	sɔŋɡɔʈʰɔnɔ
ଖୋଲାପଟ	kʰolaːpɔʈɔ
ଚୌକିଦାର	t͡ʃɔukid̪aːɾɔ
ଆଶ୍ଚର୍ଯ୍ୟଜନକ	aːst͡ʃɔrd͡ʒjɔd͡ʒɔnɔkɔ
ପ୍ରଚୁର	pɾɔt͡ʃuɾɔ
ରିପୋର୍ଟ	riporʈɔ
ପାରାମାନେ	paːraːmaːne
ଗଲାନି	ɡɔlaːni
ଉଲ୍ଲେଖ	ullekʰɔ
ଗବେଷଣା	ɡɔbesɔɳaː
ହେଲେଣି	heleɳi
ଭଉଣୀ	bʰɔuɳi
ଘୋଡ଼ା	gʰoɽaː
ବେଳକୁ	bel̪ɔku
ହଲାଇ	hɔlaːi
ଉଠିବା	uʈʰibaː
ପ୍ରତଯାତ	pɾɔt̪ɔd͡ʒaːt̪ɔ
ରହିଥାଏ	ɾɔhit̪ʰaːe
ତରତରରେ	t̪ɔɾɔt̪ɔɾɔre
ଦୁଧରେ	d̪ud̪ʱɔre
କହ	kɔhɔ
ବରଗଡ଼	bɔɾɔɡɔɖɔ
ନମ୍ବର	nɔmbɔɾɔ
ମୃତ୍ୟୁଞ୍ଜୟ	mrut̪juɲd͡ʒɔjɔ
ମାଁ	maː̃
ଗର୍ବ	ɡɔrbɔ
କୋର୍ଟ	korʈɔ
ସରି	sɔri
ପକାଅ	pɔkaːɔ
ଖୋସି	kʰosi
ସମ୍ମିଶ୍ରଣ	sɔmmisɾɔɳɔ
ଶତପଥୀ	sɔt̪ɔpɔt̪ʰi
ସରିଆସିଲାଣି	sɔriaːsilaːɳi
ଗାଆଁ	gaːaː̃
ପଡ଼ୁଥିଲା	pɔɽut̪ʰilaː
କାକଟପୁର	kaːkɔʈɔpuɾɔ
ରତ୍ନ	ɾɔt̪nɔ
ବିଭାଗ	bibʱaːɡɔ
ଯୋଡ଼ି	d͡ʒoɽi
କରିବୁ	kɔribu
ଇଞ୍ଚ	iɲt͡ʃɔ
ହୁରୁଡ଼େଇ	huruɽei
କଥିତ	kɔt̪ʰit̪ɔ
ଶିମଳା	simɔl̪aː
ସୁନାରଙ୍ଗର	sunaːɾɔŋɡɔɾɔ
ଭାରତରୁ	bʱaːɾɔt̪ɔru
ମେଳଣ	mel̪ɔɳɔ
ବାଛିବେ	baːt͡ʃʰibe
କରାଇ	kɔraːi
ହାର	haːɾɔ
ସାଙ୍ଗରେ	saːŋɡɔre
ପଛକୁ	pɔt͡ʃʰɔku
ମଫଲର	mɔpʰɔlɔɾɔ
ଜଲ୍ଦି	d͡ʒɔld̪i
ଦେଶରୁ	d̪esɔru
ପୁସ୍ତିକା	pust̪ikaː
ବଳୁଆ	bɔl̪uaː
କୂଳକୁ	kul̪ɔku
ମନ	mɔnɔ
ମୁନିଆଁ	muniaː̃
ଘଟଣାବଳୀ	ɡʱɔʈɔɳaːbɔl̪i
ଧରିବା	d̪ʱɔribaː
ପିଲା	pilaː
ବହୁଳ	bɔhul̪ɔ
ଡରିଯାନ୍ତି	ɖɔrid͡ʒaːnt̪i
ମୁକ୍ତିଲାଭ	mukt̪ilaːbʰɔ
ଭାଂଗିଲା	bʱaːŋgilaː
ସାରିଥା	saːrit̪ʰaː
ସାହିତ୍ୟିକ	saːhit̪jikɔ
ଜିନିଷଟିଏ	d͡ʒinisɔʈie
ରୂପେ	rupe
ବାଲେଶ୍ଵର	baːlesuɔɾɔ
ଚୋବାଇ	t͡ʃobaːi
ଉଦ୍ଭାବିତ	ud̪bʱaːbit̪ɔ
ବିରାଟ୍	biraːʈ
ଯାଉଛ	d͡ʒaːut͡ʃʰɔ
ଗାୟକ	gaːjɔkɔ
ଆସିପାରନ୍ତି	aːsipaːɾɔnt̪i
ଆଷାଢ଼	aːsaːɖʱɔ
ଚିକିତ୍ସା	t͡ʃikit̪saː
ନୀଳ	nil̪ɔ
ସଂସ୍ଥାନ	sɔŋst̪ʰaːnɔ
ଲୁଚିଯାଅ	lut͡ʃid͡ʒaːɔ
ପରିବାରରେ	pɔribaːɾɔre
ଡରନ୍ତି	ɖɔɾɔnt̪i
ସହଜରେ	sɔhɔd͡ʒɔre
କରିବେ	kɔribe
ଝରଣାର	d͡ʒʱɔɾɔɳaːɾɔ
ଚିରିଦେବି	t͡ʃirid̪ebi
ବବୁଲ୍	bɔbul
କାନରେ	kaːnɔre
ଯୋଷ	d͡ʒosɔ
ଆଧାର	aːd̪ʱaːɾɔ
ଦେଖି	d̪ekʰi
ସମ୍ଭାବନା	sɔmbʱaːbɔnaː
ଅର୍ଥନୈତିକ	ɔrt̪ʰɔnɔit̪ikɔ
ବାଷା	baːsaː
ପାଖାପାଖି	paːkʰaːpaːkʰi
ଡେଙ୍ଗା	ɖeŋgaː
ଏତେଦୂର	et̪ed̪uɾɔ
ଶ୍ରେଷ୍ଠ	sresʈʰɔ
ପରଗ	pɔɾɔɡɔ
ବାତ	baːt̪ɔ
ଗୁଲିର	guliɾɔ
ସେମାନେ	semaːne
କିମିତି	kimit̪i
ସୁନ୍ଦର	sund̪ɔɾɔ
ସମିତି	sɔmit̪i
ଜିନିଷଗୁଡ଼ା	d͡ʒinisɔguɽaː
ଏପର୍ଯ୍ୟନ୍ତ	epɔrd͡ʒjɔnt̪ɔ
ନୁଆଇଁ	nuaːĩ
ନୌକାଟି	nɔukaːʈi
ରଂଗୀନ	ɾɔŋginɔ
ପୂର୍ଣ୍ଣ	purɳɳɔ
ଭରାଯାଏ	bʰɔraːd͡ʒaːe
ତୁମକୁ	t̪umɔku
ମହାନଦୀ	mɔhaːnɔd̪i
ପଳେଇଯାଅ	pɔl̪eid͡ʒaːɔ
ଗୋଟାଏ	goʈaːe
ଲେଖାର	lekʰaːɾɔ
ସମ୍ପର୍କରେ	sɔmpɔrkɔre
କାନ୍ଧ	kaːnd̪ʱɔ
ଏକକ	ekɔkɔ
ଅଙ୍ଗ	ɔŋɡɔ
ନିୟମ	nijɔmɔ
ଝାରସୁଗୁଡ଼ା	d͡ʒʱaːɾɔsuguɽaː
ପ୍ରିତିକ୍ରିୟା	prit̪ikrijaː
କାହାଣୀଥିବା	kaːhaːɳit̪ʰibaː
ଜାଣିବେ	d͡ʒaːɳibe
ବଡ଼-ମୁଣ୍ଡିଆ	bɔɽɔ-muɳɖiaː
ଜିନିଷ	d͡ʒinisɔ
ଲମ୍ବାମାଛ	lɔmbaːmaːt͡ʃʰɔ
ସେଠୁ	seʈʰu
ହାଉ	haːu
କବାଡ଼ି	kɔbaːɽi
ରୁଟିକି	ruʈiki
ହସିଦେଲେ	hɔsid̪ele
ସବ୍ୟସାଚୀ	sɔbjɔsaːt͡ʃi
ନିର୍ମାଣ	nirmaːɳɔ
ପରମହଂସ	pɔɾɔmɔhɔŋsɔ
ମଣ୍ଡପ	mɔɳɖɔpɔ
ରଙ୍ଗ	ɾɔŋɡɔ
ହୋଇଯାଇଥିଲା	hoid͡ʒaːit̪ʰilaː
ଉଠିଲେ	uʈʰile
ଦେଖିନଥିଲା	d̪ekʰinɔt̪ʰilaː
କପ୍	kɔp
ସ୍ୱାଦର	suaːd̪ɔɾɔ
ଜିଭ	d͡ʒibʰɔ
ମୁଖିଟେ	mukʰiʈe
ଯାଉଥିବା	d͡ʒaːut̪ʰibaː
ସାଙ୍ଗସାଥୀ	saːŋɡɔsaːt̪ʰi
ପ୍ୟାରିସ୍	pjaːris
ପ୍ରଚାର	pɾɔt͡ʃaːɾɔ
ଜମି	d͡ʒɔmi
ସ-ସ-ସ	sɔ-sɔ-sɔ
ନିର୍ବାଚନମଣ୍ଡଳୀରୁ	nirbaːt͡ʃɔnɔmɔɳɖɔl̪iru
ସାହାଯ୍ୟରେ	saːhaːd͡ʒjɔre
ଲୁଚାଇ	lut͡ʃaːi
ମଧ୍ୟରେ	mɔd̪ʱjɔre
ସେଇଆ	seiaː
ନେଇଥାନ୍ତି	neit̪ʰaːnt̪i
ରାୟଗଡ଼ା	raːjɔɡɔɽaː
ଝୁଣ୍ଟିକି	d͡ʒʱuɳʈiki
ମାନୁଛି	maːnut͡ʃʰi
ବରଷିଯାଆ	bɔɾɔsid͡ʒaːaː
ଅରୁଣାଚଳ	ɔruɳaːt͡ʃɔl̪ɔ
ପ୍ରୋଗ୍ରାମିଂ	prograːmiŋ
ଚାଉଳ	t͡ʃaːul̪ɔ
ନୂଆସହର	nuaːsɔhɔɾɔ
କଣରେ	kɔɳɔre
ଉପାୟ	upaːjɔ
ଚିନୁ	t͡ʃinu
ଦିଗରେ	d̪iɡɔre
କେହି	kehi
ମୁହଁରେ	muhɔ̃re
ପାରିଲେ	paːrile
ଗଛର	ɡɔt͡ʃʰɔɾɔ
ଭାଷଣ	bʱaːsɔɳɔ
କି	ki
ଆସନ୍ତି	aːsɔnt̪i
କାନ୍ଦିକାନ୍ଦି	kaːnd̪ikaːnd̪i
ମାଧବ	maːd̪ʱɔbɔ
ଛୁଆଟିଏ	t͡ʃʰuaːʈie
ପାଇଥିଲେ	paːit̪ʰile
ପହଁଚିବେ	pɔhɔ̃t͡ʃibe
ଜାନୁଆରୀ	d͡ʒaːnuaːri
ଚାଚା	t͡ʃaːt͡ʃaː
ଗାଈଟି	gaːiʈi
ସଜେଇଛି	sɔd͡ʒeit͡ʃʰi
ପାଲା	paːlaː
କରିପାରେ	kɔripaːre
