vocero	vosˈero
Hospice	hospˈise
enrikece	enrikˈese
expresa	eksprˈesa
victimanan	viktimˈanan
alomenos	alomenˈos
brandweer	brandwˈeːr
Supermarket	supermarkˈet
examennan	eksamˈennan
efectonan	efektˈonan
barconan	barkˈonan
Mama	mˈama
apropia	aprˈopja
Heights	hˈe͡ɪɡhts
all	ˈall
politica	politˈika
ayera	ajˈera
clausura	klausˈura
deshaci	deʃˈasi
prijsnan	prˈe͡ɪsnan
Cinco	sˈinko
UA	wˈa
urna	ˈurna
diferente	diferˈente
pertenece	pertenˈese
Norte	nˈorte
pecho	pˈet͡ʃo
HH	hˌahˈa
deterioro	deterjˈoro
balornan	balˈornan
cambiando	kambjˈando
Hot	hˈot
recauda	rekaˈuda
conose	konˈose
lucrativo	lukratˈivo
delitonan	delitˈonan
Security	sekurˈiti
salvo	sˈalvo
KB	kˌabˈe
Challenge	t͡ʃallˈenxe
Social	sosjˈal
Emanstraat	emanstrˈaːt
Food	fˈoːd
Development	developmˈent
Codigo	kodˈiɡo
Tampoco	tampˈoko
linear	lineˈar
dicidi	disˈidi
vakantie	vakˈantje
mainta	mˈa͡ɪnta
la	lˈa
brabo	brˈabo
Boroncana	boronkˈana
parlamentarionan	parlamentarjˈonan
Sostenible	sostenˈible
celebracionnan	selebrasjˈonnan
Tin	tˈiŋ
percela	persˈela
aglomera	aɡlomˈera
salarial	salarjˈal
cielo	sjˈelo
comunista	komunˈista
impacta	impˈakta
babuca	babˈuka
desafio	desˈafjo
caracteristica	karakteristˈika
ministerio	ministˈerjo
sede	sˈede
equipo	ekwˈipo
schouder	st͡ʃowdˈer
limpieza	limpjˈeza
Saliña	salˈiɲa
lasonan	lasˈonan
determinacion	determinasjˈoŋ
KLM	kˌaˌɛlˈɛm
oportuno	oportˈuno
Respaldo	respˈaldo
director	direktˈor
VO	vˈo
site	sˈite
lokaalnan	lokˈaːlnan
patruyahe	patrujˈahe
diabetes	djabetˈes
aplicable	aplikˈable
completamente	kompletamˈente
ABV	ˈabv
politico	politˈiko
custuma	kustˈuma
aplica	aplˈika
Hecho	hˈet͡ʃo
Gemeente	xemˈeːnte
Paraguana	paraɡwˈana
exacto	eksˈakto
desaroya	desarˈoja
september	septembˈer
reemplasa	reːmplˈasa
luga	lˈuɡa
constelacion	konstelasjˈoŋ
Libertador	libertadˈor
akinan	akˈinan
informando	informˈando
splike	splˈike
dimas	dimˈas
panort	panˈort
panorama	panorˈama
CEA	sˈea
basha	bˈaʃa
machine	mat͡ʃˈine
color	kolˈor
lantando	lantˈando
Golfo	ɡˈolfo
inunda	inˈunda
Quality	kwalˈiti
sorto	sˈorto
Cuanto	kwˈanto
Fast	fˈast
concurso	konkˈurso
animal	animˈal
ensera	ensˈera
acera	asˈera
luznan	lˈuznan
Recien	resjˈeŋ
oportunidad	oportunidˈad
localiza	lokalˈiza
procedente	prosedˈente
lugarnan	luɡˈarnan
medicamento	medikamˈento
hulp	hˈulp
promove	promˈove
asegurado	aseɡurˈado
AM	ˈam
talves	talvˈes
expande	ekspˈande
kizas	kizˈas
excusa	ekskˈusa
freezer	freːzˈer
Slachtofferhulp	slat͡ʃtofferhˈulp
RdA	ˌɛrdˈeˈa
Hoo	hˈoː
destinacion	destinasjˈoŋ
independencia	independˈensja
ley	lˈej
Bosman	bosmˈaŋ
botonan	botˈonan
SIMAR	simˈar
tarea	tarˈea
Schiphol	st͡ʃiphˈol
miseria	misˈerja
raiz	rˈa͡ɪz
ingresonan	inɡresˈonan
secretario	sekretˈarjo
DOW	dˈow
Cruises	krujsˈes
Shark	ʃˈark
asintomatico	asintomatˈiko
profesionalismo	profesjonalˈismo
Suzuki	suzˈuki
boso	bˈoso
cuminza	kumˈinza
dañonan	daɲˈonan
tranca	trˈanka
auxilio	auksˈiljo
Principalmente	prinsipalmˈente
Richardson	rit͡ʃardsˈoŋ
rond	rˈond
careda	karˈeda
Trabou	trabˈow
Mitsubishi	mitsubˈiʃi
bonus	bonˈus
huespednan	hwespˈednan
Cali	kˈali
Hall	hˈall
descansa	deskˈansa
Pero	pˈero
invitado	invitˈado
Cierto	sjˈerto
cuminzamento	kuminzamˈento
compensacion	kompensasjˈoŋ
prudente	prudˈente
suave	swˈave
dentista	dentˈista
aresto	arˈesto
bebi	bˈebi
Gloria	ɡlˈorja
check	t͡ʃˈekk
bo	bˈo
atendiendo	atendjˈendo
mobiliza	mobilˈiza
Jose	jˈose
cuminda	kumˈinda
professional	professjonˈal
ta	tˈa
ganashi	ɡanˈaʃi
programanan	proɡramˈanan
anual	anwˈal
resona	resˈona
Raad	rˈaːd
invadi	invˈadi
velocidad	velosidˈad
momento	momˈento
Man	mˈaŋ
victoria	viktˈorja
Britania	britˈanja
British	britˈiʃ
anuncia	anˈunsja
gobernante	ɡobernˈante
sacamento	sakamˈento
mata	mˈata
hurista	hurˈista
aventura	aventˈura
Relacionista	relasjonˈista
concreto	konkrˈeto
amienda	amjˈenda
opera	opˈera
splika	splˈika
obtene	obtˈene
inhumano	inhumˈano
canta	kˈanta
reservanan	reservˈanan
net	nˈet
eigenlijk	e͡ɪxenlˈe͡ɪk
Sevinger	sevinxˈer
Vista	vˈista
studia	stˈudja
Eagle	eˈaɡle
divisas	divisˈas
controlando	kontrolˈando
caya	kˈaja
fianza	fjˈanza
fayo	fˈajo
Públiko	pˈubliko
necesidad	nesesidˈad
Nederlandse	nederlˈandse
Kas	kˈas
doñonan	doɲˈonan
Creek	krˈeːk
Argus	arɡˈus
League	leˈaɡe
ambulance	ambulˈanse
graduado	ɡradwˈado
lid	lˈid
conteo	kontˈeo
Ocean	oseˈaŋ
Academy	akadˈemi
hera	hˈera
resiliente	resiljˈente
Irausquin	irauskwˈiŋ
Defensor	defensˈor
sembra	sˈembra
van	vˈaŋ
Salario	salˈarjo
MB	ˌɛmbˈe
regular	reɡulˈar
labora	labˈora
positive	positˈive
maritimo	maritˈimo
renobacion	renobasjˈoŋ
ocupa	okˈupa
Diagnostico	djaɡnostˈiko
Wayaca	wajˈaka
Afortunadamente	afortunadamˈente
bolter	boltˈer
Sagicor	saxikˈor
Rusia	rˈusja
December	desembˈer
herido	herˈido
Post	pˈost
politiconan	politikˈonan
wardanan	wardˈanan
Picanto	pikˈanto
Y	iɡrˈɛk
spierta	spjˈerta
firma	fˈirma
Edgard	edɡˈard
ELMAR	elmˈar
Dialogo	djalˈoɡo
MANA	mˈana
Task	tˈask
salon	salˈoŋ
belasting	belastˈinɡ
pago	pˈaɡo
Onderwijs	onderwˈe͡ɪs
interior	interjˈor
worry	wˈorri
Awa	ˈawa
Merca	mˈerka
DE	dˈe
exposicion	eksposisjˈoŋ
legalmente	leɡalmˈente
Corsow	korsˈow
desaster	desastˈer
confirmacion	konfirmasjˈoŋ
deseo	desˈeo
LIVE	lˈive
uza	ˈuza
conscientemente	konssjentemˈente
audiencia	audjˈensja
Rampen	rampˈeŋ
Garage	ɡarˈaxe
Contabilidad	kontabilidˈad
Curason	kurasˈoŋ
verf	vˈerf
rudia	rˈudja
cinco	sˈinko
Trahadonan	trahadˈonan
turtuga	turtˈuɡa
whatsapp	whatsˈapp
solido	solˈido
casamento	kasamˈento
Loves	lovˈes
RAIZ	rˈa͡ɪz
foi	fˈoj
FPNM	ˌɛfpˌeˌɛnˈɛm
splicacion	splikasjˈoŋ
cellular	sellulˈar
haciendo	hasjˈendo
Centre	sˈentre
Odillia	odˈillja
voz	vˈoz
corantnan	korˈantnan
proteina	protˈe͡ɪna
talentonan	talentˈonan
producto	prodˈukto
mondmasker	mondmaskˈer
Tormenta	tormˈenta
intermediacion	intermedjasjˈoŋ
cunukeronan	kunukerˈonan
Antiano	antjˈano
fia	fjˈa
su	sˈu
positivamente	positivamˈente
colaboracion	kolaborasjˈoŋ
publica	publˈika
Gobierno	ɡobjˈerno
Masha	mˈaʃa
talento	talˈento
causando	kausˈando
Recurso	rekˈurso
Cliente	kljˈente
criminalidad	kriminalidˈad
presta	prˈesta
y	iɡrˈɛk
Mario	mˈarjo
Lucia	lˈusja
custumbra	kustˈumbra
lancer	lansˈer
Kico	kˈiko
UNICEF	unisˈef
educacion	edukasjˈoŋ
consciente	konssjˈente
brainstorm	bra͡ɪnstˈorm
cent	sˈent
toch	tˈot͡ʃ
Faro	fˈaro
bleki	blˈeki
Boto	bˈoto
anonimo	anonˈimo
Conforme	konfˈorme
polis	polˈis
Pashent	paʃˈent
procesamento	prosesamˈento
sinembargo	sinembˈarɡo
absolutamente	absolutamˈente
KOR	kˈor
externo	ekstˈerno
Vice	vˈise
Life	lˈife
Algemene	alxemˈene
Mando	mˈando
recien	resjˈeŋ
costumbra	kostˈumbra
front	frˈont
Cu	kˈu
smart	smˈart
CUA	kwˈa
costanan	kostˈanan
natal	natˈal
bos	bˈos
barnan	bˈarnan
Examen	eksamˈeŋ
october	oktobˈer
Comerciante	komersjˈante
simbolo	simbˈolo
desgracia	desɡrˈasja
frena	frˈena
hende	hˈende
pusha	pˈuʃa
Frances	fransˈes
hamas	hamˈas
CDA	kdˈa
aporte	apˈorte
fenomeno	fenomˈeno
global	ɡlobˈal
Breaking	breakˈinɡ
luna	lˈuna
interumpi	interˈumpi
Anselmo	ansˈelmo
AIDS	ˈa͡ɪds
center	sentˈer
Hoben	hobˈeŋ
trece	trˈese
hibe	hˈibe
exclui	eksklˈuj
patruya	patrˈuja
sintie	sˈintje
Alexander	aleksandˈer
RCA	rkˈa
encuestanan	enkwestˈanan
pan	pˈaŋ
Spaans	spˈaːns
Abogado	aboɡˈado
Via	vjˈa
rapidez	rapidˈez
Traveler	travelˈer
Drs	dˌeˌɛrˈɛs
proyectonan	projektˈonan
sistemanan	sistemˈanan
dia	djˈa
team	teˈam
coreccion	koreksjˈoŋ
reactiva	reaktˈiva
entendimento	entendimˈento
capaz	kapˈaz
pruebanan	prwebˈanan
Republica	republˈika
conrector	konrektˈor
dosnan	dˈosnan
escohi	eskˈohi
negosacion	neɡosasjˈoŋ
placa	plˈaka
reportahe	reportˈahe
enfermeronan	enfermerˈonan
pasco	pˈasko
isolacion	isolasjˈoŋ
plataformanan	plataformˈanan
codering	koderˈinɡ
proposicion	proposisjˈoŋ
renovacion	renovasjˈoŋ
awanan	awˈanan
Signs	sˈiɡns
menase	menˈase
taxista	taksˈista
Casi	kˈasi
colga	kˈolɡa
recupera	rekupˈera
MC	ˌɛmsˈe
envez	envˈez
Muhe	mˈuhe
triage	trjˈaxe
nacionalidad	nasjonalidˈad
Carlos	karlˈos
modera	modˈera
sistema	sistˈema
texto	tˈeksto
propiedadnan	propjedˈadnan
bek	bˈek
Fundacion	fundasjˈoŋ
balor	balˈor
mental	mentˈal
Yuda	jˈuda
vandalismo	vandalˈismo
Valdez	valdˈez
finalmente	finalmˈente
evidencia	evidˈensja
fenomenal	fenomenˈal
representantenan	representantˈenan
diabetico	djabetˈiko
fiscal	fiskˈal
Juni	jˈuni
Sanders	sandˈers
Sin	sˈiŋ
verbal	verbˈal
Aressa	arˈessa
obstante	obstˈante
Departamento	departamˈento
bou	bˈow
integral	inteɡrˈal
Palace	palˈase
magnitud	maɡnitˈud
unicamente	unikamˈente
actitud	aktitˈud
docente	dosˈente
divisa	divˈisa
strena	strˈena
funcionando	funsjonˈando
inversion	inversjˈoŋ
artistico	artistˈiko
TOPA	tˈopa
etapa	etˈapa
finanzas	finanzˈas
Amigo	amˈiɡo
news	nˈews
awa	ˈawa
indirecto	indirˈekto
hinke	hˈinke
creacion	kreasjˈoŋ
intencional	intensjonˈal
Diego	djˈeɡo
faha	fˈaha
mensual	menswˈal
Florin	florˈiŋ
Quota	kwˈota
Aunke	aˈunke
bieu	bjˈew
contract	kontrˈakt
charla	t͡ʃˈarla
Ministerial	ministerjˈal
autonomo	autonˈomo
inauguracion	inauɡurasjˈoŋ
nulo	nˈulo
sernan	sˈernan
severo	sevˈero
emailadres	ema͡ɪladrˈes
Lamentablemente	lamentablemˈente
Bestuurskantoor	bestyrskantˈoːr
optimalisa	optimalˈisa
crecimento	kresimˈento
generacion	xenerasjˈoŋ
cocolishi	kokolˈiʃi
remarka	remˈarka
atraca	atrˈaka
Chauffeur	t͡ʃauffˈewr
municipio	munisˈipjo
Marine	marˈine
prevalece	prevalˈese
discusion	diskusjˈoŋ
winstbelasting	winstbelastˈinɡ
agradable	aɡradˈable
Conducta	kondˈukta
HTC	hˌatˌesˈe
diversificacion	diversifikasjˈoŋ
Bo	bˈo
Nisbet	nisbˈet
alaves	alavˈes
BFTO	bftˈo
periodismo	perjodˈismo
organizacionnan	orɡanizasjˈonnan
ana	ˈana
Ningun	ninɡˈuŋ
sanger	sanxˈer
treci	trˈesi
SSA	ssˈa
Manera	manˈera
priminti	primˈinti
negoshinan	neɡoʃˈinan
Electoral	elektorˈal
Andres	andrˈes
epidemia	epidˈemja
original	orixinˈal
positivo	positˈivo
Desk	dˈesk
dunado	dunˈado
telefonicamente	telefonikamˈente
peligroso	peliɡrˈoso
eventualidad	eventwalidˈad
autonan	autˈonan
fiho	fˈiho
Europeo	ewropˈeo
nochi	nˈot͡ʃi
Spaño	spˈaɲo
aparte	apˈarte
per	pˈer
OC	ˈok
cluster	klustˈer
cuminsando	kuminsˈando
Josephine	josephˈine
aanwijzing	aːnwe͡ɪzˈinɡ
lucha	lˈut͡ʃa
voluntario	voluntˈarjo
haltura	haltˈura
pedofilnan	pedofˈilnan
compilacion	kompilasjˈoŋ
fumiga	fumˈiɡa
biodiversidad	bjodiversidˈad
biba	bˈiba
cama	kˈama
adulto	adˈulto
Esun	esˈuŋ
Antia	ˈantja
Lions	ljˈons
precaucion	prekausjˈoŋ
maske	mˈaske
relato	relˈato
venidero	venidˈero
desperdicio	desperdˈisjo
Hyatt	hjˈatt
calculacionnan	kalkulasjˈonnan
Scientology	ssjentolˈoxi
Sindicato	sindikˈato
converti	konvˈerti
melding	meldˈinɡ
vooral	voːrˈal
Sasakiweg	sasakiwˈeɡ
mentira	mentˈira
thru	thrˈu
organisando	orɡanisˈando
Authority	authorˈiti
naar	nˈaːr
leve	lˈeve
Entre	ˈentre
Mental	mentˈal
normalidad	normalidˈad
King	kˈinɡ
kaso	kˈaso
reservacion	reservasjˈoŋ
embargo	embˈarɡo
provincia	provˈinsja
International	internatjonˈal
Hogeschool	hoxest͡ʃˈoːl
toxico	toksˈiko
credito	kredˈito
codigo	kodˈiɡo
soluciona	solusjˈona
Cuentanan	kwentˈanan
Region	rexjˈoŋ
centenares	sentenarˈes
Rolando	rolˈando
set	sˈet
misa	mˈisa
sub	sˈub
Antonio	antˈonjo
Harms	hˈarms
hasi	hˈasi
sindical	sindikˈal
Booshi	bˈoːʃi
aloca	alˈoka
debido	debˈido
plantamento	plantamˈento
innova	innˈova
habitantenan	habitantˈenan
desastre	desˈastre
plazo	plˈazo
Zaken	zakˈeŋ
elogio	elˈoxjo
contratistanan	kontratistˈanan
pidie	pˈidje
restart	restˈart
Florida	florˈida
sumanan	sumˈanan
Orde	ˈorde
YMCA	ˈimka
fabrica	fabrˈika
invita	invˈita
caso	kˈaso
Santana	santˈana
Oduber	odubˈer
bandera	bandˈera
AB	ˈab
Finanzas	finanzˈas
internacional	internasjonˈal
Bogota	boɡˈota
sake	sˈake
op	ˈop
honra	hˈonra
Pedagogico	pedaɡoxˈiko
dama	dˈama
Mucho	mˈut͡ʃo
Daño	dˈaɲo
Hof	hˈof
mediano	medjˈano
Wil	wˈil
contamina	kontamˈina
culmina	kulmˈina
unico	unˈiko
vanguardia	vanɡwˈardja
studio	stˈudjo
alentador	alentadˈor
Alan	alˈaŋ
tipo	tˈipo
Presente	presˈente
Anne	ˈanne
experencianan	eksperensjˈanan
industria	indˈustrja
Wyatt	wjˈatt
Cumpra	kˈumpra
yuda	jˈuda
horcannan	horkˈannan
significa	siɡnifˈika
normalmente	normalmˈente
sospechoso	sospet͡ʃˈoso
Resorts	resˈorts
sintonisa	sintonˈisa
Koolman	koːlmˈaŋ
Ohala	ohˈala
inversionista	inversjonˈista
inmoral	inmorˈal
Action	aktjˈoŋ
cognitivo	koɡnitˈivo
tire	tˈire
aun	aˈuŋ
posibilidad	posibilidˈad
Kaya	kˈaja
ATV	ˈatv
humilde	humˈilde
inmunidad	inmunidˈad
planifica	planifˈika
CFT	sˌeˌɛftˈe
mitar	mitˈar
Biden	bidˈeŋ
DNM	dˌeˌɛnˈɛm
porcentahe	porsentˈahe
Belgica	belxˈika
berdura	berdˈura
pareha	parˈeha
average	averˈaxe
loke	lˈoke
Hogarnan	hoɡˈarnan
alimentacion	alimentasjˈoŋ
handsanitizer	handsanitizˈer
estrictamente	estriktamˈente
accidenta	aksidˈenta
estadisticanan	estadistikˈanan
licencia	lisˈensja
SVB	ˌɛsvˌebˈe
orientacion	orjentasjˈoŋ
cruz	krˈuz
stem	stˈem
nada	nˈada
inhusticia	inhustˈisja
US	ˈus
house	hˈowse
inseguridad	inseɡuridˈad
Chile	t͡ʃˈile
otorga	otˈorɡa
Awg	ˈawɡ
musiconan	musikˈonan
esfuerzonan	esfwerzˈonan
suzuki	suzˈuki
Bond	bˈond
preserva	presˈerva
dificultad	difikultˈad
miyon	mijˈoŋ
Saba	sˈaba
torneo	tornˈeo
efectivo	efektˈivo
Rene	rˈene
pasion	pasjˈoŋ
documentario	dokumentˈarjo
blaas	blˈaːs
scoge	skˈoxe
apenas	apenˈas
preocupante	preokupˈante
jeans	jeˈans
lineanan	lineˈanan
ehercicionan	ehersisjˈonan
sunchi	sˈunt͡ʃi
biahenan	bjahˈenan
kies	kjˈes
rand	rˈand
Contraloria	kontralˈorja
coriendo	korjˈendo
ingreso	inɡrˈeso
presupuesta	presupwˈesta
optimista	optimˈista
vehiculo	vehikˈulo
gastonan	ɡastˈonan
Tromp	trˈomp
fruta	frˈuta
imponi	impˈoni
alcohol	alkohˈol
Stef	stˈef
Representantenan	representantˈenan
amante	amˈante
november	novembˈer
caracter	karaktˈer
desicionnan	desisjˈonnan
comentarionan	komentarjˈonan
Categoria	kateɡˈorja
fayonan	fajˈonan
comandante	komandˈante
instiga	instˈiɡa
esfuersonan	esfwersˈonan
management	manaxemˈent
beachnan	beˈat͡ʃnan
jong	jˈonɡ
Instituto	institˈuto
poni	pˈoni
vulnerabel	vulnerabˈel
tiramento	tiramˈento
disponibilidad	disponibilidˈad
bela	bˈela
Kwartaal	kwartˈaːl
experticio	ekspertˈisjo
estudionan	estudjˈonan
eventonan	eventˈonan
EU	ˈew
Incluso	inklˈuso
Exterior	eksterjˈor
ciudadnan	sjudˈadnan
bin	bˈiŋ
Accidente	aksidˈente
Presidente	presidˈente
Israel	israˈel
cortina	kortˈina
moral	morˈal
sucesonan	susesˈonan
rectifica	rektifˈika
heroenan	herˈunan
Virgin	virxˈiŋ
contexto	kontˈeksto
bon	bˈoŋ
Ken	kˈeŋ
En	ˈeŋ
deduci	dedˈusi
spera	spˈera
raport	rapˈort
plaso	plˈaso
ofrece	ofrˈese
interna	intˈerna
envelope	envelˈope
destrui	destrˈuj
contractnan	kontrˈaktnan
pasamento	pasamˈento
Hitler	hitlˈer
dentro	dˈentro
conforme	konfˈorme
mantenimento	mantenimˈento
Financial	finansjˈal
vangrail	vanɡrˈa͡ɪl
procedura	prosedˈura
basta	bˈasta
piesa	pjˈesa
medionan	medjˈonan
Mark	mˈark
basicamente	basikamˈente
januari	janwˈari
traicion	tra͡ɪsjˈoŋ
hustifica	hustifˈika
account	akkˈownt
Alto	ˈalto
snacks	snˈakks
exigiendo	eksixjˈendo
LLC	ˌɛlˌɛlsˈe
structura	struktˈura
fragil	fraxˈil
ASF	ˈasf
Esey	esˈej
circulacion	sirkulasjˈoŋ
componentenan	komponentˈenan
fracaso	frakˈaso
escogencia	eskoxˈensja
Asamblea	asamblˈea
Sigui	sˈiɡj
aunke	aˈunke
portanan	portˈanan
work	wˈork
recibo	resˈibo
plan	plˈaŋ
anticua	antˈikwa
enfermero	enfermˈero
Nast	nˈast
merece	merˈese
Prensa	prˈensa
consulta	konsˈulta
sindicalista	sindikalˈista
Milieu	miljˈew
satisfaccion	satisfaksjˈoŋ
FCCA	fkkˈa
Ley	lˈej
desconocinan	deskonosˈinan
IBISA	ibˈisa
judicial	judisjˈal
tardi	tˈardi
Aviacion	avjasjˈoŋ
publicamente	publikamˈente
Hudicial	hudisjˈal
atraccion	atraksjˈoŋ
duradero	duradˈero
Romero	romˈero
fayece	fajˈese
Mas	mˈas
reforza	refˈorza
Consensus	konsensˈus
Publico	publˈiko
informe	infˈorme
Halloween	hallowˈeːŋ
CPI	kpˈi
fantasma	fantˈasma
comete	komˈete
al	ˈal
pa	pˈa
Christmas	t͡ʃristmˈas
Henny	hˈenni
compra	kˈompra
Lottery	lottˈeri
pasonan	pasˈonan
WVB	wˌevˌebˈe
sali	sˈali
enfermo	enfˈermo
admiti	admˈiti
Manager	manaxˈer
directornan	direktˈornan
suficiente	sufisjˈente
libra	lˈibra
dedicacion	dedikasjˈoŋ
promé	promˈe
legado	leɡˈado
dispone	dispˈone
barata	barˈata
barrio	bˈarrjo
intento	intˈento
denuncia	denˈunsja
buelta	bwˈelta
Ciencia	sjˈensja
gracia	ɡrˈasja
aviacion	avjasjˈoŋ
bunita	bunˈita
felicidad	felisidˈad
impacto	impˈakto
sigui	sˈiɡj
Roma	rˈoma
Fort	fˈort
alcanza	alkˈanza
hortando	hortˈando
policlinica	poliklinˈika
peso	pˈeso
consistente	konsistˈente
nietonan	njetˈonan
higiena	hixjˈena
LVV	ˌɛlvˌevˈe
USA	ˈusa
Preguntanan	preɡuntˈanan
spirito	spirˈito
diariamente	djarjamˈente
keto	kˈeto
rumbo	rˈumbo
shete	ʃˈete
adictonan	adiktˈonan
Cuminsando	kuminsˈando
constantemente	konstantemˈente
Triple	trˈiple
abogadonan	aboɡadˈonan
bai	bˈa͡ɪ
Hofi	hˈofi
brinda	brˈinda
respetando	respetˈando
Eddy	ˈeddi
resto	rˈesto
Cafe	kˈafe
machete	mat͡ʃˈete
Legislation	lexislatjˈoŋ
nenga	nˈenɡa
Pita	pˈita
ingrediente	inɡredjˈente
Week	wˈeːk
nocturno	noktˈurno
atraves	atravˈes
upgrade	upɡrˈade
funcionarionan	funsjonarjˈonan
empleadonan	empleadˈonan
flexibilisacion	fleksibilisasjˈoŋ
Hulanda	hulˈanda
Penha	pˈenha
uso	ˈuso
for	fˈor
orden	ordˈeŋ
directamente	direktamˈente
romantico	romantˈiko
CHE	t͡ʃˈe
auxiliar	auksiljˈar
batata	batˈata
Organizacion	orɡanizasjˈoŋ
plasma	plˈasma
ehecucion	ehekusjˈoŋ
diagnostica	djaɡnostˈika
busca	bˈuska
referendum	referendˈum
reserva	resˈerva
celebrando	selebrˈando
Psicologo	psikolˈoɡo
ticket	tikkˈet
tempu	tˈempu
alcance	alkˈanse
recomenda	rekomˈenda
Helpdesk	helpdˈesk
docentenan	dosentˈenan
tiki	tˈiki
Decision	desisjˈoŋ
inmunologico	inmunoloxˈiko
pronto	prˈonto
tips	tˈips
CENSO	sˈenso
turista	turˈista
individual	individwˈal
espera	espˈera
DAS	dˈas
rol	rˈol
hardware	hardwˈare
Patrishi	patrˈiʃi
Armando	armˈando
corolla	korˈolla
comprometi	kompromˈeti
desinfectante	desinfektˈante
basa	bˈasa
medicinal	medisinˈal
interino	interˈino
Wilhelmina	wilhelmˈina
lamentable	lamentˈable
Bomberonan	bomberˈonan
Meiveld	me͡ɪvˈeld
Dogcatcher	doɡkatt͡ʃˈer
seccion	seksjˈoŋ
skol	skˈol
economicamente	ekonomikamˈente
Casinonan	kasinˈonan
Bingo	bˈinɡo
Diasabra	djasˈabra
bringando	brinɡˈando
ingles	inɡlˈes
Administracion	administrasjˈoŋ
OCTA	ˈokta
movecionnan	movesjˈonnan
climatico	klimatˈiko
scur	skˈur
Vicente	visˈente
Tapaboca	tapabˈoka
Porfin	porfˈiŋ
rijbewijs	re͡ɪbewˈe͡ɪs
atene	atˈene
Colegio	kolˈexjo
medida	medˈida
tombola	tombˈola
Enseñanza	enseɲˈanza
Pontilius	pontiljˈus
uno	ˈuno
termino	termˈino
Blok	blˈok
rekeri	rekˈeri
Baho	bˈaho
metanan	metˈanan
permanente	permanˈente
penoso	penˈoso
super	supˈer
Kiko	kˈiko
recuperando	rekuperˈando
Representante	representˈante
cu	kˈu
Pelican	pelikˈaŋ
habon	habˈoŋ
manera	manˈera
aleha	alˈeha
Dificultad	difikultˈad
Edad	edˈad
ilustra	ilˈustra
debi	dˈebi
Pereira	perˈe͡ɪra
iniciativa	inisjatˈiva
pida	pˈida
Liliana	liljˈana
Petronia	petrˈonja
Farro	fˈarro
Sra	srˈa
niester	njestˈer
Surinam	surinˈam
recomendacion	rekomendasjˈoŋ
turistico	turistˈiko
potencial	potensjˈal
Influenza	inflwˈenza
noticianan	notisjˈanan
supuesto	supwˈesto
interesado	interesˈado
hanchi	hˈant͡ʃi
fatal	fatˈal
Art	ˈart
pobresa	pobrˈesa
catolico	katolˈiko
mei	mˈe͡ɪ
comedia	komˈedja
enfrente	enfrˈente
Gumbs	ɡˈumbs
hyundai	hjˈunda͡ɪ
California	kalifˈornja
malesa	malˈesa
hospitalnan	hospitˈalnan
causante	kausˈante
as	ˈas
bomberonan	bomberˈonan
enfasis	enfasˈis
man	mˈaŋ
Artificial	artifisjˈal
tesis	tesˈis
sobrepeso	sobrepˈeso
Grandi	ɡrˈandi
vision	visjˈoŋ
meymey	mejmˈej
Group	ɡrˈowp
joyas	jojˈas
E	ˈe
enfoca	enfˈoka
Redaccion	redaksjˈoŋ
pedagogico	pedaɡoxˈiko
duro	dˈuro
aeropuerto	aeropwˈerto
cel	sˈel
lockdown	lokkdˈowŋ
negosha	neɡˈoʃa
canabis	kanabˈis
articulo	artikˈulo
habriendo	habrjˈendo
VIP	vˈip
libertad	libertˈad
Ami	ˈami
ei	ˈe͡ɪ
condicional	kondisjonˈal
Orden	ordˈeŋ
gewoon	xewˈoːŋ
accionnan	aksjˈonnan
reconocemento	rekonosemˈento
bisiñanan	bisiɲˈanan
onderzoek	onderzˈuk
noordwest	noːrdwˈest
Biblioteca	bibljotˈeka
charter	t͡ʃartˈer
parkinglot	parkinɡlˈot
brommer	brommˈer
musca	mˈuska
hoben	hobˈeŋ
cartera	kartˈera
Luydens	lujdˈens
moviendo	movjˈendo
conserva	konsˈerva
taxi	tˈaksi
sonido	sonˈido
saconan	sakˈonan
alto	ˈalto
ambos	ambˈos
miyones	mijonˈes
Sali	sˈali
II	dˈos
Conseho	konsˈeho
ARA	ˈara
diversidad	diversidˈad
pega	pˈeɡa
cashi	kˈaʃi
cercania	serkˈanja
palabracion	palabrasjˈoŋ
mandatario	mandatˈarjo
stabilisa	stabilˈisa
Fuera	fwˈera
salarionan	salarjˈonan
rotonde	rotˈonde
Museum	musˈewm
fluho	flˈuho
sumo	sˈumo
loco	lˈoko
compromiso	kompromˈiso
obheto	obhˈeto
Team	teˈam
d	dˈe
tin	tˈiŋ
keha	kˈeha
Bario	bˈarjo
traductor	traduktˈor
Barconan	barkˈonan
Luna	lˈuna
bicicleta	bisiklˈeta
Atraco	atrˈako
bishitanan	biʃitˈanan
seca	sˈeka
Lucky	lˈukki
Basta	bˈasta
motorisa	motorˈisa
canando	kanˈando
esfuerso	esfwˈerso
direct	dirˈekt
bofon	bofˈoŋ
tormenta	tormˈenta
barcode	barkˈode
planta	plˈanta
convenio	konvˈenjo
piscado	piskˈado
siete	sjˈete
causa	kaˈusa
Melvin	melvˈiŋ
equiponan	ekwipˈonan
atento	atˈento
RFT	ˌɛrˌɛftˈe
miya	mˈija
brote	brˈote
di	dˈi
agricultura	aɡrikultˈura
formula	formˈula
sugeri	suxˈeri
Sport	spˈort
Meneer	menˈeːr
pier	pjˈer
September	septembˈer
Horeca	horˈeka
sanitizers	sanitizˈers
Incinerator	insineratˈor
cordialidad	kordjalidˈad
business	businˈess
Village	villˈaxe
beschikking	best͡ʃikkˈinɡ
Famianan	famjˈanan
lokaal	lokˈaːl
Frank	frˈank
afecta	afˈekta
candidato	kandidˈato
paro	pˈaro
horor	horˈor
orguyoso	orɡjˈoso
dental	dentˈal
financiero	finansjˈero
interaccion	interaksjˈoŋ
transmision	transmisjˈoŋ
Quanten	kwantˈeŋ
ONU	ˈonu
QUEDA	kwˈeda
Chavez	t͡ʃavˈez
Fonds	fˈonds
sanitario	sanitˈarjo
Barbados	barbadˈos
censo	sˈenso
Vanessa	vanˈessa
Special	spesjˈal
hancra	hˈankra
BCMS	bˌesˌeˌɛmˈɛs
Arends	arˈends
musica	musˈika
mondkapjes	mondkapjˈes
project	projˈekt
Pos	pˈos
DEZHI	dˈezhi
indicenan	indisˈenan
hotel	hotˈel
Amsterdam	amsterdˈam
bira	bˈira
dramatico	dramatˈiko
confisca	konfˈiska
wela	wˈela
buska	bˈuska
Jessica	jessˈika
cancionnan	kansjˈonnan
autismo	autˈismo
Glenda	ɡlˈenda
waya	wˈaja
en	ˈeŋ
combati	kombˈati
trahado	trahˈado
honesto	honˈesto
to	tˈo
Meijer	me͡ɪjˈer
oficialmente	ofisjalmˈente
sercania	serkˈanja
risico	risˈiko
Januari	janwˈari
envolvimento	envolvimˈento
mishi	mˈiʃi
comosifuera	komosifwˈera
hunta	hˈunta
comercial	komersjˈal
Service	servˈise
deteriora	deterjˈora
simultaneamente	simultaneamˈente
coordinador	koːrdinadˈor
Marketing	marketˈinɡ
unidat	unidˈat
scuridad	skuridˈad
DIMP	dˈimp
Exprodesk	eksprodˈesk
tranche	trˈant͡ʃe
manehador	manehadˈor
a	ˈa
Zoom	zˈoːm
stacion	stasjˈoŋ
Akinan	akˈinan
parse	pˈarse
perdi	pˈerdi
raporta	rapˈorta
averahe	averˈahe
embahador	embahadˈor
Cultura	kultˈura
desigualdad	desiɡwaldˈad
utilidad	utilidˈad
Poder	podˈer
Truck	trˈukk
contestanan	kontestˈanan
propagacion	propaɡasjˈoŋ
esakinan	esakˈinan
Sallestraat	sallestrˈaːt
dicon	dikˈoŋ
complica	komplˈika
cuarentena	kwarentˈena
tira	tˈira
Quandt	kwˈandt
kiko	kˈiko
Hoek	hˈuk
presenta	presˈenta
plat	plˈat
Boneiro	bonˈe͡ɪro
adecuadamente	adekwadamˈente
David	davˈid
Panama	panˈama
edificio	edifˈisjo
deliberando	deliberˈando
inspeccion	inspeksjˈoŋ
responsabilidadnan	responsabilidˈadnan
ecosistema	ekosistˈema
averigua	averˈiɡwa
prioridadnan	prjoridˈadnan
custumbernan	kustumbˈernan
esfuerzo	esfwˈerzo
Fraccion	fraksjˈoŋ
parha	pˈarha
likidez	likidˈez
imposible	imposˈible
lastimamente	lastimamˈente
digitalmente	dixitalmˈente
Regis	rexˈis
deleita	delˈe͡ɪta
peligro	pelˈiɡro
boluntarionan	boluntarjˈonan
solicitante	solisitˈante
concientiza	konsjentˈiza
Master	mastˈer
dirigente	dirixˈente
verifica	verifˈika
precisamente	presisamˈente
tristesa	tristˈesa
tabel	tabˈel
AZV	ˈazv
Fin	fˈiŋ
sacando	sakˈando
BCA	bkˈa
ter	tˈer
cerebro	serˈebro
Choudhry	t͡ʃˈowdhri
chikitonan	t͡ʃikitˈonan
infeccion	infeksjˈoŋ
pension	pensjˈoŋ
muy	mˈuj
oido	ˈojdo
investiga	investˈiɡa
cortamento	kortamˈento
Botica	botˈika
ariba	arˈiba
Stella	stˈella
parcialmente	parsjalmˈente
Posiblemente	posiblemˈente
Tobago	tobˈaɡo
bankinan	bankˈinan
logrando	loɡrˈando
eyden	ejdˈeŋ
in	ˈiŋ
substancianan	substansjˈanan
bordo	bˈordo
Tene	tˈene
Festival	festivˈal
comunidad	komunidˈad
Pasobra	pasˈobra
Kooyman	koːjmˈaŋ
banana	banˈana
No	nˈo
coalicion	koalisjˈoŋ
Carnaval	karnavˈal
alergia	alˈerxja
daña	dˈaɲa
Muher	muhˈer
apto	ˈapto
crucero	krusˈero
Koningin	koninxˈiŋ
economia	ekonˈomja
bestuurskantoor	bestyrskantˈoːr
apunta	apˈunta
insigur	insiɡˈur
sosodiendo	sosodjˈendo
Asistencia	asistˈensja
integra	intˈeɡra
luchador	lut͡ʃadˈor
fomenta	fomˈenta
resistente	resistˈente
William	willjˈam
duracion	durasjˈoŋ
valido	valˈido
frecuente	frekwˈente
transport	transpˈort
confronta	konfrˈonta
coi	kˈoj
an	ˈaŋ
BAZV	bˈazv
flexibel	fleksibˈel
dunabo	dunˈabo
Brown	brˈowŋ
constante	konstˈante
Anti	ˈanti
monumento	monumˈento
amputacion	amputasjˈoŋ
nucleo	nuklˈeo
combersacionnan	kombersasjˈonnan
electronicamente	elektronikamˈente
Jet	jˈet
voto	vˈoto
lease	leˈase
supervision	supervisjˈoŋ
gritonan	ɡritˈonan
colaboradornan	kolaboradˈornan
pisa	pˈisa
plussers	plussˈers
logro	lˈoɡro
College	kollˈexe
drechi	drˈet͡ʃi
forma	fˈorma
Tele	tˈele
uniform	unifˈorm
Kralendijk	kralendˈe͡ɪk
enfrenta	enfrˈenta
Ayo	ˈajo
Pesey	pesˈej
diagnostico	djaɡnostˈiko
malcontento	malkontˈento
Central	sentrˈal
malgasta	malɡˈasta
Anuesca	anwˈeska
CAO	kˈao
campeonato	kampeonˈato
ohala	ohˈala
islanan	islˈanan
controla	kontrˈola
ciclon	siklˈoŋ
pareu	parˈew
Simar	simˈar
cansa	kˈansa
fraccion	fraksjˈoŋ
WiFi	wˈifˈi
proposicionnan	proposisjˈonnan
tembla	tˈembla
testigonan	testiɡˈonan
Andicuri	andikˈuri
Rapportnan	rappˈortnan
parecido	paresˈido
Mirando	mirˈando
oportunidadnan	oportunidˈadnan
berde	bˈerde
ritmo	rˈitmo
tent	tˈent
bay	bˈaj
Colombiano	kolombjˈano
HOH	hˈoh
azota	azˈota
Supervision	supervisjˈoŋ
condicionan	kondisjˈonan
Minimarket	minimarkˈet
descripcion	deskripsjˈoŋ
dos	dˈos
explicitamente	eksplisitamˈente
diputado	diputˈado
protehe	protˈehe
Hernandez	hernandˈez
antes	antˈes
Bolivar	bolivˈar
seco	sˈeko
orario	orˈarjo
final	finˈal
cachonan	kat͡ʃˈonan
delegacion	deleɡasjˈoŋ
habrimento	habrimˈento
destruccion	destruksjˈoŋ
horario	horˈarjo
Biemans	bjemˈans
directivanan	direktivˈanan
abou	abˈow
Page	pˈaxe
glas	ɡlˈas
Subsidio	subsˈidjo
exclusivamente	eksklusivamˈente
rebaho	rebˈaho
webinars	webinˈars
juni	jˈuni
trahando	trahˈando
Oost	ˈoːst
Pandemia	pandˈemja
Rode	rˈode
promesa	promˈesa
fin	fˈiŋ
venezolano	venezolˈano
Algun	alɡˈuŋ
school	st͡ʃˈoːl
cientificonan	sjentifikˈonan
Sahara	sahˈara
responsable	responsˈable
Boluntario	boluntˈarjo
realisacion	realisasjˈoŋ
enfermera	enfermˈera
Testnan	tˈestnan
danki	dˈanki
asalto	asˈalto
dependiendo	dependjˈendo
sintoma	sintˈoma
kaminda	kamˈinda
asilo	asˈilo
kg	kˌaɡˈe
Wak	wˈak
marcanan	markˈanan
participante	partisipˈante
Huez	hwˈez
keho	kˈeho
Haime	hˈa͡ɪme
pandemia	pandˈemja
testimonio	testimˈonjo
huma	hˈuma
regional	rexjonˈal
Lancer	lansˈer
Playa	plˈaja
Junior	junjˈor
fiha	fˈiha
nanishi	nanˈiʃi
AO	ˈao
accident	aksidˈent
principal	prinsipˈal
Reposicionando	reposisjonˈando
Normalmente	normalmˈente
nacional	nasjonˈal
Lopez	lopˈez
fondonan	fondˈonan
reglamenta	reɡlamˈenta
getest	xetˈest
night	nˈiɡht
Lo	lˈo
remarca	remˈarka
pagando	paɡˈando
secuestra	sekwˈestra
bonbini	bonbˈini
structural	strukturˈal
flota	flˈota
estadonan	estadˈonan
barku	bˈarku
yegada	jeɡˈada
perdidanan	perdidˈanan
agradabel	aɡradabˈel
supermarket	supermarkˈet
pic	pˈik
cifranan	sifrˈanan
Beach	beˈat͡ʃ
promocion	promosjˈoŋ
Comerciantenan	komersjantˈenan
inspector	inspektˈor
Compara	kompˈara
internamente	internamˈente
Arubianonan	arubjanˈonan
sabiendo	sabjˈendo
Welcome	welkˈome
Teller	tellˈer
Varios	varjˈos
Stadhuis	stadhˈujs
Martin	martˈiŋ
sostenible	sostenˈible
Global	ɡlobˈal
datos	datˈos
Well	wˈell
hygiene	hixjˈene
frecuencia	frekwˈensja
exclusivo	eksklusˈivo
Nicole	nikˈole
instancia	instˈansja
masculino	maskulˈino
multanan	multˈanan
inversionistanan	inversjonistˈanan
Buena	bwˈena
Elizabeth	elizabˈeth
specifico	spesifˈiko
Port	pˈort
paspoort	paspˈoːrt
contribucion	kontribusjˈoŋ
Miami	mjˈami
Old	ˈold
prestamo	prestˈamo
cortico	kortˈiko
raad	rˈaːd
recuperacion	rekuperasjˈoŋ
restitucion	restitusjˈoŋ
variante	varjˈante
piscina	pissˈina
recreacion	rekreasjˈoŋ
delibera	delibˈera
Avianca	avjˈanka
acercamento	aserkamˈento
Progreso	proɡrˈeso
Ponson	ponsˈoŋ
Aki	ˈaki
ayo	ˈajo
Vivienda	vivjˈenda
SI	sˈi
aplaudi	aplaˈudi
SADA	sˈada
menasanan	menasˈanan
delito	delˈito
existente	eksistˈente
rio	rjˈo
tatanan	tatˈanan
maneha	manˈeha
Patruyanan	patrujˈanan
asunto	asˈunto
popular	populˈar
sucursalnan	sukursˈalnan
Kizas	kizˈas
reconstrui	rekonstrˈuj
trahe	trˈahe
ehecuta	ehekˈuta
Por	pˈor
cea	sˈea
coordinadornan	koːrdinadˈornan
Leynan	lˈejnan
admiracion	admirasjˈoŋ
oferta	ofˈerta
Soca	sˈoka
fam	fˈam
staff	stˈaff
hole	hˈole
alrespecto	alrespˈekto
covid	kovˈid
lesion	lesjˈoŋ
daggeldvergoeding	daɡxeldverɡudˈinɡ
bocht	bˈot͡ʃt
sinceramente	sinseramˈente
Alabes	alabˈes
Dengue	dˈenɡe
IDEA	idˈea
perseverancia	perseverˈansja
gradicimento	ɡradisimˈento
Lion	ljˈoŋ
confrontacion	konfrontasjˈoŋ
Coronavirus	koronavirˈus
menasando	menasˈando
Creando	kreˈando
publicidad	publisidˈad
gym	xˈim
Web	wˈeb
rapido	rapˈido
tene	tˈene
pensamentonan	pensamentˈonan
significativo	siɡnifikatˈivo
coopera	koːpˈera
pio	pjˈo
Branch	brˈant͡ʃ
profesional	profesjonˈal
Edwin	edwˈiŋ
toyota	tojˈota
acudi	akˈudi
refleho	reflˈeho
acusado	akusˈado
militar	militˈar
lanza	lˈanza
indocumenta	indokumˈenta
obligacionnan	obliɡasjˈonnan
tempo	tˈempo
leiding	le͡ɪdˈinɡ
Ponton	pontˈoŋ
Eerste	ˈeːrste
actuacion	aktwasjˈoŋ
Music	musˈik
organizando	orɡanizˈando
re	rˈe
keur	kˈewr
elimina	elimˈina
ecologico	ekoloxˈiko
Turistanan	turistˈanan
Plas	plˈas
incluyendo	inklujˈendo
alavez	alavˈez
bestel	bestˈel
exitosamente	eksitosamˈente
store	stˈore
justicia	justˈisja
lubida	lubˈida
greppel	ɡreppˈel
regularmente	reɡularmˈente
ziek	zjˈek
BZK	bˌezˌɛtkˈa
Eseynan	esˈejnan
Ritz	rˈitz
pick	pˈikk
clase	klˈase
piscadonan	piskadˈonan
Ecuador	ekwadˈor
masterplan	masterplˈaŋ
die	djˈe
free	frˈeː
encarga	enkˈarɡa
Cratz	krˈatz
como	kˈomo
nivelnan	nivˈelnan
coremento	koremˈento
Kennedy	kennˈedi
Aeropuerto	aeropwˈerto
Trigt	trˈiɡt
dal	dˈal
ciencia	sjˈensja
mitad	mitˈad
motorunit	motorunˈit
careteranan	kareterˈanan
sobrebibi	sobrebˈibi
FHMD	ˌɛfhˌaˌɛmdˈe
normalisa	normalˈisa
Chef	t͡ʃˈef
Funeral	funerˈal
preis	prˈe͡ɪs
CableTV	kˈabletˌevˈe
Live	lˈive
lunch	lˈunt͡ʃ
Universidad	universidˈad
damanan	damˈanan
acusacionnan	akusasjˈonnan
minimo	minˈimo
draai	drˈaːj
escenario	essenˈarjo
frontal	frontˈal
projecto	projˈekto
protocolnan	protokˈolnan
ful	fˈul
opinion	opinjˈoŋ
Rina	rˈina
wèpsait	wˈɛpsa͡ɪt
indica	indˈika
circunstancia	sirkunstˈansja
puntonan	puntˈonan
inteligente	intelixˈente
illegal	illeɡˈal
aña	ˈaɲa
escohe	eskˈohe
Angelo	anxˈelo
kas	kˈas
rason	rasˈoŋ
facultad	fakultˈad
edificionan	edifisjˈonan
pista	pˈista
demanda	demˈanda
revista	revˈista
Helder	heldˈer
hunga	hˈunɡa
awor	awˈor
cobransa	kobrˈansa
circumstancia	sirkumstˈansja
critico	kritˈiko
pabao	pabˈao
saliendo	saljˈendo
demasiado	demasjˈado
back	bˈakk
refleha	reflˈeha
specializa	spesjalˈiza
oranan	orˈanan
tubo	tˈubo
gruponan	ɡrupˈonan
satisfactorio	satisfaktˈorjo
ayudo	ajˈudo
ehemplo	ehˈemplo
Astrid	astrˈid
trayecto	trajˈekto
urgencia	urxˈensja
responsabilidad	responsabilidˈad
inn	ˈinŋ
Shelter	ʃeltˈer
bus	bˈus
spula	spˈula
Apenas	apenˈas
Ministro	minˈistro
Latino	latˈino
Sector	sektˈor
establecimento	establesimˈento
leynan	lˈejnan
buffer	buffˈer
UPP	ˈupp
lector	lektˈor
inicial	inisjˈal
resultadonan	resultadˈonan
Salazar	salazˈar
Cubano	kubˈano
adicto	adˈikto
competencianan	kompetensjˈanan
FUTURA	futˈura
alimenta	alimˈenta
opcionnan	opsjˈonnan
recientemente	resjentemˈente
problemanan	problemˈanan
ekipo	ekˈipo
publicacion	publikasjˈoŋ
organiza	orɡanˈiza
hudicial	hudisjˈal
bolbe	bˈolbe
Taskforce	taskfˈorse
documenta	dokumˈenta
artista	artˈista
companianan	kompanjˈanan
tume	tˈume
mandatarionan	mandatarjˈonan
Importacion	importasjˈoŋ
establece	establˈese
Internacional	internasjonˈal
sea	sˈea
Ombudsman	ombudsmˈaŋ
Fontein	fontˈe͡ɪŋ
traspaso	traspˈaso
West	wˈest
tratadonan	tratadˈonan
retraso	retrˈaso
Garden	ɡardˈeŋ
tur	tˈur
moderno	modˈerno
Volksgezondheid	volksxezondhˈe͡ɪd
Kelly	kˈelli
juffrouwnan	juffrˈowwnan
caracterisa	karakterˈisa
nister	nistˈer
adaptando	adaptˈando
Diaranson	djaransˈoŋ
sla	slˈa
restonan	restˈonan
innovativo	innovatˈivo
Nomber	nombˈer
iglesia	iɡlˈesja
suv	sˈuv
Conclusion	konklusjˈoŋ
Leerorkest	leːrorkˈest
movecion	movesjˈoŋ
aerolinea	aerolinˈea
spanta	spˈanta
bendiciona	bendisjˈona
Anto	ˈanto
Venezolano	venezolˈano
Boulevard	bowlevˈard
television	televisjˈoŋ
IOWA	jˈowa
Fatima	fatˈima
flora	flˈora
entradanan	entradˈanan
Pan	pˈaŋ
take	tˈake
Peterson	petersˈoŋ
funda	fˈunda
piesanan	pjesˈanan
categorianan	kateɡorjˈanan
Muchanan	mut͡ʃˈanan
opleiding	ople͡ɪdˈinɡ
Telearuba	telearˈuba
manager	manaxˈer
haya	hˈaja
Dimas	dimˈas
considera	konsidˈera
ehecutivonan	ehekutivˈonan
principalmente	prinsipalmˈente
kaba	kˈaba
Obispo	obˈispo
upload	uploˈad
hubentud	hubentˈud
anula	anˈula
Centronan	sentrˈonan
amor	amˈor
gran	ɡrˈaŋ
chikito	t͡ʃikˈito
chines	t͡ʃinˈes
coro	kˈoro
fase	fˈase
segura	seɡˈura
desinfecta	desinfˈekta
Rijksministerraad	re͡ɪksministerrˈaːd
habitat	habitˈat
actor	aktˈor
eficiencia	efisjˈensja
discrepancia	diskrepˈansja
Chikito	t͡ʃikˈito
bendicion	bendisjˈoŋ
selecta	selˈekta
pelea	pelˈea
complementa	komplemˈenta
entidadnan	entidˈadnan
Taxi	tˈaksi
Trupialen	trupjalˈeŋ
tasnan	tˈasnan
Kavel	kavˈel
art	ˈart
entendi	entˈendi
IVA	ˈiva
Chikungunya	t͡ʃikunɡˈunja
emocional	emosjonˈal
relaciona	relasjˈona
juffrouw	juffrˈoww
Thijsen	the͡ɪsˈeŋ
pena	pˈena
Ya	jˈa
Henk	hˈenk
pilar	pilˈar
best	bˈest
difunto	difˈunto
lock	lˈokk
awacati	awakˈati
fechanan	fet͡ʃˈanan
Miembronan	mjembrˈonan
brake	brˈake
lift	lˈift
peligernan	pelixˈernan
sanea	sanˈea
razzia	rˈazzja
porcierto	porsjˈerto
expectativa	ekspektatˈiva
cifra	sˈifra
motibu	motˈibu
repasa	repˈasa
House	hˈowse
Richard	rit͡ʃˈard
Pago	pˈaɡo
elabora	elabˈora
Gabinete	ɡabinˈete
Joe	jˈu
Abou	abˈow
mashin	maʃˈiŋ
trabounan	trabˈownan
chat	t͡ʃˈat
Ciudadanonan	sjudadanˈonan
Ranger	ranxˈer
atletanan	atletˈanan
carson	karsˈoŋ
contagio	kontˈaxjo
necesario	nesesˈarjo
lagando	laɡˈando
airco	ˈa͡ɪrko
record	rekˈord
seis	sˈe͡ɪs
f	ˈɛf
Washington	waʃinɡtˈoŋ
kita	kˈita
harpun	harpˈuŋ
contacto	kontˈakto
buki	bˈuki
transcuri	transkˈuri
recobra	rekˈobra
constitucion	konstitusjˈoŋ
Albertus	albertˈus
fotografianan	fotoɡrafjˈanan
Cien	sjˈeŋ
ader	adˈer
despedi	despˈedi
iregularidad	ireɡularidˈad
Mastercard	masterkˈard
SEPPA	sˈeppa
paisnan	pˈa͡ɪsnan
Tjin	tjˈiŋ
Tanki	tˈanki
Horcan	horkˈaŋ
empodera	empodˈera
felicita	felisˈita
obviamente	obvjamˈente
experto	ekspˈerto
chens	t͡ʃˈens
limpia	lˈimpja
Taxistanan	taksistˈanan
siguridad	siɡuridˈad
limpiesa	limpjˈesa
manipula	manipˈula
piscanan	piskˈanan
Mil	mˈil
largo	lˈarɡo
abilidad	abilidˈad
viahe	vjˈahe
club	klˈub
refresco	refrˈesko
RWZI	rwzˈi
Status	statˈus
Hoge	hˈoxe
bahada	bahˈada
notario	notˈarjo
sacrificio	sakrifˈisjo
mr	ˌɛmˈɛr
detenidonan	detenidˈonan
Great	ɡreˈat
Villas	villˈas
Alfonso	alfˈonso
inicio	inˈisjo
medicina	medisˈina
piki	pˈiki
inmenso	inmˈenso
lastra	lˈastra
luho	lˈuho
Accent	aksˈent
indole	indˈole
pasenshi	pasˈenʃi
tempran	temprˈaŋ
avancenan	avansˈenan
Visitor	visitˈor
aresta	arˈesta
distribucion	distribusjˈoŋ
Bandera	bandˈera
enfocando	enfokˈando
compara	kompˈara
Titular	titulˈar
situacion	sitwasjˈoŋ
bilingual	bilinɡwˈal
Hooiberg	hoːjbˈerɡ
Hugo	hˈuɡo
transplante	transplˈante
respiracion	respirasjˈoŋ
Bernabela	bernabˈela
matutino	matutˈino
handle	hˈandle
Nivel	nivˈel
Mini	mˈini
acto	ˈakto
fuentenan	fwentˈenan
dokternan	doktˈernan
database	databˈase
operacional	operasjonˈal
Mundialmente	mundjalmˈente
reporta	repˈorta
trailer	tra͡ɪlˈer
vet	vˈet
Laura	laˈura
comienso	komjˈenso
diabierna	djabjˈerna
dividi	divˈidi
apoya	apˈoja
bacteria	baktˈerja
hayabo	hajˈabo
camp	kˈamp
Ni	nˈi
figuranan	fiɡurˈanan
chevrolet	t͡ʃevrolˈet
aniversario	aniversˈarjo
pober	pobˈer
cuponan	kupˈonan
bulto	bˈulto
debil	debˈil
strea	strˈea
insisti	insˈisti
program	proɡrˈam
Google	ɡˈoːɡle
dive	dˈive
dunadornan	dunadˈornan
regula	reɡˈula
RevPAR	rˈevpˈar
conscientisa	konssjentˈisa
het	hˈet
Gouverneur	ɡowvernˈewr
huridico	huridˈiko
propaga	propˈaɡa
sosteni	sostˈeni
custumber	kustumbˈer
enseñanza	enseɲˈanza
surseance	surseˈanse
RADEX	radˈeks
Interes	interˈes
Foundation	fowndatjˈoŋ
scooter	skoːtˈer
Car	kˈar
polisnan	polˈisnan
WGK	wˌeɡˌekˈa
CAft	sˈeˈaft
militarnan	militˈarnan
Clientenan	kljentˈenan
cuchiu	kˈut͡ʃju
carnavalesco	karnavalˈesko
Avestruz	avestrˈuz
cobrando	kobrˈando
stuurgroep	styrɡrˈup
cancelacion	kanselasjˈoŋ
Korps	kˈorps
boto	bˈoto
peticion	petisjˈoŋ
instalacion	instalasjˈoŋ
Moringa	morˈinɡa
secreto	sekrˈeto
kier	kjˈer
añadi	aɲˈadi
sende	sˈende
Webinar	webinˈar
Customer	kustomˈer
innecesario	innesesˈarjo
Party	pˈarti
responde	respˈonde
Basa	bˈasa
stakeholder	stakeholdˈer
Telecomunicacion	telekomunikasjˈoŋ
cadenanan	kadenˈanan
Comercio	komˈersjo
drs	dˌeˌɛrˈɛs
temporada	temporˈada
turbulencia	turbulˈensja
prometedor	prometedˈor
ningun	ninɡˈuŋ
ministerial	ministerjˈal
Boegoeroei	buɡurˈuj
transmiti	transmˈiti
reunionan	rewnjˈonan
Thru	thrˈu
Punta	pˈunta
menaza	menˈaza
unavez	unavˈez
Project	projˈekt
Esaki	esˈaki
cuminsamento	kuminsamˈento
Ta	tˈa
aprobacion	aprobasjˈoŋ
Parlamentonan	parlamentˈonan
es	ˈes
consisti	konsˈisti
Quant	kwˈant
beyeza	bejˈeza
fuertemente	fwertemˈente
serca	sˈerka
biña	bˈiɲa
stabiel	stabjˈel
cuadra	kwˈadra
balans	balˈans
ROP	rˈop
Tambe	tˈambe
monumental	monumentˈal
sacrifica	sakrifˈika
Teishi	tˈe͡ɪʃi
intrankilidad	intrankilidˈad
Europa	ewrˈopa
salida	salˈida
cantante	kantˈante
sondeo	sondˈeo
pidiendo	pidjˈendo
marduga	mardˈuɡa
Fresh	frˈeʃ
beach	beˈat͡ʃ
Tweede	twˈeːde
tosamento	tosamˈento
Bay	bˈaj
insecticida	insektisˈida
tecnologico	teknoloxˈiko
Nightclub	niɡhtklˈub
Lider	lidˈer
cero	sˈero
soborno	sobˈorno
nubia	nˈubja
bancarota	bankarˈota
comprendibel	komprendibˈel
tocando	tokˈando
formalmente	formalmˈente
Weganan	weɡˈanan
Madiki	madˈiki
Landsverordening	landsverordenˈinɡ
Joaquin	joakwˈiŋ
crucial	krusjˈal
sugerencianan	suxerensjˈanan
Tratamento	tratamˈento
penetracion	penetrasjˈoŋ
karentena	karentˈena
Code	kˈode
Toyota	tojˈota
taskforce	taskfˈorse
Cuida	kˈujda
Caminda	kamˈinda
pasivo	pasˈivo
cambionan	kambjˈonan
pase	pˈase
speech	spˈeːt͡ʃ
viahero	vjahˈero
oost	ˈoːst
Dump	dˈump
investigacion	investiɡasjˈoŋ
impulso	impˈulso
Luenne	lwˈenne
diverso	divˈerso
Kruis	krˈujs
oponentenan	oponentˈenan
bancario	bankˈarjo
cera	sˈera
Vis	vˈis
acorda	akˈorda
mescos	meskˈos
epoca	epˈoka
Nicolaas	nikolˈaːs
enfermedadnan	enfermedˈadnan
Ocho	ˈot͡ʃo
retene	retˈene
bezig	bezˈiɡ
Milio	mˈiljo
scohe	skˈohe
bukinan	bukˈinan
kimico	kimˈiko
ijs	ˈe͡ɪs
capitan	kapitˈaŋ
reto	rˈeto
Hunto	hˈunto
York	jˈork
schedule	st͡ʃedˈule
barionan	barjˈonan
borchi	bˈort͡ʃi
demonstra	demˈonstra
Compania	kompˈanja
empleada	empleˈada
Ambulance	ambulˈanse
Hendrikstraat	hendrikstrˈaːt
Sociaal	sosjˈaːl
datonan	datˈonan
inaugural	inauɡurˈal
pianan	pjˈanan
email	emˈa͡ɪl
Avenida	avenˈida
vloer	vlˈur
embahada	embahˈada
elo	ˈelo
pedofil	pedofˈil
maleta	malˈeta
tini	tˈini
Semper	sempˈer
visible	visˈible
Bida	bˈida
optimal	optimˈal
motoriza	motorˈiza
zundra	zˈundra
transmicion	transmisjˈoŋ
pagonan	paɡˈonan
caracteristicanan	karakteristikˈanan
LNG	ˌɛlˌɛnɡˈe
unilateral	unilaterˈal
eleccionnan	eleksjˈonnan
Leo	lˈeo
admision	admisjˈoŋ
Casa	kˈasa
legitimidad	lexitimidˈad
Millennials	millennjˈals
curpa	kˈurpa
Meverly	mevˈerli
viahenan	vjahˈenan
Loke	lˈoke
tata	tˈata
esei	ˈese͡ɪ
Idioma	idjˈoma
stock	stˈokk
Biezen	bjezˈeŋ
Mahuma	mahˈuma
Union	unjˈoŋ
Watty	wˈatti
zomaar	zomˈaːr
frieu	frjˈew
exigente	eksixˈente
Venezuela	venezwˈela
Kerstboomlandia	kerstboːmlˈandja
traha	trˈaha
nomina	nomˈina
diesel	djesˈel
aumenta	aumˈenta
Waf	wˈaf
enberdad	enberdˈad
avion	avjˈoŋ
ImSan	ˈimsˈaŋ
Polisnan	polˈisnan
Nacional	nasjonˈal
manifestante	manifestˈante
manteniendo	mantenjˈendo
destina	destˈina
documento	dokumˈento
atribui	atribˈuj
maestro	maˈestro
Labor	labˈor
o	ˈo
Arubalening	arubalenˈinɡ
Pastoor	pastˈoːr
Seccion	seksjˈoŋ
Doño	dˈoɲo
intimida	intimˈida
plastic	plastˈik
deporta	depˈorta
or	ˈor
rating	ratˈinɡ
respectivamente	respektivamˈente
cargamento	karɡamˈento
maltrata	maltrˈata
conteniendo	kontenjˈendo
teritorial	teritorjˈal
Dianan	djˈanan
accepta	aksˈepta
Bisti	bˈisti
DIMAS	dimˈas
deliberadamente	deliberadamˈente
interpretacion	interpretasjˈoŋ
mucho	mˈut͡ʃo
GKMB	ɡˌekˌaˌɛmbˈe
flexibiliza	fleksibilˈiza
sexo	sˈekso
hereda	herˈeda
storianan	storjˈanan
Hues	hwˈes
Caribe	karˈibe
Empresanan	empresˈanan
jet	jˈet
Biba	bˈiba
Scol	skˈol
toque	tˈokwe
miembrecia	mjembrˈesja
decir	desˈir
sondea	sondˈea
argumento	arɡumˈento
Lejuez	lejwˈez
recept	resˈept
bes	bˈes
totalidad	totalidˈad
RAiZ	ˈɛrˈa͡ɪzˈɛt
indicador	indikadˈor
onderwijs	onderwˈe͡ɪs
Juli	jˈuli
importante	importˈante
seconde	sekˈonde
sicario	sikˈarjo
anos	anˈos
kedando	kedˈando
Directora	direktˈora
specialisa	spesjalˈisa
Wega	wˈeɡa
seno	sˈeno
Het	hˈet
cunukero	kunukˈero
diferencianan	diferensjˈanan
momentonan	momentˈonan
kwartaal	kwartˈaːl
cosnan	kˈosnan
visibel	visibˈel
discriminacion	diskriminasjˈoŋ
ser	sˈer
motibonan	motibˈonan
aceptabel	aseptabˈel
Carnival	karnivˈal
Honda	hˈonda
argumentonan	arɡumentˈonan
Asina	asˈina
estableci	establˈesi
rutina	rutˈina
formal	formˈal
siguramente	siɡuramˈente
carchi	kˈart͡ʃi
eGovernment	eɡovernmˈent
Cantidad	kantidˈad
considerablemente	konsiderablemˈente
Refineria	refinˈerja
interpreta	interprˈeta
asfalt	asfˈalt
clientela	kljentˈela
Rosel	rosˈel
facebook	fasebˈoːk
ladron	ladrˈoŋ
eynan	ˈejnan
contingencia	kontinxˈensja
Radio	rˈadjo
menos	menˈos
referencia	referˈensja
Padu	pˈadu
similar	similˈar
Voogdijraad	voːɡde͡ɪrˈaːd
suspendi	suspˈendi
para	pˈara
John	jˈohŋ
actuando	aktwˈando
drama	drˈama
clubnan	klˈubnan
mandatorio	mandatˈorjo
dengue	dˈenɡe
impuestonan	impwestˈonan
barancanan	barankˈanan
entrenamento	entrenamˈento
solo	sˈolo
Alemania	alemˈanja
mas	mˈas
met	mˈet
contaminacion	kontaminasjˈoŋ
promer	promˈer
Toets	tˈuts
fabor	fabˈor
intenta	intˈenta
felis	felˈis
combersacion	kombersasjˈoŋ
Parkietenbos	parkjetenbˈos
protocol	protokˈol
caminda	kamˈinda
AGA	ˈaɡa
gara	ɡˈara
Articulo	artikˈulo
Anthony	anthˈoni
Mira	mˈira
Fuerte	fwˈerte
esaki	esˈaki
huicio	hˈujsjo
Winklaar	winklˈaːr
capacidad	kapasidˈad
candidatonan	kandidatˈonan
Webb	wˈebb
comerciantenan	komersjantˈenan
Trinidad	trinidˈad
facilita	fasilˈita
felicitacion	felisitasjˈoŋ
captura	kaptˈura
Jorge	jˈorxe
ciudad	sjudˈad
werksternan	werkstˈernan
Wever	wevˈer
Ruben	rubˈeŋ
Ernesto	ernˈesto
decisivo	desisˈivo
estatal	estatˈal
atardi	atˈardi
laso	lˈaso
maart	mˈaːrt
donacionnan	donasjˈonnan
incumplimento	inkumplimˈento
artikel	artikˈel
chekeo	t͡ʃekˈeo
Milo	mˈilo
inmediatamente	inmedjatamˈente
bentaha	bentˈaha
links	lˈinks
conseho	konsˈeho
cumbini	kumbˈini
personan	persˈonan
comenta	komˈenta
Home	hˈome
balia	bˈalja
bishita	biʃˈita
proyeccion	projeksjˈoŋ
condenabel	kondenabˈel
biahamento	bjahamˈento
voucher	vowt͡ʃˈer
structuralmente	strukturalmˈente
notifica	notifˈika
OCCA	ˈokka
caretera	karetˈera
retiro	retˈiro
cumplimento	kumplimˈento
rumannan	rumˈannan
fundeshi	fundˈeʃi
windshield	windʃjˈeld
lo	lˈo
Parokia	parˈokja
documentonan	dokumentˈonan
interveni	intervˈeni
viaheronan	vjaherˈonan
Obispado	obispˈado
pero	pˈero
Mahestad	mahestˈad
recepcion	resepsjˈoŋ
DIP	dˈip
deficit	defisˈit
Punto	pˈunto
Desaroyo	desarˈojo
adkiri	adkˈiri
positivismo	positivˈismo
Day	dˈaj
Piedra	pjˈedra
Whatsapp	whatsˈapp
suma	sˈuma
biento	bjˈento
gosa	ɡˈosa
versus	versˈus
involucra	involˈukra
ambulante	ambulˈante
PPP	pˌepˌepˈe
Corporation	korporatjˈoŋ
Superfood	superfˈoːd
brug	brˈuɡ
hipoteca	hipotˈeka
mondkapje	mondkˈapje
Parke	pˈarke
B	bˈe
meti	mˈeti
corta	kˈorta
Maritimo	maritˈimo
palo	pˈalo
Auto	aˈuto
and	ˈand
gas	ɡˈas
ordo	ˈordo
Sagrado	saɡrˈado
teatro	teˈatro
Parlamento	parlamˈento
gigante	xiɡˈante
bakinan	bakˈinan
matanan	matˈanan
transcurso	transkˈurso
Duarte	dwˈarte
puro	pˈuro
mientrastanto	mjentrastˈanto
instructornan	instruktˈornan
Cannabis	kannabˈis
ATA	ˈata
Angela	anxˈela
sa	sˈa
genero	xenˈero
complicacion	komplikasjˈoŋ
paralisa	paralˈisa
Cura	kˈura
implementa	implemˈenta
dus	dˈus
Decreto	dekrˈeto
mediador	medjadˈor
Esunnan	esˈunnan
produccion	produksjˈoŋ
trafico	trafˈiko
pidi	pˈidi
tanda	tˈanda
specialmente	spesjalmˈente
schoolnan	st͡ʃˈoːlnan
presentacion	presentasjˈoŋ
menor	menˈor
monton	montˈoŋ
artistanan	artistˈanan
procesa	prosˈesa
malesanan	malesˈanan
subsidia	subsˈidja
saco	sˈako
Weststraat	weststrˈaːt
reparacion	reparasjˈoŋ
caida	kˈa͡ɪda
Americano	amerikˈano
Tumba	tˈumba
Mesora	mesˈora
fiansanan	fjansˈanan
Kamay	kamˈaj
Diabetes	djabetˈes
University	universˈiti
liga	lˈiɡa
sterilisa	sterilˈisa
buscando	buskˈando
insistencia	insistˈensja
Net	nˈet
WCA	wkˈa
cendi	sˈendi
construi	konstrˈuj
Divi	dˈivi
socede	sosˈede
certidumbre	sertidˈumbre
poco	pˈoko
ainda	ˈa͡ɪnda
calamidad	kalamidˈad
gesto	xˈesto
samenscholingsverbod	samenst͡ʃolinɡsverbˈod
State	stˈate
candidata	kandidˈata
ciudadano	sjudadˈano
Cuerpo	kwˈerpo
cuero	kwˈero
obligatorio	obliɡatˈorjo
papia	pˈapja
Monumentenfonds	monumentenfˈonds
fasenan	fasˈenan
observa	obsˈerva
cabesantenan	kabesantˈenan
testigo	testˈiɡo
Kapel	kapˈel
dolor	dolˈor
mediacion	medjasjˈoŋ
anteriormente	anterjormˈente
heridonan	heridˈonan
trankil	trankˈil
conhunto	konhˈunto
Samenscholingsverbod	samenst͡ʃolinɡsverbˈod
sport	spˈort
Kibaima	kibˈa͡ɪma
Republicano	republikˈano
OK	ˈok
rector	rektˈor
asuntonan	asuntˈonan
reenforsa	reːnfˈorsa
SCP	ˌɛssˌepˈe
mihor	mihˈor
Johnson	johnsˈoŋ
Señora	seɲˈora
comienzo	komjˈenzo
support	suppˈort
Orman	ormˈaŋ
bao	bˈao
actonan	aktˈonan
investigashon	investiɡaʃˈoŋ
kontakto	kontˈakto
KIA	kjˈa
practicamente	praktikamˈente
hiba	hˈiba
abismo	abˈismo
casino	kasˈino
negligencia	neɡlixˈensja
enfermedad	enfermedˈad
Specialista	spesjalˈista
cuidador	kujdadˈor
conclusion	konklusjˈoŋ
Gobiernonan	ɡobjernˈonan
mayan	majˈaŋ
cortesia	kortˈesja
Shariska	ʃarˈiska
monetario	monetˈarjo
terminal	terminˈal
tercel	tersˈel
muda	mˈuda
Industria	indˈustrja
extende	ekstˈende
malo	mˈalo
Peter	petˈer
bestianan	bestjˈanan
Card	kˈard
Sneek	snˈeːk
memey	memˈej
ambulans	ambulˈans
spuit	spˈujt
mita	mˈita
agentenan	axentˈenan
proyecta	projˈekta
advies	advjˈes
determina	determˈina
digital	dixitˈal
huntu	hˈuntu
tucson	tuksˈoŋ
hit	hˈit
trip	trˈip
creatividad	kreatividˈad
Linda	lˈinda
Productions	produktjˈons
antemano	antemˈano
Integridad	inteɡridˈad
Wiki	wˈiki
ma	mˈa
horibel	horibˈel
afdeling	afdelˈinɡ
gravedad	ɡravedˈad
huramenta	huramˈenta
totalmente	totalmˈente
cannabis	kannabˈis
rebelde	rebˈelde
Mundial	mundjˈal
Run	rˈuŋ
Kibrahacha	kibrahˈat͡ʃa
rato	rˈato
debati	debˈati
Hubenil	hubenˈil
trayectoria	trajektˈorja
proyeccionnan	projeksjˈonnan
salario	salˈarjo
compornde	kompˈornde
use	ˈuse
refinerianan	refinerjˈanan
selecciona	seleksjˈona
Oceano	oseˈano
eherce	ehˈerse
envolvi	envˈolvi
positivity	positivˈiti
Politica	politˈika
vice	vˈise
nabega	nabˈeɡa
miembronan	mjembrˈonan
registra	rexˈistra
error	errˈor
opvang	opvˈanɡ
bononan	bonˈonan
Katholiek	katholjˈek
hotelero	hotelˈero
PR	pˌeˈɛr
explosion	eksplosjˈoŋ
especialmente	espesjalmˈente
comunismo	komunˈismo
vehiculonan	vehikulˈonan
tropical	tropikˈal
Benjamin	benjamˈiŋ
opone	opˈone
Nel	nˈel
excepcional	ekssepsjonˈal
Hasta	hˈasta
Castigo	kastˈiɡo
Ministerio	ministˈerjo
comestible	komestˈible
hemchi	hˈemt͡ʃi
obra	ˈobra
MiniMega	mˈinimˈeɡa
emocion	emosjˈoŋ
huur	hˈyr
horeca	horˈeka
reflexion	refleksjˈoŋ
disposicion	disposisjˈoŋ
bentana	bentˈana
Pablo	pˈablo
acercando	aserkˈando
Passions	passjˈons
Mesa	mˈesa
tercer	tersˈer
buske	bˈuske
Balashi	balˈaʃi
Hopi	hˈopi
transferi	transfˈeri
Vehiculo	vehikˈulo
consequencianan	konsekwensjˈanan
apesar	apesˈar
banconan	bankˈonan
multa	mˈulta
organisacionnan	orɡanisasjˈonnan
adopta	adˈopta
libremente	libremˈente
rapport	rappˈort
rescata	reskˈata
bishitante	biʃitˈante
weso	wˈeso
ancra	ˈankra
Haag	hˈaːɡ
Schwengle	st͡ʃwˈenɡle
Na	nˈa
patientnan	patjˈentnan
Cacique	kasˈikwe
ruta	rˈuta
analisa	analˈisa
Exxon	eksksˈoŋ
Roza	rˈoza
Scoop	skˈoːp
by	bˈi
geel	xˈeːl
teamnan	teˈamnan
discurso	diskˈurso
Daniel	danjˈel
batayon	batajˈoŋ
Yama	jˈama
Pashentnan	paʃˈentnan
Sostenemi	sostenˈemi
veterinario	veterinˈarjo
refuerzo	refwˈerzo
aportando	aportˈando
acomodacionnan	akomodasjˈonnan
considerabel	konsiderabˈel
Figaroa	fiɡarˈoa
Financieel	finansjˈeːl
debit	debˈit
husga	hˈusɡa
presencia	presˈensja
civil	sivˈil
Advies	advjˈes
Brandweer	brandwˈeːr
sugerencia	suxerˈensja
Uni	ˈuni
invisibel	invisibˈel
combustible	kombustˈible
culminacion	kulminasjˈoŋ
turistanan	turistˈanan
online	onlˈine
regulacionnan	reɡulasjˈonnan
Sky	skˈi
rifnan	rˈifnan
pickup	pikkˈup
piedra	pjˈedra
over	ovˈer
Colorado	kolorˈado
Fondo	fˈondo
dividendo	dividˈendo
software	softwˈare
boluntario	boluntˈarjo
boton	botˈoŋ
niun	njˈuŋ
binidero	binidˈero
iluminacion	iluminasjˈoŋ
disponibel	disponibˈel
pos	pˈos
reconstruccion	rekonstruksjˈoŋ
representante	representˈante
ciere	sjˈere
integrantenan	inteɡrantˈenan
Ras	rˈas
enorme	enˈorme
blvd	bˌeˌɛlvˌedˈe
saliente	saljˈente
dialoga	djalˈoɡa
Network	netwˈork
Ruyter	rujtˈer
aereo	aerˈeo
Night	nˈiɡht
eybao	ejbˈao
Cuminda	kumˈinda
Cuatro	kwˈatro
America	amerˈika
Guillermo	ɡjllˈermo
Informacionnan	informasjˈonnan
bora	bˈora
caba	kˈaba
famia	fˈamja
yudanza	judˈanza
MAS	mˈas
Solange	solˈanxe
aliento	aljˈento
directiva	direktˈiva
Inmigracion	inmiɡrasjˈoŋ
mondi	mˈondi
arma	ˈarma
HIV	hˈiv
bendemento	bendemˈento
constant	konstˈant
piscamento	piskamˈento
hobencita	hobensˈita
curiculo	kurikˈulo
Departamentonan	departamentˈonan
cardinal	kardinˈal
Beverage	beverˈaxe
Mientras	mjentrˈas
crusero	krusˈero
cantantenan	kantantˈenan
practica	praktˈika
tawatin	tawatˈiŋ
Lotto	lˈotto
PG	pˌeɡˈe
siman	simˈaŋ
muri	mˈuri
strategianan	stratexjˈanan
transporta	transpˈorta
Moko	mˈoko
berdad	berdˈad
tino	tˈino
mala	mˈala
revela	revˈela
abo	ˈabo
viola	vjˈola
socialisa	sosjalˈisa
Qredits	kredˈits
alternativo	alternatˈivo
Meteorologico	meteoroloxˈiko
Eddie	ˈeddje
Gobernador	ɡobernadˈor
mantene	mantˈene
indicacion	indikasjˈoŋ
file	fˈile
marcha	mˈart͡ʃa
out	ˈowt
capacita	kapasˈita
impresion	impresjˈoŋ
autonomia	autonˈomja
Ocupacion	okupasjˈoŋ
triunfo	trjˈunfo
Travel	travˈel
acomoda	akomˈoda
problematico	problematˈiko
Economische	ekonomˈist͡ʃe
masalmente	masalmˈente
continuo	kontˈinwo
Nos	nˈos
rolluik	rollˈujk
ofreciendo	ofresjˈendo
deportista	deportˈista
Vrolijk	vrolˈe͡ɪk
bibo	bˈibo
obstaculo	obstakˈulo
aporta	apˈorta
residentenan	residentˈenan
tolerancia	tolerˈansja
horta	hˈorta
AVP	ˈavp
Chines	t͡ʃinˈes
vacacion	vakasjˈoŋ
anhela	anhˈela
Debit	debˈit
Maske	mˈaske
Ambos	ambˈos
complicacionnan	komplikasjˈonnan
SMAC	smˈak
opcion	opsjˈoŋ
aceptacion	aseptasjˈoŋ
boa	bˈoa
nunka	nˈunka
hungadornan	hunɡadˈornan
Eynan	ˈejnan
conocirnan	konosˈirnan
enseñansa	enseɲˈansa
meta	mˈeta
caduca	kadˈuka
necesidadnan	nesesidˈadnan
oficialnan	ofisjˈalnan
sentencia	sentˈensja
informacion	informasjˈoŋ
cuanto	kwˈanto
invitacion	invitasjˈoŋ
situacionnan	sitwasjˈonnan
ocupacion	okupasjˈoŋ
informashon	informaʃˈoŋ
Roberto	robˈerto
nacemento	nasemˈento
Instancianan	instansjˈanan
Excelencia	eksselˈensja
JZP	jˌezˌɛtpˈe
desmenti	desmˈenti
Croes	krˈus
violando	vjolˈando
dimension	dimensjˈoŋ
cabay	kabˈaj
siguransa	siɡurˈansa
pushi	pˈuʃi
violento	vjolˈento
cla	klˈa
indice	indˈise
recordatorio	rekordatˈorjo
Conservation	konservatjˈoŋ
essencial	essensjˈal
iniciativanan	inisjativˈanan
motibo	motˈibo
Nacion	nasjˈoŋ
Visa	vˈisa
Area	arˈea
pensionado	pensjonˈado
agricultornan	aɡrikultˈornan
bosonan	bosˈonan
Subway	subwˈaj
poz	pˈoz
Holiday	holidˈaj
dominio	domˈinjo
Aldrich	aldrˈit͡ʃ
Ademas	ademˈas
dispuesto	dispwˈesto
descubri	deskˈubri
atake	atˈake
logra	lˈoɡra
mercancia	merkˈansja
poko	pˈoko
divorcio	divˈorsjo
Oriente	orjˈente
resort	resˈort
institutonan	institutˈonan
pare	pˈare
santana	santˈana
staciona	stasjˈona
entrega	entrˈeɡa
cultural	kulturˈal
Wheels	whˈeːls
Aruparking	aruparkˈinɡ
Sportsubsidie	sportsubsˈidje
ata	ˈata
impresiona	impresjˈona
Asuntonan	asuntˈonan
Ambtenaar	ambtenˈaːr
tirando	tirˈando
demas	demˈas
Dande	dˈande
trastorno	trastˈorno
religion	relixjˈoŋ
realmente	realmˈente
lusnan	lˈusnan
realisa	realˈisa
tardando	tardˈando
Dabian	dabjˈaŋ
Radisson	radissˈoŋ
directora	direktˈora
fundamental	fundamentˈal
pacifico	pasifˈiko
tripulantenan	tripulantˈenan
detayenan	detajˈenan
interno	intˈerno
crypto	krˈipto
ja	jˈa
Comisario	komisˈarjo
planificacion	planifikasjˈoŋ
rutanan	rutˈanan
Rico	rˈiko
fotografo	fotoɡrˈafo
klasnan	klˈasnan
ocupantenan	okupantˈenan
autorisa	autorˈisa
short	ʃˈort
seguridad	seɡuridˈad
infraccion	infraksjˈoŋ
marca	mˈarka
Staten	statˈeŋ
inventa	invˈenta
disertacion	disertasjˈoŋ
Market	markˈet
Massive	massˈive
kisas	kisˈas
angustia	anɡˈustja
Communicatie	kommunikˈatje
unda	ˈunda
VWO	vwˈo
Rosa	rˈosa
Caribisch	karibˈist͡ʃ
planea	planˈea
Women	womˈeŋ
spearfishing	spearfiʃˈinɡ
laboratorio	laboratˈorjo
Cria	krjˈa
Ex	ˈeks
sectornan	sektˈornan
Iglesia	iɡlˈesja
actua	ˈaktwa
protestanan	protestˈanan
march	mˈart͡ʃ
suceso	susˈeso
canalnan	kanˈalnan
tsunami	tsunˈami
Tres	trˈes
dictadura	diktadˈura
Financien	finansjˈeŋ
abusa	abˈusa
kens	kˈens
aseguradonan	aseɡuradˈonan
drive	drˈive
rekisitonan	rekisitˈonan
alegra	alˈeɡra
saka	sˈaka
Docternan	doktˈernan
prestigioso	prestixjˈoso
educa	edˈuka
El	ˈel
full	fˈull
votonan	votˈonan
contrata	kontrˈata
Cabay	kabˈaj
soledad	soledˈad
regalonan	reɡalˈonan
extendi	ekstˈendi
modelonan	modelˈonan
conflicto	konflˈikto
Antes	antˈes
Fund	fˈund
simplemente	simplemˈente
friu	frjˈu
atravez	atravˈez
Miguel	miɡˈel
Airlines	a͡ɪrlinˈes
ranca	rˈanka
tres	trˈes
partidonan	partidˈonan
significante	siɡnifikˈante
Molina	molˈina
respet	respˈet
distanciamento	distansjamˈento
femenino	femenˈino
ceremonia	seremˈonja
preventivo	preventˈivo
navega	navˈeɡa
AWG	ˈawɡ
chofer	t͡ʃofˈer
stoel	stˈul
Rond	rˈond
visual	viswˈal
Masnoticia	masnotˈisja
medidanan	medidˈanan
pesar	pesˈar
discrimina	diskrimˈina
maneranan	manerˈanan
educacional	edukasjonˈal
automobilista	automobilˈista
Groningen	ɡroninxˈeŋ
obvio	ˈobvjo
Activo	aktˈivo
coperacion	koperasjˈoŋ
fayecido	fajesˈido
idioma	idjˈoma
Miyon	mijˈoŋ
dies	djˈes
pueblo	pwˈeblo
adultonan	adultˈonan
aplicando	aplikˈando
am	ˈam
TUR	tˈur
baldadi	baldˈadi
Jean	jeˈaŋ
Citgo	sˈitɡo
palonan	palˈonan
motornan	motˈornan
manifestacionnan	manifestasjˈonnan
euro	ˈewro
casa	kˈasa
Dorp	dˈorp
Lago	lˈaɡo
Enseñansa	enseɲˈansa
trafica	trafˈika
South	sˈowth
simbolico	simbolˈiko
alarma	alˈarma
optimismo	optimˈismo
aclaracion	aklarasjˈoŋ
Dentista	dentˈista
preso	prˈeso
usando	usˈando
asisti	asˈisti
Monseigneur	monse͡ɪɡnˈewr
Maestronan	maestrˈonan
pabien	pabjˈeŋ
interupcion	interupsjˈoŋ
reunionnan	rewnjˈonnan
Shaba	ʃˈaba
abusonan	abusˈonan
negosacionnan	neɡosasjˈonnan
sigi	sˈixi
ventilacion	ventilasjˈoŋ
yamado	jamˈado
contempla	kontˈempla
druk	drˈuk
vitamina	vitamˈina
ganado	ɡanˈado
tarda	tˈarda
Pasaheronan	pasaherˈonan
Uzi	ˈuzi
stress	strˈess
Unit	unˈit
Teniendo	tenjˈendo
formulanan	formulˈanan
Hefe	hˈefe
PCR	pˌesˌeˈɛr
website	websˈite
vital	vitˈal
Lito	lˈito
solidario	solidˈarjo
Grecia	ɡrˈesja
truck	trˈukk
topa	tˈopa
Moderna	modˈerna
pertenencia	pertenˈensja
Falcon	falkˈoŋ
libera	libˈera
pone	pˈone
Esta	ˈesta
rifa	rˈifa
eventualmente	eventwalmˈente
Parada	parˈada
crecemento	kresemˈento
wordo	wˈordo
amistad	amistˈad
Registro	rexˈistro
decisionan	desisjˈonan
socionan	sosjˈonan
direccion	direksjˈoŋ
scucha	skˈut͡ʃa
inclui	inklˈuj
studiando	studjˈando
perdida	perdˈida
Fase	fˈase
adiccion	adiksjˈoŋ
coordinacion	koːrdinasjˈoŋ
pirata	pirˈata
pe	pˈe
bebida	bebˈida
terenonan	terenˈonan
Docter	doktˈer
despedida	despedˈida
Birgen	birxˈeŋ
regala	reɡˈala
profesionalnan	profesjonˈalnan
Goshen	ɡoʃˈeŋ
Ady	ˈadi
declaracion	deklarasjˈoŋ
Leadership	leaderʃˈip
Organization	orɡanizatjˈoŋ
confiabel	konfjabˈel
migrante	miɡrˈante
droga	drˈoɡa
crece	krˈese
enbes	enbˈes
oficial	ofisjˈal
Catolico	katolˈiko
Ministronan	ministrˈonan
docternan	doktˈernan
redaccion	redaksjˈoŋ
Hamas	hamˈas
Mobile	mobˈile
pasa	pˈasa
obstaculonan	obstakulˈonan
warda	wˈarda
Utilities	utilitjˈes
desaroyadornan	desarojadˈornan
elogia	elˈoxja
Inspectie	inspˈektje
ARUBIANO	arubjˈano
Nicolas	nikolˈas
drentando	drentˈando
alma	ˈalma
divulga	divˈulɡa
gobierno	ɡobjˈerno
saludable	saludˈable
progreso	proɡrˈeso
respiratorio	respiratˈorjo
Naturalesa	naturalˈesa
bienestar	bjenestˈar
president	presidˈent
inovacion	inovasjˈoŋ
reglamento	reɡlamˈento
cargo	kˈarɡo
contesta	kontˈesta
alimento	alimˈento
loonbelasting	loːnbelastˈinɡ
mete	mˈete
pura	pˈura
formacion	formasjˈoŋ
un	ˈuŋ
parehanan	parehˈanan
Vondellaan	vondellˈaːŋ
rechaza	ret͡ʃˈaza
Virma	vˈirma
refugiado	refuxjˈado
scapa	skˈapa
intercambia	interkˈambja
himno	hˈimno
innecesariamente	innesesarjamˈente
tono	tˈono
incidente	insidˈente
scarsedad	skarsedˈad
intensiva	intensˈiva
erfpacht	erfpˈat͡ʃt
circo	sˈirko
buena	bwˈena
Negoshi	neɡˈoʃi
limita	limˈita
Smartphone	smartphˈone
Mester	mestˈer
Preto	prˈeto
Atardi	atˈardi
contratista	kontratˈista
ataca	atˈaka
de	dˈe
profesor	profesˈor
mencion	mensjˈoŋ
UN	ˈuŋ
Dus	dˈus
om	ˈom
Gezaghebber	xezaɡhebbˈer
pulmon	pulmˈoŋ
pobreza	pobrˈeza
falso	fˈalso
yerba	jˈerba
Aparentemente	aparentemˈente
mapa	mˈapa
Procurador	prokuradˈor
Corsou	korsˈow
Noord	nˈoːrd
Cada	kˈada
porta	pˈorta
maestra	maˈestra
Coach	koˈat͡ʃ
origen	orixˈeŋ
amplio	ˈampljo
bolo	bˈolo
conocir	konosˈir
clapchi	klˈapt͡ʃi
Prison	prisˈoŋ
Señor	seɲˈor
hospitalisa	hospitalˈisa
urgentemente	urxentemˈente
Banda	bˈanda
Masterplan	masterplˈaŋ
interactivo	interaktˈivo
Olimpico	olimpˈiko
impeachment	impeat͡ʃmˈent
marihuana	marihwˈana
encamina	enkamˈina
zodiacal	zodjakˈal
storia	stˈorja
klasse	klˈasse
confusion	konfusjˈoŋ
Gonzalez	ɡonzalˈez
halto	hˈalto
pia	pjˈa
sr	ˌɛsˈɛr
screening	skreːnˈinɡ
Seyo	sˈejo
sigaria	siɡˈarja
NV	ˌɛnvˈe
controlnan	kontrˈolnan
fe	fˈe
campo	kˈampo
tiro	tˈiro
Virus	virˈus
Marsman	marsmˈaŋ
avance	avˈanse
receta	resˈeta
construccion	konstruksjˈoŋ
sportage	sportˈaxe
prijs	prˈe͡ɪs
sangura	sanɡˈura
pretende	pretˈende
uit	ˈujt
solar	solˈar
Flamingo	flamˈinɡo
partido	partˈido
huurgrond	hyrɡrˈond
interes	interˈes
webinar	webinˈar
variedad	varjedˈad
Dominicana	dominikˈana
jeep	jˈeːp
task	tˈask
facilidadnan	fasilidˈadnan
CMB	sˌeˌɛmbˈe
Natuur	natˈyr
Nacionnan	nasjˈonnan
ATM	ˈatm
isola	isˈola
disgusta	disɡˈusta
activamente	aktivamˈente
Autismo	autˈismo
DNA	dnˈa
proteccion	proteksjˈoŋ
ilumina	ilumˈina
Resort	resˈort
zonido	zonˈido
Laboral	laborˈal
sabiduria	sabidˈurja
particularmente	partikularmˈente
concretisa	konkretˈisa
plantacion	plantasjˈoŋ
Importante	importˈante
funeraria	funerˈarja
tantisimo	tantisˈimo
porciento	porsjˈento
menasa	menˈasa
cuestion	kwestjˈoŋ
corant	korˈant
listramento	listramˈento
atractivo	atraktˈivo
Care	kˈare
hobenan	hobˈenan
solicita	solisˈita
move	mˈove
electricidad	elektrisidˈad
anciano	ansjˈano
Servicio	servˈisjo
FPNA	fpnˈa
surgi	sˈurxi
persecucion	persekusjˈoŋ
normal	normˈal
Alivio	alˈivjo
refineria	refinˈerja
daño	dˈaɲo
capital	kapitˈal
Cambionan	kambjˈonan
timeshare	timeʃˈare
comestibel	komestibˈel
rabia	rˈabja
votado	votˈado
elemento	elemˈento
costa	kˈosta
Congreso	konɡrˈeso
drenta	drˈenta
historia	histˈorja
Hyundai	hjˈunda͡ɪ
inteligencia	intelixˈensja
simple	sˈimple
condicion	kondisjˈoŋ
Brokke	brˈokke
transforma	transfˈorma
apoyo	apˈojo
baile	bˈa͡ɪle
dirigentenan	dirixentˈenan
intensivo	intensˈivo
Seroe	sˈeru
institucionnan	institusjˈonnan
genetico	xenetˈiko
republica	republˈika
colaborador	kolaboradˈor
Dakota	dakˈota
categoria	kateɡˈorja
documentacion	dokumentasjˈoŋ
compania	kompˈanja
Problemanan	problemˈanan
amplia	ˈamplja
mantencion	mantensjˈoŋ
juli	jˈuli
Wernet	wernˈet
media	mˈedja
plania	plˈanja
gobernacion	ɡobernasjˈoŋ
intencionalmente	intensjonalmˈente
Aworaki	aworˈaki
rasonnan	rasˈonnan
ey	ˈej
pro	prˈo
presonan	presˈonan
desapunta	desapˈunta
nos	nˈos
tambe	tˈambe
tiplijn	tiplˈe͡ɪŋ
Tico	tˈiko
RED	rˈed
salbaguardia	salbaɡwˈardja
Inteligencia	intelixˈensja
conferencia	konferˈensja
comunitario	komunitˈarjo
Tanto	tˈanto
cierto	sjˈerto
Personal	personˈal
diseño	disˈeɲo
SDGs	ˌɛsdˌeɡˌeˈɛs
transporte	transpˈorte
pariba	parˈiba
Tanten	tantˈeŋ
Nissan	nissˈaŋ
debidamente	debidamˈente
sosode	sosˈode
supermercado	supermerkˈado
Financiero	finansjˈero
diploma	diplˈoma
controle	kontrˈole
It	ˈit
Pickup	pikkˈup
Movies	movjˈes
Coca	kˈoka
Montenegro	montenˈeɡro
Naturalisacion	naturalisasjˈoŋ
FADA	fˈada
awendia	awˈendja
Recupera	rekupˈera
asiento	asjˈento
Duque	dˈukwe
forensyco	forensˈiko
purbando	purbˈando
inocente	inosˈente
MFA	mfˈa
originalmente	orixinalmˈente
scarcedad	skarsedˈad
du	dˈu
cancer	kansˈer
Premier	premjˈer
resa	rˈesa
contagia	kontˈaxja
padilanti	padilˈanti
Cachi	kˈat͡ʃi
riesgo	rjˈesɡo
nissan	nissˈaŋ
run	rˈuŋ
yama	jˈama
Turista	turˈista
aclarea	aklarˈea
Aparte	apˈarte
igualdad	iɡwaldˈad
Arutram	arutrˈam
vergunning	verɡunnˈinɡ
favorito	favorˈito
persigui	persˈiɡj
muestra	mwˈestra
augustus	auɡustˈus
subiendo	subjˈendo
contribui	kontribˈuj
Gold	ɡˈold
IT	ˈit
Entrante	entrˈante
Snor	snˈor
profundamente	profundamˈente
mundial	mundjˈal
baña	bˈaɲa
bahando	bahˈando
pronostico	pronostˈiko
carni	kˈarni
desespera	desespˈera
BBQ	bˌebˌekˈy
personal	personˈal
eventual	eventwˈal
cen	sˈeŋ
celebracion	selebrasjˈoŋ
contractonan	kontraktˈonan
embarazo	embarˈazo
cune	kˈune
Holding	holdˈinɡ
oracion	orasjˈoŋ
util	utˈil
motor	motˈor
encarcela	enkarsˈela
raspa	rˈaspa
asina	asˈina
encarecidamente	enkaresidamˈente
moda	mˈoda
TdQ	tˌedˈekˈy
cualnan	kwˈalnan
tawata	tawˈata
habri	hˈabri
taxistanan	taksistˈanan
normanan	normˈanan
funcionnan	funsjˈonnan
infeccionnan	infeksjˈonnan
debernan	debˈernan
plachi	plˈat͡ʃi
Boliviastraat	bolivjastrˈaːt
del	dˈel
limitacion	limitasjˈoŋ
foto	fˈoto
implementando	implementˈando
mangel	manxˈel
carera	karˈera
loteria	lotˈerja
Relaciona	relasjˈona
iresponsabel	iresponsabˈel
representacion	representasjˈoŋ
Caribbean	karibbeˈaŋ
quorum	kworˈum
exihi	eksˈihi
SOGA	sˈoɡa
instituto	institˈuto
pasashi	pasˈaʃi
Reyes	rejˈes
Dia	djˈa
market	markˈet
sanitizer	sanitizˈer
Mantene	mantˈene
Tjon	tjˈoŋ
Tur	tˈur
numbernan	numbˈernan
region	rexjˈoŋ
completo	komplˈeto
kiermeen	kjermˈeːŋ
mira	mˈira
tragedia	traxˈedja
reclama	reklˈama
humanidad	humanidˈad
escolar	eskolˈar
motivacion	motivasjˈoŋ
Pakico	pakˈiko
extraordinario	ekstraordinˈarjo
screen	skrˈeːŋ
juf	jˈuf
prestamonan	prestamˈonan
UAV	wˈav
palabracionnan	palabrasjˈonnan
anuncio	anˈunsjo
procede	prosˈede
Trump	trˈump
naci	nˈasi
line	lˈine
Jetblue	jˈetblwe
transferencianan	transferensjˈanan
Marina	marˈina
Speransa	sperˈansa
cabesante	kabesˈante
Scan	skˈaŋ
posible	posˈible
periodistico	perjodistˈiko
heridanan	heridˈanan
entrevista	entrevˈista
semper	sempˈer
Kamer	kamˈer
cantidad	kantidˈad
anualmente	anwalmˈente
notificacion	notifikasjˈoŋ
Reina	rˈe͡ɪna
bisindario	bisindˈarjo
violencia	vjolˈensja
buelo	bwˈelo
tarheta	tarhˈeta
Oro	ˈoro
rueda	rwˈeda
decoracion	dekorasjˈoŋ
medio	mˈedjo
area	arˈea
entiteit	entitˈe͡ɪt
limpi	lˈimpi
casualidad	kaswalidˈad
atacha	atˈat͡ʃa
Democratico	demokratˈiko
cuerpo	kwˈerpo
on	ˈoŋ
X	ˈɛks
Dios	djˈos
Voetbal	vutbˈal
cierre	sjˈerre
lamper	lampˈer
Impact	impˈakt
apelacion	apelasjˈoŋ
oraño	orˈaɲo
drumi	drˈumi
bisa	bˈisa
Sharina	ʃarˈina
conferencianan	konferensjˈanan
trend	trˈend
Hotel	hotˈel
mortal	mortˈal
legislativo	lexislatˈivo
protehi	protˈehi
dje	d͡ʒˈe
inespera	inespˈera
Embahada	embahˈada
mando	mˈando
esta	ˈesta
lihe	lˈihe
evalua	evˈalwa
Entertainment	enterta͡ɪnmˈent
Resultado	resultˈado
Bikker	bikkˈer
botter	bottˈer
Park	pˈark
socialista	sosjalˈista
immune	immˈune
touch	tˈowt͡ʃ
letter	lettˈer
Mr	ˌɛmˈɛr
Vallejo	vallˈejo
kitando	kitˈando
Afl	ˈafl
disciplina	dissiplˈina
ladronnan	ladrˈonnan
mi	mˈi
Nunca	nˈunka
presupuesto	presupwˈesto
yuinan	jˈujnan
platonan	platˈonan
problematica	problematˈika
Mesun	mesˈuŋ
sindicatonan	sindikatˈonan
decadanan	dekadˈanan
Fitch	fˈitt͡ʃ
Islanan	islˈanan
cuadro	kwˈadro
Keto	kˈeto
Metanan	metˈanan
colecta	kolˈekta
Plan	plˈaŋ
Liber	libˈer
relacion	relasjˈoŋ
baho	bˈaho
oradornan	oradˈornan
Seguro	seɡˈuro
temporadanan	temporadˈanan
experiencia	eksperjˈensja
carnaval	karnavˈal
disco	dˈisko
Back	bˈakk
security	sekurˈiti
komo	kˈomo
testing	testˈinɡ
afo	ˈafo
Con	kˈoŋ
Pecho	pˈet͡ʃo
One	ˈone
accesibel	aksesibˈel
cuartal	kwartˈal
mehorando	mehorˈando
sumario	sumˈarjo
Diferente	diferˈente
slow	slˈow
atrae	atrˈae
plaka	plˈaka
solucionnan	solusjˈonnan
Bushiri	buʃˈiri
energia	enˈerxja
Pavia	pˈavja
Latinoamerica	latinoamerˈika
òf	ˈɔf
Theater	theatˈer
primanan	primˈanan
tripulante	tripulˈante
VNO	vnˈo
fit	fˈit
Generalmente	xeneralmˈente
ham	hˈam
establecimentonan	establesimentˈonan
Cualkier	kwalkjˈer
minimalisa	minimalˈisa
trauma	traˈuma
trabou	trabˈow
Arubianismo	arubjanˈismo
Placa	plˈaka
riba	rˈiba
haber	habˈer
conseha	konsˈeha
administrativo	administratˈivo
Chiquito	t͡ʃikwˈito
acuerdonan	akwerdˈonan
escritor	eskritˈor
tan	tˈaŋ
Casibari	kasibˈari
prescribi	preskrˈibi
maestronan	maestrˈonan
regresa	reɡrˈesa
habilidad	habilidˈad
obhetivo	obhetˈivo
preparacionnan	preparasjˈonnan
call	kˈall
despues	despwˈes
negociacion	neɡosjasjˈoŋ
Hapon	hapˈoŋ
Sint	sˈint
cadena	kadˈena
el	ˈel
mentor	mentˈor
encargo	enkˈarɡo
spaño	spˈaɲo
Sindicatonan	sindikatˈonan
laptop	laptˈop
Minister	ministˈer
destructivo	destruktˈivo
molester	molestˈer
Paradera	paradˈera
erornan	erˈornan
haf	hˈaf
Seco	sˈeko
tokante	tokˈante
diamars	djamˈars
Esnan	ˈesnan
pronostica	pronostˈika
alivio	alˈivjo
seyo	sˈejo
finalisa	finalˈisa
silencio	silˈensjo
reino	rˈe͡ɪno
socio	sˈosjo
genera	xenˈera
parkeo	parkˈeo
diaranson	djaransˈoŋ
acompaña	akompˈaɲa
balance	balˈanse
resultado	resultˈado
corespondiente	korespondjˈente
entrena	entrˈena
Rapport	rappˈort
PPA	ppˈa
concientizacion	konsjentizasjˈoŋ
obtenibel	obtenibˈel
boternan	botˈernan
Ultimamente	ultimamˈente
suspenso	suspˈenso
mag	mˈaɡ
firme	fˈirme
new	nˈew
Dam	dˈam
convence	konvˈense
anda	ˈanda
relaha	relˈaha
Elements	elemˈents
Young	jˈownɡ
weganan	weɡˈanan
mire	mˈire
taira	tˈa͡ɪra
areanan	areˈanan
Rodenburg	rodenbˈurɡ
Jenny	jˈenni
sorpresa	sorprˈesa
Digital	dixitˈal
queda	kwˈeda
tools	tˈoːls
session	sessjˈoŋ
Pau	pˈau
preferiblemente	preferiblemˈente
provee	provˈeː
containernan	konta͡ɪnˈernan
cultiva	kultˈiva
consensus	konsensˈus
motociclista	motosiklˈista
forensico	forensˈiko
Island	islˈand
futuro	futˈuro
entregamento	entreɡamˈento
St	ˌɛstˈe
enormemente	enormemˈente
adelanto	adelˈanto
Concierto	konsjˈerto
moringa	morˈinɡa
compleho	komplˈeho
thee	thˈeː
comision	komisjˈoŋ
epicentro	episˈentro
favor	favˈor
coba	kˈoba
Valero	valˈero
Obama	obˈama
cabayero	kabajˈero
dignatario	diɡnatˈarjo
brindando	brindˈando
Coronel	koronˈel
anota	anˈota
cora	kˈora
heroe	hˈeru
nek	nˈek
Utrecht	utrˈet͡ʃt
Balentina	balentˈina
Sousa	sˈowsa
limite	limˈite
amigo	amˈiɡo
claim	klˈa͡ɪm
Algo	ˈalɡo
derota	derˈota
join	jˈojŋ
Unavez	unavˈez
ocasiona	okasjˈona
grill	ɡrˈill
Deportivo	deportˈivo
den	dˈeŋ
Belasting	belastˈinɡ
China	t͡ʃˈina
Flora	flˈora
instruccionnan	instruksjˈonnan
momentu	momˈentu
reforsa	refˈorsa
violacion	vjolasjˈoŋ
Online	onlˈine
Cuba	kˈuba
preocupacionan	preokupasjˈonan
comisionnan	komisjˈonnan
paraliza	paralˈiza
apela	apˈela
obhecion	obhesjˈoŋ
diesdos	djesdˈos
Monarch	monˈart͡ʃ
training	tra͡ɪnˈinɡ
pacient	pasjˈent
arte	ˈarte
Dicon	dikˈoŋ
gasta	ɡˈasta
nan	nˈaŋ
disturbio	distˈurbjo
agrega	aɡrˈeɡa
lectornan	lektˈornan
comparacion	komparasjˈoŋ
luganan	luɡˈanan
accentua	aksˈentwa
servicio	servˈisjo
mericano	merikˈano
relativamente	relativamˈente
Solamente	solamˈente
paar	pˈaːr
stroba	strˈoba
capitulo	kapitˈulo
Conhuntamente	konhuntamˈente
conclui	konklˈuj
Frontera	frontˈera
anterior	anterjˈor
avanza	avˈanza
entama	entˈama
safe	sˈafe
studiantenan	studjantˈenan
Arikok	arikˈok
lamenta	lamˈenta
detenshon	detenʃˈoŋ
Raymond	rajmˈond
For	fˈor
Instancia	instˈansja
mesun	mesˈuŋ
Arubano	arubˈano
vivienda	vivjˈenda
mustrando	mustrˈando
chance	t͡ʃˈanse
saca	sˈaka
flexibilisa	fleksibilˈisa
Actualmente	aktwalmˈente
PAHO	pˈaho
pafo	pˈafo
flaco	flˈako
higiene	hixjˈene
statuto	statˈuto
bieuw	bjˈeww
Mientrastanto	mjentrastˈanto
CEDE	sˈede
Dollar	dollˈar
Request	rekwˈest
meld	mˈeld
esencia	esˈensja
DJ	dˌejˈe
reforma	refˈorma
bisto	bˈisto
Blue	blwˈe
Paloma	palˈoma
debolbe	debˈolbe
Club	klˈub
historico	historˈiko
click	klˈikk
Pieters	pjetˈers
Maris	marˈis
jetBlue	jˈetblwˈe
behes	behˈes
SER	sˈer
constata	konstˈata
Pacifico	pasifˈiko
disculpa	diskˈulpa
Elite	elˈite
Carlton	karltˈoŋ
bombero	bombˈero
escala	eskˈala
ni	nˈi
kavel	kavˈel
masal	masˈal
cada	kˈada
kerstboom	kerstbˈoːm
Ling	lˈinɡ
sitio	sˈitjo
ken	kˈeŋ
Mercado	merkˈado
presentacionnan	presentasjˈonnan
Society	sosjˈeti
examen	eksamˈeŋ
roadservice	roadservˈise
sentra	sˈentra
claro	klˈaro
agencianan	axensjˈanan
obligacion	obliɡasjˈoŋ
berdaderamente	berdaderamˈente
pensa	pˈensa
literatura	literatˈura
opina	opˈina
tey	tˈej
the	thˈe
vacunanan	vakunˈanan
combina	kombˈina
determinante	determinˈante
stricto	strˈikto
Control	kontrˈol
pensando	pensˈando
Ey	ˈej
manipulacion	manipulasjˈoŋ
Wel	wˈel
American	amerikˈaŋ
forsa	fˈorsa
baila	bˈa͡ɪla
James	jamˈes
so	sˈo
zoom	zˈoːm
condicionnan	kondisjˈonnan
pinta	pˈinta
efectividad	efektividˈad
Amalia	amˈalja
stof	stˈof
accidente	aksidˈente
mastanto	mastˈanto
Unidad	unidˈad
pionero	pjonˈero
personanan	personˈanan
contagionan	kontaxjˈonan
respaldo	respˈaldo
agente	axˈente
instruccion	instruksjˈoŋ
Basora	basˈora
facil	fasˈil
kleuterschool	klewterst͡ʃˈoːl
NOS	nˈos
awe	ˈawe
hayanan	hajˈanan
dunamento	dunamˈento
Rotary	rotˈari
esencial	esensjˈal
gang	ɡˈanɡ
ofertanan	ofertˈanan
identificacion	identifikasjˈoŋ
nervioso	nervjˈoso
Thomas	thomˈas
pashent	paʃˈent
pre	prˈe
pesey	pesˈej
transaccionnan	transaksjˈonnan
deze	dˈeze
pacientnan	pasjˈentnan
districto	distrˈikto
merdia	mˈerdja
cabezante	kabezˈante
proclama	proklˈama
repatriacion	repatrjasjˈoŋ
OPPA	ˈoppa
Bestuur	bestˈyr
disciplinario	dissiplinˈarjo
cuando	kwˈando
Ritmo	rˈitmo
camaranan	kamarˈanan
vota	vˈota
Warda	wˈarda
preguntanan	preɡuntˈanan
Unda	ˈunda
delivery	delivˈeri
Kustwacht	kustwˈat͡ʃt
recicla	resˈikla
eta	ˈeta
sink	sˈink
pospone	pospˈone
Britanico	britanˈiko
registro	rexˈistro
colabora	kolabˈora
Hildward	hildwˈard
Crisis	krisˈis
cumindanan	kumindˈanan
biahero	bjahˈero
San	sˈaŋ
abogado	aboɡˈado
Officer	offisˈer
tèst	tˈɛst
indicadornan	indikadˈornan
Huridico	huridˈiko
con	kˈoŋ
ban	bˈaŋ
Star	stˈar
Diadomingo	djadomˈinɡo
prensa	prˈensa
boet	bˈut
Segun	seɡˈuŋ
populista	populˈista
t	tˈe
tim	tˈim
intenso	intˈenso
uni	ˈuni
sospechosonan	sospet͡ʃosˈonan
blauw	blaˈuw
resalta	resˈalta
restringi	restrˈinxi
fauna	faˈuna
supervisa	supervˈisa
asesina	asesˈina
Noka	nˈoka
Kleuterschool	klewterst͡ʃˈoːl
ahustacion	ahustasjˈoŋ
wayanan	wajˈanan
sero	sˈero
financia	finˈansja
honda	hˈonda
mentalidad	mentalidˈad
preocupa	preokˈupa
sucu	sˈuku
rednan	rˈednan
plaats	plˈaːts
cansancio	kansˈansjo
posibilidadnan	posibilidˈadnan
Step	stˈep
Williams	willjˈams
participa	partisˈipa
Otro	ˈotro
cubico	kubˈiko
scolnan	skˈolnan
Ehecutivo	ehekutˈivo
sobresali	sobresˈali
Asia	ˈasja
Interino	interˈino
destino	destˈino
afectando	afektˈando
encera	ensˈera
aprecio	aprˈesjo
uzo	ˈuzo
Reino	rˈe͡ɪno
ampliamente	ampljamˈente
ID	ˈid
conducta	kondˈukta
Mayor	majˈor
hoga	hˈoɡa
Black	blˈakk
Santo	sˈanto
trampa	trˈampa
confianza	konfjˈanza
cometi	komˈeti
metodo	metˈodo
empeño	empˈeɲo
barco	bˈarko
Consecuentemente	konsekwentemˈente
instala	instˈala
tabata	tabˈata
hefenan	hefˈenan
viaha	vjˈaha
Mansur	mansˈur
alegre	alˈeɡre
nuebe	nwˈebe
bij	bˈe͡ɪ
plachinan	plat͡ʃˈinan
carnet	karnˈet
primeramente	primeramˈente
beneficionan	benefisjˈonan
sperando	sperˈando
weekend	weːkˈend
traduci	tradˈusi
campaña	kampˈaɲa
rijnan	rˈe͡ɪnan
siendo	sjˈendo
luhoso	luhˈoso
azeta	azˈeta
conecta	konˈekta
abuso	abˈuso
tribi	trˈibi
accion	aksjˈoŋ
sangrando	sanɡrˈando
excelencia	eksselˈensja
riesga	rjˈesɡa
Integrity	inteɡrˈiti
boga	bˈoɡa
Censo	sˈenso
general	xenerˈal
proceduranan	prosedurˈanan
Staatsregeling	staːtsrexelˈinɡ
Iron	irˈoŋ
computer	komputˈer
Clarisca	klarˈiska
Gonzalo	ɡonzˈalo
Boneiru	bonˈe͡ɪru
Up	ˈup
desaroyonan	desarojˈonan
sonrisa	sonrˈisa
capa	kˈapa
provoca	provˈoka
iPad	ipˈad
omo	ˈomo
Sosten	sostˈeŋ
Droga	drˈoɡa
cumpli	kˈumpli
consumo	konsˈumo
habilidadnan	habilidˈadnan
indesea	indesˈea
trahadonan	trahadˈonan
firmamento	firmamˈento
DCA	dkˈa
clasificacion	klasifikasjˈoŋ
naturalmente	naturalmˈente
constructivo	konstruktˈivo
nota	nˈota
camber	kambˈer
campus	kampˈus
corectamente	korektamˈente
obligatoriamente	obliɡatorjamˈente
diversifica	diversifˈika
primi	prˈimi
Mediador	medjadˈor
Justicia	justˈisja
lema	lˈema
lansa	lˈansa
gasoline	ɡasolˈine
Eleccion	eleksjˈoŋ
mask	mˈask
admira	admˈira
Benchi	bˈent͡ʃi
especienan	espesjˈenan
Schloss	st͡ʃlˈoss
Health	heˈalth
boroto	borˈoto
welga	wˈelɡa
laborando	laborˈando
D	dˈe
contracto	kontrˈakto
Proyecto	projˈekto
bini	bˈini
unilateralmente	unilateralmˈente
poblacion	poblasjˈoŋ
urgente	urxˈente
Mangel	manxˈel
Participacion	partisipasjˈoŋ
relevante	relevˈante
suministro	suminˈistro
temanan	temˈanan
presupuestario	presupwestˈarjo
tuma	tˈuma
separacion	separasjˈoŋ
Directiva	direktˈiva
lantamento	lantamˈento
cuminsa	kumˈinsa
awacero	awasˈero
POREDmep	pˈoredmˈep
reduccion	reduksjˈoŋ
naturalesa	naturalˈesa
relacionnan	relasjˈonnan
labamento	labamˈento
netto	nˈetto
yora	jˈora
Silva	sˈilva
castigo	kastˈiɡo
raro	rˈaro
sushedad	suʃedˈad
Tera	tˈera
industrial	industrjˈal
fout	fˈowt
aan	ˈaːŋ
Yen	jˈeŋ
individualmente	individwalmˈente
sapato	sapˈato
Program	proɡrˈam
Evita	evˈita
neglisha	neɡlˈiʃa
comparti	kompˈarti
reputacion	reputasjˈoŋ
monitorea	monitorˈea
UNESCO	unˈesko
implica	implˈika
Partidonan	partidˈonan
hanja	hˈanja
kabel	kabˈel
mesa	mˈesa
Zika	zˈika
Wout	wˈowt
Hilton	hiltˈoŋ
Programa	proɡrˈama
deber	debˈer
anticipa	antisˈipa
promesanan	promesˈanan
duo	dwˈo
Prome	prˈome
revisa	revˈisa
zwaailicht	zwaːjlˈit͡ʃt
tanki	tˈanki
Tourism	towrˈism
Comunicacion	komunikasjˈoŋ
parcial	parsjˈal
LabHOH	lˈabhˈoh
gaba	ɡˈaba
MAVO	mˈavo
unabes	unabˈes
scirbi	ssˈirbi
siguiente	siɡjˈente
casi	kˈasi
Toque	tˈokwe
Britten	brittˈeŋ
adresa	adrˈesa
conosi	konˈosi
holo	hˈolo
nubianan	nubjˈanan
Siendo	sjˈendo
aprecia	aprˈesja
diario	djˈarjo
mientras	mjentrˈas
veredicto	veredˈikto
Federacion	federasjˈoŋ
Trafico	trafˈiko
agresivo	aɡresˈivo
paki	pˈaki
meneer	menˈeːr
Reclasering	reklaserˈinɡ
Rotterdam	rotterdˈam
imigracion	imiɡrasjˈoŋ
Theo	thˈeo
UTV	ˈutv
baki	bˈaki
MOT	mˈot
meimei	mˈe͡ɪme͡ɪ
lancha	lˈant͡ʃa
semi	sˈemi
Africa	afrˈika
mediante	medjˈante
Unabes	unabˈes
simbolonan	simbolˈonan
hubenil	hubenˈil
fini	fˈini
biaha	bjˈaha
Pa	pˈa
Impuesto	impwˈesto
strategico	stratexˈiko
tot	tˈot
Trahadornan	trahadˈornan
of	ˈof
propone	propˈone
Paris	parˈis
Mi	mˈi
lomba	lˈomba
ministernan	ministˈernan
De	dˈe
motiva	motˈiva
necesariamente	nesesarjamˈente
Pastor	pastˈor
prevencion	prevensjˈoŋ
kilo	kˈilo
baha	bˈaha
remarcabel	remarkabˈel
recuri	rekˈuri
planes	planˈes
celnan	sˈelnan
terorismo	terorˈismo
gradualmente	ɡradwalmˈente
cancela	kansˈela
pelicula	pelikˈula
Carlo	kˈarlo
competi	kompˈeti
bom	bˈom
hobennan	hobˈennan
bariga	barˈiɡa
exportacion	eksportasjˈoŋ
graduacion	ɡradwasjˈoŋ
locual	lokwˈal
tardansa	tardˈansa
claramente	klaramˈente
peaton	peatˈoŋ
acaso	akˈaso
Ata	ˈata
Informantenan	informantˈenan
dat	dˈat
sorprendi	sorprˈendi
Strategico	stratexˈiko
gremio	ɡrˈemjo
Tarabana	tarabˈana
sostene	sostˈene
Rasmijn	rasmˈe͡ɪŋ
Gamma	ɡˈamma
Roadservice	roadservˈise
parokia	parˈokja
awasero	awasˈero
listanan	listˈanan
huez	hwˈez
Derecho	derˈet͡ʃo
Lacle	lˈakle
keda	kˈeda
ciclista	siklˈista
ronda	rˈonda
impuesto	impwˈesto
Tour	tˈowr
instrumento	instrumˈento
Catiri	katˈiri
comprension	komprensjˈoŋ
Board	boˈard
satelite	satelˈite
Taxista	taksˈista
operando	operˈando
espantoso	espantˈoso
accent	aksˈent
bateria	batˈerja
vuelo	vwˈelo
Carolina	karolˈina
Companianan	kompanjˈanan
Miles	milˈes
Imelda	imˈelda
Turismo	turˈismo
entiero	entjˈero
Polis	polˈis
gasolin	ɡasolˈiŋ
Ambiente	ambjˈente
forza	fˈorza
mente	mˈente
Jeon	jeˈoŋ
Hotelnan	hotˈelnan
Drive	drˈive
cubo	kˈubo
compacto	kompˈakto
organizacion	orɡanizasjˈoŋ
cumprado	kumprˈado
cinema	sinˈema
Pronk	prˈonk
sensacion	sensasjˈoŋ
ahustacionnan	ahustasjˈonnan
spaar	spˈaːr
Xiomara	zjomˈara
radio	rˈadjo
mashinnan	maʃˈinnan
kap	kˈap
probablemente	probablemˈente
eligi	elˈixi
secura	sekˈura
Paramedico	paramedˈiko
Tara	tˈara
productonan	produktˈonan
sintomanan	sintomˈanan
Medico	medˈiko
te	tˈe
intensidad	intensidˈad
infantil	infantˈil
skerpi	skˈerpi
yudansa	judˈansa
consehero	konsehˈero
pagara	paɡˈara
paso	pˈaso
welo	wˈelo
bais	bˈa͡ɪs
autor	autˈor
ilustracion	ilustrasjˈoŋ
museo	musˈeo
Jurette	jurˈette
voor	vˈoːr
Policial	polisjˈal
FDA	fdˈa
pilarnan	pilˈarnan
inaceptable	inaseptˈable
presidi	presˈidi
Pasco	pˈasko
preocupacion	preokupasjˈoŋ
Shiribana	ʃiribˈana
pesei	pˈese͡ɪ
bebe	bˈebe
Bermudez	bermudˈez
democratico	demokratˈiko
herment	hermˈent
Momento	momˈento
campa	kˈampa
Palm	pˈalm
trahador	trahadˈor
temporalmente	temporalmˈente
bloki	blˈoki
asigna	asˈiɡna
Guillfred	ɡjllfrˈed
Hubert	hubˈert
contradictorio	kontradiktˈorjo
Cuna	kˈuna
kendenan	kendˈenan
ilegalidad	ileɡalidˈad
higienico	hixjenˈiko
enemigo	enemˈiɡo
fada	fˈada
Jennifer	jennifˈer
cyclista	siklˈista
Alaves	alavˈes
bari	bˈari
mokete	mokˈete
Bank	bˈank
Homber	hombˈer
Iran	irˈaŋ
garantiza	ɡarantˈiza
aerolineanan	aerolineˈanan
ruman	rumˈaŋ
wanta	wˈanta
SVOA	svˈoa
tabatin	tabatˈiŋ
enfatiza	enfatˈiza
Hulandesnan	hulandˈesnan
ofreci	ofrˈesi
cede	sˈede
TOB	tˈob
Prijs	prˈe͡ɪs
card	kˈard
Vitamina	vitamˈina
Kia	kjˈa
Suriname	surinˈame
entrante	entrˈante
resumen	resumˈeŋ
Taekwondo	taekwˈondo
decada	dekˈada
Cayman	kajmˈaŋ
Land	lˈand
salvaguardia	salvaɡwˈardja
Surnam	surnˈam
TDQ	tˌedˌekˈy
Turkia	tˈurkja
adecuado	adekwˈado
religioso	relixjˈoso
Es	ˈes
corda	kˈorda
kustwacht	kustwˈat͡ʃt
Debi	dˈebi
unidadnan	unidˈadnan
Desde	dˈesde
Zeewijk	zeːwˈe͡ɪk
pasahero	pasahˈero
Educacion	edukasjˈoŋ
vuurwerk	vyrwˈerk
cocaina	kokˈa͡ɪna
mey	mˈej
Pesei	pˈese͡ɪ
inventarisa	inventarˈisa
financieramente	finansjeramˈente
Bachelor	bat͡ʃelˈor
suavisa	swavˈisa
service	servˈise
agredi	aɡrˈedi
radical	radikˈal
mara	mˈara
facilmente	fasilmˈente
braza	brˈaza
materia	matˈerja
simpel	simpˈel
decreto	dekrˈeto
monitor	monitˈor
gusta	ɡˈusta
Autoridad	autoridˈad
Ministerraad	ministerrˈaːd
DirecTV	dirˈektˌevˈe
finaliza	finalˈiza
fisicamente	fisikamˈente
Kayak	kajˈak
Probablemente	probablemˈente
tellernan	tellˈernan
kiebra	kjˈebra
Alex	alˈeks
edad	edˈad
social	sosjˈal
hospitaliza	hospitalˈiza
Dellanire	dellanˈire
suspension	suspensjˈoŋ
FTA	ftˈa
Bijstand	be͡ɪstˈand
psicologo	psikolˈoɡo
recomendacionnan	rekomendasjˈonnan
plamando	plamˈando
oposicion	oposisjˈoŋ
escoge	eskˈoxe
Gomes	ɡomˈes
local	lokˈal
credibilidad	kredibilidˈad
Mavo	mˈavo
Maarten	maːrtˈeŋ
Restaurant	restaurˈant
calculacion	kalkulasjˈoŋ
nr	ˌɛnˈɛr
idea	idˈea
Linear	lineˈar
Temporada	temporˈada
Pabao	pabˈao
Brasil	brasˈil
Maneho	manˈeho
referente	referˈente
Kende	kˈende
OMS	ˈoms
amistadnan	amistˈadnan
unidad	unidˈad
Child	t͡ʃˈild
superior	superjˈor
suspende	suspˈende
Wit	wˈit
Monuments	monumˈents
Argentina	arxentˈina
rumornan	rumˈornan
Hulp	hˈulp
castiga	kastˈiɡa
kibra	kˈibra
altura	altˈura
cronico	kronˈiko
cordialmente	kordjalmˈente
margen	marxˈeŋ
reitera	re͡ɪtˈera
atende	atˈende
auto	aˈuto
academico	akademˈiko
toca	tˈoka
Cabesante	kabesˈante
rehabilitacion	rehabilitasjˈoŋ
Claro	klˈaro
occasion	okkasjˈoŋ
TV	tˌevˈe
atendi	atˈendi
varios	varjˈos
petrolero	petrolˈero
cua	kwˈa
live	lˈive
finansa	finˈansa
Locual	lokwˈal
Canada	kanˈada
shopping	ʃoppˈinɡ
norma	nˈorma
Hand	hˈand
liber	libˈer
nunca	nˈunka
instructor	instruktˈor
comercio	komˈersjo
efecto	efˈekto
transicion	transisjˈoŋ
naturalisacion	naturalisasjˈoŋ
modelo	modˈelo
canasta	kanˈasta
cubri	kˈubri
bien	bjˈeŋ
compromete	kompromˈete
La	lˈa
ploeg	plˈuɡ
dede	dˈede
actualisa	aktwalˈisa
Los	lˈos
elmar	elmˈar
trapi	trˈapi
husto	hˈusto
dibo	dˈibo
donjo	dˈonjo
evita	evˈita
bringamento	brinɡamˈento
reciente	resjˈente
orguyo	ˈorɡjo
Kock	kˈokk
Centro	sˈentro
BOB	bˈob
app	ˈapp
RIVM	rˈivm
tareanan	tareˈanan
inmediato	inmedjˈato
damnan	dˈamnan
tanta	tˈanta
Setar	setˈar
Kamp	kˈamp
preparacion	preparasjˈoŋ
ehempel	ehempˈel
Rijkswet	re͡ɪkswˈet
tamaño	tamˈaɲo
Ora	ˈora
hospeda	hospˈeda
participacion	partisipasjˈoŋ
Olsen	olsˈeŋ
conoci	konˈosi
Santa	sˈanta
waf	wˈaf
dado	dˈado
spart	spˈart
homenahe	homenˈahe
persona	persˈona
musico	musˈiko
evacua	evˈakwa
espacio	espˈasjo
Plat	plˈat
abusadornan	abusadˈornan
zink	zˈink
Banconan	bankˈonan
cura	kˈura
Cft	sˌeˌɛftˈe
conduci	kondˈusi
cupo	kˈupo
fructifero	fruktifˈero
refuerso	refwˈerso
brainstorming	bra͡ɪnstormˈinɡ
deporte	depˈorte
frontliners	frontlinˈers
porfabor	porfabˈor
empresanan	empresˈanan
Nunes	nunˈes
Medidanan	medidˈanan
Clinton	klintˈoŋ
piscador	piskadˈor
condena	kondˈena
Lorentzstraat	lorentzstrˈaːt
exito	eksˈito
extra	ˈekstra
ricibi	risˈibi
Nes	nˈes
Vos	vˈos
punto	pˈunto
scol	skˈol
conseheronan	konseherˈonan
APFA	ˈapfa
GDP	ɡˌedˌepˈe
seguramente	seɡuramˈente
shelter	ʃeltˈer
garantia	ɡarˈantja
respectivo	respektˈivo
casnan	kˈasnan
abao	abˈao
dependiente	dependjˈente
lapso	lˈapso
mal	mˈal
bashi	bˈaʃi
Caso	kˈaso
terminacion	terminasjˈoŋ
Gomez	ɡomˈez
camara	kamˈara
varia	vˈarja
posesion	posesjˈoŋ
automatisacion	automatisasjˈoŋ
reactivacion	reaktivasjˈoŋ
nifica	nifˈika
desde	dˈesde
cine	sˈine
suerte	swˈerte
organonan	orɡanˈonan
distingui	distˈinɡj
muhenan	muhˈenan
mescla	mˈeskla
Alarma	alˈarma
Persona	persˈona
Marinierskazerne	marinjerskazˈerne
inspira	inspˈira
Antillas	antillˈas
partnernan	partnˈernan
madruga	madrˈuɡa
TOQUE	tˈokwe
estafa	estˈafa
web	wˈeb
Jeep	jˈeːp
decision	desisjˈoŋ
Estadistica	estadistˈika
electronico	elektronˈiko
funciona	funsjˈona
Renaissance	rena͡ɪssˈanse
Nest	nˈest
reunion	rewnjˈoŋ
rumor	rumˈor
transitorio	transitˈorjo
uitkering	ujtkerˈinɡ
dushi	dˈuʃi
durante	durˈante
Rooi	rˈoːj
suplente	suplˈente
Irani	irˈani
Arte	ˈarte
adaptacion	adaptasjˈoŋ
acusa	akˈusa
President	presidˈent
salba	sˈalba
borchinan	bort͡ʃˈinan
status	statˈus
Japon	japˈoŋ
definitivo	definitˈivo
Haci	hˈasi
consehonan	konsehˈonan
opta	ˈopta
votadonan	votadˈonan
proyecto	projˈekto
perde	pˈerde
fiesta	fjˈesta
localidad	lokalidˈad
acta	ˈakta
gaña	ɡˈaɲa
premie	prˈemje
sobrevivencia	sobrevivˈensja
mande	mˈande
desagradable	desaɡradˈable
tienda	tjˈenda
mentornan	mentˈornan
corupto	korˈupto
alternativanan	alternativˈanan
boter	botˈer
Open	opˈeŋ
logico	loxˈiko
trainingnan	tra͡ɪnˈinɡnan
luz	lˈuz
silencia	silˈensja
carchinan	kart͡ʃˈinan
exactamente	eksaktamˈente
General	xenerˈal
papelnan	papˈelnan
brasa	brˈasa
Miembro	mjˈembro
policial	polisjˈal
condecoracion	kondekorasjˈoŋ
solucion	solusjˈoŋ
elementonan	elementˈonan
señor	seɲˈor
Atrobe	atrˈobe
alrededor	alrededˈor
depresion	depresjˈoŋ
Bou	bˈow
concerni	konsˈerni
grave	ɡrˈave
recorido	rekorˈido
down	dˈowŋ
Lounge	lˈownxe
interoga	interˈoɡa
tripulacion	tripulasjˈoŋ
FM	ˌɛfˈɛm
Specialmente	spesjalmˈente
obliga	oblˈiɡa
start	stˈart
Mimi	mˈimi
contribuyentenan	kontribujentˈenan
cas	kˈas
extremo	ekstrˈemo
clip	klˈip
jama	jˈama
MiSVb	miˌɛsvˌebˈe
vigilancia	vixilˈansja
Adicionalmente	adisjonalmˈente
siñamento	siɲamˈento
distincion	distinsjˈoŋ
Yaris	jarˈis
mercado	merkˈado
Mainta	mˈa͡ɪnta
defensa	defˈensa
excluyendo	eksklujˈendo
Centrum	sentrˈum
Bloomberg	bloːmbˈerɡ
airport	a͡ɪrpˈort
Mey	mˈej
precedente	presedˈente
Fiesta	fjˈesta
Hulandes	hulandˈes
argumenta	arɡumˈenta
incidentenan	insidentˈenan
Conrado	konrˈado
evitando	evitˈando
expertisio	ekspertˈisjo
Terminal	terminˈal
sesionnan	sesjˈonnan
tilda	tˈilda
horcan	horkˈaŋ
desconoci	deskonˈosi
FPNC	ˌɛfpˌeˌɛnsˈe
AAN	ˈaːŋ
diseña	disˈeɲa
monitoria	monitˈorja
Inmediatamente	inmedjatamˈente
hunto	hˈunto
Musica	musˈika
Comision	komisjˈoŋ
Sur	sˈur
prepara	prepˈara
delicado	delikˈado
Docentenan	dosentˈenan
Dowers	dowˈers
moneda	monˈeda
bril	brˈil
pabo	pˈabo
hancho	hˈant͡ʃo
rijkswet	re͡ɪkswˈet
sirbi	sˈirbi
Elmar	elmˈar
part	pˈart
Una	ˈuna
Ambulans	ambulˈans
fisico	fisˈiko
materno	matˈerno
fungi	fˈunxi
Salud	salˈud
cabey	kabˈej
Embahador	embahadˈor
Pone	pˈone
intercambio	interkˈambjo
Mundo	mˈundo
gram	ɡrˈam
Ivo	ˈivo
Eugene	ewxˈene
Interact	interˈakt
temporal	temporˈal
nombernan	nombˈernan
Convention	konventjˈoŋ
versa	vˈersa
Laboratorio	laboratˈorjo
mereci	merˈesi
Bus	bˈus
special	spesjˈal
Duna	dˈuna
listra	lˈistra
laman	lamˈaŋ
CEO	sˈeo
doctor	doktˈor
Sanchez	sant͡ʃˈez
Hendrik	hendrˈik
procesonan	prosesˈonan
Excellence	ekssellˈense
prima	prˈima
formularionan	formularjˈonan
Leoncita	leonsˈita
falta	fˈalta
por	pˈor
Planea	planˈea
teoria	teˈorja
Feliz	felˈiz
Mary	mˈari
Camacuri	kamakˈuri
yamando	jamˈando
mandando	mandˈando
crusa	krˈusa
lechi	lˈet͡ʃi
Awe	ˈawe
usuario	uswˈarjo
cunucu	kunˈuku
mensahe	mensˈahe
patras	patrˈas
autorizacion	autorizasjˈoŋ
POR	pˈor
composicion	komposisjˈoŋ
ICU	ˈiku
discusionnan	diskusjˈonnan
Ingles	inɡlˈes
honor	honˈor
informal	informˈal
suplica	suplˈika
Play	plˈaj
liher	lihˈer
dibiaha	dibjˈaha
trankilidad	trankilidˈad
systema	sistˈema
School	st͡ʃˈoːl
componente	komponˈente
secundario	sekundˈarjo
Financiamento	finansjamˈento
boluntariamente	boluntarjamˈente
Famia	fˈamja
castigonan	kastiɡˈonan
fayecidonan	fajesidˈonan
fresco	frˈesko
Bill	bˈill
ministerionan	ministerjˈonan
prizon	prizˈoŋ
PHP	pˌehˌapˈe
aparatonan	aparatˈonan
clarificacion	klarifikasjˈoŋ
clima	klˈima
bisiña	bisˈiɲa
puesto	pwˈesto
terminonan	terminˈonan
door	dˈoːr
defini	defˈini
overtime	overtˈime
permisonan	permisˈonan
hungador	hunɡadˈor
Paula	paˈula
DTI	dtˈi
comodo	komˈodo
specifica	spesifˈika
FLPD	ˌɛfˌɛlpˌedˈe
actividadnan	aktividˈadnan
show	ʃˈow
Empresa	emprˈesa
Kòrsou	kˈɔrsow
OM	ˈom
enfermeria	enfermˈerja
desayuno	desajˈuno
sancionnan	sansjˈonnan
Bao	bˈao
bario	bˈarjo
NVT	ˌɛnvˌetˈe
Baby	bˈabi
India	ˈindja
manifestacion	manifestasjˈoŋ
deteni	detˈeni
registracion	rexistrasjˈoŋ
Gaalen	ɡaːlˈeŋ
comproba	komprˈoba
Regreso	reɡrˈeso
Korea	korˈea
sin	sˈiŋ
Segundo	seɡˈundo
presente	presˈente
promedio	promˈedjo
wowo	wˈowo
psicologico	psikoloxˈiko
balente	balˈente
KPA	kpˈa
Academia	akadˈemja
funcionario	funsjonˈarjo
efectua	efˈektwa
Cuido	kˈujdo
hogar	hoɡˈar
probecho	probˈet͡ʃo
programa	proɡrˈama
previo	prˈevjo
papel	papˈel
Transporte	transpˈorte
remarke	remˈarke
congreso	konɡrˈeso
logo	lˈoɡo
Senado	senˈado
instrui	instrˈuj
Lenny	lˈenni
rekisito	rekisˈito
briya	brˈija
desicion	desisjˈoŋ
parkeerplaats	parkeːrplˈaːts
ARUBA	arˈuba
organizadornan	orɡanizadˈornan
ORANJESTAD	oranjestˈad
yui	jˈuj
CBS	sˌebˌeˈɛs
desvia	dˈesvja
takelwagen	takelwaxˈeŋ
yena	jˈena
culpable	kulpˈable
adicional	adisjonˈal
encuesta	enkwˈesta
ansiedad	ansjedˈad
baca	bˈaka
Queda	kwˈeda
VHF	vˌehˌaˈɛf
tactica	taktˈika
derecho	derˈet͡ʃo
tremendo	tremˈendo
Produccion	produksjˈoŋ
international	internatjonˈal
paramediconan	paramedikˈonan
futbol	futbˈol
trankilo	trankˈilo
parce	pˈarse
Eustatius	ewstatjˈus
facilidad	fasilidˈad
group	ɡrˈowp
inhusto	inhˈusto
situation	sitwatjˈoŋ
conexion	koneksjˈoŋ
Aña	ˈaɲa
afilia	afˈilja
temporario	temporˈarjo
asociacion	asosjasjˈoŋ
confia	kˈonfja
Prevencion	prevensjˈoŋ
repatria	repˈatrja
All	ˈall
Yarzagaray	jarzaɡarˈaj
habitante	habitˈante
cobranza	kobrˈanza
april	aprˈil
ganadornan	ɡanadˈornan
DRH	dˌeˌɛrhˈa
dicta	dˈikta
Productonan	produktˈonan
academia	akadˈemja
bureau	bureˈau
ba	bˈa
describi	deskrˈibi
conmemora	konmemˈora
Bloemond	blumˈond
Alzheimer	alzhe͡ɪmˈer
scrap	skrˈap
analiza	analˈiza
Den	dˈeŋ
interesnan	interˈesnan
adres	adrˈes
automatico	automatˈiko
dune	dˈune
Rodriguez	rodriɡˈez
espectaculo	espektakˈulo
cercano	serkˈano
riesgonan	rjesɡˈonan
Pais	pˈa͡ɪs
agradeci	aɡradˈesi
splicando	splikˈando
yude	jˈude
regulacion	reɡulasjˈoŋ
porshento	porʃˈento
altezza	altˈezza
zonanan	zonˈanan
vigor	viɡˈor
place	plˈase
informa	infˈorma
cena	sˈena
baseball	basebˈall
SKOA	skˈoa
aplauso	aplaˈuso
Cas	kˈas
Diamars	djamˈars
aden	adˈeŋ
Scolnan	skˈolnan
Obra	ˈobra
entusiasma	entusjˈasma
suficientemente	sufisjentemˈente
presidente	presidˈente
gigantesco	xiɡantˈesko
engrandece	enɡrandˈese
isla	ˈisla
Plaza	plˈaza
Organisacion	orɡanisasjˈoŋ
Telefon	telefˈoŋ
real	reˈal
armanan	armˈanan
dignidad	diɡnidˈad
ABC	ˈabk
Kong	kˈonɡ
pleita	plˈe͡ɪta
siglo	sˈiɡlo
Management	manaxemˈent
fuerte	fwˈerte
ladronicia	ladronˈisja
Ministernan	ministˈernan
productivo	produktˈivo
cualifica	kwalifˈika
ocho	ˈot͡ʃo
aire	ˈa͡ɪre
Danki	dˈanki
psychiater	psit͡ʃjatˈer
cana	kˈana
otronan	otrˈonan
aspectonan	aspektˈonan
expone	ekspˈone
concepto	konsˈepto
Cosecha	kosˈet͡ʃa
core	kˈore
pornada	pornˈada
Informacion	informasjˈoŋ
Arubig	arubˈiɡ
stabil	stabˈil
duda	dˈuda
biaheronan	bjaherˈonan
Mayornan	majˈornan
zijn	zˈe͡ɪŋ
monumentonan	monumentˈonan
votacion	votasjˈoŋ
manda	mˈanda
intension	intensjˈoŋ
Islands	islˈands
Tata	tˈata
cancion	kansjˈoŋ
Nathaly	nathˈali
Malesanan	malesˈanan
agilisa	axilˈisa
stakeholders	stakeholdˈers
DPS	dˌepˌeˈɛs
sucedido	susedˈido
colegio	kolˈexjo
sufriendo	sufrjˈendo
aworaki	aworˈaki
caha	kˈaha
ROPV	rˈopv
Rotaract	rotarˈakt
pico	pˈiko
dobla	dˈobla
placanan	plakˈanan
evaluando	evalwˈando
banda	bˈanda
Café	kafˈe
Super	supˈer
Newark	newˈark
fastioso	fastjˈoso
Ki	kˈi
Unico	unˈiko
oxigeno	oksixˈeno
realiza	realˈiza
PM	pˌeˈɛm
calor	kalˈor
LABHOH	labhˈoh
informantenan	informantˈenan
especie	espˈesje
Burger	burxˈer
consehabel	konsehabˈel
slip	slˈip
ook	ˈoːk
catastrofe	katastrˈofe
premionan	premjˈonan
dak	dˈak
stage	stˈaxe
legitimo	lexitˈimo
abase	abˈase
alerta	alˈerta
Medical	medikˈal
participantenan	partisipantˈenan
observador	observadˈor
Ben	bˈeŋ
bendi	bˈendi
scogi	skˈoxi
mail	mˈa͡ɪl
adverti	advˈerti
Force	fˈorse
humano	humˈano
odio	ˈodjo
rapidamente	rapidamˈente
estadistica	estadistˈika
prison	prisˈoŋ
discucion	diskusjˈoŋ
DWJZ	dˌewˌejˌezˈɛt
Laga	lˈaɡa
Internet	internˈet
esun	esˈuŋ
Jordan	jordˈaŋ
In	ˈiŋ
bondad	bondˈad
aserca	asˈerka
buskeda	buskˈeda
tradicion	tradisjˈoŋ
natacion	natasjˈoŋ
tosa	tˈosa
rango	rˈanɡo
shock	ʃˈokk
Matutino	matutˈino
mano	mˈano
ilegal	ileɡˈal
extranhero	ekstranhˈero
grandemente	ɡrandemˈente
boletin	boletˈiŋ
perdiendo	perdjˈendo
strategia	stratˈexja
avionnan	avjˈonnan
expo	ˈekspo
civico	sivˈiko
muher	muhˈer
trahadornan	trahadˈornan
C	sˈe
teritorio	teritˈorjo
Caracas	karakˈas
Kiermen	kjermˈeŋ
budget	budxˈet
Geerman	xeːrmˈaŋ
banco	bˈanko
fortalece	fortalˈese
Problema	problˈema
pasando	pasˈando
UPA	ˈupa
Ricardo	rikˈardo
surpasa	surpˈasa
Natural	naturˈal
anja	ˈanja
conference	konferˈense
Paisnan	pˈa͡ɪsnan
operadornan	operadˈornan
Prinses	prinsˈes
problema	problˈema
finansas	finansˈas
acceso	aksˈeso
blanco	blˈanko
ambiental	ambjentˈal
domina	domˈina
Chris	t͡ʃrˈis
double	dˈowble
United	unitˈed
portal	portˈal
RDA	rdˈa
desconfianza	deskonfjˈanza
acreditacion	akreditasjˈoŋ
testnan	tˈestnan
porfin	porfˈiŋ
domino	domˈino
telefon	telefˈoŋ
Bahamas	bahamˈas
Grace	ɡrˈase
individuo	indivˈidwo
Sasaki	sasˈaki
linea	linˈea
REOI	reˈoj
educativo	edukatˈivo
oktober	oktobˈer
principionan	prinsipjˈonan
data	dˈata
Naturalmente	naturalmˈente
emplea	emplˈea
factor	faktˈor
Mihor	mihˈor
Kabinet	kabinˈet
rekesitonan	rekesitˈonan
dinamismo	dinamˈismo
drasticamente	drastikamˈente
union	unjˈoŋ
elegi	elˈexi
concentra	konsˈentra
dispensacion	dispensasjˈoŋ
encurasha	enkurˈaʃa
hermentnan	hermˈentnan
intensivamente	intensivamˈente
leu	lˈew
experencia	eksperˈensja
pintura	pintˈura
activo	aktˈivo
teniendo	tenjˈendo
compasion	kompasjˈoŋ
stranhero	stranhˈero
scenarionan	ssenarjˈonan
artificial	artifisjˈal
Computer	komputˈer
steun	stˈewŋ
contenido	kontenˈido
Asociacion	asosjasjˈoŋ
huesped	hwespˈed
automobilistanan	automobilistˈanan
Innovation	innovatjˈoŋ
Wim	wˈim
SDG	ˌɛsdˌeɡˈe
bataya	batˈaja
Autobus	autobˈus
corte	kˈorte
molinanan	molinˈanan
saluda	salˈuda
Ruiz	rˈujz
PNA	pnˈa
conocimento	konosimˈento
London	londˈoŋ
excepcion	ekssepsjˈoŋ
proteha	protˈeha
reglanan	reɡlˈanan
Interno	intˈerno
algun	alɡˈuŋ
internacionalmente	internasjonalmˈente
percura	perkˈura
invitadonan	invitadˈonan
apertura	apertˈura
copia	kˈopja
Marlon	marlˈoŋ
famoso	famˈoso
number	numbˈer
pedofilia	pedofˈilja
bishitantenan	biʃitantˈenan
bisti	bˈisti
profundo	profˈundo
creativo	kreatˈivo
Richi	rˈit͡ʃi
Real	reˈal
BES	bˈes
auspicio	auspˈisjo
Koopmans	koːpmˈans
bulando	bulˈando
Joan	joˈaŋ
demostrando	demostrˈando
introduci	introdˈusi
agresion	aɡresjˈoŋ
Cola	kˈola
instancianan	instansjˈanan
cayendo	kajˈendo
Pesca	pˈeska
unanime	unanˈime
panico	panˈiko
paranda	parˈanda
maniobra	manjˈobra
ideanan	ideˈanan
Rocco	rˈokko
coregi	korˈexi
consumidor	konsumidˈor
departamentonan	departamentˈonan
desastroso	desastrˈoso
Thornton	thorntˈoŋ
comerciante	komersjˈante
direcion	diresjˈoŋ
coy	kˈoj
consideracion	konsiderasjˈoŋ
primordialmente	primordjalmˈente
Kawaiah	kawa͡ɪˈah
exterior	eksterjˈor
yiu	jjˈu
Helicopter	helikoptˈer
April	aprˈil
gritamento	ɡritamˈento
fast	fˈast
it	ˈit
rehabilita	rehabilˈita
fortifica	fortifˈika
Store	stˈore
serie	sˈerje
Latin	latˈiŋ
lus	lˈus
consumi	konsˈumi
Pueblo	pwˈeblo
speedboat	speːdboˈat
Renny	rˈenni
voluntarionan	voluntarjˈonan
Directie	dirˈektje
sinta	sˈinta
perfecto	perfˈekto
donacion	donasjˈoŋ
charlanan	t͡ʃarlˈanan
Intensivo	intensˈivo
comisario	komisˈarjo
recherchenan	ret͡ʃert͡ʃˈenan
subraya	subrˈaja
inscripcion	inskripsjˈoŋ
ATIA	ˈatja
alternativa	alternatˈiva
Zodiac	zodjˈak
cerando	serˈando
Abo	ˈabo
caotico	kaotˈiko
Haiti	hˈa͡ɪti
Hong	hˈonɡ
Scheepvaart	st͡ʃeːpvˈaːrt
cayente	kajˈente
bez	bˈez
aya	ˈaja
Frans	frˈans
Animal	animˈal
size	sˈize
biologico	bjoloxˈiko
supla	sˈupla
Tempo	tˈempo
atleta	atlˈeta
deal	deˈal
Hubentud	hubentˈud
exigencianan	eksixensjˈanan
candela	kandˈela
instalacionnan	instalasjˈonnan
Ordenansa	ordenˈansa
miembro	mjˈembro
virtual	virtwˈal
caos	kaˈos
enfoke	enfˈoke
reconoci	rekonˈosi
blokia	blˈokja
mehora	mehˈora
vacuna	vakˈuna
migracion	miɡrasjˈoŋ
yamada	jamˈada
cuestiona	kwestjˈona
Marisol	marisˈol
Hobennan	hobˈennan
poder	podˈer
boei	bˈuj
Dr	dˌeˈɛr
cruza	krˈuza
payaso	pajˈaso
holoshi	holˈoʃi
First	fˈirst
comite	komˈite
prohimo	prohˈimo
Grant	ɡrˈant
dato	dˈato
comprende	komprˈende
territorial	territorjˈal
supletorio	supletˈorjo
base	bˈase
Berdad	berdˈad
Dangui	dˈanɡj
autobus	autobˈus
señalnan	seɲˈalnan
Takelwagen	takelwaxˈeŋ
universidad	universidˈad
Kranwinkel	kranwinkˈel
edicion	edisjˈoŋ
periodista	perjodˈista
Medio	mˈedjo
ciruhano	siruhˈano
Cruz	krˈuz
intensifica	intensifˈika
Saladin	saladˈiŋ
Lampe	lˈampe
hacie	hˈasje
Texier	teksjˈer
oral	orˈal
APP	ˈapp
conhuntamente	konhuntamˈente
Abuse	abˈuse
via	vjˈa
tip	tˈip
Rescate	reskˈate
memoria	memˈorja
placer	plasˈer
Loonsubsidie	loːnsubsˈidje
Depresion	depresjˈoŋ
purba	pˈurba
prueba	prwˈeba
perhudica	perhudˈika
filma	fˈilma
Go	ɡˈo
miles	milˈes
mercadonan	merkadˈonan
igual	iɡwˈal
opositornan	opositˈornan
inclusivo	inklusˈivo
desconecta	deskonˈekta
muestranan	mwestrˈanan
districtonan	distriktˈonan
integridad	inteɡridˈad
ocaciona	okasjˈona
subidanan	subidˈanan
Politie	polˈitje
fecha	fˈet͡ʃa
Hooyboer	hoːjbˈur
mandato	mandˈato
inhustamente	inhustamˈente
aumento	aumˈento
Endy	ˈendi
restructuracion	restrukturasjˈoŋ
beneficia	benefˈisja
februari	febrwˈari
profundidad	profundidˈad
Energia	enˈerxja
meter	metˈer
Sinembargo	sinembˈarɡo
page	pˈaxe
miyonario	mijonˈarjo
suela	swˈela
agenda	axˈenda
Parti	pˈarti
PPS	pˌepˌeˈɛs
cos	kˈos
preferi	prefˈeri
castigabel	kastiɡabˈel
ok	ˈok
raportahe	raportˈahe
descuido	deskˈujdo
concentracion	konsentrasjˈoŋ
Papaya	papˈaja
Awo	ˈawo
WTO	wtˈo
Delivery	delivˈeri
speed	spˈeːd
dianan	djˈanan
Happy	hˈappi
voorzitter	voːrzittˈer
empeora	empeˈora
poniendo	ponjˈendo
beneficioso	benefisjˈoso
piloto	pilˈoto
mitiga	mitˈiɡa
Gino	xˈino
resolve	resˈolve
Peru	pˈeru
indirectamente	indirektamˈente
Puerto	pwˈerto
Airport	a͡ɪrpˈort
universidadnan	universidˈadnan
protegi	protˈexi
bar	bˈar
cambio	kˈambjo
Al	ˈal
Rancho	rˈant͡ʃo
Dance	dˈanse
debenan	debˈenan
verboden	verbodˈeŋ
cliente	kljˈente
pakete	pakˈete
grado	ɡrˈado
conceptonan	konseptˈonan
appel	appˈel
IMF	ˈimf
trabao	trabˈao
autoridadnan	autoridˈadnan
yen	jˈeŋ
temponan	tempˈonan
Si	sˈi
echo	ˈet͡ʃo
pagado	paɡˈado
Give	xˈive
diferencia	diferˈensja
consultanan	konsultˈanan
emisora	emisˈora
tereno	terˈeno
Solutions	solutjˈons
maltrato	maltrˈato
confidencial	konfidensjˈal
etica	etˈika
Douane	dowˈane
incinerator	insineratˈor
muchanan	mut͡ʃˈanan
alabes	alabˈes
no	nˈo
hustamente	hustamˈente
convoca	konvˈoka
Patruya	patrˈuja
DI	dˈi
revision	revisjˈoŋ
kwihi	kwˈihi
up	ˈup
evaluacion	evalwasjˈoŋ
complice	komplˈise
Investigacion	investiɡasjˈoŋ
sino	sˈino
Tienda	tjˈenda
prefera	prefˈera
adaptacionnan	adaptasjˈonnan
biahe	bjˈahe
oponente	oponˈente
Henriquez	henrikwˈez
competente	kompetˈente
liña	lˈiɲa
principio	prinsˈipjo
quizas	kwizˈas
AUA	ˈawa
train	trˈa͡ɪŋ
aunque	aˈunkwe
Choller	t͡ʃollˈer
consenshi	konsˈenʃi
doloroso	dolorˈoso
contacta	kontˈakta
Malmok	malmˈok
segundo	seɡˈundo
vigilando	vixilˈando
adelante	adelˈante
bandona	bandˈona
fotografia	fotoɡrˈafja
midi	mˈidi
avisa	avˈisa
legal	leɡˈal
aparece	aparˈese
Pfizer	pfizˈer
Ruth	rˈuth
mocion	mosjˈoŋ
noble	nˈoble
Riba	rˈiba
castigable	kastiɡˈable
hora	hˈora
paketenan	paketˈenan
peor	peˈor
Alberto	albˈerto
Airbus	a͡ɪrbˈus
fundador	fundadˈor
Conchi	kˈont͡ʃi
burachi	burˈat͡ʃi
abordo	abˈordo
pool	pˈoːl
locura	lokˈura
podernan	podˈernan
fix	fˈiks
privacidad	privasidˈad
usual	uswˈal
mision	misjˈoŋ
preto	prˈeto
miho	mˈiho
titula	titˈula
preferencia	preferˈensja
stop	stˈop
hogarnan	hoɡˈarnan
eyriba	ejrˈiba
detaya	detˈaja
moratorio	moratˈorjo
sentimentonan	sentimentˈonan
scuchando	skut͡ʃˈando
familiar	familjˈar
Bernadina	bernadˈina
Hassell	hassˈell
Kisas	kisˈas
Democracia	demokrˈasja
baby	bˈabi
hefe	hˈefe
Nort	nˈort
Isla	ˈisla
edicionnan	edisjˈonnan
etc	ˈetk
segunda	seɡˈunda
reina	rˈe͡ɪna
MP	ˌɛmpˈe
Casnan	kˈasnan
natural	naturˈal
Financia	finˈansja
asegura	aseɡˈura
yega	jˈeɡa
strobando	strobˈando
noticia	notˈisja
speranza	sperˈanza
adelanta	adelˈanta
posibel	posibˈel
supuestamente	supwestamˈente
completa	komplˈeta
Huis	hˈujs
saludabel	saludabˈel
intencion	intensjˈoŋ
productor	produktˈor
asesinato	asesinˈato
grandi	ɡrˈandi
ami	ˈami
Ronella	ronˈella
remedi	remˈedi
dao	dˈao
intacto	intˈakto
clientenan	kljentˈenan
avansa	avˈansa
webo	wˈebo
dialogo	djalˈoɡo
Situacion	sitwasjˈoŋ
Koningstraat	koninɡstrˈaːt
cientifico	sjentifˈiko
afortunadamente	afortunadamˈente
Hose	hˈose
criteria	kritˈerja
conocemento	konosemˈento
Happiness	happinˈess
Pasa	pˈasa
gusto	ɡˈusto
Chevrolet	t͡ʃevrolˈet
Riu	rjˈu
hazaña	hazˈaɲa
Uno	ˈuno
departamento	departamˈento
ALV	ˈalv
dor	dˈor
descuento	deskwˈento
Husticia	hustˈisja
mascotanan	maskotˈanan
revolver	revolvˈer
robez	robˈez
fabuloso	fabulˈoso
proposito	proposˈito
desordo	desˈordo
lastima	lastˈima
Besaril	besarˈil
autorisacion	autorisasjˈoŋ
prominente	prominˈente
Company	kompˈani
Constantemente	konstantemˈente
festivo	festˈivo
Brazil	brazˈil
matrimonio	matrimˈonjo
Hato	hˈato
panel	panˈel
cobertura	kobertˈura
cay	kˈaj
misanan	misˈanan
abierto	abjˈerto
Innovacion	innovasjˈoŋ
tristo	trˈisto
Corupcion	korupsjˈoŋ
minuut	minˈyt
ofishi	ofˈiʃi
recomendabel	rekomendabˈel
salo	sˈalo
Knops	knˈops
cahanan	kahˈanan
grabacion	ɡrabasjˈoŋ
explosivo	eksplosˈivo
SPO	spˈo
electrico	elektrˈiko
temperatura	temperatˈura
alinea	alinˈea
escrito	eskrˈito
ela	ˈela
importa	impˈorta
Donald	donˈald
incidental	insidentˈal
Oranje	orˈanje
Complex	komplˈeks
estricto	estrˈikto
formalisa	formalˈisa
malisimo	malisˈimo
Integracion	inteɡrasjˈoŋ
Resiliente	resiljˈente
tristeza	tristˈeza
ilegalnan	ileɡˈalnan
beneficio	benefˈisjo
reconocimento	rekonosimˈento
PIN	pˈiŋ
infecta	infˈekta
mexicano	meksikˈano
HAVO	hˈavo
conservacion	konservasjˈoŋ
organisacionan	orɡanisasjˈonan
acelera	aselˈera
Groot	ɡrˈoːt
fondo	fˈondo
sexualmente	sekswalmˈente
rasa	rˈasa
restaurant	restaurˈant
estilo	estˈilo
soño	sˈoɲo
Debe	dˈebe
Shailiny	ʃa͡ɪlˈini
detene	detˈene
tankinan	tankˈinan
enfrentando	enfrentˈando
biblioteca	bibljotˈeka
Falta	fˈalta
grandinan	ɡrandˈinan
biniendo	binjˈendo
creencia	krˈeːnsja
skirbi	skˈirbi
Prof	prˈof
resisti	resˈisti
opinionnan	opinjˈonnan
continua	kontˈinwa
dialuna	djalˈuna
actornan	aktˈornan
APA	ˈapa
comprobante	komprobˈante
riñon	riɲˈoŋ
Kort	kˈort
Cacho	kˈat͡ʃo
Celebracion	selebrasjˈoŋ
ripara	ripˈara
KvK	kˌavˈekˈa
negocia	neɡˈosja
Papa	pˈapa
tradicional	tradisjonˈal
Candelaria	kandelˈarja
BNA	bnˈa
Agencia	axˈensja
Francisco	fransˈisko
News	nˈews
horizonte	horizˈonte
recursonan	rekursˈonan
DAO	dˈao
Bombero	bombˈero
Oranjestad	oranjestˈad
Juan	jwˈaŋ
Rey	rˈej
Gobernacion	ɡobernasjˈoŋ
Inspector	inspektˈor
sospecho	sospˈet͡ʃo
entregando	entreɡˈando
Pabien	pabjˈeŋ
maltratando	maltratˈando
Siguiendo	siɡjˈendo
hisa	hˈisa
aplicabel	aplikabˈel
DIARIO	djˈarjo
tratando	tratˈando
IBIS	ibˈis
scan	skˈaŋ
rico	rˈiko
central	sentrˈal
hermana	hermˈana
seccionnan	seksjˈonnan
recoge	rekˈoxe
Formacion	formasjˈoŋ
kehonan	kehˈonan
BO	bˈo
Hende	hˈende
porvenir	porvenˈir
terapia	terˈapja
oficinanan	ofisinˈanan
wega	wˈeɡa
Mescos	meskˈos
servicionan	servisjˈonan
ASTEC	astˈek
edadnan	edˈadnan
pues	pwˈes
separa	sepˈara
Rekenkamer	rekenkamˈer
WEB	wˈeb
permiti	permˈiti
Arubadag	arubadˈaɡ
pashentnan	paʃˈentnan
Stichting	stit͡ʃtˈinɡ
SLM	ˌɛsˌɛlˈɛm
Romano	romˈano
Pues	pwˈes
Lid	lˈid
manual	manwˈal
cultura	kultˈura
profila	profˈila
cambia	kˈambja
gana	ɡˈana
oro	ˈoro
Juffrouw	juffrˈoww
Bucuti	bukˈuti
mensahenan	mensahˈenan
djis	d͡ʒˈis
top	tˈop
mln	ˌɛmˌɛlˈɛn
renoba	renˈoba
atras	atrˈas
cautela	kautˈela
implementacion	implementasjˈoŋ
acusacion	akusasjˈoŋ
postkantoor	postkantˈoːr
Nota	nˈota
pendiente	pendjˈente
evidente	evidˈente
graba	ɡrˈaba
sostenibilidad	sostenibilidˈad
asientonan	asjentˈonan
protega	protˈeɡa
worde	wˈorde
Interest	interˈest
inicialmente	inisjalmˈente
Recherche	ret͡ʃˈert͡ʃe
EPB	ˈepb
misterio	mistˈerjo
psycologo	psikolˈoɡo
informenan	informˈenan
sufri	sˈufri
pensioen	pensjˈuŋ
UNOCA	unˈoka
sentimento	sentimˈento
plamamento	plamamˈento
Caribense	karibˈense
slachtofferhulp	slat͡ʃtofferhˈulp
Dilanti	dilˈanti
benidero	benidˈero
tratamento	tratamˈento
los	lˈos
version	versjˈoŋ
patruyando	patrujˈando
Rodgers	rodxˈers
rosea	rosˈea
Haseth	hasˈeth
devastador	devastadˈor
Retiro	retˈiro
casinonan	kasinˈonan
Venezolanonan	venezolanˈonan
traspasa	traspˈasa
LG	ˌɛlɡˈe
acostumbrado	akostumbrˈado
multiple	multˈiple
DIA	djˈa
FMTB	ˌɛfˌɛmtˌebˈe
aspira	aspˈira
ratifica	ratifˈika
florece	florˈese
insiguridad	insiɡuridˈad
Sta	stˈa
credit	kredˈit
Rijbewijs	re͡ɪbewˈe͡ɪs
materialnan	materjˈalnan
ridiculo	ridikˈulo
cantica	kantˈika
priva	prˈiva
Candela	kandˈela
Nature	natˈure
cumbre	kˈumbre
cordial	kordjˈal
trabaonan	trabaˈonan
frecuenta	frekwˈenta
bida	bˈida
intermedia	intermˈedja
rek	rˈek
bati	bˈati
comporta	kompˈorta
procedimento	prosedimˈento
arubiano	arubjˈano
Finansa	finˈansa
Zr	zˌɛtˈɛr
Total	totˈal
IPA	ˈipa
CoronaVirus	korˈonavirˈus
inversionnan	inversjˈonnan
funcionamento	funsjonamˈento
Number	numbˈer
Tours	tˈowrs
fuseer	fusˈeːr
Interior	interjˈor
refugio	refˈuxjo
declaracionnan	deklarasjˈonnan
hopi	hˈopi
rij	rˈe͡ɪ
digitalisa	dixitalˈisa
empuhe	empˈuhe
pregunta	preɡˈunta
zuid	zˈujd
mayoria	majˈorja
maluza	malˈuza
Entretanto	entretˈanto
subsidio	subsˈidjo
dr	dˌeˈɛr
ADR	ˈadr
Militair	militˈa͡ɪr
incansabel	inkansabˈel
Nada	nˈada
Logicamente	loxikamˈente
respalda	respˈalda
rondo	rˈondo
ED	ˈed
detayes	detajˈes
acuerdo	akwˈerdo
bingo	bˈinɡo
aumentando	aumentˈando
participando	partisipˈando
decente	desˈente
vacatura	vakatˈura
negoshi	neɡˈoʃi
abusado	abusˈado
laboratorionan	laboratorjˈonan
Aduana	adwˈana
sifuera	sifwˈera
debe	dˈebe
cabez	kabˈez
CPR	sˌepˌeˈɛr
cabando	kabˈando
carta	kˈarta
emergencia	emerxˈensja
parke	pˈarke
Contact	kontˈakt
paga	pˈaɡa
cuida	kˈujda
simannan	simˈannan
emiti	emˈiti
open	opˈeŋ
lidera	lidˈera
Como	kˈomo
Van	vˈaŋ
par	pˈar
posecion	posesjˈoŋ
Comandante	komandˈante
spiritual	spiritwˈal
Su	sˈu
Jade	jˈade
campañanan	kampaɲˈanan
laat	lˈaːt
atencion	atensjˈoŋ
Samsung	samsˈunɡ
wak	wˈak
atracador	atrakadˈor
WOW	wˈow
Comunidad	komunidˈad
bringa	brˈinɡa
detaye	detˈaje
mascota	maskˈota
RST	ˌɛrˌɛstˈe
decreta	dekrˈeta
KYPA	kˈipa
angulo	anɡˈulo
Cumana	kumˈana
comun	komˈuŋ
DEA	dˈea
Karibe	karˈibe
desafionan	desafjˈonan
saldo	sˈaldo
stap	stˈap
pica	pˈika
Promer	promˈer
spiel	spjˈel
inspiracion	inspirasjˈoŋ
gradua	ɡrˈadwa
coleccion	koleksjˈoŋ
encaso	enkˈaso
Otronan	otrˈonan
pazuid	pazˈujd
certifica	sertifˈika
hygiena	hixjˈena
caro	kˈaro
dienst	djˈenst
imagennan	imaxˈennan
paradanan	paradˈanan
identifica	identifˈika
Wardacosta	wardakˈosta
reformanan	reformˈanan
surplus	surplˈus
Velasquez	velaskwˈez
probecha	probˈet͡ʃa
Dunadornan	dunadˈornan
transmission	transmissjˈoŋ
factornan	faktˈornan
aparentemente	aparentemˈente
indefini	indefˈini
Shanayah	ʃanajˈah
detecta	detˈekta
anti	ˈanti
productornan	produktˈornan
andando	andˈando
Plenipotenciario	plenipotensjˈarjo
Paskel	paskˈel
caidanan	ka͡ɪdˈanan
Cabai	kˈaba͡ɪ
populacion	populasjˈoŋ
Flip	flˈip
afspraak	afsprˈaːk
Jan	jˈaŋ
sostenibel	sostenibˈel
Frido	frˈido
aki	ˈaki
Weg	wˈeɡ
eficaz	efikˈaz
muraya	murˈaja
hayando	hajˈando
modo	mˈodo
ganador	ɡanadˈor
Casino	kasˈino
Smith	smˈith
musical	musikˈal
radar	radˈar
scenario	ssenˈarjo
Marchena	mart͡ʃˈena
vacunacion	vakunasjˈoŋ
Paramediconan	paramedikˈonan
tolera	tolˈera
nace	nˈase
laboral	laborˈal
circulo	sirkˈulo
bastante	bastˈante
Derechonan	deret͡ʃˈonan
puntra	pˈuntra
fuel	fwˈel
prome	prˈome
agradecido	aɡradesˈido
Parce	pˈarse
digitalisacion	dixitalisasjˈoŋ
posicionnan	posisjˈonnan
derechonan	deret͡ʃˈonan
tende	tˈende
Beatrix	beatrˈiks
vulnerable	vulnerˈable
specialista	spesjalˈista
cuidadano	kujdadˈano
huy	hˈuj
usuarionan	uswarjˈonan
Partido	partˈido
asistencia	asistˈensja
difamacion	difamasjˈoŋ
Sero	sˈero
helpdesk	helpdˈesk
confiansa	konfjˈansa
netamente	netamˈente
cayanan	kajˈanan
hinca	hˈinka
Commissie	kommˈissje
palabranan	palabrˈanan
restante	restˈante
veld	vˈeld
SVGA	svɡˈa
creditornan	kreditˈornan
prohibicion	prohibisjˈoŋ
Award	awˈard
gerencia	xerˈensja
Place	plˈase
rate	rˈate
Schakel	st͡ʃakˈel
solidaridad	solidaridˈad
Relacionnan	relasjˈonnan
Ainda	ˈa͡ɪnda
pagina	paxˈina
Finansas	finansˈas
Politiconan	politikˈonan
regio	rˈexjo
Arashi	arˈaʃi
costonan	kostˈonan
Reclassering	reklasserˈinɡ
Toch	tˈot͡ʃ
distancia	distˈansja
alumnonan	alumnˈonan
Landsrecherche	landsret͡ʃˈert͡ʃe
Entiteit	entitˈe͡ɪt
alegria	alˈeɡrja
sex	sˈeks
stagna	stˈaɡna
eerste	ˈeːrste
carteranan	karterˈanan
Tecnologia	teknolˈoxja
herida	herˈida
lista	lˈista
nort	nˈort
encabesa	enkabˈesa
rementa	remˈenta
resta	rˈesta
Illes	illˈes
sera	sˈera
Walk	wˈalk
Toezicht	tuzˈit͡ʃt
fayecimento	fajesimˈento
regreso	reɡrˈeso
IPKO	ˈipko
CITGO	sˈitɡo
investigando	investiɡˈando
Little	lˈittle
eseynan	esˈejnan
consequencia	konsekwˈensja
atrasa	atrˈasa
Digicel	dixisˈel
Maestro	maˈestro
Sostenibel	sostenibˈel
bankroet	bankrˈut
Patrick	patrˈikk
helicopter	helikoptˈer
dedica	dedˈika
ponencianan	ponensjˈanan
impedi	impˈedi
Rampenbestrijding	rampenbestre͡ɪdˈinɡ
regarda	reɡˈarda
rondona	rondˈona
florin	florˈiŋ
sincero	sinsˈero
Condecoracion	kondekorasjˈoŋ
briyante	brijˈante
Trabao	trabˈao
atrapa	atrˈapa
publicacionnan	publikasjˈonnan
Gradus	ɡradˈus
rabo	rˈabo
transportacion	transportasjˈoŋ
sinceridad	sinseridˈad
ambtenaarnan	ambtenˈaːrnan
Town	tˈowŋ
dinamico	dinamˈiko
tumando	tumˈando
referi	refˈeri
mall	mˈall
stuur	stˈyr
risiconan	risikˈonan
Habitantenan	habitantˈenan
seleccion	seleksjˈoŋ
rehen	rehˈeŋ
kWh	kˈawˌehˈa
cauteloso	kautelˈoso
Tevreden	tevredˈeŋ
combustibel	kombustibˈel
kibrando	kibrˈando
Anochi	anˈot͡ʃi
box	bˈoks
sunu	sˈunu
legalisa	leɡalˈisa
yudabo	judˈabo
inkietud	inkjetˈud
variacion	varjasjˈoŋ
link	lˈink
board	boˈard
propietario	propjetˈarjo
Esakinan	esakˈinan
Benny	bˈenni
Guarda	ɡwˈarda
representando	representˈando
tension	tensjˈoŋ
adhunto	adhˈunto
ceramento	seramˈento
cube	kˈube
Curacao	kurakˈao
pantaya	pantˈaja
golpi	ɡˈolpi
Rutte	rˈutte
reglamentonan	reɡlamentˈonan
Poco	pˈoko
reparticion	repartisjˈoŋ
Do	dˈo
Finalisando	finalisˈando
Agricultura	aɡrikultˈura
sushi	sˈuʃi
VBA	vbˈa
combinacion	kombinasjˈoŋ
Janine	janˈine
distribui	distribˈuj
bishitando	biʃitˈando
hincamento	hinkamˈento
zwaai	zwˈaːj
insinua	insˈinwa
adapta	adˈapta
Best	bˈest
Wilhelminastraat	wilhelminastrˈaːt
pata	pˈata
sigura	siɡˈura
stimula	stimˈula
Teritorial	teritorjˈal
investigacionnan	investiɡasjˈonnan
Lanta	lˈanta
nivel	nivˈel
splica	splˈika
Andin	andˈiŋ
minuutnan	minˈytnan
Siman	simˈaŋ
vuelonan	vwelˈonan
identidad	identidˈad
diki	dˈiki
boluntad	boluntˈad
ehecutivo	ehekutˈivo
lote	lˈote
Blvd	bˌeˌɛlvˌedˈe
visa	vˈisa
rescate	reskˈate
contrae	kontrˈae
actividad	aktividˈad
bruin	brˈujŋ
reemplaza	reːmplˈaza
cumpra	kˈumpra
Instagram	instaɡrˈam
Considerando	konsiderˈando
invalido	invalˈido
hari	hˈari
curason	kurasˈoŋ
muha	mˈuha
Luanne	lwˈanne
Americas	amerikˈas
Openbare	openbˈare
Zeeland	zeːlˈand
Finalmente	finalmˈente
solamente	solamˈente
Ford	fˈord
Guardacosta	ɡwardakˈosta
capta	kˈapta
condolencia	kondolˈensja
sticker	stikkˈer
independiente	independjˈente
patronchi	patrˈont͡ʃi
planeta	planˈeta
lora	lˈora
kima	kˈima
choller	t͡ʃollˈer
awo	ˈawo
plannan	plˈannan
Myron	mirˈoŋ
Percura	perkˈura
uzando	uzˈando
proximo	proksˈimo
tocante	tokˈante
Djis	d͡ʒˈis
share	ʃˈare
origina	orixˈina
huiswerk	hujswˈerk
Bureau	bureˈau
Andre	ˈandre
mundo	mˈundo
background	bakkɡrˈownd
sker	skˈer
simanan	simˈanan
Safety	safˈeti
capita	kapˈita
Barcadera	barkadˈera
dosis	dosˈis
pensamento	pensamˈento
reuni	rˈewni
Ma	mˈa
familiarnan	familjˈarnan
diplomatico	diplomatˈiko
reconoce	rekonˈose
Lab	lˈab
criterianan	kriterjˈanan
Roland	rolˈand
beslag	beslˈaɡ
Lantamento	lantamˈento
Piet	pjˈet
bala	bˈala
Klabér	klabˈer
centronan	sentrˈonan
Grand	ɡrˈand
Defensie	defˈensje
posicion	posisjˈoŋ
Bienestar	bjenestˈar
inflacion	inflasjˈoŋ
razon	razˈoŋ
destaho	destˈaho
flexibilizacion	fleksibilizasjˈoŋ
depende	depˈende
Expertonan	ekspertˈonan
November	novembˈer
Reunion	rewnjˈoŋ
ehercicio	ehersˈisjo
Inglatera	inɡlatˈera
compras	komprˈas
imprimi	imprˈimi
hand	hˈand
increibel	inkre͡ɪbˈel
chauffeur	t͡ʃauffˈewr
tercera	tersˈera
sra	srˈa
destinacionnan	destinasjˈonnan
mahos	mahˈos
cursonan	kursˈonan
casonan	kasˈonan
incorecto	inkorˈekto
Sea	sˈea
contrato	kontrˈato
papiamento	papjamˈento
drastico	drastˈiko
mini	mˈini
AVB	ˈavb
subi	sˈubi
reaccionnan	reaksjˈonnan
Wingo	wˈinɡo
inusual	inuswˈal
inspecciona	inspeksjˈona
aparato	aparˈato
Salubridad	salubridˈad
deseonan	deseˈonan
nutricion	nutrisjˈoŋ
Maria	mˈarja
Driemasterstraat	drjemasterstrˈaːt
Intensive	intensˈive
Blanco	blˈanko
yudando	judˈando
yabi	jˈabi
specialistanan	spesjalistˈanan
cadaver	kadavˈer
Economico	ekonomˈiko
tog	tˈoɡ
Normal	normˈal
recuerdo	rekwˈerdo
deteccion	deteksjˈoŋ
Rep	rˈep
Camara	kamˈara
donante	donˈante
Plus	plˈus
ya	jˈa
compensa	kompˈensa
incluso	inklˈuso
competitivo	kompetitˈivo
boost	bˈoːst
calcula	kalkˈula
sosega	sosˈeɡa
partner	partnˈer
Gruponan	ɡrupˈonan
impulsa	impˈulsa
Entrega	entrˈeɡa
presion	presjˈoŋ
Corda	kˈorda
Palo	pˈalo
curso	kˈurso
potretnan	potrˈetnan
premio	prˈemjo
curashi	kurˈaʃi
DPL	dˌepˌeˈɛl
landspakket	landspakkˈet
Diesel	djesˈel
beleid	belˈe͡ɪd
amiga	amˈiɡa
operador	operadˈor
Mei	mˈe͡ɪ
clave	klˈave
restaurantnan	restaurˈantnan
Realidad	realidˈad
likides	likidˈes
Rica	rˈika
Of	ˈof
zorg	zˈorɡ
Halto	hˈalto
sacrificionan	sakrifisjˈonan
workshop	workʃˈop
precario	prekˈarjo
ciclo	sˈiklo
estadia	estˈadja
acerca	asˈerka
TeleAruba	tˈelearˈuba
convivencia	konvivˈensja
MetaCorp	mˈetakˈorp
hinka	hˈinka
modernisa	modernˈisa
ameno	amˈeno
atakenan	atakˈenan
beyesa	bejˈesa
Encuanto	enkwˈanto
representa	represˈenta
retonan	retˈonan
clasico	klasˈiko
Boston	bostˈoŋ
Rector	rektˈor
Pier	pjˈer
semanal	semanˈal
score	skˈore
wordu	wˈordu
patient	patjˈent
Awor	awˈor
sconde	skˈonde
is	ˈis
subida	subˈida
lesa	lˈesa
park	pˈark
der	dˈer
Mega	mˈeɡa
time	tˈime
speransa	sperˈansa
petroleo	petrolˈeo
communidad	kommunidˈad
Integriteit	inteɡritˈe͡ɪt
Davelaar	davelˈaːr
IBiSA	ibˈisˈa
stul	stˈul
body	bˈodi
sosten	sostˈeŋ
danjo	dˈanjo
straño	strˈaɲo
organisadornan	orɡanisadˈornan
Youth	jˈowth
añas	aɲˈas
gabinete	ɡabinˈete
valve	vˈalve
loonsubsidie	loːnsubsˈidje
premira	premˈira
gobernador	ɡobernadˈor
Huize	hˈujze
WhatsApp	whˈatsˈapp
disfruta	disfrˈuta
jingle	jˈinɡle
importacion	importasjˈoŋ
bruto	brˈuto
sikiera	sikjˈera
contradeci	kontradˈesi
kia	kjˈa
Tabatin	tabatˈiŋ
keri	kˈeri
Bar	bˈar
Dienst	djˈenst
diripiente	diripjˈente
transparente	transparˈente
Antiyas	antijˈas
Seis	sˈe͡ɪs
tera	tˈera
c	sˈe
manehando	manehˈando
fiel	fjˈel
focus	fokˈus
BBO	bbˈo
Dunado	dunˈado
camindanan	kamindˈanan
light	lˈiɡht
goberna	ɡobˈerna
ignora	iɡnˈora
hungando	hunɡˈando
kere	kˈere
financiamento	finansjamˈento
ke	kˈe
Statuut	statˈyt
tanto	tˈanto
vecindario	vesindˈarjo
Horacio	horˈasjo
Valdes	valdˈes
expansion	ekspansjˈoŋ
sorteo	sortˈeo
Envez	envˈez
indigna	indˈiɡna
tiendanan	tjendˈanan
bibando	bibˈando
piek	pjˈek
demostra	demˈostra
City	sˈiti
olanan	olˈanan
ilegalmente	ileɡalmˈente
garganta	ɡarɡˈanta
tennis	tennˈis
crash	krˈaʃ
Personanan	personˈanan
contrincante	kontrinkˈante
reapertura	reapertˈura
doño	dˈoɲo
burocracia	burokrˈasja
presidencial	presidensjˈal
tal	tˈal
estrecho	estrˈet͡ʃo
Infantil	infantˈil
instante	instˈante
manifiesto	manifjˈesto
pisca	pˈiska
pakiko	pakˈiko
ki	kˈi
cualkier	kwalkjˈer
Jaburibari	jaburibˈari
Trade	trˈade
imagen	imaxˈeŋ
pais	pˈa͡ɪs
Arubiano	arubjˈano
deadline	deadlˈine
conforma	konfˈorma
corecto	korˈekto
Plataforma	platafˈorma
estimulo	estimˈulo
endemico	endemˈiko
Pronto	prˈonto
suministra	suminˈistra
cooperacion	koːperasjˈoŋ
inicia	inˈisja
victima	viktˈima
chauffeurnan	t͡ʃauffˈewrnan
compila	kompˈila
mancha	mˈant͡ʃa
dirigi	dirˈixi
Presupuesto	presupwˈesto
confirma	konfˈirma
mester	mestˈer
Registracion	rexistrasjˈoŋ
Enid	enˈid
Hunta	hˈunta
operacion	operasjˈoŋ
vigila	vixˈila
faya	fˈaja
sector	sektˈor
postura	postˈura
electoral	elektorˈal
Veer	vˈeːr
descubrimento	deskubrimˈento
pas	pˈas
susha	sˈuʃa
Piscadonan	piskadˈonan
murayanan	murajˈanan
Air	ˈa͡ɪr
titulo	titˈulo
algu	ˈalɡu
laba	lˈaba
parhanan	parhˈanan
cai	kˈa͡ɪ
ampliacion	ampljasjˈoŋ
ingresa	inɡrˈesa
Miljard	miljˈard
off	ˈoff
Arubus	arubˈus
cruzada	kruzˈada
ausente	ausˈente
paña	pˈaɲa
Hesus	hesˈus
dilanti	dilˈanti
primordial	primordjˈal
deportivo	deportˈivo
tapaboca	tapabˈoka
Door	dˈoːr
October	oktobˈer
generacionnan	xenerasjˈonnan
deliberacion	deliberasjˈoŋ
propuesta	propwˈesta
Papilon	papilˈoŋ
amigonan	amiɡˈonan
soña	sˈoɲa
docter	doktˈer
decora	dekˈora
vigente	vixˈente
Contrario	kontrˈarjo
recompensa	rekompˈensa
tras	trˈas
instrumentonan	instrumentˈonan
lamentabel	lamentabˈel
presupuestonan	presupwestˈonan
animo	anˈimo
Covid	kovˈid
corupcion	korupsjˈoŋ
desk	dˈesk
Robert	robˈert
Imigracion	imiɡrasjˈoŋ
WHO	whˈo
consecuencia	konsekwˈensja
Ing	ˈinɡ
berdadero	berdadˈero
rebiba	rebˈiba
costumber	kostumbˈer
comprendible	komprendˈible
preparando	preparˈando
cende	sˈende
lansamento	lansamˈento
Voz	vˈoz
preparatorio	preparatˈorjo
traves	travˈes
Alavez	alavˈez
restriccionnan	restriksjˈonnan
Cambio	kˈambjo
comentario	komentˈarjo
Gasoline	ɡasolˈine
sucursal	sukursˈal
fuente	fwˈente
Boekhoudt	bukhˈowdt
Eman	emˈaŋ
convenci	konvˈensi
asocia	asˈosja
potret	potrˈet
Museo	musˈeo
inciso	insˈiso
Movimiento	movimjˈento
mustra	mˈustra
benta	bˈenta
Sons	sˈons
hechonan	het͡ʃˈonan
Otmar	otmˈar
aglomeracion	aɡlomerasjˈoŋ
Rudy	rˈudi
seminario	seminˈarjo
dera	dˈera
parkeer	parkˈeːr
apartamento	apartamˈento
bisabo	bisˈabo
Dentro	dˈentro
ansha	ˈanʃa
Aseguro	aseɡˈuro
colmo	kˈolmo
formato	formˈato
delinea	delinˈea
carece	karˈese
prohibi	prohˈibi
planning	plannˈinɡ
mobilisa	mobilˈisa
Prins	prˈins
lunanan	lunˈanan
Positivo	positˈivo
campamento	kampamˈento
liter	litˈer
specialismo	spesjalˈismo
prolongacion	prolonɡasjˈoŋ
fraccionnan	fraksjˈonnan
lage	lˈaxe
buraco	burˈako
popularidad	popularidˈad
despacha	despˈat͡ʃa
respuesta	respwˈesta
Jimenez	jimenˈez
paden	padˈeŋ
zona	zˈona
integro	intˈeɡro
negociando	neɡosjˈando
combate	kombˈate
stakeholdernan	stakeholdˈernan
paz	pˈaz
Daphne	dˈaphne
infunda	infˈunda
coleganan	koleɡˈanan
mascara	maskˈara
sagrado	saɡrˈado
pensionadonan	pensjonadˈonan
download	downloˈad
handschoen	handst͡ʃˈuŋ
afspraaknan	afsprˈaːknan
contrario	kontrˈarjo
drief	drjˈef
interesadonan	interesadˈonan
liderazgo	liderˈazɡo
Arubaanse	arubˈaːnse
infeccioso	infeksjˈoso
carbon	karbˈoŋ
Kids	kˈids
urgi	ˈurxi
inventario	inventˈarjo
politicamente	politikamˈente
gradici	ɡradˈisi
rekesito	rekesˈito
scondi	skˈondi
vence	vˈense
sufrimento	sufrimˈento
indicacionnan	indikasjˈonnan
chiquito	t͡ʃikwˈito
hero	hˈero
severamente	severamˈente
Escudero	eskudˈero
bayendo	bajˈendo
Guera	ɡˈera
Cruise	krˈujse
henter	hentˈer
Parlamentarionan	parlamentarjˈonan
acentua	asˈentwa
ideal	ideˈal
internet	internˈet
bisando	bisˈando
Diabierna	djabjˈerna
cashier	kaʃjˈer
insulta	insˈulta
restauracion	restaurasjˈoŋ
eficiente	efisjˈente
combatimento	kombatimˈento
sponsornan	sponsˈornan
intimo	intˈimo
circular	sirkulˈar
exigi	eksˈixi
pompstation	pompstatjˈoŋ
PDVSA	pˈedvsˈa
transformacion	transformasjˈoŋ
alcansa	alkˈansa
Smart	smˈart
organo	orɡˈano
Guardian	ɡwardjˈaŋ
contact	kontˈakt
tour	tˈowr
Empleado	empleˈado
specificamente	spesifikamˈente
inaceptabel	inaseptabˈel
Baly	bˈali
obranan	obrˈanan
container	konta͡ɪnˈer
bachi	bˈat͡ʃi
gobiernonan	ɡobjernˈonan
wiel	wjˈel
Savaneta	savanˈeta
Ryan	rjˈaŋ
generalmente	xeneralmˈente
mes	mˈes
criadero	krjadˈero
areglo	arˈeɡlo
expresion	ekspresjˈoŋ
administracion	administrasjˈoŋ
primario	primˈarjo
curazon	kurazˈoŋ
Green	ɡrˈeːŋ
shift	ʃˈift
tendencia	tendˈensja
Keda	kˈeda
lesnan	lˈesnan
stabilidad	stabilidˈad
protesta	protˈesta
camanan	kamˈanan
formulario	formulˈarjo
les	lˈes
astronomico	astronomˈiko
Catalina	katalˈina
asbest	asbˈest
desplega	desplˈeɡa
depresivo	depresˈivo
ricibiendo	risibjˈendo
que	kwˈe
critica	kritˈika
Edjean	ed͡ʒeˈaŋ
Novel	novˈel
evento	evˈento
reanuda	reanˈuda
crudo	krˈudo
yobe	jˈobe
ultimo	ultˈimo
cabalmente	kabalmˈente
oficina	ofisˈina
teror	terˈor
reflexiona	refleksjˈona
contribuyente	kontribujˈente
pasobra	pasˈobra
conciente	konsjˈente
Emergencia	emerxˈensja
diciplina	disiplˈina
interogacion	interoɡasjˈoŋ
Test	tˈest
Wilmer	wilmˈer
baranca	barˈanka
mina	mˈina
pasado	pasˈado
ripiti	ripˈiti
mañan	maɲˈaŋ
hospice	hospˈise
dokter	doktˈer
sobrepasa	sobrepˈasa
hortamento	hortamˈento
adecua	adˈekwa
west	wˈest
digitalizacion	dixitalizasjˈoŋ
COHO	kˈoho
World	wˈorld
Willemstad	willemstˈad
morocoy	morokˈoj
garantisa	ɡarantˈisa
balansa	balˈansa
regalo	reɡˈalo
Recientemente	resjentemˈente
interesa	interˈesa
pleno	plˈeno
Italia	itˈalja
Local	lokˈal
dump	dˈump
mil	mˈil
hala	hˈala
comprencion	komprensjˈoŋ
Monserat	monserˈat
Sanicolas	sanikolˈas
agresor	aɡresˈor
Roos	rˈoːs
yamadanan	jamadˈanan
bestuur	bestˈyr
pesca	pˈeska
Jairo	jˈa͡ɪro
cup	kˈup
otorgamento	otorɡamˈento
otro	ˈotro
poesia	pˈusja
todo	tˈodo
track	trˈakk
decisionnan	desisjˈonnan
atrobe	atrˈobe
crèche	krˈɛt͡ʃe
señal	seɲˈal
Parlamentario	parlamentˈarjo
Studiantenan	studjantˈenan
Sr	ˌɛsˈɛr
Marriott	marrjˈott
griep	ɡrjˈep
Higiena	hixjˈena
notando	notˈando
toke	tˈoke
emocionnan	emosjˈonnan
pm	pˌeˈɛm
unanimamente	unanimamˈente
findishi	findˈiʃi
Inn	ˈinŋ
frecuentemente	frekwentemˈente
Nobo	nˈobo
remedia	remˈedja
Colony	kolˈoni
Rumbastraat	rumbastrˈaːt
tarhetanan	tarhetˈanan
George	xeˈorxe
canto	kˈanto
Bisiñanan	bisiɲˈanan
ODEA	odˈea
Montaña	montˈaɲa
compaña	kompˈaɲa
incorpora	inkorpˈora
certificacion	sertifikasjˈoŋ
formanan	formˈanan
morde	mˈorde
MEP	mˈep
yobida	jobˈida
salanan	salˈanan
eybanda	ejbˈanda
Edward	edwˈard
confrontando	konfrontˈando
interesante	interesˈante
parlamentario	parlamentˈarjo
Mervin	mervˈiŋ
lugar	luɡˈar
Kiwanis	kiwanˈis
papiando	papjˈando
force	fˈorse
Colombia	kolˈombja
aveo	avˈeo
Rosario	rosˈarjo
Jucuri	jukˈuri
economico	ekonomˈiko
HAVA	hˈava
finalisando	finalisˈando
Boca	bˈoka
afortuna	afortˈuna
foyeto	fojˈeto
orarionan	orarjˈonan
Tisa	tˈisa
huramento	huramˈento
BaluArte	bˈaluˈarte
klas	klˈas
Nederland	nederlˈand
experienciando	eksperjensjˈando
tema	tˈema
recherche	ret͡ʃˈert͡ʃe
cariño	karˈiɲo
Abao	abˈao
kico	kˈiko
technico	tet͡ʃnˈiko
Public	publˈik
SIN	sˈiŋ
Awendia	awˈendja
placentero	plasentˈero
siña	sˈiɲa
debate	debˈate
print	prˈint
Cual	kwˈal
palabra	palˈabra
Tamarijn	tamarˈe͡ɪŋ
encuestion	enkwestjˈoŋ
Reglanan	reɡlˈanan
tayer	tajˈer
recorda	rekˈorda
Sacrificio	sakrifˈisjo
renombra	renˈombra
kantidat	kantidˈat
desmantela	desmantˈela
bisami	bisˈami
intentonan	intentˈonan
empresario	empresˈarjo
advertencia	advertˈensja
propiedad	propjedˈad
añanan	aɲˈanan
wave	wˈave
empresa	emprˈesa
crimen	krimˈeŋ
dicho	dˈit͡ʃo
atmosfera	atmosfˈera
checklist	t͡ʃekklˈist
poderoso	poderˈoso
publico	publˈiko
vocifera	vosifˈera
Eduardo	edwˈardo
Pietersz	pjetˈersz
paginanan	paxinˈanan
Veterinaire	veterinˈa͡ɪre
substancia	substˈansja
good	ɡˈoːd
reaccion	reaksjˈoŋ
Ladronnan	ladrˈonnan
Kendrick	kendrˈikk
defende	defˈende
cuatro	kwˈatro
Bin	bˈiŋ
yegando	jeɡˈando
Costa	kˈosta
kende	kˈende
santo	sˈanto
campeon	kampeˈoŋ
balanza	balˈanza
animalnan	animˈalnan
AAA	ˈaːa
aplicante	aplikˈante
eherciendo	ehersjˈendo
ahusta	ahˈusta
rapportnan	rappˈortnan
Haciendo	hasjˈendo
blokea	blokˈea
telefoon	telefˈoːŋ
Domingo	domˈinɡo
husticia	hustˈisja
escalacion	eskalasjˈoŋ
Astec	astˈek
SPA	spˈa
COVID	kovˈid
preocupacionnan	preokupasjˈonnan
Ruso	rˈuso
Notario	notˈarjo
informativo	informatˈivo
birada	birˈada
Mayoria	majˈorja
esunan	esˈunan
tapa	tˈapa
una	ˈuna
larga	lˈarɡa
lanta	lˈanta
Palabra	palˈabra
eleva	elˈeva
studiante	studjˈante
Lee	lˈeː
Growell	ɡrowˈell
existi	eksˈisti
Tuitt	tˈujtt
Fijo	fˈe͡ɪo
Danies	danjˈes
humanitario	humanitˈarjo
Serlimar	serlimˈar
Zuid	zˈujd
Vocero	vosˈero
toets	tˈuts
numa	nˈuma
Maduro	madˈuro
paradero	paradˈero
stranheronan	stranherˈonan
FASE	fˈase
mehoracion	mehorasjˈoŋ
realidad	realidˈad
Meza	mˈeza
stipula	stipˈula
comunicacion	komunikasjˈoŋ
feedback	feːdbˈakk
motorcycle	motorsˈikle
domestico	domestˈiko
contene	kontˈene
maximo	maksˈimo
kiermen	kjermˈeŋ
guera	ɡˈera
CIBC	sˈibk
Gerencia	xerˈensja
economisa	ekonomˈisa
Lisette	lisˈette
turno	tˈurno
asbesto	asbˈesto
lachi	lˈat͡ʃi
rooi	rˈoːj
crew	krˈew
niet	njˈet
Augustus	auɡustˈus
Motibo	motˈibo
propio	prˈopjo
minister	ministˈer
Economia	ekonˈomja
Zoutman	zowtmˈaŋ
Democrats	demokrˈats
Locura	lokˈura
Primario	primˈarjo
plama	plˈama
autoridad	autoridˈad
operacionnan	operasjˈonnan
dolornan	dolˈornan
diez	djˈez
automaticamente	automatikamˈente
medico	medˈiko
certamen	sertamˈeŋ
desaroyando	desarojˈando
homber	hombˈer
ateriza	aterˈiza
sexual	sekswˈal
RIU	rjˈu
Campaña	kampˈaɲa
desconfiansa	deskonfjˈansa
cruel	krwˈel
mortalidad	mortalidˈad
residencia	residˈensja
Autoridadnan	autoridˈadnan
clinico	klinˈiko
SVb	ˌɛsvˌebˈe
input	inpˈut
comunica	komunˈika
Willem	willˈem
carton	kartˈoŋ
Cunucu	kunˈuku
Vision	visjˈoŋ
duna	dˈuna
Goeloe	ɡˈulu
hues	hwˈes
Futbol	futbˈol
recesion	resesjˈoŋ
ocupante	okupˈante
inconveniencia	inkonvenjˈensja
soporta	sopˈorta
Tipline	tiplˈine
acogida	akoxˈida
dañino	daɲˈino
manifesta	manifˈesta
consenso	konsˈenso
bise	bˈise
virus	virˈus
Apple	ˈapple
Negoshinan	neɡoʃˈinan
Hepple	hˈepple
aconseha	akonsˈeha
parlamento	parlamˈento
Financiën	finansjˈeŋ
mentalmente	mentalmˈente
sentido	sentˈido
cambernan	kambˈernan
Korpschef	korpst͡ʃˈef
tos	tˈos
gasto	ɡˈasto
anochinan	anot͡ʃˈinan
Un	ˈuŋ
Andrew	andrˈew
figura	fiɡˈura
ola	ˈola
coach	koˈat͡ʃ
desea	desˈea
humamento	humamˈento
grita	ɡrˈita
afor	afˈor
labor	labˈor
accionan	aksjˈonan
anima	anˈima
ataka	atˈaka
deposita	deposˈita
imparcial	imparsjˈal
tenso	tˈenso
tanten	tantˈeŋ
nacion	nasjˈoŋ
dificil	difisˈil
skeiro	skˈe͡ɪro
cabuya	kabˈuja
descarta	deskˈarta
neishi	nˈe͡ɪʃi
actual	aktwˈal
diaranzon	djaranzˈoŋ
actualmente	aktwalmˈente
colectivo	kolektˈivo
Chito	t͡ʃˈito
YouTube	jˈowtˈube
racha	rˈat͡ʃa
Apesar	apesˈar
Deporte	depˈorte
Bon	bˈoŋ
inaugura	inauɡˈura
extension	ekstensjˈoŋ
profesion	profesjˈoŋ
cuarto	kwˈarto
Mexico	meksˈiko
er	ˈer
Diaranzon	djaranzˈoŋ
Laba	lˈaba
acontecimento	akontesimˈento
costoso	kostˈoso
plataforma	platafˈorma
DVG	dˌevˌeɡˈe
fronteranan	fronterˈanan
Michael	mit͡ʃaˈel
Ports	pˈorts
bestia	bˈestja
circumstancianan	sirkumstansjˈanan
acomodacion	akomodasjˈoŋ
ambiente	ambjˈente
grandura	ɡrandˈura
Secretario	sekretˈarjo
personalnan	personˈalnan
resistencia	resistˈensja
Infrastructura	infrastruktˈura
calidad	kalidˈad
partners	partnˈers
sala	sˈala
Migracion	miɡrasjˈoŋ
guia	ɡjˈa
Entrevista	entrevˈista
incertidumbre	insertidˈumbre
precis	presˈis
december	desembˈer
tine	tˈine
negociacionnan	neɡosjasjˈonnan
adress	adrˈess
cria	krjˈa
plus	plˈus
colega	kolˈeɡa
actualisacion	aktwalisasjˈoŋ
incansablemente	inkansablemˈente
Consulado	konsulˈado
penal	penˈal
encuanto	enkwˈanto
tratado	tratˈado
manteni	mantˈeni
Penal	penˈal
Paso	pˈaso
substancial	substansjˈal
consecuentemente	konsekwentemˈente
bende	bˈende
asumi	asˈumi
Miss	mˈiss
sabi	sˈabi
Canal	kanˈal
satisfecho	satisfˈet͡ʃo
corrupcion	korrupsjˈoŋ
challenge	t͡ʃallˈenxe
hibando	hibˈando
CDC	sˌedˌesˈe
Siguientemente	siɡjentemˈente
trempan	trempˈaŋ
hulandes	hulandˈes
anochi	anˈot͡ʃi
Humano	humˈano
bono	bˈono
eroneo	eronˈeo
CAFT	kˈaft
patruyanan	patrujˈanan
creciendo	kresjˈendo
guardia	ɡwˈardja
democracia	demokrˈasja
Hospital	hospitˈal
klapchi	klˈapt͡ʃi
sindicato	sindikˈato
Segunda	seɡˈunda
costo	kˈosto
Enfermeria	enfermˈerja
expresionnan	ekspresjˈonnan
Proteccion	proteksjˈoŋ
Vroegop	vruɡˈop
Meta	mˈeta
grandioso	ɡrandjˈoso
nieto	njˈeto
SV	ˌɛsvˈe
fundacion	fundasjˈoŋ
festival	festivˈal
hòmber	hˈɔmber
sancion	sansjˈoŋ
teme	tˈeme
awenochi	awenˈot͡ʃi
cushina	kuʃˈina
Landsbesluit	landsbeslˈujt
ponencia	ponˈensja
stichting	stit͡ʃtˈinɡ
continuidad	kontinujdˈad
Organisacionnan	orɡanisasjˈonnan
exponi	ekspˈoni
Business	businˈess
localmente	lokalmˈente
algo	ˈalɡo
desaroyo	desarˈojo
termina	termˈina
division	divisjˈoŋ
Hendenan	hendˈenan
creando	kreˈando
Cultural	kulturˈal
Genser	xensˈer
miedo	mjˈedo
caravana	karavˈana
Arqueologico	arkweoloxˈiko
herencia	herˈensja
Softball	softbˈall
stempel	stempˈel
era	ˈera
preveni	prevˈeni
Leendert	leːndˈert
conocido	konosˈido
levemente	levemˈente
exigencia	eksixˈensja
exitoso	eksitˈoso
cuestionario	kwestjonˈarjo
cien	sjˈeŋ
parti	pˈarti
Dor	dˈor
introduccion	introduksjˈoŋ
trucknan	trˈukknan
conscientisacion	konssjentisasjˈoŋ
BER	bˈer
Prueba	prwˈeba
mucha	mˈut͡ʃa
Chief	t͡ʃjˈef
criminal	kriminˈal
crusada	krusˈada
resolvi	resˈolvi
investigadornan	investiɡadˈornan
refinancia	refinˈansja
institui	institˈuj
criminalnan	kriminˈalnan
Dado	dˈado
ekivalente	ekivalˈente
Ela	ˈela
sociaal	sosjˈaːl
SETAR	setˈar
High	hˈiɡh
annual	annwˈal
Macuarima	makwarˈima
Facebook	fasebˈoːk
Havenstraat	havenstrˈaːt
videoclip	videoklˈip
hotelnan	hotˈelnan
peticionnan	petisjˈonnan
March	mˈart͡ʃ
u	ˈu
Mericanonan	merikanˈonan
tarifa	tarˈifa
FLEXO	flˈekso
gremionan	ɡremjˈonan
stima	stˈima
parada	parˈada
relata	relˈata
Desiree	desirˈeː
robes	robˈes
Mucha	mˈut͡ʃa
Expression	ekspressjˈoŋ
timon	timˈoŋ
responsabilisa	responsabilˈisa
consecutivo	konsekutˈivo
calma	kˈalma
impresionante	impresjonˈante
Casonan	kasˈonan
medaya	medˈaja
circulando	sirkulˈando
probabilidad	probabilidˈad
Calidad	kalidˈad
hamber	hambˈer
influenza	inflwˈenza
empleo	emplˈeo
Iniciativa	inisjatˈiva
yaris	jarˈis
Copa	kˈopa
prolonga	prolˈonɡa
Spearfishing	spearfiʃˈinɡ
indicando	indikˈando
cedula	sedˈula
Aruba	arˈuba
atraconan	atrakˈonan
asta	ˈasta
Bubali	bubˈali
wowonan	wowˈonan
Restaurantnan	restaurˈantnan
LaSorte	lˈasˈorte
titular	titulˈar
sostenedornan	sostenedˈornan
Traimerdia	tra͡ɪmˈerdja
hendenan	hendˈenan
insulto	insˈulto
disponible	disponˈible
residente	residˈente
comunidadnan	komunidˈadnan
at	ˈat
merca	mˈerka
Lagoen	laɡˈuŋ
deposito	deposˈito
certificado	sertifikˈado
importancia	importˈansja
Misa	mˈisa
come	kˈome
Oficina	ofisˈina
lidernan	lidˈernan
valioso	valjˈoso
clausula	klausˈula
ekiponan	ekipˈonan
sano	sˈano
diadomingo	djadomˈinɡo
sponsor	sponsˈor
Timeshare	timeʃˈare
bista	bˈista
juda	jˈuda
excepto	ekssˈepto
desaparece	desaparˈese
tram	trˈam
berguensa	berɡˈensa
Pelea	pelˈea
food	fˈoːd
Erasmus	erasmˈus
Entrada	entrˈada
sorprende	sorprˈende
Emmastraat	emmastrˈaːt
ministro	minˈistro
intervencion	intervensjˈoŋ
kilometer	kilometˈer
abusador	abusadˈor
Compleho	komplˈeho
Ciudadano	sjudadˈano
Adriaan	adrjˈaːŋ
tecnologia	teknolˈoxja
trapa	trˈapa
fiansa	fjˈansa
logistico	loxistˈiko
tecnica	teknˈika
Fun	fˈuŋ
nomber	nombˈer
cuentanan	kwentˈanan
contento	kontˈento
New	nˈew
posiblemente	posiblemˈente
men	mˈeŋ
desempleo	desemplˈeo
fila	fˈila
Acaso	akˈaso
partinan	partˈinan
Papiamento	papjamˈento
respeta	respˈeta
ultimamente	ultimamˈente
cash	kˈaʃ
yame	jˈame
trese	trˈese
acompañante	akompaɲˈante
hobby	hˈobbi
exporta	ekspˈorta
seguro	seɡˈuro
test	tˈest
restablece	restablˈese
virtualmente	virtwalmˈente
banki	bˈanki
haña	hˈaɲa
temblor	temblˈor
restaura	restaˈura
sobrevivi	sobrevˈivi
Fiscal	fiskˈal
mutuo	mˈutwo
dictatorial	diktatorjˈal
Accion	aksjˈoŋ
The	thˈe
ambtenaar	ambtenˈaːr
lama	lˈama
grato	ɡrˈato
Nan	nˈaŋ
organisacion	orɡanisasjˈoŋ
transaccion	transaksjˈoŋ
salud	salˈud
Distanciamento	distansjamˈento
Poets	pˈuts
Mes	mˈes
crisis	krisˈis
explora	eksplˈora
economianan	ekonomjˈanan
aruba	arˈuba
emision	emisjˈoŋ
Corridor	korridˈor
trata	trˈata
volumen	volumˈeŋ
planeando	planeˈando
ancianonan	ansjanˈonan
lobby	lˈobbi
Aumento	aumˈento
do	dˈo
señora	seɲˈora
Wuhan	wuhˈaŋ
alumno	alˈumno
Dushi	dˈuʃi
first	fˈirst
Douaneronan	dowanerˈonan
Condé	kondˈe
tipico	tipˈiko
Paul	paˈul
remedinan	remedˈinan
estado	estˈado
sabor	sabˈor
Futura	futˈura
carga	kˈarɡa
fantasia	fantˈasja
Anteriormente	anterjormˈente
vitrina	vitrˈina
network	netwˈork
Family	famˈili
Unidadnan	unidˈadnan
posponi	pospˈoni
Grupo	ɡrˈupo
mediconan	medikˈonan
payroll	pajrˈoll
Boso	bˈoso
cantidadnan	kantidˈadnan
Democrata	demokrˈata
celular	selulˈar
nombra	nˈombra
restructura	restruktˈura
DUO	dwˈo
inverti	invˈerti
hustificacion	hustifikasjˈoŋ
Cerca	sˈerka
Royal	rojˈal
Siglo	sˈiɡlo
Dirks	dˈirks
amargo	amˈarɡo
avioneta	avjonˈeta
menciona	mensjˈona
Gusto	ɡˈusto
resorta	resˈorta
Marquez	markwˈez
trato	trˈato
pafor	pafˈor
imposibel	imposibˈel
cueste	kwˈeste
Texas	teksˈas
permiso	permˈiso
kentel	kentˈel
material	materjˈal
Ayera	ajˈera
influencia	inflwˈensja
ford	fˈord
mundialmente	mundjalmˈente
frontera	frontˈera
teni	tˈeni
Cientificonan	sjentifikˈonan
ramo	rˈamo
Diripiente	diripjˈente
GNC	ɡˌeˌɛnsˈe
privilegio	privilˈexjo
Sexual	sekswˈal
mensualmente	menswalmˈente
usa	ˈusa
sangra	sˈanɡra
topico	topˈiko
Comite	komˈite
muhernan	muhˈernan
Constitucion	konstitusjˈoŋ
SMOA	smˈoa
mobil	mobˈil
entusiasmo	entusjˈasmo
eror	erˈor
esnan	ˈesnan
comportacion	komportasjˈoŋ
ademas	ademˈas
App	ˈapp
shop	ʃˈop
Pro	prˈo
landa	lˈanda
Estado	estˈado
ausencia	ausˈensja
resulta	resˈulta
validez	validˈez
trimester	trimestˈer
cobra	kˈobra
drempel	drempˈel
apart	apˈart
tardanza	tardˈanza
recurso	rekˈurso
debilidad	debilidˈad
circula	sirkˈula
heeft	hˈeːft
Werleman	werlemˈaŋ
graduadonan	ɡradwadˈonan
suppose	suppˈose
Protocol	protokˈol
categorisa	kateɡorˈisa
kleuter	klewtˈer
ocacion	okasjˈoŋ
paciente	pasjˈente
Wardakosta	wardakˈosta
Adventista	adventˈista
ciudadanonan	sjudadanˈonan
Nuhad	nuhˈad
post	pˈost
Association	assosjatjˈoŋ
expectativanan	ekspektativˈanan
educador	edukadˈor
Sigur	siɡˈur
Di	dˈi
flexibilidad	fleksibilidˈad
speculacion	spekulasjˈoŋ
faborabel	faborabˈel
roga	rˈoɡa
SABA	sˈaba
solicitud	solisitˈud
estudio	estˈudjo
Abraham	abrahˈam
proponi	propˈoni
Sharline	ʃarlˈine
Oficialmente	ofisjalmˈente
buraconan	burakˈonan
metodonan	metodˈonan
Cumbre	kˈumbre
Rio	rjˈo
proba	prˈoba
institucion	institusjˈoŋ
smartphone	smartphˈone
ubica	ubˈika
contagioso	kontaxjˈoso
Conferencia	konferˈensja
fracasa	frakˈasa
toezicht	tuzˈit͡ʃt
infrastructura	infrastruktˈura
sospecha	sospˈet͡ʃa
Gran	ɡrˈaŋ
regimen	reximˈeŋ
Dama	dˈama
absoluto	absolˈuto
comestibles	komestiblˈes
impactante	impaktˈante
regla	rˈeɡla
leak	leˈak
bula	bˈula
Escolar	eskolˈar
update	updˈate
Center	sentˈer
relatonan	relatˈonan
combersa	kombˈersa
Buki	bˈuki
Diahuebs	djahwˈebs
telefonico	telefonˈiko
Kier	kjˈer
preliminar	preliminˈar
conociendo	konosjˈendo
continuamente	kontinwamˈente
djies	d͡ʒjˈes
negativo	neɡatˈivo
Suites	sujtˈes
botica	botˈika
bijstand	be͡ɪstˈand
especial	espesjˈal
puntre	pˈuntre
