शम्	ɕɐm
लषति	l̪ɐʂɐt̪i
व्याघ्र	ʋjɑːɡʱɾɐ
मेधा	meːd̪ʱɑː
जल	d͡ʑɐl̪ɐ
रन्धयति	ɾɐn̪d̪ʱɐjɐt̪i
द्रायति	d̪ɾɑ́ːjɐt̪i
शरद्	ɕɐɾɐd̪
क्रेता	kɾɐjt̪ɑː
भाजयति	bʱɑːd͡ʑɐjɐt̪i
श्लिष्यन्ति	ɕl̪iʂjɐn̪t̪i
पुरोळाश्	puɾoːɭ̆ɑːɕ
कपोल	kɐpɐwl̪ɐ
शिक्षिकाणाम्	ɕikʂikɑːɳɑːm
बुध्यते	búd̪ʱjɐt̪ɐj
काम	kɑːmɐ
प्रवाचे	pɾɐʋɑːt͡ɕeː
क्लन्द्	kl̪ɐn̪d̪
रैवत	ɾɑjʋɐt̪ɐ
गृणाति	ɡr̩ɳɑːt̪i
अस्थात्	ɐ́s̪t̪ʰɑːt̪
सायम्	s̪ɑːjɐm
क्रम	kɾɐ́mɐ
स्याली	s̪jɑːl̪iː
अङ्गुष्ठ	ɐŋɡuʂʈʰɐ
करोतु	kɐɾoːt̪u
पुस्तक	pus̪t̪ɐkɐ
प्यायित	pjɑːjit̪ɐ
दोषा	d̪oːʂɑː
दम्	d̪ɐ́m
अप्सस्	ɐ́ps̪ɐs̪
आलु	ɑːl̪u
बभ्रु	bɐbʱɾu
गृह	ɡr̩ɦɐ
वायु	ʋɑːju
गुलानाम्	ɡul̪ɑːn̪ɑːm
हस्तत्राण	ɦɐs̪t̪ɐt̪ɾɑːɳɐ
इन्द्र	ín̪d̪ɾɐ
संकल्प	s̪ɐŋkɐl̪pɐ́
पञ्चाशत्	pɐɲt͡ɕɑːɕɐt̪
कम्बल	kɐmbɐl̪ɐ
पीयूष	piːjuːʂɐ
दोमन्	d̪oːmɐn̪
वाष्प	ʋɑːʂpɐ
लाञ्छ्	l̪ɑːɲt͡ɕʰ
ग्ना	ɡn̪ɑː
दम	d̪ɐ́mɐ
सज्जन	s̪ɐdd͡ʑɐn̪ɐ
पसस्	pɐ́s̪ɐs̪
विश्पति	ʋiɕpɐ́t̪i
उष्ट्र	uʂʈɾɐ
ईशान	iːɕɑːn̪ɐ
यस्मिन्	jɐs̪min̪
बर्जह्य	bɐɾd͡ʑɐɦjɐ
प्रज्ञान	pɾɐd͡ʑɲɑ́ːn̪ɐ
उर्वरा	uɾʋɐ́ɾɑː
श्विन्दताम्	ɕʋin̪d̪ɐt̪ɑːm
यौन	jɑːwn̪ɐ
पीन	piːn̪ɐ
शुभ्र	ɕubʱɾɐ
पुरोळाश्	puɾɐwɭ̆ɑ́ːɕ
तेषां	t̪ɐjʂɑːm
मानव	mɑːn̪ɐʋɐ
नश्	n̪ɐɕ
मसिपात्र	mɐs̪ipɑːt̪ɾɐ
अन्धकार	ɐn̪d̪ʱɐkɑːɾɐ
शीर्ष	ɕiːɾʂɐ́
चिकित्सकेन	t͡ɕikit̪s̪ɐkɐjn̪ɐ
अर्क	ɐɾkɐ
प्रपद्यते	pɾɐpɐd̪jɐt̪eː
मधु	mɐd̪ʱu
तुतोर्ति	t̪ut̪oːɾt̪i
दिक्करिन्	d̪ikkɐɾin̪
पुष्यति	púʂjɐt̪i
सरु	s̪ɐɾu
महाभारत	mɐɦɑ́ːbʱɑːɾɐt̪ɐh
अघ्न्या	ɐ́ɡʱn̪jɑː
सिंह	s̪ĩɦɐ
दूर्वा	d̪uːɾʋɑː
निवास	n̪iʋɑːs̪ɐ
वीतिराधस्	ʋiːt̪iɾɑːd̪ʱɐs̪
छिनत्ति	t͡ɕʰin̪ɐ́t̪t̪i
भर्ग	bʱɐ́ɾɡɐ
श्रोणि	ɕɾoːɳi
सदस्	s̪ɐ́d̪ɐs̪
क्षोदस्	kʂɐ́wd̪ɐs̪
मेष	meːʂɐ
श्रोत्र	ɕɾɐ́wt̪ɾɐ
ऋणी	r̩ɳiː
स्वर्दते	s̪ʋɐɾd̪ɐt̪ɐj
वेदि	ʋɐ́jd̪i
कुटिल	kuʈil̪ɐ
गृह्णाति	ɡr̩ɦɳɑːt̪i
ददातु	d̪ɐd̪ɑːt̪u
शूल	ɕuːl̪ɐ
मुञ्चति	muɲt͡ɕɐt̪i
फलनेषु	pʰɐl̪ɐn̪ɐjʂu
गीर्	ɡíːɾ
गोदावरी	ɡɐwd̪ɑːʋɐɾiː
जनक	d͡ʑɐn̪ɐkɐ
तलक	t̪ɐl̪ɐkɐ
स्तनति	s̪t̪ɐn̪ɐt̪i
पुनर्	pun̪ɐɾ
अननुमेय	ɐn̪ɐn̪umɐ́jjɐ
आस्	ɑ́ːs̪
भाजन	bʱɑ́ːd͡ʑɐn̪ɐ
फल	pʰɐ́l̪ɐ
अस्थन्	ɐs̪t̪ʰɐn̪
गूर्त	ɡuːɾt̪ɐ
आसार	ɑːs̪ɑːɾɐ
गूर्ति	ɡuːɾt̪i
अगम्ये	ɐɡɐmjeː
असत्	ɐs̪ɐt̪
रुच्	ɾut͡ɕ
सूत्र	s̪úːt̪ɾɐ
नाथताम्	n̪ɑːt̪ʰɐt̪ɑːm
शिफेषु	ɕipʰɐjʂu
अर्जनयोः	ɐɾd͡ʑɐn̪ɐjɐwh
अपदेश	ɐpɐd̪ɐjɕɐ
भद्र	bʱɐd̪ɾɐ́
माया	mɑːjɑ́ː
दंष्ट्र	d̪ɐ̃́ʂʈɾɐ
ग्रथन	ɡɾɐt̪ʰɐn̪ɐ
कृपाभ्याम्	kr̩pɑːbʱjɑːm
हीन	ɦiːn̪ɐ
भवामि	bʱɐʋɑːmi
तस्मिन्	t̪ɐs̪min̪
इन	in̪ɐ
कदे	kɐd̪eː
सहति	s̪ɐɦɐt̪i
खेदात्	kʰɐjd̪ɑːt̪
कक्ष	kɐ́kʂɐ
मूल	múːl̪ɐ
खनित्रात्	kʰɐn̪it̪ɾɑːt̪
छिन्न	t͡ɕʰin̪n̪ɐ
परिवर्तन	pɐɾiʋɐɾt̪ɐn̪ɐ
पवमान	pɐ́ʋɐmɑːn̪ɐ
सङ्ग	s̪ɐŋɡɐ
मन्त्र	mɐn̪t̪ɾɐ
वैश्वानर	ʋɑːjɕʋɑːn̪ɐɾɐ́
तक्षन्	t̪ɐkʂɐn̪
मर्यादा	mɐɾjɑːd̪ɑː
शैव	ɕɑːjʋɐ
प्राकार	pɾɑːkɑːɾɐ
सादेषु	s̪ɑːd̪eːʂu
पितामह	pit̪ɑːmɐɦɐ
तृष्यति	t̪ŕ̩ʂjɐt̪i
यून	juːn̪ɐ
लिहति	l̪iɦɐ́t̪i
अस्वर्ष्यत्	ɐs̪ʋɐɾʂjɐt̪
क्वथते	kʋɐ́t̪ʰɐt̪ɐj
स्वेद	s̪ʋeːd̪ɐ
ध्रुव	d̪ʱɾuʋɐ́
जज्ञौ	d͡ʑɐd͡ʑɲɑːw
करीन्द्र	kɐɾiːn̪d̪ɾɐ
वर्ग	ʋɐɾɡɐ
शिफेषु	ɕipʰeːʂu
अर्हति	ɐɾɦɐt̪i
तिल	t̪il̪ɐ
सत्यताम्	s̪ɐt̪jɐt̪ɑːm
श्लोक	ɕl̪ɐ́wkɐ
सुशेव्य	s̪uɕeːʋjɐ
वोढृ	ʋoːɖʱr̩
गभस्ति	ɡɐbʱɐs̪t̪i
वयुन	ʋɐjun̪ɐ
सामान्य	s̪ɑːmɑːn̪jɐ
असृक्	ɐ́s̪r̩k
ऊर्ध्व	uːɾd̪ʱʋɐ
स्तुका	s̪t̪ukɑː
उच्छ्वस्	utt͡ɕʰʋɐs̪
गुलैः	ɡul̪ɑːjh
दिति	d̪it̪i
जनू	d͡ʑɐn̪uː
कङ्कत	kɐŋkɐt̪ɐ
त्वे	t̪ʋeː
कन्दरा	kɐn̪d̪ɐɾɑː
कमल	kɐ́mɐl̪ɐ
ज्योतिष	d͡ʑjoːt̪iʂɐ
बर्बट	bɐɾbɐʈɐ
करण	kɐɾɐɳɐ
शंकर	ɕɐŋkɐɾɐ́
मरीचि	mɐɾiːt͡ɕi
छात्त्र	t͡ɕʰɑːt̪t̪ɾɐ
कुट्ट्	kuʈʈ
पिशाच	piɕɑːt͡ɕɐ́
स्कुन्दे	s̪kun̪d̪eː
फलनेन	pʰɐl̪ɐn̪ɐjn̪ɐ
अव	ɐʋɐ
सत्यतया	s̪ɐt̪jɐt̪ɐjɑː
गोलदीप	ɡoːl̪ɐd̪iːpɐ
पालि	pɑːl̪i
माङ्गलिक	mɑːŋɡɐl̪ikɐ
एनस्	eːn̪ɐs̪
पाटल	pɑːʈɐl̪ɐ
नीर	n̪iːɾɐ
हिन्द्याः	ɦin̪d̪jɑːh
राज्ञीः	ɾɑːd͡ʑɲiːh
वशात्व	ʋɐɕɑːt̪ʋɐ
रभस्	ɾɐbʱɐs̪
देवसर्षप	d̪ɐjʋɐ́s̪ɐɾʂɐpɐ
खेदः	kʰeːd̪ɐh
लज्जा	l̪ɐdd͡ʑɑː
राजन्	ɾɑːd͡ʑɐn̪
सेधति	s̪ɐ́jd̪ʱɐt̪i
शन्तनु	ɕɐn̪t̪ɐn̪u
मीनीतः	miːn̪iːt̪ɐh
यह्वा	jɐɦʋɑː
हिन्दीम्	ɦin̪d̪iːm
कर्तुम्	kɐɾt̪um
शुष्क	ɕúʂkɐ
रौद्र	ɾɑːwd̪ɾɐ́
वयति	ʋɐjɐt̪i
ऐश्वर्य	ɑːjɕʋɐɾjɐ
शत्रुः	ɕɐt̪ɾuh
जन्मन्	d͡ʑɐn̪mɐn̪
जुहू	d͡ʑuɦuː
दाल	d̪ɑːl̪ɐ
अर्जनयोः	ɐɾd͡ʑɐn̪ɐjoːh
स्तनति	s̪t̪ɐ́n̪ɐt̪i
गृध्र	ɡr̩d̪ʱɾɐ
चत्वारिंशत्	t͡ɕɐt̪ʋɑːɾĩɕɐt̪
क्षिपति	kʂipɐt̪i
गूळ्ह	ɡuːɭ̆ɦɐ́
ज्वलति	d͡ʑʋɐl̪ɐt̪i
आत्मनेपद	ɑːt̪mɐn̪ɐjpɐd̪ɐ
पादत्राणयोः	pɑːd̪ɐt̪ɾɑːɳɐjɐwh
जनि	d͡ʑɐ́n̪i
कुलीन	kul̪iːn̪ɐ
त्रयोविंशति	t̪ɾɐ́jɐwʋĩɕɐt̪i
निस्	n̪is̪
सादाय	s̪ɑːd̪ɑːjɐ
अङ्गुलि	ɐŋɡúl̪i
अभ्यलंकृत	ɐbʱjɐl̪ɐŋkr̩t̪ɐ
पृथ्वी	pr̩t̪ʰʋiː
क्षम्	kʂɐm
भय	bʱɐjɐ́
गाधते	ɡɑːd̪ʱɐt̪eː
मांस्	mɑ̃ːs̪
लिलेह	l̪il̪ɐjɦɐ
महाभारत	mɐɦɑːbʱɑːɾɐt̪ɐm
सूत्र	s̪uːt̪ɾɐ
नप्तृ	n̪ɐpt̪r̩
वसिष्ठ	ʋɐs̪iʂʈʰɐ
पत्नी	pɐ́t̪n̪iː
नारिकेल	n̪ɑːɾikɐjl̪ɐ
वेलाभूमि	ʋɐjl̪ɑːbʱuːmi
तपति	t̪ɐpɐt̪i
चतुर्दश	t͡ɕɐt̪uɾd̪ɐɕɐ
शोचति	ɕɐwt͡ɕɐt̪i
रिक्षा	ɾikʂɑː
उद्गॄ	ud̪ɡr̩ː
द्वितीय	d̪ʋit̪íːjɐ
तक्षति	t̪ɐ́kʂɐt̪i
चातुर्य	t͡ɕɑːt̪uɾjɐ
शङ्के	ɕɐŋkeː
हाला	ɦɑːl̪ɑː
मिह्	míɦ
चर्मन्	t͡ɕɐ́ɾmɐn̪
पार्थिव	pɑ́ːɾt̪ʰiʋɐ
मीढ्वस्	miːɖʱʋɐ́s̪
रुद्राक्ष	ɾud̪ɾɑːkʂɐ
सुम्न	s̪umn̪ɐ́
लपति	l̪ɐpɐt̪i
स्वधा	s̪ʋɐd̪ʱɑː
मानसिक	mɑːn̪ɐs̪ikɐ
जीर्ण	d͡ʑiːɾɳɐ́
ईश	iːɕɐ
दत्त	d̪ɐt̪t̪ɐ
क्रीडाङ्गन	kɾiːɖɑːŋɡɐn̪ɐ
बुध्	búd̪ʱ
यहस्	jɐ́ɦɐs̪
गच्छेत	ɡɐtt͡ɕʰeːt̪ɐ
व्यधिकरण	ʋjɐd̪ʱikɐɾɐɳɐ
हा	ɦɑː
मूष्	muːʂ
तत्र	t̪ɐ́t̪ɾɐ
भर्त्सन	bʱɐɾt̪s̪ɐn̪ɐ
सादे	s̪ɑːd̪ɐj
सनक	s̪ɐn̪ɐkɐ
गच्छति	ɡɐtt͡ɕʰɐt̪i
तलातल	t̪ɐl̪ɑːt̪ɐl̪ɐ
उन्नत	un̪n̪ɐt̪ɐ́
मनोतृ	mɐn̪ɐ́wt̪r̩
मूल	muːl̪ɐ
गत	ɡɐt̪ɐ
चिकित्सिकाभ्यः	t͡ɕikit̪s̪ikɑːbʱjɐh
अपद्रव्य	ɐpɐd̪ɾɐʋjɐ
संकल्पेभ्यः	s̪ɐŋkɐl̪peːbʱjɐh
शत्रुभ्याम्	ɕɐt̪ɾubʱjɑːm
दृळ्ह	d̪r̩ɭ̆ɦɐ́
कौतुकिन्	kɑwt̪ukin̪
मात्रा	mɑːt̪ɾɑː
अवधारण	ɐʋɐd̪ʱɑːɾɐɳɐ
भस्त्रा	bʱɐ́s̪t̪ɾɑː
जनी	d͡ʑɐn̪iː
सहस्रिमान	s̪ɐɦɐs̪ɾimɑːn̪ɐ
चान्द्र	t͡ɕɑːn̪d̪ɾɐ
नील	n̪íːl̪ɐ
आगस्	ɑ́ːɡɐs̪
नीळ	n̪iːɭ̆ɐ
रथ	ɾɐ́t̪ʰɐ
कीकि	kiːki
प्लवते	pl̪ɐ́ʋɐt̪ɐj
सप्तदश	s̪ɐpt̪ɐ́d̪ɐɕɐ
संक्रमण	s̪ɐŋkɾɐmɐɳɐ
ईळे	íːɭ̆ɐj
बुद्धीन्द्रिय	bud̪d̪ʱiːn̪d̪ɾijɐ́
नौ	n̪ɑːw
प्रथम	pɾɐt̪ʰɐmɐ́
कार	kɑːɾɐ
पुष्यति	puʂjɐt̪i
खेला	kʰɐjl̪ɑː
मस्तु	mɐ́s̪t̪u
बजे	bɐd͡ʑɐj
खादन	kʰɑːd̪ɐn̪ɐ
इह	iɦɐ
भूयसे	bʱuːjɐs̪eː
रसायनज्ञ	ɾɐs̪ɑːjɐn̪ɐd͡ʑɲɐ
हेमन्त	ɦeːmɐn̪t̪ɐ
सुश्चन्द्र	s̪uɕt͡ɕɐn̪d̪ɾɐ́
तृप्त	t̪r̩pt̪ɐ́
लेढा	l̪ɐjɖʱɑː
कोष्ठ	koːʂʈʰɐ
रोधति	ɾoːd̪ʱɐt̪i
भय	bʱɐjɐ
प्रदातोस्	pɾɐd̪ɑːt̪oːs̪
प्रतीक	pɾɐ́t̪iːkɐ
अलंकृत	ɐl̪ɐŋkr̩t̪ɐ
कदौ	kɐd̪ɑːw
करिबन्ध	kɐɾibɐn̪d̪ʱɐ
पक्ष	pɐkʂɐ
याग	jɑːɡɐ
खेदयोः	kʰeːd̪ɐjoːh
क्रीळति	kɾiːɭ̆ɐt̪i
अम्नस्	ɐmn̪ɐs̪
नदीपति	n̪ɐd̪iːpɐt̪í
कृति	kr̩t̪í
पृष्ठ	pr̩ʂʈʰɐ
मुहुर्	múɦuɾ
उच्चैस्	utt͡ɕɑjs̪
वेदस्	ʋeːd̪ɐs̪
शर्मन्	ɕɐɾmɐn̪
भिषक्	bʱiʂɐk
क्रीड	kɾiːɖɐ
पादत्राणाय	pɑːd̪ɐt̪ɾɑːɳɑːjɐ
प्रेष्	pɾeːʂ
मयूर	mɐjuːɾɐ
तावत्क	t̪ɑːʋɐt̪kɐ
मृत	mr̩t̪ɐ́
शक्ति	ɕɐ́kt̪i
कामुक	kɑːmukɐ
भर्त्स्	bʱɐɾt̪s̪
भूत	bʱuːt̪ɐ
तेषु	t̪ɐjʂu
दीक्षितृ	d̪iːkʂít̪r̩
नश्यामः	n̪ɐɕjɑːmɐh
षड्विंशति	ʂɐ́ɖʋĩɕɐt̪i
तेजस्विन्	t̪ɐjd͡ʑɐs̪ʋin̪
दन्तकूर्च	d̪ɐn̪t̪ɐkuːɾt͡ɕɐ
सुशेव	s̪uɕeːʋɐ
प्रदातोस्	pɾɐd̪ɑːt̪ɐws̪
गर्जति	ɡɐ́ɾd͡ʑɐt̪i
मरीचि	mɐ́ɾiːt͡ɕi
नौका	n̪ɑwkɑː
राशिचक्र	ɾɑːɕít͡ɕɐkɾɐ
इह	iɦɐ́
तापयति	t̪ɑːpɐjɐt̪i
सार्थ	s̪ɑ́ːɾt̪ʰɐ
कण्ठेन	kɐɳʈʰɐjn̪ɐ
ग्रन्थि	ɡɾɐn̪t̪ʰi
त्सर्	t̪s̪ɐɾ
चित्र	t͡ɕit̪ɾɐ
तस्मै	t̪ɐs̪mɑːj
श्वन्	ɕʋɐ́n̪
वातायन	ʋɑːt̪ɑːjɐn̪ɐ
नाधे	n̪ɑːd̪ʱɐj
पराशॄ	pɐɾɑːɕr̩ː
दश	d̪ɐɕɐ
वृष्णि	ʋŕ̩ʂɳi
वीर	ʋiːɾɐ́
गाधताम्	ɡɑːd̪ʱɐt̪ɑːm
सर्व	s̪ɐ́ɾʋɐ
ऋज्र	r̩d͡ʑɾɐ́
स्पर्धे	s̪pɐɾd̪ʱɐj
रोहित	ɾɐ́wɦit̪ɐ
एधताम्	ɐjd̪ʱɐt̪ɑːm
लिपि	l̪ipi
चतुर्	t͡ɕɐ́t̪uɾ
ददर्श	d̪ɐd̪ɐ́ɾɕɐ
एषः	eːʂɐh
द्यूत	d̪juːt̪ɐ́
अम्बा	ɐmbɑ́ː
सक्त	s̪ɐkt̪ɐ
खेदाय	kʰeːd̪ɑːjɐ
यजस्	jɐ́d͡ʑɐs̪
रजनी	ɾɐ́d͡ʑɐn̪iː
शीघ्र	ɕiːɡʱɾɐ́
वरिष्ठ	ʋɐɾiʂʈʰɐ
अनस्	ɐn̪ɐs̪
अ	ɐ
स्तीर्ण	s̪t̪iːɾɳɐ́
शवस्	ɕɐ́ʋɐs̪
स्नावन्	s̪n̪ɑːʋɐn̪
जॄ	d͡ʑr̩ː
मषिपात्र	mɐʂipɑːt̪ɾɐ
नाथ	n̪ɑːt̪ʰɐ
आगच्छति	ɑːɡɐtt͡ɕʰɐt̪i
नपात्	n̪ɐ́pɑːt̪
मिमीते	mimiːt̪eː
जुष्ट	d͡ʑuʂʈɐ́
आरा	ɑ́ːɾɑː
सुखिन्	s̪ukʰin̪
कृपायै	kr̩pɑːjɑj
स्तीर्ण	s̪t̪iːɾɳɐ
वृक्ते	ʋr̩kt̪ɐj
श्रवण	ɕɾɐʋɐɳɐ
खनति	kʰɐn̪ɐt̪i
उत्तान	ut̪t̪ɑːn̪ɐ
रति	ɾɐ́t̪i
उपन्यस्यति	upɐn̪jɐs̪jɐt̪i
अंसपृष्ठ	ɐ̃s̪ɐpr̩ʂʈʰɐ
वार्त्ता	ʋɑːɾt̪t̪ɑː
अन	ɐn̪ɐ́
स्कुनाति	s̪kun̪ɑːt̪i
अबुध्न	ɐbud̪ʱn̪ɐ
अलंकार	ɐl̪ɐŋkɑːɾɐ
कारण	kɑːɾɐɳɐ
पृथु	pr̩t̪ʰú
तनेभिः	t̪ɐn̪eːbʱih
ज्योति	d͡ʑjɐwt̪i
सेना	s̪eːn̪ɑː
क्षुर	kʂuɾɐ́
वध	ʋɐd̪ʱɐ
गम्ये	ɡɐmjɐj
ऐतिहासिक	ɑːjt̪iɦɑːs̪ikɐ
सहस्र	s̪ɐɦɐs̪ɾɐ
चिकित्सिकाम्	t͡ɕikit̪s̪ikɑːm
भूर्ज	bʱuːɾd͡ʑɐ
स्तन	s̪t̪ɐn̪ɐ
ऋश	r̩ɕɐ
युवन्	júʋɐn̪
ज्ञाता	d͡ʑɲɑːt̪ɑː
भजते	bʱɐd͡ʑɐt̪eː
प्रतिनिधित्व	pɾɐt̪in̪id̪ʱit̪ʋɐ
पक्ष	pɐ́kʂɐ
अक्षर	ɐkʂɐɾɐ
क्षुल्ल	kʂul̪l̪ɐ
केलि	keːl̪i
ऋष्टि	r̩ʂʈi
भजन	bʱɐd͡ʑɐn̪ɐ
शिफैः	ɕipʰɑːjh
जनितृ	d͡ʑɐn̪it̪ŕ̩
म्रियते	mɾijɐt̪eː
कूप	kuːpɐ
शय्या	ɕɐjjɑː
वल्	ʋɐl̪
दुक्ष	d̪ukʂɐ́
खद्योत	kʰɐ́d̪jɐwt̪ɐ
शुष्कफल	ɕuʂkɐpʰɐl̪ɐ
उदर	ud̪ɐ́ɾɐ
दार	d̪ɑːɾɐ
जजन्ति	d͡ʑɐd͡ʑɐn̪t̪i
लिह्यात्	l̪iɦjɑːt̪
बभूव	bɐbʱúːʋɐ
करिपोत	kɐɾipɐwt̪ɐ
त्वम्	t̪ʋɐ́m
विशति	ʋiɕɐt̪i
त्रयोदश	t̪ɾɐjoːd̪ɐɕɐ
पौरुष	pɑːwɾuʂɐ́
यातृ	jɑːt̪r̩
गच्छामः	ɡɐtt͡ɕʰɑːmɐh
नम्र	n̪ɐmɾɐ́
श्रयति	ɕɾɐjɐt̪i
शंस	ɕɐ̃s̪ɐ
पलाव	pɐl̪ɑ́ːʋɐ
जिह्रेति	d͡ʑiɦɾeːt̪i
वीचिस्	ʋíːt͡ɕis̪
पृथ्वी	pr̩t̪ʰʋíː
जन्म	d͡ʑɐ́n̪mɐ
शूशुजान	ɕúːɕud͡ʑɑːn̪ɐ
देवपुत्र	d̪eːʋɐput̪ɾɐ
राघव	ɾɑːɡʱɐʋɐ
आयु	ɑːju
वेवेक्ति	ʋɐjʋɐjkt̪i
अङ्गन	ɐŋɡɐn̪ɐ
धुरा	d̪ʱuɾɑː
तैलात्	t̪ɑjl̪ɑːt̪
सकृत्	s̪ɐkŕ̩t̪
अपितु	ɐpit̪u
रिप्	ɾíp
छिद्र	t͡ɕʰid̪ɾɐ́
ताली	t̪ɑːl̪iː
हस्ततल	ɦɐs̪t̪ɐt̪ɐl̪ɐ
पराकाष्ठा	pɐɾɑːkɑːʂʈʰɑː
इति	ít̪i
संवहन	s̪ɐ̃ʋɐɦɐn̪ɐ
आज	ɑːd͡ʑɐ
हिन्द्याम्	ɦin̪d̪jɑːm
षष्	ʂɐʂ
व्युष्टि	ʋjuʂʈi
विष	ʋíʂɐ
नेतृ	n̪ɐjt̪ŕ̩
श्याव	ɕjɑːʋɐ́
भूयामहे	bʱuːjɑːmɐɦeː
तुखार	t̪ukʰɑːɾɐ
भीम	bʱiːmɐ́
कम्पन	kɐmpɐn̪ɐ
सर्षप	s̪ɐɾʂɐpɐ
डालेन	ɖɑːl̪eːn̪ɐ
विमान	ʋimɑːn̪ɐ
अर्घ	ɐɾɡʱɐ
मन्तु	mɐ́n̪t̪u
रंहति	ɾɐ̃ɦɐt̪i
अजिगांसत्	ɐd͡ʑiɡɑ̃ːs̪ɐt̪
होतृ	ɦoːt̪r̩
बोभवति	boːbʱɐʋɐt̪i
चतुर्	t͡ɕɐt̪uɾ
वृष्टि	ʋr̩ʂʈí
दोष	d̪oːʂɐ
युध्	jud̪ʱ
पचति	pɐ́t͡ɕɐt̪i
महादेव	mɐɦɑːd̪ɐjʋɐ́
शिफेन	ɕipʰeːn̪ɐ
शरु	ɕɐɾu
धयति	d̪ʱɐ́jɐt̪i
कामकेलि	kɑ́ːmɐkɐjl̪i
शुल्क	ɕul̪kɐ
त्रिंशत्	t̪ɾĩɕɐt̪
जिगांसते	d͡ʑiɡɑ̃ːs̪ɐt̪ɐj
केवल	kɐ́jʋɐl̪ɐ
पृथिवी	pr̩t̪ʰiʋíː
उरण	úɾɐɳɐ
उक्त्वा	ukt̪ʋɑː
दुवस्	d̪uʋɐs̪
कृषक	kr̩ʂɐkɐh
दान	d̪ɑ́ːn̪ɐ
प्रथम	pɾɐt̪ʰɐmɐ
तनानाम्	t̪ɐn̪ɑːn̪ɑːm
वन्दताम्	ʋɐn̪d̪ɐt̪ɑːm
मोचते	moːt͡ɕɐt̪eː
अस्त	ɐs̪t̪ɐ
रुधिर	ɾud̪ʱiɾɐ
फुल्ल	pʰul̪l̪ɐ
शिक्षिकासु	ɕikʂikɑːs̪u
अञ्च्	ɐɲt͡ɕ
प्राथमिक	pɾɑːt̪ʰɐmikɐ
पात्र	pɑ́ːt̪ɾɐ
वपुष्टर	ʋɐ́puʂʈɐɾɐ
करिरत	kɐɾiɾɐt̪ɐ
ग्रसति	ɡɾɐs̪ɐt̪i
सम्राज्	s̪ɐmɾɑːd͡ʑ
अवकर्षति	ɐʋɐkɐɾʂɐt̪i
बालक्रीडा	bɑːl̪ɐkɾiːɖɑː
श्रम्भति	ɕɾɐmbʱɐt̪i
पुनर्दर्शनाय	pun̪ɐɾd̪ɐɾɕɐn̪ɑːjɐ
द्रोण	d̪ɾoːɳɐ
दूरभाषयोः	d̪uːɾɐbʱɑːʂɐjoːh
जीत	d͡ʑiːt̪ɐ́
दर्तृ	d̪ɐ́ɾt̪r̩
प्राण	pɾɑːɳɐ́
युवन	júʋɐn̪ɐ
भगदत्त	bʱɐɡɐd̪ɐt̪t̪ɐ
यवनिका	jɐʋɐn̪ikɑː
सूर्य	s̪uːɾjɐ
उशिज्	uɕíd͡ʑ
शीर्षन्	ɕiːɾʂɐ́n̪
दाम्यति	d̪ɑ́ːmjɐt̪i
किरति	kiɾɐt̪i
अनुमेय	ɐn̪umeːjɐ
अनिन्द्रिय	ɐn̪in̪d̪ɾijɐ
यान	jɑ́ːn̪ɐ
वितस्ति	ʋít̪ɐs̪t̪i
स्वस्ति	s̪ʋɐs̪t̪i
वृषन्	ʋŕ̩ʂɐn̪
अत्र	ɐ́t̪ɾɐ
मे	mɐj
पालयति	pɑːl̪ɐjɐt̪i
अष्ट्रा	ɐʂʈɾɑː
फेन	pʰɐ́jn̪ɐ
भोजन	bʱɐ́wd͡ʑɐn̪ɐ
स्वर्	s̪úʋɐɾ
चिकित्सिके	t͡ɕikit̪s̪ikɐj
दृश्य	d̪r̩ɕjɐ
सत्य	s̪ɐt̪jɐ
अंशु	ɐ̃ɕú
असनिष्यत्	ɐs̪ɐn̪iʂjɐt̪
खनित्राणाम्	kʰɐn̪it̪ɾɑːɳɑːm
मनु	mɐ́n̪u
पादकन्दुकक्रीडा	pɑːd̪ɐkɐn̪d̪ukɐkɾiːɖɑː
विद्यते	ʋid̪jɐ́t̪ɐj
मुमोच	mumoːt͡ɕɐ
ईजितुम्	iːd͡ʑit̪um
सनोति	s̪ɐn̪oːt̪i
कृप्	kr̩p
ब्रह्मा	bɾɐɦmɑː
खेदाभ्याम्	kʰeːd̪ɑːbʱjɑːm
स्मत्	s̪mɐ́t̪
द्विस्	d̪ʋis̪
कादम्ब	kɑːd̪ɐmbɐ
चरति	t͡ɕɐ́ɾɐt̪i
भल्लातक	bʱɐl̪l̪ɑːt̪ɐkɐ
क्षरति	kʂɐɾɐt̪i
ऋणिनी	r̩ɳin̪iː
विस्मय	ʋis̪mɐjɐ
रेफ	ɾɐjpʰɐ
गौस्	ɡɑ́ːws̪
ऊर्मि	uːɾmí
क्षमा	kʂɐmɑː
शरभ	ɕɐɾɐbʱɐ
बुन्द	bun̪d̪ɐ́
काजेन	kɑːd͡ʑeːn̪ɐ
राध्य	ɾɑːd̪ʱjɐ
सज्ज्	s̪ɐdd͡ʑ
राज्	ɾɑ́ːd͡ʑ
नवति	n̪ɐʋɐt̪i
अज्ञान	ɐd͡ʑɲɑːn̪ɐ
प्रभु	pɾɐbʱú
ऋण	r̩ɳɐ́
राजतरंगिणी	ɾɑːd͡ʑɐt̪ɐɾɐŋɡiɳiː
गन्ध	ɡɐn̪d̪ʱɐ
मना	mɐn̪ɑː
तपस्	t̪ɐpɐs̪
तित्तिर	t̪it̪t̪iɾɐ
अकाल	ɐkɑːl̪ɐ
रंसु	ɾɐ̃́s̪u
तुमुल	t̪umul̪ɐ
सरु	s̪ɐ́ɾu
यान	jɑːn̪ɐ
भूमन्	bʱuːmɐn̪
शत्रुणा	ɕɐt̪ɾuɳɑː
भञ्ज्	bʱɐɲd͡ʑ
असि	ɐs̪í
अकार	ɐkɑːɾɐ
राट्	ɾɑ́ːʈ
शत्रूणाम्	ɕɐt̪ɾuːɳɑːm
रुद्ध	ɾud̪d̪ʱɐ́
मुष्क	muʂkɐ́
परेमन्	pɐ́ɾɐjmɐn̪
जग्म	d͡ʑɐɡmɐ
मज्जन्	mɐdd͡ʑɐn̪
शरस्	ɕɐɾɐs̪
दोह	d̪oːɦɐ
खनि	kʰɐn̪í
शेफ	ɕeːpʰɐ
राजकुमार	ɾɑːd͡ʑɐkumɑːɾɐ
गच्छेत्	ɡɐtt͡ɕʰɐjt̪
वेट	ʋeːʈɐ
दूरदर्शन	d̪uːɾɐd̪ɐɾɕɐn̪ɐ
भ्रमण	bʱɾɐmɐɳɐ
अङ्ग	ɐ́ŋɡɐ
दातोस्	d̪ɑːt̪oːs̪
व्यञ्चन	ʋjɐɲt͡ɕɐn̪ɐ
अन्तर	ɐ́n̪t̪ɐɾɐ
मानव	mɑːn̪ɐʋɐ́
जुषते	d͡ʑuʂɐt̪eː
तुर	t̪uɾɐ́
सस्वार	s̪ɐs̪ʋɑːɾɐ
तेजस्	t̪eːd͡ʑɐs̪
सुगन्ध	s̪uɡɐn̪d̪ʱɐ
उपयोगिन्	upɐjɐwɡin̪
पकार	pɐkɑːɾɐ
दीर्घ	d̪iːɾɡʱɐ
कश्चन	kɐɕt͡ɕɐn̪ɐ
गुलाः	ɡul̪ɑːh
इहेह	iɦɐ́jɦɐ
सदैव	s̪ɐd̪ɑːjʋɐ
कण्ठ	kɐɳʈʰɐ
एधे	ɐjd̪ʱɐj
बुद्धि	bud̪d̪ʱi
रेपस्	ɾeːpɐs̪
चक्षु	t͡ɕɐ́kʂu
रोगी	ɾɐwɡiː
शिक्षति	ɕíkʂɐt̪i
पेशी	pɐjɕiː
नु	n̪u
यादस्	jɑːd̪ɐs̪
काम्बोज	kɑːmboːd͡ʑɐ
सेवा	s̪ɐjʋɑː
स्थान	s̪t̪ʰɑːn̪ɐ
अहि	ɐ́ɦi
पुच्छ	putt͡ɕʰɐ
रोचते	ɾoːt͡ɕɐt̪eː
स्वास्थ्य	s̪ʋɑːs̪t̪ʰjɐ
सादेन	s̪ɑːd̪eːn̪ɐ
धामन्	d̪ʱɑːmɐn̪
बीज	bíːd͡ʑɐ
रिष्ट	ɾiʂʈɐ
वेष	ʋeːʂɐ
अगच्छत	ɐɡɐtt͡ɕʰɐt̪ɐ
सदस्	s̪ɐd̪ɐs̪
आता	ɑːt̪ɑː
भर्ग	bʱɐɾɡɐ
अरण	ɐ́ɾɐɳɐ
धी	d̪ʱíː
पादत्राणेन	pɑːd̪ɐt̪ɾɑːɳeːn̪ɐ
दिन	d̪in̪ɐ
प्रताडित	pɾɐt̪ɑːɖit̪ɐ
युवति	juʋɐt̪i
छिनत्ति	t͡ɕʰin̪ɐt̪t̪i
पराक्रमी	pɐɾɑːkɾɐmiː
रेष	ɾɐjʂɐ́
धर्मता	d̪ʱɐ́ɾmɐt̪ɑː
मिश्र	miɕɾɐ́
मगध	mɐɡɐ́d̪ʱɐ
जानि	d͡ʑɑːn̪i
पश्चात्	pɐɕt͡ɕɑːt̪
मेण्ढ्र	mɐjɳɖʱɾɐ
पर्दते	pɐ́ɾd̪ɐt̪ɐj
स्तम्भ	s̪t̪ɐmbʱɐ
व्यायाम	ʋjɑːjɑːmɐ
परिच्छेदैस्	pɐɾitt͡ɕʰeːd̪ɑjs̪
वन्	ʋɐn̪
रोचते	ɾɐ́wt͡ɕɐt̪ɐj
धर्मता	d̪ʱɐɾmɐt̪ɑː
संयोग	s̪ɐ̃jɐwɡɐ
अजति	ɐ́d͡ʑɐt̪i
सदा	s̪ɐd̪ɑː
सस्पिञ्जर	s̪ɐs̪píɲd͡ʑɐɾɐ
मरति	mɐ́ɾɐt̪i
वैदर्भ	ʋɑːjd̪ɐɾbʱɐ
शत्रवे	ɕɐt̪ɾɐʋɐj
साप्ताहिक	s̪ɑːpt̪ɑːɦikɐ
तनू	t̪ɐn̪uː
यह्वा	jɐɦʋɑ́ː
अत्यद्भुत	ɐt̪jɐd̪bʱut̪ɐ
तपति	t̪ɐ́pɐt̪i
ईर्ष्या	iːɾʂjɑː
भानु	bʱɑːn̪ú
वंश	ʋɐ̃ɕɐ́
इषु	iʂu
एवंक्रतु	eːʋɐŋkɾɐt̪u
पादकन्दुक	pɑːd̪ɐkɐn̪d̪ukɐ
गुलेन	ɡul̪eːn̪ɐ
धिष्ण्य	d̪ʱiʂɳjɐ
दूरभाष	d̪uːɾɐbʱɑːʂɐ
पोषण	pɐwʂɐɳɐ
मास	mɑːs̪ɐ
शष्प	ɕɐʂpɐ
ह्वृ	ɦʋr̩
पुच्छ	pútt͡ɕʰɐ
स्नात	s̪n̪ɑːt̪ɐ́
मन्त्रिन्	mɐn̪t̪ɾin̪
पापतीति	pɑːpɐt̪iːt̪i
रभसा	ɾɐbʱɐs̪ɑː
निरन्तर	n̪iɾɐn̪t̪ɐɾɐ
सहस्	s̪ɐ́ɦɐs̪
विन्दति	ʋin̪d̪ɐt̪i
अघ्न्या	ɐɡʱn̪jɑː
कठिनचित्त	kɐʈʰin̪ɐt͡ɕit̪t̪ɐ
पलव	pɐl̪ɐʋɐ
दुर्योण	d̪uɾjoːɳɐ
तनेन	t̪ɐn̪eːn̪ɐ
शौर्य	ɕɑwɾjɐ
गुहा	ɡúɦɑː
प्रत्याशिनी	pɾɐt̪jɑːɕin̪iː
गाढ	ɡɑːɖʱɐ
मयूख	mɐjúːkʰɐ
स्वसृ	s̪ʋɐs̪r̩
विरोधालंकार	ʋiɾɐwd̪ʱɑːl̪ɐŋkɑːɾɐ
श्रोणि	ɕɾɐ́wɳi
जहका	d͡ʑɐɦɐkɑː
हितकार	ɦit̪ɐkɑːɾɐ
धिष्ण्य	d̪ʱíʂɳjɐ
पश्यति	pɐɕjɐt̪i
घर्म	ɡʱɐɾmɐ́
वल	ʋɐl̪ɐ́
जनति	d͡ʑɐ́n̪ɐt̪i
नृत्यति	n̪r̩t̪jɐt̪i
बिभर्ति	bibʱɐɾt̪i
आयात	ɑːjɑːt̪ɐ
अयस्कार	ɐjɐs̪kɑːɾɐ
दुरोण	d̪uɾoːɳɐ
अंसपृष्ठ	ɐ̃́s̪ɐpr̩ʂʈʰɐ
करिदन्त	kɐɾid̪ɐn̪t̪ɐ
सदैव	s̪ɐd̪ɑjʋɐ
मेरुदण्ड	mɐjɾud̪ɐɳɖɐ
चिकित्सकान्	t͡ɕikit̪s̪ɐkɑːn̪
मित्र	mit̪ɾɐ
शुच्	ɕut͡ɕ
प्रउग्य	pɾɐuɡjɐ́
लिम्पति	l̪impɐt̪i
ज	d͡ʑɐ
सौर	s̪ɑːwɾɐ
खेल्	kʰeːl̪
धेनोः	d̪ʱeːn̪oːh
क्षय	kʂɐjɐ
गोक्षीर	ɡoːkʂiːɾɐ
स्कन्ध	s̪kɐn̪d̪ʱɐ
कठिनहृदय	kɐʈʰin̪ɐɦr̩d̪ɐjɐ
काच	kɑːt͡ɕɐ
मास्	mɑ́ːs̪
ऊबध्य	úːbɐd̪ʱjɐ
वल	ʋɐl̪ɐ
रश्मि	ɾɐɕmí
बर्बटी	bɐɾbɐʈiː
पीयति	piːjɐt̪i
संकल्पाय	s̪ɐŋkɐl̪pɑːjɐ
वपुष्य	ʋɐpuʂjɐ́
सम्	s̪ɐm
मति	mɐt̪í
अभिषचते	ɐbʱiʂɐt͡ɕɐt̪ɐj
शाम	ɕɑːmɐ
स्कम्भ	s̪kɐmbʱɐ
कत्थति	kɐt̪t̪ʰɐt̪i
आवाभ्यां	ɑːʋɑːbʱjɑːm
बर्हिस्	bɐɾɦis̪
तूय	t̪uːjɐ
कतर	kɐt̪ɐɾɐ́
स्वार्थिनी	s̪ʋɑːɾt̪ʰin̪iː
सिंहपुर	s̪ĩɦɐ́puɾɐ
सुस्वादु	s̪us̪ʋɑːd̪u
क्षित	kʂit̪ɐ
हास्यास्पद	ɦɑːs̪jɑːs̪pɐd̪ɐ
तृप्ति	t̪ŕ̩pt̪i
वैदिक	ʋɑːjd̪ikɐ́
शिक्षति	ɕikʂɐt̪i
सन्ति	s̪ɐn̪t̪i
गच्छेः	ɡɐtt͡ɕʰeːh
आस्ते	ɑːs̪t̪eː
भ्रंश	bʱɾɐ̃ɕɐ
सन	s̪ɐ́n̪ɐ
जायते	d͡ʑɑːjɐt̪eː
सप्तन्	s̪ɐpt̪ɐn̪
चमस	t͡ɕɐmɐs̪ɐ́
मेहति	meːɦɐt̪i
युष्माक	juʂmɑːkɐ
गच्छेतम्	ɡɐtt͡ɕʰɐjt̪ɐm
भूमिपुत्र	bʱúːmiput̪ɾɐ
पञ्चन्	pɐ́ɲt͡ɕɐn̪
रघु	ɾɐɡʱu
प्रेषण	pɾɐ́jʂɐɳɐ
सत्यतानाम्	s̪ɐt̪jɐt̪ɑːn̪ɑːm
ऋषभ	r̩ʂɐbʱɐ́
विश्वास	ʋiɕʋɑːs̪ɐ
गणक	ɡɐ́ɳɐkɐ
जंहस्	d͡ʑɐ̃́ɦɐs̪
गुरवस्	ɡuɾɐʋɐs̪
धनंजय	d̪ʱɐn̪ɐɲd͡ʑɐjɐ́
द्विस्	d̪ʋís̪
देग्धि	d̪ɐ́jɡd̪ʱi
आशु	ɑːɕú
कदम्	kɐd̪ɐm
बहुक	bɐɦukɐ
कलत्र	kɐl̪ɐt̪ɾɐ
अदस्	ɐd̪ɐ́s̪
कोमल	koːmɐl̪ɐ
रंहति	ɾɐ̃́ɦɐt̪i
मातृ	mɑːt̪r̩
अंसकूट	ɐ̃s̪ɐkuːʈɐ
शष्पिञ्जर	ɕɐʂpíɲd͡ʑɐɾɐ
बहुल	bɐɦul̪ɐ
चयते	t͡ɕɐjɐt̪eː
भावित	bʱɑːʋit̪ɐ
हेक्का	ɦeːkkɑː
खनित्रयोः	kʰɐn̪it̪ɾɐjoːh
अदस्	ɐd̪ɐs̪
चिकित्सकौ	t͡ɕikit̪s̪ɐkɑːw
परिच्छेदेषु	pɐɾitt͡ɕʰɐjd̪ɐjʂu
गृभ्णाति	ɡr̩bʱɳɑːt̪i
शिव	ɕiʋɐ́
अद्	ɐd̪
अभितस्	ɐbʱit̪ɐs̪
ओकार	oːkɑːɾɐ
सादान्	s̪ɑːd̪ɑːn̪
सह	s̪ɐɦɐ
वीति	ʋiːt̪i
छिन्न	t͡ɕʰin̪n̪ɐ́
बसयान	bɐs̪ɐjɑːn̪ɐ
रिप्र	ɾipɾɐ
क्षेत्र	kʂeːt̪ɾɐ
ईर्षित	iːɾʂit̪ɐ
नभ्य	n̪ɐbʱjɐ
जहाति	d͡ʑɐ́ɦɑːt̪i
अनीक	ɐ́n̪iːkɐ
निधातोस्	n̪íd̪ʱɑːt̪ɐws̪
शृङ्ग	ɕr̩ŋɡɐ
परुष	pɐɾuʂɐ́
गभीर	ɡɐbʱiːɾɐ́
पुत्र	put̪ɾɐ́
परिच्छेदस्	pɐɾitt͡ɕʰɐjd̪ɐs̪
चिकित्सिकाः	t͡ɕikit̪s̪ikɑːh
सादेभ्यः	s̪ɑːd̪eːbʱjɐh
स्नुषा	s̪n̪uʂɑː
श्रद्धा	ɕɾɐd̪d̪ʱɑ́ː
कुठार	kuʈʰɑːɾɐ
मुद्ग	mud̪ɡɐ
चरति	t͡ɕɐɾɐt̪i
बाल्य	bɑːl̪jɐ
दूरभाषेषु	d̪uːɾɐbʱɑːʂɐjʂu
हर्षण	ɦɐ́ɾʂɐɳɐ
अन्न	ɐ́n̪n̪ɐ
जग्मुः	d͡ʑɐɡmuh
तीर्त्वा	t̪iːɾt̪ʋɑː
चोरयति	t͡ɕɐwɾɐjɐt̪i
अगच्छः	ɐɡɐtt͡ɕʰɐh
सहते	s̪ɐ́ɦɐt̪ɐj
स्यात्	s̪jɑːt̪
सिसर्ति	s̪is̪ɐɾt̪i
सूर्यकान्ति	s̪uːɾjɐkɑːn̪t̪i
छुरी	t͡ɕʰuɾiː
जालपृष्ठ	d͡ʑɑːl̪ɐpr̩ʂʈʰɐ
डालान्	ɖɑːl̪ɑːn̪
शङ्के	ɕɐŋkɐj
जवस्	d͡ʑɐʋɐs̪
शिशु	ɕíɕu
यह्व	jɐɦʋɐ́
रजिष्ठ	ɾɐ́d͡ʑiʂʈʰɐ
भयते	bʱɐ́jɐt̪ɐj
रैवत	ɾɑːjʋɐt̪ɐ́
तप्	t̪ɐp
सादासः	s̪ɑːd̪ɑːs̪ɐh
वक्षति	ʋɐkʂɐt̪i
तविष्या	t̪ɐʋiʂjɑː
स्वपितुम्	s̪ʋɐpit̪um
आति	ɑːt̪i
मनुस्	mɐ́n̪us̪
सावधान	s̪ɑːʋɐd̪ʱɑːn̪ɐ
एध	ɐ́jd̪ʱɐ
संलक्ष्	s̪ɐ̃l̪ɐkʂ
खिन्न	kʰin̪n̪ɐ
प्रत्याशी	pɾɐt̪jɑːɕiː
असत्	ɐ́s̪ɐt̪
यात्रिन्	jɑːt̪ɾin̪
कृपाणाम्	kr̩pɑːɳɑːm
अल्पप्राण	ɐl̪pɐpɾɑːɳɐ
भवतात्	bʱɐʋɐt̪ɑːt̪
मणि	mɐɳi
ऋतूनाम्	r̩t̪uːn̪ɑːm
अक्षय्य	ɐkʂɐjjɐ́
यातु	jɑːt̪ú
ऋत	r̩t̪ɐ
सत्त्र	s̪ɐt̪t̪ɾɐ
शत्रो	ɕɐt̪ɾoː
केम्बुक	kɐjmbukɐ
जव	d͡ʑɐ́ʋɐ
द्रवति	d̪ɾɐʋɐt̪i
केश	keːɕɐ
परिवर्तते	pɐ́ɾiʋɐɾt̪ɐt̪ɐj
यहु	jɐ́ɦu
गुण	ɡuɳɐ
यूस्	júːs̪
अहि	ɐɦi
हिन्दु	ɦin̪d̪u
रशना	ɾɐɕɐn̪ɑ́ː
वर्तिस्	ʋɐɾt̪ís̪
ईक्ष	iːkʂɐ
द्वेष	d̪ʋeːʂɐ
कपोत	kɐpɐ́wt̪ɐ
क्रीडक	kɾiːɖɐ́kɐ
यम	jɐmɐ
अर्चति	ɐɾt͡ɕɐt̪i
चन्द्रमाः	t͡ɕɐn̪d̪ɾɐmɑːh
जुहोति	d͡ʑuɦoːt̪i
तैलेन	t̪ɑːjl̪ɐjn̪ɐ
मेक्षयति	meːkʂɐjɐt̪i
उदक	ud̪ɐkɐ
ऋजु	r̩d͡ʑu
द्वेष	d̪ʋɐ́jʂɐ
विशाल	ʋiɕɑːl̪ɐ́
द्रुह्	d̪ɾúɦ
मसी	mɐs̪iː
कशप्लक	kɐ́ɕɐpl̪ɐkɐ
छर्दति	t͡ɕʰɐ́ɾd̪ɐt̪i
ध्वज	d̪ʱʋɐd͡ʑɐ́
बृहन्त्	br̩ɦɐ́n̪t̪
ग्रन्थि	ɡɾɐn̪t̪ʰí
शाल	ɕɑːl̪ɐ́
ज्रयस्	d͡ʑɾɐ́jɐs̪
वेद	ʋeːd̪ɐ
पण्डित	pɐɳɖit̪ɐ́
तैलात्	t̪ɑːjl̪ɑːt̪
द्वेष्टि	d̪ʋɐ́jʂʈi
व्यजन	ʋjɐd͡ʑɐn̪ɐ
नाथतात्	n̪ɑːt̪ʰɐt̪ɑːt̪
मूर्खताः	muːɾkʰɐt̪ɑːh
गृध्यति	ɡr̩d̪ʱjɐt̪i
गूर्त	ɡuːɾt̪ɐ́
प्रभु	pɾɐbʱu
धर्मयुद्ध	d̪ʱɐɾmɐjud̪d̪ʱɐ
उभ्नाति	ubʱn̪ɑ́ːt̪i
द्वितीया	d̪ʋit̪iːjɑː
श्री	ɕɾiː
उत्पीठिका	ut̪piːʈʰikɑː
गमिष्यथः	ɡɐmiʂjɐt̪ʰɐh
संध्या	s̪ɐn̪d̪ʱjɑː
राद्धि	ɾɑːd̪d̪ʱi
भल्लूक	bʱɐl̪l̪uːkɐ
घृण	ɡʱr̩ɳɐ́
रन्ध्र	ɾɐn̪d̪ʱɾɐ
शोषयति	ɕoːʂɐjɐt̪i
मति	mɐ́t̪i
शत्र्वोः	ɕɐt̪ɾʋoːh
शाव	ɕɑːʋɐ
यत्न	jɐt̪n̪ɐ
गन्तोस्	ɡɐn̪t̪oːs̪
दूरभाषेभ्यः	d̪uːɾɐbʱɑːʂɐjbʱjɐh
व्याघ्र	ʋjɑːɡʱɾɐ́
षकार	ʂɐkɑːɾɐ
सन्ति	s̪ɐ́n̪t̪i
त्विषि	t̪ʋiʂi
देवपुत्र	d̪ɐjʋɐput̪ɾɐ
स्नेह	s̪n̪eːɦɐ
जामित्र	d͡ʑɑːmit̪ɾɐ
मनस्	mɐ́n̪ɐs̪
डमरुक	ɖɐmɐɾukɐ
द्व	d̪ʋɐ
युज्य	júd͡ʑjɐ
देवभाषा	d̪eːʋɐbʱɑːʂɑː
स्वादु	s̪ʋɑːd̪ú
कदाः	kɐd̪ɑːh
आपण	ɑːpɐɳɐ
गोरूप	ɡoːɾuːpɐ
कला	kɐl̪ɑː
खुद्	kʰud̪
दोष	d̪ɐ́wʂɐ
हस्त	ɦɐ́s̪t̪ɐ
भरीमन्	bʱɐɾiːmɐn̪
नॄन्	n̪ŕ̩ːn̪
वयति	ʋɐ́jɐt̪i
दण्ड	d̪ɐɳɖɐ
खेदेभ्यः	kʰeːd̪eːbʱjɐh
दातोस्	d̪ɑ́ːt̪ɐws̪
चिकेत्ति	t͡ɕikeːt̪t̪i
अनङ्ग	ɐn̪ɐŋɡɐ
समुद्र	s̪ɐmud̪ɾɐ́
मन्तृ	mɐn̪t̪ŕ̩
वैष्णव	ʋɑːjʂɳɐʋɐ́
परिच्छेदम्	pɐɾitt͡ɕʰeːd̪ɐm
सेवि	s̪ɐjʋi
आञ्छन	ɑːɲt͡ɕʰɐn̪ɐ
देह	d̪eːɦɐ
स्तुका	s̪t̪úkɑː
हय	ɦɐjɐ
मृद्	mŕ̩d̪
स्वृ	s̪ʋr̩
अश्वा	ɐɕʋɑː
शिफम्	ɕipʰɐm
अविद्या	ɐʋid̪jɑː
पश्चात्	pɐɕt͡ɕɑ́ːt̪
द्यौस्	d̪jɑ́ːws̪
ऊनविंशति	uːn̪ɐʋĩɕɐt̪i
काजैः	kɑːd͡ʑɑːjh
एला	eːl̪ɑː
भोट	bʱɐ́wʈɐh
एकादश	eːkɑːd̪ɐɕɐ
जनि	d͡ʑɐn̪i
संवत्सर	s̪ɐ̃ʋɐt̪s̪ɐɾɐ
विसृष्टि	ʋís̪r̩ʂʈi
प्सरस्	ps̪ɐ́ɾɐs̪
रमते	ɾɐ́mɐt̪ɐj
विदाहक	ʋid̪ɑːɦɐkɐ
जय	d͡ʑɐjɐ́
दीन	d̪iːn̪ɐ́
उचित	ut͡ɕit̪ɐ
निरवदाति	n̪iɾɐʋɐd̪ɑːt̪i
राजति	ɾɑːd͡ʑɐt̪i
अपि	ɐpi
दधन्ति	d̪ɐd̪ʱɐn̪t̪i
विकृत	ʋíkr̩t̪ɐ
हरस्	ɦɐ́ɾɐs̪
पाप	pɑ́ːpɐ
ऊर्दताम्	uːɾd̪ɐt̪ɑːm
वेष	ʋɐ́jʂɐ
शत्र्वे	ɕɐt̪ɾʋɐj
तरणताल	t̪ɐɾɐɳɐt̪ɑːl̪ɐ
रीळ्ह	ɾiːɭ̆ɦɐ
राष्ट्रपति	ɾɑːʂʈɾɐpɐt̪i
ताम्रमुख	t̪ɑːmɾɐmukʰɐ
सृष्ट	s̪r̩ʂʈɐ
भोग्य	bʱoːɡjɐ
ऊर्ध्ववायु	uːɾd̪ʱʋɐʋɑːju
रिहति	ɾiɦɐ́t̪i
खेदे	kʰɐjd̪ɐj
आहरण	ɑːɦɐɾɐɳɐ
शत्र्वे	ɕɐt̪ɾʋeː
कर्पास	kɐɾpɑːs̪ɐ
पौष्टिक	pɑwʂʈikɐ
ऐच्छत्	ɑjtt͡ɕʰɐt̪
कारा	kɑːɾɑː
स्वेदक	s̪ʋeːd̪ɐkɐ
पृणाति	pr̩ɳɑːt̪i
अर्चि	ɐɾt͡ɕí
जन्तु	d͡ʑɐn̪t̪ú
स्थापयतु	s̪t̪ʰɑːpɐjɐt̪u
गल्ल	ɡɐl̪l̪ɐ
बोधि	bɐwd̪ʱí
लेखन	l̪ɐjkʰɐn̪ɐ
रजनी	ɾɐd͡ʑɐn̪iː
परिच्छेदेभ्यस्	pɐɾitt͡ɕʰeːd̪eːbʱjɐs̪
शङ्कते	ɕɐŋkɐt̪eː
काजैः	kɑːd͡ʑɑjh
सम	s̪ɐmɐ́
स्नानागार	s̪n̪ɑːn̪ɑːɡɑːɾɐ
कठिनपृष्ठ	kɐʈʰin̪ɐpr̩ʂʈʰɐ
ध्रजति	d̪ʱɾɐd͡ʑɐt̪i
जीवति	d͡ʑiːʋɐt̪i
संकल्पात्	s̪ɐŋkɐl̪pɑːt̪
तैलस्य	t̪ɑjl̪ɐs̪jɐ
भोटान्त	bʱoːʈɑːn̪t̪ɐ
वेग	ʋɐjɡɐ
विंशति	ʋĩɕɐt̪i
अधम	ɐd̪ʱɐmɐ
स्वर्ता	s̪ʋɐɾt̪ɑː
शकार	ɕɐkɑːɾɐ
आराम	ɑːɾɑːmɐ
दुःस्वप्न	d̪uhs̪ʋɐpn̪ɐ
फलनम्	pʰɐl̪ɐn̪ɐm
प्रज्ञान	pɾɐd͡ʑɲɑːn̪ɐ
सिस्वरिषति	s̪is̪ʋɐɾiʂɐt̪i
तात	t̪ɑːt̪ɐ́
अस्मि	ɐ́s̪mi
एषः	ɐjʂɐh
कनीनिका	kɐn̪íːn̪ikɑː
शं	ɕɐ́m
संन्यासिनी	s̪ɐ̃n̪jɑːs̪in̪iː
पुनाति	pun̪ɑːt̪i
दम्पती	d̪ɐmpɐt̪iː
बाहु	bɑːɦu
कन्या	kɐn̪jɑː
चिकित्सकस्य	t͡ɕikit̪s̪ɐkɐs̪jɐ
स्पश्	s̪pɐɕ
ज्ञापयति	d͡ʑɲɑːpɐjɐt̪i
श्लिष्यतः	ɕl̪iʂjɐt̪ɐh
क्रेतृ	kɾɐjt̪r̩
भूयध्वे	bʱuːjɐd̪ʱʋeː
अकन्या	ɐ́kɐn̪jɑː
तुर	t̪uɾɐ
पापा	pɑːpɑː
वीर	ʋiːɾɐ
शल्य	ɕɐl̪jɐ
द्यौष्पितृ	d̪jɑ́ːwʂpit̪ŕ̩
गोरूप	ɡɐwɾuːpɐ́
रयि	ɾɐjí
नगर	n̪ɐɡɐɾɐ
कय	kɐjɐ
शारद	ɕɑːɾɐd̪ɐ
द्रुह्यति	d̪ɾuɦjɐ́t̪i
मेढ्र	meːɖʱɾɐ
शेप	ɕɐ́jpɐ
भूये	bʱuːjɐj
प्रथस्	pɾɐt̪ʰɐs̪
दूर	d̪uːɾɐ
यूथ	juːt̪ʰɐ́
मृद्	mr̩d̪
शक्नोति	ɕɐkn̪ɐ́wt̪i
प्राप्तिका	pɾɑːpt̪ikɑː
पुवस्	puʋɐs̪
द्वंद्व	d̪ʋɐn̪d̪ʋɐ
मिथस्	mit̪ʰɐ́s̪
अंश	ɐ̃ɕɐ
धावति	d̪ʱɑːʋɐt̪i
वेवेष्टि	ʋeːʋeːʂʈi
वल्क	ʋɐl̪kɐ́
तृणेढि	t̪r̩ɳɐjɖʱi
पुनर्	pún̪ɐɾ
नवति	n̪ɐʋɐt̪í
संकल्पौ	s̪ɐŋkɐl̪pɑw
दण्डदीप	d̪ɐɳɖɐd̪iːpɐ
वष्टि	ʋɐʂʈi
पालङ्की	pɑːl̪ɐŋkiː
दृष्ट	d̪r̩ʂʈɐ
अप	ɐ́pɐ
रसायन	ɾɐs̪ɑːjɐn̪ɐ
परुत्	pɐɾut̪
गर्जति	ɡɐɾd͡ʑɐt̪i
महाकवि	mɐɦɑːkɐʋi
अक्ष	ɐkʂɐ
अपशब्द	ɐpɐɕɐbd̪ɐ
दोस्	d̪oːs̪
बाढ	bɑːɖʱɐ́
नाभि	n̪ɑːbʱi
प्रतिमा	pɾɐt̪imɑ́ː
उज्ज्वल	udd͡ʑʋɐl̪ɐ
पृणाति	pr̩ɳɑ́ːt̪i
ईशान	íːɕɑːn̪ɐ
तनस्य	t̪ɐn̪ɐs̪jɐ
प्रवदति	pɾɐʋɐd̪ɐt̪i
हवते	ɦɐ́ʋɐt̪ɐj
नस्	n̪ɐs̪
भुग्न	bʱuɡn̪ɐ́
गच्छेव	ɡɐtt͡ɕʰeːʋɐ
नाभि	n̪ɑ́ːbʱi
दुह्	d̪úɦ
जिन	d͡ʑin̪ɐ
अर्धपथ	ɐɾd̪ʱɐ́pɐt̪ʰɐ
हन्	ɦɐ́n̪
चयते	t͡ɕɐ́jɐt̪ɐj
शिरस्	ɕíɾɐs̪
अश्मन्	ɐɕmɐn̪
स्वरिता	s̪ʋɐɾit̪ɑː
अभिवृष्ट	ɐbʱíʋr̩ʂʈɐ
क्षम्	kʂɐ́m
अष्ट	ɐʂʈɐ
यकृत्	jɐ́kr̩t̪
स्रोतस्	s̪ɾɐ́wt̪ɐs̪
गेह	ɡeːɦɐ
लोभ	l̪ɐwbʱɐ
गुलाभ्याम्	ɡul̪ɑːbʱjɑːm
जलूका	d͡ʑɐl̪uːkɑː
ववर्त	ʋɐʋɐ́ɾt̪ɐ
भाग	bʱɑːɡɐ
सादाः	s̪ɑːd̪ɑːh
पोस्फोर्ति	poːs̪pʰoːɾt̪i
हलदिका	ɦɐl̪ɐd̪ikɑː
रोमन्	ɾɐ́wmɐn̪
अही	ɐɦíː
जान	d͡ʑɑːn̪ɐ
देवृ	d̪eːʋr̩
बस्त	bɐs̪t̪ɐ́
कलश	kɐl̪ɐ́ɕɐ
कृन्ततः	kr̩n̪t̪ɐt̪ɐh
बहुत्व	bɐɦut̪ʋɐ
कृकर	kr̩kɐɾɐ
क्षुद्र	kʂud̪ɾɐ́
पृषत्	pŕ̩ʂɐt̪
रेभ	ɾeːbʱɐ
अक्षि	ɐkʂi
अहं	ɐɦɐm
शासन	ɕɑːs̪ɐn̪ɐ
जनितृ	d͡ʑɐn̪it̪r̩
वराह	ʋɐɾɑːɦɐ́
मेक्षयति	mɐjkʂɐjɐt̪i
लूता	l̪uːt̪ɑ́ː
अद्रि	ɐ́d̪ɾi
जठर	d͡ʑɐʈʰɐ́ɾɐ
गमति	ɡɐ́mɐt̪i
चमति	t͡ɕɐmɐt̪i
ताष्टि	t̪ɑ́ːʂʈi
अक्ष	ɐ́kʂɐ
सादयोः	s̪ɑːd̪ɐjoːh
सदस्पति	s̪ɐ́d̪ɐs̪pɐt̪i
अवति	ɐ́ʋɐt̪i
द्राघ्मन्	d̪ɾɑːɡʱmɐn̪
बल	bɐ́l̪ɐ́
तन	t̪ɐ́n̪ɐ
घ्रंस	ɡʱɾɐ̃s̪ɐ
प्रैणान	pɾɑjɳɑːn̪ɐ
जेन्य	d͡ʑɐ́jn̪jɐ
धृष्ट	d̪ʱr̩ʂʈɐ
संलयन	s̪ɐ̃l̪ɐjɐn̪ɐ
सेविका	s̪eːʋikɑː
मृग	mr̩ɡɐ́
चेतिष्यति	t͡ɕeːt̪iʂjɐt̪i
कुप्	kup
मूर	muːɾɐ́
सिंह	s̪ĩɦɐ́
भ्रूण	bʱɾuːɳɐ́
जतु	d͡ʑɐt̪u
सम्पत्ति	s̪ɐmpɐt̪t̪i
वग्नु	ʋɐɡn̪u
याति	jɑ́ːt̪i
तुच्छ्य	t̪utt͡ɕʰjɐ́
करिक	kɐɾikɐ
गणक	ɡɐɳɐkɐ
आत्	ɑ́ːt̪
स्वाद	s̪ʋɑːd̪ɐ́
भरति	bʱɐɾɐt̪i
चीन	t͡ɕiːn̪ɐ
बोधते	boːd̪ʱɐt̪eː
नेदीयस्	n̪ɐ́jd̪iːjɐs̪
संकल्पेन	s̪ɐŋkɐl̪pɐjn̪ɐ
पुरा	puɾɑ́ː
सीदति	s̪íːd̪ɐt̪i
हिक्किका	ɦikkikɑː
भेषज	bʱɐjʂɐd͡ʑɐ́
ङकार	ŋɐkɑːɾɐ
चैत्र	t͡ɕɑːjt̪ɾɐ
अयन	ɐ́jɐn̪ɐ
ज्ञात	d͡ʑɲɑːt̪ɐ
आतिथ्य	ɑːt̪it̪ʰjɐ
भीम	bʱiːmɐ
तल्	t̪ɐl̪
कुत्र	kut̪ɾɐ
द्वितीया	d̪ʋit̪íːjɑː
क्षुध्	kʂud̪ʱ
कारवेल्ल	kɑːɾɐʋeːl̪l̪ɐ
देव	d̪ɐjʋɐ́
त्मन्	t̪mɐ́n̪
राति	ɾɑːt̪i
भाषते	bʱɑ́ːʂɐt̪ɐj
धातृ	d̪ʱɑːt̪ŕ̩
छिद्	t͡ɕʰid̪
परस्वत्	pɐ́ɾɐs̪ʋɐt̪
परिषद्	pɐɾiʂɐ́d̪
वक्तवे	ʋɐkt̪ɐʋɐj
श्विन्दे	ɕʋin̪d̪eː
तनाय	t̪ɐn̪ɑːjɐ
ते	t̪eː
तपस्	t̪ɐ́pɐs̪
अव	ɐ́ʋɐ
भवसि	bʱɐʋɐs̪i
वृत्र	ʋr̩t̪ɾɐ
भाल	bʱɑːl̪ɐ
आशय	ɑːɕɐjɐ
महादेव	mɐɦɑːd̪eːʋɐ
शुख	ɕukʰɐ́
समुद्र	s̪ɐmud̪ɾɐ
रिशादस्	ɾiɕɑːd̪ɐs̪
ऊवध्य	úːʋɐd̪ʱjɐ
लोभ	l̪oːbʱɐ
शत्रवः	ɕɐt̪ɾɐʋɐh
स्वस्ति	s̪ʋɐs̪t̪í
ञकार	ɲɐkɑːɾɐ
पाटलिपुत्र	pɑːʈɐl̪iput̪ɾɐ
किम्पुरुष	kimpúɾuʂɐ
काल	kɑːl̪ɐ
युद्ध	jud̪d̪ʱɐ
शय्या	ɕeːjɑː
वञ्चति	ʋɐɲt͡ɕɐt̪i
तत्रैव	t̪ɐt̪ɾɑːjʋɐ
उपकरणप्रयोजक	upɐkɐɾɐɳɐpɾɐjoːd͡ʑɐkɐ
अज्ञ	ɐd͡ʑɲɐ
पाय्य	pɑ́ːjjɐ
घ	ɡʱɐ
कृणोति	kr̩ɳɐ́wt̪i
रामेण	ɾɑːmɐjɳɐ
वर्तिस्	ʋɐɾt̪is̪
बन्धु	bɐn̪d̪ʱu
भूये	bʱuːjeː
हेति	ɦɐjt̪í
हृद्	ɦŕ̩d̪
एवंगत	eːʋɐŋɡɐt̪ɐ
वर्ष	ʋɐɾʂɐ
लीढे	l̪iːɖʱeː
हस्ताक्षर	ɦɐs̪t̪ɑːkʂɐɾɐ
होत्र	ɦɐwt̪ɾɐ́
सीक्षते	s̪iːkʂɐt̪eː
पृथुक	pŕ̩t̪ʰukɐ
प्रीणाति	pɾiːɳɑːt̪i
तारक	t̪ɑːɾɐkɐ
अहंकारिणी	ɐɦɐŋkɑːɾiɳiː
सत्यतायै	s̪ɐt̪jɐt̪ɑːjɑːj
उच्चैस्	utt͡ɕɑ́ːjs̪
लवण	l̪ɐʋɐɳɐ́
ज्योतिस्	d͡ʑjɐ́wt̪is̪
उप	úpɐ
लक्ष्मी	l̪ɐkʂmíː
प्रीणाति	pɾiːɳɑ́ːt̪i
चर्मन्	t͡ɕɐɾmɐn̪
संकल्पेन	s̪ɐŋkɐl̪peːn̪ɐ
दधाति	d̪ɐd̪ʱɑːt̪i
मुद्रा	mud̪ɾɑ́ː
गच्छथ	ɡɐtt͡ɕʰɐt̪ʰɐ
दिशति	d̪iɕɐ́t̪i
धूलि	d̪ʱuːl̪i
अष्ट	ɐʂʈɐ́
सादस्य	s̪ɑːd̪ɐs̪jɐ
पुवस्	púʋɐs̪
कृपायै	kr̩pɑːjɑːj
कामकेलि	kɑːmɐkeːl̪i
त्रै	t̪ɾɑːj
शिंष्मः	ɕĩʂmɐh
व्युत्पादक	ʋjut̪pɑːd̪ɐkɐ
वमति	ʋɐ́mɐt̪i
वृद्धि	ʋŕ̩d̪d̪ʱi
न्यून	n̪júːn̪ɐ
बन्ध	bɐn̪d̪ʱɐ
पूत	puːt̪ɐ
राज्ञ्योः	ɾɑːd͡ʑɲjɐwh
उदासिन्	ud̪ɑːs̪in̪
श्रोत्र	ɕɾoːt̪ɾɐ
अस्र	ɐs̪ɾɐ
वृष्ट	ʋr̩ʂʈɐ
वसन्तर्तु	ʋɐs̪ɐn̪t̪ɐ́ɾt̪u
प्रतिशाखा	pɾɐt̪iɕɑːkʰɑː
लेढि	l̪eːɖʱi
खनन	kʰɐn̪ɐn̪ɐ
मज्जस्	mɐdd͡ʑɐs̪
तस्य	t̪ɐs̪jɐ
ऊवध्य	uːʋɐd̪ʱjɐ
ग्रीवा	ɡɾiːʋɑː
किरण	kiɾɐ́ɳɐ
एतोस्	ɐ́jt̪ɐws̪
शोक	ɕoːkɐ
अषाढ	ɐʂɑːɖʱɐ
नियम	n̪ijɐmɐ́
यकारादिपद	jɐkɑːɾɑːd̪ipɐd̪ɐ
अज्र्य	ɐd͡ʑɾjɐ
तालिन्	t̪ɑːl̪in̪
यज्ञोपवीत	jɐd͡ʑɲoːpɐʋiːt̪ɐ
मौन	mɑwn̪ɐ
अस्ति	ɐ́s̪t̪i
कपीश	kɐpiːɕɐ
दोषा	d̪ɐwʂɑ́ː
वर्त्मन्	ʋɐ́ɾt̪mɐn̪
स्वर	s̪ʋɐɾɐ
सनातन	s̪ɐn̪ɑːt̪ɐn̪ɐ
शिफासः	ɕipʰɑːs̪ɐh
पृच्छा	pr̩tt͡ɕʰɑː
करोतु	kɐɾɐwt̪u
वृक्क	ʋr̩kkɐ
मेढ्र	mɐ́jɖʱɾɐ
नग्न	n̪ɐɡn̪ɐ
यामन्	jɑ́ːmɐn̪
श्विन्दे	ɕʋin̪d̪ɐj
भौम	bʱɑwmɐ
धुर	d̪ʱuɾɐ
गति	ɡɐ́t̪i
रेफ	ɾeːpʰɐ
ग्मा	ɡmɑ́ː
प्रासाद	pɾɑːs̪ɑːd̪ɐ
परिच्छेदेषु	pɐɾitt͡ɕʰeːd̪eːʂu
अप	ɐpɐ
फलनैः	pʰɐl̪ɐn̪ɑːjh
हर्षित	ɦɐɾʂit̪ɐ
वर्धति	ʋɐ́ɾd̪ʱɐt̪i
गाथ	ɡɑːt̪ʰɐ
संकल्पाभ्याम्	s̪ɐŋkɐl̪pɑːbʱjɑːm
नेत्रोपम	n̪eːt̪ɾoːpɐmɐ
गच्छतु	ɡɐtt͡ɕʰɐt̪u
इक्षु	ikʂu
दुरोण	d̪uɾɐwɳɐ́
पृच्छति	pr̩tt͡ɕʰɐ́t̪i
सर्जन	s̪ɐ́ɾd͡ʑɐn̪ɐ
केलि	kɐjl̪i
सिद्ध	s̪id̪d̪ʱɐ
ग्रसति	ɡɾɐ́s̪ɐt̪i
वङ्कु	ʋɐŋku
गुलात्	ɡul̪ɑːt̪
पटोल	pɐʈɐwl̪ɐ
पाटल	pɑːʈɐl̪ɐ́
रारहाण	ɾɑːɾɐɦɑːɳɐ
कलविङ्क	kɐl̪ɐʋiŋkɐ
तेषां	t̪eːʂɑːm
षाण्मासिक	ʂɑːɳmɑːs̪ikɐ
युष्मान्	juʂmɑːn̪
नर्य	n̪ɐ́ɾjɐ
कर्तवे	kɐ́ɾt̪ɐʋɐj
रुच्	ɾút͡ɕ
तुञ्ज	t̪uɲd͡ʑɐ
स्वरु	s̪ʋɐɾu
स्तरु	s̪t̪ɐɾu
सात	s̪ɑːt̪ɐ
ददताम्	d̪ɐd̪ɐt̪ɑːm
पिनष्टि	pin̪ɐʂʈi
जिहीते	d͡ʑiɦiːt̪eː
धन	d̪ʱɐn̪ɐ
पूयति	púːjɐt̪i
दाक्षिण्य	d̪ɑːkʂiɳjɐ
गमिष्यसि	ɡɐmiʂjɐs̪i
फडिङ्गा	pʰɐɖiŋɡɑː
मक्षिका	mɐkʂikɑː
अस्	ɐs̪
इच्छा	itt͡ɕʰɑː
खेट	kʰeːʈɐ
तुर्वणे	t̪uɾʋɐ́ɳɐj
वर्चोदा	ʋɐɾt͡ɕɐwd̪ɑ́ː
काजे	kɑːd͡ʑɐj
अक्षय्य	ɐkʂeːjɐ
पञ्चविंशति	pɐ́ɲt͡ɕɐʋĩɕɐt̪i
मरति	mɐɾɐt̪i
मज्जा	mɐdd͡ʑɑ́ː
अलि	ɐl̪i
ऋणोति	r̩ɳoːt̪i
महाययति	mɐɦɑːjɐjɐt̪i
शिक्य	ɕikjɐ́
ज्ञाति	d͡ʑɲɑːt̪í
हि	ɦi
पथिन्	pɐt̪ʰin̪
स्वधा	s̪ʋɐ́d̪ʱɑː
उपार्जन	upɑːɾd͡ʑɐn̪ɐ
अर्चिस्	ɐɾt͡ɕis̪
मषि	mɐʂi
चिकित्सकात्	t͡ɕikit̪s̪ɐkɑːt̪
नृप	n̪r̩pɐ
तक्षन्	t̪ɐ́kʂɐn̪
सहस्	s̪ɐɦɐs̪
चनस्	t͡ɕɐn̪ɐs̪
तस्मै	t̪ɐs̪mɑj
पृष्टि	pr̩ʂʈi
दर्भ	d̪ɐɾbʱɐ́
धृषु	d̪ʱr̩ʂu
क्रमण	kɾɐ́mɐɳɐ
गात्र	ɡɑːt̪ɾɐ
कच्छप	kɐtt͡ɕʰɐpɐ
रिपुघातिन्	ɾipuɡʱɑːt̪in̪
अदाक्षिण्य	ɐd̪ɑːkʂiɳjɐ
चकार	t͡ɕɐkɑːɾɐ
पाण्डव	pɑːɳɖɐʋɐ
वाच्	ʋɑːt͡ɕ
सत्य	s̪ɐt̪jɐ́
ग्रामचर्या	ɡɾɑːmɐt͡ɕɐɾjɑː
कारक	kɑːɾɐkɐ
लोक्	l̪oːk
खेलन	kʰeːl̪ɐn̪ɐ
लिहति	l̪iɦɐt̪i
कम्पित	kɐmpit̪ɐ
कोलिक	koːl̪ikɐ
राशि	ɾɑːɕi
भर	bʱɐɾɐ
अरमति	ɐɾɐmɐt̪i
क्रतु	kɾɐt̪u
राजन्	ɾɑ́ːd͡ʑɐn̪
परुष	pɐɾuʂɐ
भर्त्सक	bʱɐɾt̪s̪ɐkɐ
बलीवर्द	bɐl̪iːʋɐɾd̪ɐ
कक्ष	kɐkʂɐ
मोग्धि	moːɡd̪ʱi
तुविद्युम्न	t̪uʋíd̪jumn̪ɐ
वीळु	ʋiːɭ̆u
दरीमन्	d̪ɐɾiːmɐn̪
भगवान्	bʱɐɡɐʋɑːn̪
गुलेषु	ɡul̪eːʂu
छद्मन्	t͡ɕʰɐd̪mɐn̪
नारक	n̪ɑːɾɐkɐ
अतुल्य	ɐt̪ul̪jɐ
तात	t̪ɑːt̪ɐ
खा	kʰɑ́ː
व्यायाम	ʋjɑːjɑːmɐ́
बन्ध	bɐn̪d̪ʱɐ́
तम्	t̪ɐm
चन्द्र	t͡ɕɐn̪d̪ɾɐ
मद्य	mɐd̪jɐ
अरित्र	ɐɾít̪ɾɐ
ऋच्	ŕ̩t͡ɕ
वृत्रहन्	ʋr̩t̪ɾɐɦɐn̪
कर्म	kɐɾmɐ
मुद्ग	mud̪ɡɐ́
अष्टादश	ɐʂʈɑːd̪ɐɕɐ
अखिल	ɐkʰil̪ɐ
उदच्यते	ud̪ɐt͡ɕjɐt̪ɐj
चिकित्सकासः	t͡ɕikit̪s̪ɐkɑːs̪ɐh
वस्मन्	ʋɐs̪mɐn̪
वी	ʋiː
पिता	pit̪ɑ́ː
गुद	ɡud̪ɐ
युष्माक	juʂmɑ́ːkɐ
अद्यैव	ɐd̪jɑ́ːjʋɐ
सहवास	s̪ɐɦɐ́ʋɑːs̪ɐ
वेदस्	ʋɐ́jd̪ɐs̪
अंसकूट	ɐ̃́s̪ɐkuːʈɐ
चेतना	t͡ɕeːt̪ɐn̪ɑː
कृत्य	kr̩t̪jɐ
कदेन	kɐd̪ɐjn̪ɐ
साम	s̪ɑːmɐ
अत्ति	ɐt̪t̪i
कोटर	kɐwʈɐɾɐ
तावत्क	t̪ɑ́ːʋɐt̪kɐ
प्रेषित	pɾɐ́jʂit̪ɐ
कथम्	kɐt̪ʰɐm
फलक	pʰɐl̪ɐkɐ
दोग्धि	d̪oːɡd̪ʱi
सर्प	s̪ɐɾpɐ́
धर्त्र	d̪ʱɐɾt̪ɾɐ
सादयोः	s̪ɑːd̪ɐjɐwh
दुर्योण	d̪uɾjɐwɳɐ́
युनक्ति	jun̪ɐ́kt̪i
ऋषि	ŕ̩ʂi
छकार	t͡ɕʰɐkɑːɾɐ
काजस्य	kɑːd͡ʑɐs̪jɐ
उदन्	ud̪ɐn̪
अवरिफ्	ɐʋɐɾipʰ
बुद्ध	bud̪d̪ʱɐ
संचारक	s̪ɐɲt͡ɕɑːɾɐkɐ
सुशेव्य	s̪uɕɐ́jʋjɐ
मह	mɐɦɐ
दूरभाषः	d̪uːɾɐbʱɑːʂɐh
पाषण्ड	pɑ́ːʂɐɳɖɐ
अंशुक	ɐ̃ɕukɐ
महस्	mɐɦɐs̪
षष्टि	ʂɐʂʈi
लोहित	l̪ɐ́wɦit̪ɐ
बर्हिष्ठ	bɐ́ɾɦiʂʈʰɐ
अक्षि	ɐ́kʂi
उत्तराधरविवर	ut̪t̪ɐɾɑːd̪ʱɐɾɐʋiʋɐɾɐ
नारक	n̪ɑ́ːɾɐkɐ
जुहू	d͡ʑuɦúː
गुलैः	ɡul̪ɑjh
विकृत	ʋikr̩t̪ɐ
गुरु	ɡuɾu
रिप्	ɾip
क्रुध्यति	kɾúd̪ʱjɐt̪i
वर्ग	ʋɐ́ɾɡɐ
कुष्माण्ड	kuʂmɑːɳɖɐ
अर्जुन	ɐɾd͡ʑun̪ɐ
कपाल	kɐpɑːl̪ɐ
वाज	ʋɑːd͡ʑɐ
आर्द्रक	ɑːɾd̪ɾɐkɐ
डालेभ्यस्	ɖɑːl̪eːbʱjɐs̪
देवन्	d̪eːʋɐn̪
प्राप्यक	pɾɑːpjɐkɐ
करिमकर	kɐɾimɐkɐɾɐ
कृप्	kŕ̩p
नारि	n̪ɑ́ːɾi
अश्मन्	ɐ́ɕmɐn̪
पिनाक	pin̪ɑːkɐ
नूतन	n̪uːt̪ɐn̪ɐ
मर्य	mɐɾjɐ
हिरण्य	ɦíɾɐɳjɐ
गन्तास्थः	ɡɐn̪t̪ɑːs̪t̪ʰɐh
नावाज	n̪ɑːʋɑːd͡ʑɐ
फेन	pʰeːn̪ɐ
शेव	ɕɐ́jʋɐ
मर्द	mɐɾd̪ɐ
जनस्	d͡ʑɐn̪ɐs̪
दृष्टि	d̪r̩ʂʈi
कृपे	kr̩pɐj
संकल्पेभ्यः	s̪ɐŋkɐl̪pɐjbʱjɐh
क्रोध	kɾoːd̪ʱɐ
कृपाम्	kr̩pɑːm
हल	ɦɐl̪ɐ́
अङ्कस्	ɐŋkɐs̪
भिनत्ति	bʱin̪ɐt̪t̪i
सार्थ	s̪ɑːɾt̪ʰɐ
ऋणोति	r̩ɳɐ́wt̪i
रक्षा	ɾɐkʂɑː
वीरता	ʋiːɾɐt̪ɑː
परि	pɐ́ɾi
धुर्	d̪ʱuɾ
सती	s̪ɐt̪iː
यह्वत्	jɐɦʋɐt̪
वामन	ʋɑːmɐn̪ɐ́
उग्र	uɡɾɐ
प्रतीक	pɾɐt̪iːkɐ
रोगिणी	ɾɐwɡiɳiː
वाहन	ʋɑ́ːɦɐn̪ɐ
पशु	pɐɕú
सामि	s̪ɑːmí
तारण	t̪ɑːɾɐɳɐ
गच्छावः	ɡɐtt͡ɕʰɑːʋɐh
शिरस्	ɕiɾɐs̪
वाणि	ʋɑːɳi
सवितृ	s̪ɐʋit̪r̩
प्रीणीतः	pɾiːɳiːt̪ɐh
अवति	ɐʋɐt̪i
मारुक	mɑ́ːɾukɐ
माधव	mɑːd̪ʱɐʋɐ
स्पर्धताम्	s̪pɐɾd̪ʱɐt̪ɑːm
राज्ञीनाम्	ɾɑːd͡ʑɲiːn̪ɑːm
उरु	uɾu
त्सारिन्	t̪s̪ɑːɾín̪
काश्चन	kɑːɕt͡ɕɐn̪ɐ
वर	ʋɐ́ɾɐ
फलनेभ्यः	pʰɐl̪ɐn̪ɐjbʱjɐh
चत्वारस्	t͡ɕɐt̪ʋɑ́ːɾɐs̪
यावन्	jɑːʋɐn̪
कठिनता	kɐʈʰin̪ɐt̪ɑː
दिशा	d̪íɕɑː
जू	d͡ʑuː
स्वार्थिन्	s̪ʋɑːɾt̪ʰin̪
करिमुक्ता	kɐɾimukt̪ɑː
धीता	d̪ʱiːt̪ɑː
मग्न	mɐɡn̪ɐ
दशा	d̪ɐɕɑː
शं	ɕɐm
खेलति	kʰɐjl̪ɐt̪i
चक्रवात	t͡ɕɐkɾɐʋɑːt̪ɐ
फलनानि	pʰɐl̪ɐn̪ɑːn̪i
स्पष्ट	s̪pɐʂʈɐ
जिहर्ति	d͡ʑiɦɐɾt̪i
तन्तु	t̪ɐ́n̪t̪u
सस	s̪ɐs̪ɐ́
जननी	d͡ʑɐn̪ɐn̪iː
तिग्म	t̪iɡmɐ
यच्छति	jɐ́tt͡ɕʰɐt̪i
बभस्ति	bɐbʱɐs̪t̪i
स्तर्य	s̪t̪ɐɾjɐ
ललाट	l̪ɐl̪ɑ́ːʈɐ
गल	ɡɐl̪ɐ
हिन्दुस्थान	ɦin̪d̪us̪t̪ʰɑːn̪ɐ
रोपयति	ɾɐwpɐjɐt̪i
कवि	kɐʋí
वर्ष	ʋɐɾʂɐ́
स्तरिमन्	s̪t̪ɐɾimɐn̪
मा	mɑː
तनात्	t̪ɐn̪ɑːt̪
जास्पति	d͡ʑɑːs̪pɐt̪i
एकविंशति	ɐ́jkɐʋĩɕɐt̪i
बाल	bɑːl̪ɐ
प्रहेलिका	pɾɐɦɐjl̪ikɑː
यहस्	jɐɦɐs̪
कदेभ्यः	kɐd̪eːbʱjɐh
अञ्जस्	ɐɲd͡ʑɐs̪
शस्त	ɕɐs̪t̪ɐ
छर्दति	t͡ɕʰɐɾd̪ɐt̪i
उपधान	upɐd̪ʱɑːn̪ɐ
शैम्ब्य	ɕɑːjmbjɐ
इष्टि	íʂʈi
नीड	n̪iːɖɐ
रस	ɾɐ́s̪ɐ
यामान्	jɑːmɑːn̪
अघ	ɐɡʱɐ́
मुद्रा	mud̪ɾɑː
मषी	mɐʂiː
धृष्णोति	d̪ʱr̩ʂɳoːt̪i
पूर्ण	puːɾɳɐ́
अधस्	ɐd̪ʱɐ́s̪
तित्तिर	t̪it̪t̪iɾɐ́
जयति	d͡ʑɐ́jɐt̪i
गो	ɡoː
वरस्	ʋɐɾɐs̪
द्राघिमन्	d̪ɾɑːɡʱimɐ́n̪
घास	ɡʱɑːs̪ɐ
गौड	ɡɑːwɖɐ
निद्रा	n̪id̪ɾɑː
श्रेष्ठ	ɕɾɐ́jiʂʈʰɐ
कर्तोस्	kɐɾt̪oːs̪
मयस्	mɐ́jɐs̪
बुक्कयति	bukkɐjɐt̪i
चोरयति	t͡ɕoːɾɐjɐt̪i
युज्	júd͡ʑ
त्वेषद्युम्न	t̪ʋɐjʂɐ́d̪jumn̪ɐ
किम्	kím
वपुष्टर	ʋɐpúʂʈɐɾɐ
खेदेभिः	kʰeːd̪eːbʱih
स्वरतात्	s̪ʋɐɾɐt̪ɑːt̪
इङ्गितुम्	iŋɡit̪um
षोळशन्	ʂɐwɭ̆ɐɕɐn̪
खेदान्	kʰɐjd̪ɑːn̪
तृ	t̪r̩
अंसत्र	ɐ̃́s̪ɐt̪ɾɐ
गोपाल	ɡɐwpɑːl̪ɐ́
शुप्ति	ɕúpt̪i
परिच्छेदासस्	pɐɾitt͡ɕʰeːd̪ɑːs̪ɐs̪
कनीन	kɐn̪íːn̪ɐ
ऋज्र	r̩d͡ʑɾɐ
स्वर्द्	s̪ʋɐɾd̪
यात्रिणी	jɑːt̪ɾiɳiː
अस्मान्	ɐs̪mɑːn̪
रथी	ɾɐt̪ʰiː
लैङ्ग	l̪ɑjŋɡɐ
द्विरेफ	d̪ʋiɾɐjpʰɐ
आञ्छ्	ɑːɲt͡ɕʰ
यजति	jɐ́d͡ʑɐt̪i
विद्या	ʋid̪jɑː
अंसफलक	ɐ̃s̪ɐpʰɐl̪ɐkɐ
भिषक्ति	bʱiʂɐ́kt̪i
पात	pɑːt̪ɐ
द्वेषस्	d̪ʋeːʂɐs̪
मान	mɑːn̪ɐ
सत्यता	s̪ɐt̪jɐt̪ɑː
दुवस्यु	d̪uʋɐs̪ju
आचार	ɑːt͡ɕɑːɾɐ
यूष	juːʂɐ
दुर	d̪uɾɐ
गुले	ɡul̪eː
पुत्रकाम	put̪ɾɐ́kɑːmɐ
पिपासा	pipɑːs̪ɑ́ː
धाना	d̪ʱɑːn̪ɑː
चक्रवर्तिनी	t͡ɕɐkɾɐʋɐɾt̪in̪iː
आशा	ɑːɕɑ́ː
रोगिणी	ɾoːɡiɳiː
आवयोः	ɑːʋɐjɐwh
चिन्तयति	t͡ɕin̪t̪ɐjɐt̪i
युवन्	juʋɐn̪
धनु	d̪ʱɐn̪u
करिज	kɐɾid͡ʑɐ
अन्य	ɐn̪jɐ́
पादांशुक	pɑːd̪ɑ̃ːɕukɐ
असिन्व	ɐs̪in̪ʋɐ
मल	mɐ́l̪ɐ
ऋजु	r̩d͡ʑú
कोशवती	kɐwɕɐʋɐt̪iː
पुष्प	púʂpɐ
दम्	d̪ɐm
सूनु	s̪uːn̪u
शंसति	ɕɐ̃s̪ɐt̪i
मुहुर्	muɦuɾ
शल्यक्रिया	ɕɐl̪jɐkɾijɑː
धयति	d̪ʱɐjɐt̪i
दहति	d̪ɐɦɐt̪i
अशनि	ɐɕɐn̪i
त्रिष्टुभ्	t̪ɾiʂʈubʱ
लैङ्गिक	l̪ɑːjŋɡikɐ
शिक्षिकाभ्यः	ɕikʂikɑːbʱjɐh
कुशल	kuɕɐl̪ɐ
सनुते	s̪ɐn̪ut̪ɐj
स्तर	s̪t̪ɐɾɐ
जग्मतुः	d͡ʑɐɡmɐt̪uh
अश्रीर	ɐɕɾiːɾɐ́
दन्तमूलीय	d̪ɐ́n̪t̪ɐmuːl̪iːjɐ
छात्रा	t͡ɕʰɑːt̪ɾɑː
स्फिगी	s̪pʰiɡiː
भवतु	bʱɐʋɐt̪u
विपरिवर्तन	ʋipɐɾiʋɐɾt̪ɐn̪ɐ
गच्छेयुः	ɡɐtt͡ɕʰeːjuh
अश्रोत्	ɐ́ɕɾɐwt̪
शाम	ɕɑːmɐ́
पुर्	puɾ
पाति	pɑːt̪i
स्तृणोति	s̪t̪r̩ɳɐ́wt̪i
हरेणु	ɦɐɾɐjɳu
गन्तास्मः	ɡɐn̪t̪ɑːs̪mɐh
अलम्	ɐ́l̪ɐm
सत्यते	s̪ɐt̪jɐt̪eː
सुवर्ण	s̪uʋɐ́ɾɳɐ
भरीमन्	bʱɐ́ɾiːmɐn̪
मुञ्चति	muɲt͡ɕɐ́t̪i
मठ	mɐʈʰɐ
सूक्त	s̪uːkt̪ɐ́
तमस्वत्	t̪ɐ́mɐs̪ʋɐt̪
राशि	ɾɑːɕí
तविषी	t̪ɐ́ʋiʂiː
टिण्डिश	ʈiɳɖiɕɐ
शिंषाते	ɕĩʂɑːt̪eː
भोग	bʱoːɡɐ
मध्यम	mɐd̪ʱjɐmɐ
स्नायु	s̪n̪ɑ́ːju
नयति	n̪ɐ́jɐt̪i
रोचस्	ɾoːt͡ɕɐs̪
गन्तोस्	ɡɐ́n̪t̪ɐws̪
नाथ्	n̪ɑːt̪ʰ
लेप	l̪ɐjpɐ
आसन	ɑːs̪ɐn̪ɐ́
चिकित्सकेषु	t͡ɕikit̪s̪ɐkɐjʂu
त्रि	t̪ɾí
रोमन्थ	ɾɐwmɐn̪t̪ʰɐ
तरुस्	t̪ɐ́ɾus̪
परिच्छेदयोस्	pɐɾitt͡ɕʰeːd̪ɐjoːs̪
सुवर्णभूमि	s̪uʋɐ́ɾɳɐbʱuːmi
खेदैः	kʰɐjd̪ɑːjh
उत्तराधिकारिणी	ut̪t̪ɐɾɑːd̪ʱikɑːɾiɳiː
पिष्ट	piʂʈɐ́
पादत्राणेभ्यः	pɑːd̪ɐt̪ɾɑːɳɐjbʱjɐh
शर	ɕɐɾɐ́
ऋघायति	r̩ɡʱɑːjɐt̪i
भूयसे	bʱuːjɐs̪ɐj
सहते	s̪ɐɦɐt̪eː
वर्पस्	ʋɐɾpɐs̪
ज	d͡ʑɐ́
राष्टि	ɾɑ́ːʂʈi
असि	ɐs̪i
श्लक्ष्ण	ɕl̪ɐkʂɳɐ́
सव्य	s̪ɐʋjɐ́
घूर्ण्	ɡʱuːɾɳ
तना	t̪ɐn̪ɑː
सनिता	s̪ɐn̪it̪ɑː
द्युम्निन्	d̪jumn̪in̪
जू	d͡ʑúː
बुध्न	bud̪ʱn̪ɐ
मूक	muːkɐ
डालास्	ɖɑːl̪ɑːs̪
करिमाचल	kɐɾimɑːt͡ɕɐl̪ɐ
वर्तनी	ʋɐɾt̪ɐn̪iː
धन्वन्	d̪ʱɐn̪ʋɐn̪
नारी	n̪ɑːɾiː
क्रतु	kɾɐ́t̪u
मेधिर	mɐ́jd̪ʱiɾɐ
हुत	ɦut̪ɐ́
कषेरुका	kɐʂeːɾukɑː
धरुण	d̪ʱɐɾuɳɐ
गृहपति	ɡr̩ɦɐ́pɐt̪i
गुलम्	ɡul̪ɐm
अष्टाविंशति	ɐʂʈɑːʋĩɕɐt̪i
तुरस्पेय	t̪uɾɐs̪peːjɐ
कदयोः	kɐd̪ɐjoːh
दक्षिण	d̪ɐ́kʂiɳɐ
अषाळ्ह	ɐ́ʂɑːɭ̆ɦɐ
मकर	mɐkɐɾɐ
परिच्छेदास्	pɐɾitt͡ɕʰeːd̪ɑːs̪
सुपर्ण	s̪upɐɾɳɐ
देवृ	d̪ɐjʋŕ̩
गुलः	ɡul̪ɐh
मूर्छन	muːɾt͡ɕʰɐn̪ɐ
सूतिकागार	s̪uːt̪ikɑːɡɑːɾɐ
पार्ष्णि	pɑ́ːɾʂɳi
शुभ्र	ɕubʱɾɐ́
कुशलेन	kúɕɐl̪ɐjn̪ɐ
अहो	ɐɦɐw
भूगोल	bʱuːɡɐwl̪ɐ
छदिस्	t͡ɕʰɐd̪is̪
वल्क	ʋɐl̪kɐ
तर्क	t̪ɐɾkɐ́
शक्ति	ɕɐkt̪i
भी	bʱíː
भवानि	bʱɐʋɑːn̪i
सुरा	s̪úɾɑː
गविष्टि	ɡɐ́ʋiʂʈi
शरभ	ɕɐɾɐbʱɐ́
एति	eːt̪i
खा	kʰɑː
मिश्र	miɕɾɐ
नाक	n̪ɑ́ːkɐ
भूकम्प	bʱúːkɐmpɐ
पाल	pɑːl̪ɐ
उलाहना	ul̪ɑːɦɐn̪ɑː
खनित्रेभ्यः	kʰɐn̪it̪ɾɐjbʱjɐh
लभ्	l̪ɐbʱ
चन्द्रमास्	t͡ɕɐn̪d̪ɾɐmɑːs̪
वकार	ʋɐkɑːɾɐ
यदि	jɐd̪i
तविष्या	t̪ɐʋiʂjɑ́ː
कौशल	kɑːwɕɐl̪ɐ
भृज्जति	bʱr̩dd͡ʑɐ́t̪i
जकार	d͡ʑɐkɑːɾɐ
शब्द	ɕɐ́bd̪ɐ
पलायन	pɐl̪ɑːjɐn̪ɐ
श्रोमत	ɕɾɐ́wmɐt̪ɐ
हृत	ɦr̩t̪ɐ́
सेधति	s̪eːd̪ʱɐt̪i
ऊति	uːt̪i
चिकित्सकैः	t͡ɕikit̪s̪ɐkɑːjh
यादृश्	jɑːd̪ŕ̩ɕ
संन्यासी	s̪ɐ̃n̪jɑːs̪iː
अर्क	ɐɾkɐ́
एवंक्रतु	ɐ́jʋɐŋkɾɐt̪u
खुर	kʰuɾɐ
चन्द्रमः	t͡ɕɐn̪d̪ɾɐmɐh
स्पर्धे	s̪pɐɾd̪ʱeː
शेफस्	ɕɐjpʰɐs̪
गच्छेम	ɡɐtt͡ɕʰɐjmɐ
द्राक्षा	d̪ɾɑːkʂɑː
आस	ɑːs̪ɐ
ताण्डव	t̪ɑːɳɖɐʋɐ
प्रवते	pɾɐ́ʋɐt̪ɐj
मनुष्य	mɐn̪uʂjɐ
तरणक्रीडा	t̪ɐɾɐɳɐkɾiːɖɑː
बुभुक्षा	bubʱukʂɑː
पालयति	pɑːl̪ɐ́jɐt̪i
विचेष्टति	ʋit͡ɕeːʂʈɐt̪i
विधवा	ʋid̪ʱɐʋɑː
सात	s̪ɑːt̪ɐ́
जस्यति	d͡ʑɐ́s̪jɐt̪i
मूर्ख	muːɾkʰɐ
सित	s̪it̪ɐ
अर्थात्	ɐɾt̪ʰɑːt̪
उपवन	upɐʋɐn̪ɐ
वैदर्भ	ʋɑjd̪ɐɾbʱɐ
धनंजय	d̪ʱɐn̪ɐɲd͡ʑɐjɐ
अङ्गिरस्	ɐ́ŋɡiɾɐs̪
नव	n̪ɐ́ʋɐ
सादे	s̪ɑːd̪eː
घन	ɡʱɐn̪ɐ
शिफा	ɕipʰɑː
कालिका	kɑːl̪ikɑː
षष्टि	ʂɐʂʈí
चषक	t͡ɕɐʂɐkɐh
सदस्पति	s̪ɐd̪ɐs̪pɐt̪i
सञ्जय	s̪ɐɲd͡ʑɐjɐ
जग्ध	d͡ʑɐɡd̪ʱɐ́
जक्षत्	d͡ʑɐ́kʂɐt̪
जयति	d͡ʑɐjɐt̪i
अतिथिपति	ɐt̪it̪ʰipɐt̪i
ऋष्व	r̩ʂʋɐ
स्कुन्दताम्	s̪kun̪d̪ɐt̪ɑːm
दा	d̪ɑː
हिङ्गु	ɦiŋɡu
योद्धा	jɐwd̪d̪ʱɑː
जनु	d͡ʑɐn̪u
सुवति	s̪uʋɐt̪i
मल्ह	mɐl̪ɦɐ
लिलेह	l̪il̪eːɦɐ
वात	ʋɑːt̪ɐ
वृत्	ʋr̩t̪
हेमन्	ɦɐ́jmɐn̪
भ्रंशते	bʱɾɐ̃́ɕɐt̪ɐj
हस्तिन्	ɦɐs̪t̪in̪
लेप	l̪eːpɐ
यज्ञ	jɐd͡ʑɲɐ
जिह्रेति	d͡ʑiɦɾɐjt̪i
समि	s̪ɐmi
कषेरुका	kɐʂɐjɾukɑː
देवस्	d̪ɐ́jʋɐs̪
क्लोमन्	kl̪ɐ́wmɐn̪
क्रीळ	kɾiːɭ̆ɐ
शिक्षिकायै	ɕikʂikɑːjɑj
तनु	t̪ɐn̪u
कद	kɐd̪ɐ
विकट	ʋíkɐʈɐ
मौखिक	mɑwkʰikɐ
ईर्ष्यु	iːɾʂjú
राज्ञीभिः	ɾɑːd͡ʑɲiːbʱih
पौत्र	pɑ́ːwt̪ɾɐ
असनिष्यत	ɐs̪ɐn̪iʂjɐt̪ɐ
भविष्यति	bʱɐʋiʂjɐt̪i
मह	mɐɦɐ́
स्वार्थ	s̪ʋɑːɾt̪ʰɐ
सनक	s̪ɐn̪ɐkɐ́
जर्जर	d͡ʑɐɾd͡ʑɐɾɐ
रञ्जित	ɾɐɲd͡ʑit̪ɐ
सर्पिस्	s̪ɐɾpís̪
हु	ɦu
शू	ɕuː
ज्येष्ठ	d͡ʑjɐ́jʂʈʰɐ
स्थापयति	s̪t̪ʰɑːpɐjɐt̪i
भूयते	bʱuːjɐt̪ɐj
तैलस्य	t̪ɑːjl̪ɐs̪jɐ
डालस्	ɖɑːl̪ɐs̪
मूर्खता	muːɾkʰɐt̪ɑː
पत्नी	pɐt̪n̪iː
आयु	ɑ́ːju
पताका	pɐt̪ɑːkɑː
जनयति	d͡ʑɐn̪ɐjɐt̪i
गुरुत्व	ɡuɾut̪ʋɐ
रिरंसा	ɾiɾɐ̃́s̪ɑː
परिच्छेदास्	pɐɾitt͡ɕʰɐjd̪ɑːs̪
ग्रीष्म	ɡɾiːʂmɐ́
ऋकार	r̩kɑːɾɐ
शस्त	ɕɐs̪t̪ɐ́
रश्मि	ɾɐɕmi
स्मर	s̪mɐɾɐ́
डालेभिस्	ɖɑːl̪ɐjbʱis̪
अरण	ɐɾɐɳɐ
ज्योति	d͡ʑjoːt̪i
सूक्ष्म	s̪uːkʂmɐ
पागल	pɑːɡɐl̪ɐ
धुरा	d̪ʱúɾɑː
दर्वी	d̪ɐɾʋiː
नियम	n̪ijɐmɐ
पिनद्ध	pin̪ɐ́d̪d̪ʱɐ
सोम	s̪ɐ́wmɐ
यव	jɐ́ʋɐ
कञ्चन	kɐɲt͡ɕɐn̪ɐ
तरण	t̪ɐɾɐɳɐ
आम्	ɑːm
दाना	d̪ɑːn̪ɑː
प्रीयते	pɾiːjɐt̪eː
क्षमते	kʂɐ́mɐt̪ɐj
सभाजयति	s̪ɐbʱɑːd͡ʑɐjɐt̪i
मोक्तुम्	mɐwkt̪um
म्रियते	mɾijɐ́t̪ɐj
दिन	d̪in̪ɐ́
क्षप्	kʂɐ́p
क्षुधा	kʂud̪ʱɑː
नरक	n̪ɐ́ɾɐkɐ
गर्दभ	ɡɐɾd̪ɐbʱɐ́
काफी	kɑːpʰiː
पाय्य	pɑjjɐ
नश्यति	n̪ɐ́ɕjɐt̪i
भस्त्री	bʱɐs̪t̪ɾiː
मूर्खते	muːɾkʰɐt̪eː
अल	ɐl̪ɐ
असार	ɐs̪ɑːɾɐ
दत्	d̪ɐ́t̪
संकल्पेषु	s̪ɐŋkɐl̪pɐjʂu
एध	eːd̪ʱɐ
सचते	s̪ɐt͡ɕɐt̪eː
महिष	mɐɦiʂɐ́
बुद्ध	bud̪d̪ʱɐ́
करिपथ	kɐɾipɐt̪ʰɐ
गिरति	ɡiɾɐt̪i
घर्षति	ɡʱɐɾʂɐt̪i
दर्त्नु	d̪ɐɾt̪n̪ú
यातु	jɑːt̪u
भूमिपुत्र	bʱuːmiput̪ɾɐ
करोति	kɐɾoːt̪i
श्येन	ɕjɐjn̪ɐ́
स्निह्यति	s̪n̪iɦjɐt̪i
आलुक	ɑːl̪ukɐ
यूष	juːʂɐ́
रक्षस्	ɾɐ́kʂɐs̪
गच्छताम्	ɡɐtt͡ɕʰɐt̪ɑːm
तुरीय	t̪uɾíːjɐ
कदासः	kɐd̪ɑːs̪ɐh
प्रचेतस्	pɾɐt͡ɕɐjt̪ɐs̪
पाषण्ड	pɑːʂɐɳɖɐ
तितउ	t̪it̪ɐu
शिक्षिकायै	ɕikʂikɑːjɑːj
ग्रावन्	ɡɾɑːʋɐn̪
चिकित्सिका	t͡ɕikit̪s̪ikɑː
वेद	ʋɐjd̪ɐ
भर्मन्	bʱɐɾmɐn̪
पादत्राणैः	pɑːd̪ɐt̪ɾɑːɳɑjh
दश	d̪ɐ́ɕɐ
भवति	bʱɐ́ʋɐt̪i
नी	n̪iː
चन्द्रमस्	t͡ɕɐn̪d̪ɾɐmɐs̪
दुर्	d̪uɾ
चिकित्सकाः	t͡ɕikit̪s̪ɐkɑːh
पोस्फोर्ति	pɐws̪pʰɐwɾt̪i
निन्दति	n̪ín̪d̪ɐt̪i
अष्ठीवत्	ɐʂʈʰiːʋɐ́t̪
नहि	n̪ɐɦí
पर्वत	pɐɾʋɐt̪ɐ
दूरभाषेभिः	d̪uːɾɐbʱɑːʂeːbʱih
भार्मन्	bʱɑ́ːɾmɐn̪
ऊर्णा	uːɾɳɑː
लघु	l̪ɐɡʱú
संकल्पाः	s̪ɐŋkɐl̪pɑːh
पादत्राणेभ्यः	pɑːd̪ɐt̪ɾɑːɳeːbʱjɐh
विद्	ʋid̪
उपकार	upɐkɑːɾɐ
गर्हति	ɡɐɾɦɐt̪i
हठयोग	ɦɐʈʰɐjɐwɡɐ
सौचिक	s̪ɑːwt͡ɕikɐ
शिफ	ɕipʰɐ
स्तृणोति	s̪t̪r̩ɳoːt̪i
लोल	l̪oːl̪ɐ
स्थित	s̪t̪ʰit̪ɐ́
आम्र	ɑːmɾɐ́
परिच्छेदात्	pɐɾitt͡ɕʰeːd̪ɑːt̪
अस्मि	ɐs̪mi
अभितस्	ɐbʱít̪ɐs̪
रंसु	ɾɐ̃s̪u
गभस्ति	ɡɐ́bʱɐs̪t̪i
भर्तृ	bʱɐɾt̪ŕ̩
नमति	n̪ɐ́mɐt̪i
सरस्वती	s̪ɐɾɐs̪ʋɐt̪iː
छत्रक	t͡ɕʰɐt̪ɾɐkɐ
प्लवते	pl̪ɐʋɐt̪eː
अजति	ɐd͡ʑɐt̪i
ब्रध्न	bɾɐd̪ʱn̪ɐ́
भनक्ति	bʱɐn̪ɐ́kt̪i
शास्ति	ɕɑ́ːs̪t̪i
बालिश	bɑːl̪iɕɐ
बिल	bil̪ɐ
रभसा	ɾɐ́bʱɐs̪ɑː
आम	ɑːmɐ́
चण्डिमन्	t͡ɕɐɳɖimɐn̪
देवेन	d̪eːʋeːn̪ɐ
ज्या	d͡ʑjɑː
हर्म्य	ɦɐɾmjɐ
भृ	bʱr̩
उत्तान	ut̪t̪ɑːn̪ɐ́
तृष्णा	t̪ŕ̩ʂɳɑː
उत्पल	ut̪pɐl̪ɐ
भस्त्रा	bʱɐs̪t̪ɾɑː
पूजयति	puːd͡ʑɐjɐt̪i
सस	s̪ɐs̪ɐ
तीक्ष्ण	t̪iːkʂɳɐ́
चेतिष्यति	t͡ɕɐjt̪iʂjɐt̪i
हंस	ɦɐ̃s̪ɐ
रहस्	ɾɐ́ɦɐs̪
दह्	d̪ɐɦ
त्वेषनृम्ण	t̪ʋɐjʂɐ́n̪r̩mɳɐ
अनङ्ग	ɐn̪ɐŋɡɐ́
स्तृ	s̪t̪r̩
सचा	s̪ɐt͡ɕɑː
अभवत्	ɐ́bʱɐʋɐt̪
भवतः	bʱɐʋɐt̪ɐh
वृक	ʋŕ̩kɐ
तलित	t̪ɐl̪it̪ɐ
आसक्त	ɑːs̪ɐkt̪ɐ
परिच्छेद	pɐɾitt͡ɕʰeːd̪ɐ
स्वस्तिक	s̪ʋɐs̪t̪ikɐ
छाया	t͡ɕʰɑːjɑ́ː
दुःखिन्	d̪uhkʰin̪
वृक्ते	ʋr̩kt̪eː
षोडशन्	ʂɐ́wɖɐɕɐn̪
कम्प्	kɐmp
प्रतिमन्	pɾɐt̪imɐn̪
उल्लिखति	ul̪l̪ikʰɐt̪i
श्रुत	ɕɾut̪ɐ́
हरति	ɦɐɾɐt̪i
यज्	jɐ́d͡ʑ
लुण्ट्	l̪uɳʈ
अमृता	ɐmr̩t̪ɑː
द्वार	d̪ʋɑːɾɐ
संकल्पेभिः	s̪ɐŋkɐl̪pɐjbʱih
ज्ञात	d͡ʑɲɑːt̪ɐ́
पूर्त्वा	puːɾt̪ʋɑː
करिष्यति	kɐɾiʂjɐt̪i
कदात्	kɐd̪ɑːt̪
उदगद्रि	ud̪ɐɡɐd̪ɾi
द्यति	d̪jɐ́t̪i
कदैः	kɐd̪ɑːjh
साक्षिन्	s̪ɑːkʂin̪
आसन	ɑ́ːs̪ɐn̪ɐ
ज्युत्	d͡ʑjut̪
भ्रू	bʱɾuː
भवितव्य	bʱɐʋit̪ɐʋjɐ
गन्धर्व	ɡɐn̪d̪ʱɐɾʋɐ
वक्तवे	ʋɐkt̪ɐʋeː
अलाबुका	ɐl̪ɑːbukɑː
दायिनी	d̪ɑːjin̪iː
अन्यथा	ɐn̪jɐ́t̪ʰɑː
कौशल	kɑwɕɐl̪ɐ
शल्यकार	ɕɐl̪jɐkɑːɾɐ
कृपा	kr̩pɑː
मेथी	meːt̪ʰiː
विभूति	ʋibʱuːt̪i
गच्छेयुः	ɡɐtt͡ɕʰɐjjuh
खेदैः	kʰeːd̪ɑjh
दूरता	d̪uːɾɐt̪ɑː
तनैः	t̪ɐn̪ɑːjh
कण्टक	kɐ́ɳʈɐkɐ
काजानि	kɑːd͡ʑɑːn̪i
सौर्य	s̪ɑwɾjɐ
हृत	ɦr̩t̪ɐ
मासिक	mɑːs̪ikɐ
धरेरन्	d̪ʱɐɾɐjɾɐn̪
सुश्रप	s̪uɕɾɐpɐ
दुवस्	d̪úʋɐs̪
चिकित्सकम्	t͡ɕikit̪s̪ɐkɐm
पिच्छोरा	pitt͡ɕʰoːɾɑː
अन्य	ɐn̪jɐ
जीत	d͡ʑiːt̪ɐ
द्वादश	d̪ʋɑːd̪ɐɕɐ
मषीपात्र	mɐʂiːpɑːt̪ɾɐ
रक्तफल	ɾɐkt̪ɐpʰɐl̪ɐ
उब्जति	ubd͡ʑɐt̪i
तुदति	t̪ud̪ɐt̪i
धेनु	d̪ʱeːn̪u
विषकन्या	ʋiʂɐkɐn̪jɑː
नेत्री	n̪ɐjt̪ɾíː
अस्थात्	ɐs̪t̪ʰɑːt̪
द्रापि	d̪ɾɑ́ːpi
मृ	mr̩
मीढुष्टम	miːɖʱúʂʈɐmɐ
तिरस्	t̪iɾɐs̪
अन्धस्	ɐn̪d̪ʱɐs̪
मशक	mɐɕɐkɐ
प्रतिगच्छति	pɾɐt̪iɡɐtt͡ɕʰɐt̪i
शुङ्ग	ɕuŋɡɐ́
पुरुष	púɾuʂɐ
दातृ	d̪ɑ́ːt̪r̩
विन्ते	ʋin̪t̪eː
रुक्म	ɾukmɐ́
प्साति	ps̪ɑːt̪i
धृत	d̪ʱr̩t̪ɐ́
आर्द्र	ɑːɾd̪ɾɐ
अघ्न्या	ɐɡʱn̪jɑ́ː
ईशान	iːɕɑ́ːn̪ɐ
शीघ्र	ɕiːɡʱɾɐ
इरस्यति	iɾɐs̪jɐt̪i
पाताल	pɑːt̪ɑːl̪ɐ
परिच्छेदस्	pɐɾitt͡ɕʰeːd̪ɐs̪
छन्दस्	t͡ɕʰɐ́n̪d̪ɐs̪
प्रज्ञा	pɾɐd͡ʑɲɑː
गिरति	ɡiɾɐ́t̪i
दृणाति	d̪r̩ɳɑːt̪i
मदिर	mɐd̪iɾɐ́
कुञ्जर	kuɲd͡ʑɐɾɐ
गाथा	ɡɑːt̪ʰɑ́ː
किंनर	kĩn̪ɐɾɐ
अभिवृष्ट	ɐbʱiʋr̩ʂʈɐ
आवयोः	ɑːʋɐjoːh
वितस्ति	ʋit̪ɐs̪t̪i
संकल्पः	s̪ɐŋkɐl̪pɐh
तैलम्	t̪ɑjl̪ɐm
ऋभु	r̩bʱu
अमनस्	ɐmɐn̪ɐs̪
प्रैतोस्	pɾɑːjt̪ɐws̪
शत	ɕɐt̪ɐ́
सृष्टि	s̪r̩ʂʈí
रहस्य	ɾɐɦɐs̪jɐ
उत्कटदुःख	ut̪kɐʈɐd̪uhkʰɐ
रिहति	ɾiɦɐt̪i
रमते	ɾɐmɐt̪eː
उष्णकाल	uʂɳɐkɑːl̪ɐ
जान	d͡ʑɑ́ːn̪ɐ
संकल्पस्य	s̪ɐŋkɐl̪pɐs̪jɐ
उशिज्	uɕid͡ʑ
पुष्कलावती	puʂkɐl̪ɑːʋɐt̪iː
धातु	d̪ʱɑːt̪u
संयोग	s̪ɐ̃joːɡɐ
शिक्षिकाभिः	ɕikʂikɑːbʱih
मदिर	mɐd̪iɾɐ
वलते	ʋɐl̪ɐt̪eː
शर्ध	ɕɐɾd̪ʱɐ
भृज्जति	bʱr̩dd͡ʑɐt̪i
भूयावहे	bʱuːjɑːʋɐɦeː
मह्यम्	mɐɦjɐm
जन	d͡ʑɐ́n̪ɐ
उदच्यते	ud̪ɐt͡ɕjɐt̪eː
ष्ठीवति	ʂʈʰíːʋɐt̪i
भुज	bʱúd͡ʑɐ
उष्णता	uʂɳɐt̪ɑː
उपरि	upɐ́ɾi
पार्थिव	pɑːɾt̪ʰiʋɐ
उदन्	ud̪ɐ́n̪
त्रपते	t̪ɾɐpɐt̪eː
श्लोक	ɕl̪oːkɐ
वर्ण	ʋɐ́ɾɳɐ
अङ्कनी	ɐŋkɐn̪iː
वक्त्र	ʋɐkt̪ɾɐ
पाणिनि	pɑːɳin̪i
जन्मन्	d͡ʑɐ́n̪mɐn̪
आम	ɑːmɐ
नाथामि	n̪ɑːt̪ʰɑːmi
स्वेद	s̪ʋɐ́jd̪ɐ
सना	s̪ɐ́n̪ɑː
सुऊति	s̪uuːt̪i
स्वदताम्	s̪ʋɐd̪ɐt̪ɑːm
रुग्ण	ɾuɡɳɐ
चिकित्सकैः	t͡ɕikit̪s̪ɐkɑjh
रजस्वला	ɾɐd͡ʑɐs̪ʋɐl̪ɑː
शिरोपधान	ɕiɾoːpɐd̪ʱɑːn̪ɐ
पूय	púːjɐ
आर्थिक	ɑːɾt̪ʰikɐ
जानीते	d͡ʑɑːn̪iːt̪ɐj
क्रेता	kɾeːt̪ɑː
उदाहरण	ud̪ɑːɦɐɾɐɳɐ
अङ्गसङ्ग	ɐ́ŋɡɐs̪ɐŋɡɐ
वृश्चिक	ʋr̩ɕt͡ɕikɐ
उपार्ज्	upɑːɾd͡ʑ
त्राण	t̪ɾɑːɳɐ
प्रचलित	pɾɐt͡ɕɐl̪it̪ɐ
सुवति	s̪uʋɐ́t̪i
स्तृति	s̪t̪r̩t̪i
दृढबीज	d̪r̩ɖʱɐbiːd͡ʑɐ
जम्भ	d͡ʑɐmbʱɐ
वसु	ʋɐs̪u
मूर्च्छ्	muːɾtt͡ɕʰ
ह्रस्व	ɦɾɐs̪ʋɐ́
ऋतावन्	r̩t̪ɑ́ːʋɐn̪
प्लीहन्	pl̪iːɦɐ́n̪
भर्त्सना	bʱɐɾt̪s̪ɐn̪ɑː
सामन्	s̪ɑːmɐn̪
छद्मन्	t͡ɕʰɐ́d̪mɐn̪
सत्यतायै	s̪ɐt̪jɐt̪ɑːjɑj
त्सरु	t̪s̪ɐɾu
ऐतिहासिक	ɑjt̪iɦɑːs̪ikɐ
शिक्षिके	ɕikʂikeː
जीव	d͡ʑiːʋɐ́
मुष्टि	muʂʈí
काज	kɑːd͡ʑɐ
तडित्	t̪ɐɖít̪
कदेषु	kɐd̪eːʂu
द्वितीय	d̪ʋit̪iːjɐ
करिकृष्णा	kɐɾikr̩ʂɳɑː
एध्	eːd̪ʱ
परिविष्ट	pɐ́ɾiʋiʂʈɐ
काशते	kɑ́ːɕɐt̪ɐj
मेरुदण्ड	meːɾud̪ɐɳɖɐ
च्यवते	t͡ɕjɐʋɐt̪ɐj
वारि	ʋɑ́ːɾi
सत्त्व	s̪ɐt̪t̪ʋɐ
नर्य	n̪ɐɾjɐ
परिच्छेदाय	pɐɾitt͡ɕʰɐjd̪ɑːjɐ
बन्धन	bɐ́n̪d̪ʱɐn̪ɐ
कलश	kɐl̪ɐɕɐ
चिकित्सकेभिः	t͡ɕikit̪s̪ɐkeːbʱih
पीडयति	piːɖɐjɐt̪i
गम्येते	ɡɐmjeːt̪eː
काजे	kɑːd͡ʑeː
जगमिथ	d͡ʑɐɡɐmit̪ʰɐ
जिगांसते	d͡ʑiɡɑ̃ːs̪ɐt̪eː
आमन्त्रयते	ɑːmɐn̪t̪ɾɐjɐt̪ɐj
दूरभाषाणाम्	d̪uːɾɐbʱɑːʂɑːɳɑːm
ऊर्मि	uːɾmi
वैकुण्ठ	ʋɑjkuɳʈʰɐ
आगस्	ɑːɡɐs̪
हिक्कित	ɦikkit̪ɐ
अनु	ɐ́n̪u
शांतनु	ɕɑːn̪t̪ɐn̪u
गुप्त	ɡupt̪ɐ
वदति	ʋɐ́d̪ɐt̪i
आसीत्	ɑ́ːs̪iːt̪
यादृश	jɑːd̪r̩ɕɐ
अङ्गसङ्ग	ɐŋɡɐs̪ɐŋɡɐ
स्वादिष्ठ	s̪ʋɑ́ːd̪iʂʈʰɐ
मेघ	meːɡʱɐ
शोचयति	ɕɐwt͡ɕɐjɐt̪i
अयनान्त	ɐjɐn̪ɑːn̪t̪ɐ
एवंगत	ɐ́jʋɐŋɡɐt̪ɐ
भैषज्य	bʱɑ́ːjʂɐd͡ʑjɐ
मर्त	mɐ́ɾt̪ɐ
दूरभाषे	d̪uːɾɐbʱɑːʂeː
जगाम	d͡ʑɐɡɑːmɐ
स्वेदते	s̪ʋɐ́jd̪ɐt̪ɐj
भूयावहे	bʱuːjɑːʋɐɦɐj
भोस्	bʱɐws̪
हिन्द्या	ɦin̪d̪jɑː
ददर्श	d̪ɐd̪ɐɾɕɐ
अननुमेय	ɐn̪ɐn̪umeːjɐ
चरित्र	t͡ɕɐɾit̪ɾɐ
ऋष्व	r̩ʂʋɐ́
अभि	ɐbʱí
अद्यापि	ɐd̪jɑːpi
दामन्	d̪ɑːmɐ́n̪
सीक्षते	s̪íːkʂɐt̪ɐj
अथर्वन्	ɐ́t̪ʰɐɾʋɐn̪
पूर्	púːɾ
अर्जित	ɐɾd͡ʑit̪ɐ
दर्शन	d̪ɐ́ɾɕɐn̪ɐ
भास्	bʱɑ́ːs̪
कदौ	kɐd̪ɑw
मोह	mɐ́wɦɐ
गृञ्जन	ɡr̩ɲd͡ʑɐn̪ɐ
मुख	múkʰɐ
जिह्वा	d͡ʑiɦʋɑː
गदति	ɡɐ́d̪ɐt̪i
पौत्र	pɑwt̪ɾɐ
मण्डलिका	mɐɳɖɐl̪ikɑː
बजे	bɐd͡ʑeː
ईषत्	iːʂɐ́t̪
गृध्यति	ɡŕ̩d̪ʱjɐt̪i
शालिवाहन	ɕɑːl̪iʋɑːɦɐn̪ɐ
ज्योत्स्ना	d͡ʑjoːt̪s̪n̪ɑː
च	t͡ɕɐ
ग्रन्थ	ɡɾɐn̪t̪ʰɐ
वृत्रघ्ने	ʋr̩t̪ɾɐɡʱn̪ɐ́j
स्थिति	s̪t̪ʰit̪i
पिष्ट	piʂʈɐ
उक्ति	ukt̪i
स्व	s̪ʋɐ
सम्भोग	s̪ɐmbʱɐwɡɐ
शाक्त	ɕɑːkt̪ɐ
गच्छेयम्	ɡɐtt͡ɕʰɐjjɐm
आशय	ɑːɕɐ́jɐ
मन्त्रालय	mɐn̪t̪ɾɑːl̪ɐjɐ
तन्त्रयति	t̪ɐn̪t̪ɾɐjɐt̪i
कूप	kúːpɐ
डिण्डिश	ɖiɳɖiɕɐ
ऋक्ष	r̩kʂɐ́
संजय	s̪ɐɲd͡ʑɐjɐ
वार	ʋɑ́ːɾɐ
क्रन्दस्	kɾɐn̪d̪ɐs̪
ऋष्टि	r̩ʂʈí
काला	kɑːl̪ɑː
आविस्	ɑːʋis̪
सूक्ष्म	s̪uːkʂmɐ́
नृ	n̪r̩
हर्षति	ɦɐ́ɾʂɐt̪i
उपधान	upɐd̪ʱɑ́ːn̪ɐ
त्रसति	t̪ɾɐs̪ɐt̪i
बाधे	bɑːd̪ʱɐj
पितृव्य	pit̪r̩ʋjɐ
सनुतर्	s̪ɐn̪ut̪ɐɾ
गुहा	ɡuɦɑː
संतापयति	s̪ɐn̪t̪ɑːpɐjɐt̪i
महागज	mɐɦɑːɡɐd͡ʑɐ
बाळ्ह	bɑːɭ̆ɦɐ́
चुद्	t͡ɕud̪
ऋतवः	r̩t̪ɐ́ʋɐh
दविष्ठम्	d̪ɐʋiʂʈʰɐm
स्नान	s̪n̪ɑːn̪ɐ
जित	d͡ʑit̪ɐ́
नवन्	n̪ɐ́ʋɐn̪
दातृ	d̪ɑːt̪r̩
यत्रा	jɐt̪ɾɑː
मीळ्ह	miːɭ̆ɦɐ́
जन	d͡ʑɐn̪ɐ
क्षेत्रनाम	kʂeːt̪ɾɐn̪ɑːmɐ
उद्र	ud̪ɾɐ́
दुःख	d̪uhkʰɐ
छ्यवते	t͡ɕʰjɐʋɐt̪eː
अलंकृ	ɐl̪ɐŋkr̩
अवसर्पिणी	ɐʋɐs̪ɐɾpiɳiː
इक्षु	ikʂú
अग्नि	ɐɡn̪i
प्रावृष्	pɾɑːʋŕ̩ʂ
मनेत्	mɐn̪eːt̪
हर्षण	ɦɐɾʂɐɳɐ
मघ	mɐɡʱɐ́
वर्षा	ʋɐɾʂɑː
राध्	ɾɑːd̪ʱ
शिफः	ɕipʰɐh
सू	s̪úː
ब्रह्मन्	bɾɐɦmɐn̪
परिच्छेदान्	pɐɾitt͡ɕʰeːd̪ɑːn̪
फलने	pʰɐl̪ɐn̪eː
रोच	ɾoːt͡ɕɐ
दधताम्	d̪ɐd̪ʱɐt̪ɑːm
सामि	s̪ɑːmi
क्रेतृ	kɾeːt̪r̩
हलदीका	ɦɐl̪ɐd̪iːkɑː
कण्ठेन	kɐɳʈʰeːn̪ɐ
अभि	ɐbʱi
सदस्य	s̪ɐd̪ɐs̪jɐ
तुञ्ज	t̪uɲd͡ʑɐ́
अश्व	ɐɕʋɐ
कलिङ्ग	kɐl̪iŋɡɐ
अर्भ	ɐ́ɾbʱɐ
शिंष्ठ	ɕĩʂʈʰɐ
जात	d͡ʑɑːt̪ɐ
धानेयक	d̪ʱɑːn̪ɐjjɐkɐ
एति	ɐ́jt̪i
यजुस्	jɐ́d͡ʑus̪
वृकी	ʋr̩kíː
गन्तृ	ɡɐn̪t̪r̩
सकृत्	s̪ɐkr̩t̪
समासेन	s̪ɐmɑːs̪eːn̪ɐ
रसा	ɾɐs̪ɑː
करि	kɐɾi
चतुर्विंशति	t͡ɕɐt̪uɾʋĩɕɐt̪i
शर	ɕɐɾɐ
वात	ʋɑ́ːt̪ɐ
गूढ	ɡuːɖʱɐ
भाम	bʱɑ́ːmɐ
त्वेषरथ	t̪ʋeːʂɐɾɐt̪ʰɐ
तविषीयु	t̪ɐʋiʂiːju
युग्म	juɡmɐ
नमस्	n̪ɐ́mɐs̪
कनिष्ठ	kɐ́n̪iʂʈʰɐ
गुण	ɡuɳɐ́
अरण्य	ɐ́ɾɐɳjɐ
जम्भ	d͡ʑɐ́mbʱɐ
इयर्ति	íjɐɾt̪i
आनयति	ɑːn̪ɐjɐt̪i
वयम्	ʋɐjɐm
अनिन्द्रिय	ɐn̪in̪d̪ɾijɐ́
स्फलति	s̪pʰɐl̪ɐt̪i
दहति	d̪ɐ́ɦɐt̪i
वित्त	ʋit̪t̪ɐ
देवी	d̪eːʋiː
तदुपरान्त	t̪ɐd̪upɐɾɑːn̪t̪ɐ
वाच्	ʋɑ́ːt͡ɕ
सप्तविंशति	s̪ɐpt̪ɐ́ʋĩɕɐt̪i
तुष्यति	t̪úʂjɐt̪i
कदः	kɐd̪ɐh
अर्चिस्	ɐɾt͡ɕís̪
परिच्छेदासस्	pɐɾitt͡ɕʰɐjd̪ɑːs̪ɐs̪
नो	n̪ɐ́w
छात्र	t͡ɕʰɑːt̪ɾɐ
कोङ्कण	kɐwŋkɐɳɐ
भुवन	bʱuʋɐn̪ɐ
गम्यन्ते	ɡɐmjɐn̪t̪eː
अभ्र	ɐbʱɾɐ
छदिस्	t͡ɕʰɐd̪ís̪
मारण	mɑːɾɐɳɐ
धारा	d̪ʱɑ́ːɾɑː
रामायण	ɾɑːmɑːjɐɳɐ
उग्र	uɡɾɐ́
क्लोमन्	kl̪oːmɐn̪
केम्बुक	keːmbukɐ
सत्यते	s̪ɐt̪jɐt̪ɐj
वानर	ʋɑːn̪ɐɾɐ
गच्छसि	ɡɐtt͡ɕʰɐs̪i
प्रिय	pɾijɐ
द्यूत	d̪juːt̪ɐ
तैल	t̪ɑjl̪ɐ
गु	ɡu
गर्भ	ɡɐɾbʱɐ
दृष्ट	d̪r̩ʂʈɐ́
वर्पस्	ʋɐ́ɾpɐs̪
सप्त	s̪ɐpt̪ɐ
ओतु	ɐ́wt̪u
चकृतिम	t͡ɕɐkr̩t̪imɐ
वीतमन्यु	ʋiːt̪ɐmɐn̪ju
रीळ्ह	ɾiːɭ̆ɦɐ́
भाति	bʱɑːt̪i
अजिरायति	ɐd͡ʑiɾɑːjɐt̪i
सर्म	s̪ɐɾmɐ
डालौ	ɖɑːl̪ɑːw
किल	kil̪ɐ
भिन्न	bʱin̪n̪ɐ́
सादेभिः	s̪ɑːd̪eːbʱih
नरक	n̪ɐɾɐkɐ
अंस	ɐ̃́s̪ɐ
बाण	bɑːɳɐ
हठेन	ɦɐʈʰɐjn̪ɐ
ऋक्ष	ŕ̩kʂɐ
प्यान	pjɑːn̪ɐ
स्निह्यति	s̪n̪íɦjɐt̪i
षण्णवति	ʂɐ́ɳɳɐʋɐt̪i
क्रविस्	kɾɐʋís̪
अत्ति	ɐ́t̪t̪i
वक्ति	ʋɐkt̪i
कृपाभ्यः	kr̩pɑːbʱjɐh
राष्ट्रीय	ɾɑːʂʈɾiːjɐ
अविद्या	ɐ́ʋid̪jɑː
गम्यताम्	ɡɐmjɐt̪ɑːm
मूर्छा	muːɾt͡ɕʰɑː
वाद्य	ʋɑːd̪jɐ
दन्त	d̪ɐ́n̪t̪ɐ
मन्त्री	mɐn̪t̪ɾiː
युग्म	juɡmɐ́
वृक्ष	ʋr̩kʂɐ́
त्रयोविंशति	t̪ɾɐjoːʋĩɕɐt̪i
मनसा	mɐn̪ɐs̪ɑː
भ्रूण	bʱɾuːɳɐ
दैनिक	d̪ɑjn̪ikɐ
दारु	d̪ɑ́ːɾu
एक	eːkɐ
साढ	s̪ɑːɖʱɐ
होम	ɦɐ́wmɐ
विना	ʋin̪ɑː
शरारु	ɕɐɾɑ́ːɾu
मना	mɐn̪ɑ́ː
विमान	ʋímɑːn̪ɐ
कश्मीर	kɐɕmiːɾɐ
खेदान्	kʰeːd̪ɑːn̪
रेपस्	ɾɐ́jpɐs̪
राज्ञी	ɾɑ́ːd͡ʑɲiː
तोक	t̪ɐwkɐ́
निचय	n̪it͡ɕɐjɐ
संयमी	s̪ɐ̃jɐmiː
स्वरु	s̪ʋɐ́ɾu
शैम्ब्य	ɕɑjmbjɐ
स्वरेत्	s̪ʋɐɾɐjt̪
प्सुरस्	ps̪úɾɐs̪
मेरु	meːɾu
ताल	t̪ɑːl̪ɐ
अस्वारीत्	ɐs̪ʋɑːɾiːt̪
अश्रु	ɐ́ɕɾu
मनन	mɐn̪ɐ́n̪ɐ
द्वेषस्	d̪ʋɐ́jʂɐs̪
सत्	s̪ɐt̪
खकार	kʰɐkɑːɾɐ
नवविंशति	n̪ɐ́ʋɐʋĩɕɐt̪i
कृति	kr̩t̪i
वास्तु	ʋɑːs̪t̪u
साध्य	s̪ɑːd̪ʱjɐ́
एधे	eːd̪ʱeː
प्साति	ps̪ɑ́ːt̪i
गन्ध	ɡɐn̪d̪ʱɐ́
व्यायम्	ʋjɑːjɐm
गोलदीप	ɡɐwl̪ɐd̪iːpɐ
कृष्णव्याल	kr̩ʂɳɐʋjɑːl̪ɐ
शत्रुभिः	ɕɐt̪ɾubʱih
भान	bʱɑːn̪ɐ
रोदिति	ɾɐ́wd̪it̪i
राज्ञ्यौ	ɾɑːd͡ʑɲjɑw
रोमन्थ	ɾoːmɐn̪t̪ʰɐ
छ्यवते	t͡ɕʰjɐʋɐt̪ɐj
वपा	ʋɐpɑː
धूम	d̪ʱuːmɐ
असङ्ख्येय	ɐs̪ɐŋkʰjɐjjɐ
दविष्ठम्	d̪ɐʋiʂʈʰɐ́m
शाक्यमुनि	ɕɑːkjɐmun̪i
अनुमेय	ɐn̪umɐ́jjɐ
टहति	ʈɐ́ɦɐt̪i
ऋषि	r̩ʂi
अनस्	ɐ́n̪ɐs̪
पतति	pɐt̪ɐt̪i
रश्मन्	ɾɐɕmɐn̪
भस्	bʱɐs̪
कपिलायाः	kɐpil̪ɑːjɑːh
वचस्	ʋɐ́t͡ɕɐs̪
अर्शस्	ɐɾɕɐs̪
अपि	ɐ́pi
बप्सति	bɐ́ps̪ɐt̪i
क्षत्रिय	kʂɐt̪ɾíjɐ
ह्वयति	ɦʋɐ́jɐt̪i
वाला	ʋɑːl̪ɑː
जिघ्रति	d͡ʑíɡʱɾɐt̪i
सार	s̪ɑːɾɐ
वक्षस्	ʋɐkʂɐs̪
क्रन्दस्	kɾɐ́n̪d̪ɐs̪
महाभारत	mɐɦɑ́ːbʱɑːɾɐt̪ɐm
करम्भ	kɐɾɐmbʱɐ́
वधू	ʋɐd̪ʱúː
छला	t͡ɕʰɐl̪ɑː
वदन	ʋɐ́d̪ɐn̪ɐ
वृद्ध	ʋr̩d̪d̪ʱɐ́
आतिथ्य	ɑːt̪it̪ʰjɐ́
नादेय	n̪ɑːd̪ɐjjɐ́
ईडयति	iːɖɐjɐt̪i
यादृश्	jɑːd̪r̩ɕ
जुष्ट	d͡ʑuʂʈɐ
संयमिनी	s̪ɐ̃jɐmin̪iː
चक्षु	t͡ɕɐkʂu
नदी	n̪ɐd̪iː
वहति	ʋɐɦɐt̪i
ऋषभ	r̩ʂɐbʱɐ
मृदु	mr̩d̪u
वर्धति	ʋɐɾd̪ʱɐt̪i
पादत्राणेभिः	pɑːd̪ɐt̪ɾɑːɳeːbʱih
मन्त्रिन्	mɐn̪t̪ɾín̪
रेभ	ɾɐjbʱɐ́
वपुस्	ʋɐpus̪
तनक्ति	t̪ɐn̪ɐkt̪i
विनक्ति	ʋin̪ɐkt̪i
इकार	ikɑːɾɐ
षाण्मासिक	ʂɑːɳmɑːs̪ikɐ́
बुध्न	bud̪ʱn̪ɐ́
क्रीणीतः	kɾiːɳiːt̪ɐh
शिक्षिकाः	ɕikʂikɑːh
गोल	ɡɐwl̪ɐ
आगार	ɑːɡɑːɾɐ
वीणा	ʋiːɳɑː
श्रमिका	ɕɾɐmikɑː
पाषी	pɑːʂiː
शृणोति	ɕr̩ɳɐ́wt̪i
द्रुह्	d̪ɾuɦ
ग्रावन्	ɡɾɑ́ːʋɐn̪
धूम	d̪ʱuːmɐ́
प्रणृत्यति	pɾɐɳr̩t̪jɐt̪i
विना	ʋín̪ɑː
समह	s̪ɐmɐɦɐ
त्वष्टृ	t̪ʋɐʂʈr̩
व्यञ्जन	ʋjɐɲd͡ʑɐn̪ɐ
चिकित्सालय	t͡ɕikit̪s̪ɑːl̪ɐjɐ
नृत्त	n̪r̩t̪t̪ɐ
पूर्व	púːɾʋɐ
अश्वश्चन्द्र	ɐ́ɕʋɐɕt͡ɕɐn̪d̪ɾɐ
नेमि	n̪eːmi
महार्घ	mɐɦɑːɾɡʱɐ
बर्हयति	bɐɾɦɐjɐt̪i
लज्जास्पद	l̪ɐdd͡ʑɑːs̪pɐd̪ɐ
आशा	ɑːɕɑː
आर्य	ɑ́ːɾjɐ
अस्मान्	ɐs̪mɑ́ːn̪
भरत्	bʱɐɾɐt̪
रुग्ण	ɾuɡɳɐ́
भूमि	bʱuːmi
ईर्षु	iːɾʂu
स्तरीमन्	s̪t̪ɐɾiːmɐn̪
भर्तृ	bʱɐ́ɾt̪r̩
द्रावयति	d̪ɾɑːʋɐjɐt̪i
अक्षर	ɐkʂɐ́ɾɐ
नृपशु	n̪ŕ̩pɐɕu
करिकणा	kɐɾikɐɳɑː
धामन्	d̪ʱɑ́ːmɐn̪
रभस्	ɾɐ́bʱɐs̪
साक्षी	s̪ɑːkʂiː
याजि	jɑːd͡ʑi
खेदाः	kʰeːd̪ɑːh
बर्हिस्	bɐɾɦís̪
प्राणिन्	pɾɑːɳin̪
स्वेदते	s̪ʋeːd̪ɐt̪eː
लेखन	l̪eːkʰɐn̪ɐ
फलनेषु	pʰɐl̪ɐn̪eːʂu
साधु	s̪ɑːd̪ʱu
याभ	jɑːbʱɐ
कुष्ठ	kuʂʈʰɐ
रक्षति	ɾɐ́kʂɐt̪i
दूरभाषैः	d̪uːɾɐbʱɑːʂɑːjh
धृत्य	d̪ʱr̩t̪jɐ
लिङ्ग	l̪iŋɡɐ
चिकित्सकयोः	t͡ɕikit̪s̪ɐkɐjɐwh
पिपर्ति	pípɐɾt̪i
रिफित	ɾipʰit̪ɐ
स्वरति	s̪ʋɐɾɐt̪i
योगिन्	joːɡin̪
युग	juɡɐ́
गर्दभ	ɡɐɾd̪ɐbʱɐ
मौखिक	mɑːwkʰikɐ
तरुतृ	t̪ɐɾut̪r̩
सप्तन्	s̪ɐpt̪ɐ́n̪
वपुष्टर	ʋɐpuʂʈɐɾɐ
जनस्	d͡ʑɐ́n̪ɐs̪
स्मृत्वा	s̪mr̩t̪ʋɑː
वृणोति	ʋr̩ɳoːt̪i
पृच्छति	pr̩tt͡ɕʰɐt̪i
इङ्गते	iŋɡɐt̪eː
ज्योत्स्ना	d͡ʑjɐ́wt̪s̪n̪ɑː
स्व	s̪ʋɐ́
उत्तराधिकारी	ut̪t̪ɐɾɑːd̪ʱikɑːɾiː
गृह	ɡr̩ɦɐ́
रोध्र	ɾɐwd̪ʱɾɐ
वृष्णि	ʋr̩ʂɳi
दृळ्ह	d̪r̩ɭ̆ɦɐ
चरु	t͡ɕɐɾu
गोल	ɡoːl̪ɐ
वैज्ञानिक	ʋɑːjd͡ʑɲɑːn̪ikɐ
पिप्पलि	pippɐl̪i
बीज	biːd͡ʑɐ
तरुस्	t̪ɐɾus̪
वास	ʋɑːs̪ɐ
खेल	kʰeːl̪ɐ
भानु	bʱɑːn̪u
न्याय	n̪jɑːjɐ
वीतभी	ʋiːt̪ɐbʱiː
यत्र	jɐt̪ɾɐ
मत्स्य	mɐt̪s̪jɐ
वध्या	ʋɐd̪ʱjɑː
मर्मन्	mɐ́ɾmɐn̪
कारक	kɑ́ːɾɐkɐ
स्वतन्त्र	s̪ʋɐt̪ɐn̪t̪ɾɐh
अस्त	ɐ́s̪t̪ɐ
अबुध्न	ɐbud̪ʱn̪ɐ́
कदा	kɐd̪ɑː
गम्येत	ɡɐmjɐjt̪ɐ
महाराष्ट्र	mɐɦɑːɾɑːʂʈɾɐ
च्युप	t͡ɕjupɐ
युवयोः	juʋɐjoːh
बर्हिष्ठ	bɐɾɦiʂʈʰɐ
अनूप	ɐn̪uːpɐ́
यदि	jɐ́d̪i
भारिन्	bʱɑːɾin̪
भ्रंशते	bʱɾɐ̃ɕɐt̪eː
ग्रीवा	ɡɾiːʋɑ́ː
एतवे	eːt̪ɐʋeː
भास्	bʱɑːs̪
स्रवति	s̪ɾɐʋɐt̪i
विषुव	ʋiʂuʋɐ
शिक्	ɕik
नि	n̪í
हल	ɦɐl̪ɐ
हति	ɦɐt̪i
मह्यम्	mɐ́ɦjɐm
धर्म	d̪ʱɐɾmɐ
पचति	pɐt͡ɕɐt̪i
रञ्जन	ɾɐɲd͡ʑɐn̪ɐ
बाधताम्	bɑːd̪ʱɐt̪ɑːm
गात्र	ɡɑ́ːt̪ɾɐ
विश्वस्	ʋiɕʋɐs̪
निमय	n̪imɐjɐ
कूच	kuːt͡ɕɐ
शिश्न	ɕiɕn̪ɐ
पद	pɐd̪ɐ́
नामक	n̪ɑːmɐkɐ
हठेन	ɦɐʈʰeːn̪ɐ
गुरु	ɡuɾú
दूत	d̪uːt̪ɐ́
शङ्कते	ɕɐ́ŋkɐt̪ɐj
विद्युत्	ʋid̪jút̪
जज्ञौ	d͡ʑɐd͡ʑɲɑw
धनाढ्य	d̪ʱɐ́n̪ɑːɖʱjɐ
उभौ	ubʱɑw
नकार	n̪ɐkɑːɾɐ
लब्ध्वा	l̪ɐbd̪ʱʋɑː
अम्नस्	ɐmn̪ɐ́s̪
अपसर्जन	ɐpɐs̪ɐɾd͡ʑɐn̪ɐ
काली	kɑːl̪iː
भुवन	bʱúʋɐn̪ɐ
क्रुद्ध	kɾud̪d̪ʱɐ
एते	eːt̪eː
जनता	d͡ʑɐn̪ɐ́t̪ɑː
ब्रह्मन्	bɾɐ́ɦmɐn̪
मध्य	mɐd̪ʱjɐ
तव्य	t̪ɐ́ʋjɐ
रजस्	ɾɐ́d͡ʑɐs̪
कर्पास	kɐɾpɑ́ːs̪ɐ
पुरुष	puɾuʂɐ
क्रोध	kɾɐ́wd̪ʱɐ
प्रश्न	pɾɐɕn̪ɐ́
नासा	n̪ɑ́ːs̪ɑː
प्रवेश	pɾɐʋɐjɕɐ
पितृ	pit̪r̩
पराभव	pɐɾɑːbʱɐʋɐ
उच्छ्वास	utt͡ɕʰʋɑːs̪ɐ́
दोग्धि	d̪ɐ́wɡd̪ʱi
देवन	d̪ɐjʋɐn̪ɐ
पतित्व	pɐt̪it̪ʋɐ
यात	jɑːt̪ɐ́
युक्त	jukt̪ɐ́
वैष्णव	ʋɑjʂɳɐʋɐ
करिस्कन्ध	kɐɾis̪kɐn̪d̪ʱɐ
दैव	d̪ɑjʋɐ
करिगर्जित	kɐɾiɡɐɾd͡ʑit̪ɐ
तन्मः	t̪ɐn̪mɐh
सप्तति	s̪ɐpt̪ɐt̪i
असनोत्	ɐs̪ɐn̪oːt̪
बन्दिनी	bɐn̪d̪in̪iː
सादः	s̪ɑːd̪ɐh
अरोधत्	ɐɾɐwd̪ʱɐt̪
हेषस्	ɦɐ́jʂɐs̪
योगिनी	jɐwɡin̪iː
करिपत्त्र	kɐɾipɐt̪t̪ɾɐ
धन्य	d̪ʱɐn̪jɐ
अनक्ति	ɐn̪ɐkt̪i
तालक	t̪ɑːl̪ɐkɐ
पद्म	pɐd̪mɐ
अर्णव	ɐɾɳɐʋɐ
सादेभ्यः	s̪ɑːd̪ɐjbʱjɐh
आयुस्	ɑːjus̪
साकम्	s̪ɑːkɐm
गुड	ɡuɖɐ
क्षेत्र	kʂɐ́jt̪ɾɐ
गोपाल	ɡoːpɑːl̪ɐ
क्रीडक	kɾiːɖɐkɐ
गोस्वामिन्	ɡoːs̪ʋɑːmin̪
दायी	d̪ɑːjiː
द्विप	d̪ʋipɐ
होम	ɦoːmɐ
अद्य	ɐd̪jɐ
द्युम्निन्	d̪jumn̪ín̪
सर्वनामन्	s̪ɐɾʋɐn̪ɑːmɐn̪
राष्टि	ɾɑːʂʈi
कर्तुम्	kɐ́ɾt̪um
लैङ्गिक	l̪ɑjŋɡikɐ
त्वेषद्युम्न	t̪ʋeːʂɐd̪jumn̪ɐ
उत	ut̪ɐ
शिफानाम्	ɕipʰɑːn̪ɑːm
महिष	mɐɦiʂɐ
कार्त्तिक	kɑːɾt̪t̪ikɐ
पादत्राणे	pɑːd̪ɐt̪ɾɑːɳeː
तूष्णीम्	t̪uːʂɳiːm
रुधिर	ɾud̪ʱiɾɐ́
अपराधिनी	ɐpɐɾɑːd̪ʱin̪iː
चिकित्सिकासु	t͡ɕikit̪s̪ikɑːs̪u
कोङ्कण	koːŋkɐɳɐ
स्रुव	s̪ɾuʋɐ
अश्व	ɐ́ɕʋɐ
भा	bʱɑː
शोधक	ɕɐwd̪ʱɐkɐ
अगच्छन्	ɐɡɐtt͡ɕʰɐn̪
महागज	mɐɦɑ́ːɡɐd͡ʑɐ
एवं	ɐjʋɐm
नष्टचन्द्र	n̪ɐʂʈɐt͡ɕɐn̪d̪ɾɐ
मूर्खतयोः	muːɾkʰɐt̪ɐjɐwh
इन्द्रिय	in̪d̪ɾijɐ́
पादत्राणयोः	pɑːd̪ɐt̪ɾɑːɳɐjoːh
वैदिक	ʋɑjd̪ikɐ
अक्षित	ɐkʂit̪ɐ
यत्र	jɐ́t̪ɾɐ
मृत्यु	mr̩t̪jú
हन्ति	ɦɐn̪t̪i
द्रवति	d̪ɾɐ́ʋɐt̪i
रति	ɾɐt̪i
पञ्चदश	pɐ́ɲt͡ɕɐd̪ɐɕɐ
दशा	d̪ɐ́ɕɑː
अयुत	ɐjut̪ɐ
गो	ɡɐ́w
त्विष्	t̪ʋiʂ
युत	jut̪ɐ
विलक्षण	ʋil̪ɐkʂɐɳɐ
तर्कु	t̪ɐɾkú
हरेणु	ɦɐɾeːɳu
संकल्प	s̪ɐŋkɐl̪pɐ
असृज्	ɐ́s̪r̩d͡ʑ
काजेभ्यः	kɑːd͡ʑɐjbʱjɐh
सुशोक	s̪uɕɐ́wkɐ
घोर	ɡʱoːɾɐ
निधातोस्	n̪id̪ʱɑːt̪oːs̪
पौंस्य	pɑ̃ws̪jɐ
लक्ष्मण	l̪ɐkʂmɐɳɐ
नाथतु	n̪ɑːt̪ʰɐt̪u
रिप्र	ɾipɾɐ́
ससान	s̪ɐs̪ɑːn̪ɐ
फलनयोः	pʰɐl̪ɐn̪ɐjɐwh
अरण्य	ɐɾɐɳjɐ
तारा	t̪ɑːɾɑː
एध्	ɐjd̪ʱ
युज्	jud͡ʑ
परस्वत्	pɐɾɐs̪ʋɐt̪
शिक्षिकाभ्याम्	ɕikʂikɑːbʱjɑːm
उपकरण	upɐkɐɾɐɳɐ
खण्ड	kʰɐɳɖɐ
पुर्	púɾ
अपूप	ɐpuːpɐ́
गुलाय	ɡul̪ɑːjɐ
कर्गद	kɐɾɡɐd̪ɐ
चिकित्सकानाम्	t͡ɕikit̪s̪ɐkɑːn̪ɑːm
कुञ्चिका	kuɲt͡ɕikɑː
वङ्कु	ʋɐŋkú
जिह्वा	d͡ʑiɦʋɑ́ː
लीढ	l̪iːɖʱɐ
श्वास	ɕʋɑːs̪ɐ́
पिङ्गल	piŋɡɐl̪ɐ́
क्रूर	kɾuːɾɐ
अर्जनेन	ɐɾd͡ʑɐn̪ɐjn̪ɐ
त्वरितरम्	t̪ʋɐɾit̪ɐɾɐm
देग्धि	d̪eːɡd̪ʱi
संवर्धन	s̪ɐ̃ʋɐɾd̪ʱɐn̪ɐ
तुरीय	t̪uɾiːjɐ
यक्ष	jɐkʂɐ́
आवश्यकता	ɑːʋɐɕjɐkɐt̪ɑː
अङ्गिरस्	ɐŋɡiɾɐs̪
सृष्टि	s̪r̩ʂʈi
आर्य	ɑːɾjɐ
भद्र	bʱɐd̪ɾɐ
क्याकु	kjɑːku
भिषज्	bʱiʂɐd͡ʑ
यजति	jɐd͡ʑɐt̪i
धान्य	d̪ʱɑːn̪jɐ́
त्वेष्य	t̪ʋɐjʂjɐ́
निष्क	n̪iʂkɐ
शावक	ɕɑːʋɐkɐ
चिकित्सिकायाः	t͡ɕikit̪s̪ikɑːjɑːh
परिविष्ट	pɐɾiʋiʂʈɐ
यातृ	jɑ́ːt̪r̩
रिणक्ति	ɾiɳɐkt̪i
ऋत	r̩t̪ɐ́
वसन्त	ʋɐs̪ɐn̪t̪ɐ
विक्रेतृ	ʋikɾeːt̪r̩
सृगाल	s̪r̩ɡɑːl̪ɐ
वर्वट	ʋɐɾʋɐʈɐ
अगार	ɐɡɑːɾɐ
करम्भ	kɐɾɐmbʱɐ
बहिष्	bɐɦiʂ
तान	t̪ɑ́ːn̪ɐ
आम्रेडित	ɑːmɾeːɖit̪ɐ
ग्रह्	ɡɾɐɦ
खिट्	kʰiʈ
लोहित	l̪oːɦit̪ɐ
श्वश्रू	ɕʋɐɕɾuː
धान्य	d̪ʱɑːn̪jɐ
त्रप्	t̪ɾɐp
सम्राट्	s̪ɐmɾɑːʈ
तरति	t̪ɐ́ɾɐt̪i
जहाति	d͡ʑɐɦɑːt̪i
रीति	ɾiːt̪í
कारयति	kɑːɾɐjɐt̪i
स्वस्थ	s̪ʋɐs̪t̪ʰɐ
शत्रवे	ɕɐt̪ɾɐʋeː
व्युष्टि	ʋíjuʂʈi
भारत	bʱɑ́ːɾɐt̪ɐ
केले	kɐjl̪ɐj
गुलयोः	ɡul̪ɐjoːh
बहिस्	bɐɦís̪
रोटी	ɾoːʈiː
बन्धु	bɐ́n̪d̪ʱu
अर्हति	ɐ́ɾɦɐt̪i
गण्ड	ɡɐɳɖɐ
श्लाघते	ɕl̪ɑːɡʱɐt̪eː
दशति	d̪ɐɕɐt̪i
जनति	d͡ʑɐn̪ɐt̪i
निम्न	n̪imn̪ɐ
ओघ	oːɡʱɐ
कर्षति	kɐɾʂɐt̪i
गर्भिणी	ɡɐɾbʱíɳiː
गुले	ɡul̪ɐj
बर्जह्य	bɐɾd͡ʑɐɦjɐ́
क्षास्	kʂɑːs̪
मस्	mɐs̪
संयम	s̪ɐ̃jɐmɐ
असाधारण	ɐs̪ɑːd̪ʱɑːɾɐɳɐ
दीव्	d̪iːʋ
गुलासः	ɡul̪ɑːs̪ɐh
योनि	joːn̪i
पांसु	pɑ̃ːs̪u
भव्य	bʱɐʋjɐ
मर्यादा	mɐɾjɑ́ːd̪ɑː
नदी	n̪ɐd̪íː
अभ्र	ɐbʱɾɐ́
वज्र	ʋɐ́d͡ʑɾɐ
रोरवीति	ɾoːɾɐʋiːt̪i
शारद	ɕɑːɾɐd̪ɐ́
उप	upɐ
शास्त्रिन्	ɕɑːs̪t̪ɾin̪
अगच्छे	ɐɡɐtt͡ɕʰɐj
अधिकारिन्	ɐd̪ʱikɑːɾin̪
आशा	ɑ́ːɕɑː
गूहति	ɡuːɦɐt̪i
देवर	d̪ɐjʋɐɾɐ́
कठ्	kɐʈʰ
क्रीडा	kɾiːɖɑː
छिद्र	t͡ɕʰid̪ɾɐ
ज्येष्ठ	d͡ʑjeːʂʈʰɐ
हिन्दी	ɦin̪d̪iː
लाबु	l̪ɑːbu
बर्बर	bɐɾbɐɾɐ
अभयारण्य	ɐbʱɐjɑːɾɐɳjɐ
गति	ɡɐt̪i
पण्डित	pɐɳɖit̪ɐ
मोचते	mɐwt͡ɕɐt̪ɐj
कुष्ठ	kúʂʈʰɐ
शिंषाते	ɕĩʂɑːt̪ɐj
त्रै	t̪ɾɑj
धर्तृ	d̪ʱɐɾt̪ŕ̩
शस्त्र	ɕɐs̪t̪ɾɐ
महात्मन्	mɐɦɑːt̪mɐn̪
रथी	ɾɐt̪ʰíː
रोमन्	ɾoːmɐn̪
शब्दालंकार	ɕɐbd̪ɑːl̪ɐŋkɑːɾɐ
रोग	ɾɐ́wɡɐ
डिम्ब	ɖimbɐ
काण्ड	kɑ́ːɳɖɐ
गुलेषु	ɡul̪ɐjʂu
यत्रा	jɐ́t̪ɾɑː
मनन	mɐn̪ɐn̪ɐ
शिखा	ɕikʰɑː
राजेन्द्र	ɾɑːd͡ʑɐjn̪d̪ɾɐ
संज्ञा	s̪ɐɲd͡ʑɲɑ́ː
वसिष्ठ	ʋɐ́s̪iʂʈʰɐ
युवयोः	juʋɐjɐwh
शत्रौ	ɕɐt̪ɾɑːw
यौवन	jɑːwʋɐn̪ɐ́
ताम्र	t̪ɑːmɾɐ́
पूर्णमास्	puːɾɳɐmɑːs̪
जज्ञे	d͡ʑɐd͡ʑɲɐj
रिरंसा	ɾiɾɐ̃s̪ɑː
पशव्य	pɐɕɐʋjɐ
अंशकरण	ɐ̃ɕɐkɐɾɐɳɐ
अधुना	ɐd̪ʱun̪ɑː
अयजत्	ɐjɐd͡ʑɐt̪
अप्सरस्	ɐps̪ɐɾɐ́s̪
ओष	oːʂɐ
द्राक्षा	d̪ɾɑ́ːkʂɑː
अन्त्र	ɐ́n̪t̪ɾɐ
अकरोत्	ɐkɐɾoːt̪
हन्	ɦɐn̪
रैवत्य	ɾɑːjʋɐt̪jɐ́
दक्षिणापथ	d̪ɐkʂiɳɑːpɐt̪ʰɐ
तायु	t̪ɑːjú
श्वेत	ɕʋeːt̪ɐ
उष्ण	uʂɳɐ
सहस्र	s̪ɐɦɐ́s̪ɾɐ
पिङ्गल	piŋɡɐl̪ɐ
यशस्	jɐ́ɕɐs̪
फलनैः	pʰɐl̪ɐn̪ɑjh
रोरोति	ɾoːɾoːt̪i
भ्राता	bʱɾɑːt̪ɑː
तति	t̪ɐt̪i
आरोप	ɑːɾɐwpɐ
कर्षति	kɐ́ɾʂɐt̪i
नक्	n̪ɐk
शुचित्वा	ɕut͡ɕit̪ʋɑː
वहित्र	ʋɐɦit̪ɾɐ
चिकित्सकयोः	t͡ɕikit̪s̪ɐkɐjoːh
आयुस्	ɑ́ːjus̪
गच्छेत	ɡɐtt͡ɕʰɐjt̪ɐ
दत्तांश	d̪ɐt̪t̪ɑ̃ːɕɐ
बाळ्ह	bɑːɭ̆ɦɐ
परशु	pɐɾɐɕú
ओजिष्ठ	ɐ́wd͡ʑiʂʈʰɐ
आखेटक	ɑːkʰɐjʈɐkɐ
बर्जह	bɐɾd͡ʑɐɦɐ
धनाढ्य	d̪ʱɐn̪ɑːɖʱjɐ
तकु	t̪ɐku
संवत्सर	s̪ɐ̃ʋɐt̪s̪ɐɾɐ́
मरु	mɐɾu
अजर्बैजान	ɐd͡ʑɐɾbɑjd͡ʑɑːn̪ɐ
गम्ये	ɡɐmjeː
आस	ɑ́ːs̪ɐ
गिर्	ɡíɾ
आगच्छ	ɑːɡɐtt͡ɕʰɐ
ह्वरते	ɦʋɐɾɐt̪eː
यम्	jɐm
यूथ	juːt̪ʰɐ
भवत्	bʱɐ́ʋɐt̪
वैद्युतक	ʋɑjd̪jut̪ɐkɐ
रामेण	ɾɑːmeːɳɐ
वृषभ	ʋr̩ʂɐbʱɐ́
बृहन्त्	br̩ɦɐn̪t̪
जाबालिपुर	d͡ʑɑːbɑːl̪ipuɾɐ
एरका	ɐjɾɐkɑː
अकरोत्	ɐ́kɐɾɐwt̪
कान्ति	kɑːn̪t̪i
शश	ɕɐɕɐ́
संसिद्धि	s̪ɐ̃s̪id̪d̪ʱi
ऋश	ŕ̩ɕɐ
कौतुकिन्	kɑːwt̪ukin̪
तद्	t̪ɐd̪
सनुते	s̪ɐn̪ut̪eː
वाणी	ʋɑːɳiː
तनम्	t̪ɐn̪ɐm
वृक्क	ʋr̩kkɐ́
त्यजति	t̪jɐd͡ʑɐt̪i
ब्रध्न	bɾɐd̪ʱn̪ɐ
प्रवस्ते	pɾɐʋɐs̪t̪ɐj
औत्सुक्य	ɑːwt̪s̪ukjɐ
तीक्ष्ण	t̪iːkʂɳɐ
व्यान	ʋjɑːn̪ɐ́
पादत्राणा	pɑːd̪ɐt̪ɾɑːɳɑː
वा	ʋɑː
प्सुरस्	ps̪uɾɐs̪
पादत्राणेन	pɑːd̪ɐt̪ɾɑːɳɐjn̪ɐ
संरक्षित	s̪ɐ̃ɾɐkʂit̪ɐ
गुल्म	ɡul̪mɐ
चिकित्सकेषु	t͡ɕikit̪s̪ɐkeːʂu
कृपायाः	kr̩pɑːjɑːh
नश्यथ	n̪ɐɕjɐt̪ʰɐ
सादेन	s̪ɑːd̪ɐjn̪ɐ
स्रुव	s̪ɾuʋɐ́
हिम	ɦimɐ
भञ्जक	bʱɐɲd͡ʑɐkɐ
मार्जार	mɑːɾd͡ʑɑːɾɐ
धारणा	d̪ʱɑːɾɐɳɑː
नीत	n̪iːt̪ɐ
स्वयम्	s̪ʋɐjɐm
अङ्कित	ɐŋkit̪ɐ
पादत्राणाभ्याम्	pɑːd̪ɐt̪ɾɑːɳɑːbʱjɑːm
मूर्खतायाः	muːɾkʰɐt̪ɑːjɑːh
उद्रुणद्धि	ud̪ɾuɳɐd̪d̪ʱi
कृपायाम्	kr̩pɑːjɑːm
भूभाग	bʱúːbʱɑːɡɐ
अष्ठीवत्	ɐʂʈʰiːʋɐt̪
फलने	pʰɐl̪ɐn̪ɐj
अलाबू	ɐl̪ɑːbuː
दैनिक	d̪ɑːjn̪ikɐ
शिव	ɕiʋɐ
किम्	kim
गौड	ɡɑwɖɐ
आरिफ्	ɑːɾipʰ
समय	s̪ɐmɐjɐ́
शरस्	ɕɐ́ɾɐs̪
मनुष्य	mɐn̪uʂjɐ́
स्वेदक	s̪ʋɐjd̪ɐkɐ
प्रतिज्ञा	pɾɐt̪id͡ʑɲɑː
अस्माभिः	ɐs̪mɑːbʱih
वेवेक्ति	ʋeːʋeːkt̪i
कर्तवे	kɐɾt̪ɐʋeː
असृक्	ɐs̪r̩k
उनत्ति	ún̪ɐt̪t̪i
ऋतवः	r̩t̪ɐʋɐh
यूस्	juːs̪
गोदावरी	ɡoːd̪ɑːʋɐɾiː
कद्रु	kɐ́d̪ɾu
आकृत	ɑːkr̩t̪ɐ
गोक्षीर	ɡɐwkʂiːɾɐ
उष्ट	uʂʈɐ
शक्नोति	ɕɐkn̪oːt̪i
अरत्नि	ɐɾɐt̪n̪í
जनता	d͡ʑɐn̪ɐt̪ɑː
स्फुरति	s̪pʰuɾɐt̪i
द्रावयति	d̪ɾɑ́ːʋɐjɐt̪i
ननान्दृ	n̪ɐ́n̪ɑːn̪d̪r̩
शैशव	ɕɑjɕɐʋɐ
उदार	ud̪ɑːɾɐ
कारयान	kɑːɾɐjɑːn̪ɐ
तुर्वणे	t̪uɾʋɐɳeː
असानीत्	ɐs̪ɑːn̪iːt̪
मूर्खते	muːɾkʰɐt̪ɐj
वड्र	ʋɐɖɾɐ
ह्रादते	ɦɾɑ́ːd̪ɐt̪ɐj
भवावः	bʱɐʋɑːʋɐh
वीडु	ʋiːɖú
घृणा	ɡʱr̩ɳɑː
भरस्	bʱɐ́ɾɐs̪
वीतिराधस्	ʋiːt̪íɾɑːd̪ʱɐs̪
शीर्ष	ɕiːɾʂɐ
तवस्	t̪ɐʋɐs̪
त्वेषस्	t̪ʋeːʂɐs̪
समूह	s̪ɐmuːɦɐ
सेतु	s̪eːt̪u
नॄन्	n̪r̩ːn̪
पठति	pɐʈʰɐt̪i
लक्ष	l̪ɐkʂɐ́
वृषभ	ʋr̩ʂɐbʱɐ
खद्योतस्	kʰɐd̪joːt̪ɐs̪
उद्यान	ud̪jɑ́ːn̪ɐ
धरुण	d̪ʱɐɾúɳɐ
शस्त्र	ɕɐs̪t̪ɾɐ́
यामन्	jɑːmɐn̪
भाजयति	bʱɑːd͡ʑɐ́jɐt̪i
योद्धा	joːd̪d̪ʱɑː
अर्थालंकार	ɐɾt̪ʰɑːl̪ɐŋkɑːɾɐ
सादम्	s̪ɑːd̪ɐm
चमू	t͡ɕɐmuː
अगमत्	ɐɡɐmɐt̪
नागिन्	n̪ɑːɡin̪
अक	ɐkɐ
नष्टाप्तिसूत्र	n̪ɐʂʈɑːpt̪is̪uːt̪ɾɐ
पृष्टि	pr̩ʂʈí
परशु	pɐɾɐɕu
मन्यु	mɐn̪jú
विन्त्ते	ʋin̪t̪t̪ɐj
पटल	pɐʈɐl̪ɐ
करिमण्डित	kɐɾimɐɳɖit̪ɐ
राति	ɾɑːt̪í
नयति	n̪ɐjɐt̪i
नौ	n̪ɑw
कर्ता	kɐɾt̪ɑː
दीर्घ	d̪iːɾɡʱɐ́
पुद्गल	pud̪ɡɐl̪ɐ
बभार	bɐbʱɑ́ːɾɐ
शिनक्षि	ɕin̪ɐkʂi
कृन्तति	kr̩n̪t̪ɐt̪i
परिच्छेदस्य	pɐɾitt͡ɕʰɐjd̪ɐs̪jɐ
दत्	d̪ɐt̪
ऊनविंशति	uːn̪ɐʋĩɕɐ́t̪i
प्लीहन्	pl̪iːɦɐn̪
योगस्	joːɡɐs̪
एव	ɐ́jʋɐ
सम्भोग	s̪ɐmbʱoːɡɐ
ईर्म	iːɾmɐ́
भन्दताम्	bʱɐn̪d̪ɐt̪ɑːm
प्लुषि	pl̪uʂi
अर्यमा	ɐɾjɐmɑː
प्रान्त	pɾɑːn̪t̪ɐ
केश	kɐ́jɕɐ
त्सरु	t̪s̪ɐ́ɾu
भृष्टि	bʱr̩ʂʈi
गन्तासि	ɡɐn̪t̪ɑːs̪i
खनित्रेण	kʰɐn̪it̪ɾɐjɳɐ
काजाभ्याम्	kɑːd͡ʑɑːbʱjɑːm
ऊर्दते	uːɾd̪ɐt̪eː
क्रीळति	kɾíːɭ̆ɐt̪i
भवथः	bʱɐʋɐt̪ʰɐh
दूरभाषेभिः	d̪uːɾɐbʱɑːʂɐjbʱih
सूनु	s̪uːn̪ú
भृति	bʱr̩t̪i
पटोल	pɐʈoːl̪ɐ
जलद	d͡ʑɐl̪ɐd̪ɐ
शास्त्र	ɕɑːs̪t̪ɾɐ
गिर्	ɡiɾ
स्नायु	s̪n̪ɑːju
नेतृ	n̪ɐ́jt̪r̩
त्विष्	t̪ʋíʂ
धेनोः	d̪ʱɐjn̪ɐwh
राष्ट्र	ɾɑːʂʈɾɐ
संलग्न	s̪ɐ̃l̪ɐɡn̪ɐ
शिला	ɕil̪ɑː
ह्यस्	ɦjɐ́s̪
यच्छति	jɐtt͡ɕʰɐt̪i
ज्या	d͡ʑijɑ́ː
खनित्रेभिः	kʰɐn̪it̪ɾeːbʱih
गच्छथः	ɡɐtt͡ɕʰɐt̪ʰɐh
याम	jɑːmɐ
प्रवेश	pɾɐʋeːɕɐ
नीत	n̪iːt̪ɐ́
तद्	t̪ɐ́d̪
भूयेथे	bʱuːjeːt̪ʰeː
गुलयोः	ɡul̪ɐjɐwh
स्तरी	s̪t̪ɐɾiː
कवि	kɐʋi
पथ	pɐt̪ʰɐ́
पति	pɐ́t̪i
पोषण	poːʂɐɳɐ
गुल्म	ɡúl̪mɐ
उण्डुक	uɳɖukɐ
अऋणिन्	ɐr̩ɳin̪
सदस्य	s̪ɐd̪ɐs̪jɐ́
गदति	ɡɐd̪ɐt̪i
तनाभ्याम्	t̪ɐn̪ɑːbʱjɑːm
नभस्	n̪ɐbʱɐs̪
परित्रै	pɐɾit̪ɾɑːj
धेनु	d̪ʱɐjn̪ú
घर्म	ɡʱɐɾmɐ
दन्तमूलीय	d̪ɐn̪t̪ɐmuːl̪iːjɐ
हूण	ɦuːɳɐ
हिम्	ɦim
अशीति	ɐɕiːt̪i
अर्यमन्	ɐɾjɐmɐn̪
आयुर्वेद	ɑːjuɾʋɐjd̪ɐ
तमस्वत्	t̪ɐmɐs̪ʋɐt̪
भूयेते	bʱuːjeːt̪eː
भजति	bʱɐ́d͡ʑɐt̪i
उद्द्योत	ud̪d̪joːt̪ɐ
डमरु	ɖɐmɐɾu
संज्ञापद	s̪ɐɲd͡ʑɲɑːpɐd̪ɐ
दर्शयति	d̪ɐɾɕɐ́jɐt̪i
उर्वरा	uɾʋɐɾɑː
दैत्य	d̪ɑːjt̪jɐ
अलाबुक	ɐl̪ɑːbukɐ
जिघर्ति	d͡ʑiɡʱɐɾt̪i
सस्पिञ्जर	s̪ɐs̪piɲd͡ʑɐɾɐ
आदि	ɑːd̪i
शिंष्टः	ɕĩʂʈɐh
ह्वयति	ɦʋɐjɐt̪i
दग्ध	d̪ɐɡd̪ʱɐ́
वृत्रघ्ने	ʋr̩t̪ɾɐɡʱn̪eː
जाति	d͡ʑɑːt̪í
रंहि	ɾɐ̃́ɦi
इति	it̪i
मन्दताम्	mɐn̪d̪ɐt̪ɑːm
स्वर्ग	s̪ʋɐɾɡɐ
पत्रिका	pɐt̪t̪ɾikɑː
दत्तात्	d̪ɐt̪t̪ɑːt̪
प्राण	pɾɑːɳɐ
केतु	kɐjt̪ú
वपुष्या	ʋɐpuʂjɑ́ː
पर्वन्	pɐ́ɾʋɐn̪
शर्ध	ɕɐ́ɾd̪ʱɐ
आसन्द	ɑːs̪ɐn̪d̪ɐ
यभति	jɐ́bʱɐt̪i
आह्वयति	ɑːɦʋɐjɐt̪i
स्तृति	s̪t̪ŕ̩t̪i
स्वार्थी	s̪ʋɑːɾt̪ʰiː
रकार	ɾɐkɑːɾɐ
गिरि	ɡiɾí
पिनद्ध	pin̪ɐd̪d̪ʱɐ
आर्तव	ɑːɾt̪ɐʋɐ́
धुर	d̪ʱúɾɐ
कश	kɐ́ɕɐ
मूर्छ्	muːɾt͡ɕʰ
त्वं	t̪ʋɐm
उत्पीठिकायाः	ut̪piːʈʰikɑːjɑːh
ऋभु	r̩bʱú
रौद्र	ɾɑ́ːwd̪ɾɐ
सह	s̪ɐɦɐ́
जनिमन्	d͡ʑɐn̪imɐn̪
पूर्ण	puːɾɳɐ
श्याव	ɕjɑːʋɐ
पितु	pit̪ú
धर्त्र	d̪ʱɐɾt̪ɾɐ́
उचित	ut͡ɕit̪ɐ́
वसा	ʋɐs̪ɑː
नलद	n̪ɐl̪ɐd̪ɐ
पीठ	piːʈʰɐ
इदम्	id̪ɐ́m
धातृ	d̪ʱɑːt̪r̩
भरिष	bʱɐɾiʂɐ́
इहेह	iɦeːɦɐ
रज्जु	ɾɐ́dd͡ʑu
क्षालयति	kʂɑːl̪ɐjɐt̪i
फल्	pʰɐl̪
पशु	pɐ́ɕu
मनस्	mɐn̪ɐs̪
स्वर्दते	s̪ʋɐɾd̪ɐt̪eː
स्रेधति	s̪ɾɐ́jd̪ʱɐt̪i
सादानाम्	s̪ɑːd̪ɑːn̪ɑːm
इङ्गति	iŋɡɐt̪i
स्तन	s̪t̪ɐ́n̪ɐ
कुट्टयति	kuʈʈɐjɐt̪i
हत	ɦɐt̪ɐ́
लीढे	l̪iːɖʱɐj
शल्य	ɕɐl̪jɐ́
स्तेनयति	s̪t̪eːn̪ɐjɐt̪i
अघ	ɐɡʱɐ
मनेत्	mɐn̪ɐjt̪
वराह	ʋɐɾɑːɦɐ
शिंष्टे	ɕĩʂʈeː
स्तृ	s̪t̪ŕ̩
रजनि	ɾɐd͡ʑɐn̪i
पर्ण	pɐɾɳɐ́
एष	eːʂɐ
मोचयति	mɐwt͡ɕɐjɐt̪i
त्वच्	t̪ʋɐ́t͡ɕ
खेलना	kʰeːl̪ɐn̪ɑː
प्रचेतस्	pɾɐt͡ɕeːt̪ɐs̪
मेण्ढ्र	meːɳɖʱɾɐ
वेग	ʋeːɡɐ
परिच्छेद	pɐɾitt͡ɕʰɐjd̪ɐ
नष्ट	n̪ɐʂʈɐ́
चण्ड	t͡ɕɐ́ɳɖɐ
पृष्ट	pr̩ʂʈɐ́
प्लव	pl̪ɐʋɐ́
कदस्य	kɐd̪ɐs̪jɐ
नग्न	n̪ɐɡn̪ɐ́
वेट	ʋɐjʈɐ
कनिष्क	kɐn̪iʂkɐ
डाले	ɖɑːl̪ɐj
तन	t̪ɐn̪ɐ
नाशयति	n̪ɑːɕɐ́jɐt̪i
मोदताम्	moːd̪ɐt̪ɑːm
स्वामिन्	s̪ʋɑːmin̪
ऋणिन्	r̩ɳin̪
वृद्ध	ʋr̩d̪d̪ʱɐ
छत्र	t͡ɕʰɐt̪ɾɐ
मांस	mɑ̃ːs̪ɐ
धृषु	d̪ʱr̩ʂú
भल्लाक	bʱɐl̪l̪ɑːkɐ
खेदौ	kʰɐjd̪ɑːw
वापी	ʋɑːpiː
यवन	jɐʋɐn̪ɐ
तिथि	t̪it̪ʰi
खनि	kʰɐn̪i
शेप	ɕeːpɐ
सस्य	s̪ɐs̪jɐ́
वीतभीति	ʋiːt̪ɐbʱiːt̪i
अक्षत	ɐ́kʂɐt̪ɐ
स्रुत	s̪ɾut̪ɐ
शाल	ɕɑːl̪ɐ
मुञ्चते	muɲt͡ɕɐt̪ɐj
शीर्षन्	ɕiːɾʂɐn̪
अर्णव	ɐɾɳɐ́ʋɐ
म्लेच्छ	ml̪ɐjtt͡ɕʰɐ́
समा	s̪ɐ́mɑː
सोढ	s̪ɐwɖʱɐ
संदिह्	s̪ɐn̪d̪iɦ
प्रेत	pɾɐ́jt̪ɐ
दुग्धाग्र	d̪uɡd̪ʱɑːɡɾɐ
श्वास	ɕʋɑːs̪ɐ
वर्तते	ʋɐ́ɾt̪ɐt̪ɐj
सन्यात्	s̪ɐn̪jɑːt̪
खनित्रेभिः	kʰɐn̪it̪ɾɐjbʱih
घृत	ɡʱr̩t̪ɐ
शिंष्टे	ɕĩʂʈɐj
नेम	n̪eːmɐ
शत्रौ	ɕɐt̪ɾɑw
आरम्भ	ɑːɾɐmbʱɐ
करुणा	kɐɾuɳɑː
शेव	ɕeːʋɐ
आत्मनेपद	ɑːt̪mɐn̪eːpɐd̪ɐ
कर्मन्	kɐ́ɾmɐn̪
मूर्छित	muːɾt͡ɕʰit̪ɐ
योद्धृ	jɐwd̪d̪ʱr̩
रामायण	ɾɑːmɑ́ːjɐɳɐ
तनोति	t̪ɐn̪oːt̪i
स्वरिष्यति	s̪ʋɐɾiʂjɐt̪i
संकल्पे	s̪ɐŋkɐl̪pɐj
नाशयति	n̪ɑːɕɐjɐt̪i
मर्मन्	mɐɾmɐn̪
विन्यास	ʋin̪jɑːs̪ɐ
नष्ट	n̪ɐʂʈɐ
परीक्षते	pɐ́ɾiːkʂɐt̪ɐj
भक्ष	bʱɐkʂɐ́
दूरभाषौ	d̪uːɾɐbʱɑːʂɑːw
नपात्	n̪ɐpɑːt̪
तेषु	t̪eːʂu
विंशति	ʋĩɕɐt̪í
भोग	bʱɐ́wɡɐ
अकिञ्चन	ɐkiɲt͡ɕɐn̪ɐ
क्षीर	kʂiːɾɐ
कशप्लक	kɐɕɐpl̪ɐkɐ
शत्रुम्	ɕɐt̪ɾum
वाटिका	ʋɑːʈikɑː
ग्लौ	ɡl̪ɑːw
हरस्	ɦɐɾɐs̪
परि	pɐɾi
प्रैणान	pɾɑːjɳɑːn̪ɐ́
पत्त्र	pɐ́t̪t̪ɾɐ
धाना	d̪ʱɑːn̪ɑ́ː
मनुस्	mɐn̪us̪
यन्तृ	jɐn̪t̪r̩
दर्वि	d̪ɐ́ɾʋi
त्वरित	t̪ʋɐɾit̪ɐ
कृष्ण	kŕ̩ʂɳɐ
मीर	miːɾɐ
स्मेरता	s̪meːɾɐt̪ɑː
मुर्छ्	muɾt͡ɕʰ
कन्या	kɐn̪jɑ́ː
स्त्री	s̪t̪ɾíː
मसीपात्र	mɐs̪iːpɑːt̪ɾɐ
दुग्ध	d̪uɡd̪ʱɐ
प्सरस्	ps̪ɐɾɐs̪
सगर्भ्य	s̪ɐɡɐɾbʱjɐ
यौवन	jɑwʋɐn̪ɐ
चोर	t͡ɕoːɾɐ
श्रवस्	ɕɾɐʋɐs̪
परिच्छेदाभ्याम्	pɐɾitt͡ɕʰɐjd̪ɑːbʱjɑːm
मार	mɑ́ːɾɐ
राधस्	ɾɑ́ːd̪ʱɐs̪
योनी	joːn̪iː
किकि	kiki
डालयोस्	ɖɑːl̪ɐjoːs̪
क्षरति	kʂɐ́ɾɐt̪i
प्रेषित	pɾeːʂit̪ɐ
संस्कृत	s̪ɐ̃́s̪kr̩t̪ɐ
बस्त	bɐs̪t̪ɐ
कूर्च	kuːɾt͡ɕɐ́
विसर्ग	ʋis̪ɐɾɡɐ́
शङ्ख	ɕɐŋkʰɐ
नमति	n̪ɐmɐt̪i
मकक	mɐ́kɐkɐ
स्फिगी	s̪pʰiɡíː
भर्तृ	bʱɐɾt̪r̩
नेतृत्व	n̪ɐjt̪r̩t̪ʋɐ
सप्तम	s̪ɐpt̪ɐmɐ́
परिच्छेदेभिस्	pɐɾitt͡ɕʰɐjd̪ɐjbʱis̪
गृहपति	ɡr̩ɦɐpɐt̪i
प्लव	pl̪ɐʋɐ
लोक्	l̪ɐwk
तस्थौ	t̪ɐs̪t̪ʰɑ́ːw
तत्रैव	t̪ɐt̪ɾɑjʋɐ
वंश	ʋɐ̃ɕɐ
शब्दार्थ	ɕɐbd̪ɑːɾt̪ʰɐh
सव्य	s̪ɐʋjɐ
सादेभिः	s̪ɑːd̪ɐjbʱih
आनन	ɑːn̪ɐn̪ɐ
वङ्गन	ʋɐŋɡɐn̪ɐ
मन्या	mɐ́n̪jɑː
वस्मन्	ʋɐ́s̪mɐn̪
दूरभाषासः	d̪uːɾɐbʱɑːʂɑːs̪ɐh
वङ्क्य	ʋɐŋkjɐ
हरिद्रा	ɦɐɾid̪ɾɑː
सरस्	s̪ɐɾɐs̪
रङ्गिन्	ɾɐŋɡin̪
अनूक	ɐn̪uːkɐ
व्रत	ʋɾɐt̪ɐ́
बोभोति	bɐwbʱɐwt̪i
रस	ɾɐs̪ɐ
अन्ध	ɐn̪d̪ʱɐ́
मनः	mɐn̪ɐh
सौर्य	s̪ɑːwɾjɐ
द्राघ्मन्	d̪ɾɑːɡʱmɐ́n̪
बद्ध	bɐd̪d̪ʱɐ́
निद्	n̪íd̪
मूलिका	muːl̪ikɑː
घिण्ण्	ɡʱiɳɳ
रात्रि	ɾɑːt̪ɾi
शिंषन्ति	ɕĩʂɐn̪t̪i
दन्तघर्षण	d̪ɐn̪t̪ɐɡʱɐɾʂɐɳɐ
तृ	t̪ŕ̩
नादेय	n̪ɑːd̪eːjɐ
एनस्	ɐ́jn̪ɐs̪
राज्ञी	ɾɑːd͡ʑɲiː
खेदयोः	kʰɐjd̪ɐjɐwh
डालैस्	ɖɑːl̪ɑːjs̪
इष्	íʂ
अङ्ग	ɐŋɡɐ
यत	jɐt̪ɐ́
मृत्यु	mr̩t̪ju
प्सात	ps̪ɑːt̪ɐ́
अनु	ɐn̪u
भवन्ति	bʱɐʋɐn̪t̪i
उद्यान	ud̪jɑːn̪ɐ
ग्ना	ɡn̪ɑ́ː
कदयोः	kɐd̪ɐjɐwh
कर्म	kɐ́ɾmɐ
द्रप्स	d̪ɾɐps̪ɐ
विद्युत्	ʋid̪jut̪
दा	d̪ɑ́ː
मूर्खताभ्याम्	muːɾkʰɐt̪ɑːbʱjɑːm
फिरङ्गिन्	pʰiɾɐŋɡin̪
आदिम	ɑːd̪ímɐ
सज्जा	s̪ɐdd͡ʑɑː
राद्धि	ɾɑ́ːd̪d̪ʱi
केसर	kɐ́js̪ɐɾɐ
तनोमि	t̪ɐn̪ɐwmi
लक्ष	l̪ɐkʂɐ
सक्त	s̪ɐkt̪ɐ́
श्रेष्ठ	ɕɾeːʂʈʰɐ
धाराखान	d̪ʱɑːɾɑːkʰɑːn̪ɐ
कल्प	kɐl̪pɐ
मेघ	mɐjɡʱɐ́
द्युत्	d̪jut̪
स्यूत	s̪juːt̪ɐ́
मूर्च्छित	muːɾtt͡ɕʰit̪ɐ
अश्रु	ɐɕɾu
तेषाम्	t̪eːʂɑːm
यह्व	jɐɦʋɐ
भरस्	bʱɐɾɐs̪
घृणा	ɡʱr̩ɳɑ́ː
आत्	ɑːt̪
शुष्कफल	ɕúʂkɐpʰɐl̪ɐ
धरेरन्	d̪ʱɐɾeːɾɐn̪
पिञ्जर	piɲd͡ʑɐɾɐ
सम्प्रददाति	s̪ɐmpɾɐd̪ɐd̪ɑːt̪i
शरदा	ɕɐɾɐ́d̪ɑː
कपोल	kɐpoːl̪ɐ
शङ्ख	ɕɐŋkʰɐ́
ददौ	d̪ɐd̪ɑ́ːw
रपस्	ɾɐpɐs̪
नाग	n̪ɑːɡɐ
आपीन	ɑːpiːn̪ɐ
अभवत्	ɐbʱɐʋɐt̪
वन	ʋɐ́n̪ɐ
मूर्धन्	muːɾd̪ʱɐ́n̪
नारिकेल	n̪ɑːɾikeːl̪ɐ
त्रपते	t̪ɾɐ́pɐt̪ɐj
संकल्पम्	s̪ɐŋkɐl̪pɐm
दूरभाषस्य	d̪uːɾɐbʱɑːʂɐs̪jɐ
राजेन्द्र	ɾɑːd͡ʑeːn̪d̪ɾɐ
डकार	ɖɐkɑːɾɐ
क्षीयते	kʂiːjɐ́t̪ɐj
उत्तर	út̪t̪ɐɾɐ
पुरस्	puɾɐs̪
गाथा	ɡɑːt̪ʰɑː
लेखनी	l̪eːkʰɐn̪iː
वि	ʋi
अनूप	ɐn̪uːpɐ
स्रोतस्	s̪ɾoːt̪ɐs̪
जानु	d͡ʑɑːn̪u
सामवेद	s̪ɑːmɐʋeːd̪ɐ
दाह	d̪ɑːɦɐ
पादत्राणेषु	pɑːd̪ɐt̪ɾɑːɳɐjʂu
हिमालय	ɦimɑːl̪ɐjɐ
प्रौढ	pɾɑwɖʱɐ
अट्टालिका	ɐʈʈɑːl̪ikɑː
सेने	s̪eːn̪eː
ऐश	ɑːjɕɐ
मीढुष्टम	miːɖʱuʂʈɐmɐ
सिन्धु	s̪in̪d̪ʱu
श्चन्द्र	ɕt͡ɕɐn̪d̪ɾɐ
बहुता	bɐɦut̪ɑː
गृभ्	ɡŕ̩bʱ
अङ्कयति	ɐŋkɐjɐt̪i
बाधति	bɑ́ːd̪ʱɐt̪i
पुष्पशाक	puʂpɐɕɑːkɐ
अंशु	ɐ̃ɕu
जीर्ण	d͡ʑiːɾɳɐ
अर्श	ɐɾɕɐ
प्रतिरोध	pɾɐt̪iɾoːd̪ʱɐ
दानिन्	d̪ɑːn̪in̪
स्नुषा	s̪n̪uʂɑ́ː
आयम्	ɑːjɐm
मियेध	mijɐ́jd̪ʱɐ
माधव	mɑ́ːd̪ʱɐʋɐ
पृष्ठ	pr̩ʂʈʰɐ́
पथ	pɐt̪ʰɐ
यत्	jɐt̪
इदानीम्	id̪ɑːn̪iːm
कृष्ण	kr̩ʂɳɐ́
कदेभिः	kɐd̪eːbʱih
एधताम्	eːd̪ʱɐt̪ɑːm
तुविद्युम्न	t̪uʋid̪jumn̪ɐ
स्कन्ध	s̪kɐn̪d̪ʱɐ́
पति	pɐt̪i
देवर	d̪eːʋɐɾɐ
ज्येष्ठ	d͡ʑjɐjʂʈʰɐ́
पालिका	pɑːl̪ikɑː
पादोपधान	pɑːd̪ɐwpɐd̪ʱɑːn̪ɐ
द्वार	d̪ʋɑ́ːɾɐ
तनोति	t̪ɐn̪ɐ́wt̪i
वृद्धि	ʋr̩d̪d̪ʱi
भशिरा	bʱɐɕiɾɑː
गुलेभ्यः	ɡul̪eːbʱjɐh
तुण्ड	t̪uɳɖɐ
ऋग्वेद	r̩ɡʋeːd̪ɐ
कदैः	kɐd̪ɑjh
आयुर्वेद	ɑːjuɾʋeːd̪ɐ
उत्पत्ति	ut̪pɐt̪t̪i
वाताम	ʋɑːt̪ɑːmɐ
स्तायु	s̪t̪ɑːju
वीरुध्	ʋiːɾud̪ʱ
सुश्रवस्	s̪uɕɾɐʋɐs̪
ईर्ष्यति	íːɾʂjɐt̪i
करियादस्	kɐɾijɑːd̪ɐs̪
घ्रंस	ɡʱɾɐ̃s̪ɐ́
ददौ	d̪ɐd̪ɑw
दैव	d̪ɑ́ːjʋɐ
किट	kiʈɐ
माता	mɑːt̪ɑː
नेतृ	n̪eːt̪r̩
सादौ	s̪ɑːd̪ɑːw
फलनाय	pʰɐl̪ɐn̪ɑːjɐ
अकर्	ɐ́kɐɾ
तक्व	t̪ɐkʋɐ́
युध्	júd̪ʱ
देवसर्षप	d̪eːʋɐs̪ɐɾʂɐpɐ
तवस्	t̪ɐʋɐ́s̪
दूरभाषात्	d̪uːɾɐbʱɑːʂɑːt̪
लघु	l̪ɐɡʱu
रेखाङ्कित	ɾɐjkʰɑːŋkit̪ɐ
स्मृ	s̪mr̩
अंहु	ɐ̃ɦu
अभियन्ता	ɐbʱijɐn̪t̪ɑː
तैलम्	t̪ɑːjl̪ɐm
पिच्छोरा	pitt͡ɕʰɐwɾɑː
आपयति	ɑːpɐjɐt̪i
लवंग	l̪ɐʋɐŋɡɐ
अप्सस्	ɐps̪ɐs̪
उदार	ud̪ɑ́ːɾɐ
कृन्तन्ति	kr̩n̪t̪ɐn̪t̪i
यत	jɐt̪ɐ
सूतिकागार	s̪úːt̪ikɑːɡɑːɾɐ
भक्त	bʱɐkt̪ɐ́
अलम्	ɐl̪ɐm
रोहित	ɾoːɦit̪ɐ
भविष्यसि	bʱɐʋiʂjɐs̪i
शरदा	ɕɐɾɐd̪ɑː
अम्बर	ɐ́mbɐɾɐ
शूल	ɕúːl̪ɐ
खेदासः	kʰeːd̪ɑːs̪ɐh
कर्मधारय	kɐɾmɐd̪ʱɑːɾɐjɐ
मे	meː
तु	t̪ú
अन्तर्	ɐn̪t̪ɐɾ
खेदात्	kʰeːd̪ɑːt̪
चतुर्दश	t͡ɕɐ́t̪uɾd̪ɐɕɐ
गकार	ɡɐkɑːɾɐ
अस्वरिष्यत्	ɐs̪ʋɐɾiʂjɐt̪
क्षण्	kʂɐɳ
जुष्ट	d͡ʑúʂʈɐ
क्षप्	kʂɐp
स्तेन	s̪t̪eːn̪ɐ
बोधयति	bɐwd̪ʱɐ́jɐt̪i
भृष्टि	bʱr̩ʂʈí
कतर	kɐt̪ɐɾɐ
पद्	pɐd̪
मदिरा	mɐd̪iɾɑː
गमिष्यावः	ɡɐmiʂjɑːʋɐh
भूयते	bʱuːjɐt̪eː
विज्ञान	ʋid͡ʑɲɑːn̪ɐ
रोगिन्	ɾɐwɡin̪
तनुमः	t̪ɐn̪umɐh
आचरति	ɑːt͡ɕɐɾɐt̪i
भोट	bʱoːʈɐh
जतु	d͡ʑɐ́t̪u
हृदय	ɦŕ̩d̪ɐjɐ
काशति	kɑːɕɐt̪i
या	jɑː
वसन्तर्तु	ʋɐs̪ɐn̪t̪ɐɾt̪ú
चनस्	t͡ɕɐ́n̪ɐs̪
कुल्व	kul̪ʋɐ́
खनति	kʰɐ́n̪ɐt̪i
बहिः	bɐɦih
जंहस्	d͡ʑɐ̃ɦɐs̪
शिफे	ɕipʰɐj
भर्व्	bʱɐ́ɾʋ
स्थिति	s̪t̪ʰít̪i
तनोतु	t̪ɐn̪ɐwt̪u
सृष्ट	s̪r̩ʂʈɐ́
नामन्	n̪ɑ́ːmɐn̪
ऋतु	r̩t̪ú
मर्य	mɐ́ɾjɐ
क्षोदस्	kʂoːd̪ɐs̪
इयर्ति	ijɐɾt̪i
मन्त्र	mɐ́n̪t̪ɾɐ
शोषयति	ɕɐwʂɐ́jɐt̪i
कदे	kɐd̪ɐj
क्रीणाति	kɾiːɳɑ́ːt̪i
गन्तास्थ	ɡɐn̪t̪ɑːs̪t̪ʰɐ
मधुर	mɐd̪ʱuɾɐ
शुङ्गा	ɕuŋɡɑ́ː
अकर्तिष्यताम्	ɐkɐɾt̪iʂjɐt̪ɑːm
सना	s̪ɐn̪ɑː
रेखाङ्कित	ɾeːkʰɑːŋkit̪ɐ
गम्यन्ते	ɡɐmjɐn̪t̪ɐj
चोदति	t͡ɕɐ́wd̪ɐt̪i
न	n̪ɐ́
वपुष	ʋɐpuʂɐ
स्वादिष्ठ	s̪ʋɑːd̪iʂʈʰɐ
उत्साह	ut̪s̪ɑːɦɐ
दाधाव्यते	d̪ɑːd̪ʱɑːʋjɐt̪eː
एक	ɐ́jkɐ
सनुतर्	s̪ɐn̪ut̪ɐ́ɾ
धन	d̪ʱɐ́n̪ɐ
रेणु	ɾɐjɳú
जास्पति	d͡ʑɑ́ːs̪pɐt̪i
सरोज	s̪ɐɾɐwd͡ʑɐ
सरल	s̪ɐɾɐl̪ɐ
हति	ɦɐ́t̪i
पञ्चदश	pɐɲt͡ɕɐd̪ɐɕɐ
दधे	d̪ɐd̪ʱeː
ऋति	r̩t̪í
धर्मन्	d̪ʱɐ́ɾmɐn̪
हल्	ɦɐl̪
एकादशी	eːkɑːd̪ɐɕiː
धनी	d̪ʱɐn̪iː
पुण्डरीक	puɳɖɐ́ɾiːkɐ
मास्	mɑːs̪
भल्लात	bʱɐl̪l̪ɑːt̪ɐ
चिकित्सिकयोः	t͡ɕikit̪s̪ikɐjɐwh
धावति	d̪ʱɑ́ːʋɐt̪i
सञ्ज्	s̪ɐɲd͡ʑ
पिबति	píbɐt̪i
फलनस्य	pʰɐl̪ɐn̪ɐs̪jɐ
कण्ठ्य	kɐɳʈʰjɐ
ऋति	r̩t̪i
आता	ɑ́ːt̪ɑː
कियद्	kijɐd̪
साक्षिणी	s̪ɑːkʂiɳiː
ईषत्	iːʂɐt̪
मज्जति	mɐ́dd͡ʑɐt̪i
नश्यावः	n̪ɐɕjɑːʋɐh
कश	kɐɕɐ
बालिका	bɑːl̪ikɑː
दर्मन्	d̪ɐɾmɐ́n̪
दुग्धं	d̪uɡd̪ʱɐm
रोच	ɾɐwt͡ɕɐ́
पेशी	peːɕiː
घोष	ɡʱoːʂɐ
रायति	ɾɑːjɐt̪i
विद्यार्थिन्	ʋid̪jɑːɾt̪ʰin̪
वक्षति	ʋɐ́kʂɐt̪i
अनन्य	ɐn̪ɐn̪jɐ́
हवते	ɦɐʋɐt̪eː
जा	d͡ʑɑ́ː
रिक्त	ɾikt̪ɐ́
यह्वत्	jɐɦʋɐ́t̪
योनि	jɐwn̪i
चिकित्सिकानाम्	t͡ɕikit̪s̪ikɑːn̪ɑːm
संक्रमित	s̪ɐŋkɾɐmit̪ɐ
चिकित्सकेभिः	t͡ɕikit̪s̪ɐkɐjbʱih
तल	t̪ɐl̪ɐ
सूद	s̪úːd̪ɐ
विष्णु	ʋɪʂɳʊ
युज्य	jud͡ʑjɐ
शोक	ɕɐwkɐ́
सिनीतः	s̪in̪iːt̪ɐh
विशेषण	ʋiɕeːʂɐɳɐ
ऊर्णा	úːɾɳɑː
स्पर्धते	s̪pɐɾd̪ʱɐt̪eː
अरणि	ɐɾɐ́ɳi
पाति	pɑ́ːt̪i
काजात्	kɑːd͡ʑɑːt̪
प्रिय	pɾijɐ́
ऋण	r̩ɳɐ
खेट	kʰɐjʈɐ
रेष	ɾeːʂɐ
तति	t̪ɐ́t̪i
नभस्	n̪ɐ́bʱɐs̪
हरि	ɦɐɾi
सृगाल	s̪r̩ɡɑːl̪ɐ́
प्रजापति	pɾɐd͡ʑɑ́ːpɐt̪i
कुक्षि	kukʂi
सपत्नी	s̪ɐpɐ́t̪n̪iː
पुराण	puɾɑːɳɐ́
नासाभ्याम्	n̪ɑːs̪ɑːbʱjɑːm
असनीत्	ɐs̪ɐn̪iːt̪
हार्द	ɦɑːɾd̪ɐ
शकटाल	ɕɐkɐʈɑːl̪ɐ
मुह्यति	múɦjɐt̪i
दिग्ध	d̪iɡd̪ʱɐ
तनोषि	t̪ɐn̪oːʂi
पादत्राणानि	pɑːd̪ɐt̪ɾɑːɳɑːn̪i
गोधूम	ɡɐwd̪ʱúːmɐ
पादोपधान	pɑːd̪oːpɐd̪ʱɑːn̪ɐ
खेदौ	kʰeːd̪ɑw
उदक	ud̪ɐkɐ́
मनोगत	mɐ́n̪ɐwɡɐt̪ɐ
अभिष्टिद्युम्न	ɐbʱiʂʈíd̪jumn̪ɐ
जिहीते	d͡ʑiɦiːt̪ɐj
असङ्ख्येय	ɐs̪ɐŋkʰjeːjɐ
अरमति	ɐɾɐ́mɐt̪i
शम्ब	ɕɐmbɐ
पर्ण	pɐɾɳɐ
क्षिपति	kʂipɐ́t̪i
कदाभ्याम्	kɐd̪ɑːbʱjɑːm
ज्योतिस्	d͡ʑjoːt̪is̪
रेतस्	ɾɐ́jt̪ɐs̪
तनेभ्यः	t̪ɐn̪ɐjbʱjɐh
नहि	n̪ɐɦi
क्षुर	kʂuɾɐ
लोह	l̪oːɦɐ
साध्वलंकृत	s̪ɑːd̪ʱʋɐl̪ɐŋkr̩t̪ɐ
वाक्य	ʋɑːkjɐ
जीर्यति	d͡ʑiːɾjɐt̪i
ग	ɡɐ
स्तेय	s̪t̪ɐjjɐ́
चेतना	t͡ɕɐjt̪ɐn̪ɑː
ऋश्य	ŕ̩ɕjɐ
याद	jɑːd̪ɐ
गम्	ɡɐm
मधुरेण	mɐd̪ʱuɾeːɳɐ
दुःख	d̪uhkʰɐ́
स्मयते	s̪mɐ́jɐt̪ɐj
श्चन्द्र	ɕt͡ɕɐn̪d̪ɾɐ́
अधात्	ɐd̪ʱɑːt̪
तैले	t̪ɑːjl̪ɐj
तमस्	t̪ɐ́mɐs̪
ज्योतिरिङ्गण	d͡ʑjoːt̪iɾiŋɡɐɳɐ
बभ्रे	bɐbʱɾeː
एताः	eːt̪ɑːh
खेल्	kʰɐjl̪
जग्मथुः	d͡ʑɐɡmɐt̪ʰuh
बालकेलि	bɑːl̪ɐkɐjl̪i
बभूव	bɐbʱuːʋɐ
द्राघिमन्	d̪ɾɑːɡʱimɐn̪
ऊम	uːmɐ
तु	t̪u
ईश	iːɕɐ́
जिघर्ति	d͡ʑíɡʱɐɾt̪i
वेद्या	ʋeːd̪jɑː
पूयति	puːjɐt̪i
ध्रुव	d̪ʱɾuʋɐ
विक्रेतृ	ʋikɾɐjt̪r̩
सटीक	s̪ɐʈiːkɐ
उक्थ	ukt̪ʰɐ́
तडित्	t̪ɐɖit̪
नकार	n̪ɐ́kɑːɾɐ
साकम्	s̪ɑːkɐ́m
शौर्य	ɕɑ́ːwɾjɐ
शिफयोः	ɕipʰɐjɐwh
मसि	mɐs̪i
धुर्	d̪ʱúɾ
बोधति	bɐ́wd̪ʱɐt̪i
ह्रस्व	ɦɾɐs̪ʋɐ
तत्	t̪ɐt̪
प्रत्याशिन्	pɾɐt̪jɑːɕin̪
ऋतावन्	r̩t̪ɑːʋɐn̪
खादति	kʰɑːd̪ɐt̪i
स्पृध्	s̪pr̩d̪ʱ
पूजा	puːd͡ʑɑː
पी	piː
शिखा	ɕíkʰɑː
दाधाव्यते	d̪ɑːd̪ʱɑːʋjɐt̪ɐj
भुनक्ति	bʱun̪ɐ́kt̪i
वाले	ʋɑːl̪eː
भेषज	bʱeːʂɐd͡ʑɐ
षोडशन्	ʂoːɖɐɕɐn̪
अर्जनस्य	ɐɾd͡ʑɐn̪ɐs̪jɐ
न्यग्रोध	n̪jɐɡɾɐ́wd̪ʱɐ
देव	d̪eːʋɐ
अमृत	ɐmŕ̩t̪ɐ
निन्दा	n̪in̪d̪ɑː
छद्म	t͡ɕʰɐd̪mɐ
वीचि	ʋiːt͡ɕi
चित्	t͡ɕit̪
पुनाति	pun̪ɑ́ːt̪i
गुलौ	ɡul̪ɑw
महान्	mɐɦɑːn̪
अप्	ɐp
पिपासा	pipɑːs̪ɑː
समलंकृत	s̪ɐmɐl̪ɐŋkr̩t̪ɐ
गुल	ɡul̪ɐ
जवा	d͡ʑɐʋɑː
वस्ति	ʋɐs̪t̪í
सन्	s̪ɐn̪
स्वर	s̪ʋɐ́ɾɐ
गमति	ɡɐmɐt̪i
लोपाक	l̪ɐwpɑːkɐ
अहर्	ɐɦɐɾ
कदान्	kɐd̪ɑːn̪
शिक्षिका	ɕikʂikɑː
स्कुनीतः	s̪kun̪iːt̪ɐh
भूषण	bʱuːʂɐɳɐ
उपरान्त	upɐɾɑːn̪t̪ɐ
शिफाभ्याम्	ɕipʰɑːbʱjɑːm
खेदानाम्	kʰɐjd̪ɑːn̪ɑːm
ज्ञातोस्	d͡ʑɲɑ́ːt̪ɐws̪
दर्शयति	d̪ɐɾɕɐjɐt̪i
कफ	kɐpʰɐ
विद्यार्थिनी	ʋid̪jɑːɾt̪ʰin̪iː
नश्यति	n̪ɐɕjɐt̪i
खनित्रे	kʰɐn̪it̪ɾeː
तत्र	t̪ɐt̪ɾɐ
वपुष्य	ʋɐpuʂjɐ
सुशेवस्	s̪uɕeːʋɐs̪
अगच्छाव	ɐɡɐtt͡ɕʰɑːʋɐ
शुच्	ɕút͡ɕ
अद्यैव	ɐd̪jɑjʋɐ
श्लाघते	ɕl̪ɑ́ːɡʱɐt̪ɐj
प्लुषि	pl̪úʂi
एवं	eːʋɐm
नृम्ण	n̪r̩mɳɐ́
जन्य	d͡ʑɐ́n̪jɐ
वयम्	ʋɐjɐ́m
साळ्हृ	s̪ɑ́ːɭ̆ɦr̩
आग्नेय	ɑːɡn̪ɐjjɐ́
मिमीते	mímiːt̪ɐj
ऊधस्	uːd̪ʱɐs̪
संयुज्	s̪ɐ̃jud͡ʑ
मत्स्य	mɐ́t̪s̪jɐ
संलक्षण	s̪ɐ̃l̪ɐkʂɐɳɐ
विन्ते	ʋin̪t̪ɐj
रोचस्	ɾɐ́wt͡ɕɐs̪
स्त्री	s̪t̪ɾiː
घृणोति	ɡʱr̩ɳoːt̪i
श्री	ɕɾíː
राशिचक्र	ɾɑːɕit͡ɕɐkɾɐ
मेथी	mɐjt̪ʰiː
दुःस्वप्न	d̪uhs̪ʋɐ́pn̪ɐ
होतृ	ɦɐ́wt̪r̩
जासयति	d͡ʑɑːs̪ɐjɐt̪i
मृग	mr̩ɡɐ
खनिज	kʰɐn̪id͡ʑɐ
कूट	kuːʈɐ
दिन	d̪ín̪ɐ
रहस्	ɾɐɦɐs̪
पात्र	pɑːt̪ɾɐ
दुर्लभ	d̪uɾl̪ɐbʱɐ
स्तेन	s̪t̪ɐjn̪ɐ́
ऊह	uːɦɐ
क्षास्	kʂɑ́ːs̪
रङ्ग	ɾɐŋɡɐ
तृण	t̪ŕ̩ɳɐ
अयस्कार	ɐ́jɐs̪kɑːɾɐ
शत्रो	ɕɐt̪ɾɐw
मूर्खताभ्यः	muːɾkʰɐt̪ɑːbʱjɐh
भाजन	bʱɑːd͡ʑɐn̪ɐ
नीड	n̪iːɖɐ́
द्यति	d̪jɐt̪i
ऊढ	uːɖʱɐ́
वाले	ʋɑːl̪ɐj
वेश्या	ʋeːɕjɑː
ऐच्छत्	ɑːjtt͡ɕʰɐt̪
अश्वमेध	ɐ́ɕʋɐmɐjd̪ʱɐ
खेलन	kʰɐjl̪ɐn̪ɐ
शम्ब	ɕɐ́mbɐ
भर्व्	bʱɐɾʋ
ज्योतिष	d͡ʑjɐwt̪iʂɐ
स्नावन्	s̪n̪ɑ́ːʋɐn̪
अति	ɐ́t̪i
स्वयं	s̪ʋɐjɐm
अंहु	ɐ̃́ɦu
समाकुरुते	s̪ɐmɑːkuɾut̪eː
गाधे	ɡɑːd̪ʱeː
जस्यति	d͡ʑɐs̪jɐt̪i
दीक्षितृ	d̪iːkʂit̪r̩
दूरभाषेण	d̪uːɾɐbʱɑːʂeːɳɐ
ओतु	oːt̪u
शंकर	ɕɐŋkɐɾɐ
उपनेत्र	upɐn̪ɐjt̪ɾɐ
बुद्धीन्द्रिय	bud̪d̪ʱiːn̪d̪ɾijɐ
संकल्पैः	s̪ɐŋkɐl̪pɑjh
श्वसन	ɕʋɐs̪ɐn̪ɐ́
शिक्षिकयोः	ɕikʂikɐjoːh
रमण	ɾɐmɐɳɐ
कण्टक	kɐɳʈɐkɐ
परिच्छेदाभ्याम्	pɐɾitt͡ɕʰeːd̪ɑːbʱjɑːm
अस्ति	ɐs̪t̪i
धारयति	d̪ʱɑːɾɐ́jɐt̪i
भनति	bʱɐ́n̪ɐt̪i
दधाति	d̪ɐ́d̪ʱɑːt̪i
युवति	juʋɐt̪í
स्पश्	s̪pɐ́ɕ
स्वपति	s̪ʋɐpɐt̪i
हकार	ɦɐkɑːɾɐ
मुमोच	mumɐwt͡ɕɐ
परिच्छेदेन	pɐɾitt͡ɕʰeːd̪eːn̪ɐ
वेत्ति	ʋeːt̪t̪i
जिह्म	d͡ʑiɦmɐ
य	jɐ
धर्मन्	d̪ʱɐɾmɐ́n̪
विधि	ʋid̪ʱi
पालक	pɑːl̪ɐkɐ
सभ्य	s̪ɐbʱjɐ
दर्म	d̪ɐɾmɐ
दुर्	d̪úɾ
गच्छाम	ɡɐtt͡ɕʰɑːmɐ
काल्पनिक	kɑːl̪pɐn̪ikɐ
साळ्हृ	s̪ɑːɭ̆ɦr̩
तेजते	t̪ɐ́jd͡ʑɐt̪ɐj
विष	ʋiʂɐ́
हिम्	ɦím
नख	n̪ɐkʰɐ
हिंसितोस्	ɦiɴs̪it̪oːs̪
नाक	n̪ɑːkɐ
काजयोः	kɑːd͡ʑɐjoːh
ह्रादुनि	ɦɾɑːd̪ún̪i
उक्ति	ukt̪í
राध्य	ɾɑ́ːd̪ʱjɐ
स्वर्ष्यति	s̪ʋɐɾʂjɐt̪i
ऊधर्	uːd̪ʱɐɾ
ज्ञाति	d͡ʑɲɑːt̪i
कीट	kiːʈɐ
युवा	juʋɑː
दूळभ	d̪uːɭ̆ɐ́bʱɐ
दुवस्यु	d̪uʋɐs̪jú
शिक्षिकया	ɕikʂikɐjɑː
बद्ध	bɐd̪d̪ʱɐ
दुष्यति	d̪uʂjɐt̪i
संकल्पे	s̪ɐŋkɐl̪peː
फलनेभ्यः	pʰɐl̪ɐn̪eːbʱjɐh
राज्ञीभ्याम्	ɾɑːd͡ʑɲiːbʱjɑːm
खेद	kʰɐjd̪ɐ
सृक	s̪r̩kɐ
उक्त	ukt̪ɐ́
तनुतात्	t̪ɐn̪ut̪ɑːt̪
द्यौष्पितृ	d̪jɑwʂpit̪r̩
कोलिक	kɐwl̪ikɐ
क्षु	kʂú
योग	joːɡɐ
अर्ह्	ɐɾɦ
एतत्कालम्	ɐjt̪ɐt̪kɑːl̪ɐm
ऋघायति	r̩ɡʱɑːjɐ́t̪i
डालेभ्यस्	ɖɑːl̪ɐjbʱjɐs̪
फलनेभिः	pʰɐl̪ɐn̪eːbʱih
स्तरीमन्	s̪t̪ɐ́ɾiːmɐn̪
हसति	ɦɐs̪ɐt̪i
द्वंद्व	d̪ʋɐn̪d̪ʋɐ́
भोजन	bʱoːd͡ʑɐn̪ɐ
मद्य	mɐ́d̪jɐ
कनीन	kɐn̪iːn̪ɐ
तृणेढि	t̪r̩ɳeːɖʱi
बोभवीति	boːbʱɐʋiːt̪i
वामन	ʋɑːmɐn̪ɐ
युक्त	jukt̪ɐ
स्फ्य	s̪pʰjɐ́
तनेभ्यः	t̪ɐn̪eːbʱjɐh
तेभ्यः	t̪ɐjbʱjɐh
शिष्या	ɕiʂjɑː
ध्वनि	d̪ʱʋɐn̪í
उच्चा	utt͡ɕɑ́ː
पिपीलिका	pipiːl̪ikɑː
रथ	ɾɐt̪ʰɐ
अहरहर्	ɐɦɐɾɐɦɐɾ
शिक्य	ɕikjɐ
त्वया	t̪ʋɐjɑː
गम्यते	ɡɐmjɐt̪ɐj
वस्त्र	ʋɐs̪t̪ɾɐ
विद्या	ʋid̪jɑ́ː
खेदस्य	kʰeːd̪ɐs̪jɐ
सीव्यति	s̪iːʋjɐt̪i
तनेन	t̪ɐn̪ɐjn̪ɐ
फिङ्गक	pʰiŋɡɐkɐ
हेति	ɦeːt̪i
निम्न	n̪imn̪ɐ́
क्रीडिका	kɾiːɖikɑː
त्व	t̪ʋɐ́
युध्य	jud̪ʱjɐ́
अश्रोत्	ɐɕɾoːt̪
कुह	kúɦɐ
अर्जन	ɐɾd͡ʑɐn̪ɐ
पूत	puːt̪ɐ́
शश	ɕɐɕɐ
तनु	t̪ɐn̪ú
द्रुह्यति	d̪ɾúɦjɐt̪i
पत्त्र	pɐt̪t̪ɾɐ
शत्रून्	ɕɐt̪ɾuːn̪
संकल्पैः	s̪ɐŋkɐl̪pɑːjh
वलते	ʋɐl̪ɐt̪ɐj
भूकम्प	bʱuːkɐmpɐ
भूयध्वे	bʱuːjɐd̪ʱʋɐj
मन्या	mɐn̪jɑː
गौतम	ɡɑwt̪ɐmɐ
परिच्छेदेभिस्	pɐɾitt͡ɕʰeːd̪eːbʱis̪
दिव्	d̪iʋ
प्रउग्य	pɾɐuɡjɐ
दम्पति	d̪ɐmpɐt̪i
दुर्गन्ध	d̪uɾɡɐn̪d̪ʱɐ
रै	ɾɑ́ːj
उषःकल	uʂɐhkɐl̪ɐ
वैज्ञानिक	ʋɑjd͡ʑɲɑːn̪ikɐ
नेतृत्व	n̪eːt̪r̩t̪ʋɐ
करिपोत	kɐɾipoːt̪ɐ
स्तृनाति	s̪t̪r̩n̪ɑːt̪i
गुलेन	ɡul̪ɐjn̪ɐ
सुसज्जित	s̪us̪ɐdd͡ʑit̪ɐ
जग्मिम	d͡ʑɐɡmimɐ
सुस्वादु	s̪ús̪ʋɑːd̪u
रोदिति	ɾoːd̪it̪i
परिच्छेदैस्	pɐɾitt͡ɕʰɐjd̪ɑːjs̪
वरस्	ʋɐ́ɾɐs̪
गच्छेत्	ɡɐtt͡ɕʰeːt̪
लिखति	l̪ikʰɐ́t̪i
बोधयति	boːd̪ʱɐjɐt̪i
नाश	n̪ɑːɕɐ
उक्षन्	ukʂɐ́n̪
सुवर्णभूमि	s̪uʋɐɾɳɐbʱuːmi
देवन	d̪eːʋɐn̪ɐ
यजस्	jɐd͡ʑɐs̪
नाग	n̪ɑːɡɐ́
आखेट	ɑːkʰɐjʈɐ
विज्	ʋid͡ʑ
वहति	ʋɐ́ɦɐt̪i
प्रमेतोस्	pɾɐmeːt̪oːs̪
सदा	s̪ɐ́d̪ɑː
दानु	d̪ɑ́ːn̪u
मातृ	mɑ́ːt̪r̩
यथा	jɐ́t̪ʰɑː
पुण्डरीक	puɳɖɐɾiːkɐ
हितकार	ɦit̪ɐ́kɑːɾɐ
पेचक	pɐ́jt͡ɕɐkɐ
वेत्ति	ʋɐ́jt̪t̪i
मेधा	mɐjd̪ʱɑ́ː
पिता	pit̪ɑː
सुम्न	s̪umn̪ɐ
दिनेश	d̪in̪eːɕɐ
अवि	ɐʋi
हसति	ɦɐ́s̪ɐt̪i
चिकित्सके	t͡ɕikit̪s̪ɐkɐj
कति	kɐ́t̪i
अर्धपथे	ɐɾd̪ʱɐpɐt̪ʰeː
स्थामन्	s̪t̪ʰɑ́ːmɐn̪
प्रातःकाल	pɾɑːt̪ɐhkɑːl̪ɐ
तनेषु	t̪ɐn̪eːʂu
सेविका	s̪ɐjʋikɑː
खेल	kʰɐjl̪ɐ́
जात	d͡ʑɑːt̪ɐ́
स्मयते	s̪mɐjɐt̪eː
सतर्क	s̪ɐt̪ɐɾkɐ
रिक्त	ɾikt̪ɐ
वार्षिक	ʋɑːɾʂikɐ
लाभ	l̪ɑːbʱɐ́
शुष्यति	ɕúʂjɐt̪i
करिशावक	kɐɾiɕɑːʋɐkɐ
संकल्पासः	s̪ɐŋkɐl̪pɑːs̪ɐh
आखु	ɑːkʰu
जग्मथुर्	d͡ʑɐɡmɐt̪ʰuɾ
निर्वाण	n̪iɾʋɑːɳɐ
करिन्	kɐɾin̪
अपनह्यति	ɐpɐn̪ɐɦjɐt̪i
सूची	s̪uːt͡ɕíː
श्रद्दधाति	ɕɾɐ́d̪d̪ɐd̪ʱɑːt̪i
देवन्	d̪ɐjʋɐ́n̪
विनिमय	ʋin̪imɐjɐ
रूप	ɾuːpɐ
अवगच्छति	ɐʋɐɡɐtt͡ɕʰɐt̪i
चक्र	t͡ɕɐkɾɐ́
गूहति	ɡúːɦɐt̪i
ओष्ठ	ɐ́wʂʈʰɐ
जनुस्	d͡ʑɐn̪us̪
शयन	ɕɐjɐn̪ɐ
अंसफलक	ɐ̃s̪ɐpʰɐl̪ɐkɐ́
मृष्यति	mr̩ʂjɐt̪i
पिपर्ति	pipɐɾt̪i
तने	t̪ɐn̪eː
सुर	s̪uɾɐ
फिरङ्ग	pʰiɾɐŋɡɐ
इङ्गन	iŋɡɐn̪ɐ
बोधिसत्त्व	boːd̪ʱis̪ɐt̪t̪ʋɐ
अधिकारी	ɐd̪ʱikɑːɾiː
त्रि	t̪ɾi
चिकेति	t͡ɕíkɐjt̪i
पशु	pɐɕu
कोमल	kɐwmɐl̪ɐ
वीतभी	ʋiːt̪ɐbʱíː
ज्ञानिन्	d͡ʑɲɑːn̪in̪
तवस्य	t̪ɐʋɐs̪jɐ
त्वयि	t̪ʋɐji
त्यजस्	t̪jɐ́d͡ʑɐs̪
कटु	kɐʈú
नु	n̪ú
रूपवत्	ɾuːpɐʋɐt̪
वास	ʋɑːs̪ɐ́
अत्र	ɐt̪ɾɐ
रेणु	ɾeːɳu
सव	s̪ɐʋɐ
इद्धाग्नि	id̪d̪ʱɑ́ːɡn̪i
पायु	pɑːjú
पिशाच	piɕɑːt͡ɕɐ
तिष्ठति	t̪íʂʈʰɐt̪i
स्रव	s̪ɾɐʋɐ
शिक्षिकायाम्	ɕikʂikɑːjɑːm
हुत	ɦut̪ɐ
छदि	t͡ɕʰɐd̪i
अत्क	ɐt̪kɐ
ओषति	ɐ́wʂɐt̪i
नेदीयस्	n̪eːd̪iːjɐs̪
युग्य	juɡjɐ
काल्याम्	kɑːl̪jɑːm
नीच	n̪iːt͡ɕɐ
अभियन्तृ	ɐbʱijɐn̪t̪r̩
कदाय	kɐd̪ɑːjɐ
गमिष्यति	ɡɐmiʂjɐt̪i
श्येन	ɕjeːn̪ɐ
पादत्राणस्य	pɑːd̪ɐt̪ɾɑːɳɐs̪jɐ
श्वन्	ɕʋɐn̪
कालीन	kɑːl̪iːn̪ɐ
उब्जति	ubd͡ʑɐ́t̪i
अधर	ɐd̪ʱɐɾɐ
प्रतिबुद्ध	pɾɐ́t̪ibud̪d̪ʱɐ
घन	ɡʱɐn̪ɐ́
योगस्	jɐwɡɐs̪
सुशेव	s̪uɕɐ́jʋɐ
परिच्छेदेन	pɐɾitt͡ɕʰɐjd̪ɐjn̪ɐ
स्मरति	s̪mɐ́ɾɐt̪i
विश्व	ʋiɕʋɐ
गायन	ɡɑːjɐn̪ɐ
वेदि	ʋeːd̪i
त्वष्टृ	t̪ʋɐ́ʂʈr̩
पादत्राणैः	pɑːd̪ɐt̪ɾɑːɳɑːjh
ध्वज	d̪ʱʋɐd͡ʑɐ
तेजस्विन्	t̪eːd͡ʑɐs̪ʋin̪
वास्तु	ʋɑ́ːs̪t̪u
अपूप	ɐpuːpɐ
शवस्	ɕɐʋɐs̪
शिफैः	ɕipʰɑjh
शम्	ɕɐ́m
शोच्यते	ɕɐwt͡ɕjɐt̪ɐj
मीढ	miːɖʱɐ
अर्जनाभ्याम्	ɐɾd͡ʑɐn̪ɑːbʱjɑːm
एधते	ɐ́jd̪ʱɐt̪ɐj
गच्छेताम्	ɡɐtt͡ɕʰeːt̪ɑːm
वीरुध्	ʋiːɾúd̪ʱ
मृत	mr̩t̪ɐ
स	s̪ɐ́
दीव्	d̪íːʋ
अन	ɐn̪ɐ
राग	ɾɑːɡɐ
वि	ʋí
वृष्ट	ʋr̩ʂʈɐ́
शिक्षा	ɕikʂɑː
अप्	ɐ́p
खेदेभिः	kʰɐjd̪ɐjbʱih
पिप्पल	píppɐl̪ɐ
पद्यते	pɐ́d̪jɐt̪ɐj
नाश	n̪ɑːɕɐ́
ह्री	ɦɾiː
मश	mɐɕɐ
अपत्य	ɐ́pɐt̪jɐ
मेहति	mɐ́jɦɐt̪i
लिखति	l̪ikʰɐt̪i
नाधे	n̪ɑːd̪ʱeː
गमिष्यतः	ɡɐmiʂjɐt̪ɐh
स्वपस्	s̪ʋɐ́pɐs̪
चोदति	t͡ɕoːd̪ɐt̪i
रिणक्ति	ɾiɳɐ́kt̪i
दर्म	d̪ɐɾmɐ́
ब्राह्मण	bɾɑːɦmɐɳɐ
कृश	kr̩ɕɐ́
हीक	ɦiːkɐ
दूरभाषेभ्यः	d̪uːɾɐbʱɑːʂeːbʱjɐh
कटि	kɐʈi
पलाव	pɐl̪ɑːʋɐ
कृणोति	kr̩ɳoːt̪i
घोर	ɡʱɐwɾɐ́
रोध्र	ɾoːd̪ʱɾɐ
कृपयोः	kr̩pɐjoːh
जिह्म	d͡ʑiɦmɐ́
दारुण	d̪ɑːɾuɳɐ́
ग्रीष्म	ɡɾiːʂmɐ
शष्पिञ्जर	ɕɐʂpiɲd͡ʑɐɾɐ
पीयूषधाराकिर्	piːjuːʂɐd̪ʱɑːɾɑːkiɾ
भवामः	bʱɐʋɑːmɐh
क्षेषत्	kʂeːʂɐt̪
भिषज्	bʱiʂɐ́d͡ʑ
यति	jɐt̪i
याम	jɑ́ːmɐ
क्षिति	kʂit̪i
अपर	ɐ́pɐɾɐ
अष्टाविंशति	ɐʂʈɑ́ːʋĩɕɐt̪i
कुमार	kumɑːɾɐ
असिन्व	ɐs̪in̪ʋɐ́
हेषस्	ɦeːʂɐs̪
तूय	t̪úːjɐ
उपाध्याय	upɑːd̪ʱjɑːjɐ
यक्ष	jɐkʂɐ
प्रियदर्शिन्	pɾijɐd̪ɐɾɕin̪
यात्री	jɑːt̪ɾiː
भर	bʱɐ́ɾɐ
लुम्बति	l̪umbɐt̪i
बोधति	boːd̪ʱɐt̪i
अववर्जति	ɐʋɐʋɐɾd͡ʑɐt̪i
खेदाय	kʰɐjd̪ɑːjɐ
पिप्पल	pippɐl̪ɐ
मक्षिका	mɐ́kʂikɑː
तक्षति	t̪ɐkʂɐt̪i
गमिष्यामः	ɡɐmiʂjɑːmɐh
गीर्	ɡiːɾ
भरिष	bʱɐɾiʂɐ
मध्य	mɐ́d̪ʱjɐ
निम्बूक	n̪imbuːkɐ
पुंस्	púɴs̪
ननान्दृ	n̪ɐn̪ɑːn̪d̪r̩
राज्ञ्यौ	ɾɑːd͡ʑɲjɑːw
कुम्भ	kumbʱɐ
कर्तोस्	kɐ́ɾt̪ɐws̪
तन्वः	t̪ɐn̪ʋɐh
स्थापयामि	s̪t̪ʰɑːpɐjɑːmi
भोस्	bʱoːs̪
गच्छेः	ɡɐtt͡ɕʰɐjh
स्वपति	s̪ʋɐ́pɐt̪i
स्तेनयति	s̪t̪ɐjn̪ɐjɐt̪i
जाति	d͡ʑɑːt̪i
भग्न	bʱɐɡn̪ɐ́
सिन्व	s̪in̪ʋɐ
भक्त	bʱɐkt̪ɐ
बुक्कति	bukkɐt̪i
पर्द	pɐɾd̪ɐ
पुरोडाश	puɾɐwɖɑ́ːɕɐ
शेपस्	ɕeːpɐs̪
युवन	juʋɐn̪ɐ
नित्य	n̪ít̪jɐ
घास	ɡʱɑːs̪ɐ́
ह्वे	ɦʋɐj
ऋक्षेण	r̩kʂɐjɳɐ
रोगिन्	ɾoːɡin̪
तकु	t̪ɐ́ku
कदेषु	kɐd̪ɐjʂu
शर्मण्यदेश	ɕɐɾmɐɳjɐd̪eːɕɐ
ज्ञातुं	d͡ʑɲɑːt̪um
वशत्व	ʋɐɕɐt̪ʋɐ
भारत	bʱɑːɾɐt̪ɐ
युष्मद्	juʂmɐd̪
जाल	d͡ʑɑːl̪ɐ
मघ	mɐɡʱɐ
नक्त	n̪ɐkt̪ɐ
मर्त्य	mɐɾt̪jɐ
कथासरित्सागर	kɐt̪ʰɑːs̪ɐɾit̪s̪ɑːɡɐɾɐ
सृष्टि	s̪ŕ̩ʂʈi
रोगी	ɾoːɡiː
त्मन्	t̪mɐn̪
भवथ	bʱɐʋɐt̪ʰɐ
सन्धान	s̪ɐn̪d̪ʱɑːn̪ɐ
सूकर	s̪uːkɐɾɐ
तृन्त्ते	t̪r̩n̪t̪t̪eː
कलविङ्क	kɐl̪ɐʋíŋkɐ
क्रीणाति	kɾiːɳɑːt̪i
तृतीय	t̪r̩t̪íːjɐ
किम्पुरुष	kimpuɾuʂɐ
अस्माक	ɐs̪mɑ́ːkɐ
स्वस्तिक	s̪ʋɐ́s̪t̪ikɐ
आज्ञाकारिन्	ɑːd͡ʑɲɑːkɑːɾin̪
विचेष्टति	ʋit͡ɕɐjʂʈɐt̪i
संकल्पयोः	s̪ɐŋkɐl̪pɐjɐwh
तैलाय	t̪ɑːjl̪ɑːjɐ
अर्चा	ɐɾt͡ɕɑ́ː
प्सात	ps̪ɑːt̪ɐ
श्रिया	ɕɾijɑː
देह	d̪ɐ́jɦɐ
दर्मन्	d̪ɐɾmɐn̪
डालम्	ɖɑːl̪ɐm
भृति	bʱŕ̩t̪i
धर्म	d̪ʱɐ́ɾmɐ
हलद्दी	ɦɐl̪ɐd̪d̪iː
गर्धयते	ɡɐɾd̪ʱɐjɐt̪ɐj
अस्तित्व	ɐs̪t̪it̪ʋɐ
शिच्	ɕit͡ɕ
प्राणी	pɾɑːɳiː
त्रयस्	t̪ɾɐjɐs̪
यह्वी	jɐɦʋiː
ऐश्वर्य	ɑjɕʋɐɾjɐ
रदति	ɾɐ́d̪ɐt̪i
द्राति	d̪ɾɑːt̪i
अर्यमा	ɐɾjɐmɑ́ː
सनितुर्	s̪ɐn̪it̪uɾ
पृथिवी	pr̩t̪ʰiʋiː
स्मेर	s̪mɐ́jɾɐ
केकर	kɐjkɐɾɐ
आत्मन्	ɑːt̪mɐn̪
क्री	kɾiː
मरीयमि	mɐɾiːjɐmi
क्षिति	kʂit̪í
वारकिन्	ʋɑːɾɐkin̪
तेजते	t̪eːd͡ʑɐt̪eː
निखिल	n̪ikʰil̪ɐ
आकाङ्क्षते	ɑːkɑːŋkʂɐt̪eː
क्षत्री	kʂɐt̪ɾiː
शत	ɕɐt̪ɐ
शफर	ɕɐpʰɐɾɐ
वाति	ʋɑːt̪i
सम्पादन	s̪ɐmpɑːd̪ɐn̪ɐ
अष्टादश	ɐʂʈɑ́ːd̪ɐɕɐ
वाण	ʋɑːɳɐ
भूप	bʱuːpɐ
क्षत्र	kʂɐt̪ɾɐ́
उद्धन्ति	ud̪d̪ʱɐn̪t̪i
जुषते	d͡ʑuʂɐ́t̪ɐj
स्मर	s̪mɐɾɐ
लोपाक	l̪oːpɑːkɐ
द्वीप	d̪ʋiːpɐ
उष्ण	uʂɳɐ́
संग्रन्थन	s̪ɐŋɡɾɐn̪t̪ʰɐn̪ɐ
हिन्द्यै	ɦin̪d̪jɑːj
अमवत्	ɐmɐʋɐt̪
सखा	s̪ɐkʰɑː
प्रवाचे	pɾɐʋɑ́ːt͡ɕɐj
जासयति	d͡ʑɑːs̪ɐ́jɐt̪i
सत्यतायाः	s̪ɐt̪jɐt̪ɑːjɑːh
हिंस्र	ɦĩs̪ɾɐ
घृणोति	ɡʱr̩ɳɐ́wt̪i
मिथस्	mit̪ʰɐs̪
अर्ज्	ɐɾd͡ʑ
वाद्य	ʋɑ́ːd̪jɐ
कल्य	kɐl̪jɐ
मेह	meːɦɐ
सिद्धार्थ	s̪id̪d̪ʱɑːɾt̪ʰɐ
हंस	ɦɐ̃s̪ɐ́
प्रतिमा	pɾɐt̪imɑː
उक्थ	ukt̪ʰɐ
शुच	ɕut͡ɕɐ
तान	t̪ɑːn̪ɐ
धृष्ट	d̪ʱŕ̩ʂʈɐ
पुष्टि	púʂʈi
पौरुष	pɑwɾuʂɐ
सुख	s̪ukʰɐ́
क्लिन्द्	kl̪in̪d̪
पाप	pɑːpɐ́
शरण	ɕɐɾɐ́ɳɐ
सत्यतासु	s̪ɐt̪jɐt̪ɑːs̪u
राष्ट्र	ɾɑːʂʈɾɐ́
विद्वान्	ʋid̪ʋɑːn̪
भूभाग	bʱuːbʱɑːɡɐ
कन्दर	kɐn̪d̪ɐɾɐ
जुवस्	d͡ʑúʋɐs̪
डालात्	ɖɑːl̪ɑːt̪
उपयोगिन्	upɐjoːɡin̪
काङ्क्षति	kɑːŋkʂɐt̪i
वमति	ʋɐmɐt̪i
तीव्र	t̪iːʋɾɐ́
मयूख	mɐjuːkʰɐ
फलनेन	pʰɐl̪ɐn̪eːn̪ɐ
दधि	d̪ɐ́d̪ʱi
त्वरि	t̪ʋɐɾi
लशुन	l̪ɐɕun̪ɐ
नत	n̪ɐt̪ɐ
चिकित्सिकया	t͡ɕikit̪s̪ikɐjɑː
अस्मिन्	ɐs̪mín̪
न्यग्रोध	n̪jɐɡɾoːd̪ʱɐ
अब्जित्	ɐbd͡ʑit̪
भिषक्	bʱiʂɐ́k
आबुत्त	ɑːbut̪t̪ɐ
दूरभाषम्	d̪uːɾɐbʱɑːʂɐm
धरति	d̪ʱɐ́ɾɐt̪i
रजिष्ठ	ɾɐd͡ʑiʂʈʰɐ
स्वर्	s̪ʋɐɾ
वृष्णि	ʋr̩ʂɳí
रिष्ट	ɾiʂʈɐ́
रदति	ɾɐd̪ɐt̪i
भिक्षु	bʱikʂú
डालौ	ɖɑːl̪ɑw
धारा	d̪ʱɑːɾɑː
तनयोः	t̪ɐn̪ɐjɐwh
अन्तःपुर	ɐn̪t̪ɐhpuɾɐ
डालासस्	ɖɑːl̪ɑːs̪ɐs̪
इन	in̪ɐ́
कुत्र	kút̪ɾɐ
हरति	ɦɐ́ɾɐt̪i
डालयोस्	ɖɑːl̪ɐjɐws̪
सुवर्ण	s̪uʋɐɾɳɐ
स्पृध्	s̪pŕ̩d̪ʱ
गेह	ɡɐjɦɐ́
असृज्	ɐs̪r̩d͡ʑ
कृमि	kr̩mi
पूर्	puːɾ
वी	ʋíː
जानाति	d͡ʑɑːn̪ɑ́ːt̪i
बदर	bɐd̪ɐɾɐ
जीव	d͡ʑiːʋɐ
ताला	t̪ɑːl̪ɑː
यज्यु	jɐd͡ʑju
आम्र	ɑːmɾɐ
शुख	ɕukʰɐ
तविष	t̪ɐʋiʂɐ́
नख	n̪ɐkʰɐ́
युवाभ्याम्	juʋɑːbʱjɑːm
परिवर्तन	pɐɾiʋɐ́ɾt̪ɐn̪ɐ
सरति	s̪ɐ́ɾɐt̪i
हठयोग	ɦɐʈʰɐjoːɡɐ
साद	s̪ɑːd̪ɐ
ववर्ध	ʋɐʋɐɾd̪ʱɐ
श्लिष्यति	ɕl̪iʂjɐt̪i
अतिथि	ɐ́t̪it̪ʰi
ऋते	r̩t̪eː
पादत्राणे	pɑːd̪ɐt̪ɾɑːɳɐj
इष्	iʂ
डालस्य	ɖɑːl̪ɐs̪jɐ
हत	ɦɐt̪ɐ
ध्रुति	d̪ʱɾút̪i
बहुल	bɐɦul̪ɐ́
विश्	ʋiɕ
गच्छन्ति	ɡɐtt͡ɕʰɐn̪t̪i
प्रउग	pɾɐuɡɐ
रयिन्तम	ɾɐjín̪t̪ɐmɐ
संकल्पान्	s̪ɐŋkɐl̪pɑːn̪
क्रुद्ध	kɾud̪d̪ʱɐ́
जगम	d͡ʑɐɡɐmɐ
मत्त	mɐt̪t̪ɐ́
सीव्यति	s̪íːʋjɐt̪i
ह्वे	ɦʋeː
अति	ɐt̪i
खनित्रे	kʰɐn̪it̪ɾɐj
वस्त्र	ʋɐ́s̪t̪ɾɐ
आवाम्	ɑːʋɑːm
अग्नि	ɐɡn̪í
वीति	ʋiːt̪í
अष्ट्रा	ɐ́ʂʈɾɑː
द्विरेफ	d̪ʋiɾeːpʰɐ
अद्राक्षीत्	ɐd̪ɾɑːkʂiːt̪
त्रयस्	t̪ɾɐ́jɐs̪
चिकित्सकाभ्याम्	t͡ɕikit̪s̪ɐkɑːbʱjɑːm
इष्ट	iʂʈɐ́
सप्त	s̪ɐpt̪ɐ́
वीळु	ʋiːɭ̆ú
सूर	s̪úːɾɐ
निदाघ	n̪id̪ɑːɡʱɐ́
स्खलन	s̪kʰɐl̪ɐn̪ɐ
पौंस्य	pɑ̃́ːws̪jɐ
देवस्	d̪eːʋɐs̪
प्रपद्यते	pɾɐpɐd̪jɐt̪ɐj
पयस्	pɐ́jɐs̪
शाला	ɕɑːl̪ɑː
शिफौ	ɕipʰɑːw
ऋतूनाम्	r̩t̪uːn̪ɑ́ːm
चुकोट्ट	t͡ɕukɐwʈʈɐ
जनिमन्	d͡ʑɐ́n̪imɐn̪
स्पर्धते	s̪pɐ́ɾd̪ʱɐt̪ɐj
तिरस्	t̪iɾɐ́s̪
करिहस्त	kɐɾiɦɐs̪t̪ɐ
गण	ɡɐɳɐ
क्षु	kʂu
मूर्खतयोः	muːɾkʰɐt̪ɐjoːh
सज्जित	s̪ɐdd͡ʑit̪ɐ
पुंस्	puɴs̪
परीक्षते	pɐɾiːkʂɐt̪eː
गम्यते	ɡɐmjɐt̪eː
अरत्नि	ɐɾɐt̪n̪i
बहिर्	bɐɦiɾ
अहरहर्	ɐ́ɦɐɾɐɦɐɾ
मातुःष्वसृ	mɑːt̪uhʂʋɐs̪r̩
जनू	d͡ʑɐn̪úː
ध्वान्त	d̪ʱʋɑːn̪t̪ɐ
वृणोति	ʋr̩ɳɐ́wt̪i
तृन्त्ते	t̪ŕ̩n̪t̪t̪ɐj
दुहितृ	d̪uɦit̪r̩
करिवर	kɐɾiʋɐɾɐ
अनृक्षर	ɐn̪r̩kʂɐɾɐ́
मद्गु	mɐd̪ɡú
आग्नेय	ɑːɡn̪eːjɐ
परिषद्	pɐɾiʂɐd̪
धातु	d̪ʱɑ́ːt̪u
हेळ	ɦeːɭ̆ɐ
उच्चा	utt͡ɕɑː
अयन	ɐjɐn̪ɐ
वाष्प	ʋɑːʂpɐ́
आविस्	ɑːʋís̪
रौद्र	ɾɑwd̪ɾɐ
कन्द	kɐn̪d̪ɐ
राजावर्त	ɾɑːd͡ʑɑːʋɐɾt̪ɐ
बिभाय	bibʱɑːjɐ
फलन	pʰɐl̪ɐn̪ɐ
उद्द्योत	ud̪d̪jɐwt̪ɐ
नित्य	n̪it̪jɐ
गोधूम	ɡoːd̪ʱuːmɐ
रै	ɾɑj
श्रद्दधाति	ɕɾɐd̪d̪ɐd̪ʱɑːt̪i
खानि	kʰɑːn̪i
अवि	ɐ́ʋi
वग्नु	ʋɐɡn̪ú
दुग्ध	d̪uɡd̪ʱɐ́
भूप	bʱúːpɐ
द्रुह्यति	d̪ɾuɦjɐt̪i
जिज्ञासते	d͡ʑid͡ʑɲɑːs̪ɐt̪eː
मास	mɑ́ːs̪ɐ
शुचि	ɕut͡ɕi
श्मश्रु	ɕmɐ́ɕɾu
श्वशुर	ɕʋɐ́ɕuɾɐ
वाणि	ʋɑ́ːɳi
एड	eːɖɐ
मूर	muːɾɐ
पीयूष	piːjúːʂɐ
अज	ɐd͡ʑɐ́
अगच्छम्	ɐɡɐtt͡ɕʰɐm
पादत्राणम्	pɑːd̪ɐt̪ɾɑːɳɐm
जन्तु	d͡ʑɐn̪t̪u
बुभुक्षित	bubʱukʂit̪ɐ
स्वतन्त्र	s̪ʋɐ́t̪ɐn̪t̪ɾɐh
वस्ते	ʋɐ́s̪t̪ɐj
कृपया	kr̩pɐjɑː
ऋतु	r̩t̪u
हृदय	ɦr̩d̪ɐjɐ
गृध्र	ɡŕ̩d̪ʱɾɐ
बोधते	bɐwd̪ʱɐt̪ɐj
स्वरान्तर	s̪ʋɐɾɑːn̪t̪ɐɾɐ
मीढ्वस्	miːɖʱʋɐs̪
भोटान्त	bʱɐwʈɑːn̪t̪ɐ
द्विगु	d̪ʋiɡu
करण	kɐ́ɾɐɳɐ
इङ्गते	iŋɡɐt̪ɐj
खेदम्	kʰɐjd̪ɐm
अप्सरस्	ɐps̪ɐɾɐs̪
उष्ट्र	úʂʈɾɐ
ईषा	iːʂɑ́ː
नक्ति	n̪ɐkt̪i
अक्षत	ɐkʂɐt̪ɐ
अपत्य	ɐpɐt̪jɐ
ललाट	l̪ɐl̪ɑːʈɐ
भौम	bʱɑːwmɐ́
श्वसन	ɕʋɐs̪ɐn̪ɐ
दरीमन्	d̪ɐ́ɾiːmɐn̪
नक्	n̪ɐ́k
जेन्य	d͡ʑeːn̪jɐ
हलदी	ɦɐl̪ɐd̪iː
अस्तु	ɐs̪t̪u
अर्जनम्	ɐɾd͡ʑɐn̪ɐm
वत्स	ʋɐt̪s̪ɐ́
वपुष्टम	ʋɐ́puʂʈɐmɐ
सहवास	s̪ɐɦɐʋɑːs̪ɐ
सौचिक	s̪ɑwt͡ɕikɐ
क्रियाविशेषण	kɾijɑːʋiɕeːʂɐɳɐ
योग्य	joːɡjɐ
शाक	ɕɑːkɐ
आङ्ग्लभाषा	ɑːŋɡl̪ɐbʱɑːʂɑː
घर्षति	ɡʱɐ́ɾʂɐt̪i
चमति	t͡ɕɐ́mɐt̪i
कदेभ्यः	kɐd̪ɐjbʱjɐh
उष्ट	uʂʈɐ́
अद्ग	ɐ́d̪ɡɐ
भरु	bʱɐɾu
रजि	ɾɐ́d͡ʑi
स्रुत	s̪ɾut̪ɐ́
पलाण्डु	pɐl̪ɑːɳɖu
विशति	ʋiɕɐ́t̪i
घृण	ɡʱr̩ɳɐ
कम्प	kɐmpɐ
सत्त्व	s̪ɐt̪t̪ʋɐ́
भग	bʱɐ́ɡɐ
भरति	bʱɐ́ɾɐt̪i
नवनीत	n̪ɐʋɐn̪iːt̪ɐ
परस्मैपद	pɐɾɐs̪mɑjpɐd̪ɐ
मन्यु	mɐn̪ju
बिभाय	bibʱɑ́ːjɐ
शनि	ɕɐn̪i
गच्छाव	ɡɐtt͡ɕʰɑːʋɐ
अतल	ɐt̪ɐl̪ɐ
शुक्ल	ɕukl̪ɐ́
डाले	ɖɑːl̪eː
बृहत्	br̩ɦɐ́t̪
खेदाः	kʰɐjd̪ɑːh
गच्छेयम्	ɡɐtt͡ɕʰeːjɐm
इच्छति	itt͡ɕʰɐ́t̪i
हस्तिन्	ɦɐs̪t̪ín̪
पश्चा	pɐɕt͡ɕɑː
स्वाद	s̪ʋɑːd̪ɐ
शुष्क	ɕuʂkɐ
एलीका	ɐjl̪iːkɑː
मूढ	muːɖʱɐ
मरु	mɐɾú
गच्छ	ɡɐtt͡ɕʰɐ
तनोषि	t̪ɐn̪ɐwʂi
हदति	ɦɐd̪ɐt̪i
उद्र	ud̪ɾɐ
संसार	s̪ɐ̃s̪ɑːɾɐ
क्रीड	kɾiːɖɐ́
शास्त्रिणी	ɕɑːs̪t̪ɾiɳiː
गर्भिणी	ɡɐɾbʱiɳiː
अद्य	ɐd̪jɐ́
दर्वि	d̪ɐɾʋi
गायति	ɡɑ́ːjɐt̪i
दाम्यति	d̪ɑːmjɐt̪i
वम्र	ʋɐmɾɐ
इन्द्र	in̪d̪ɾɐ
संकल्पेषु	s̪ɐŋkɐl̪peːʂu
द्विर	d̪ʋiɾɐ
परिच्छेदानाम्	pɐɾitt͡ɕʰɐjd̪ɑːn̪ɑːm
याति	jɑːt̪i
खेदः	kʰɐjd̪ɐh
अहम्	ɐɦɐm
विन्त्ते	ʋin̪t̪t̪eː
कृत	kr̩t̪ɐ́
गन्तास्वः	ɡɐn̪t̪ɑːs̪ʋɐh
त्यजस्	t̪jɐd͡ʑɐs̪
नेनेक्ति	n̪ɐjn̪ɐjkt̪i
आराम	ɑːɾɑːmɐ́
क्रोश	kɾɐ́wɕɐ
क्रूर	kɾuːɾɐ́
संभोग	s̪ɐmbʱɐ́wɡɐ
गिरि	ɡiɾi
सङ्गणक	s̪ɐŋɡɐɳɐkɐ
गमिष्यामि	ɡɐmiʂjɑːmi
स्नात	s̪n̪ɑːt̪ɐ
मन्यते	mɐn̪jɐt̪eː
अषाळ्ह	ɐʂɑːɭ̆ɦɐ
राज्ञीभ्यः	ɾɑːd͡ʑɲiːbʱjɐh
अंश	ɐ̃́ɕɐ
ऋते	r̩t̪ɐ́j
अश्रीर	ɐɕɾiːɾɐ
दूळभ	d̪uːɭ̆ɐbʱɐ
तरति	t̪ɐɾɐt̪i
गत	ɡɐt̪ɐ́
सैनिक	s̪ɑjn̪ikɐ
स्था	s̪t̪ʰɑː
नश्यसि	n̪ɐɕjɐs̪i
तक्र	t̪ɐ́kɾɐ
यौन	jɑwn̪ɐ
घृत	ɡʱr̩t̪ɐ́
आङ्ग्ल	ɑːŋɡl̪ɐ
तनस्	t̪ɐn̪ɐs̪
नरक	n̪ɐɾɐ́kɐ
अमवत्	ɐ́mɐʋɐt̪
पिबति	pibɐt̪i
योग्य	jɐ́wɡjɐ
अविद्वस्	ɐʋid̪ʋɐs̪
संयुक्त	s̪ɐ̃jukt̪ɐ
गर्धयते	ɡɐɾd̪ʱɐjɐt̪eː
कपिशाक	kɐpiɕɑːkɐ
इष्टका	íʂʈɐkɑː
अर्जनेन	ɐɾd͡ʑɐn̪eːn̪ɐ
यव्या	jɐʋjɑː
नाथ	n̪ɑːt̪ʰɐ́
अर्जने	ɐɾd͡ʑɐn̪ɐj
पृषत्	pr̩ʂɐt̪
पर्वन्	pɐɾʋɐn̪
बिन्दु	bin̪d̪ú
बोधि	boːd̪ʱi
गम्येत	ɡɐmjeːt̪ɐ
खनित्रेषु	kʰɐn̪it̪ɾɐjʂu
युनक्ति	jun̪ɐkt̪i
अधिक	ɐd̪ʱikɐ
बलीवर्द	bɐl̪iːʋɐ́ɾd̪ɐ
भवत्	bʱɐʋɐt̪
मध्यस्थ	mɐd̪ʱjɐs̪t̪ʰɐ
सौर	s̪ɑwɾɐ
सेने	s̪ɐjn̪ɐj
अस्र	ɐs̪ɾɐ́
सामवेद	s̪ɑ́ːmɐʋɐjd̪ɐ́
त्वम्	t̪ʋɐm
बर्हयति	bɐɾɦɐ́jɐt̪i
अतिथिपति	ɐ́t̪it̪ʰipɐt̪i
हर्ष	ɦɐɾʂɐ
त्वेषस्	t̪ʋɐjʂɐ́s̪
रिपुघातिन्	ɾipúɡʱɑːt̪in̪
रुजति	ɾud͡ʑɐt̪i
बभ्रे	bɐbʱɾɐj
कण	kɐ́ɳɐ
सप्ताह	s̪ɐpt̪ɑːɦɐ
अभिनय	ɐbʱin̪ɐjɐ
शुम्भति	ɕumbʱɐt̪i
नप्तृ	n̪ɐ́pt̪r̩
गण	ɡɐɳɐ́
महत्त्व	mɐɦɐt̪t̪ʋɐ
मूत्र	múːt̪ɾɐ
अगम्यत	ɐɡɐmjɐt̪ɐ
माण्डलिक	mɑːɳɖɐl̪ikɐ
बहिस्	bɐɦis̪
पॄ	pr̩ː
द्राति	d̪ɾɑ́ːt̪i
गमिष्यन्ति	ɡɐmiʂjɐn̪t̪i
बभार	bɐbʱɑːɾɐ
स्वपिति	s̪ʋɐpit̪i
दिनेश	d̪in̪ɐjɕɐ
स्वलंकृत	s̪ʋɐl̪ɐŋkr̩t̪ɐ
नरसिंह	n̪ɐɾɐs̪ĩɦɐ
शिष्ट	ɕiʂʈɐ
ऋग्वेद	r̩ɡʋɐjd̪ɐ́
कदा	kɐd̪ɑ́ː
दम्पति	d̪ɐ́mpɐt̪i
प्रजापति	pɾɐd͡ʑɑːpɐt̪i
धनञ्जय	d̪ʱɐn̪ɐɲd͡ʑɐjɐ
ऊधस्	úːd̪ʱɐs̪
प्यै	pjɑːj
स्वरि	s̪ʋɐɾí
क्षिण्	kʂiɳ
पश्य्	pɐɕj
स्वर्यात्	s̪ʋɐɾjɑːt̪
समासेन	s̪ɐmɑːs̪ɐjn̪ɐ
खाद्	kʰɑːd̪
अङ्गुली	ɐŋɡul̪iː
परिच्छेदे	pɐɾitt͡ɕʰɐjd̪ɐj
विवेश	ʋiʋɐ́jɕɐ
धृष्णोति	d̪ʱr̩ʂɳɐ́wt̪i
तैलेन	t̪ɑjl̪eːn̪ɐ
कुख्याति	kukʰjɑːt̪i
कदानाम्	kɐd̪ɑːn̪ɑːm
देवेन	d̪ɐjʋɐjn̪ɐ
शुङ्ग	ɕuŋɡɐ
पावक	pɑːʋɐkɐ́
उषस्	uʂɐs̪
सू	s̪uː
कारवेल्ल	kɑːɾɐʋɐjl̪l̪ɐ
क्षुद्र	kʂud̪ɾɐ
भूयेथे	bʱuːjɐjt̪ʰɐj
शिफेभिः	ɕipʰeːbʱih
न	n̪ɐ
सेवि	s̪eːʋi
क्षेति	kʂɐ́jt̪i
भूर्ज	bʱuːɾd͡ʑɐ́
उत्तम	ut̪t̪ɐmɐ́
मोग्धि	mɐwɡd̪ʱi
शक	ɕɐkɐ
क्षण	kʂɐɳɐ
अपराधिन्	ɐpɐɾɑːd̪ʱin̪
ग्राम	ɡɾɑ́ːmɐ
अलाबु	ɐl̪ɑ́ːbu
कपि	kɐpi
बान्धव	bɑːn̪d̪ʱɐʋɐ
महावीर	mɐɦɑːʋiːɾɐ
डाल	ɖɑːl̪ɐ
शिक्षिकयोः	ɕikʂikɐjɐwh
वह्	ʋɐɦ
बुद्धि	búd̪d̪ʱi
रोधति	ɾɐ́wd̪ʱɐt̪i
गोपाल	ɡɐ́wpɑːl̪ɐ
कः	kɐ́h
डालेभिस्	ɖɑːl̪eːbʱis̪
क्रव्य	kɾɐʋjɐ́
सादौ	s̪ɑːd̪ɑw
दूरभाषाः	d̪uːɾɐbʱɑːʂɑːh
निस्	n̪ís̪
पञ्चविंशति	pɐɲt͡ɕɐʋĩɕɐt̪i
ईर्ष्यति	iːɾʂjɐt̪i
मूत्र	muːt̪ɾɐ
स्वल्प	s̪ʋɐl̪pɐ
अधात्	ɐ́d̪ʱɑːt̪
यह्वी	jɐɦʋíː
मनति	mɐn̪ɐt̪i
नेत्री	n̪eːt̪ɾiː
करिवैजयन्ती	kɐɾiʋɑːjd͡ʑɐjɐn̪t̪iː
शफ	ɕɐpʰɐ
प्रावृष्	pɾɑːʋr̩ʂ
शेफ	ɕɐjpʰɐ
उत्तम	ut̪t̪ɐmɐ
चक्र	t͡ɕɐkɾɐ
आयुस्	ɑːjús̪
शप्	ɕɐp
अङ्गार	ɐ́ŋɡɑːɾɐ
शिंष्वः	ɕĩʂʋɐh
तृष्यति	t̪r̩ʂjɐt̪i
दम	d̪ɐmɐ
कण्ठ्य	kɐ́ɳʈʰjɐ
गच्छेताम्	ɡɐtt͡ɕʰɐjt̪ɑːm
अङ्गुलि	ɐŋɡul̪i
ष्ठीवति	ʂʈʰiːʋɐt̪i
मोचयति	moːt͡ɕɐjɐt̪i
स्त्रीत्व	s̪t̪ɾiːt̪ʋɐ
पयोहिम	pɐjoːɦimɐ
मीढ	miːɖʱɐ́
द्रुह्वन्	d̪ɾuɦʋɐn̪
तनुताम्	t̪ɐn̪ut̪ɑːm
योक्त्र	jɐ́wkt̪ɾɐ
नो	n̪oː
तविष	t̪ɐʋiʂɐ
लूता	l̪uːt̪ɑː
इष्ट	iʂʈɐ
क्रन्दनु	kɾɐn̪d̪ɐn̪u
काण	kɑːɳɐ́
अस्वीकार	ɐs̪ʋiːkɑːɾɐ
चुकोट्ट	t͡ɕukoːʈʈɐ
अस्थि	ɐs̪t̪ʰi
शत्रोः	ɕɐt̪ɾɐwh
छल	t͡ɕʰɐl̪ɐ
ॐ	ɐwm
ऊन	uːn̪ɐ
मूर्ख	muːɾkʰɐ́
गच्छन्तु	ɡɐtt͡ɕʰɐn̪t̪u
शकटव्यूह	ɕɐkɐʈɐʋjuːɦɐ
वीडु	ʋiːɖu
म्ना	mn̪ɑː
नदीपति	n̪ɐd̪iːpɐt̪i
बिभेति	bibʱɐ́jt̪i
षण्णवति	ʂɐɳɳɐʋɐt̪i
उभौ	ubʱɑ́ːw
यज्ञ	jɐd͡ʑɲɐ́
तने	t̪ɐn̪ɐj
ऋश्य	r̩ɕjɐ
अषाढ	ɐ́ʂɑːɖʱɐ
सच	s̪ɐt͡ɕɐ
शाला	ɕɑ́ːl̪ɑː
रोपयति	ɾoːpɐjɐt̪i
व्यन्तर	ʋjɐn̪t̪ɐɾɐ
ऊर्ध्व	uːɾd̪ʱʋɐ́
जग्ध	d͡ʑɐɡd̪ʱɐ
रक्षति	ɾɐkʂɐt̪i
तनोतु	t̪ɐn̪oːt̪u
ह्रादुनि	ɦɾɑːd̪un̪i
गुड	ɡuɖɐ́
नराशंस	n̪ɐɽɑːɕɐ̃s̪ɐ
गार्ह्य	ɡɑːɾɦjɐ
तृप्त	t̪r̩pt̪ɐ
दाडिम	d̪ɑːɖimɐ
अगच्छत्	ɐ́ɡɐtt͡ɕʰɐt̪
पूर्व	puːɾʋɐ
त्याग	t̪jɑːɡɐ
गोत्र	ɡɐwt̪ɾɐ
शरु	ɕɐ́ɾu
परिच्छेदाय	pɐɾitt͡ɕʰeːd̪ɑːjɐ
मुमुचे	mumut͡ɕɐj
आरोप	ɑːɾoːpɐ
प्यै	pjɑj
उषास्	uʂɑːs̪
प्रीयते	pɾiːjɐt̪ɐj
अन्तर्	ɐn̪t̪ɐ́ɾ
भ्रातृ	bʱɾɑ́ːt̪r̩
दुक्ष	d̪ukʂɐ
काण्ड	kɑːɳɖɐ́
निद्रा	n̪id̪ɾɑ́ː
काजेषु	kɑːd͡ʑeːʂu
गान	ɡɑːn̪ɐ
राद्ध	ɾɑːd̪d̪ʱɐ́
कश्यपमेरु	kɐɕjɐpɐmɐjɾu
श्रामणेर	ɕɾɑːmɐɳɐjɾɐ
इ	i
उच्छ्वास	utt͡ɕʰʋɑːs̪ɐ
मेथिका	mɐjt̪ʰikɑː
आत्मन्	ɑːt̪mɐ́n̪
गुप्त	ɡupt̪ɐ́
शाब्दिक	ɕɑːbd̪ikɐ
खेदेषु	kʰɐjd̪ɐjʂu
गुच्छ	ɡutt͡ɕʰɐ
गोत्र	ɡoːt̪ɾɐ
शुष्यति	ɕuʂjɐt̪i
पितृ	pit̪ŕ̩
अंस	ɐ̃s̪ɐ
दारु	d̪ɑːɾú
बटु	bɐʈu
पुरस्	puɾɐ́s̪
स्पष्ट	s̪pɐʂʈɐ́
तस्थौ	t̪ɐs̪t̪ʰɑw
तत	t̪ɐt̪ɐ́
धृत्वा	d̪ʱr̩t̪ʋɑː
दृणाति	d̪r̩ɳɑ́ːt̪i
अनुक	ɐn̪ukɐ
शत्रू	ɕɐt̪ɾuː
रुक्म	ɾukmɐ
ॐ	oːm
असाधारण	ɐs̪ɑ́ːd̪ʱɑːɾɐɳɐ
सम्राज्	s̪ɐmɾɑ́ːd͡ʑ
पवयति	pɐʋɐjɐt̪i
वस्यस्	ʋɐs̪jɐs̪
मूढ	muːɖʱɐ́
प्रेत	pɾeːt̪ɐ
स्पर्धा	s̪pɐɾd̪ʱɑː
सन	s̪ɐn̪ɐ
स्रवति	s̪ɾɐ́ʋɐt̪i
रजस्	ɾɐd͡ʑɐs̪
जिघ्रति	d͡ʑiɡʱɾɐt̪i
वसा	ʋɐ́s̪ɑː
पीडा	piːɖɑː
शृङ्खल	ɕr̩ŋkʰɐl̪ɐ
विश्व	ʋíɕʋɐ
देश	d̪ɐjɕɐ́
शिक्याकृत	ɕikjɑ́ːkr̩t̪ɐ
पेचक	peːt͡ɕɐkɐ
हास	ɦɑːs̪ɐ
दूरभाषेण	d̪uːɾɐbʱɑːʂɐjɳɐ
छन्दस्	t͡ɕʰɐn̪d̪ɐs̪
संस्कृत	s̪ɐ̃s̪kr̩t̪ɐ
स्वपिति	s̪ʋɐ́pit̪i
पुरु	puɾu
शर्कर	ɕɐɾkɐɾɐ
पौष्टिक	pɑːwʂʈikɐ
वैद्युतक	ʋɑːjd̪jut̪ɐkɐ
श्वस्	ɕʋɐ́s̪
शिनष्मि	ɕin̪ɐʂmi
चिकित्सकेन	t͡ɕikit̪s̪ɐkeːn̪ɐ
पथिन्	pɐ́t̪ʰin̪
माष	mɑːʂɐ
रेक्णस्	ɾɐ́jkɳɐs̪
एताः	ɐjt̪ɑːh
जम्बुद्वीप	d͡ʑɐmbud̪ʋiːpɐ
बप्सति	bɐps̪ɐt̪i
चण	t͡ɕɐɳɐ
इषु	íʂu
ज्ञातोस्	d͡ʑɲɑːt̪oːs̪
इव	iʋɐ
श्रयति	ɕɾɐ́jɐt̪i
वैश्वानर	ʋɑjɕʋɑːn̪ɐɾɐ
मयूर	mɐjúːɾɐ
राज्ञ्योः	ɾɑːd͡ʑɲjoːh
लिह्	l̪iɦ
खेदेन	kʰɐjd̪ɐjn̪ɐ
शान्तनु	ɕɑːn̪t̪ɐn̪u
कोक	koːkɐ
त्रसति	t̪ɾɐ́s̪ɐt̪i
शोचयति	ɕoːt͡ɕɐjɐt̪i
पुष्	puʂ
लोल	l̪ɐwl̪ɐ
भान	bʱɑ́ːn̪ɐ
इदानि	id̪ɑːn̪i
भाम	bʱɑːmɐ
स्वर्ग	s̪ʋɐɾɡɐ́
मन्यते	mɐ́n̪jɐt̪ɐj
कृश	kr̩ɕɐ
अगम्ये	ɐɡɐmjɐj
त्वेषथ	t̪ʋeːʂɐt̪ʰɐ
स्मृत	s̪mr̩t̪ɐ
संवेग	s̪ɐ̃ʋɐjɡɐ
पीनस	piːn̪ɐs̪ɐ
काजेभिः	kɑːd͡ʑeːbʱih
रोध	ɾɐwd̪ʱɐ
पापतीति	pɑ́ːpɐt̪iːt̪i
नृम्ण	n̪r̩mɳɐ
मद्गु	mɐd̪ɡu
भ्रंश	bʱɾɐ̃ɕɐ́
फलनेभिः	pʰɐl̪ɐn̪ɐjbʱih
दुनोति	d̪un̪ɐ́wt̪i
संदेह	s̪ɐn̪d̪ɐjɦɐ́
नम्र	n̪ɐmɾɐ
भ्रातृ	bʱɾɑːt̪r̩
स्फिच्	s̪pʰit͡ɕ
जङ्गम	d͡ʑɐŋɡɐmɐ
वरुण	ʋɐɾuɳɐ
मम	mɐmɐ
अगन्	ɐ́ɡɐn̪
चेतस्	t͡ɕɐ́jt̪ɐs̪
वत्स	ʋɐt̪s̪ɐ
मौन	mɑːwn̪ɐ́
क्रविस्	kɾɐʋis̪
महर्द्धिक	mɐɦɐɾd̪d̪ʱikɐ
सुनीत	s̪un̪iːt̪ɐ
आसन	ɑːs̪ɐn̪ɐ
महत्	mɐɦɐ́t̪
कम्	kɐm
बिभेति	bibʱeːt̪i
सुन्दर	s̪un̪d̪ɐɾɐ
बभ्रु	bɐbʱɾú
तरुण	t̪ɐ́ɾuɳɐ
स्मत्	s̪mɐt̪
शिश्न	ɕiɕn̪ɐ́
दूरभाषाय	d̪uːɾɐbʱɑːʂɑːjɐ
बन्दिन्	bɐn̪d̪in̪
तुमुल	t̪umúl̪ɐ
आज्ञा	ɑːd͡ʑɲɑː
नगर	n̪ɐ́ɡɐɾɐ
स्कुनाति	s̪kun̪ɑ́ːt̪i
निक्त	n̪ikt̪ɐ
वष्टि	ʋɐ́ʂʈi
सम्मुख	s̪ɐmmukʰɐ́
तव्य	t̪ɐʋjɐ́
स्फुरति	s̪pʰuɾɐ́t̪i
तन्त्र	t̪ɐn̪t̪ɾɐ
विरोधालंकार	ʋiɾoːd̪ʱɑːl̪ɐŋkɑːɾɐ
काजेभिः	kɑːd͡ʑɐjbʱih
दर्शनाय	d̪ɐɾɕɐn̪ɑːjɐ
ज्वलति	d͡ʑʋɐ́l̪ɐt̪i
अर्धपथे	ɐɾd̪ʱɐ́pɐt̪ʰɐj
आयाम	ɑːjɑːmɐ
सूची	s̪uːt͡ɕiː
अधिकारिणी	ɐd̪ʱikɑːɾiɳiː
श्रद्धा	ɕɾɐd̪d̪ʱɑː
ऋजिप्य	r̩d͡ʑipjɐ́
अतिथि	ɐt̪it̪ʰi
शिफौ	ɕipʰɑw
शर्म	ɕɐɾmɐ
विनीत	ʋin̪iːt̪ɐ
होरा	ɦoːɾɑː
स्नेह	s̪n̪ɐ́jɦɐ
तोक	t̪oːkɐ
भूमन्	bʱuːmɐ́n̪
प्रौढ	pɾɑːwɖʱɐ
इष्टि	iʂʈi
कति	kɐt̪i
व्रत	ʋɾɐt̪ɐ
हिन्द्यै	ɦin̪d̪jɑj
डालाय	ɖɑːl̪ɑːjɐ
भृति	bʱr̩t̪í
तत्क्षण	t̪ɐt̪kʂɐɳɐ
रिणाति	ɾiɳɑ́ːt̪i
तिग्म	t̪iɡmɐ́
वचस्	ʋɐt͡ɕɐs̪
वम्र	ʋɐmɾɐ́
वसति	ʋɐ́s̪ɐt̪i
देश	d̪eːɕɐ
भरतु	bʱɐɾɐt̪u
वृक्षशायिका	ʋr̩kʂɐɕɑːjikɑː
गमिष्यथ	ɡɐmiʂjɐt̪ʰɐ
हिंसितोस्	ɦíɴs̪it̪ɐws̪
सत्यताभिः	s̪ɐt̪jɐt̪ɑːbʱih
तेजस्	t̪ɐ́jd͡ʑɐs̪
सूतिका	s̪uːt̪ikɑː
मज्जन्	mɐdd͡ʑɐ́n̪
खनित्रेषु	kʰɐn̪it̪ɾeːʂu
अयम्	ɐjɐm
कपाल	kɐpɑ́ːl̪ɐ
केसर	keːs̪ɐɾɐ
साढृ	s̪ɑ́ːɖʱr̩
मार	mɑːɾɐ
काजाय	kɑːd͡ʑɑːjɐ
एकविंशति	eːkɐʋĩɕɐt̪i
पांसु	pɑ̃ːs̪ú
पीडयति	piːɖɐ́jɐt̪i
सत्यताभ्यः	s̪ɐt̪jɐt̪ɑːbʱjɐh
कटु	kɐʈu
शिनष्टि	ɕin̪ɐʂʈi
अक्तु	ɐkt̪u
मलपृष्ठ	mɐl̪ɐpr̩ʂʈʰɐ
मस्तु	mɐs̪t̪u
वयुन	ʋɐjún̪ɐ
नवन्	n̪ɐʋɐn̪
एधस्	ɐ́jd̪ʱɐs̪
उच्यति	ut͡ɕjɐt̪i
अस्मिन्	ɐs̪min̪
दिह्	d̪iɦ
रण्ड	ɾɐɳɖɐ
हिक्का	ɦikkɑː
कोक	kɐ́wkɐ
ह्रादते	ɦɾɑːd̪ɐt̪eː
दिव्य	d̪iʋjɐ
औषध	ɑwʂɐd̪ʱɐ
भिक्षु	bʱikʂu
मर्मर	mɐɾmɐɾɐ
जिगाति	d͡ʑiɡɑːt̪i
शिफात्	ɕipʰɑːt̪
क्वथते	kʋɐt̪ʰɐt̪eː
कूर्च	kuːɾt͡ɕɐ
मक्षू	mɐkʂúː
गच्छतम्	ɡɐtt͡ɕʰɐt̪ɐm
खनित्राय	kʰɐn̪it̪ɾɑːjɐ
किट्	kiʈ
कदली	kɐd̪ɐl̪iː
अरित्र	ɐɾit̪ɾɐ
आसीत्	ɑːs̪iːt̪
तनू	t̪ɐn̪úː
द्वीप	d̪ʋiːpɐ́
दत्त	d̪ɐt̪t̪ɐ́
निरन्तर	n̪iɾɐ́n̪t̪ɐɾɐ
केले	keːl̪eː
आम्रेडित	ɑːmɾɐjɖit̪ɐ
श्रुति	ɕɾút̪i
रूप	ɾuːpɐ́
वाटर	ʋɑːʈɐɾɐ
पद्यते	pɐd̪jɐt̪eː
अनुनासिक	ɐn̪un̪ɑːs̪ikɐ
दूरभाषौ	d̪uːɾɐbʱɑːʂɑw
यव	jɐʋɐ
रोरवीति	ɾɐ́wɾɐʋiːt̪i
अशीति	ɐɕiːt̪í
स्वामिन्	s̪ʋɑːmín̪
अश्रि	ɐ́ɕɾi
नामन्	n̪ɑːmɐn̪
जीवित	d͡ʑiːʋit̪ɐ́
मन्दुरा	mɐn̪d̪uɾɑː
मन्	mɐn̪
काजा	kɑːd͡ʑɑː
दृष्टि	d̪ŕ̩ʂʈi
प्रातर्	pɾɑːt̪ɐ́ɾ
गम्येते	ɡɐmjɐjt̪ɐj
प्रेष्	pɾɐ́jʂ
वेद	ʋɐ́jd̪ɐ
ग्मा	ɡmɑː
शत्रुत्व	ɕɐt̪ɾut̪ʋɐ
दूर	d̪uːɾɐ́
शिखर	ɕikʰɐɾɐ
कुम्भ	kumbʱɐ́
त्वेष्य	t̪ʋeːʂjɐ
वर्चस्	ʋɐɾt͡ɕɐs̪
ज्ञा	d͡ʑɲɑː
दुहितृ	d̪úɦit̪r̩
ग्राम	ɡɾɑːmɐ
तव्य	t̪ɐʋjɐ
द्वय	d̪ʋɐjɐ
खेद	kʰeːd̪ɐ
सम्राट्	s̪ɐmɾɑ́ːʈ
क	kɐ́
एला	ɐjl̪ɑː
हाल	ɦɑːl̪ɐ
क्षुण्ण	kʂuɳɳɐ
मूर्च्छन	muːɾtt͡ɕʰɐn̪ɐ
पसस्	pɐs̪ɐs̪
आलंकारिक	ɑːl̪ɐŋkɑːɾikɐ
भवान्	bʱɐʋɑːn̪
ओकस्	oːkɐs̪
क्रुध्यति	kɾud̪ʱjɐt̪i
सर्व	s̪ɐɾʋɐ
नवनीत	n̪ɐ́ʋɐn̪iːt̪ɐ
अमरावती	ɐmɐɾɑːʋɐt̪iː
रघु	ɾɐɡʱú
दिशति	d̪iɕɐt̪i
धार्मिक	d̪ʱɑːɾmikɐ
चिकित्सिकायाम्	t͡ɕikit̪s̪ikɑːjɑːm
पुत्र	put̪ɾɐ
चिकित्सक	t͡ɕikit̪s̪ɐkɐ
वधू	ʋɐd̪ʱuː
कुह	kuɦɐ
शंस	ɕɐ̃́s̪ɐ
काव्य	kɑːʋjɐ
शुनक	ɕun̪ɐkɐh
राज्ञ्याम्	ɾɑːd͡ʑɲjɑːm
लक्ष्मणपुर	l̪ɐkʂmɐɳɐpuɾɐ
सुसंस्कृत	s̪ús̪ɐ̃s̪kr̩t̪ɐ
प्रतिबुद्ध	pɾɐt̪ibud̪d̪ʱɐ
सुश्रप	s̪uɕɾɐ́pɐ
ओषति	oːʂɐt̪i
सोढ	s̪oːɖʱɐ
शुक्र	ɕukɾɐ́
हार्द	ɦɑ́ːɾd̪ɐ
खेदे	kʰeːd̪eː
मण्डल	mɐɳɖɐl̪ɐ
उपालम्भ	upɑːl̪ɐmbʱɐ
जामातृ	d͡ʑɑ́ːmɑːt̪r̩
मरुस्थली	mɐɾus̪t̪ʰɐl̪iː
दान	d̪ɑːn̪ɐ
वीणा	ʋíːɳɑː
सिंहपुर	s̪ĩɦɐpuɾɐ
सती	s̪ɐt̪íː
काव्य	kɑːʋjɐ́
जवति	d͡ʑɐʋɐt̪i
क	kɐ
अन्न	ɐn̪n̪ɐ
मद्यसार	mɐd̪jɐs̪ɑːɾɐ
ककार	kɐkɑːɾɐ
माया	mɑːjɑː
पुरा	puɾɑː
धर्तृ	d̪ʱɐɾt̪r̩
कुब्ज	kubd͡ʑɐ́
डालेषु	ɖɑːl̪ɐjʂu
अज्र	ɐ́d͡ʑɾɐ
मगध	mɐɡɐd̪ʱɐ
सिसर्ति	s̪ís̪ɐɾt̪i
क्षत्र	kʂɐt̪ɾɐ
आर्द्र	ɑːɾd̪ɾɐ́
सरत्	s̪ɐ́ɾɐt̪
पञ्चाशत्	pɐɲt͡ɕɑːɕɐ́t̪
सोल्लुण्ठ	s̪ɐwl̪l̪uɳʈʰɐ
अनीक	ɐn̪iːkɐ
स्तुभ्नीतः	s̪t̪ubʱn̪iːt̪ɐh
तक्षशिला	t̪ɐkʂɐɕil̪ɑː
दक्षिण	d̪ɐkʂiɳɐ
अक्तु	ɐkt̪ú
क्रीडिका	kɾiːɖíkɑː
जिह्वामूलीय	d͡ʑiɦʋɑ́ːmuːl̪iːjɐ
औपस्थ्य	ɑwpɐs̪t̪ʰjɐ
शिंष्ठः	ɕĩʂʈʰɐh
दिशा	d̪iɕɑː
स्विद्यति	s̪ʋid̪jɐt̪i
पीयति	píːjɐt̪i
नश्यामि	n̪ɐɕjɑːmi
अमनस्	ɐ́mɐn̪ɐs̪
किल	kíl̪ɐ
लोपाश	l̪ɐwpɑːɕɐ́
ऋजिप्य	r̩d͡ʑipjɐ
त्रिस्	t̪ɾis̪
क्षुल्लक	kʂul̪l̪ɐkɐ́
झकार	d͡ʑʱɐkɑːɾɐ
धाव्यते	d̪ʱɑːʋjɐt̪eː
फल	pʰɐl̪ɐ
मत्त	mɐt̪t̪ɐ
असुर	ɐs̪uɾɐ
जानाति	d͡ʑɑːn̪ɑːt̪i
युध्य	jud̪ʱjɐ
दूरभाषयोः	d̪uːɾɐbʱɑːʂɐjɐwh
कृष्णायस्	kr̩ʂɳɑːjɐs̪
सीता	s̪iːt̪ɑː
दुर्मति	d̪uɾmɐt̪í
राज्य	ɾɑːd͡ʑjɐ
चरित्र	t͡ɕɐɾít̪ɾɐ
युवक	juʋɐkɐ
दिधेष्टि	d̪id̪ʱeːʂʈi
अञ्जस्	ɐ́ɲd͡ʑɐs̪
सुरक्षा	s̪uɾɐkʂɑː
दैत्य	d̪ɑjt̪jɐ
कालम्	kɑːl̪ɐm
गोष्ठ	ɡoːʂʈʰɐ
ईर्षा	iːɾʂɑː
गृभ्णाति	ɡr̩bʱɳɑ́ːt̪i
चिकित्सकेभ्यः	t͡ɕikit̪s̪ɐkɐjbʱjɐh
गविष्टि	ɡɐʋiʂʈi
खद्योत	kʰɐd̪joːt̪ɐ
स्कम्भ	s̪kɐmbʱɐ́
नलद	n̪ɐ́l̪ɐd̪ɐ
वसति	ʋɐs̪ɐt̪i
धी	d̪ʱiː
सवीमन्	s̪ɐʋiːmɐn̪
तनानि	t̪ɐn̪ɑːn̪i
नमस्ते	n̪ɐmɐs̪t̪eː
गच्छ्	ɡɐtt͡ɕʰ
गन्तारौ	ɡɐn̪t̪ɑːɾɑw
भेषज्य	bʱɐjʂɐd͡ʑjɐ́
पादप	pɑːd̪ɐpɐ
अस्मद्	ɐs̪mɐd̪
तुतोर्ति	t̪ut̪ɐwɾt̪i
जीर्यति	d͡ʑíːɾjɐt̪i
कर्तृत्व	kɐɾt̪r̩t̪ʋɐ
अमनत्	ɐmɐn̪ɐt̪
यन्त्र	jɐn̪t̪ɾɐ
माल	mɑːl̪ɐ
करिकुसुम्भ	kɐɾikus̪umbʱɐ
खेदासः	kʰɐjd̪ɑːs̪ɐh
एरका	eːɾɐkɑː
त्यजति	t̪jɐ́d͡ʑɐt̪i
श्रोमत	ɕɾoːmɐt̪ɐ
मन्तु	mɐn̪t̪u
श्रेयस्	ɕɾeːjɐs̪
चैत्र	t͡ɕɑjt̪ɾɐ
जित	d͡ʑit̪ɐ
हस्	ɦɐs̪
हठ	ɦɐʈʰɐ
ओकस्	ɐwkɐ́s̪
दत्ताम्	d̪ɐt̪t̪ɑːm
गरुड	ɡɐɾuɖɐ́
ऐश	ɑjɕɐ
सगर्भ्य	s̪ɐ́ɡɐɾbʱjɐ
नीर	n̪iːɾɐ́
तुदति	t̪ud̪ɐ́t̪i
दुद्राव	d̪ud̪ɾɑːʋɐ
गाधते	ɡɑːd̪ʱɐt̪ɐj
जरत्	d͡ʑɐ́ɾɐt̪
ववर्ध	ʋɐʋɐ́ɾd̪ʱɐ
सरस्	s̪ɐ́ɾɐs̪
अही	ɐɦiː
सादेषु	s̪ɑːd̪ɐjʂu
नारि	n̪ɑːɾi
पुष्प	puʂpɐ
क्रान्ति	kɾɑːn̪t̪i
औपस्थ्य	ɑːwpɐs̪t̪ʰjɐ
कठिन	kɐʈʰin̪ɐ
इष्टि	iʂʈí
रज्जु	ɾɐdd͡ʑu
रशना	ɾɐɕɐn̪ɑː
आकाङ्क्षते	ɑːkɑːŋkʂɐt̪ɐj
तितउ	t̪ít̪ɐu
दोह	d̪ɐwɦɐ
ओष्ठ्य	oːʂʈʰjɐ
राज्ञि	ɾɑːd͡ʑɲi
डालैस्	ɖɑːl̪ɑjs̪
अर्थ	ɐɾt̪ʰɐ
योधयति	jɐwd̪ʱɐ́jɐt̪i
दिति	d̪ít̪i
काजेषु	kɑːd͡ʑɐjʂu
नमस्ते	n̪ɐmɐs̪t̪ɐj
पक्ष्मन्	pɐ́kʂmɐn̪
हिनस्ति	ɦin̪ɐs̪t̪i
तर्कु	t̪ɐɾku
अयम्	ɐjɐ́m
भ्राता	bʱɾɑ́ːt̪ɑː
कठिनत्व	kɐʈʰin̪ɐt̪ʋɐ
श्रेयस्	ɕɾɐ́jjɐs̪
जनयति	d͡ʑɐn̪ɐ́jɐt̪i
म्लेच्छ	ml̪eːtt͡ɕʰɐ
दूरवाणी	d̪uːɾɐʋɑːɳiː
क्रीडाङ्गण	kɾiːɖɑːŋɡɐɳɐ
जाल	d͡ʑɑːl̪ɐ́
दूरभाषान्	d̪uːɾɐbʱɑːʂɑːn̪
म्लात	ml̪ɑːt̪ɐ́
अर्शस्	ɐ́ɾɕɐs̪
तर्क	t̪ɐɾkɐ
भुज	bʱud͡ʑɐ
द्यु	d̪ju
ताम्र	t̪ɑːmɾɐ
मारुक	mɑːɾukɐ
संकल्पानाम्	s̪ɐŋkɐl̪pɑːn̪ɑːm
मध्याह्न	mɐd̪ʱjɑːɦn̪ɐ
क्रीळ	kɾiːɭ̆ɐ́
रंहि	ɾɐ̃ɦi
योगिन्	jɐwɡin̪
दॄ	d̪r̩ː
परिच्छेदौ	pɐɾitt͡ɕʰeːd̪ɑw
व्यान	ʋjɑːn̪ɐ
क्रमण	kɾɐmɐɳɐ
अर्जनाय	ɐɾd͡ʑɐn̪ɑːjɐ
सुस्वूर्षति	s̪us̪ʋuːɾʂɐt̪i
आगा	ɑːɡɑː
आखु	ɑːkʰú
वृष्टि	ʋr̩ʂʈi
पृ	pr̩
क्षेत्रनाम	kʂɐjt̪ɾɐn̪ɑːmɐ
मनोगत	mɐn̪oːɡɐt̪ɐ
वर्चोधा	ʋɐɾt͡ɕoːd̪ʱɑː
कोशवती	koːɕɐʋɐt̪iː
वेलाभूमि	ʋeːl̪ɑːbʱuːmi
बज	bɐd͡ʑɐ
अमृत	ɐmr̩t̪ɐ
वपुष्या	ʋɐpuʂjɑː
हिङ्गु	ɦiŋɡú
लिम्पति	l̪impɐ́t̪i
वध्या	ʋɐ́d̪ʱjɑː
लैङ्ग	l̪ɑːjŋɡɐ
अपगम	ɐpɐɡɐmɐ
सीदति	s̪iːd̪ɐt̪i
नेम	n̪ɐ́jmɐ
शिला	ɕil̪ɑ́ː
द्रुह्वन्	d̪ɾúɦʋɐn̪
दृश्य	d̪ŕ̩ɕjɐ
संकल्पौ	s̪ɐŋkɐl̪pɑːw
शेपस्	ɕɐ́jpɐs̪
त्वेषथ	t̪ʋɐjʂɐ́t̪ʰɐ
भग	bʱɐɡɐ
दानिनी	d̪ɑːn̪in̪iː
करिदारक	kɐɾid̪ɑːɾɐkɐ
यादस्	jɑ́ːd̪ɐs̪
मुमुचे	mumut͡ɕeː
पद	pɐd̪ɐ
चिकित्सिकाभ्याम्	t͡ɕikit̪s̪ikɑːbʱjɑːm
निदाघ	n̪id̪ɑːɡʱɐ
लक्ष्मी	l̪ɐkʂmiː
ओजस्	oːd͡ʑɐs̪
चण्ड	t͡ɕɐɳɖɐ
रसगोल	ɾɐs̪ɐɡoːl̪ɐ
दारुण	d̪ɑ́ːɾuɳɐ
आखेटक	ɑːkʰeːʈɐkɐ
सरस्वती	s̪ɐ́ɾɐs̪ʋɐt̪iː
भगवत्	bʱɐɡɐʋɐt̪
बजाय	bɐd͡ʑɑːjɐ
अन्ध	ɐn̪d̪ʱɐ
शिफस्य	ɕipʰɐs̪jɐ
चक्रवर्तिन्	t͡ɕɐkɾɐʋɐɾt̪in̪
सर्ग	s̪ɐɾɡɐ
दर्वी	d̪ɐ́ɾʋiː
स्वप्न	s̪ʋɐpn̪ɐ
छत्त्र	t͡ɕʰɐt̪t̪ɾɐ
जय	d͡ʑɐjɐ
संकल्पयोः	s̪ɐŋkɐl̪pɐjoːh
दिव्य	d̪iʋjɐ́
कुब्ज	kubd͡ʑɐ
अध्वन्	ɐd̪ʱʋɐn̪
वसन्तर्तु	ʋɐs̪ɐn̪t̪ɐɾt̪u
नष्टक्रिय	n̪ɐʂʈɐkɾijɐ
तालानि	t̪ɑːl̪ɑːn̪i
अहो	ɐɦoː
यज्यु	jɐ́d͡ʑju
छेदि	t͡ɕʰɐ́jd̪i
रिशादस्	ɾiɕɑ́ːd̪ɐs̪
खान	kʰɑːn̪ɐ
सनितुर्	s̪ɐn̪it̪úɾ
वाति	ʋɑ́ːt̪i
परिच्छेदौ	pɐɾitt͡ɕʰɐjd̪ɑːw
सेवा	s̪eːʋɑː
कवक	kɐʋɐkɐ
गदा	ɡɐd̪ɑː
अहंकारिन्	ɐɦɐŋkɑːɾin̪
पादत्र	pɑːd̪ɐt̪ɾɐ
गरुड	ɡɐɾuɖɐ
सम	s̪ɐmɐ
ज्ञातुम्	d͡ʑɲɑːt̪um
खनित्रेभ्यः	kʰɐn̪it̪ɾeːbʱjɐh
बोभवीति	bɐ́wbʱɐʋiːt̪i
गन्तारः	ɡɐn̪t̪ɑːɾɐh
नक्षत्र	n̪ɐkʂɐt̪ɾɐ
खेदेषु	kʰeːd̪eːʂu
सृक	s̪r̩kɐ́
व्याकरण	ʋjɑːkɐɾɐɳɐm
वसु	ʋɐ́s̪u
अर्जुन	ɐ́ɾd͡ʑun̪ɐ
अनवपृग्ण	ɐn̪ɐʋɐpr̩ɡɳɐ
अस्थन्	ɐs̪t̪ʰɐ́n̪
वसति	ʋɐs̪ɐt̪í
राज्	ɾɑːd͡ʑ
काश्मीर	kɑːɕmiːɾɐ
अक्षय	ɐkʂɐjɐ
कुत्सयति	kut̪s̪ɐjɐt̪i
फेनक	pʰeːn̪ɐkɐ
ओष्ठ	oːʂʈʰɐ
तायु	t̪ɑːju
पताका	pɐ́t̪ɑːkɑː
स्तौति	s̪t̪ɑ́ːwt̪i
कृत्वा	kr̩t̪ʋɑː
वृष्टि	ʋŕ̩ʂʈi
तृष्णा	t̪r̩ʂɳɑː
भरत्	bʱɐ́ɾɐt̪
चिकित्सिकायै	t͡ɕikit̪s̪ikɑːjɑj
शिफान्	ɕipʰɑːn̪
वलति	ʋɐl̪ɐt̪i
खनित्रैः	kʰɐn̪it̪ɾɑːjh
वर	ʋɐɾɐ
मद्यपान	mɐd̪jɐpɑːn̪ɐ
तार्किक	t̪ɑːɾkikɐ
अर्यमन्	ɐɾjɐmɐ́n̪
जिह्वामूलीय	d͡ʑiɦʋɑːmuːl̪iːjɐ
सरति	s̪ɐɾɐt̪i
कृदन्त	kr̩d̪ɐn̪t̪ɐ
कनीनिका	kɐn̪iːn̪ikɑː
दूरभाषैः	d̪uːɾɐbʱɑːʂɑjh
विद्वस्	ʋid̪ʋɐs̪
विद्यते	ʋid̪jɐt̪eː
ओघ	ɐwɡʱɐ
बहुव्रीहि	bɐɦuʋɾiːɦi
स्तौति	s̪t̪ɑwt̪i
पृथु	pr̩t̪ʰu
मम्नौ	mɐmn̪ɑw
भग्न	bʱɐɡn̪ɐ
हि	ɦí
तैलाय	t̪ɑjl̪ɑːjɐ
अगच्छत्	ɐɡɐtt͡ɕʰɐt̪
जीवित	d͡ʑiːʋit̪ɐ
धृ	d̪ʱr̩
चिकित्सिकयोः	t͡ɕikit̪s̪ikɐjoːh
जनितोस्	d͡ʑɐ́n̪it̪ɐws̪
सुन्दरी	s̪un̪d̪ɐɾiː
एष	ɐjʂɐ
छेदि	t͡ɕʰeːd̪i
रपस्	ɾɐ́pɐs̪
तड्	t̪ɐɖ
अश्वश्चन्द्र	ɐɕʋɐɕt͡ɕɐn̪d̪ɾɐ
क्रोश	kɾoːɕɐ
गॄ	ɡr̩ː
हिरण्य	ɦiɾɐɳjɐ
जानीते	d͡ʑɑːn̪iːt̪eː
तल	t̪ɐ́l̪ɐ
धारयति	d̪ʱɑːɾɐjɐt̪i
उपसंगम्	upɐs̪ɐŋɡɐm
तुरस्पेय	t̪uɾɐs̪pɐ́jjɐ
उपचार	upɐt͡ɕɑːɾɐ
पादत्राणात्	pɑːd̪ɐt̪ɾɑːɳɑːt̪
काम्य	kɑ́ːmjɐ
होत्र	ɦoːt̪ɾɐ
उक्षन्	ukʂɐn̪
आपणम्	ɑːpɐɳɐm
अयुत	ɐjút̪ɐ
महत्	mɐɦɐt̪
स्वप्न	s̪ʋɐ́pn̪ɐ
शिफेभिः	ɕipʰɐjbʱih
नमस्कार	n̪ɐmɐs̪kɑːɾɐ
सेतु	s̪ɐ́jt̪u
जक्षत्	d͡ʑɐkʂɐt̪
यजतु	jɐd͡ʑɐt̪u
करिचर्मन्	kɐɾit͡ɕɐɾmɐn̪
अध्यापक	ɐd̪ʱjɑːpɐkɐ
रिपु	ɾipu
त्रुटि	t̪ɾuʈi
आशु	ɑːɕu
काण	kɑːɳɐ
तेषाम्	t̪ɐjʂɑːm
कद्रु	kɐd̪ɾu
ओजस्	ɐ́wd͡ʑɐs̪
मलिन	mɐl̪in̪ɐ
परिच्छेदात्	pɐɾitt͡ɕʰɐjd̪ɑːt̪
सुपर्ण	s̪upɐɾɳɐ́
अद्ग	ɐd̪ɡɐ
ज्ञान	d͡ʑɲɑ́ːn̪ɐ
फलनयोः	pʰɐl̪ɐn̪ɐjoːh
मांस	mɑ̃ːs̪ɐ́
भनक्ति	bʱɐn̪ɐkt̪i
युवाम्	juʋɑːm
ऊधर्	úːd̪ʱɐɾ
खेला	kʰeːl̪ɑː
क्रम	kɾɐmɐ
यादव	jɑːd̪ɐʋɐ
संभोग	s̪ɐmbʱoːɡɐ
मक्षू	mɐkʂuː
वर्चोदा	ʋɐɾt͡ɕoːd̪ɑː
अंहस्	ɐ̃́ɦɐs̪
क्षिति	kʂít̪i
संयुक्त	s̪ɐ̃́jukt̪ɐ
सचते	s̪ɐ́t͡ɕɐt̪ɐj
खेदाभ्याम्	kʰɐjd̪ɑːbʱjɑːm
श्लक्ष्ण	ɕl̪ɐkʂɳɐ
शंसति	ɕɐ̃́s̪ɐt̪i
भेषज्य	bʱeːʂɐd͡ʑjɐ
चिकित्सकः	t͡ɕikit̪s̪ɐkɐh
पर्शान	pɐɾɕɑːn̪ɐ
नक्ति	n̪ɐ́kt̪i
टहति	ʈɐɦɐt̪i
आधुनिक	ɑːd̪ʱun̪ikɐ
गलति	ɡɐ́l̪ɐt̪i
गृह्णाति	ɡr̩ɦɳɑ́ːt̪i
भनति	bʱɐn̪ɐt̪i
दुर्मनस्	d̪uɾmɐn̪ɐs̪
चत्वारस्	t͡ɕɐt̪ʋɑːɾɐs̪
त्वे	t̪ʋɐj
आवाभ्याम्	ɑːʋɑːbʱjɑːm
शुक्र	ɕukɾɐ
प्रमेतोस्	pɾɐmɐjt̪ɐws̪
कृष्ण	kr̩ʂɳɐ
आधिक	ɑːd̪ʱikɐ
सुऊति	s̪uuːt̪í
भ्रू	bʱɾúː
सत्	s̪ɐ́t̪
उषस्	uʂɐ́s̪
संकल्पेभिः	s̪ɐŋkɐl̪peːbʱih
करिमुख	kɐɾimukʰɐ
यव्या	jɐwĭjɑ́ː
वनस्	ʋɐn̪ɐs̪
सूर्यकान्ति	s̪úːɾjɐkɑːn̪t̪i
भू	bʱuː
शत्रुत्व	ɕɐt̪ɾut̪ʋɐ́
धर्मन्	d̪ʱɐɾmɐn̪
शास्ति	ɕɑːs̪t̪i
रजि	ɾɐd͡ʑi
द्यौस्	d̪jɑws̪
तीक्ष्णदंष्ट्रक	t̪iːkʂɳɐd̪ɐ̃ʂʈɾɐkɐ
कृपासु	kr̩pɑːs̪u
बन्धन	bɐn̪d̪ʱɐn̪ɐ
कश्यपमेरु	kɐɕjɐpɐmeːɾu
पाप	pɑːpɐ
घोष	ɡʱɐ́wʂɐ
शुच	ɕut͡ɕɐ́
मर्त्य	mɐ́ɾt̪jɐ
अथर्वन्	ɐt̪ʰɐɾʋɐn̪
शत्रुषु	ɕɐt̪ɾuʂu
नीळ	n̪iːɭ̆ɐ́
द्रप्स	d̪ɾɐps̪ɐ́
पुत्रकाम	put̪ɾɐkɑːmɐ
विट्	ʋíʈ
भवानी	bʱɐʋɑːn̪iː
युध्म	jud̪ʱmɐ́
बिन्दु	bin̪d̪u
ओषधि	ɐ́wʂɐd̪ʱi
अस्वरत्	ɐs̪ʋɐɾɐt̪
गन्ता	ɡɐn̪t̪ɑː
शिशु	ɕiɕu
गौस्	ɡɑws̪
राज्ञ्यः	ɾɑːd͡ʑɲjɐh
डालेन	ɖɑːl̪ɐjn̪ɐ
स्विद्यति	s̪ʋíd̪jɐt̪i
बिभर्ति	bibʱɐ́ɾt̪i
अंसत्र	ɐ̃s̪ɐt̪ɾɐ
अन्तःपात्र	ɐn̪t̪ɐ́ɸpɑːt̪ɾɐ́
उज्झति	udd͡ʑʱɐt̪i
वियाति	ʋijɑːt̪i
शूशुजान	ɕuːɕud͡ʑɑːn̪ɐ
सूर्य	súːɾijɐ
योगिनी	joːɡin̪iː
हरि	ɦɐ́ɾi
कन्दुक	kɐn̪d̪ukɐ
परिच्छेदे	pɐɾitt͡ɕʰeːd̪eː
नर	n̪ɐ́ɾɐ
लोह	l̪ɐwɦɐ́
अलिन्	ɐl̪in̪
पद्	pɐ́d̪
पयस्	pɐjɐs̪
वर्तनी	ʋɐɾt̪ɐn̪íː
ददाति	d̪ɐ́d̪ɑːt̪i
हेमन्	ɦeːmɐn̪
नारी	n̪ɑ́ːɾiː
नश्यथः	n̪ɐɕjɐt̪ʰɐh
नस्	n̪ɐ́s̪
अकर्	ɐkɐɾ
महाभारत	mɐɦɑːbʱɑːɾɐt̪ɐh
द्विचक्रिका	d̪ʋit͡ɕɐkɾikɑː
कृपयोः	kr̩pɐjɐwh
फलति	pʰɐl̪ɐt̪i
दोस्	d̪ɐ́ws̪
स्वपस्	s̪ʋɐpɐs̪
चष्टे	t͡ɕɐ́ʂʈɐj
प्रतीति	pɾɐt̪iːt̪i
अश्वमेध	ɐɕʋɐmɐjd̪ʱɐ́
पितामह	pit̪ɑːmɐɦɐ́
अङ्खयति	ɐŋkʰɐjɐt̪i
अनुसार	ɐn̪us̪ɑːɾɐ
सुख	s̪ukʰɐ
क्रव्य	kɾɐʋjɐ
विवेश	ʋiʋeːɕɐ
केतु	keːt̪u
मुकुट	mukuʈɐ
ईर्म	iːɾmɐ
शूर	ɕúːɾɐ
कङ्काल	kɐŋkɑːl̪ɐ
स्थामन्	s̪t̪ʰɑːmɐn̪
मण्डूक	mɐɳɖuːkɐ
बाढ	bɑːɖʱɐ
यभति	jɐbʱɐt̪i
दृढ	d̪r̩ɖʱɐ́
परिमन्यु	pɐɾimɐn̪jú
क्षीयते	kʂiːjɐt̪eː
द्रम्म	d̪ɾɐ́mmɐ
युद्ध	jud̪d̪ʱɐ́
परस्मैपद	pɐɾɐs̪mɑːjpɐd̪ɐ
कश्यप	kɐɕjɐpɐ
सम्मुख	s̪ɐmmukʰɐ
संक्रमण	s̪ɐŋkɾɐ́mɐɳɐ
कनिष्ठ	kɐn̪iʂʈʰɐ́
शृङ्ग	ɕr̩ŋɡɐ́
दृढ	d̪r̩ɖʱɐ
बुध्यते	bud̪ʱjɐt̪eː
परिच्छेदेभ्यस्	pɐɾitt͡ɕʰɐjd̪ɐjbʱjɐs̪
अशिर	ɐɕiɾɐ
बिल	bíl̪ɐ
पलित	pɐl̪it̪ɐ
वीचिस्	ʋiːt͡ɕis̪
तन्तु	t̪ɐn̪t̪u
षण्मास	ʂɐɳmɑːs̪ɐ
वज्र	ʋɐd͡ʑɾɐ
हेळ	ɦɐ́jɭ̆ɐ
भूयन्ते	bʱuːjɐn̪t̪eː
दंष्ट्र	d̪ɐ̃ʂʈɾɐ
स्तरी	s̪t̪ɐɾíː
सित	s̪it̪ɐ́
गुलेभिः	ɡul̪eːbʱih
त्वाम्	t̪ʋɑːm
त्रिंशत्	t̪ɾĩɕɐ́t̪
इष्टका	iʂʈɐkɑː
क्षेति	kʂeːt̪i
शेष	ɕɐjʂɐ
प्रतिश्याय	pɾɐt̪iɕjɑːjɐ
सादैः	s̪ɑːd̪ɑːjh
हर्षति	ɦɐɾʂɐt̪i
मरीयमिपुत्र	mɐɾiːjɐmiput̪ɾɐ
अशनि	ɐ́ɕɐn̪i
नृ	n̪ŕ̩
बर्जह	bɐ́ɾd͡ʑɐɦɐ
एकादश	ɐ́jkɑːd̪ɐɕɐ
वक्ति	ʋɐ́kt̪i
गुद	ɡud̪ɐ́
पतति	pɐ́t̪ɐt̪i
जीवन	d͡ʑiːʋɐn̪ɐ
प्रेषण	pɾeːʂɐɳɐ
अगच्छे	ɐɡɐtt͡ɕʰeː
दुर्ग	d̪uɾɡɐ
श्रीणीतः	ɕɾiːɳiːt̪ɐh
वायु	ʋɑːjú
सप्तदश	s̪ɐpt̪ɐd̪ɐɕɐ
कृष्णा	kr̩ʂɳɑː
अज्र	ɐd͡ʑɾɐ
एतद्	eːt̪ɐd̪
प्रवस्ते	pɾɐʋɐs̪t̪eː
राज्ञ्यै	ɾɑːd͡ʑɲjɑːj
नाम	n̪ɑːmɐ
मति	mɐt̪i
चिकित्सकेभ्यः	t͡ɕikit̪s̪ɐkeːbʱjɐh
उल्ब	úl̪bɐ
भार	bʱɑːɾɐ
काजेभ्यः	kɑːd͡ʑeːbʱjɐh
मर्त	mɐɾt̪ɐ
अङ्कस्	ɐ́ŋkɐs̪
भूमन्	bʱúːmɐn̪
गुलौ	ɡul̪ɑːw
संन्यासिन्	s̪ɐ̃n̪jɑːs̪in̪
चोर	t͡ɕɐwɾɐ́
वर्णयति	ʋɐɾɳɐjɐt̪i
वोळ्हृ	ʋɐwɭ̆ɦŕ̩
सुश्रवस्	s̪uɕɾɐ́ʋɐs̪
कुमार	kumɑːɾɐ́
वस्ते	ʋɐs̪t̪eː
तृण्	t̪r̩ɳ
तक्र	t̪ɐkɾɐ
ववर्त	ʋɐʋɐɾt̪ɐ
तृप्ति	t̪r̩pt̪i
श्वश्रू	ɕʋɐɕɾúː
सङ्ख्या	s̪ɐŋkʰjɑː
मूष्	múːʂ
ग्रामचर्या	ɡɾɑ́ːmɐt͡ɕɐɾjɑː
आवश्यक	ɑːʋɐɕjɐkɐ
कथम्	kɐt̪ʰɐ́m
हिक्किन्	ɦikkin̪
जीवति	d͡ʑíːʋɐt̪i
स्तभ्नीतः	s̪t̪ɐbʱn̪iːt̪ɐh
गाधे	ɡɑːd̪ʱɐj
प्रवते	pɾɐʋɐt̪eː
मया	mɐjɑː
मुच्	mut͡ɕ
पवमान	pɐʋɐmɑːn̪ɐ
तैल	t̪ɑːjl̪ɐ́
इच्छति	itt͡ɕʰɐt̪i
स्फलति	s̪pʰɐl̪ɐ́t̪i
बभस्ति	bɐ́bʱɐs̪t̪i
विदा	ʋid̪ɑː
गन्तारौ	ɡɐn̪t̪ɑːɾɑːw
तनयोः	t̪ɐn̪ɐjoːh
गुलेभिः	ɡul̪ɐjbʱih
समा	s̪ɐmɑː
खनित्र	kʰɐn̪it̪ɾɐ
कृपाः	kr̩pɑːh
अनृक्षर	ɐn̪r̩kʂɐɾɐ
अर्जनात्	ɐɾd͡ʑɐn̪ɑːt̪
श्रामणेर	ɕɾɑːmɐɳeːɾɐ
ददाति	d̪ɐd̪ɑːt̪i
नवदश	n̪ɐʋɐd̪ɐɕɐ
बुन्द	bun̪d̪ɐ
दधि	d̪ɐd̪ʱi
देवनागरी	d̪eːʋɐn̪ɑːɡɐɾiː
शत्रु	ɕɐ́t̪ɾu
उषास्	uʂɑ́ːs̪
वृत्रहन्	ʋr̩t̪ɾɐɦɐ́n̪
वृक	ʋr̩kɐ
शिफे	ɕipʰeː
वृकी	ʋr̩kiː
करवस्त्र	kɐɾɐʋɐs̪t̪ɾɐ
तनोमि	t̪ɐn̪oːmi
अनुक	ɐ́n̪ukɐ
रात्रि	ɾɑ́ːt̪ɾi
जूर्ण	d͡ʑuːɾɳɐ
नेनेक्ति	n̪eːn̪eːkt̪i
अविद्वस्	ɐ́ʋid̪ʋɐs̪
वपुष्टम	ʋɐpuʂʈɐmɐ
अस्वार्षीत्	ɐs̪ʋɑːɾʂiːt̪
जुघुक्षति	d͡ʑuɡʱukʂɐt̪i
रयिन्तम	ɾɐjin̪t̪ɐmɐ
सवीमन्	s̪ɐ́ʋiːmɐn̪
ऋक्ष	r̩kʂɐ
वक्तोस्	ʋɐkt̪oːs̪
वर्चस्	ʋɐ́ɾt͡ɕɐs̪
वक्तोस्	ʋɐ́kt̪ɐws̪
शिफाय	ɕipʰɑːjɐ
भिनत्ति	bʱin̪ɐ́t̪t̪i
एकादशी	ɐjkɑːd̪ɐɕiː
नेदिष्ठ	n̪eːd̪iʂʈʰɐ
गज	ɡɐd͡ʑɐ
करिष्यति	kɐɾiʂjɐ́t̪i
धाव्यते	d̪ʱɑːʋjɐt̪ɐj
क्रन्दनु	kɾɐn̪d̪ɐn̪ú
खादति	kʰɑ́ːd̪ɐt̪i
आरा	ɑːɾɑː
मकक	mɐkɐkɐ
स्मेर	s̪meːɾɐ
दशति	d̪ɐ́ɕɐt̪i
कथयति	kɐt̪ʰɐjɐt̪i
चिकित्सिके	t͡ɕikit̪s̪ikeː
समकार	s̪ɐmɐkɑːɾɐ
हिन्द्यास्	ɦin̪d̪jɑːs̪
द्वादश	d̪ʋɑ́ːd̪ɐɕɐ
कुशलेन	kuɕɐl̪eːn̪ɐ
जङ्घा	d͡ʑɐ́ŋɡʱɑː
सोम	s̪oːmɐ
विश्पति	ʋiɕpɐt̪i
करिकुम्भ	kɐɾikumbʱɐ
त्वेष	t̪ʋeːʂɐ
अपर	ɐpɐɾɐ
दूर्वा	d̪úːɾʋɑː
जव	d͡ʑɐʋɐ
धरति	d̪ʱɐɾɐt̪i
समस्	s̪ɐmɐs̪
स्वरेत्	s̪ʋɐɾeːt̪
वर्षति	ʋɐɾʂɐt̪i
कठिनपृष्ठक	kɐʈʰin̪ɐpr̩ʂʈʰɐkɐ
मयि	mɐji
गूढ	ɡuːɖʱɐ́
गन्तास्मि	ɡɐn̪t̪ɑːs̪mi
ततः	t̪ɐt̪ɐh
पुल	pul̪ɐ
ईषा	iːʂɑː
तीव्र	t̪iːʋɾɐ
काम्य	kɑːmjɐ
एलीका	eːl̪iːkɑː
वृक्ष	ʋr̩kʂɐ
मिह्	miɦ
काम्बोज	kɑːmbɐwd͡ʑɐ
अङ्गुष्ठ	ɐŋɡúʂʈʰɐ
जायते	d͡ʑɑ́ːjɐt̪ɐj
ऋतप्सु	r̩t̪ɐps̪u
गच्छेम	ɡɐtt͡ɕʰeːmɐ
अविक	ɐʋikɐ
राजन	ɾɑːd͡ʑɐn̪ɐ
कूट	kúːʈɐ
भूमि	bʱúːmi
कश्यप	kɐɕjɐ́pɐ
द्वार्	d̪ʋɑːɾ
वनस्	ʋɐ́n̪ɐs̪
वेद्या	ʋɐjd̪jɑ́ː
भविष्यामि	bʱɐʋiʂjɑːmi
असंकॢप्त	ɐs̪ɐŋkl̩pt̪ɐ
क्षित	kʂit̪ɐ́
हस्त	ɦɐs̪t̪ɐ
राजति	ɾɑ́ːd͡ʑɐt̪i
सादैः	s̪ɑːd̪ɑjh
द्वार्	d̪ʋɑ́ːɾ
खेदेभ्यः	kʰɐjd̪ɐjbʱjɐh
शिक्षिके	ɕikʂikɐj
अक	ɐ́kɐ
सामन्	s̪ɑ́ːmɐn̪
अस्माक	ɐs̪mɑːkɐ
चन्द्र	t͡ɕɐn̪d̪ɾɐ́
यकृत्	jɐkr̩t̪
द्रापि	d̪ɾɑːpi
भुग्न	bʱuɡn̪ɐ
कः	kɐh
राजमाष	ɾɑːd͡ʑɐmɑːʂɐ
निद्	n̪id̪
भोग्य	bʱɐwɡjɐ́
स्फिज्	s̪pʰid͡ʑ
कोटर	koːʈɐɾɐ
यहु	jɐɦu
सेना	s̪ɐ́jn̪ɑː
चरु	t͡ɕɐɾú
शत्रु	ɕɐt̪ɾu
काजयोः	kɑːd͡ʑɐjɐwh
पृष्ट	pr̩ʂʈɐ
वातिङ्गण	ʋɑːt̪iŋɡɐɳɐ
बकार	bɐkɑːɾɐ
सरोज	s̪ɐɾoːd͡ʑɐ
सायं	s̪ɑːjɐm
कण	kɐɳɐ
विशेषज्ञ	ʋiɕɐjʂɐd͡ʑɲɐ
वर्तते	ʋɐɾt̪ɐt̪eː
जल	d͡ʑɐl̪ɐ́
अनन्य	ɐn̪ɐn̪jɐ
परिच्छिद्	pɐɾitt͡ɕʰid̪
अलाबु	ɐl̪ɑːbu
द्रुपद	d̪ɾupɐd̪ɐ
कनिष्ठ	kɐn̪iʂʈʰɐ
चिकित्सिकायै	t͡ɕikit̪s̪ikɑːjɑːj
दन्त	d̪ɐn̪t̪ɐ
दर्शन	d̪ɐɾɕɐn̪ɐ
शिक्षिकायाः	ɕikʂikɑːjɑːh
चिकित्सिकाभिः	t͡ɕikit̪s̪ikɑːbʱih
औषध	ɑːwʂɐd̪ʱɐ́
ग्रभ्	ɡɾɐbʱ
सप्तति	s̪ɐpt̪ɐt̪í
द्व	d̪ʋɐ́
गोस्वामिन्	ɡɐws̪ʋɑːmin̪
हिक्क्	ɦikk
यात	jɑːt̪ɐ
रीति	ɾiːt̪i
गूळ्ह	ɡuːɭ̆ɦɐ
नव	n̪ɐʋɐ
शिक्षिकाम्	ɕikʂikɑːm
मज्जति	mɐdd͡ʑɐt̪i
लोक	l̪oːkɐ
अकर्त्स्यत्	ɐkɐɾt̪s̪jɐt̪
पूजा	puːd͡ʑɑ́ː
आदिम	ɑːd̪imɐ
द्यु	d̪jú
भजते	bʱɐ́d͡ʑɐt̪ɐj
दुनोति	d̪un̪oːt̪i
नवविंशति	n̪ɐʋɐʋĩɕɐt̪i
अभिष्टिद्युम्न	ɐbʱiʂʈid̪jumn̪ɐ
फेनक	pʰɐjn̪ɐkɐ
बाहु	bɑːɦú
बहु	bɐɦu
इदम्	id̪ɐm
विधवा	ʋid̪ʱɐ́ʋɑː
भा	bʱɑ́ː
मन्त्रिणी	mɐn̪t̪ɾiɳiː
श्लिष्यसि	ɕl̪iʂjɐs̪i
व्रीडति	ʋɾiːɖɐt̪i
विद्यादेवी	ʋid̪jɑːd̪eːʋiː
क्लिन्दताम्	kl̪in̪d̪ɐt̪ɑːm
यशस्	jɐɕɐs̪
क्रिया	kɾijɑ́ː
पट्टिका	pɐʈʈikɑː
आति	ɑːt̪í
शयनागार	ɕɐjɐn̪ɑːɡɑːɾɐ
स्वेदन	s̪ʋeːd̪ɐn̪ɐ
रिणाति	ɾiɳɑːt̪i
भविष्य	bʱɐʋiʂjɐ
अगरु	ɐɡɐɾu
खनित्राणि	kʰɐn̪it̪ɾɑːɳi
धृत	d̪ʱr̩t̪ɐ
शेष	ɕeːʂɐ
सुशोक	s̪uɕoːkɐ
स्वर्दताम्	s̪ʋɐɾd̪ɐt̪ɑːm
मयस्	mɐjɐs̪
कुशल	kúɕɐl̪ɐ
जुहोति	d͡ʑuɦɐ́wt̪i
सूद	s̪uːd̪ɐ
जवस्	d͡ʑɐ́ʋɐs̪
यावन्	jɑ́ːʋɐn̪
लेढि	l̪ɐ́jɖʱi
अनूक	ɐ́n̪uːkɐ
पराशर	pɐɾɑːɕɐɾɐ
घृण्	ɡʱr̩ɳ
ओषधि	oːʂɐd̪ʱi
संध्या	s̪ɐn̪d̪ʱjɑ́ː
प्रतिरोध	pɾɐt̪iɾɐwd̪ʱɐ
परिस्तोम	pɐɾis̪t̪oːmɐ
वैकुण्ठ	ʋɑːjkuɳʈʰɐ́
एधते	eːd̪ʱɐt̪eː
डालाभ्याम्	ɖɑːl̪ɑːbʱjɑːm
इद्धाग्नि	id̪d̪ʱɑːɡn̪i
आलाक्त	ɑ́ːl̪ɑːkt̪ɐ
वपा	ʋɐpɑ́ː
यकार	jɐkɑːɾɐ
वपुष	ʋɐ́puʂɐ
शुप्ति	ɕupt̪i
गन्धर्व	ɡɐn̪d̪ʱɐɾʋɐ́
शक्ति	ɕɐkt̪í
रेतस्	ɾeːt̪ɐs̪
भैषज्य	bʱɑjʂɐd͡ʑjɐ
सनोति	s̪ɐn̪ɐ́wt̪i
खेदम्	kʰeːd̪ɐm
मुक्त	mukt̪ɐ
शैव	ɕɑjʋɐ
तन्	t̪ɐn̪
नक्षत्र	n̪ɐ́kʂɐt̪ɾɐ
गोग्रह	ɡɐwɡɾɐɦɐ
उपनेत्र	upɐn̪eːt̪ɾɐ
उपयोगिनी	upɐjɐwɡin̪iː
मरकत	mɐɾɐkɐt̪ɐ
तनस्	t̪ɐ́n̪ɐs̪
अगच्छाम	ɐɡɐtt͡ɕʰɑːmɐ
चष्टे	t͡ɕɐʂʈeː
देवनागरी	d̪ɐjʋɐ́n̪ɑːɡɐɾiː
गुह्	ɡuɦ
कपिला	kɐpil̪ɑː
शत्रोः	ɕɐt̪ɾoːh
बधिर	bɐd̪ʱiɾɐ
ओकार	ɐwkɑːɾɐ
संनिर्गच्छति	s̪ɐ̃n̪iɾɡɐtt͡ɕʰɐt̪i
सूतिकागृह	s̪úːt̪ikɑːɡr̩ɦɐ
रक्षोहन्	ɾɐkʂoːɦɐn̪
उष्	úʂ
सास्वर्ति	s̪ɑːs̪ʋɐɾt̪i
भिण्डा	bʱiɳɖɑː
गोग्रह	ɡoːɡɾɐɦɐ
कृमि	kŕ̩mi
धानेयक	d̪ʱɑːn̪eːjɐkɐ
तिन्दिश	t̪in̪d̪iɕɐ
जुवस्	d͡ʑuʋɐs̪
ते	t̪ɐj
दुर्गा	d̪uɾɡɑː
मद्	mɐd̪
खनित्राभ्याम्	kʰɐn̪it̪ɾɑːbʱjɑːm
अगच्छतम्	ɐɡɐtt͡ɕʰɐt̪ɐm
सपत्नी	s̪ɐpɐt̪n̪iː
रसा	ɾɐs̪ɑ́ː
सोल्लुण्ठ	s̪oːl̪l̪uɳʈʰɐ
उन्नम्	un̪n̪ɐm
ऊति	uːt̪í
भूषण	bʱuːʂɐ́ɳɐ
भिन्न	bʱin̪n̪ɐ
ध्रजति	d̪ʱɾɐ́d͡ʑɐt̪i
हीन	ɦiːn̪ɐ́
भेद	bʱeːd̪ɐ
दुर्मति	d̪uɾmɐt̪i
तृढ	t̪r̩ɖʱɐ
बाधति	bɑːd̪ʱɐt̪i
जानि	d͡ʑɑ́ːn̪i
अन्धस्	ɐ́n̪d̪ʱɐs̪
योधयति	joːd̪ʱɐjɐt̪i
मम्नौ	mɐmn̪ɑːw
संज्ञा	s̪ɐɲd͡ʑɲɑː
जहका	d͡ʑɐ́ɦɐkɑː
चम्	t͡ɕɐm
प्रहेलिका	pɾɐɦeːl̪ikɑː
लाभ	l̪ɑːbʱɐ
रुद्ध	ɾud̪d̪ʱɐ
शिफाः	ɕipʰɑːh
सुशेवस्	s̪uɕɐ́jʋɐs̪
द्रम्म	d̪ɾɐmmɐ
खेदेन	kʰeːd̪eːn̪ɐ
लाञ्छित	l̪ɑːɲt͡ɕʰit̪ɐ
हन्ति	ɦɐ́n̪t̪i
नील	n̪iːl̪ɐ
क्वथित	kʋɐt̪ʰit̪ɐ
खनित्रस्य	kʰɐn̪it̪ɾɐs̪jɐ
श्मश्रु	ɕmɐɕɾu
सादाभ्याम्	s̪ɑːd̪ɑːbʱjɑːm
ओजोदा	ɐwd͡ʑɐwd̪ɑ́ː
चतुर्विंशति	t͡ɕɐ́t̪uɾʋĩɕɐt̪i
वस्यस्	ʋɐ́s̪jɐs̪
विशेषज्ञ	ʋiɕeːʂɐd͡ʑɲɐ
भार्मन्	bʱɑːɾmɐn̪
दैव	d̪ɑːjʋɐ́
योनी	jɐwn̪iː
अर्ध	ɐɾd̪ʱɐ
निष्कारणम्	n̪iʂkɑːɾɐɳɐm
लेखनी	l̪ɐjkʰɐn̪iː
रिपुघ्न	ɾipuɡʱn̪ɐ
अर्हित	ɐɾɦit̪ɐ
तूष्णीम्	t̪uːʂɳíːm
पक्ष्मन्	pɐkʂmɐn̪
रणति	ɾɐɳɐt̪i
उच्छिन्न	utt͡ɕʰin̪n̪ɐ
काजम्	kɑːd͡ʑɐm
भाति	bʱɑ́ːt̪i
पर्शु	pɐɾɕu
संदेह	s̪ɐn̪d̪eːɦɐ
कृपाभिः	kr̩pɑːbʱih
अन्तर	ɐn̪t̪ɐɾɐ
प्यायन	pjɑːjɐn̪ɐ
त्वेषरथ	t̪ʋɐjʂɐ́ɾɐt̪ʰɐ
उत्तराधिकारिन्	ut̪t̪ɐɾɑːd̪ʱikɑːɾin̪
विसर्ग	ʋis̪ɐɾɡɐ
गर्भ	ɡɐ́ɾbʱɐ
व्यर्थ	ʋjɐɾt̪ʰɐ
शब्द	ɕɐbd̪ɐ
स्तेय	s̪t̪eːjɐ
रिपु	ɾipú
रायति	ɾɑ́ːjɐt̪i
गच्छत	ɡɐtt͡ɕʰɐt̪ɐ
कलिका	kɐl̪ikɑː
अहर्	ɐ́ɦɐɾ
मुख	mukʰɐ
पितृव्य	pit̪r̩ʋjɐ́
मियेध	mijeːd̪ʱɐ
स्वरि	s̪ʋɐɾi
असनोत्	ɐs̪ɐn̪ɐwt̪
स्वर्ग्य	s̪ʋɐɾɡjɐ
गच्छानि	ɡɐtt͡ɕʰɑːn̪i
शॄ	ɕr̩ː
काच	kɑːt͡ɕɐ́
उष्	uʂ
किरण	kiɾɐɳɐ
सर्म	s̪ɐ́ɾmɐ
मीळ्हुष्टम	miːɭ̆ʱúʂʈɐmɐ
स्पन्दताम्	s̪pɐn̪d̪ɐt̪ɑːm
भजति	bʱɐd͡ʑɐt̪i
बहुव्रीहि	bɐɦúʋɾiːɦi
अरणि	ɐɾɐɳi
सव	s̪ɐʋɐ́
चिकित्सकाय	t͡ɕikit̪s̪ɐkɑːjɐ
साढ	s̪ɑːɖʱɐ́
स्रेधति	s̪ɾeːd̪ʱɐt̪i
नन्दिनी	n̪ɐn̪d̪in̪iː
माम्	mɑːm
त्सारिन्	t̪s̪ɑːɾin̪
निन्दति	n̪in̪d̪ɐt̪i
पश्यति	pɐ́ɕjɐt̪i
बल	bɐl̪ɐ
फकार	pʰɐkɑːɾɐ
करदीप	kɐɾɐd̪iːpɐ
पर्शान	pɐ́ɾɕɑːn̪ɐ
क्षीण	kʂiːɳɐ
बधिर	bɐd̪ʱiɾɐ́
पृथुक	pr̩t̪ʰukɐ
द्रोण	d̪ɾɐ́wɳɐ
शाकपुष्प	ɕɑːkɐpuʂpɐ
सकार	s̪ɐkɑːɾɐ
जिहर्ति	d͡ʑíɦɐɾt̪i
स्वादु	s̪ʋɑːd̪u
सत्यताः	s̪ɐt̪jɐt̪ɑːh
हृद्	ɦr̩d̪
ऋच्	r̩t͡ɕ
पुरोडाश	puɾoːɖɑːɕɐ
लाञ्छन	l̪ɑːɲt͡ɕʰɐn̪ɐ
शोचति	ɕoːt͡ɕɐt̪i
वोळ्हृ	ʋoːɭ̆ɦr̩
वस्ति	ʋɐs̪t̪i
अंहस्	ɐ̃ɦɐs̪
वन	ʋɐn̪ɐ
हिरण	ɦiɾɐɳɐ
जनी	d͡ʑɐ́n̪iː
स्थावर	s̪t̪ʰɑːʋɐɾɐ
बहु	bɐɦú
चित्र	t͡ɕit̪ɾɐ́
षड्विंशति	ʂɐɖʋĩɕɐt̪i
शत्र्वा	ɕɐt̪ɾʋɑː
क्षत्रिय	kʂɐt̪ɾijɐ
स्फ्य	s̪pʰjɐ
जनुस्	d͡ʑɐn̪ús̪
कर्कटिका	kɐɾkɐʈikɑː
अकन्या	ɐkɐn̪jɑː
योस्	joːs̪
खिद्	kʰid̪
काण्ड	kɑːɳɖɐ
देवी	d̪ɐjʋíː
पास्यति	pɑːs̪jɐt̪i
नभ्य	n̪ɐ́bʱjɐ
ताष्टि	t̪ɑːʂʈi
अभ्यङ्ग	ɐbʱjɐŋɡɐ
होला	ɦɐwl̪ɑː
भुनक्ति	bʱun̪ɐkt̪i
बहुता	bɐɦút̪ɑː
खद्योतस्	kʰɐ́d̪jɐwt̪ɐs̪
गच्छेतम्	ɡɐtt͡ɕʰeːt̪ɐm
एते	ɐjt̪ɐj
अश्वा	ɐ́ɕʋɑː
भारिक	bʱɑːɾikɐ
अर्जने	ɐɾd͡ʑɐn̪eː
राद्ध	ɾɑːd̪d̪ʱɐ
आधान	ɑːd̪ʱɑːn̪ɐ
मुग्ध	muɡd̪ʱɐ
रन्ध्र	ɾɐ́n̪d̪ʱɾɐ
शूर	ɕuːɾɐ
मनु	mɐn̪u
काजानाम्	kɑːd͡ʑɑːn̪ɑːm
तनुवः	t̪ɐn̪uʋɐh
गमन	ɡɐmɐn̪ɐ
वातावरण	ʋɑːt̪ɑːʋɐɾɐɳɐ
नि	n̪i
उत्तर	ut̪t̪ɐɾɐ
विश्	ʋíɕ
षोळशन्	ʂoːɭ̆ɐɕɐn̪
प्रथस्	pɾɐ́t̪ʰɐs̪
मालिनी	mɑːl̪in̪iː
तनेभिः	t̪ɐn̪ɐjbʱih
मारण	mɑ́ːɾɐɳɐ
रन्धयति	ɾɐn̪d̪ʱɐ́jɐt̪i
अधुना	ɐd̪ʱun̪ɑ́ː
संस्कृत	s̪ɐ̃s̪kr̩t̪ɐ́
एतोस्	eːt̪oːs̪
तक्व	t̪ɐkʋɐ
पठन	pɐʈʰɐn̪ɐ
वित्त	ʋit̪t̪ɐ́
पावक	pɑːʋɐkɐ
नति	n̪ɐt̪i
यभ्	jɐbʱ
बालकेलि	bɑːl̪ɐkeːl̪i
लेढा	l̪eːɖʱɑː
दूरत्व	d̪uːɾɐt̪ʋɐ
भी	bʱiː
एतवे	ɐ́jt̪ɐʋɐj
कोप	kɐ́wpɐ
मूक	muːkɐ́
कृपे	kr̩peː
त्वेष	t̪ʋɐjʂɐ́
महात्मन्	mɐɦɑːt̪mɐ́n̪
दण्ड	d̪ɐɳɖɐ́
क्षय	kʂɐjɐ́
करोति	kɐɾɐ́wt̪i
वदन	ʋɐd̪ɐn̪ɐ
अणु	ɐɳu
ओजिष्ठ	oːd͡ʑiʂʈʰɐ
आलाक्त	ɑːl̪ɑːkt̪ɐ
सैनिक	s̪ɑːjn̪ikɐ
ज्रयस्	d͡ʑɾɐjɐs̪
हिक्वा	ɦikʋɑː
वरुण	ʋɐ́ɾuɳɐ
जन्य	d͡ʑɐn̪jɐ
सायंकाल	s̪ɑːjɐŋkɑːl̪ɐ
जठर	d͡ʑɐʈʰɐɾɐ
अज	ɐd͡ʑɐ
ऊम	úːmɐ
उत	ut̪ɐ́
तन्त्र	t̪ɐ́n̪t̪ɾɐ
निष्कारण	n̪iʂkɑːɾɐɳɐ
इदानीम्	id̪ɑ́ːn̪iːm
ईर्ष्यु	iːɾʂju
विशेषण	ʋiɕɐjʂɐɳɐ
आस्ते	ɑːs̪t̪ɐj
वाणी	ʋɑ́ːɳiː
कृत	kr̩t̪ɐ
परिवृत्	pɐɾiʋr̩t̪
तरुण	t̪ɐɾuɳɐ
नश्यन्ति	n̪ɐɕjɐn̪t̪i
परिच्छेदम्	pɐɾitt͡ɕʰɐjd̪ɐm
वर्षति	ʋɐ́ɾʂɐt̪i
परेमन्	pɐɾeːmɐn̪
संगणक	s̪ɐŋɡɐɳɐkɐ
वक्षस्	ʋɐ́kʂɐs̪
नृप	n̪ŕ̩pɐ
अन्तर्जालेन	ɐn̪t̪ɐɾd͡ʑɑːl̪eːn̪ɐ
शरद्	ɕɐɾɐ́d̪
मूर्धन्	muːɾd̪ʱɐn̪
जनितोस्	d͡ʑɐn̪it̪oːs̪
काजेन	kɑːd͡ʑɐjn̪ɐ
अहिभृत्	ɐɦibʱr̩t̪
दर्भ	d̪ɐɾbʱɐ
निन्दा	n̪in̪d̪ɑ́ː
गलति	ɡɐl̪ɐt̪i
दुह्	d̪uɦ
खेलति	kʰeːl̪ɐt̪i
दीन	d̪iːn̪ɐ
वार	ʋɑːɾɐ
जिज्ञासते	d͡ʑíd͡ʑɲɑːs̪ɐt̪ɐj
यज्ञोपवीत	jɐd͡ʑɲɐwpɐʋiːt̪ɐ́
आञ्छित	ɑːɲt͡ɕʰit̪ɐ
तृढ	t̪r̩ɖʱɐ́
साढृ	s̪ɑːɖʱr̩
ह्यस्	ɦjɐs̪
वारा	ʋɑːɾɑː
सफल	s̪ɐpʰɐl̪ɐ
विशाल	ʋiɕɑːl̪ɐ
कलम	kɐl̪ɐmɐ
तमस्	t̪ɐmɐs̪
षष्	ʂɐ́ʂ
कर्मन्	kɐɾmɐn̪
मन्तृ	mɐn̪t̪r̩
श्वस्	ɕʋɐs̪
पितु	pit̪u
दुर्ग	d̪uɾɡɐ́
वृषन्	ʋr̩ʂɐn̪
नेत्रोपम	n̪ɐjt̪ɾɐwpɐmɐ
सत्यतयोः	s̪ɐt̪jɐt̪ɐjɐwh
ध्रुति	d̪ʱɾut̪i
उदर	ud̪ɐɾɐ
जैन	d͡ʑɑjn̪ɐ
अरोधत्	ɐɾoːd̪ʱɐt̪
शोधक	ɕoːd̪ʱɐkɐ
स्वसृ	s̪ʋɐ́s̪r̩
निक्त	n̪ikt̪ɐ́
आस्	ɑːs̪
संचालक	s̪ɐɲt͡ɕɑːl̪ɐkɐ
अभिषचते	ɐbʱiʂɐt͡ɕɐt̪eː
दानी	d̪ɑːn̪iː
नर	n̪ɐɾɐ
सुरा	s̪uɾɑː
सप्तविंशति	s̪ɐpt̪ɐʋĩɕɐt̪i
