egypt	ɛɡipt
klas	kɫas
hašiš	ɦaʃiʃ
malachiáš	maɫaxiaːʃ
spyware	spajvɛːr
schopný	sxɔpniː
justa	justa
telách	cɛɫaːx
eta	ɛta
jahoda	jaɦɔda
hrdlo	ɦr̩dɫɔ
jazero	jazɛrɔ
chudnúť	xʊdnuːc
fruštik	fruʃcik
úzky	uːski
konfirmácia	kɔnfirmaːt͡sia
rozália	rɔzaːlia
mena	mɛna
kamila	kamiɫa
zlatý	zɫatiː
matej	matɛj
fero	fɛrɔ
beh	bɛx
sopka	sɔpka
anna	anna
aktualizovať	aktualizovac
pravdy	pravdi
macedónsko	mat͡sɛdɔːnskɔ
zátvorka	zaːtvɔrka
švédsky	ʃvɛːtski
riad	ri̯at
ruska	ruska
sofoniáš	sɔfɔniaːʃ
tma	tma
bohdana	bɔɦdana
rastislav	rascisɫau̯
pekáreň	pɛkaːrɛɲ
herečka	ɦɛrɛt͡ʃka
bradatý	bradatiː
anamnéza	anamnɛːza
fotografiami	fɔtɔɡrafiami
vratislav	vracisɫau̯
nacionalistka	nat͡siɔnalistka
územie	uːzɛmi̯ɛ
týždeň	tiːʒɟɛɲ
metajazyk	mɛtajazik
medvedice	mɛdvɛɟit͡sɛ
osem	ɔsɛm
akonáhle	akɔnaːɦlɛ
robota	rɔbɔta
hypnos	ɦipnɔs
milica	milit͡sa
koruna	koruna
koláčový	kɔɫaːt͡ʃɔviː
slovinka	sɫɔviŋka
slimák	slimaːk
sen	sɛn
sa	sa
nohavice	nɔɦavit͡sɛ
charakter	xaraktɛr
jazera	jazɛra
motýlí	mɔtiːʎiː
jazerá	jazɛraː
stroncium	strɔnt͡sium
strelec	strɛlɛt͡s
drôt	dru̯ɔt
hrianka	ɦr̩i̯aŋka
kapitalizmus	kapitalizmus
cudzinec	t͡sud͡ziɲɛt͡s
lítium	liːtium
čas	t͡ʃas
olovo	ɔɫɔvɔ
myslieť	misli̯ɛc
strukovina	strukɔvina
stehlík	scɛɦʎiːk
jednou	jednou̯
topánky	tɔpaːŋki
ryba	riba
rožok	rɔʒɔk
íri	iːri
gajdy	ɡajdi
figovník	fiɡɔu̯ɲiːk
prvosienka	pr̩vɔsi̯ɛŋka
biskup	biskup
rus	rus
ado	adɔ
meno	mɛnɔ
tráva	traːva
jednými	jedniːmi
zemiak	zɛmi̯ak
socialistický	sɔt͡sialistit͡skiː
situácia	situaːt͡sia
stretnutie	strɛtnuci̯ɛ
prvý	pr̩viː
devätnásť	ɟɛvætnaːsc
kakao	kakaɔ
prdieť	pr̩ɟi̯ɛc
oto	ɔtɔ
nádražiu	naːdraʒi̯u
dionýz	dioniːs
elektrina	ɛlɛktrina
predať	prɛdac
losos	ɫɔsɔs
genovéva	ɡɛnɔvɛːva
mário	maːriɔ
šťúr	ʃcuːr
tabu	tabu
európy	ɛu̯rɔːpi
damask	damask
danuta	danuta
daňo	daɲɔ
od	ɔd
tomáš	tɔmaːʃ
chlapi	xɫapi
jar	jar
zdraví	zdraviː
ústa	uːsta
faktu	faktu
vincent	vint͡sɛnt
betón	bɛtɔːn
judita	judita
svetoch	svɛtɔx
bratranec	bratranet͡s
škvrna	ʃkvr̩na
mrlí	mr̩liː
zombia	zɔmbia
fön	føn
dej	ɟɛj
ľuda	ʎuda
chmeľ	xmɛʎ
kýl	kiːɫ
škóti	ʃkɔːci
kmeň	kmɛɲ
bohužiaľ	bɔɦuʒi̯aʎ
karí	kariː
žriebäcí	ʒri̯bɛt͡siː
dážď	daːʃc
győr	ɟɛːr
hudba	ɦudba
baht	baːt
tok	tɔk
vziať	vzi̯ac
chudý	xudiː
džungľa	d͡ʒuŋɡʎa
sviečka	svi̯ɛt͡ʃka
rúno	ruːnɔ
škáročka	ʃkaːrɔt͡ʃka
ypsilon	ipsiɫɔn
škál	ʃkaːɫ
sokol	so̞ko̞l
najmenší	najmɛnʃiː
báb	baːp
prípad	priːpat
bojovať	bɔjɔvac
krajinách	krajinaːx
mech	mɛx
hajzel	ɦajzɛɫ
tkáč	tkaːt͡ʃ
slivka	sliu̯ka
dva	dva
miezd	mi̯est
luk	ɫuk
piť	pic
jób	jɔːp
ušnica	uʃɲit͡sa
tlmač	tɫ̩mat͡ʃ
kanton	kantɔn
okuliarnik	ɔkuʎi̯arɲik
jednu	jednu
servus	sɛrvus
morava	mɔrava
puška	puʃka
letisko	lɛciskɔ
olympia	ɔlimpia
aperitív	apɛritiːw
václav	ʋaːt͡sɫaw
róbert	rɔːbɛrt
branislava	braɲislava
pšenice	pʃɛɲit͡sɛ
bombardovať	bɔmbardɔvac
turek	turɛk
šatôčka	ʃatu̯ɔt͡ʃka
figa	fiɡa
pokým	pɔkiːm
držgroš	dr̩ʒɡrɔʃ
monarcha	mɔnarxa
vinš	vinʃ
ch	x
povedať	pɔvɛdac
autobus	au̯tɔbus
jeruzalem	jɛruzalɛm
líška	liːʃka
krajinami	krajinami
jazýček	jaziːt͡ʃɛk
choroba	xɔrɔba
dobroslava	dɔbrɔsɫava
kožušník	kɔʒuʃɲiːk
džez	d͡ʒɛs
kus	kus
cikať	t͡sikac
sodík	sɔɟiːk
berta	bɛrta
aragonit	araɡɔnit
peklo	pɛkɫɔ
zuzana	zuzana
nájsť	naːjsc
erb	ɛrb
úbohý	uːbɔɦiː
pod	pɔt
hrdý	ɦr̩diː
kambodža	kambɔd͡ʒa
film	fiɫm
srdca	sr̩t͡sa
noc	nɔt͡s
štrnásť	ʃtr̩naːsc
oliva	oliva
koreň	kɔrɛɲ
holandčina	ɦɔɫandt͡ʃina
zuzka	zuska
mikroskop	mikrɔskɔp
nízky	ɲiːski
ďakujúci	ɟakujuːt͡si
debna	ɟɛbna
pornografia	pɔrnɔɡrafia
žihľavka	ʒiɦʎau̯ka
hrdinka	ɦr̩ɟiŋka
stanislav	staɲisɫau̯
arménsko	armɛːnskɔ
demeter	dɛmɛtɛr
premávka	prɛmaːu̯ka
hnačka	ɦnat͡ʃka
pravdám	pravdaːm
laco	ɫat͡so
kuchyňa	kuxiɲa
drahoslava	draɦɔsɫava
idiot	idiɔt
vuvuzela	ʋuʋuzeɫa
kubo	kubɔ
stromom	strɔmɔm
králik	kraːʎik
kluž	kluʃ
črieda	t͡ʃri̯ɛda
preteky	prɛcɛki
zubáč	zubaːt͡ʃ
okná	ɔknaː
tlač	tɫat͡ʃ
danica	daɲit͡sa
faktom	faktom
ulicu	uʎit͡su
hebrejčina	ɦɛbrɛjt͡ʃina
čokoláda	t͡ʃɔkɔɫaːda
dudy	dudi
sveta	svɛta
niekto	ɲi̯ɛktɔ
vlastimil	vɫascimiɫ
džem	d͡ʒɛm
meč	mɛt͡ʃ
kocúr	kot͡suːr
láska	ɫaːska
turecko	turɛt͡skɔ
idea	idɛa
celý	t͡sɛliː
izis	izis
nataša	nataʃa
užitočnosť	uʒitɔt͡ʃnɔsc
ä	æ
horčica	ɦɔrt͡ʃit͡sa
slovinec	sɫɔviɲɛt͡s
sujet	syʒɛ
medveď	mɛdvɛc
pretekár	prɛcɛkaːr
drviť	dr̩vic
poloostrov	pɔɫɔɔstrɔu̯
svedomí	svɛdɔmiː
angelika	aŋɡɛlika
mama	mama
jestvovať	jɛstvɔvac
šálka	ʃaːɫka
labuť	ɫabuc
hrať	ɦrac
strach	strax
poznať	pɔznac
beňadik	bɛɲaɟik
otec	ɔcɛt͡s
národný	naːrɔdniː
juliána	juliaːna
teplý	cɛpliː
garáž	ɡaraːʃ
denis	dɛnis
brita	brita
samárium	samaːrium
výbuch	viːbux
kupec	kupɛt͡s
dezider	dɛzidɛr
boháč	bɔɦaːt͡ʃ
roentgenium	rɛnɡɛnium
olivách	ɔlivaːx
zmija	zmija
bábka	baːbka
pošta	poʃta
tiel	ci̯ɛɫ
astronómia	astrɔnɔːmia
chvíľka	xviːʎka
nórčina	nɔːrt͡ʃina
ľuboš	ʎubɔʃ
prostredie	prɔstrɛɟi̯ɛ
horký	ɦɔrkiː
radovan	radɔvan
juliana	juliana
cigara	t͡siɡara
tango	taŋɡɔ
sup	sup
zachariáš	zaxariaːʃ
volfrám	vɔɫfraːm
roj	rɔj
rozhodnutie	rɔzɦɔdnuci̯ɛ
ruka	ruka
graz	ɡrat͡s
hrdinovia	ɦr̩ɟinɔvi̯a
nero	nɛrɔ
beáta	bɛaːta
evanjelium	ɛvaɲi̯ɛlium
téma	te̞ːma
svetov	svɛtɔu̯
slepý	slɛpiː
gálium	ɡaːlium
múdry	muːdri
fakľa	fakʎa
blamáž	blamaːʃ
živý	ʒiviː
páv	paːu̯
logika	ɫɔɡika
kvas	kvas
carihrad	t͡ʃariɦrat
lodž	ɫɔd͡ʒ
svetozár	svɛtɔzaːr
dánčina	daːnt͡ʃina
predseda	prɛtsɛda
bozkať	bɔskac
afrike	afrikɛ
vzal	vzaɫ
viedeň	vi̯ɛɟɛɲ
imidž	imit͡ʃ
mudrc	mudr̩t͡s
cisár	t͡sisaːr
domček	dɔmt͡ʃɛk
negližé	nɛɡliʒɛː
kľúč	kʎuːt͡ʃ
konštantín	kɔnʃtantiːn
vnútornosti	vnuːtɔrnɔsc
judaizmus	judaizmus
radúz	raduːs
liana	liana
plecniak	plɛt͡sɲi̯ak
adamom	adamɔm
tehlička	cɛɦʎit͡ʃka
stroj	strɔj
obdobie	ɔbdɔbi̯ɛ
európou	ɛu̯rɔːpɔu̯
metamorfóza	mɛtamɔrfɔːza
päť	pɛc
zdenka	zɟɛŋka
dán	daːn
baktérie	baktɛːriɛ
jednej	jednej
zuzanka	zuzaŋka
brata	brata
lýtko	liːtkɔ
pneumatika	pnɛumatika
deväť	ɟevæc
marcela	mart͡sɛɫa
muche	muxɛ
nikel	nikɛɫ
banky	baŋki
časti	t͡ʃasci
informácia	infɔrmaːt͡sia
tuk	tuk
žltý	ʒɫ̩tiː
správa	spraːva
xenofón	ksɛnɔfɔːn
vrecko	vrɛt͡skɔ
skratka	skratka
byť	bic
uhol	uɦɔɫ
sára	saːra
byt	bit
seba	sɛba
pontifex	po̞ntife̞ks
klietka	kʎi̯ɛtka
vy	vi
bez	bɛs
mať	mac
kočišová	kɔt͡ʃiʃɔvaː
králice	kraːlit͡sɛ
svätyňa	svɛtiɲa
najstarší	najstarʃiː
kľúčik	kʎuːt͡ʃik
sliepka	sli̯ɛpka
moskva	mɔskva
vravieť	vravi̯ɛc
rameno	ramɛnɔ
stromy	strɔmi
bedminton	bɛːdmintɔn
farba	farba
lichtenštajnsko	lixtɛnʃtajnskɔ
flauta	fɫau̯ta
medard	mɛdard
púpava	puːpava
milada	miɫada
aurel	au̯rɛːɫ
stroji	strɔji
šatka	ʃatka
topánka	tɔpaːŋka
oco	ɔt͡sɔ
braček	brat͡ʃɛk
galaktický	ɡaɫaktit͡skiː
kreslo	krɛsɫɔ
baňa	baɲa
ladislava	ɫaɟisɫava
husle	ɦuslɛ
vidiecky	viɟi̯ɛt͡ski
biely	bi̯ɛli
heterosexualita	ɦɛtɛrɔsɛksualita
vlasť	ʋɫasc
severín	sɛvɛriːn
draslík	drasliːk
bratislavčan	bracislau̯t͡ʃan
vít	viːt
príslovia	priːsɫɔvi̯a
sto	stɔ
kohút	kɔɦuːt
brigita	briɡita
kaderníčka	kaɟɛrɲiːt͡ʃka
plutónium	pɫutɔːnium
iskierka	iski̯ɛrka
dvanásť	dvanaːsc
pravdou	pravdou̯
môcť	mu̯ɔt͡sc
tvoj	tvɔj
janov	janɔu̯
potrebovať	pɔtrɛbɔvac
schudnúť	sxudnuːc
prímerie	priːmɛri̯ɛ
nížina	ɲiːʒina
egreš	ɛɡrɛʃ
ålandy	ɔɫandi
cap	t͡sap
strom	strɔm
peter	pɛtɛr
veľmi	vɛʎmi
fašizmus	faʃizmus
prozódia	prɔzɔːdia
slovníka	sɫoʋɲiːka
rasca	rast͡sa
chujovina	xujɔvina
dedinka	ɟɛɟiŋka
fúkať	fuːkac
florián	fɫɔriaːn
vanád	ʋanaːt
kmeňom	kmɛɲɔm
škála	ʃkaːɫa
šestnásť	ʃɛstnaːsc
pokoj	pɔkɔj
fľaša	fʎaʃa
cez	t͡sɛs
jediný	jeɟɪniː
stena	scɛna
kvisling	kvisliŋɡ
olomouc	ɔɫɔmɔu̯t͡s
dymy	dimi
aids	ɛjt͡s
vasil	vasiɫ
tokoferol	tɔkɔfɛrɔɫ
lýdia	liːdia
detstvo	ɟɛt͡stvɔ
osoba	ɔsɔba
potôčik	pɔtu̯ɔt͡ʃik
strachov	straxou̯
či	t͡ʃi
srbsko	sr̩pskɔ
františka	francɪʃka
hala	ɦaɫa
žirafí	ʒirafiː
žaneta	ʒanɛta
vlani	vɫaɲi
libuša	libuʃa
zröntgenovať	zrɛntɡɛnɔvac
botanizovať	bɔtanizɔvac
sudca	sutt͡sa
najmenej	najmeɲej
róm	rɔːm
protivný	prɔcivniː
orgován	orɡovaːn
herakles	ɦɛraklɛs
častica	t͡ʃascit͡sa
mĺzť	mɫ̩ːsc
hovädzí	ɦɔvæd͡ziː
bohuslav	bɔɦuslau̯
nahý	naɦiː
adela	adeɫa
ženou	ʒenɔu̯
lotyština	ɫɔtiʃcina
holí	ɦɔliː
sliezsko	sli̯ɛsskɔ
prežúvavec	prɛʒuːvavɛt͡s
hovädina	ɦɔvɛɟina
opitý	ɔpitiː
človiečik	t͡ʃɫɔvi̯ɛt͡ʃik
útroba	uːtrɔba
sokrates	sɔkratɛs
zapínať	zapiːnac
krôčik	kru̯ɔt͡ʃik
klobúk	klɔbuːk
ulíc	uʎiːt͡s
škandinávia	ʃkandinaːvia
žalmy	ʒaɫmi
kórejčina	kɔːrɛjt͡ʃina
mlyn	mlin
esej	ɛsɛj
viera	vi̯ɛra
taliansky	tali̯anski
sviečkach	svi̯ɛt͡ʃkax
skrutkovať	skrutkɔvac
množina	mnɔʒina
mištička	miʃcit͡ʃka
haruspex	ɦaruspeks
hmotnosť	ɦmɔtnɔsc
čej	t͡ʃɛj
hydina	ɦiɟina
pizda	pizda
amnézia	amnɛːzia
čajka	t͡ʃajka
ulici	uɫit͡si
strecha	strɛxa
štefánia	ʃcɛfaːnia
mešita	mɛʃita
bezo	bɛzɔ
nôh	nu̯ox
vojak	vɔjak
selén	sɛlɛːn
inga	iŋɡa
lesana	lɛsana
voz	vɔs
aký	akiː
užší	uʃiː
hystéria	ɦistɛːria
nemčina	ɲɛmt͡ʃina
antónia	antɔːnia
plukovník	pɫukɔvɲiːk
kobrách	kɔbraːx
ctí	t͡sciː
irena	irɛna
republika	rɛpublika
lei	lɛi
nadšený	natʃeniː
sukničkár	sukɲit͡ʃkaːr
pop	pop
terst	tɛrst
zoológia	zɔɔɫɔːɡia
mät	mæt
malinový	malinɔviː
stan	stan
drumbľa	drumbʎa
európe	ɛu̯rɔːpɛ
ihla	iɦɫa
skuhroš	skuɦrɔʃ
miloslav	miɫɔsɫau̯
deviaty	ɟɛvi̯ati
fín	fiːn
hroch	ɦrɔx
telúr	tɛɫuːr
zastaralý	zastaraɫiː
harfa	ɦarfa
nádražím	naːdraʒiːm
hnoj	ɦnɔj
bartolomej	bartɔɫɔmɛj
dymami	dimami
schody	sxɔdi
vedľa	vɛdʎa
akcia	akt͡sia
džin	d͡ʒin
líštička	liʃcit͡ʃka
nemecky	ɲɛmɛt͡ski
budyšín	budiʃiːn
podpňovka	pɔtpɲɔu̯ka
viac	vi̯at͡s
medzi	mɛd͡zi
február	fɛbruaːr
pán	paːn
bróm	brɔːm
fajčenie	fajt͡ʃɛɲi̯ɛ
vdov	vdɔu̯
hriva	ɦriva
vrabec	vrabɛt͡s
užitočný	uʒitɔt͡ʃniː
kaše	kaʃɛ
jedenásť	jɛdɛnaːsc
nórsky	nɔːrski
oblečenie	ɔblɛt͡ʃɛɲi̯ɛ
klára	kɫaːra
labe	ɫabɛ
krajoch	krajox
smädný	smædniː
rakúsko	rakuːskɔ
berlín	bɛrliːn
hŕstka	ɦr̩ːstka
pravdách	pravdaːx
električka	ɛlɛktrit͡ʃka
pivnica	pivɲit͡sa
erbium	ɛrbium
cadik	t͡sadik
hemendex	ɦɛmɛndɛks
ceruza	tsɛruza
hruška	ɦruʃka
kata	kata
kornélia	kɔrnɛːlia
daniel	daniɛɫ
kazimír	kazimiːr
bože	bɔʒɛ
aristoteles	aristɔtɛlɛs
mníchov	mɲiːxɔu̯
leo	lɛɔ
dojča	dɔjt͡ʃa
čistej	t͡ʃiscɛj
kúpiť	kuːpic
tieň	ci̯ɛɲ
zajac	zajat͡s
vitráž	ʋitraːʃ
koreni	kɔrɛɲi
vretenica	vrɛcɛɲit͡sa
žien	ʒi̯en
miroslava	mirɔsɫava
krajinám	krajinaːm
krajina	krajina
najmä	najmæ
škrupinka	ʃkrupiŋka
ísť	iːsc
kníhkupec	kɲiːxkupɛt͡s
knižnica	kɲɪʒɲɪt͡sa
používateľ	pɔuʒiːvacɛʎ
boleslav	bɔlɛslau̯
hojdačka	ɦɔjdat͡ʃka
moriak	mɔri̯ak
barbara	barbara
indium	indium
nór	nɔːr
jeho	jɛɦɔ
ananás	ananaːs
pražský	praʃskiː
havaj	ɦavaj
škorica	ʃkɔrit͡sa
dymu	dimu
lexikálny	lɛksikaːlni
bibiána	bibiaːna
darina	darina
musieť	musi̯ɛc
timotej	timɔtɛj
krajov	krajou̯
toxický	toksit͡skiː
bislama	bisɫama
ohovárať	ɔɦɔvaːrac
chrbtica	xr̩pcit͡sa
veternica	vɛcɛrɲit͡sa
grékyňa	ɡrɛːkiɲa
matematik	matɛmatik
krásny	kraːsni
väčšina	væt͡ʃʃina
strome	strɔmɛ
cuda	t͡suda
vražda	vraʒda
požiar	pɔʒi̯ar
sága	saːɡa
nižší	ɲiʃʃiː
sústava	suːstava
knižočka	kɲiʒɔt͡ʃka
machiavellizmus	makiavɛlizmus
masť	masc
dobrá	dɔbraː
voziť	vɔzic
ír	iːr
holý	ɦɔɫiː
ľubomír	ʎubɔmiːr
lano	ɫanɔ
starší	starʃiː
mrkva	mr̩kva
mops	mɔps
duba	duba
kostrová	kɔstrɔvaː
dvere	dvɛrɛ
rozumný	rɔzumniː
soľ	sɔʎ
chren	xrɛn
dano	danɔ
lýra	liːra
sláva	sɫaːva
miro	mirɔ
muži	mʊʒɪ
slzička	sɫ̩zit͡ʃka
mäkkýš	mɛkiːʃ
svätopluk	svætɔpɫuk
hosť	ɦɔsc
zub	zup
ďalší	ɟaɫʃiː
morka	mɔrka
alexandra	alɛksandra
sukienka	suki̯ɛŋka
myš	miʃ
literatúra	literatuːra
mäkčeň	mækt͡ʃeɲ
svokra	svɔkra
telám	cɛɫaːm
pečeň	pɛtʃɛɲ
piepor	pi̯ɛpɔr
olympiáda	ɔlimpiaːda
kocka	kɔt͡ska
jarok	jarok
osla	ɔsɫa
naozaj	naɔzaj
kašlať	kaʃɫac
strachu	straxu
eliška	ɛliʃka
čím	t͡ʃiːm
mäta	mæta
cukor	t͡sukɔr
nádražiam	naːdraʒi̯am
čomu	t͡ʃɔmu
jüan	jian
rubídium	rubiːdium
sebec	sɛbɛt͡s
dana	dana
linda	linda
záležitosť	zaːʎeʒitɔsc
fínsko	fiːnskɔ
volov	vɔɫɔu̯
takmer	takmɛr
rómka	rɔːmka
čižmička	t͡ʃiʒmit͡ʃka
švéd	ʃʋeːt
dobrý	dɔbriː
medovina	mɛdɔvina
najväčší	najvɛt͡ʃʃiː
krajine	krajiɲe
irak	irak
pätica	pæcit͡sa
katapult	katapult
slovinčina	sɫɔvint͡ʃina
plný	pl̩niː
kmeňa	kmɛɲa
tatiana	tati̯ana
einsteinium	ajnʃtajnium
borec	bɔrɛt͡s
uliciam	uɫit͡si̯am
obyvateľ	ɔbivacɛʎ
sidónia	sidɔːnia
spoločnosť	spɔɫɔt͡ʃnɔsc
január	januaːr
ľubo	ʎubɔ
vývojka	viːvɔjka
ruža	ruʒa
doktora	dɔktɔra
ožran	ɔʒran
panic	paɲit͡s
dvanásťročný	dvanaːscrɔt͡ʃniː
šok	ʃɔk
hôľ	ɦu̯oʎ
aktualizovaný	aktualizovaniː
lídrov	liːdrɔu̯
koč	kɔt͡ʃ
revue	rɛvy
hovädo	ɦɔvædɔ
nevädza	ɲɛvæd͡za
perla	pɛrɫa
hrab	ɦrap
mäte	mæcɛ
olívia	ɔliːvia
edita	ɛdita
podujatie	pɔdujaci̯ɛ
možno	mɔʒnɔ
emília	ɛmiːlia
švagor	ʃvaɡɔr
jeremiáš	jɛrɛmiaːʃ
včera	ft͡ʃɛra
uzbekistan	uzbɛkistan
jolana	jɔɫana
pomorník	pɔmɔrɲiːk
neuróza	nɛu̯rɔːza
mesto	me̞sto̞
valér	valɛːr
cesta	t͡sɛsta
prezývka	prɛziːu̯ka
kulturistika	kuɫturistika
zlý	zɫiː
diana	diana
mäsiar	mæsi̯ar
slovenčina	sɫɔvɛnt͡ʃina
vodopád	vɔdɔpaːt
bohrium	bɔrium
breza	brɛza
láma	ɫaːma
odo	ɔdɔ
hybný	ɦibniː
jogurt	jɔɡurt
alfréd	aɫfrɛːt
raz	ras
starká	starkaː
galaxiu	ɡalaksiu
srna	sr̩na
herec	ɦɛrɛt͡s
tkáčka	tkaːt͡ʃka
bohuslava	bɔɦuslava
cholera	xɔlɛra
žila	ʒiɫa
sukňa	sukɲa
turnaj	turnaj
benzín	bɛnziːn
katapulty	katapuɫti
slováci	sɫɔvaːt͡si
vydra	vidra
barbora	barbɔra
lantán	ɫantaːn
kvapeľ	kvapɛʎ
včela	ft͡ʃɛɫa
fakte	fakce
kristína	kristiːna
strachom	straxom
chlapmi	xɫapmi
viking	vikiŋɡ
kel	kɛɫ
faerský	faɛrskiː
víťaz	viːcas
slavomíra	sɫavɔmiːra
guru	ɡuru
samuraj	samuraj
jak	jak
aleš	alɛʃ
holandsky	ɦɔɫandski
františek	franciʃɛk
dni	dɲi
džamija	d͡ʒamija
katedrála	katedraːɫa
zelený	ze̞ʎe̞niː
erno	ɛrnɔ
ufňukaný	ufɲukaniː
tur	tur
olovrant	ɔɫɔvrant
pätnásť	pætnaːsc
spôsob	spu̯ɔsɔp
škovránok	ʃkɔvraːnɔk
schod	sxɔt
zázračný	zaːzrat͡ʃniː
jablko	jabɫ̩ko
irán	iraːn
dcérečka	t͡sɛːrɛt͡ʃka
kraj	kraj
šógun	ʃɔːɡun
krm	kr̩m
dvadsať	dvatsac
rebro	rɛbrɔ
prsník	pr̩sɲiːk
zbohom	zbɔɦɔm
atómový	atɔːmɔviː
pŕhľavka	pr̩ːɦʎau̯ka
borovicový	bɔrɔvit͡sɔviː
vilma	viɫma
hierarchia	ɦi̯ɛrarxia
dánsky	daːnski
nauru	nauru
rakúsky	rakuːski
bambusový	bambusɔviː
euro	ɛu̯rɔ
syr	sir
blcha	bɫ̩xa
zajačik	zajat͡ʃik
šesť	ʃɛst
telami	cɛɫami
fluór	fluɔːr
pôžička	pu̯ɔʒit͡ʃka
atény	atɛːni
krvi	kr̩vi
hrdinom	ɦr̩ɟinɔm
dráždec	draːʒɟɛt͡s
rádium	raːdium
srdciam	sr̩t͡si̯am
bielorusko	bi̯ɛɫɔruskɔ
mäkkýš	mækiːʃ
korčule	kɔrt͡ʃulɛ
ideológia	idɛɔɫɔːɡia
vodík	vɔɟiːk
vláčik	vɫaːt͡ʃik
bohdan	bɔɦdan
smutný	smutniː
radón	radɔːn
jela	jɛɫa
diéta	diɛːta
krajčír	krajt͡ʃiːr
trolejbus	trɔlɛjbus
kongres	kɔŋɡrɛs
kvasnice	kvasɲit͡sɛ
stromami	strɔmami
luna	luna
veľký	vɛʎkiː
maňuška	maɲuʃka
bohuš	bɔɦuʃ
katapultami	katapuɫtami
chrček	xr̩t͡ʃɛk
s	s
môj	mu̯ɔj
pláž	plaːʃ
terbium	tɛrbium
pravý	praviː
žigmund	ʒiɡmund
kubánec	kubaːɲɛt͡s
kapverdy	kapvɛrdi
tisíc	cisiːt͡s
čuchať	t͡ʃuxac
pokrievka	pɔkri̯ɛu̯ka
jačí	jat͡ʃiː
adamovia	adamɔvi̯a
vilnius	viɫɲi̯us
stáť	staːc
fí	fiː
rieka	ri̯ɛka
chvíľa	xviːʎa
dunaj	dunaj
popol	pɔpɔɫ
krívať	kriːvac
slon	sɫɔn
modlivka	mɔdliu̯ka
krása	kraːsa
cmar	t͡smar
denný	ɟɛnniː
jana	jana
litava	litava
ľuboslava	ʎubɔsɫava
kopija	kɔpija
mýto	miːtɔ
jachta	jaxta
embólie	ɛmbɔːliɛ
škótsky	ʃkɔːtski
nedele	ɲɛɟɛʎɛ
škola	ʃkɔɫa
sedem	sɛɟɛm
škoda	ʃkɔda
sabína	sabiːna
pyžamo	piʒamɔ
šošovica	ʃɔʃɔvit͡sa
jej	jɛj
opúšťať	ɔpuːʃcac
ohňostroj	ɔɦɲɔstrɔj
karol	karɔɫ
orlí	ɔrliː
kravata	kravata
pásavka	paːsau̯ka
napokon	napokon
kôra	ku̯ora
medzinárodný	mɛd͡zinaːrɔdniː
končiť	kɔnt͡ʃic
šija	ʃija
miriam	miriam
denisa	dɛnisa
vedro	vɛdrɔ
zombi	zɔmbi
chyža	xiʒa
stroju	strɔju
kornel	kɔrnɛɫ
mäkký	mekiː
nesčíselný	ɲɛst͡ʃiːsɛlniː
um	um
smädiť	smæɟic
telá	cɛɫaː
piaty	pi̯ati
doktorovi	dɔktɔrɔvi
marcel	mart͡sɛɫ
dielo	ɟi̯ɛɫɔ
tučniak	tut͡ʃɲi̯ak
máj	maːj
golier	ɡɔʎi̯ɛr
ján	jaːn
lepší	lɛpʃiː
draha	draɦa
teizmus	tɛizmus
zatiaľ	zaci̯aʎ
latrína	ɫatriːna
bologna	boloɲa
olivami	ɔlivami
leu	lɛu
jeseter	jɛsɛcɛr
osol	ɔsɔɫ
hlad	ɦɫat
sexu	sɛksu
hlas	ɦɫas
vzduch	vzdux
yzop	izɔp
valéria	valɛːria
koliba	kɔliba
mojžíš	mɔjʒiːʃ
budova	budɔva
fyzikálni	fizikaːɫni
ejakulácia	ejakulaːt͡sia
veverica	vɛvɛrit͡sa
pohár	pɔɦaːr
udrieť	udri̯ɛc
predmestie	prɛdmɛsci̯ɛ
nárečie	naːrɛt͡ʃi̯ɛ
strojmi	strɔjmi
začiatok	zat͡ʃi̯atɔk
škandál	ʃkandaːɫ
novak	nɔvak
dežo	dɛʒɔ
dž	d͡ʒ
nemecko	ɲɛmɛt͡skɔ
augustín	au̯ɡustiːn
slanina	sɫaɲina
drozdí	drɔzɟiː
špagety	ʃpaɡɛti
kožuch	kɔʒux
paľo	paʎɔ
čečenský	t͡ʃɛt͡ʃɛnskiː
škorec	ʃkɔrɛt͡s
gréčtina	ɡrɛːt͡ʃcina
polostrov	pɔɫɔstrɔu̯
cirkev	t͡sirke̞u̯
imrich	imrix
husi	ɦusi
struna	struna
röntgenovať	rɛntɡɛnɔvac
lángoš	ɫaːŋɡɔʃ
rozmarín	rɔzmariːn
dláto	dɫaːtɔ
miloš	miɫɔʃ
holmium	ɦɔɫmium
brdo	br̩dɔ
jaroslava	jarɔsɫava
blázon	bɫaːzɔn
zrenica	zrɛɲit͡sa
december	dɛt͡sɛmbɛr
valkýra	vaɫkiːra
mlieko	mli̯ɛkɔ
pavúk	pavuːk
roman	rɔman
vtáčik	ftaːt͡ʃik
koža	kɔʒa
sušič	suʃit͡ʃ
kožušina	kɔʒuʃina
sad	sad
banku	baŋku
sukne	sukɲɛ
bizmut	bizmut
georgína	ɡɛɔrɡiːna
dať	dac
marhuľa	marɦuʎa
synovia	sinovi̯a
birmovanie	birmɔvaɲi̯ɛ
topánočka	tɔpaːnɔt͡ʃka
nezmysel	ɲɛzmisɛɫ
tabak	tabak
alandy	aɫandi
kunda	kunda
gaba	ɡaba
písmeno	piːsmɛnɔ
žerucha	ʒɛruxa
nič	ɲit͡ʃ
dagmara	daɡmara
kopa	kɔpa
urtikárie	urtikaːriɛ
ázijský	aːzijskiː
chorý	xɔriː
nádcha	naːtxa
klárka	kɫaːrka
palacinka	palatsiŋka
drahomíra	draɦɔmiːra
vädnúť	vædnuːc
oko	ɔkɔ
výťah	viːcax
lista	lista
zdravie	zdravi̯ɛ
vestibul	vɛstibuɫ
škótština	ʃkɔːtʃcina
nedeľa	ɲeɟelʲa
súťaž	suːcaʃ
astát	astaːt
vážka	vaːʃka
údolie	uːdɔʎi̯ɛ
pivá	pivaː
americký	amɛrit͡skiː
police	pɔlit͡sɛ
hovädo	ɦɔvɛdɔ
č	t͡ʃ
artritída	artritiːda
galaxiou	ɡalaksiou̯
posteľ	pɔscɛʎ
predložka	prɛdɫɔʃka
žurnál	ʒurnaːɫ
protirečiť	prɔcirɛt͡ʃic
svahilčina	svaɦiɫt͡ʃina
gdynia	ɡdiɲa
katapultom	katapuɫtɔm
kamil	kamiɫ
arabčina	arapt͡ʃina
bobona	bɔbɔna
nádherný	naːdɦɛrniː
smrti	smr̩ci
hloh	ɦɫɔx
stromoch	strɔmɔx
landgróf	ɫandɡrɔːf
dánka	daːŋka
sýkorka	siːkɔrka
izabela	izabɛɫa
jednému	jedneːmu
hruď	ɦruc
bratislavu	bracisɫavu
labutí	ɫabuciː
kadmium	kadmium
lakeť	ɫakɛc
tridsať	trit͡sac
lyža	liʒa
nosiť	nɔsic
dĺžka	dɫ̩ːʃka
dedko	ɟɛtkɔ
islande	isɫanɟɛ
vodiť	vɔɟic
záhrada	zaːɦrada
knižôčka	kɲiʒu̯ɔt͡ʃka
pretože	prɛtɔʒɛ
finále	finaːlɛ
níreďháza	ɲiːrɛɟɦaːza
žuvačka	ʒuvat͡ʃka
hlaholika	ɦɫaɦɔlit͡sa
os	ɔs
potravina	pɔtravina
prísudok	priːsudɔk
stupidita	stupɪdɪta
slovenskí	sɫɔvɛnskiː
lekorica	lɛkɔrit͡sa
ľadoborec	ʎadɔbɔrɛt͡s
kipa	kipa
oldrich	ɔɫdrix
vedec	vɛɟɛt͡s
šachovnica	ʃaxɔu̯ɲit͡sa
ovca	ɔu̯t͡sa
motorka	mɔtɔrka
tadžik	tad͡ʒik
báseň	baːsɛɲ
baktéria	baktɛːria
danka	daŋka
bozk	bɔsk
iný	iniː
jednako	jeːdnako
najvyšší	najviʃʃiː
október	ɔktɔːbɛr
slovan	sɫɔvan
ulice	uʎit͡se
hniezdo	ɦɲi̯ɛzdɔ
pilier	pili̯ɛr
chameleón	xamɛlɛɔːn
meny	mɛni
blažej	bɫaʒɛj
doktoroch	dɔktɔrɔx
švédčina	ʃvɛːtt͡ʃina
minsk	minsk
smiech	smi̯ɛx
dav	daw
dobré	dɔbrɛː
chrabrý	xrabriː
pomaranč	pɔmarant͡ʃ
hodžová	hɔd͡ʒɔvaː
slnečný	sɫ̩ɲɛt͡ʃniː
heda	ɦɛda
vypínať	vipiːnac
ema	ɛma
meranie	mɛraɲi̯ɛ
utešený	ucɛʃɛniː
papraď	paprac
odborníčka	ɔdbɔrɲiːt͡ʃka
kameň	kamɛɲ
richard	rixart
listu	listu
živočích	ʒivɔt͡ʃiːx
aktínium	aktiːnium
olive	ɔlivɛ
melánia	mɛɫaːnia
mesiačik	mɛsi̯at͡ʃik
šofér	ʃɔfɛːr
cestovina	t͡sɛstɔvina
cyril	t͡siriɫ
smäd	smæt
dážďovka	daːʒɟɔu̯ka
jačmeň	jat͡ʃmɛɲ
krava	krava
áno	aːnɔ
dcérka	t͡sɛːrka
slovensky	sɫɔvɛnski
almanach	almanax
spálňa	spaːɫɲa
mäkký	mækiː
lož	lɔʃ
kde	ɡɟɛ
tibetčina	tibɛtt͡ʃina
plávať	pɫaːvac
slivovica	slɪvovɪtsa
ringlota	riŋɡɫɔta
mier	mi̯ɛr
hassium	ɦasium
vädnúť	vɛdnuːc
cesnak	t͡sɛsnak
krajinu	krajinu
med	mɛt
premiéra	prɛmiɛːra
rené	rɛnɛː
žĺtkový	ʒɫ̩ːtkɔviː
zoja	zɔja
ľahký	ʎaxkiː
mater	macɛr
bara	bara
múch	muːx
súlož	suːɫɔʃ
lea	lɛa
istý	istiː
mních	mɲiːx
viezť	vi̯ɛsc
jazdec	jazɟɛt͡s
lietať	li̯ɛtac
prazeodým	prazɛɔdiːm
dom	dɔm
čiapka	t͡ʃi̯apka
brány	braːni
smrekovec	smrɛkɔvɛt͡s
sekunda	sɛkunda
vidieť	viɟi̯ɛc
kilo	kiɫɔ
suka	suka
oblasť	ɔbɫasc
naďalej	naɟalɛj
ponuka	pɔnuka
láva	ɫaːva
paládium	paɫaːdium
jazykovedec	jazikɔvɛɟɛt͡s
lesbický	lɛzbit͡skiː
galaxiách	ɡalaksiaːx
pazucha	pazuxa
chlór	xɫɔːr
číňanka	t͡ʃiːɲaŋka
ľad	ʎat
väčší	vɛt͡ʃʃi
kňaz	kɲas
alánd	aɫaːnt
kľuka	kʎuka
karina	karina
lift	lift
srbský	sr̩pskiː
jabĺčok	jabɫ̩ːt͡ʃok
uliciach	uɫit͡si̯ax
sviečkami	svi̯ɛt͡ʃkami
cestár	t͡sɛstaːr
cisárstvo	t͡sisaːrstvɔ
kmeňmi	kmɛɲmi
žurnalista	ʒurnalista
valaška	vaɫaʃka
užívateľ	uʒiːvacɛʎ
právd	praːvd
cudová	t͡sudɔvaː
švédka	ʃʋeːtka
lužica	ɫuʒit͡sa
wikipédia	vikipɛːdia
cézium	tseːzium
krídlo	kriːdɫɔ
győr	ɟøːr
molybdén	mɔlibdɛːn
kukulienka	kukuli̯ɛŋka
andrej	andrɛj
pomalý	pɔmaliː
ročný	rɔt͡ʃniː
ubehlík	ubɦɛliːk
menej	meɲej
gýč	ɡiːt͡ʃ
hafnium	ɦafnium
šiesty	ʃi̯ɛsti
rak	rak
ozeáš	ɔzɛaːʃ
jantárový	jantaːrɔviː
koreňa	kɔrɛɲa
svoj	svɔj
rím	riːm
testosterón	tɛstɔstɛrɔːn
zväz	zʋæs
bielizník	bi̯ɛlizɲiːk
ä	e
starký	starkiː
chromozóm	xrɔmɔzɔːm
svetový	svɛtɔviː
ľubor	ʎubɔr
pomoc	pɔmɔt͡s
vitamín	vitamiːn
rusko	ruskɔ
turizmus	turizmus
fínčina	fiːnt͡ʃina
rodina	rɔɟina
hovädina	ɦɔvæɟina
detí	ɟɛciː
pšenica	pʃɛɲit͡sa
rímsky	riːmski
najlepší	najlɛpʃiː
dve	dvɛ
svokor	svɔkɔr
matkin	matkin
múr	muːr
temnota	cɛmnɔta
ich	ix
vlčica	vɫ̩t͡ʃit͡sa
hrýzť	ɦriːsc
dĺžeň	dɫ̩ːʒɛɲ
žlna	ʒɫ̩na
strachmi	straxmi
pavol	pavɔɫ
vratko	vratkɔ
zubár	zubaːr
vladimíra	vɫaɟimiːra
vojačik	vɔjat͡ʃik
afriku	afriku
obtiažny	ɔbci̯aʒni
prokop	prɔkɔp
triezvy	tri̯ɛzvi
jazvec	jazvɛt͡s
urgentný	urɡɛntniː
jedový	jɛdɔviː
island	islant
ľubica	ʎubit͡sa
dobrých	dɔbriːx
lídra	liːdra
kopernikium	kɔpɛrnikium
kupovať	kupɔvac
sviečkou	svi̯ɛt͡ʃkɔu̯
hrach	ɦrax
kmeňu	kmɛɲu
víno	viːnɔ
helga	ɦɛɫɡa
ľudomil	ʎudɔmiɫ
medvedica	mɛdvɛɟit͡sa
alojz	aɫɔjs
dávid	daːvit
cibuľa	t͡sibuʎa
siedmy	si̯ɛdmi
krhla	kr̩ɦla
pančucha	pant͡ʃuxa
výskum	viːskum
pätica	pɛcit͡sa
čechy	t͡ʃɛxi
mineralógia	minɛraɫɔːɡia
ligotať	liɡɔtac
sveťo	svɛcɔ
lietadlo	li̯ɛtadɫɔ
pohlavie	pɔɦɫavi̯ɛ
čiaročka	t͡ʃi̯arɔt͡ʃka
hnedý	ɦɲɛdiː
rajčina	rajt͡ʃina
drahokam	draɦɔkam
esbjerg	ɛzbjɛr
zmrzlina	zmr̩zʎina
alica	alit͡sa
čerešňa	t͡ʃɛrɛʃɲa
šakal	ʃakaɫ
mária	maːria
mäta	mɛta
ovocie	ɔvɔt͡si̯ɛ
blahoslav	bɫaɦɔsɫau̯
bohatý	bɔɦatiː
vyhodnotiť	viɦɔdnɔcic
tálium	taːlium
gaskonsko	ɡaskɔnskɔ
fajka	fajka
mak	mak
vďačný	vɟat͡ʃniː
kapitalistický	kapitalisciskiː
mäsiar	mɛsi̯ar
dŕžavní	dr̩ːʒavniː
strachoch	straxox
pomôcť	pɔmu̯ɔt͡sc
dedinôčka	ɟɛɟinu̯ɔt͡ʃka
stretnúť	strɛtnuːc
feudalizmus	fɛu̯dalizmus
černoch	t͡ʃɛrnɔx
győrsky	ɟeːrski
sirôtka	siru̯ɔtka
hrivna	ɦrivna
gazdiná	ɡazɟinaː
lívia	liːvia
sebe	sɛbɛ
karpaty	karpati
päta	pɛta
agáta	aɡaːta
vdovám	vdɔvaːm
pestrý	pɛstriː
ani	aɲi
uhlík	uɦʎiːk
dostať	dɔstac
handra	ɦandra
klobása	kɫɔbaːsa
ôsmy	u̯osmi
väčšina	vɛt͡ʃʃina
kotol	kɔtɔɫ
protaktínium	prɔtaktiːnium
ródium	rɔːdium
dolinôčka	dɔlinu̯ɔt͡ʃka
berkélium	bɛrkɛːlium
lienka	li̯ɛŋka
faerčina	faɛrt͡ʃina
jarolím	jarɔliːm
návrh	naːvr̩x
filozofia	filɔzɔfia
xénia	kseːnia
sluch	sɫux
pipík	pipiːk
kmeni	kmɛɲi
ångström	ankstrem
bianka	bi̯aŋka
merkúr	mɛrkuːr
slovenka	sɫɔvɛŋka
krásne	kraːsnɛ
segment	seɡment
domov	dɔmɔu̯
smäd	smɛt
hranica	ɦraɲit͡sa
ukrajinský	ukrajinskiː
aktivovať	aktivovac
sôvä	su̯ɔvæ
rudo	rudɔ
smotana	smɔtana
umrieť	umri̯ɛc
otecko	ɔcɛt͡skɔ
ostrov	ostrou̯
ujček	ujt͡ʃɛk
prepáčiť	prɛpaːt͡ʃic
mašina	maʃina
škatuľa	ʃkatuʎa
panpsychizmus	panpsixizmus
noviny	nɔvini
američan	amɛrit͡ʃan
ručička	rut͡ʃit͡ʃka
žíla	ʒiːɫa
denník	ɟɛnɲiːk
faerčanka	faɛrt͡ʃaŋka
bystrý	bistriː
pravoslav	pravɔsɫau̯
chodiť	xɔɟic
snežiť	sɲɛʒic
blanka	bɫaŋka
krvavnica	kr̩vau̯ɲit͡sa
rodinný	rɔɟinniː
víťazstvo	viːcasstvɔ
fám	faːm
menu	mɛnu
fén	fɛːn
ráz	raːs
jaroslav	jarɔsɫau̯
žinčica	ʒint͡ʃit͡sa
slovníkmi	sɫoʋɲiːkmi
ceruzka	t͡sɛruska
titán	titaːn
anglicko	aŋɡlit͡skɔ
chí	xiː
kovu	kɔvu
dobrí	dɔbriː
tretí	trɛciː
srdcom	sr̩t͡sɔm
štefan	ʃcɛfan
vdovách	vdɔvaːx
odpoludnie	ɔtpɔɫudɲi̯ɛ
aurélia	au̯rɛːlia
margaréta	marɡare̞ːta
príroda	priːrɔda
keňa	kɛɲa
mapa	mapa
čujný	t͡ʃujniː
silvia	siɫvia
ihrisko	iɦriskɔ
chrbát	xr̩baːt
jüan	jyan
fruštik	fruʃtik
ženami	ʒɛnami
hrdinov	ɦr̩ɟinɔu̯
fermium	fɛrmium
svätý	svetiː
sovietsky	sɔvi̯ɛtski
zázrak	zaːzrak
korytnačka	kɔritnat͡ʃka
kat	kat
somarina	sɔmarina
so	sɔ
cyprián	t͡sipriaːn
knieža	kɲi̯ɛʒa
ingrida	iŋɡrida
štiny	ʃcini
ľudmila	ʎudmiɫa
riti	rici
spojka	spɔjka
henten	ɦɛntɛn
škrečok	ʃkrɛt͡ʃɔk
rozum	rɔzum
jazier	jazi̯er
chrumkavý	xrumkaviː
koľaj	kɔʎaj
československo	t͡ʃɛskɔsɫɔvɛnskɔ
hortenzia	ɦɔrtɛnzia
číselný	t͡ʃiːsɛɫniː
zima	zima
ukrajina	ukrajina
myšlienka	miʃli̯ɛŋka
kukučka	kukut͡ʃka
jaseň	jasɛɲ
platina	pɫatina
pažerák	paʒɛraːk
vdovu	vdɔvu
tadžikistan	tad͡ʒikistan
kurence	kurɛnt͡sɛ
francúzština	frant͡suːsʃcina
jahňa	jaɦɲa
zelenina	zɛlɛɲina
sestra	sɛstra
króna	kroːna
segedín	sɛɡɛdiːn
vlha	ʋɫ̩ɦa
oblička	ɔblit͡ʃka
pešiak	pɛʃi̯ak
mäte	mɛcɛ
bryndza	brind͡za
bežať	bɛʒac
jebať	jɛbac
ja	ja
iskra	iskra
veko	vɛkɔ
jadro	jadrɔ
machiavelizmus	makiavɛlizmus
vlásočnica	vɫaːsɔt͡ʃɲit͡sa
gabriel	ɡabriɛɫ
olivám	ɔlivaːm
bárium	baːrium
obed	ɔbɛt
ivica	ivit͡sa
rasťo	rascɔ
hrdinovi	ɦr̩ɟinɔvi
srvátka	sr̩vaːtka
tepať	cɛpac
prinútiť	prinuːcic
rušeň	ruʃɛɲ
pravdu	pravdu
pane	paɲɛ
poľnohospodárstvo	pɔʎnɔɦɔspɔdaːrstvɔ
škótsko	ʃkɔːtskɔ
leu	lɛu̯
mzda	mzda
žubrienka	ʒubri̯ɛŋka
psychológia	psixɔɫɔːɡia
priateľ	pri̯acɛʎ
princezná	print͡sɛznaː
zemepis	zɛmɛpis
jed	jɛt
peržan	pɛrʒan
malina	malina
dominik	dɔminik
autostráda	au̯tɔstraːda
kôš	ku̯oʃ
tri	tri
sýrsky	siːrski
skrutkovač	skrutkɔvat͡ʃ
bruchomluvec	bruxɔmluvɛt͡s
baník	baɲiːk
dosiaľ	dɔsi̯aʎ
streda	streda
zemi	zemi
simona	simɔna
súrne	suːrɲɛ
dobre	dɔbrɛ
hod	ɦɔt
luxembursko	ɫuksɛmburskɔ
štopeľ	ʃtɔpɛʎ
chrípka	xriːpka
miroslav	mirɔsɫau̯
egypťan	ɛɡipcan
polabčina	pɔɫapt͡ʃina
katapultu	katapuɫtu
materský	macɛrskiː
žriebäcí	ʒri̯ɛbæt͡siː
reštaurácia	rɛʃtau̯raːt͡sia
hrdinami	ɦr̩ɟinami
matematika	matɛmatika
domorodec	dɔmɔrɔɟɛt͡s
akýkoľvek	akiːkɔʎvɛk
miest	mi̯est
bisexualita	bisɛksualita
informovať	infɔrmɔvac
lutécium	ɫutɛːt͡sium
jelša	jɛɫʃa
dobromil	dɔbrɔmiɫ
psica	psit͡sa
uliciach	uʎit͡si̯ax
nacionalistický	nat͡siɔnalistit͡skiː
tamara	tamara
dcérenka	t͡sɛːrɛŋka
kniha	kɲiɦa
dorota	dɔrɔta
yeti	jeti
riziko	rizikɔ
pedagogika	pɛdaɡɔɡika
napríklad	napriːkɫat
teodor	tɛɔdɔr
kyjev	kijɛu̯
hodina	ɦɔɟina
oblok	ɔbɫɔk
sex	sɛks
daň	daɲ
sviečku	svi̯ɛt͡ʃku
machuľa	maxuʎa
vdove	vdɔvɛ
visla	visɫa
iskrička	iskrit͡ʃka
kuna	kuna
zlato	zɫatɔ
kača	kat͡ʃa
platiť	pɫacic
najmä	najmɛ
zlodej	zɫɔɟɛj
piesok	pi̯ɛsɔk
noe	nɔɛ
gašpar	ɡaʃpar
afrika	afrika
jesenný	jɛsɛnniː
človek	t͡ʃɫɔvɛk
viedenský	vi̯ɛɟɛnskiː
zažať	zaʒac
runa	runa
biológia	biɔɫɔːɡia
guľa	ɡuʎa
zachmúrený	zaxmuːrɛniː
listom	listɔm
myší	miʃiː
nemý	ɲɛmiː
vápnik	ʋaːpɲik
juraj	juraj
verejný	vɛrɛjniː
obdĺžnik	ɔbdɫ̩ːʒɲik
dýchať	diːxac
tesť	cɛsc
drevo	drɛvɔ
čech	t͡ʃɛx
dani	daɲi
skald	skaɫt
ľadnička	ʎadɲit͡ʃka
chodidlo	xɔɟidɫɔ
svastika	svastika
módny	mɔːdni
atrament	atramɛnt
dub	dup
pat	pat
kraji	kraji
celiakia	t͡sɛliakia
ligurček	liɡurt͡ʃɛk
zľava	zʎava
autu	au̯tu
archeológia	arxɛɔɫɔːɡia
dobrou	dɔbrɔu̯
povaha	pɔvaɦa
maslo	masɫɔ
albánčina	aɫbaːnt͡ʃina
kaviarnička	kavi̯arɲit͡ʃka
marek	marɛk
apríl	apriːɫ
predsa	prɛtsa
mŕtvy	mr̩ːtvɪ
juh	jux
koleno	kɔlɛnɔ
autách	au̯taːx
alkoholický	alkɔhɔlit͡skiː
anjel	aɲi̯ɛɫ
celebrita	t͡sɛlɛbrita
sestrin	sɛstrin
letný	lɛtniː
straka	straka
seaborgium	siːbɔrɡium
vôľa	vu̯ɔʎa
kristo	kristɔ
peťo	pɛcɔ
gadolínium	ɡadɔliːnium
chleba	xlɛba
čučoriedka	t͡ʃut͡ʃɔri̯ɛtka
zbožie	zbɔʒi̯ɛ
baníctvo	baɲiːt͡svɔ
harmanček	ɦarmant͡ʃɛk
parochňa	parɔxɲa
grék	ɡrɛːk
dvaja	dvaja
praha	praɦa
paríž	pariːʃ
samovražda	samɔvraʒda
jarmulka	jarmuɫka
eugénia	ɛu̯ɡɛːnia
ryšavec	riʃavɛt͡s
janko	jaŋkɔ
dedo	ɟɛdɔ
chuligán	xuliɡaːn
pštrosí	pʃtrɔsiː
gauč	ɡau̯t͡ʃ
katarína	katariːna
zo	zɔ
nitra	ɲitra
islam	isɫam
milena	milɛna
ona	ɔna
kosť	kɔsc
lukáš	ɫukaːʃ
joga	jɔɡa
priehlavok	pri̯ɛɦɫavɔk
kaleráb	kaleraːp
vrátiť	vraːcic
duša	duʃa
zabudnúť	zabudnuːc
íver	iːvɛr
sobota	sɔbɔta
lotyšsko	ɫɔtiʃskɔ
zunovaný	zunɔvaniː
cestovateľ	t͡sɛstɔvacɛʎ
daniela	daɲiela
holubí	ɦɔɫubiː
možnosť	mɔʒnɔsc
ostrihom	ɔstriɦɔm
mladá	mɫadaː
derviš	dɛrviʃ
jednom	jednom
hentam	ɦɛntam
bystrík	bistriːk
florida	florida
počasie	pɔt͡ʃasi̯ɛ
dube	dubɛ
milovať	miɫɔvac
roland	rɔɫant
tekvica	cɛkvit͡sa
liva	liva
nôž	nu̯oʃ
pozdĺž	pɔzdɫ̩ːʃ
činnosť	t͡ʃinnɔsc
chémia	xɛːmia
elektromagnetický	ɛlɛktrɔmaɡnɛtit͡skiː
nezábudka	ɲɛzaːbutka
doteraz	dɔtɛras
on	ɔn
rumunsko	rumunskɔ
opát	ɔpaːt
škót	ʃkɔːt
breh	brɛx
preč	prɛt͡ʃ
auta	au̯ta
železo	ʒeɫezɔ
kvark	kvark
alexander	alɛksandɛr
tichomír	cixɔmiːr
zvyšný	zviʃniː
hrozný	ɦrɔzniː
nerozumiem	ɲɛrɔzumi̯ɛm
ženy	ʒeni
duše	duʃɛ
šopron	ʃɔprɔn
auto	au̯tɔ
záhreb	zaːɦrɛp
panna	panna
číňan	t͡ʃiːɲan
estónsko	ɛstɔːnskɔ
fedor	fɛdɔr
chlapovi	xɫapɔvi
sliepočka	sli̯ɛpɔt͡ʃka
margarétka	marɡareːtka
narodeniny	narɔɟɛɲini
győrsky	ɟøːrski
koniec	kɔɲi̯ɛt͡s
alžbeta	aɫʒbɛta
dlhý	dl̩ɦiː
dymov	dimɔu̯
fínsky	fiːnski
krásne	kraːsɲɛ
akuzatív	akuzatiːu̯
očko	ɔt͡ʃkɔ
schéma	sxɛːma
schopnosť	sxɔpnɔsc
portugalčina	pɔrtuɡaɫt͡ʃina
baba	baba
potrebný	pɔtrɛbniː
jarmila	jarmiɫa
krakov	krakou̯
listami	listami
gazdinka	ɡazɟiŋka
návrhy	naːvr̩ɦi
klamár	kɫamaːr
krone	krɔnɛ
pštros	pʃtrɔs
osa	ɔsa
iránsky	iraːnski
patrícia	patriːt͡sia
vieroslava	vi̯ɛrɔsɫava
márnica	maːrɲit͡sa
zvuk	zvuk
dedinčan	ɟɛɟɪntʃan
svet	svɛt
samoa	samɔa
krajinou	krajinou̯
tupý	tupiː
čln	t͡ʃɫ̩n
em	ɛm
črta	t͡ʃr̩ta
alexej	alɛksɛj
kašľať	kaʃlac
obťažný	ɔpcaʒniː
valašsko	vaɫaʃskɔ
toho	tɔɦɔ
deti	ɟɛci
kráčať	kraːt͡ʃac
brucho	bruxɔ
jen	jɛn
dominika	dɔminika
tlačovka	tɫat͡ʃɔu̯ka
röntgen	rɛntɡɛn
hrdzavý	ɦr̩d͡zaviː
miesto	mi̯ɛstɔ
netopier	ɲɛtɔpi̯ɛr
päsť	pɛsc
čssr	t͡ʃɛːɛsɛsɛr
francium	frant͡sium
nepriateľ	ɲɛpri̯acɛʎ
uško	uʃkɔ
chlapa	xɫapa
hoci	ɦɔt͡si
ryšiak	riʃi̯ak
regína	rɛɡiːna
tenký	cɛŋkiː
farbu	farbu
žurnalistika	ʒurnalistika
zemetrasenie	zɛmɛtrasɛɲi̯ɛ
rozmaznaný	rɔzmaznaniː
katovice	katovit͡se
káhira	kaːɦira
valentína	valɛntiːna
júlia	juːlia
kým	kiːm
mikrobus	mikrɔbus
rezance	rɛzant͡sɛ
kíl	kiːɫ
pravde	prau̯ɟɛ
móric	mɔːrit͡s
servác	sɛrvaːt͡s
lamí	ɫamiː
ferdinand	fɛrdinand
počúvať	pɔt͡ʃuːvac
antimón	antimɔːn
chlapoch	xɫapɔx
lama	ɫama
alkoholik	aɫkɔɦɔlik
klobúčik	kɫɔbuːt͡ʃik
upratať	upratac
božena	bɔʒɛna
koloman	kɔɫɔman
plat	pɫat
prajazyk	prajazik
deista	dɛista
kašeľ	kaʃɛʎ
nováčik	nɔvaːt͡ʃik
hedviga	ɦɛdviɡa
ivana	ivana
svätý	svætiː
fjord	fjɔrd
súper	suːpɛr
pálenka	paːlɛŋka
cicavec	t͡sit͡savɛt͡s
egyptský	ɛɡiptskiː
sloveso	sɫɔvɛsɔ
dievčinka	ɟi̯ɛu̯t͡ʃiŋka
malajec	maɫajɛt͡s
ponorka	pɔnɔrka
červený	t͡ʃɛrvɛniː
murár	muraːr
skrutka	skrutka
sudety	sudɛti
básnik	baːsɲik
pes	pɛs
jrd	jɛːɛrdɛː
belgicko	bɛɫɡit͡ʃkɔ
totalitarizmus	tɔtalitarizmus
stolička	stɔlit͡ʃka
príklad	priːkɫat
oliver	ɔlivɛr
londýn	ɫɔndiːn
bosorák	bɔsɔraːk
počas	pɔt͡ʃas
adamoch	adamɔx
mláďa	mɫaːɟa
fakt	fakt
doktorom	dɔktɔrɔm
vlasta	vɫasta
žriebä	ʒri̯ebe
kôrovec	ku̯ɔrɔvɛt͡s
lucia	ɫut͡sia
sloj	sɫɔj
portugalsko	pɔrtuɡaɫskɔ
žirafa	ʒirafa
nemka	ɲɛmka
paprika	paprika
špageta	ʃpaɡɛta
foxtrot	fɔkstrɔt
galaxie	ɡalaksie
hmla	ɦmɫa
črevo	t͡ʃrɛvɔ
hovädzí	ɦɔvɛd͡ziː
brat	brat
kaviareň	kavi̯arɛɲ
hoľa	ɦoʎa
požičať	pɔʒit͡ʃac
adamov	adamɔu̯
klenoty	klɛnɔti
tangá	taŋɡaː
priestor	pri̯ɛstɔr
jaromír	jarɔmiːr
kyslík	kisliːk
holí	ɦɔʎiː
obor	ɔbɔr
slabý	sɫabiː
iba	iba
mat	mat
vdovou	vdɔvɔu̯
kyselina	kisɛlina
garbiar	ɡarbi̯ar
dubu	dubu
hákelling	hɔɑt͡ʃʰɛtlɪŋk
zröntgenovať	zrœntɡɛnɔvac
moja	mɔja
klaudia	kɫau̯dia
pekný	pɛkniː
cintorín	t͡sintɔriːn
annu	annu
viliam	viliam
mravec	mravɛt͡s
kokot	kɔkɔt
dobrej	dɔbrɛj
mene	mɛɲɛ
zlatica	zɫacit͡sa
filoména	filɔmɛːna
albína	aɫbiːna
andrea	andrɛa
shetlandský	ʃɛtlɛndskiː
cunami	t͡sunami
otília	ɔtiːlia
jašterička	jaʃcɛrit͡ʃka
grínd	ɡriːnt
sujet	suʒɛt
mačka	mat͡ʃka
chlapom	xɫapɔm
iľja	iʎja
javor	javor
neskôr	ɲɛsku̯ɔr
potok	pɔtɔk
bábika	baːbika
takýto	takiːtɔ
kov	kɔu̯
oskár	ɔskaːr
chuj	xuj
ľubomíra	ʎubɔmiːra
telu	cɛɫu
halier	ɦaʎi̯ɛr
častí	t͡ʃasciː
diabol	ɟi̯abɔɫ
otrok	ɔtrɔk
riaditeľ	ri̯aɟicɛʎ
plameň	pɫamɛɲ
ohúriť	ɔɦuːric
socializmus	sɔt͡sializmus
všetok	fʃɛtɔk
čítať	t͡ʃiːtac
policajt	pɔlit͡sajt
púšť	puːʃc
kríza	kriːza
kupola	kupɔɫa
zrelý	zrɛliː
jedným	jedniːm
žriebä	ʒri̯ebæ
bača	bat͡ʃa
oľga	ɔʎɡa
koľko	kɔʎkɔ
príchod	priːxɔt
kurča	kurt͡ʃa
panenský	paɲɛnskiː
áut	aːu̯t
vavrinec	vavriɲɛt͡s
vankúš	vaŋkuːʃ
slnce	sɫ̩nt͡sɛ
irídium	iriːdium
bruško	bruʃkɔ
arzén	arzɛːn
stanislava	staɲisɫava
striga	striɡa
program	prɔɡram
žalúdok	ʒaɫuːdɔk
zapnúť	zapnuːc
nové	nɔvɛː
zámok	zaːmɔk
reč	rɛt͡ʃ
scípio	st͡siːpiɔ
kráľ	kraːʎ
okabátiť	ɔkabaːcic
herkules	ɦɛrkulɛs
keďže	kɛd͡ʒɛ
krištof	kriʃtɔf
mráčik	mraːt͡ʃik
európsky	ɛu̯rɔːpski
materinský	macɛrinskiː
bratislavy	bracisɫavi
milý	miliː
hlboký	ɦɫ̩bɔkiː
izba	izba
ťava	cava
tele	cɛlɛ
strukoviny	strukɔvini
paulína	pau̯liːna
maximilián	maksimiliaːn
dobrom	dɔbrɔm
spln	spɫ̩n
katapultoch	katapuɫtɔx
lastúrničiar	ɫastuːrɲit͡ʃi̯ar
lastovička	ɫastɔvit͡ʃka
spať	spac
nádražiach	naːdraʒi̯ax
črep	t͡ʃrɛp
vrana	vrana
behať	bɛɦac
dobrými	dɔbriːmi
kazachstan	kazaxstan
otcovský	ɔtt͡sɔu̯skiː
bratislave	bracisɫavɛ
jožo	jɔʒɔ
holúbä	ɦɔɫuːbɛ
kilogram	kiɫɔɡram
lídroch	liːdrɔx
bližší	bliʃʃiː
embólia	ɛmbɔːlia
nacistický	nat͡sistit͡skiː
kosa	kɔsa
kapilára	kapiɫaːra
orol	ɔrɔɫ
čeština	t͡ʃɛʃcina
milan	miɫan
pavúčí	pavuːt͡ʃiː
galina	ɡalina
whisky	ʋiski
dalibor	dalibɔr
trona	trɔna
nika	nika
žať	ʒac
varšava	ʋarʃaʋa
priateľka	pri̯acɛʎka
starček	start͡ʃɛk
vidlička	vidʎit͡ʃka
národ	naːrɔt
ozajstný	ɔzajstniː
aids	ajt͡s
žiačík	ʒi̯at͡ʃiːk
prečo	pretʃo
klement	klɛmɛnt
žni	ʒɲi
pečiatka	pɛt͡ʃi̯atka
aids	aːiːdɛːɛs
vrša	vr̩ʃa
livermorium	livɛrmɔrium
urobiť	urɔbic
tobôž	tɔbu̯ɔʃ
svete	svɛcɛ
had	ɦat
rumunčina	rumunt͡ʃina
duboch	dubɔx
ľuba	ʎuba
kristián	kristiaːn
jód	joːt
henrich	ɦɛnrix
krajom	krajom
alfonz	aɫfɔns
list	list
čaj	t͡ʃaj
vrátane	vraːtanɛ
tvaroh	tvarɔx
peniaze	pɛɲi̯azɛ
dardanely	dardanɛli
šiška	ʃiʃka
členok	t͡ʃlɛnɔk
hodža	hɔd͡ʒa
lenka	lɛŋka
vroclav	ʋrɔt͡sɫaw
bohumír	bɔɦumiːr
vlastný	vɫastniː
tatry	tatri
piano	pianɔ
ak	ak
mias	mi̯as
fazuľa	fazuʎa
koreňom	kɔrɛɲɔm
cnosť	t͡snɔsc
pondelok	pɔnɟɛɫɔk
poznaň	pɔznaɲ
večes	ʋetʃes
lesť	lɛsc
syntaxe	sintaksɛ
kolibrík	kɔlibriːk
justína	justiːna
jaternica	jacɛrɲit͡sa
riť	ric
próza	pro̞ːza
ťažký	caʃkiː
vdovy	vdɔvi
koreňmi	kɔrɛɲmi
bronislava	brɔɲislava
odhodlaný	odɦodlaniː
alibi	alibi
kmene	kmɛɲɛ
tokio	tɔkiɔ
srať	srac
grinda	ɡrinda
norbert	nɔrbɛrt
desiaty	ɟɛsi̯ati
jedného	jedneːɦo
drahoslav	draɦɔsɫau̯
afriky	afriki
váh	vaːx
zápcha	zaːpxa
viesť	vi̯ɛsc
opustiť	ɔpuscic
homosexualita	ɦɔmɔsɛksualita
snob	snɔp
loď	ɫɔc
angström	aŋɡstrɛm
vendelín	vɛndɛliːn
teta	cɛta
desať	ɟɛsac
hermína	ɦɛrmiːna
spŕška	spr̩ːʃka
erika	ɛrika
žiak	ʒi̯ak
kysličník	kislit͡ʃɲiːk
chlap	xlap
vrece	vrɛt͡sɛ
lechický	lɛxit͡skiː
nohavica	nɔɦavit͡sa
klamstvo	kɫamstvɔ
päta	pæta
polievka	pɔli̯ɛu̯ka
matka	matka
ahoj	aɦɔj
faerčan	faɛrt͡ʃan
páliť	paːlic
som	sɔm
snáď	snaːc
cech	t͡sɛx
storočie	storot͡ʃi̯e
turkyňa	turkiɲa
struk	struk
zeus	ze̞us
extáza	ɛkstaːza
záležitosť	zaːɫeʒitɔsc
neodým	nɛɔdiːm
chorvatistika	xɔrvatistika
ĺ	ɫ̩ː
strachy	straxi
synček	sint͡ʃɛk
oslobodiť	ɔsɫɔbɔɟic
strýc	striːt͡s
európu	ɛu̯rɔːpu
tanierik	taɲi̯ɛrik
podľa	pɔdʎa
ervín	ɛrviːn
šach	ʃax
narkomanka	narkɔmaŋka
fyzika	fizika
prezident	prɛzidɛnt
dunajec	dunajɛt͡s
technológia	tɛxnɔɫɔːɡia
pena	pɛna
nečujný	ɲɛt͡ʃujniː
nôžka	nu̯ɔʃka
štvrtý	ʃtvr̩tiː
ulica	uʎit͡sa
drahuša	drahuʃa
ľubľana	lʲublʲana
vrtuľník	vr̩tuʎɲiːk
škandinávie	ʃkandinaːviɛ
nielen	ɲi̯ɛlɛn
mesiac	mɛsi̯at͡s
horúci	ɦɔruːt͡si
delfín	dɛlfiːn
katapultov	katapuɫtɔu̯
ontogenéza	ɔntɔɡɛnɛːza
tlačiť	tɫat͡ʃic
svedomie	svɛdɔmi̯e
faktoch	faktox
ovčí	ɔu̯t͡ʃiː
žemľa	ʒɛmʎa
skorocel	skɔrɔt͡sɛɫ
pohľad	pɔɦʎat
tigris	tiɡris
osoby	ɔsɔbi
sepsa	sɛpsa
osemnásť	ɔsɛmnaːsc
galaxiami	ɡalaksiami
havran	ɦavran
móda	mɔːda
dievča	ɟi̯ɛu̯t͡ʃa
tuleň	tulɛɲ
socha	sɔxa
kryptón	kriptɔːn
ulicu	uɫit͡su
mitra	mitra
horúčava	ɦɔruːt͡ʃava
telefón	tɛlɛfɔːn
dubmi	dubmi
ty	ti
leto	lɛtɔ
počet	pɔt͡ʃɛt
pravda	prau̯da
pandeizmus	pandɛizmus
večera	vɛt͡ʃɛra
osôb	ɔsu̯op
esbjerg	ɛzbjɛrk
ctibor	t͡scibɔr
dcérsky	t͡sɛːrski
belasý	belasiː
dcéra	t͡sɛːra
september	sɛptɛmbɛr
víkend	ʋiːkent
monoteistický	mɔnɔtɛistit͡skiː
dušana	duʃana
nový	nɔviː
margita	marɡita
slovníkov	sɫoʋɲiːkou̯
architektúra	arxitɛktuːra
albín	aɫbiːn
tapeta	tapɛta
beňo	bɛɲɔ
podprsenka	pɔtpr̩sɛŋka
bieloruština	bi̯ɛɫɔruʃcina
znamenať	znamɛnac
mydlo	midɫɔ
bažant	baʒant
tvrdza	tvr̩d͡za
kočiš	kɔt͡ʃiʃ
nevädza	ɲɛvɛd͡za
škrupina	ʃkrupina
vetva	vɛtva
brazílski	braziːɫski
bukurešť	bukurɛʃc
ulíc	uɫiːt͡s
prsteň	pr̩scɛɲ
hnida	ɦɲida
taliančina	tali̯ant͡ʃina
samurajka	samurajka
liter	litɛr
motýľ	mɔtiːʎ
necht	ɲɛxt
počty	pɔt͡ʃti
podnikateľ	pɔdɲikacɛʎ
arnold	arnɔld
alan	aɫan
holub	ɦɔɫup
valach	vaɫax
sova	sɔva
voda	vɔda
novák	nɔvaːk
mozog	mɔzɔk
vdovami	vdɔvami
zmrzlina	zmr̩zɫina
hrudní	ɦrudniː
mrav	mrau̯
čaša	t͡ʃaʃa
inštrumentál	inʃtrumɛntaːɫ
bielizeň	bi̯ɛlizɛɲ
sirôtočka	siru̯ɔtɔt͡ʃka
homár	homaːr
že	ʒɛ
michal	mixaɫ
puma	puma
mliečny	mli̯ɛt͡ʃni
plamenček	pɫamɛnt͡ʃɛk
žiletka	ʒilɛtka
zoznam	zɔznam
metro	mɛtrɔ
gustáv	ɡustaːu̯
mládež	mɫaːɟɛʃ
raž	raʃ
bankovka	bankɔu̯ka
ves	ʋes
fotograf	fɔtɔɡraf
pani	paɲi
matematička	matɛmatit͡ʃka
renáta	rɛnaːta
zrno	zr̩nɔ
žgrloš	ʒɡr̩ɫɔs
pätnásť	pɛtnaːsc
lúka	ɫuːka
polievočka	pɔli̯ɛvɔt͡ʃka
albert	aɫbɛrt
stôl	stu̯ɔɫ
petra	pɛtra
dunajskí	dunajskiː
ornitológia	ɔrnitɔɫɔːɡia
sestrička	sɛstrit͡ʃka
maroš	marɔʃ
cárovič	t͡saːrɔvit͡ʃ
český	t͡ʃeskiː
erik	ɛrik
vďaka	vɟaka
hej	ɦɛj
ulica	uɫit͡sa
jún	juːn
jedna	jedna
databáza	databaːza
dánsko	daːnskɔ
pitjantjatjara	picancacara
mladý	mɫadiː
kôpor	ku̯ɔpɔr
sprcha	spr̩xa
dabing	dabiŋɡ
rad	rat
líce	liːt͡sɛ
dobrého	dɔbrɛːɦɔ
lečo	lɛt͡ʃɔ
klamať	kɫamac
xantipa	ksantipa
miriama	miriama
holandsko	ɦɔɫandskɔ
tibor	cibɔr
fakty	fakti
gibon	ɡibɔn
opica	ɔpit͡sa
budúci	buduːt͡si
cudzinka	t͡sud͡ziŋka
väčší	væt͡ʃʃi
nočný	nɔt͡ʃniː
američanka	amɛrit͡ʃaŋka
božtek	bɔʃcɛk
tanec	taɲet͡s
zlo	zɫɔ
braňa	braɲa
chorvátsko	xɔrvaːtskɔ
džbán	d͡ʒbaːn
ľudo	ʎudɔ
taliansko	tali̯anskɔ
chvost	xvɔst
kolegyňa	kɔlɛɡiɲa
deizmus	dɛizmus
rimanom	rimanɔm
gombík	ɡɔmbiːk
beátka	bɛaːtka
kraje	kraje
martina	martina
birmovka	birmɔu̯ka
finančný	finant͡ʃniː
írčina	iːrt͡ʃina
lídrami	liːdrami
listoch	listɔx
grónsko	ɡrɔːnskɔ
persefona	pɛrsɛfɔna
koreňu	kɔrɛɲu
mláďatko	mɫaːɟatkɔ
sviečok	svi̯ɛt͡ʃɔk
šáločka	ʃaɫɔt͡ʃka
cár	t͡saːr
mráz	mraːs
egypťanka	ɛɡipcanka
oslo	ɔsɫɔ
bolesť	bɔlɛsc
bernard	bɛrnard
povraz	pɔvras
chlapov	xɫapɔu̯
anaxagoras	anaksaɡoras
bohemizmus	bɔɦɛmizmus
sladký	sɫatkiː
starý	stariː
trhu	tr̩ɦu
shetlandy	ʃɛtlɛndi
záhada	zaːɦada
orgazmu	ɔrɡazmu
klišé	kliʃɛː
jablkový	jabɫ̩kɔviː
heliometer	ɦɛliɔmɛtɛr
ateizmus	atɛizmus
bedro	bɛːdrɔ
kobra	kɔbra
viola	viɔɫa
kremácia	krɛmaːt͡sia
kanada	kanada
okno	ɔknɔ
vtedy	ftɛdi
jablkách	jabɫ̩kaːx
slovo	sɫɔvɔ
všetci	fʃɛtt͡si
strojoch	strɔjɔx
ako	akɔ
ste	scɛ
niekoľko	ɲi̯ɛkɔʎkɔ
telo	cɛɫɔ
riečka	ri̯ɛt͡ʃka
sloní	sɫɔɲiː
nazdar	nazdar
terézia	tɛrɛːzia
jazda	jazda
boh	bɔx
katapulte	katapuɫcɛ
trávička	traːvit͡ʃka
noha	nɔɦa
meitnerium	mai̯tnɛrium
sendvič	sɛndvit͡ʃ
kvet	kvɛt
ťarchavý	carxaviː
oheň	ɔɦɛɲ
kalamár	kaɫamaːr
jedných	jedniːx
adamovi	adamɔvi
chlm	xɫ̩m
ženách	ʒɛnaːx
alena	alɛna
epir	ɛpir
my	mi
technécium	tɛxnɛːt͡sium
henrieta	ɦɛnri̯ɛta
helsinki	ɦɛɫsiŋki
štrajk	ʃtrajk
nemecký	ɲɛmɛt͡skiː
husí	ɦusiː
igor	iɡɔr
strmý	str̩miː
orlej	ɔrʎɛj
kapsula	kapsula
slovanský	sɫɔvanskiː
zoom	zuːm
červ	t͡ʃɛrw
anabela	anabɛɫa
adam	adam
džús	d͡ʒuːs
výnos	viːnɔs
bankami	baŋkami
slovníkoch	sɫoʋɲiːkox
dne	dɲɛ
chorobný	xɔrɔbniː
skupáň	skupaːɲ
vďačnosť	vɟat͡ʃnɔsc
rovnaký	rɔvnakiː
biotit	biotit
párny	paːrni
maltčina	maɫtt͡ʃina
uzbek	uzbek
rybár	ribaːr
malta	maɫta
slonica	slɔnit͡sa
štart	ʃtart
somár	sɔmaːr
bodka	bɔtka
klávesnica	kɫavɛsɲit͡sa
ulicou	uʎit͡sɔw
pieskoviská	pi̯ɛskɔviskaː
pipka	pipka
chudobný	xudɔbniː
ostriež	ɔstri̯ɛʃ
rytier	rici̯ɛr
ladislav	ɫaɟisɫau̯
jednoduchý	jɛdnɔduxiː
mezopotámia	mɛzɔpɔtaːmia
etymológia	ɛtimɔɫɔːɡia
bodnúť	bɔdnuːc
micheáš	mixɛaːʃ
fašistický	faʃistit͡skiː
srdiečko	sr̩ɟi̯ɛt͡ʃkɔ
lokomotíva	ɫɔkɔmɔtiːva
niób	niɔːp
stroje	strɔjɛ
začať	zat͡ʃac
tužka	tuʃka
jamôčka	jamu̯ɔt͡ʃka
najnižší	najɲiʃʃiː
mikuláš	mikuɫaːʃ
okna	ɔkna
vrkoč	vr̩kɔt͡ʃ
litovčina	litɔu̯t͡ʃina
vec	vɛt͡s
zelená	zɛlɛnaː
obláčik	ɔbɫaːt͡ʃik
cudzina	t͡sud͡zina
vychádzka	vixaːt͡ska
srdcu	sr̩t͡su
z	z
fidži	fid͡ʒi
čoskoro	t͡ʃɔskɔrɔ
lukostrelec	ɫukɔstrɛlɛt͡s
španielčina	ʃpaɲi̯ɛɫt͡ʃina
nebo	ɲɛbɔ
chýr	xiːr
ruda	ruda
druhý	druɦiː
múdrosť	muːdrɔsc
fliačik	fʎi̯at͡ʃik
elvíra	ɛlviːra
raňajkovať	raɲajkɔvac
pražan	praʒan
držať	dr̩ʒac
tiež	ci̯ɛʃ
uhorka	uɦɔrka
drahomír	draɦɔmiːr
vraní	vraɲiː
primusieť	primusi̯ɛc
kurva	kurva
ježiš	jɛʒiʃ
stela	stɛɫa
vodca	ʋɔt͡sːa
afrikou	afrikɔu̯
jednorožec	jɛdnɔrɔʒɛt͡s
xylofón	ksilɔfɔːn
prsia	pr̩si̯a
hier	ɦi̯er
košeľa	kɔʃɛʎa
vstupenka	fstupɛŋka
obrus	ɔbrus
mostík	mo̞sciːk
krk	kr̩k
bystrica	bistrit͡sa
flerovium	flɛrɔvium
zrak	zrak
vplyv	fpɫiw
lujza	ɫujza
doma	dɔma
triesočka	tri̯ɛsɔt͡ʃka
bunda	bunda
rumanček	rumant͡ʃɛk
iza	iza
lúč	ɫuːt͡ʃ
veľa	vɛʎa
galaxiám	ɡalaksiaːm
nahum	naɦum
písať	piːsac
ulici	uʎit͡si
párnokopytník	paːrnɔkɔpitɲiːk
česko	t͡ʃɛskɔ
rýchlosť	riːxlɔsc
bohyňa	boɦiɲa
deaktivovať	dɛaktivɔvac
do	dɔ
sobáš	sɔbaːʃ
rozhodnúť	rɔzɦɔdnuːc
hlahol	ɦɫaɦɔɫ
prešporok	prɛʃpɔrɔk
roh	rɔx
myšiu	miʃi̯u
čpavok	t͡ʃpavɔk
vaše	ʋaʃe
slovník	sloʋɲiːk
nehnuteľnosť	ɲɛɦnucɛʎnɔsc
žofia	ʒɔfia
jazierko	jazi̯ɛrkɔ
koza	kɔza
hradba	ɦradba
autom	au̯tɔm
cín	t͡siːn
autami	au̯tami
súostrovie	suːɔstrɔvi̯ɛ
pankrác	paŋkraːt͡s
terminológia	tɛrminɔɫɔːɡia
klus	kɫus
bezpečnosť	bɛspɛt͡ʃnɔsc
antisemita	antisɛmita
nemec	ɲɛmɛt͡s
albánsky	aɫbaːnski
zlatko	zɫatkɔ
jánov	jaːnɔu̯
viktória	viktɔːria
koreňoch	kɔrɛɲɔx
šamlík	ʃamliːk
rití	riciː
fujarôčka	fujaru̯ɔt͡ʃka
juno	junɔ
jebačka	jɛbat͡ʃka
európa	ɛu̯rɔːpa
strojom	strɔjɔm
lídri	liːdri
altruizmus	aɫtruizmus
štvrtok	ʃtvr̩tɔk
kúty	kuːti
práve	praːvɛ
andulka	anduɫka
dôležitý	du̯ɔlɛʒitiː
sláčik	sɫaːt͡ʃik
sviečky	svi̯ɛt͡ʃki
hovädzie	ɦɔvɛd͡zi̯ɛ
vanuatu	vanuatu
bejrút	bɛjruːt
kobru	kɔbru
jozue	jɔzuɛ
podpazušie	pɔtpazuʃi̯ɛ
sergej	sɛrɡɛj
život	ʒivɔt
röntgen	rœntɡɛn
bambus	bambus
kura	kura
neptúnium	nɛptuːnium
perspektíva	pɛrspɛktiːva
koreňov	kɔrɛɲɔu̯
vodič	vɔɟit͡ʃ
pršať	pr̩ʃac
žemlička	ʒɛmlit͡ʃka
srdcia	sr̩t͡si̯a
dubnium	dubnium
námestíčko	naːmɛsciːt͡ʃkɔ
víťazoslava	viːcazɔsɫava
zboží	zbɔʒiː
kmeňov	kmɛɲɔu̯
semeno	sɛmɛnɔ
kopije	kɔpijɛ
zdrobnenina	zdrɔbɲɛɲina
kôstkovina	ku̯ɔstkɔvina
kajak	kajak
július	juːlius
čínsky	t͡ʃiːnski
vtákopysk	ftaːkɔpisk
anežka	aɲɛʃka
autám	au̯taːm
práca	praːt͡sa
nepárnokopytník	ɲɛpaːrnɔkɔpitɲiːk
podmienka	pɔdmi̯ɛŋka
lenže	lɛnʒɛ
yterbium	itɛrbium
óda	ɔːda
doktormi	dɔktɔrmi
sušička	suʃit͡ʃka
litva	litva
chalan	xaɫan
správať	spraːvac
tráviaci	traːvi̯at͡si
kukurica	kukurit͡sa
tovar	tɔvar
jašterica	jaʃcɛrit͡sa
nikto	ɲiktɔ
svetu	svɛtu
slovníkom	sɫoʋɲiːkom
hrozienko	ɦrɔzi̯ɛŋkɔ
morča	mɔrt͡ʃa
ž	ʒ
izák	izaːk
jedny	jedni
meniny	mɛɲini
mužský	muʃskiː
fotogenický	fɔtɔɡɛnit͡skiː
more	mɔrɛ
deň	ɟɛɲ
írsko	iːrskɔ
dní	dɲiː
politik	pɔlitik
kobry	kɔbri
pieskovisko	pi̯ɛskɔviskɔ
marína	mariːna
španielsko	ʃpaɲi̯ɛɫskɔ
karolína	karɔliːna
prázdny	praːzdni
alka	aɫka
preukázať	prɛukaːzac
vypnúť	vipnuːc
tamhľa	tamɦʎa
dúha	duːɦa
žeriav	ʒɛri̯au̯
krajmi	krajmi
félix	fɛːliks
jesť	jɛsc
eleonóra	ɛlɛɔnɔːra
mantinel	mantinɛɫ
roztomilý	rɔstɔmiliː
rýchly	riːxli
sujet	syʒɛt
tágo	taːɡɔ
kríž	kriːʃ
heraldika	ɦɛraɫdika
dymoch	dimɔx
jarabica	jarabit͡sa
partizán	partizaːn
hlavný	ɦɫavniː
mliečko	mli̯ɛt͡ʃkɔ
zina	zina
treba	trɛba
epikuros	ɛpikurɔs
alebo	alɛbɔ
keď	kɛc
tmavý	tmaviː
čečensko	t͡ʃet͡ʃenskɔ
palác	paɫaːt͡s
pravdami	pravdami
angličtina	aŋɡlit͡ʃcina
curium	kyrium
bratislavou	bracisɫavɔu̯
júl	juːɫ
eduard	ɛduard
ytrium	itrium
tisíci	cisiːt͡si
vysvedčenie	ʋisʋett͡ʃeni̯e
rúž	ruːʃ
hilda	ɦiɫda
ázia	aːzia
príslovie	priːsɫɔvi̯ɛ
dvakrát	dvakraːt
ony	ɔni
dedinčanka	ɟɛɟint͡ʃaŋka
ďalekohľad	ɟalɛkɔɦʎat
pásomnica	paːsɔmɲit͡sa
vežička	vɛʒit͡ʃka
vietor	vi̯ɛtɔr
jogurtu	jɔɡurtu
nádražia	naːdraʒi̯a
kile	kilɛ
starec	starɛt͡s
dovolenka	dɔvɔlɛŋka
darmstadtium	darmʃtatium
malvína	maɫviːna
metla	mɛtɫa
rysy	risi
upír	upiːr
pamäť	pamæc
zmes	zmɛs
rozsobáš	rɔssɔbaːʃ
vlajočka	vɫajɔt͡ʃka
chlapec	xɫapɛt͡s
pieseň	pi̯eseɲ
ruksak	ruksak
vajce	vajt͡sɛ
dokázať	dɔkaːzac
nominatív	nɔminatiːu̯
baleáry	balɛaːri
bohumil	bɔɦumiɫ
námesačníctvo	naːmɛsat͡ʃɲiːt͡svɔ
rutherfordium	radzɛfɔrdium
nádražie	naːdraʒi̯ɛ
hviezda	ɦvi̯ɛzda
utorok	utɔrɔk
čad	t͡ʃat
žiačik	ʒi̯at͡ʃik
izidor	izidɔr
cica	t͡sit͡sa
uhličitý	uɦʎit͡ʃitiː
dunčo	dunt͡ʃɔ
lekár	lekaːr
kalifornium	kalifɔrnium
strážiť	straːʒic
jarmo	jarmɔ
ignác	iɡnaːt͡s
večer	vɛt͡ʃɛr
dubov	dubɔu̯
plece	plet͡se
líder	liːder
opilec	ɔpilɛt͡s
žene	ʒɛɲɛ
kečup	kɛt͡ʃup
rokov	rɔkɔu̯
kvapka	kvapka
pretekať	prɛcɛkac
smädný	smedniː
nórsko	nɔːrskɔ
fajčiar	fajt͡ʃi̯ar
ihličnan	iɦɫit͡ʃnan
röntgenovať	rœntɡɛnɔvac
olomoucký	olomou̯t͡skiː
drozd	drɔst
aljaška	alʲaʃka
roľa	rɔʎa
hrdina	ɦr̩ɟina
súkromný	suːkrɔmniː
bicykel	bit͡sikɛɫ
piatok	pi̯atok
temešvár	tɛmɛʃvaːr
starostlivosť	starɔstlivɔsc
fagot	faɡɔt
slávka	sɫaːu̯ka
černica	t͡ʃɛrɲit͡sa
monika	mɔnika
slovníky	sɫoʋɲiːki
koláč	koɫaːt͡ʃ
synáčik	sinaːt͡ʃik
morave	mɔravɛ
načervenkasto	nat͡ʃɛrvɛŋkastɔ
tlmočník	tɫ̩mɔt͡ʃɲiːk
nijaký	ɲijakiː
lopata	ɫɔpata
domáci	dɔmaːt͡si
kobalt	kɔbaɫt
osľa	ɔsʎa
pytón	pitɔːn
priečinok	pri̯ɛt͡ʃinɔk
piešťany	pi̯ɛʃcani
saša	saʃa
víchor	viːxɔr
valašský	vaɫaʃskiː
cesto	t͡sɛstɔ
kandidóza	kandidɔːza
ulicou	uɫit͡sɔw
determinant	dɛtɛrminant
čiapočka	t͡ʃi̯apɔt͡ʃka
chodník	xɔdɲiːk
exodus	ɛksɔdus
krokodíl	krɔkɔdiːɫ
vlaha	vɫaɦa
groznyj	ɡrɔzni
vedieť	vɛɟi̯ɛc
banán	banaːn
predkožka	prɛtkɔʃka
hadž	ɦat͡ʃ
pôvod	pu̯ɔvɔt
strojov	strɔjɔu̯
levoslav	lɛvɔsɫau̯
rabín	rabiːn
vanda	vanda
adrián	adriaːn
perzia	pɛrzia
dalimil	dalimiɫ
bomba	bɔmba
cól	t͡sɔːɫ
zápražka	zaːpraʃka
bulharčina	buɫɦart͡ʃina
česť	t͡ʃɛsc
sýria	siːria
nina	ɲina
číslo	t͡ʃiːsɫɔ
ruténium	rutɛːnium
tam	tam
parole	parɔɫ
urban	urban
dejepis	ɟɛjɛpis
matica	macit͡sa
teológia	tɛɔɫɔːɡia
rozmaznať	rɔzmaznac
adelka	adɛɫka
extáze	ɛkstaːzɛ
cér	t͡sɛːr
japončina	japɔnt͡ʃina
švédsko	ʃvɛːtskɔ
uliciam	uʎit͡si̯am
dobro	dobro
cigareta	t͡siɡarɛta
magnetický	maɡnɛtit͡skiː
kvetoslava	kvɛtɔsɫava
gregor	ɡrɛɡɔr
minca	mint͡sa
európium	ɛu̯rɔːpium
peň	pɛɲ
čo	t͡ʃɔ
oni	ɔɲi
šimpanz	ʃimpans
nahí	naɦiː
mangán	maŋɡaːn
chrúst	xruːst
amália	amaːlia
starena	starɛna
frederik	frɛdɛrik
chvíľočka	xviːʎɔt͡ʃka
mät	mɛt
tisa	cisa
spajvér	spajvɛːr
dáma	daːma
slnko	sɫ̩ŋkɔ
dobrú	dɔbruː
božidara	bɔʒidara
sôch	su̯ox
brusel	brusɛɫ
stále	staːlɛ
fajočka	fajɔt͡ʃka
štóla	ʃtɔːɫa
slovníku	sɫoʋɲiːku
chróm	xroːm
zmluva	zmɫuva
zomrieť	zɔmri̯ɛc
síra	siːra
jesienka	jɛsi̯ɛŋka
liste	liscɛ
šampión	ʃampiɔːn
viktor	viktɔr
meteorológia	mɛtɛɔrɔlɔːɡia
matúš	matuːʃ
nádraží	naːdraʒiː
petronela	pɛtrɔnɛɫa
cenník	t͡sɛnɲiːk
moľ	mɔʎ
ženám	ʒɛnaːm
kováč	kɔvaːt͡ʃ
emil	ɛmiɫ
sekera	sɛkɛra
belo	bɛɫɔ
náter	naːcɛr
priezvisko	pri̯ɛzviskɔ
ďateľ	ɟacɛʎ
nás	naːs
mendelevium	mɛndɛlɛvium
rys	ris
sakristia	sakristia
pochodovať	pɔxɔdɔvac
ženu	ʒenu
stalaktit	staɫaktit
niesť	ɲi̯ɛsc
aktualizácia	aktualizaːt͡sia
chladný	xɫadniː
striebro	stri̯ɛbrɔ
prvočíslo	pr̩vɔt͡ʃiːsɫɔ
spraviť	spravic
študent	ʃtudɛnt
viať	vi̯ac
hĺbkomer	ɦɫ̩ːpkɔmɛr
prasa	prasa
dvojitý	dvɔjitiː
adolf	adoɫf
čmeľ	t͡ʃmɛʎ
soňa	sɔɲa
hanoj	ɦanɔj
mexický	mɛksit͡skiː
časť	t͡ʃasc
ivona	ivɔn
tigriňa	tiɡriɲa
zunovať	zunɔvac
cieľ	t͡si̯ɛʎ
kúpeľ	kuːpɛʎ
základný	zaːkɫadniː
bonifác	bɔnifaːt͡s
cudzí	t͡sud͡ziː
politika	pɔlitika
lev	lɛu̯
sluha	sɫuɦa
pápež	paːpɛʃ
nepárny	ɲɛpaːrni
peha	pɛɦa
dvojbodka	dvɔjbɔtka
jozefína	jɔzɛfiːna
aute	au̯cɛ
tlstý	tɫ̩stiː
horší	ɦɔrʃiː
jeseň	jɛsɛɲ
čiže	t͡ʃiʒɛ
iračanka	irat͡ʃaŋka
benzínka	bɛnziːnka
amerícium	amɛriːt͡sium
agnesa	aɡnɛsa
cvikla	t͡svikla
sať	sac
utečenec	ucɛt͡ʃɛɲɛt͡s
hana	ɦana
žĺtok	ʒɫ̩ːtɔk
ŕ	r̩ː
oltár	oɫtaːr
tórium	tɔːrium
strela	strɛɫa
dubom	dubɔm
patriť	patric
šošovka	ʃɔʃɔu̯ka
určite	urt͡ʃicɛ
stromu	strɔmu
mestečko	mɛscɛt͡ʃkɔ
svadobný	svadɔbniː
telom	cɛɫɔm
čína	t͡ʃiːna
rudolf	rudɔɫf
jabĺk	jabɫ̩ːk
broskyňa	brɔskiɲa
adjektívum	adjɛktiːvum
ker	kɛr
okrem	ɔkrɛm
sedemnásť	sɛɟɛmnaːsc
kto	kto̞
lebo	lɛbɔ
zvyšok	zviʃɔk
siaha	si̯aɦa
vlkolak	vɫ̩kɔɫak
hodža	ɦɔd͡ʒa
dŕžava	dr̩ːʒava
emanuel	ɛmanuɛɫ
túlium	tuːlium
ujo	ujɔ
shetland	ʃɛtlɛnt
kohútik	kɔɦuːcik
hrdinoch	ɦr̩ɟinɔx
vagína	vaɡiːna
ulicami	uɫit͡sami
leopold	lɛɔpɔld
kórea	kɔːrɛa
východ	viːxɔt
olivu	ɔlivu
vaňa	vaɲa
cencúľ	t͡sɛnt͡suːʎ
konár	kɔnaːr
doktor	dɔktɔr
zoltán	zɔɫtaːn
karta	karta
ryža	riʒa
panteizmus	panteizmus
čierny	t͡ʃi̯erni
dobroslav	dɔbrɔsɫau̯
riadiť	ri̯aɟic
stryná	strinaː
dominikánsky	dɔminikaːnski
ríbezľa	riːbɛzʎa
želmíra	ʒɛɫmiːra
šípka	ʃiːpka
svätopluk	svɛtɔpɫuk
žreb	ʒrɛp
prísť	priːsc
korene	kɔrɛɲɛ
kábel	kaːbɛɫ
sviečkam	svi̯ɛt͡ʃkam
magdaléna	maɡdalɛːna
chorou	xɔrɔu̯
devätnásť	ɟɛvɛtnaːsc
voš	vɔʃ
modrý	mɔdriː
zápal	zaːpaɫ
nebohý	ɲɛbɔɦiː
guľôčka	ɡuʎu̯ɔt͡ʃka
letište	lɛciʃcɛ
sklo	skɫɔ
mŕtvola	mr̩ːtvɔɫa
päť	pæc
ten	tɛn
chvastúň	xvastuːɲ
rozumieť	rɔzumi̯ɛc
vianoce	vi̯anɔt͡sɛ
muška	muʃka
skala	skaɫa
zať	zac
kaša	kaʃa
moravský	mɔrau̯skiː
eva	ɛva
mandarínka	mandariːŋka
univerzitný	univɛrzitniː
kobyla	kɔbiɫa
benjamín	bɛnjamiːn
foyer	fɔajɛː
vnúčik	ʋnuːt͡ʃik
železo	ʒeʎezɔ
dedina	ɟɛɟina
mnoho	mnɔɦɔ
znezrady	zɲɛzradi
jakub	jakup
hnutie	ɦnuci̯ɛ
ábel	aːbɛɫ
junák	junaːk
vraj	vraj
urán	uraːn
nakoľko	nakɔʎkɔ
jablčný	jabɫ̩t͡ʃniː
maroko	marɔkɔ
hrob	ɦrɔp
turista	turista
afrikánec	afrikaːɲɛt͡s
raňajky	raɲajki
hovädzie	ɦɔvæd͡zi̯ɛ
napätie	napæci̯ɛ
cicka	t͡sit͡ska
srdciami	sr̩t͡si̯ami
božica	bɔʒit͡sa
príslovka	priːsɫɔu̯ka
driev	dri̯eu̯
majonéza	majɔnɛːza
faktami	faktami
napätie	napɛci̯ɛ
bór	bɔːr
jedlo	jɛdɫɔ
vladimír	vɫaɟimiːr
šíp	ʃiːp
ráb	raːp
gunár	ɡunaːr
branislav	braɲisɫau̯
lievik	li̯ɛvik
lipsko	lipskɔ
bodkočiarka	bɔtkɔt͡ʃi̯arka
matilda	matiɫda
