pogosto	pɔɡóːstɔ
bober	bɔ̀ːbər
koren	kɔréːn
bajta	báːjta
kategorija	katɛɡɔríːja
smetana	smèːtana
dotakniti	dɔtaknìːti
konkreten	kɔnkréːtən
življenje	ʒiʋljɛ̀ːnjɛ
komet	kɔméːt
molibden	mɔlibdéːn
pljučnica	pljúːt͡ʃnit͡sa
najmanjši	nájmáːnʃi
sedemdeset	sèːdəmdɛsɛt
poldan	pɔ́ːʋdan
odvisen	ɔdʋìːsən
rojstvo	rɔ̀ːjstʋɔ
prga	pə̀rɡa
bolgarščina	bɔlɡáːrʃt͡ʃina
gripa	ɡrìːpa
čipka	t͡ʃíːpka
dragulj	draɡùːl
češka	t͡ʃéːʃka
ponedeljek	pɔnɛdéːljək
stroj	strɔ́j
vpliv	ʋplíːʋ
krompir	krɔmpíːr
pornografski	pɔrnɔɡráːfski
kupovati	kupɔʋàːti
pisati	pisàːti
ločiti	lòːt͡ʃiti
luteranec	lutɛráːnət͡s
sreda	sréːda
luč	lùːt͡ʃ
lepiti	lɛpìːti
kapetanka	kapéːtanka
risba	ríːzba
jelša	jèːʋʃa
mavrica	máːʋrit͡sa
gost	ɡóːst
bivši	bíːʋʃi
usluga	uslúːɡa
očim	òːt͡ʃim
reka	rèːka
učiti	ut͡ʃìːti
adjektiven	adjɛktíːʋən
kelih	kèːlix
ogljik	ɔɡljíːk
leči	lèːt͡ʃi
kadar	kádar
jeremija	jɛrɛmíːja
čutiti	t͡ʃutìːti
krokar	króːkar
aljaska	aljáːska
petelin	pɛtɛ̀ːlin
najdražji	nájdráːʒji
zločin	zlɔt͡ʃíːn
ruvati	rúːʋati
klofuta	klɔfùːta
smodnik	smɔdnìːk
znanje	znáːnjɛ
podlejši	pɔ̀ːdlɛjʃi
grapa	ɡràːpa
orgiastičen	ɔrɡiàːstit͡ʃən
vojna	ʋɔ̀ːjna
oni	ɔ̀ːni
magnezij	maɡnéːzij
oporoka	ɔpɔróːka
grozljivka	ɡrɔzljíːʋka
nadlegovati	nadlɛɡɔʋàːti
perverzija	pɛrʋɛrzíːja
trizob	trizóːp
joga	jóːɡa
pravo	práːʋɔ
takoj	takɔ́j
modo	móːdɔ
ustreznik	ustrèːznik
zelen	zɛlɛ́n
skuša	skùːʃa
miličnik	milíːt͡ʃnik
be	béː
roman	rɔmáːn
menih	mɛnìːx
staviti	stàːʋiti
moški	mɔ̀ːʃki
trava	tràːʋa
sveča	sʋèːt͡ʃa
brod	bróːt
tveganje	tʋéːɡanjɛ
senožet	sɛnɔ̀ːʒɛt
sesalec	səsáːlət͡s
romunka	rɔmúːnka
nehemija	nɛxɛmíːja
egipt	ɛɡíːpt
sedlo	sɛ̀ːdlɔ
iskati	iskàːti
litij	lìːtij
dimlje	díːmljɛ
drkajva	də́rkajʋa
radost	ràːdɔst
najjasnejši	nájjasnɛ́ːjʃi
ljubljana	ljubljàːna
pogovor	pɔɡɔ́ːʋɔr
čopič	t͡ʃóːpit͡ʃ
majhen	máːjxən
arašid	araʃíːt
vodik	ʋɔdíːk
megavat	méːɡaʋáːt
razpelo	raspèːlɔ
voda	ʋɔ̀ːda
pozen	pɔ̀ːzən
poklekniti	pɔklɛknìːti
mjanmar	mjanmáːr
zgoraj	zɡɔ̀ːraj
stopiti	stɔpíːti
novina	nɔʋìːna
travnik	tràːʋnik
čemaž	t͡ʃèːmaʃ
abak	áːbak
optičen	òːptit͡ʃən
poudariti	pɔudàːriti
ingver	ìːnɡʋɛr
matica	máːtit͡sa
kitajski	kitáːjski
vi	ʋíː
energija	ɛnɛrɡíːja
lepiti	lɛpíːti
general	ɡɛnɛráːl
usoda	usóːda
volkodlak	ʋɔʋkɔdláːk
cena	t͡sèːna
ve	ʋéː
prazeodim	prazɛɔdíːm
govedo	ɡɔʋéːdɔ
puhati	pùːxati
mula	mùːla
grebsti	ɡrɛ̀ːpsti
žep	ʒɛ́p
krsta	kə̀rsta
nosorog	nɔsɔróːk
kovinski	kɔʋíːnski
črevo	t͡ʃrɛʋóː
ugrizniti	uɡrìːzniti
poln	pɔ́ːʋn
zdravljica	zdraʋljìːt͡sa
splošen	splɔ̀ːʃən
bosanski	bɔsáːnski
hropsti	xrɔ̀ːpsti
šest	ʃéːst
optika	òːptika
bruc	brúːt͡s
nosilec	nɔsíːlət͡s
pogoltniti	pɔɡɔ̀ːʋtniti
prijeten	prijèːtən
italijanka	italijáːnka
francoščina	frant͡sóːʃt͡ʃina
mezinec	mɛzíːnət͡s
komarček	kɔmáːrt͡ʃək
ovčar	ɔʋt͡ʃàːr
nazaj	nazàːj
vsaj	ʋsáːj
dogajati	dɔɡáːjati
brat	brát
sedem	sèːdəm
sirilo	sirìːlɔ
italija	itàːlija
poljski	póːlski
drug	drúːk
samorog	samɔróːk
postelja	pòːstɛlja
maja	màːja
šoja	ʃòːja
brdo	bə̀rdɔ
velblod	ʋɛlblóːt
študent	ʃtudɛ́nt
počivati	pɔt͡ʃìːʋati
srbija	sə́rbija
je	jèː
odprt	ɔtpə́rt
palčnik	páːʋt͡ʃnik
vovk	ʋɔ́ːʋk
mrkev	mə̀rkəʋ
kuga	kùːɡa
platana	platáːna
žveplo	ʒʋɛ̀ːplɔ
množina	mnɔʒìːna
sanjati	sàːnjati
mihaela	míːxaɛla
ura	ùːra
kakšen	káːkʃən
prababica	práːbàːbit͡sa
mišjak	míːʃjak
podleči	pɔdlèːt͡ʃi
punt	púnt
osnoven	ɔsnɔ́ːʋən
bliže	blíːʒɛ
gruzinski	ɡruzíːnski
skrivnost	skriʋnóːst
maček	màːt͡ʃək
kalij	kàːlij
hrana	xràːna
rumenjak	rumɛnjàːk
cilj	t͡síːl
muslimanka	muslimáːnka
rjuti	ərjùːti
bukev	búːkəʋ
govorec	ɡɔʋóːrət͡s
ruti	rùːti
m	ɛm
ovratnik	ɔʋráːtnik
šestnajst	ʃɛstnàːjst
pogača	pɔɡàːt͡ʃa
najdaljši	nájdáːlʃi
niša	nìːʃa
raba	ràːba
dobiti	dɔbìːti
sviloprejka	sʋilɔprɛ́ːjka
nagelj	nàːɡəl
seksualnost	sɛksuáːlnɔst
detel	dèːtəl
glog	ɡlɔ́k
žrebe	ʒrɛbɛ́
gorica	ɡɔrìːt͡sa
nov	nɔ́ʋ
pravičen	praʋìːt͡ʃən
globlji	ɡlóːblji
vaga	ʋáːɡa
zaljubiti	zaljubìːti
ček	t͡ʃéːk
apokalipsa	apɔkalíːpsa
historičen	xistòːrit͡ʃən
asimetrija	ásimɛtríːja
mandolina	mandɔlíːna
stavek	stáːʋək
rdeč	ərdɛ́t͡ʃ
čarovnik	t͡ʃarɔ́ːʋnik
rima	rìːma
sončnica	sóːnt͡ʃnit͡sa
beg	béːk
krom	króːm
gnostičen	ɡnòːstit͡ʃən
prstanec	pə̀rstanət͡s
sonce	sóːnt͡sɛ
nadporočnica	natpɔróːt͡ʃnit͡sa
grad	ɡráːt
carstvo	t͡sáːrstʋɔ
napisati	napisàːti
mladina	mladìːna
strast	stráːst
upati	úːpati
živahen	ʒiʋàːxən
apartma	apartmáː
kres	kréːs
topiti	tɔpíːti
teti	tèːti
melancana	mɛlant͡sáːna
najsrečnejši	nájsrèːt͡ʃnɛjʃi
posebej	pɔséːbɛj
nositi	nɔsìːti
slina	slìːna
dvajset	dʋáːjsɛt
francoz	frant͡sóːs
utrujati	utrùːjati
nemec	nèːmət͡s
solaren	sɔláːrən
ajd	ájt
lom	lɔ́m
poznati	pɔznàːti
mojzes	móːjzɛs
germanij	ɡɛrmàːnij
svakinja	sʋáːkinja
ozek	òːzək
kozorog	kɔzɔróːk
najdalj	nájdál
istanbul	íːstanbul
slovaška	slɔʋáːʃka
rusinja	rúːsinja
izpuščaj	ispuʃt͡ʃáːj
herbivor	xɛrbiʋóːr
recikliranje	rɛt͡siklíːranjɛ
repatica	rɛpatìːt͡sa
gradec	ɡráːdət͡s
klasti	klàːsti
cvetje	t͡sʋèːtjɛ
suspenzorij	suspɛnzòːrij
možnost	mòːʒnɔst
nota	nóːta
mesti	mèːsti
smel	sméːʋ
mesar	mɛsàːr
bazalt	bazáːlt
fotografija	fɔtɔɡrafíːja
blizu	blìːzu
hrupen	xrùːpən
ščinkavec	ʃt͡ʃìːnkaʋət͡s
najtrši	nájtə́rʃi
prijaznejši	prijàːznɛjʃi
ivan	íːʋan
stati	stàːti
cesarstvo	t͡sɛsáːrstʋɔ
smreka	smrèːka
nevihta	nɛʋíːxta
zupan	zúːpan
grenlandija	ɡréːnláːndija
runo	rúːnɔ
katalonija	katalòːnija
števnik	ʃtéːʋnik
slava	slàːʋa
vstopati	ʋstòːpati
pristati	pristàːti
čarovnica	t͡ʃarɔ́ːʋnit͡sa
vanadij	ʋanàːdij
militi	míːliti
sicilija	sit͡sìːlija
pistacija	pistàːt͡sija
glasba	ɡláːzba
kis	kíːs
obuti	ɔbùːti
usoden	usòːdən
opazovati	ɔpazɔʋàːti
antilopa	antilóːpa
ne	nɛ́
mestnik	méːstnik
murva	múːrʋa
mesto	mèːstɔ
maternica	máːtɛrnit͡sa
zakaj	zakáːj
brez	brɛs
dol	dɔ́ːʋ
žrebica	ʒrɛbìːt͡sa
edvard	éːdʋart
spominjati	spɔmìːnjati
musliman	muslimáːn
me	méː
erbij	ɛ̀ːrbij
bolezen	bɔléːzən
uniforma	unifóːrma
davek	dàːʋək
neposreden	nɛ́pɔsréːdən
halucinacija	xalut͡sinàːt͡sija
bršljan	bərʃljáːn
moka	mòːka
zima	zìːma
gorivo	ɡɔrìːʋɔ
vzhoden	ʋzxóːdən
francosko	frant͡sóːskɔ
najbelejši	nájbɛlɛ́ːjʃi
dvojček	dʋóːjt͡ʃək
neapelj	nɛàːpəl
grk	ɡə́rk
borza	bóːrza
ograja	ɔɡràːja
socvetje	sɔt͡sʋéːtjɛ
kopalnica	kɔpáːlnit͡sa
dude	dúːdɛ
iridij	irìːdij
rek	réːk
najmlajši	nájmláːjʃi
znotraj	znòːtraj
gladilka	ɡladíːlka
orakelj	ɔràːkəl
ledenik	lɛdɛnìːk
pomaranča	pɔmaráːnt͡ʃa
iterbij	itɛ̀ːrbij
belejši	bɛlɛ́ːjʃi
tožilnik	tɔʒíːlnik
estonija	ɛstòːnija
šal	ʃáːl
čitati	t͡ʃìːtati
štor	ʃtɔ́r
najvarnejši	nájʋàːrnɛjʃi
valentin	ʋalɛntíːn
mirta	mìːrta
čistota	t͡ʃistɔ̀ːta
ustnica	úːstnit͡sa
nominativ	nóːminatiʋ
zastavnica	zastáːʋnit͡sa
fukati	fúːkati
diamant	dijamàːnt
estonec	ɛstóːnət͡s
krut	krúːt
zibati	zibàːti
fosfor	fóːsfɔr
mornarica	mɔrnáːrit͡sa
vesel	ʋɛséːʋ
plamen	plàːmɛn
romunščina	rɔmúːnʃt͡ʃina
jak	jáːk
star	stár
zver	zʋéːr
smrtonosen	smərtɔnɔ̀ːsən
vest	ʋéːst
poljanšek	pɔljàːnʃək
gana	ɡáːna
romb	róːmp
neumnejši	nɛùːmnɛjʃi
kavkaz	kaʋkáːs
ubiti	ubìːti
všečnost	ʋʃèːt͡ʃnɔst
pastir	pastìːr
meniti	mɛníːti
imeti	imèːti
aerodinamika	áːɛrɔdinàːmika
čut	t͡ʃúːt
vodnar	ʋɔdnàːr
apnenec	apnèːnət͡s
betežen	bɛtèːʒən
obraz	ɔbrás
zvone	zʋóːnɛ
sranje	sràːnjɛ
najpomembnejši	nájpɔmèːmbnɛjʃi
neon	néːɔn
cona	t͡sóːna
madžarsko	mad͡ʒáːrskɔ
starec	stáːrət͡s
zemljevid	zɛmljɛʋíːt
dreti	drèːti
pred	prɛt
nekaj	nèːkaj
presti	prèːsti
lunaren	lunáːrən
svetilnik	sʋɛtíːlnik
rešiti	rɛʃìːti
korenina	kɔrɛnìːna
slamica	slàːmit͡sa
kersnik	kɛrsnìːk
miniti	miníːti
datelj	dàːtəl
kardinal	kardináːl
odgovoriti	ɔdɡɔʋɔrìːti
homoseksualen	xɔmɔsɛksuáːlən
tolkalo	tɔʋkàːlɔ
črn	t͡ʃə̀rn
belgijski	bèːlɡijski
knjigarna	knjiɡáːrna
kmet	kmɛ́t
majati	màːjati
podaljšava	pɔdalʃáːʋa
kovanec	kɔʋàːnət͡s
jetika	jèːtika
jezik	jɛ̀ːzik
slonica	slɔ̀ːnit͡sa
sliva	slìːʋa
kupiti	kupìːti
irka	íːrka
nasvidenje	nasʋíːdɛnjɛ
tkalec	tkáːlət͡s
končati	kɔnt͡ʃàːti
roka	rɔ̀ːka
stranišče	stranìːʃt͡ʃɛ
goreti	ɡɔrèːti
tantal	táːntal
divji	dìːʋji
isti	íːsti
vejica	ʋɛ́ːjit͡sa
koš	kɔ́ʃ
klen	kléːn
morje	móːrjɛ
posodobiti	pɔsɔdɔ̀ːbiti
čebela	t͡ʃɛbéːla
mah	máːx
trakulja	trakùːlja
rabiti	rabíːti
univerza	uniʋɛ́ːrza
oditi	ɔdìːti
občutljiv	ɔpt͡ʃutljíːʋ
janez	jàːnɛs
kristjan	kristjáːn
ujeda	ujèːda
ponarediti	pɔnarɛdìːti
mešati	mèːʃati
prazniti	pràːzniti
skoraj	skɔ́ːraj
značilnejši	znat͡ʃíːlnɛjʃi
glagolski	ɡlàːɡɔlski
sedanjik	sɛdáːnjik
mečji	méːt͡ʃji
bager	bàːɡər
šestdeset	ʃéːzddɛsɛt
odpreti	ɔtprèːti
škatla	ʃkáːtla
dvojina	dʋɔjìːna
bati	bàːti
sezuti	səzùːti
pijavka	pijáːʋka
milimeter	milimèːtər
bukva	búːkʋa
spet	spéːt
pšenica	pʃɛnìːt͡sa
milijon	milijóːn
oseba	ɔséːba
osončje	ɔsóːnt͡ʃjɛ
komori	kɔmóːri
tikati	tìːkati
škotska	ʃkóːtska
krajina	kráːjina
dejavnejši	dɛjàːʋnɛjʃi
sodoben	sɔdɔ̀ːbən
on	ɔ́n
tvegati	tʋéːɡati
srebrnina	srɛbərnìːna
kje	kjèː
tunizija	tunìːzija
klor	klóːr
irski	íːrski
najnaravnejši	nájnaràːʋnɛjʃi
portugalka	pɔrtuɡáːlka
stroncij	stròːnt͡sij
kašljati	káːʃljati
tisoč	tíːsɔt͡ʃ
vnukinja	ʋnúːkinja
volfram	ʋóːlfram
lovka	lɔ́ːʋka
nemogoč	nɛ́mɔɡòːt͡ʃ
katalonski	katalóːnski
radij	ráːdij
književnost	knjiʒéːʋnɔst
beljak	bɛljàːk
mlajši	mláːjʃi
meja	mɛ̀ːja
merkur	mɛrkúːr
čile	t͡ʃíːlɛ
jogurt	jóːɡurt
kdaj	ɡdàːj
posoditi	pɔsɔdìːti
obrazen	ɔbráːzən
južnoameriški	juʒnɔamɛ́ːriʃki
lemež	lɛ̀ːmɛʃ
vzhod	ʋzxɔ́t
črnilo	t͡ʃərnìːlɔ
jur	jùːr
stožec	stɔ̀ːʒət͡s
ukrasti	ukràːsti
namenilnik	namɛníːlnik
kompas	kóːmpas
demokracija	dɛmɔkrat͡síːja
viti	ʋíːti
buteljka	butéːlka
gejzir	ɡɛjzíːr
kenguru	kɛnɡurúː
testo	tɛstóː
angleščina	anɡléːʃt͡ʃina
podrobnejši	pɔdróːbnɛjʃi
načrt	nat͡ʃə́rt
vidra	ʋìːdra
težek	tɛ̀ːʒək
atrij	àːtrij
poljak	pɔljàːk
sposoditi	spɔsɔdìːti
bolgarija	bɔlɡàːrija
igra	íːɡra
nadzorovati	nadzɔrɔʋàːti
grši	ɡə́rʃi
pogumen	pɔɡùːmən
gospod	ɡɔspóːt
močerad	mɔt͡ʃɛrát
tvoriti	tʋóːriti
mitološki	mitɔlóːʃki
kobalt	kóːbalt
devetdeset	dɛʋéːddɛsɛt
drag	dráːk
vleči	ʋlèːt͡ʃi
ribariti	ribàːriti
blazen	blàːzən
absurdnejši	apsúːrdnɛjʃi
bova	bóːʋa
najpustejši	nájpùːstɛjʃi
srečneje	srɛt͡ʃnɛ́ːjɛ
programje	prɔɡráːmjɛ
slab	sláp
kosinus	kóːzinus
navdih	naʋdíːx
pogojnik	pɔɡóːjnik
gor	ɡɔ̀ːr
jegulja	jɛɡùːlja
zadnjica	záːdnjit͡sa
leska	lèːska
aktualizacija	aktualizàːt͡sija
rebro	rɛ̀ːbrɔ
poročen	pɔróːt͡ʃən
umoriti	umɔrìːti
narečje	naréːt͡ʃjɛ
viti	ʋìːti
pita	pìːta
briti	brìːti
njegov	njɛɡɔ̀ːʋ
mrkva	mə̀rkʋa
švedska	ʃʋéːtska
senožet	sɛnɔʒéːt
skrivati	skrìːʋati
vice	ʋìːt͡sɛ
skrivnejši	skríːʋnɛjʃi
bambus	báːmbus
zlat	zláːt
policistka	pɔlit͡síːstka
znanost	znàːnɔst
filipini	filipíːni
losos	lóːsɔs
osem	òːsəm
praslovanščina	práːslɔʋáːnʃt͡ʃina
najočitnejši	nájɔt͡ʃìːtnɛjʃi
gos	ɡóːs
kurdščina	kúːrtʃt͡ʃina
krutejši	krúːtɛjʃi
žrtvovati	ʒərtʋɔʋàːti
pomemben	pɔmèːmbən
načelo	nat͡ʃɛ̀ːlɔ
liberija	libɛ̀ːrija
zvitek	zʋíːtək
en	ɛ́n
hvaliti	xʋalìːti
moča	mòːt͡ʃa
kobarid	kɔbaríːt
šarenica	ʃarɛnìːt͡sa
skupnost	skùːpnɔst
pozabiti	pɔzàːbiti
predhodnik	prɛdxóːdnik
voluhar	ʋɔlúːxar
planet	planéːt
slaven	slàːʋən
nasmeh	nasmɛ́x
rim	rìːm
vrstilen	ʋərstíːlən
potrpežljiv	pɔtərpɛʒljíːʋ
okarina	ɔkaríːna
samozadovoljevati	sáːmɔzadɔʋɔljɛʋàːti
koleno	kɔlèːnɔ
sinhrono	sinxróːnɔ
krajši	kráːjʃi
nebotičnik	nɛbɔtíːt͡ʃnik
poklekniti	pɔklèːkniti
grenak	ɡrɛnáːk
postaja	pɔstáːja
potrebovati	pɔtrɛbɔʋàːti
kirij	kirìːj
desetnica	dɛséːtnit͡sa
sel	sə́ʋ
analogija	analɔɡíːja
jabolko	jàːbɔʋkɔ
monom	mɔnóːm
čustvo	t͡ʃúːstʋɔ
izuti	izùːti
krater	kràːtɛr
resnica	rɛsnìːt͡sa
obljuba	ɔbljúːba
batiskaf	batiskáːf
belina	bɛlìːna
srbski	sə́rpski
tehnecij	tɛxnèːt͡sij
vice	ʋíːt͡sɛ
saksofon	saksɔfóːn
javiti	jàːʋiti
četrtek	t͡ʃɛtə̀rtək
peljati	pɛljàːti
fazan	fazáːn
vreti	ʋrèːti
kreniti	krɛnìːti
kristus	kríːstus
igrača	iɡràːt͡ʃa
podkovati	pɔtkɔʋàːti
brusnica	brúːsnit͡sa
grešiti	ɡrɛʃíːti
panj	páːn
pomembnost	pɔmèːmbnɔst
sedemnajst	sɛdəmnàːjst
seč	séːt͡ʃ
število	ʃtɛʋìːlɔ
pira	pìːra
slovenščina	slɔʋèːnʃt͡ʃina
spodobnejši	spɔdòːbnɛjʃi
najbolj	nájbɔl
krava	kràːʋa
muzej	muzɛ́ːj
butan	butáːn
noj	nóːj
pustiti	pustíːti
drugoten	druɡɔ̀ːtən
sladkor	slàːtkɔr
najstarejši	nájstarɛ́ːjʃi
turek	tùːrək
babica	bàːbit͡sa
preproga	prɛpróːɡa
zdolgočasen	zdɔʋɡɔt͡ʃáːsɛn
pedagogika	pɛdaɡòːɡika
osnovnejši	ɔsnɔ́ːʋnɛjʃi
deležnik	dɛléːʒnik
riti	rìːti
kdaj	ɡdáːj
srečnejše	srèːt͡ʃnɛjʃɛ
roževina	rɔʒɛʋìːna
tetovirati	tɛtɔʋíːrati
na	na
blesti	blɛ̀ːsti
glavnik	ɡlaʋnìːk
snežak	snɛʒàːk
kadmij	kàːdmij
kanjon	káːnjɔn
slovenija	slɔʋèːnija
itrij	ìːtrij
angleški	anɡléːʃki
klošar	klɔʃàːr
greti	ɡrèːti
talij	tàːlij
zaman	zamán
uplinjač	uplinjàːt͡ʃ
orgazem	ɔrɡàːzəm
ljudski	ljúːtski
brana	bràːna
morda	mɔrdá
korenje	kɔrɛ̀ːnjɛ
maj	màːj
spustiti	spustìːti
teksas	téːksas
letališče	lɛtalìːʃt͡ʃɛ
jezero	jéːzɛrɔ
domov	dɔmɔ́ːʋ
smet	sméːt
poper	pɔ̀ːpər
zanimiv	zanimìːʋ
len	léːn
aleksander	alɛksàːndər
ločevati	lɔt͡ʃɛʋàːti
rjav	ərjáʋ
kras	krás
svakinja	sʋàːkinja
nevarnejši	nɛʋàːrnɛjʃi
plačati	plàːt͡ʃati
premena	prɛméːna
podlasica	pɔdlàːsit͡sa
rezultat	rɛzultáːt
peteršilj	pɛtɛrʃíl
najusodnejši	nájusòːdnɛjʃi
sokol	sɔ̀ːkɔl
dirigent	diriɡɛ́nt
bolnik	bɔʋnìːk
birtija	birtíːja
maldivi	maldíːʋi
krivoverec	kriʋɔʋéːrət͡s
profesor	prɔféːsɔr
dunajski	dùːnajski
iglokožec	iɡlɔkóːʒət͡s
strela	strèːla
več	ʋɛ́t͡ʃ
trikotnik	trikóːtnik
gruzija	ɡrúːzija
zadovoljiti	zadɔʋɔljíːti
sadje	sàːdjɛ
tom	tóːm
prha	pə̀rxa
imenovalnik	imɛnɔʋáːlnik
diamanten	diamáːntən
češko	t͡ʃéːʃkɔ
zrelejši	zrèːlɛjʃi
skriven	skríːʋən
budimpešta	búːdimpɛʃta
labod	labóːt
eržen	ɛrʒéːn
grča	ɡə̀rt͡ʃa
pek	pèːk
česmina	t͡ʃɛsmìːna
nebo	nɛbóː
podrobnost	pɔdróːbnɔst
junij	jùːnij
vrč	ʋə́rt͡ʃ
robot	rɔbóːt
hvala	xʋàːla
jesen	jɛ̀ːsɛn
letalo	lɛtàːlɔ
komaj	kóːmaj
stolp	stɔ́lp
rad	ráːt
najrevnejši	nájrèːʋnɛjʃi
slovanka	slɔʋáːnka
lažji	láːʒji
kronati	króːnati
las	láːs
mreti	mrèːti
govno	ɡɔ̀ːʋnɔ
temen	tə̀mən
turško	tùːrʃkɔ
lajati	láːjati
danščina	dáːnʃt͡ʃina
pridnejši	prìːdnɛjʃi
jablana	jáːblana
zamuditi	zamudìːti
voz	ʋóːs
barion	báːrijɔn
erik	ɛ́ːrik
roditi	rɔdíːti
boš	bóːʃ
cigara	t͡siɡáːra
jeti	jèːti
meta	méːta
ves	ʋə́s
maroko	maróːkɔ
hidrat	xidráːt
leteti	lɛtèːti
nuna	nùːna
brazilija	brazìːlija
presredek	prɛsréːdək
cink	t͡síːnk
komar	kɔmàːr
notri	nòːtri
jasniti	jasnìːti
krilo	krìːlɔ
hmelj	xmɛ́l
velikan	ʋɛlikáːn
pepelka	pɛpéːlka
molitev	mɔlíːtəʋ
odločba	ɔdlóːd͡ʒba
nekdo	nɛɡdóː
rast	ráːst
starejši	starɛ́ːjʃi
ubog	ubóːk
noč	nóːt͡ʃ
desetarka	dɛsɛtàːrka
otrok	ɔtrɔ́k
arabski	aráːpski
ampak	ámpak
tele	tɛ̀ːlɛ
terarij	tɛràːrij
sklanjatev	sklanjáːtəʋ
vegetarijanec	ʋɛɡɛtarijáːnət͡s
želva	ʒèːlʋa
pripeti	pripèːti
rastlina	rastlìːna
katedrala	katɛdráːla
riba	rìːba
dol	dɔ̀ːl
suženjstvo	sùːʒənstʋɔ
klitoris	klíːtɔris
vikati	ʋìːkati
libanon	líːbanɔn
loviti	lɔʋíːti
primer	priméːr
trebuh	trèːbux
ameriški	amɛ́ːriʃki
govoriti	ɡɔʋɔrìːti
astat	astáːt
phati	pxàːti
jagoda	jàːɡɔda
všečen	ʋʃèːt͡ʃən
vrtnica	ʋə́rtnit͡sa
bistvo	bíːstʋɔ
glup	ɡlúːp
tikati	tíːkati
sneti	snèːti
kaditi	kadìːti
glasoslovje	ɡlasɔslɔ́ːʋjɛ
kuhar	kúːxar
palma	páːlma
slušati	slùːʃati
morski	mɔ̀ːrski
zdravstvo	zdráːʋstʋɔ
občinstvo	ɔpt͡ʃíːnstʋɔ
telovaditi	tɛlɔʋàːditi
gams	ɡáms
lastnost	lastnóːst
zelen	zéːlən
jupiter	júːpitər
šestnajst	ʃéːstnajst
poletje	pɔléːtjɛ
švicarski	ʃʋíːt͡sarski
dekle	dɛklɛ́
perut	pɛrúːt
uporabljati	upɔràːbljati
bukarešta	bukaréːʃta
vnuk	ʋnúːk
cezij	t͡sèːzij
mavretanija	maʋrɛtàːnija
drek	drɛ́k
jasniti	jasníːti
slajši	sláːjʃi
tek	téːk
najnaglejši	nájnàːɡlɛjʃi
vir	ʋíːr
zaljubiti	zaljúːbiti
udariti	udàːriti
albanija	albàːnija
ovca	ɔ̀ːʋt͡sa
aktinij	aktìːnij
škarje	ʃkáːrjɛ
tajvan	táːjʋan
robidnica	rɔbíːdnit͡sa
zdravo	zdráːʋɔ
srbohrvaški	sərbɔxərʋáːʃki
poljubiti	pɔljùːbiti
atonalen	átɔnáːlən
norvežan	nɔrʋɛʒáːn
zabava	zabáːʋa
republika	rɛpùːblika
neptunij	nɛptùːnij
ejakulacija	ɛjakulàːt͡sija
gostitelj	ɡɔstíːtɛl
instrumentalen	instrumɛntáːlən
mak	mák
mušnica	múːʃnit͡sa
pomniti	póːmniti
trst	tə́rst
najpravilneje	nájpraʋíːlnɛjɛ
lopata	lɔpàːta
počasi	pɔt͡ʃáːsi
osel	ɔ̀ːsəʋ
bo	bóː
pravilneje	praʋíːlnɛjɛ
betežnejši	bɛtèːʒnɛjʃi
očim	óːt͡ʃim
megla	məɡlá
abeceda	abɛt͡séːda
praprot	pràːprɔt
narod	nàːrɔt
najplodnejši	nájplòːdnɛjʃi
pleti	plèːti
položaj	pɔlɔʒáːj
praga	pràːɡa
brazgotina	brazɡɔtìːna
bisaga	bisáːɡa
podaljšati	pɔdáːlʃati
ljubljenje	ljùːbljɛnjɛ
rakun	rakúːn
kolidž	kóːlitʃ
nlp	nələpə́
antimon	antimóːn
čmrlj	t͡ʃmə̀rl
štacun	ʃtat͡sùːn
prati	pràːti
topiti	tɔpìːti
prostornina	prɔstɔrnìːna
znanstven	znáːnstʋɛn
mehur	mɛxùːr
godba	ɡóːdba
smeh	sméːx
ostrivec	ɔstríːʋət͡s
goba	ɡòːba
šiliti	ʃìːliti
mačeha	màːt͡ʃɛxa
pogosteje	pɔɡóːstɛjɛ
narediti	narɛdíːti
siriti	sìːriti
umoriti	umɔríːti
drugi	drúːɡi
korak	kɔráːk
benzen	bɛnzéːn
snaha	snàːxa
kozmologija	kɔzmɔlɔɡíːja
lastovka	làːstɔʋka
levinja	lɛʋìːnja
kelt	kéːlt
fluor	flúːɔr
klasičen	klàːsit͡ʃən
čad	t͡ʃáːt
prakrt	práːkərt
mak	máːk
naraven	naràːʋən
rvati	ərʋàːti
pot	pòːt
švedinja	ʃʋéːdinja
lagati	laɡàːti
klepati	klɛpàːti
lonec	lɔ̀ːnət͡s
samomnožinski	samóːmnɔʒíːnski
jeklo	jɛ̀ːklɔ
ne	nɛ
modernizirati	mɔdɛrnizíːrati
uporabiti	upɔrabíːti
odgovor	ɔdɡɔ́ːʋɔr
nemka	nèːmka
kraljestvo	kraljéːstʋɔ
bosti	bɔ̀ːsti
vprašati	ʋpraʃàːti
švica	ʃʋíːt͡sa
ostriga	ɔstrìːɡa
drkamo	də́rkamɔ
srednjeveški	srɛdnjɛʋéːʃki
portugalec	pɔrtuɡáːlət͡s
prekletstvo	prɛkléːtstʋɔ
bisaga	bisàːɡa
evropij	ɛʋròːpij
potres	pɔtrɛ́s
nesti	nɛ̀ːsti
bitje	bìːtjɛ
lesketati	lɛskɛtàːti
devet	dɛʋéːt
boja	bóːja
zadnjik	záːdnjik
škržat	ʃkərʒáːt
insekt	inséːkt
bolgarski	bɔlɡàːrski
izkrcanje	íːskərt͡sàːnjɛ
hleb	xléːp
zdaj	zdáj
kokoš	kɔkóːʃ
sodnik	sɔdnìːk
razgovor	razɡɔ́ːʋɔr
lepši	léːpʃi
popačenka	pɔpáːt͡ʃɛnka
turist	turíːst
čeprav	t͡ʃɛpráʋ
volk	ʋɔ́ːʋk
pestrejši	pèːstrɛjʃi
bosta	bóːsta
polž	pɔ̀ːʋʃ
slovo	slɔʋóː
najznačilnejši	nájznat͡ʃíːlnɛjʃi
radovednost	radɔʋèːdnɔst
lep	léːp
litovsko	líːtɔʋskɔ
hematologija	xɛmatɔlɔɡíːja
finski	fíːnski
trener	trɛnɛ́ːr
indonezija	indɔnèːzija
gledati	ɡlèːdati
četrtinka	t͡ʃɛtərtíːnka
ljubiti	ljùːbiti
groziti	ɡrɔzíːti
jazon	jáːzɔn
ednina	ɛdnìːna
površina	pɔʋərʃìːna
adut	adúːt
kupa	kùːpa
otrpniti	ɔtə̀rpniti
strog	stróːk
drozd	dróːst
šahovnica	ʃaxɔ́ːʋnit͡sa
umazan	umáːzan
devica	dɛʋìːt͡sa
kot	kɔt
brom	bróːm
dromedar	drɔmɛdàːr
potem	pɔtéːm
prah	práːx
kvas	kʋáːs
moriti	mɔríːti
španski	ʃpáːnski
drobiž	drɔbìːʃ
genitiv	ɡéːnitiʋ
evo	éːʋɔ
poslati	pɔslàːti
klima	klíːma
zelena	zéːlɛna
svetnik	sʋéːtnik
irska	íːrska
žaba	ʒàːba
padalo	padàːlɔ
trdnjava	tərdnjáːʋa
vino	ʋìːnɔ
zahod	zaxɔ́t
habakuk	xabakúːk
žreti	ʒrèːti
tat	tát
turkinja	tùːrkinja
izposoditi	ispɔsɔdìːti
hujši	xúːjʃi
bolgarsko	bɔlɡàːrskɔ
nizozemka	nizɔzéːmka
osa	ɔ̀ːsa
resnik	réːsnik
če	t͡ʃɛ
lomiti	lɔmìːti
ost	óːst
hinavski	xináːʋski
žoga	ʒòːɡa
pokop	pɔkɔ́p
verjeti	ʋɛrjèːti
razred	ràːzrɛt
pravopis	praʋɔpíːs
pokrov	pɔkrɔ́ʋ
enajst	ɛnàːjst
rana	ràːna
čopič	t͡ʃɔ́ːpit͡ʃ
jezus	jéːzus
obramba	ɔbráːmba
žerjav	ʒɛrjáʋ
prositi	prɔsìːti
drkava	də́rkaʋa
vozel	ʋɔ̀ːzəʋ
košarka	kɔʃáːrka
mamilo	mamìːlɔ
že	ʒɛ
finska	fíːnska
rep	réːp
rilec	ríːlət͡s
natrij	nàːtrij
zapustiti	zapustíːti
tvoj	tʋòːj
ždeti	ʒdèːti
plesati	plɛsàːti
malteščina	maltéːʃt͡ʃina
strupen	strupéːn
možnar	mòːʒnar
petnajst	pɛtnàːjst
zahodnejši	zaxóːdnɛjʃi
zastava	zastáːʋa
lubje	lùːbjɛ
čifut	t͡ʃìːfut
počiti	pɔt͡ʃìːti
beton	bɛtóːn
vladavina	ʋladaʋìːna
dno	dnɔ́
hiša	xìːʃa
radoveden	radɔʋèːdən
družina	druʒìːna
tekoč	tɛkòːt͡ʃ
delavec	dèːlaʋət͡s
snežiti	snɛʒíːti
zvok	zʋóːk
branik	branìːk
ogroziti	ɔɡrɔzìːti
snovati	snɔʋàːti
malto	máːltɔ
tenis	téːnis
jagnjetina	jaɡnjɛtìːna
tjulenj	tjúːlən
bahrajn	baxráːjn
všeč	ʋʃéːt͡ʃ
pianist	pijaníːst
bojazen	bɔjáːzən
scenarij	st͡sɛnàːrij
papagaj	papaɡáːj
atol	atóːl
klovn	klɔ̀ːʋn
najhitreje	nájxitrɛ̀ːjɛ
pulzar	púːlzar
drkajo	də́rkajɔ
menih	mənìːx
plačati	plat͡ʃàːti
violončelo	ʋijɔlɔnt͡ʃéːlɔ
krt	kə́rt
vez	ʋéːs
kavarna	kaʋáːrna
boginja	bɔɡìːnja
sosed	sɔ̀ːsɛt
japonska	japóːnska
polenovka	pɔlèːnɔʋka
gluh	ɡlúːx
glušji	ɡlúːʃji
lenivec	lɛníːʋət͡s
vinograd	ʋinòːɡrat
suša	sùːʃa
grenek	ɡrɛ̀ːnək
rus	rúːs
gubiti	ɡubìːti
zlitina	zlíːtina
pasti	pàːsti
krajšava	krajʃáːʋa
križ	krìːʃ
kašča	kàːʃt͡ʃa
glog	ɡlóːk
najljubosumnejši	nájljubɔsùːmnɛjʃi
splošnejši	splɔ̀ːʃnɛjʃi
bokal	bɔkáːl
razglednica	razɡléːdnit͡sa
atomski	atóːmski
galij	ɡàːlij
marjan	máːrjan
čehinja	t͡ʃéːxinja
umor	umɔ́r
valj	ʋàːl
doživeti	dɔʒiʋèːti
prijazen	prijàːzən
vranica	ʋràːnit͡sa
ugriz	uɡríːs
odličen	ɔdlìːt͡ʃən
krasti	kràːsti
paladij	palàːdij
nebesa	nɛbèːsa
krajina	kràːjina
okno	ɔ̀ːknɔ
najgrji	nájɡə́rji
pomenski	pɔméːnski
samomor	samɔmɔ́r
pustejši	pùːstɛjʃi
literatura	litɛratúːra
lipa	lìːpa
obljubiti	ɔbljubìːti
prebiti	prɛbìːti
sanje	sàːnjɛ
lovec	lɔ̀ːʋət͡s
starost	staróːst
pojasniti	pɔjàːsniti
sadež	sáːdɛʃ
luka	lùːka
slon	slɔ́n
resničen	rɛsnìːt͡ʃən
besedilo	bɛsɛdìːlɔ
neodim	nɛɔdíːm
prst	pə́rst
skorja	skóːrja
slovan	slɔʋáːn
trinko	tríːnkɔ
brada	bràːda
ščegetavček	ʃt͡ʃɛɡɛtáːʋt͡ʃək
amputirati	amputíːrati
malina	malìːna
ljubosumnejši	ljubɔsùːmnɛjʃi
obljubiti	ɔbljúːbiti
najpomembnejši	nájpɔméːmbnɛjʃi
resničen	rɛsníːt͡ʃən
pri	pri
iti	ìːti
trši	tə́rʃi
mlad	mláːt
december	dɛt͡sɛ̀ːmbər
trpeti	tərpèːti
programski	prɔɡráːmski
cekin	t͡sɛkíːn
izmolsti	izmɔ̀ːʋsti
latvija	làːtʋija
izposoditi	ispɔsòːditi
bran	bráːn
sovražiti	sɔʋráːʒiti
bos	bɔ́s
armada	armáːda
ud	úːt
instrumental	instrumɛntáːl
fagot	faɡóːt
obed	ɔbɛ́t
pekel	pəkə́ʋ
okopati	ɔkòːpati
besedotvorje	bɛsɛdɔtʋóːrjɛ
skočiti	skɔt͡ʃìːti
heksagon	xɛksaɡóːn
tolči	tɔ̀ːʋt͡ʃi
manjši	máːnʃi
prostorski	prɔstòːrski
oznaka	ɔznáːka
klicati	klìːt͡sati
sončnik	sóːnt͡ʃnik
los	lóːs
radar	ráːdar
koroška	kɔróːʃka
medenica	mɛdɛnìːt͡sa
nehati	néːxati
prase	prasɛ́
krema	kréːma
zgrešiti	zɡrɛ̀ːʃiti
boriti	bɔríːti
kosinus	kɔ́síːnus
oddajnik	ɔddáːjnik
molsti	mɔ̀ːʋsti
predal	prɛdáːl
božati	bóːʒati
zrelejši	zrɛlɛ́ːjʃi
armenija	armèːnija
dogodek	dɔɡóːdək
francozinja	frant͡sóːzinja
aglomeracija	aɡlɔmɛràːt͡sija
os	óːs
mizantropija	mizantrɔpíːja
najkrutejši	nájkrúːtɛjʃi
najpotrpežljivejši	nájpɔtərpɛʒljìːʋɛjʃi
blato	blàːtɔ
metulj	mɛtùːl
najrazličnejši	nájrazlìːt͡ʃnɛjʃi
učiteljica	ut͡ʃíːtɛljit͡sa
epicenter	ɛpit͡sèːntər
kakovost	kakɔ̀ːʋɔst
avgust	aʋɡúːst
litovec	lìːtɔʋət͡s
ljubljenje	ljúːbljɛnjɛ
bodi	bòːdi
južnejši	jùːʒnɛjʃi
izvir	izʋíːr
borša	bóːrʃa
juvan	júːʋan
kobila	kɔbìːla
marelica	maréːlit͡sa
gospa	ɡɔspàː
sel	sə́l
slovenka	slɔʋèːnka
makedonski	makɛdóːnski
past	páːst
kavka	káːʋka
plaz	pláːs
sršen	sə̀rʃɛn
brcniti	bə̀rt͡sniti
baza	báːza
kositi	kòːsiti
prihodnjik	prixóːdnjik
aerolit	aɛrɔlíːt
vrša	ʋə̀rʃa
seznam	sɛznám
malo	màːlɔ
pa	pa
občutljivejši	ɔpt͡ʃutljìːʋɛjʃi
jahati	jáːxati
izmena	izmɛ́ːna
seksualen	sɛksuáːlən
vožnja	ʋɔ̀ːʒnja
vol	ʋɔ́ʋ
suti	sùːti
indijka	ìːndijka
ded	déːt
najboljši	nájbóːlʃi
najpogosteje	nájpɔɡóːstɛjɛ
najin	náːjin
ja	jáː
mleko	mlèːkɔ
brati	bràːti
bretanja	brɛtàːnja
trska	tə̀rska
fizika	fìːzika
vprašati	ʋpràːʃati
sekunda	sɛkúːnda
vojščak	ʋɔjʃt͡ʃàːk
ribi	rìːbi
pero	pɛróː
aceton	at͡sɛtóːn
nasmehniti	nasmèːxniti
najdejavnejši	nájdɛjáːʋnɛjʃi
strešica	strèːʃit͡sa
upor	upɔ́r
zakleniti	zaklɛníːti
voziti	ʋɔzíːti
samostalniški	samɔstáːlniʃki
mati	màːti
lice	líːt͡sɛ
meka	mèːka
najbednejši	nájbèːdnɛjʃi
hrupen	xrúːpən
devetnajst	dɛʋéːtnajst
njen	njèːn
vodja	ʋóːdja
zgodba	zɡóːdba
malarija	malàːrija
sod	sóːt
biti	bìːti
zober	zòːbər
polizati	pɔlìːzati
madžarski	mad͡ʒáːrski
jastreb	jáːstrɛp
cvet	t͡sʋéːt
malte	máːltɛ
kovati	kɔʋàːti
husit	xusíːt
cerkev	t͡sèːrkəʋ
zupanc	zúːpant͡s
apnenec	apnéːnət͡s
orjak	ɔrjàːk
ki	ki
judovstvo	jùːdɔʋstʋɔ
preproga	prɛpròːɡa
kreta	kréːta
sršen	sərʃɛ́n
petdeset	péːddɛsɛt
počasneje	pɔt͡ʃàːsnɛjɛ
igla	íːɡla
njun	njùːn
praporščak	prapɔrʃt͡ʃàːk
otvoriti	ɔtʋóːriti
vodnjak	ʋɔdnjàːk
očiten	ɔt͡ʃìːtən
mleti	mlèːti
ruščina	rúːʃt͡ʃina
najbetežnejši	nájbɛtèːʒnɛjʃi
lani	làːni
borba	bóːrba
potegovati	pɔtɛɡɔʋàːti
vedro	ʋɛ̀ːdrɔ
nocoj	nɔt͡sòːj
pojasniti	pɔjasnìːti
izboljšava	izbɔlʃáːʋa
gambija	ɡàːmbija
entomologija	ɛntɔmɔlɔɡíːja
koreja	kɔrɛ́ːja
odnos	ɔdnɔ́s
travojedec	traʋɔjéːdət͡s
aman	áːman
bogatejši	bɔɡatɛ́ːjʃi
zdravilo	zdraʋìːlɔ
mesija	mɛsíːja
osemdeset	òːsəmdɛsɛt
čevelj	t͡ʃéːʋəl
konkretno	kɔnkréːtnɔ
igralec	iɡráːlət͡s
prostata	próːstata
tjulenj	tjùːlən
španščina	ʃpáːnʃt͡ʃina
bosanščina	bɔsàːnʃt͡ʃina
lopov	lɔ́ːpɔʋ
dativ	dáːtiʋ
zrak	zrák
pohorje	póːxɔrjɛ
sit	sít
namigovati	namiɡɔʋàːti
jasen	jàːsən
dvom	dʋóːm
ropar	róːpar
žaga	ʒáːɡa
moč	móːt͡ʃ
obrv	ɔbə́rʋ
varen	ʋàːrən
nož	nɔ́ʃ
holmij	xòːlmij
kazalec	kazáːlət͡s
ravnik	ráːʋnik
kuža	kúːʒa
strastnejši	stràːstnɛjʃi
ulice	ulit͡sɛ
hoditi	xɔdìːti
najglasnejši	nájɡlasnɛ́ːjʃi
bon	bóːn
mineralogija	minɛralɔɡíːja
veti	ʋèːti
blago	blaɡóː
slovničen	slɔ́ːʋnit͡ʃən
pizda	píːzda
franc	fránt͡s
dvomiti	dʋòːmiti
telo	tɛlóː
nepotrpežljiv	nɛ́pɔtərpɛʒljíːʋ
želja	ʒɛ̀ːlja
trepalnica	trɛpáːlnit͡sa
temniti	təmníːti
nizozemec	nizɔzéːmət͡s
nedoločnik	nɛ́dɔlóːt͡ʃnik
paglavec	pàːɡlaʋət͡s
februar	féːbruar
dragulj	draɡúːl
toda	tóːda
srbščina	sə́rpʃt͡ʃina
začetek	zat͡ʃéːtək
pogovoriti	pɔɡɔʋɔríːti
izbrati	izbràːti
lasten	làːstən
brv	bə́rʋ
kokolj	kòːkɔl
steza	stə̀za
tipkovnica	tipkɔ́ːʋnit͡sa
niša	níːʃa
oblikoslovje	ɔblikɔslɔ́ːʋjɛ
bolnišnica	bɔʋníːʃnit͡sa
vrsten	ʋə́rstən
vprašaj	ʋpraʃáːj
miličnica	milíːt͡ʃnit͡sa
mlin	mlíːn
gnil	ɡníːʋ
podel	pɔ̀ːdəʋ
ulica	ùːlit͡sa
red	réːt
cula	t͡sùːla
ulomek	ulóːmək
bizantinski	bizantíːnski
čemaž	t͡ʃɛmáːʃ
naprava	napráːʋa
tris	tríːs
mošt	mɔ́ʃt
začeti	zat͡ʃèːti
uvel	uʋèːʋ
ksenofobija	ksɛnɔfɔbíːja
belorusija	bɛlɔrúːsija
telur	tɛlùːr
slabo	slabóː
učitelj	ut͡ʃíːtɛl
o	ɔ
grlica	ɡə̀rlit͡sa
kakšen	kàːkʃən
pogovoriti	pɔɡɔʋɔrìːti
rep	rɛ́p
izpeljati	ispɛljàːti
droben	drɔ̀ːbən
brest	brɛ́st
bel	bèːʋ
azija	àːzija
najspodobnejši	nájspɔdòːbnɛjʃi
skorbut	skɔrbúːt
zapestje	zapéːstjɛ
kladivo	klàːdiʋɔ
atene	atéːnɛ
izdajalec	izdajáːlət͡s
heziod	xɛzijóːt
bivol	bíːʋɔl
albansko	albáːnskɔ
kraj	kráj
buča	bùːt͡ʃa
gvajana	ɡʋajáːna
nihče	nixt͡ʃɛ́
strojiti	stróːjiti
dolgočasnejši	dɔlɡɔt͡ʃàːsnɛjʃi
skromen	skrɔ̀ːmən
oktober	ɔktòːbər
arterija	artɛ̀ːrija
vohunski	ʋɔxúːnski
ključiti	kljùːt͡ʃiti
bolgar	bɔlɡáːr
kaplja	kàːplja
nepredvidljiv	nɛ́prɛdʋidljíːʋ
govor	ɡɔ́ːʋɔr
majati	majàːti
norveška	nɔrʋéːʃka
noter	nòːtɛr
turčija	túːrt͡ʃija
oglas	ɔɡlás
znoj	znɔ́j
hrbet	xərbə́t
podroben	pɔdróːbən
kravžati	kráːʋʒati
latinski	latíːnski
rosomah	rɔsɔmáːx
benetke	bɛnéːtkɛ
perverzija	pɛrʋɛ̀ːrzija
nihče	níːxt͡ʃɛ
izložba	izlóːʒba
italijan	italiján
sestra	sɛ̀ːstra
sečničen	séːt͡ʃnit͡ʃən
izbira	izbíːra
istra	íːstra
ciklon	t͡siklóːn
slovanski	slɔʋáːnski
svet	sʋɛ́t
posoditi	pɔsɔdíːti
presenetiti	prɛsɛnéːtiti
najzrelejši	nájzrèːlɛjʃi
igrati	iɡràːti
najslabše	nájsláːpʃɛ
nekdo	néːɡdɔ
pest	péːst
obljubiti	ɔbljubíːti
mejiti	mɛjìːti
zaklad	zaklát
kuba	kúːba
pester	pèːstər
dvomiti	dʋóːmiti
reven	rèːʋən
jeza	jèːza
zenica	zɛnìːt͡sa
podgana	pɔdɡàːna
modrejši	mɔdrɛ́ːjʃi
sranje	sráːnjɛ
materen	máːtɛrən
škripec	ʃkríːpət͡s
kamin	kamíːn
moker	mòːkər
akuzativ	áːkuzatiʋ
antarktika	antàːrktika
dolina	dɔlìːna
sestrična	sɛstríːt͡ʃna
šarenica	ʃáːrɛnit͡sa
svak	sʋàːk
čuti	t͡ʃùːti
ujeti	ujèːti
mladič	mladít͡ʃ
hrvaška	xərʋáːʃka
barij	bàːrij
gepard	ɡéːpart
rešiti	rɛʃíːti
bežati	bɛʒàːti
loviti	lɔʋìːti
šesti	ʃɛ̀ːsti
hidrolog	xidrɔlóːk
mezeg	mə̀zək
krap	kráp
zbežati	zbɛʒàːti
stena	stèːna
kri	kríː
bitje	bíːtjɛ
pečat	pɛt͡ʃáːt
štorklja	ʃtóːrklja
mladost	mladóːst
bojo	bóːjɔ
skrivnostnejši	skriʋnóːstnɛjʃi
prosim	pròːsim
finsko	fíːnskɔ
spam	spɛ́ːm
prijateljica	prijáːtɛljit͡sa
ogrožati	ɔɡròːʒati
pomoč	pɔmóːt͡ʃ
čast	t͡ʃáːst
polkovnica	pɔlkɔ́ːʋnit͡sa
bomba	bóːmba
jantar	jáːntar
razvoj	razʋɔ́j
porod	pɔrɔ́t
džihad	d͡ʒixáːt
žarek	ʒáːrək
sanskrt	sanskə́rt
ustava	ustáːʋa
ježevec	jèːʒɛʋət͡s
pamet	pàːmɛt
džihad	d͡ʒíːxat
središče	srɛdìːʃt͡ʃɛ
varuh	ʋáːrux
sneguljčica	snɛɡúːlt͡ʃit͡sa
čistiti	t͡ʃìːstiti
luknja	lúːknja
narediti	narɛdìːti
sperma	spɛ́ːrma
breza	brèːza
lešnik	lèːʃnik
lek	léːk
zahteva	zaxtéːʋa
slabši	sláːpʃi
doma	dɔmáː
kontinent	kɔntinɛ́nt
meglica	məɡlìːt͡sa
ducat	dùːt͡sat
lisica	lisìːt͡sa
boljše	bóːlʃɛ
sobota	sɔbòːta
vaza	ʋàːza
zavreti	zaʋrèːti
božič	bɔ̀ːʒit͡ʃ
bolečina	bɔlɛt͡ʃìːna
slonica	slɔnìːt͡sa
ž	ʒ
najdolgočasnejši	nájdɔlɡɔt͡ʃàːsnɛjʃi
popek	póːpək
švedsko	ʃʋéːtskɔ
cev	t͡séːʋ
grb	ɡə́rp
poklicati	pɔklìːt͡sati
plavati	pláːʋati
holandski	xɔláːntski
satelit	satɛlíːt
svoboda	sʋɔbɔ̀ːda
steza	stəzá
hraniti	xràːniti
borka	bòːrka
hraniti	xraníːti
klop	klóːp
smučati	smúːt͡ʃati
jod	jóːt
kopel	kɔpéːl
psalmi	psáːlmi
najvišji	nájʋíːʃji
pospešek	pɔspéːʃək
mišičen	míːʃit͡ʃən
timijan	tíːmijan
vrat	ʋráːt
lobanja	lɔbàːnja
vektor	ʋèːktɔr
visok	ʋisɔ́k
polmer	pɔʋméːr
sta	stá
eden	ɛ̀ːdən
dolg	dɔ́ːʋk
artefakt	artɛfáːkt
zmaj	zmáːj
hasidizem	xasidíːzəm
blesteti	blɛstèːti
zahoden	zaxóːdən
zanimiv	zanimíːʋ
krog	króːk
zlonameren	zlɔnamèːrən
kreda	kréːda
duh	dúːx
žena	ʒɛ̀ːna
anton	antóːn
voditi	ʋɔdìːti
dejavnost	dɛjáːʋnɔst
zel	zə́ʋ
dihur	dixúːr
najsrečnejše	nájsrèːt͡ʃnɛjʃɛ
matej	matɛ́ːj
prisega	priséːɡa
nanašati	nanáːʃati
tlak	tláːk
bolj	bɔ́l
buldog	búːldɔk
slonovina	slɔnɔʋìːna
blagajna	blaɡáːjna
škof	ʃkɔ́f
vosek	ʋóːsək
hišen	xíːʃən
izgubiti	izɡubìːti
rubidij	rubìːdij
pobrati	pɔbràːti
bom	bóːm
soba	sɔ̀ːba
postati	pɔstàːti
strojiti	strɔjíːti
stegno	stɛ̀ːɡnɔ
dedovati	dɛdɔʋàːti
teden	téːdən
kje	kjéː
kurva	kúːrʋa
gost	ɡɔ́st
vaš	ʋáʃ
silicij	silìːt͡sij
cesar	t͡sɛ̀ːsar
hudič	xudìːt͡ʃ
zlog	zlɔ́k
terorist	tɛrɔríːst
januar	jáːnuar
mesec	méːsət͡s
dlaka	dlàːka
bodimo	bɔdíːmɔ
škorenj	ʃkóːrən
jelen	jɛ̀ːlɛn
biološki	biɔlóːʃki
radij	ràːdij
med	mɛt
ime	iméː
kop	kóːp
slovaško	slɔʋáːʃkɔ
avstrija	áːʋstrija
lokomotiva	lɔkɔmɔtíːʋa
abstrakten	apstráːktən
piton	pitóːn
da	dá
navada	naʋáːda
kenta	kéːnta
celota	t͡sɛlɔ̀ːta
metež	méːtɛʃ
asklepij	asklèːpij
tomaž	tɔmáːʃ
gros	ɡróː
elektron	ɛlɛktròːn
zaliv	zalíːʋ
večen	ʋèːt͡ʃən
možen	mòːʒən
noht	nóːxt
slanina	slanìːna
zvečer	zʋɛt͡ʃéːr
kurba	kúːrba
hercegovina	xɛrt͡sɛɡɔʋìːna
urnik	úːrnik
kositi	kɔsíːti
globok	ɡlɔbɔ́k
pornografija	pɔrnɔɡrafíːja
lemež	léːmɛʃ
lulček	lúːlt͡ʃək
sejati	sɛjàːti
grm	ɡə́rm
cenzura	t͡sɛnzúːra
aksiom	aksijóːm
duda	dúːda
kitajska	kitáːjska
srečnejše	srɛt͡ʃnɛ́ːjʃɛ
afrika	áːfrika
baza	bàːza
podmornica	pɔdmóːrnit͡sa
vojvodina	ʋóːjʋɔdina
najbliže	nájblíːʒɛ
težji	téːʒji
gadolinij	ɡadɔlìːnij
varnejši	ʋàːrnɛjʃi
sršen	sərʃéːn
aktualizirati	aktualizíːrati
alpaka	alpáːka
lahek	làːxək
gleženj	ɡlèːʒən
spolovilo	spɔlɔʋìːlɔ
prevajalec	prɛʋajáːlət͡s
tog	tóːk
veter	ʋéːtər
rog	róːk
tempelj	tɛ̀ːmpəl
opuščaj	ɔpuʃt͡ʃáːj
kaliti	kalìːti
roditi	rɔdìːti
zmaj	zmáj
pod	pɔ́t
runo	rùːnɔ
koliko	kòːlikɔ
deska	də̀ska
žila	ʒìːla
rokavica	rɔkaʋìːt͡sa
islandski	isláːntski
gravitacijski	ɡraʋitat͡síːjski
krastača	krastàːt͡ʃa
luksemburški	luksɛmbúːrʃki
prijaviti	prijàːʋiti
prazen	pràːzən
pica	píːt͡sa
umetnik	uméːtnik
topel	tɔ̀ːpəʋ
zaspan	zaspàːn
trinajst	tríːnajst
dež	də́ʃ
bič	bìːt͡ʃ
darilo	darìːlɔ
reši	rèːʃi
dokler	dóːklɛr
masa	máːsa
ananas	áːnanas
bober	bòːbər
sosed	sòːsɛt
izraz	izrás
zverina	zʋɛrìːna
kvar	kʋáːr
orel	ɔ̀ːrəʋ
maša	màːʃa
grom	ɡrɔ́m
inštitut	inʃtitúːt
najkrajši	nájkráːjʃi
že	ʒɛ́
sluti	slùːti
najmečji	nájméːt͡ʃji
klarinet	klarinéːt
spomin	spɔmíːn
militi	mìːliti
lutnja	lúːtnja
zažgati	zaʒɡàːti
dalek	dáːlɛk
budist	budíːst
jokati	jòːkati
beseden	bɛséːdən
čist	t͡ʃíːst
ingver	íːnɡʋɛr
najustreznejši	nájustrèːznɛjʃi
usta	ùːsta
ironija	irɔníːja
amarant	amaràːnt
dežela	dɛʒɛ̀ːla
krivda	kríːʋda
včeraj	ʋt͡ʃèːraj
muditi	mudíːti
ajd	àːjt
pomočnik	pɔmɔt͡ʃnìːk
zlomiti	zlɔmìːti
dvanajst	dʋanáːjst
posoditi	pɔsòːditi
neodvisen	nɛ́ɔdʋìːsən
jebati	jɛ́ːbati
obrazilo	ɔbrazìːlɔ
lug	lùːk
temza	téːmza
pohištvo	pɔxíːʃtʋɔ
mujezin	mujɛzíːn
priznati	priznàːti
dvomiti	dʋɔmìːti
sedeti	sɛdèːti
pijača	pijàːt͡ʃa
čao	t͡ʃáːɔ
pluti	plùːti
piramida	piramíːda
seznam	səznám
sečnica	séːt͡ʃnit͡sa
izsiljevalski	issiljɛʋáːʋski
antonim	antɔníːm
ožji	óːʒji
strah	stráːx
njegov	njɛɡɔ́ʋ
uživati	uʒìːʋati
samota	samɔ̀ːta
nedoločnik	nɛ́dɔlòːt͡ʃnik
parfum	parfúːm
mina	míːna
jajčnik	jáːjt͡ʃnik
monoteizem	mɔnɔtɛìːzəm
likalnik	likáːlnik
hrup	xrúːp
pesem	péːsəm
tetoviranje	tɛtɔʋíːranjɛ
odvreti	ɔdʋrèːti
bezjak	bɛzjáːk
boljši	bóːlʃi
klošč	klɔ́ʃt͡ʃ
daleč	dàːlɛt͡ʃ
oteti	ɔtèːti
urok	urɔ́k
ker	kɛr
skrivnosten	skriʋnóːstən
jože	jóːʒɛ
vladati	ʋlàːdati
pozavna	pɔzáːʋna
fin	fíːn
portugalsko	pɔrtuɡáːlskɔ
strop	strɔ́p
irščina	íːrʃt͡ʃina
raven	ràːʋən
ura	úːra
srečen	srèːt͡ʃən
ran	ráːn
aligator	aliɡáːtɔr
zmaga	zmáːɡa
vzhodnejši	ʋzxóːdnɛjʃi
zbirati	zbíːrati
bodite	bòːditɛ
holm	xóːlm
aragonit	araɡɔníːt
stranka	stráːnka
buden	bùːdən
pariz	paríːs
kartagina	kartáːɡina
azil	azíːl
je	jɛ́
italijanski	italijáːnski
pogodba	pɔɡóːdba
prometij	prɔmèːtij
liti	lìːti
pokazati	pɔkàːzati
seči	sèːt͡ʃi
legendaren	lɛɡɛndáːrən
domišljija	dɔmiʃljíːja
modrejši	mòːdrɛjʃi
transilvanija	transilʋàːnija
lira	líːra
sirija	sìːrija
latinica	latíːnit͡sa
liturgija	liturɡíːja
kopno	kɔ́ːpnɔ
štala	ʃtàːla
prostor	prɔ̀ːstɔr
let	lɛ́t
genij	ɡèːnij
doba	dɔ̀ːba
kocka	kóːt͡ska
enota	ɛnɔ̀ːta
umiti	umìːti
felicijan	fɛlit͡sijáːn
irec	íːrət͡s
balet	baléːt
najpogumnejši	nájpɔɡùːmnɛjʃi
dejanje	dɛjáːnjɛ
čigar	t͡ʃíːɡar
reči	rɛ̀ːt͡ʃi
kip	kíːp
podla	pɔ̀ːdla
preja	prɛ́ːja
mamut	máːmut
vrba	ʋə̀rba
meti	mèːti
kapetan	kapéːtan
uporabiti	upɔràːbiti
tadžikistan	tad͡ʒíːkistan
dama	dàːma
opatinja	ɔpáːtinja
divizija	diʋizíːja
učinek	ut͡ʃíːnək
najskrivnejši	nájskríːʋnɛjʃi
gozd	ɡɔ́st
lotos	lóːtɔs
najdebelejši	nájdɛbɛlɛ́ːjʃi
hobotnica	xɔbóːtnit͡sa
čebula	t͡ʃəbùːla
nikolaj	nikɔláːj
žuželka	ʒuʒéːlka
nafta	náːfta
slop	slɔ́p
kozarec	kɔzáːrət͡s
bas	báːs
nekrofilija	nɛkrɔfilíːja
noga	nɔ̀ːɡa
zelena	zɛ́ːlɛna
skoraj	skɔ̀ːraj
zagnati	zaɡnàːti
jahati	jàːxati
dotakniti	dɔtakníːti
enačba	ɛnáːd͡ʒba
tako	takóː
kislina	kislìːna
tisti	tíːsti
klečati	klɛt͡ʃàːti
veverica	ʋèːʋɛrit͡sa
spremeniti	sprɛmɛnìːti
vulkan	ʋulkáːn
nem	néːm
severen	sèːʋɛrən
kuhinja	kùːxinja
dinozaver	dinɔzàːʋər
paladin	paladíːn
ožemati	ɔʒéːmati
kikiriki	kikirikíː
najdejavnejši	nájdɛjàːʋnɛjʃi
obiskovati	ɔbiskɔʋàːti
kosilo	kɔsìːlɔ
volga	ʋɔ̀ːʋɡa
srb	sə́rp
bralnik	bráːlnik
jerebica	jɛrɛbìːt͡sa
najožji	nájóːʒji
redar	rɛdàːr
voščilo	ʋɔʃt͡ʃìːlɔ
monako	mɔnáːkɔ
komolec	kɔmóːlət͡s
desetletje	dɛsɛtléːtjɛ
gozdarstvo	ɡɔzdáːrstʋɔ
pomemben	pɔméːmbən
turški	tùːrʃki
filozof	filɔzóːf
aerodinamika	aɛ́ːrɔdinàːmika
vojakinja	ʋɔjàːkinja
ravnotežje	raʋnɔtéːʒjɛ
bresti	brɛ̀ːsti
vaditi	ʋàːditi
urban	urbán
vstopiti	ʋstɔpíːti
glaven	ɡláːʋən
uganka	uɡáːnka
čelo	t͡ʃéːlɔ
kurec	kúːrət͡s
boriti	bɔrìːti
predvidljiv	prɛdʋidljíːʋ
žolčnik	ʒɔ́ːʋt͡ʃnik
slovenec	slɔʋèːnət͡s
meniti	mɛnìːti
grčija	ɡə́rt͡ʃija
smelejši	smèːlɛjʃi
makedonščina	makɛdóːnʃt͡ʃina
opeklina	ɔpɛklìːna
izklopiti	isklɔpìːti
brihten	brìːxtən
slediti	slɛdìːti
ol	óːʋ
in	in
matematika	matɛmàːtika
spominčica	spɔmíːnt͡ʃit͡sa
ošiliti	ɔʃìːliti
frekvenca	frɛkʋéːnt͡sa
fukajoč	fukajóːt͡ʃ
sin	síːn
princesa	print͡séːsa
rabiti	rabìːti
pražiti	pràːʒiti
platno	plàːtnɔ
peti	pɛ̀ːti
živ	ʒíːʋ
betlehem	béːtlɛxɛm
koruza	kɔrùːza
voščiti	ʋòːʃt͡ʃiti
plašč	plàːʃt͡ʃ
tolmač	tɔlmàːt͡ʃ
zaseben	zaséːbən
poljubiti	pɔljubíːti
jamajka	jamáːjka
šimpanz	ʃimpáːns
žiti	ʒìːti
bretonka	brɛtóːnka
genocid	ɡɛnɔt͡síːt
stric	strìːt͡s
ljubezen	ljubéːzən
berkelij	bɛrkèːlij
braniti	braníːti
bedak	bɛdàːk
spretnost	sprèːtnɔst
kavsati	káːʋsati
rudar	rudàːr
prevodnik	prɛʋóːdnik
renesansa	rɛnɛsáːnsa
sekalec	sɛkáːlət͡s
kateter	katèːtər
orodje	ɔróːdjɛ
grščina	ɡə́rʃt͡ʃina
otroče	ɔtrɔt͡ʃɛ́
samum	samúːm
latvijski	làːtʋijski
grško	ɡə́rʃkɔ
baba	bàːba
dogajati	dɔɡàːjati
heteroseksualnost	xɛtɛrɔsɛksuáːlnɔst
srati	sràːti
bolgarski	bɔlɡáːrski
praded	práːdɛ́t
dalj	dál
kdo	ɡdòː
najkrutejši	nájkrùːtɛjʃi
sapnik	sáːpnik
borka	bóːrka
kako	kakòː
zakon	zàːkɔn
vraža	ʋràːʒa
si	si
spol	spɔ́l
skromnejši	skrɔ̀ːmnɛjʃi
učenec	ut͡ʃɛ̀ːnət͡s
blatnik	bláːtnik
socializem	sɔt͡sijalìːzəm
anarhizem	anarxìːzəm
kemija	kɛmíːja
nad	nat
prt	pə́rt
pridevnik	pridéːʋnik
spodaj	spɔ̀ːdaj
lizbona	lizbóːna
termit	tɛrmíːt
praslovanski	práːslɔʋáːnski
ruvati	rùːʋati
zvezda	zʋèːzda
rodilnik	rɔdíːlnik
tih	tíːx
drkanje	də́rkanjɛ
dvojček	dʋòːjt͡ʃək
sezuti	sɛzùːti
ambrozija	ambròːzija
sljuda	sljùːda
b	bə́
potrpežljivejši	pɔtərpɛʒljìːʋɛjʃi
albanka	albáːnka
dol	dóːʋ
najpočasneje	nájpɔt͡ʃasnɛ́ːjɛ
neposredno	nɛ́pɔsréːdnɔ
kratica	kratìːt͡sa
moskva	móːskʋa
struktura	struktúːra
siv	síːʋ
zavesa	zaʋéːsa
polotok	pɔlɔtɔ́k
zadovoljiti	zadɔʋɔljìːti
biseksualnost	bíːsɛksuáːlnɔst
bizon	bíːzɔn
spodoben	spɔdòːbən
jožef	jóːʒɛf
pojasniti	pɔjáːsniti
zvati	zʋàːti
ključavnica	kljut͡ʃáːʋnit͡sa
ali	áli
padati	pàːdati
barantati	barantàːti
vrana	ʋràːna
trot	tróːt
presenetiti	prɛsɛnèːtiti
stetoskop	stɛtɔskɔ́p
zmaj	zmàːj
kvark	kʋáːrk
pravičnost	praʋíːt͡ʃnɔst
najresničnejši	nájrɛsnìːt͡ʃnɛjʃi
krvaveti	kərʋaʋèːti
romunsko	rɔmúːnskɔ
april	apríːl
preteklik	prɛtɛ̀ːklik
zapornica	zapóːrnit͡sa
puhati	púːxati
srednjevaloven	srɛdnjɛʋalɔ́ːʋən
mil	míːl
zadnjičen	záːdnjit͡ʃən
polonij	pɔlòːnij
volna	ʋɔ̀ːʋna
palača	palàːt͡ʃa
rek	rɛ́k
premeniti	prɛmɛnìːti
celina	t͡sɛlìːna
striči	strìːt͡ʃi
cvreti	t͡sʋrèːti
koper	kɔ̀ːpər
vžigalica	ʋʒiɡáːlit͡sa
vrata	ʋràːta
besedotvoren	bɛsɛdɔtʋóːrən
mreža	mrèːʒa
posameznik	pɔsáːmɛznik
stikalo	stikàːlɔ
grd	ɡə́rt
pizda	pìːzda
azerbajdžan	azɛrbajd͡ʒáːn
duša	dùːʃa
veselje	ʋɛsɛ̀ːljɛ
ščet	ʃt͡ʃéːt
hoditi	xɔdíːti
vrstnost	ʋə́rstnɔst
kondom	kɔndóːm
konec	kɔ̀ːnət͡s
objaviti	ɔbjàːʋiti
kosmulja	kɔsmùːlja
njihov	njíːxɔʋ
prašič	pràːʃit͡ʃ
podoba	pɔdóːba
protaktinij	prɔtaktìːnij
čebela	t͡ʃəbéːla
luč	lúːt͡ʃ
portugalski	pɔrtuɡáːlski
včlaniti	ʋt͡ʃlàːniti
snežiti	snɛʒìːti
samostalnik	samɔstáːlnik
anatomija	anatɔmíːja
moliti	mɔlíːti
jajčevec	jàːjt͡ʃɛʋət͡s
peči	pɛ̀ːt͡ʃi
oklepaj	ɔklɛpáːj
klavir	klaʋíːr
prostorski	prɔstóːrski
bos	bóːs
najstrastnejši	nájstràːstnɛjʃi
višji	ʋíːʃji
bodimo	bòːdimɔ
alkohol	alkɔxóːl
žolt	ʒɔ́ːʋt
titan	titáːn
slivovka	slìːʋɔʋka
islandija	islàːndija
češplja	t͡ʃéːʃplja
gospodična	ɡɔspɔdíːt͡ʃna
car	t͡sàːr
rijavec	rìːjaʋət͡s
sablja	sáːblja
jagnjetina	jàːɡnjɛtina
mišica	míːʃit͡sa
mogoče	mɔɡòːt͡ʃɛ
kenija	kèːnija
najslajši	nájsláːjʃi
kapitalist	kapitalíːst
razlika	razlíːka
vagina	ʋaɡíːna
usodnejši	usòːdnɛjʃi
najpustejši	nájpustɛ́ːjʃi
vladati	ʋláːdati
skrotum	skróːtum
najskrivnostnejši	nájskriʋnóːstnɛjʃi
avtobus	áːʋtɔbus
ogroziti	ɔɡrɔzíːti
file	filéː
kamen	kàːmən
miniti	minìːti
klop	klɔ́p
patološki	patɔlóːʃki
nos	nóːs
torij	tòːrij
molekula	mɔléːkula
patologija	patɔlɔɡíːja
zobozdravnik	zɔbɔzdraʋnìːk
moravec	mɔràːʋət͡s
bolnica	bóːlnit͡sa
adijo	adíːjɔ
najsladejši	nájsladɛ́ːjʃi
sendvič	séːndʋit͡ʃ
strojen	strɔ́ːjən
pofukati	pɔfúːkati
veja	ʋɛ́ːja
tuberkuloza	tubɛrkulóːza
peta	pɛ̀ːta
mafija	màːfija
kuna	kùːna
jadro	jàːdrɔ
francij	fràːnt͡sij
lezbijka	lèːzbijka
makedonka	makɛdóːnka
niobij	nijòːbij
bosanščina	bɔsáːnʃt͡ʃina
vstopiti	ʋstɔpìːti
kos	kóːs
takoj	takóːj
hosta	xóːsta
svoj	sʋòːj
lug	lúːk
rama	ràːma
jarem	jàːrəm
prvak	pərʋàːk
gnosticizem	ɡnɔstit͡sìːzəm
maslo	màːslɔ
kladivce	kladìːʋt͡sɛ
vejati	ʋɛ́ːjati
cvesti	t͡sʋəstí
klic	klíːt͡s
bunda	búːnda
podpičje	pɔ́tpíːt͡ʃjɛ
mi	míː
bosanski	bɔsàːnski
umivati	umìːʋati
obiskati	ɔbiskàːti
kupiti	kùːpiti
dopoldan	dɔpɔ́ːʋdan
predlog	prɛ̀ːdlɔk
pričakovati	prit͡ʃakɔʋàːti
avto	áːʋtɔ
koliko	kóːlikɔ
počasno	pɔt͡ʃàːsnɔ
slavec	slàːʋət͡s
ponos	pɔnɔ́s
bomo	bóːmɔ
indij	ìːndij
ahil	axíːl
ogel	óːɡəʋ
stopnišče	stɔpnìːʃt͡ʃɛ
železo	ʒɛlèːzɔ
jeznejši	jèːznɛjʃi
najgrši	nájɡə́rʃi
slap	sláːp
zvonar	zʋɔnàːr
zlo	zlɔ́
polh	pɔ́ːʋx
oziroma	ɔzíːrɔma
štirinajst	ʃtirinàːjst
hitrost	xitróːst
naglejši	nàːɡlɛjʃi
brest	brèːst
portugalska	pɔrtuɡáːlska
organizacija	ɔrɡanizàːt͡sija
črka	t͡ʃə̀rka
soprog	sɔpróːk
restavracija	rɛstaʋràːt͡sija
ščurek	ʃt͡ʃùːrək
cveten	t͡sʋéːtən
deblo	dɛ̀ːblɔ
žival	ʒiʋáːʋ
kopito	kɔpìːtɔ
pek	péːk
relativnost	rɛlatíːʋnɔst
malta	máːlta
kamela	kaméːla
italijansko	italijáːnskɔ
sporočilo	spɔrɔt͡ʃìːlɔ
konj	kɔ́n
pavel	páːʋəl
izgovoriti	izɡɔʋɔrìːti
vesti	ʋɛ̀ːsti
madžar	mad͡ʒáːr
kneginja	knéːɡinja
žvečiti	ʒʋèːt͡ʃiti
najprijaznejši	nájprijàːznɛjʃi
voščiti	ʋɔʃt͡ʃíːti
povednik	pɔʋéːdnik
rotovž	róːtɔʋʃ
količina	kɔlit͡ʃìːna
presti	prɛ̀ːsti
lijak	lijàːk
laž	láːʃ
gnati	ɡnàːti
naš	náʃ
domovina	dɔmɔʋìːna
pesek	pèːsək
drugi	drùːɡi
galeb	ɡaléːp
sardinija	sardìːnija
vstaviti	ʋstàːʋiti
relativnost	réːlatiʋnɔst
donava	dóːnaʋa
gumb	ɡúːmp
svinčnik	sʋìːnt͡ʃnik
samec	sàːmət͡s
uspeti	uspèːti
čutiti	t͡ʃutíːti
posteljica	pòːstɛljit͡sa
najobčutljivejši	nájɔpt͡ʃutljìːʋɛjʃi
prihajati	prixáːjati
stopiti	stɔpìːti
tovariš	tɔʋáːriʃ
sova	sɔ̀ːʋa
hvaliti	xʋalíːti
macesen	mat͡sɛ̀ːsən
najpočasneje	nájpɔt͡ʃàːsnɛjɛ
bezeg	bə̀zək
otomanski	ɔtɔmáːnski
jarek	jàːrək
najbrihtnejši	nájbrìːxtnɛjʃi
uspeh	uspɛ́x
topol	tɔ̀ːpɔl
strasten	stràːstən
amfiteater	amfitɛàːtər
predlagati	prɛdláːɡati
beseda	bɛséːda
burek	búːrɛk
litva	líːtʋa
hren	xrɛ́n
gams	ɡàːms
klorofil	klɔrɔfíːl
objem	ɔbjɛ́m
gristi	ɡrìːsti
argon	arɡóːn
zidati	zidàːti
oseben	ɔséːbən
norveško	nɔrʋéːʃkɔ
janšizem	janʃizɛm
ogenj	ɔ̀ːɡən
malteški	maltéːʃki
rovka	rɔ́ːʋka
špansko	ʃpáːnskɔ
kitara	kitáːra
bukselj	bùːksəl
zlaten	zlatéːn
pozno	pɔ̀ːznɔ
kup	kúp
gibanje	ɡìːbanjɛ
zet	zɛ́t
borec	bóːrət͡s
debelejši	dɛbɛlɛ́ːjʃi
ekonomist	ɛkɔnɔmíːst
svoboden	sʋɔbɔ̀ːdən
dleto	dlèːtɔ
širok	ʃirɔ́k
sobana	sɔbàːna
tipka	tíːpka
počiti	pòːt͡ʃiti
najsončnejši	nájsóːnt͡ʃnɛjʃi
kategorialen	katɛɡɔrijáːlən
žafran	ʒafráːn
britanija	britàːnija
redko	rèːtkɔ
jesen	jɛséːn
zidati	zìːdati
kaznovati	kaznɔʋàːti
noj	nɔ́j
shizofrenija	sxizɔfrɛníːja
medvedka	mɛdʋéːtka
juha	jùːxa
kdor	ɡdɔ́r
vsebina	ʋsɛbìːna
prepucij	prɛpùːt͡sij
beloruščina	bɛlɔrúːʃt͡ʃina
uran	uráːn
malteško	maltéːʃkɔ
veliko	ʋɛlìːkɔ
džungla	d͡ʒúːnɡla
nikelj	nìːkəl
jajce	jàːjt͡sɛ
kit	kíːt
klošar	klóːʃar
mlesti	mlèːsti
moliti	mɔlìːti
banka	báːnka
bagrist	baɡríːst
hrast	xràːst
ruvati	ruʋàːti
rezilo	rɛzìːlɔ
zgodaj	zɡóːdaj
albanščina	albáːnʃt͡ʃina
najlažji	nájláːʒji
svetel	sʋɛ̀ːtəʋ
latvijščina	làːtʋijʃt͡ʃina
kalifornij	kalifòːrnij
slikati	slíːkati
najokusnejši	nájɔkùːsnɛjʃi
nasmeh	nasméːx
andora	andóːra
datum	dáːtum
oman	óːman
ploden	plòːdən
mohamed	mòːxamɛt
ljubosumnost	ljubɔsùːmnɔst
korenje	kɔréːnjɛ
zssr	zəsəsərə́
marko	màːrkɔ
jaz	jás
fakulteta	fakultéːta
teči	tɛ̀ːt͡ʃi
spremeniti	sprɛmɛníːti
spogledovati	spɔɡlɛdɔʋàːti
brazilski	brazíːlski
fermij	fɛ̀ːrmij
vurnik	ʋúːrnik
makedonija	makɛdòːnija
nikoli	nikóːli
knez	knéːs
nemški	nèːmʃki
kovnica	kɔ́ːʋnit͡sa
bretonščina	brɛtóːnʃt͡ʃina
simboličen	simbòːlit͡ʃən
pisatelj	pisáːtɛl
zora	zɔ̀ːra
ceh	t͡séːx
možgani	mɔʒɡáːni
eritreja	ɛritrɛ́ːja
telur	tɛlúːr
kamerun	káːmɛrun
ranejši	ràːnɛjʃi
gravitacija	ɡraʋitàːt͡sija
najpodobnejši	nájpɔdòːbnɛjʃi
opat	ɔpáːt
čefur	t͡ʃɛfùːr
dokler	dɔ́klɛr
č	t͡ʃ
oko	ɔkóː
pojutrišnjem	pɔjúːtriʃnjɛm
muzikologija	muzikɔlɔɡíːja
najsrečnejše	nájsrɛt͡ʃnɛ́ːjʃɛ
bič	bít͡ʃ
cigara	t͡siɡàːra
opeka	ɔpéːka
španec	ʃpáːnət͡s
izdati	izdàːti
zapreti	zaprèːti
vedeti	ʋèːdɛti
izposoditi	ispɔsɔdíːti
mrož	mróːʃ
okopavati	ɔkɔpáːʋati
vodnica	ʋóːdnit͡sa
orlič	ɔrlít͡ʃ
jesti	jèːsti
okusnejši	ɔkùːsnɛjʃi
vzeti	ʋzèːti
dovolj	dɔʋɔ́l
luksemburški	lúːksɛmburʃki
rjuha	ərjùːxa
elektron	ɛléːktrɔn
članek	t͡ʃláːnək
slep	sléːp
drkajmo	də́rkajmɔ
dojenček	dɔjɛ̀ːnt͡ʃək
tekoč	tɛkóːt͡ʃ
opomba	ɔpóːmba
uporaba	upɔráːba
bodiva	bɔdíːʋa
ptica	ptìːt͡sa
spem	spɛ́ːm
tvorba	tʋóːrba
krč	kə́rt͡ʃ
poskušati	pɔskùːʃati
rabiti	ràːbiti
seznam	səznáːm
zabavnik	zabáːʋnik
britof	bríːtɔf
petek	pèːtək
tanek	tàːnək
pipa	pìːpa
polzeti	pɔʋzèːti
arhivar	arxiʋàːr
tajska	táːjska
geodezija	ɡɛɔdɛzíːja
jezikoslovec	jɛzikɔslɔ́ːʋət͡s
včasih	ʋt͡ʃáːsix
kapati	kàːpati
pevec	pèːʋət͡s
mendelevij	mɛndɛlèːʋij
melodija	mɛlɔdíːja
dimlje	dìːmljɛ
srajca	sràːjt͡sa
kavčič	káːʋt͡ʃit͡ʃ
vid	ʋíːt
tulij	tùːlij
sydney	síːdni
sad	sáːt
bor	bɔ́r
kreniti	krɛníːti
hvaliti	xʋàːliti
pust	púːst
prijatelj	prijáːtɛl
čigav	t͡ʃiɡàːʋ
čaj	t͡ʃáːj
baterija	batɛríːja
svetloba	sʋɛtlɔ̀ːba
sodobnejši	sɔdɔ̀ːbnɛjʃi
močvirje	mɔt͡ʃʋíːrjɛ
muditi	mudìːti
vklopiti	ʋklɔpíːti
polž	pɔ́ːʋʃ
cerij	t͡sɛ̀ːrij
tiger	tìːɡər
lahko	laxkóː
italijan	italijáːn
simetrija	simɛtríːja
muslimanski	muslimáːnski
jajčevec	jáːjt͡ʃɛʋət͡s
srečno	srèːt͡ʃnɔ
zanimivejši	zanimìːʋɛjʃi
najtežji	nájtéːʒji
klas	kláːs
čas	t͡ʃás
poskusiti	pɔskùːsiti
popoldan	pɔpɔ́ːʋdan
deber	dəbə́r
odrešenik	ɔdrɛʃɛnìːk
dušik	duʃíːk
hrček	xə́rt͡ʃək
nogavica	nɔɡaʋìːt͡sa
pravilno	praʋíːlnɔ
lipovec	lìːpɔʋət͡s
spati	spàːti
indijec	íːndijət͡s
ograja	ɔɡráːja
brezoseben	brɛzɔséːbən
sinica	sinìːt͡sa
hrib	xrìːp
pitagora	pitàːɡɔra
rob	róːp
žamet	ʒàːmɛt
slovnica	slɔ́ːʋnit͡sa
opatija	ɔpatíːja
platina	pláːtina
simbol	simbóːl
spalnica	spáːlnit͡sa
skočiti	skɔt͡ʃíːti
obraniti	ɔbranìːti
akvarij	akʋàːrij
otava	ɔtàːʋa
videti	ʋìːdɛti
poker	pòːkər
enačaj	ɛnat͡ʃáːj
polmer	pɔlméːr
kopati	kɔpàːti
netopir	nɛtɔpíːr
oreh	ɔ̀ːrɛx
podobnejši	pɔdòːbnɛjʃi
nepotrpežljiv	nɛ́pɔtərpɛʒljìːʋ
lomiti	lɔmíːti
morati	móːrati
pokazati	pɔkazàːti
mars	máːrs
polica	pɔlìːt͡sa
bogat	bɔɡát
skriti	skrìːti
avstralija	aʋstràːlija
milisekunda	míːlisɛkúːnda
bizmut	bíːzmut
najosnovnejši	nájɔsnɔ́ːʋnɛjʃi
kost	kóːst
so	sɔ́
košara	kɔʃáːra
zdravnik	zdraʋnìːk
požar	pɔʒáːr
tisa	tíːsa
golobrad	ɡɔlɔbrát
tisočletje	tisɔt͡ʃléːtjɛ
najpogostejše	nájpɔɡóːstɛjʃɛ
iz	is
priden	prìːdən
liter	lìːtər
katalonščina	katalóːnʃt͡ʃina
ščir	ʃt͡ʃíːr
naglas	naɡlás
kobilica	kɔbìːlit͡sa
menjati	mɛnjàːti
dunaj	dùːnaj
gnoj	ɡnóːj
zaljubiti	zaljùːbiti
zdrav	zdráʋ
islam	íːslam
brki	bə́rki
končen	kɔ̀ːnt͡ʃən
pogovarjati	pɔɡɔʋáːrjati
sraka	sràːka
kuščar	kùːʃt͡ʃar
izklopiti	isklòːpiti
turščina	tùːrʃt͡ʃina
bretonski	brɛtóːnski
objeti	ɔbjèːti
ulico	ulit͡sɔ
sekira	sɛkìːra
kratek	kràːtək
skupnost	skúːpnɔst
nečak	nɛt͡ʃàːk
pihati	pìːxati
porcelan	pɔrt͡sɛláːn
palindrom	palindróːm
cvesti	t͡sʋɛ̀ːsti
oranža	ɔráːnʒa
rumen	rumɛ́n
naslednji	nasléːdnji
manjšalnica	manʃáːlnit͡sa
podnebje	pɔdnéːbjɛ
paranoja	paranóːja
najsrečnejši	nájsrɛt͡ʃnɛ́ːjʃi
mejiti	mɛjíːti
bahami	baxáːmi
sloveti	slɔʋèːti
božur	bɔʒúːr
drevo	drɛʋóː
šved	ʃʋéːt
sabotaža	sabɔtáːʒa
danski	dáːnski
mohar	mɔ̀ːxar
najranejši	nájràːnɛjʃi
ujec	ùːjət͡s
pajek	páːjək
berilij	bɛrìːlij
slan	sláːn
kaditi	kadíːti
pismo	pìːsmɔ
napačen	napáːt͡ʃən
napad	napát
živeti	ʒiʋèːti
zlomiti	zlɔmíːti
teoretik	tɛɔrèːtik
krutejši	krùːtɛjʃi
skakač	skakàːt͡ʃ
zlemu	zlɛmú
kadilo	kadìːlɔ
seno	sɛnóː
tretjak	trɛtjàːk
darovati	darɔʋàːti
nizozemsko	nizɔzéːmskɔ
beda	bèːda
eto	éːtɔ
damask	damáːsk
maltežanka	maltɛʒáːnka
dovoljenje	dɔʋɔljɛ̀ːnjɛ
marec	màːrət͡s
pazduha	páːzduxa
umeti	umèːti
vezati	ʋèːzati
grenivka	ɡrɛníːʋka
absurden	apsúːrdən
iskra	ìːskra
vohun	ʋɔxúːn
tod	tóːt
gniti	ɡnìːti
skandij	skàːndij
penis	péːnis
senca	séːnt͡sa
elektromagnetski	ɛléːktrɔmaɡnéːtski
nogomet	nɔɡɔmɛ́t
rž	ə́rʃ
argon	áːrɡɔn
zaiti	zaìːti
haitijski	xaíːtijski
dogovor	dɔɡɔ́ːʋɔr
jasnejši	jasnɛ́ːjʃi
češčina	t͡ʃéːʃt͡ʃina
hrvaški	xərʋáːʃki
leten	léːtən
srp	sə́rp
sesalec	sɛsáːlət͡s
hleb	xlɛ́p
skladnja	sklàːdnja
porod	pɔ̀ːrɔt
kuhati	kùːxati
zjutraj	zjùːtraj
cvek	t͡sʋɛ́k
denarnica	dɛnáːrnit͡sa
por	pɔ́r
okusen	ɔkùːsən
ralo	ràːlɔ
drva	də̀rʋa
pes	pə́s
norvežanka	nɔrʋɛʒáːnka
predmet	prɛ̀ːdmɛt
ljubiti	ljubìːti
pravkar	práʋkar
misel	míːsəʋ
tri	tríː
zapornik	zapóːrnik
vidra	ʋíːdra
tesen	tɛ̀ːsən
vdova	ʋdɔ́ːʋa
predvideti	prɛdʋìːdɛti
stanovati	stanɔʋàːti
žetev	ʒéːtəʋ
jebati	jéːbati
sever	sèːʋɛr
greh	ɡrèːx
sila	sìːla
svila	sʋíːla
naravnejši	naràːʋnɛjʃi
zaščita	zaʃt͡ʃíːta
napisati	napìːsati
česen	t͡ʃɛ̀ːsən
rad	rát
skala	skàːla
dar	dáːr
nemščina	nèːmʃt͡ʃina
ajnštajnij	áːjnʃtajnij
izklopiti	isklóːpiti
bokal	bɔkáːʋ
ples	pléːs
ležati	lɛʒàːti
boleti	bɔlèːti
griža	ɡríːʒa
brivec	bríːʋət͡s
portoriko	pɔrtɔríːkɔ
največ	nájʋɛt͡ʃ
po	pɔ
ducat	dúːt͡sat
italijanščina	italijáːnʃt͡ʃina
potrpežljiv	pɔtərpɛʒljìːʋ
estonski	ɛstóːnski
skorja	skòːrja
ježevec	jéːʒɛʋət͡s
nedelja	nɛdèːlja
vitez	ʋíːtɛs
poklekniti	pɔklɛkníːti
krom	krɔ́m
dejavnejši	dɛjáːʋnɛjʃi
mezeg	məzə́k
mraz	mrás
albanski	albáːnski
nit	nít
poklic	pɔklíːt͡s
gvineja	ɡʋinɛ́ːja
otročji	ɔtròːt͡ʃji
britanski	britáːnski
galicija	ɡalìːt͡sija
knjiga	knjìːɡa
kola	kóːla
jež	jèːʃ
tolpa	tɔ̀ːlpa
bosenski	bóːsənski
cirkonij	t͡sirkòːnij
treti	trèːti
potrebnejši	pɔtrèːbnɛjʃi
bič	bíːt͡ʃ
usoden	usóːdən
križanje	krìːʒanjɛ
nekaj	néːkaj
prihodnji	prixóːdnji
glas	ɡláːs
najhujši	nájxúːjʃi
kazati	kazàːti
iti	íːti
trstenjak	tərstɛnjàːk
norveški	nɔrʋéːʃki
značilen	znat͡ʃíːlən
kunec	kúːnət͡s
rasa	ràːsa
eksodus	éːksɔdus
list	líːst
ravnejši	ràːʋnɛjʃi
denar	dɛnàːr
kaliti	kalíːti
bradat	bradát
marija	maríːja
usnje	ùːsnjɛ
črevce	t͡ʃrèːʋt͡sɛ
sovraštvo	sɔʋráːʃtʋɔ
rokomet	rɔkɔmɛ́t
limona	limóːna
instrumental	íːnstrumɛntal
rusko	rúːskɔ
kočija	kɔt͡ʃíːja
kapsula	káːpsula
plod	plóːt
grozljiv	ɡrɔzljìːʋ
plodnejši	plòːdnɛjʃi
izsiljevalski	issiljɛʋáːlski
krona	króːna
ženski	ʒèːnski
krojač	krɔjàːt͡ʃ
deska	dəská
padec	páːdət͡s
peč	péːt͡ʃ
starost	stàːrɔst
mesti	mɛ̀ːsti
duda	dùːda
svet	sʋéːt
pozabiti	pɔzabíːti
latinščina	latíːnʃt͡ʃina
najravnejši	nájràːʋnɛjʃi
bajonet	bajɔnéːt
poljsko	póːlskɔ
tip	tíːp
poceni	pɔt͡sèːni
vikati	ʋíːkati
sovražiti	sɔʋraʒìːti
sef	séːf
drkata	də́rkata
plesti	plɛ̀ːsti
lažnivec	laʒníːʋət͡s
samoglasnik	samɔɡláːsnik
zalar	záːlar
violina	ʋijɔlíːna
sidro	sìːdrɔ
polje	póːljɛ
mlečen	mlèːt͡ʃən
informatik	infɔrmàːtik
prijateljski	prijáːtɛlski
tveganje	tʋèːɡanjɛ
hidrologija	xidrɔlɔɡíːja
vodič	ʋɔdít͡ʃ
hurija	xùːrija
skupina	skupìːna
posodobiti	pɔsɔdɔ́ːbiti
šum	ʃúːm
ja	jàː
v	ʋ
seveda	sɛʋéːda
lizati	lizàːti
najbogatejši	nájbɔɡatɛ́ːjʃi
veleposlaništvo	ʋɛ́lɛpɔslàːniʃtʋɔ
zemljepis	zɛmljɛpíːs
črv	t͡ʃə́rʋ
terbij	tɛ̀ːrbij
klepec	klɛ̀ːpət͡s
harmonika	xarmòːnika
ono	ɔ̀ːnɔ
fant	fánt
pestič	pɛstít͡ʃ
rabarbara	rabàːrbara
diamant	dijamáːnt
ukrajina	ukrajìːna
črnogorski	t͡ʃərnɔɡóːrski
redkejši	rèːtkɛjʃi
sončnejši	sóːnt͡ʃnɛjʃi
luna	lùːna
prebivalec	prɛbiʋáːlət͡s
trobenta	trɔbéːnta
največ	nájʋɛ́t͡ʃ
čaplja	t͡ʃáːplja
slovak	slɔʋàːk
trošt	tróːʃt
gledališče	ɡlɛdalìːʃt͡ʃɛ
zajtrk	záːjtərk
dalija	dàːlija
zajec	záːjət͡s
naključje	nakljúːt͡ʃjɛ
ris	ríːs
seksologija	sɛksɔlɔɡìːja
študirati	ʃtudíːrati
orgle	óːrɡlɛ
prebava	prɛbáːʋa
zbirati	zbìːrati
gosti	ɡòːsti
binom	binóːm
kajak	káːjak
križanka	kríːʒanka
kura	kùːra
bombaž	bɔmbáːʃ
samarij	samàːrij
sedanjik	sədàːnjik
redkejši	rɛtkɛ́ːjʃi
sposoditi	spɔsòːditi
pisati	pìːsati
nekdo	nɛɡdòː
pogovoren	pɔɡɔ́ːʋɔrən
jurij	jùːrij
jakac	jáːkat͡s
metati	mɛtàːti
libidinozen	libidinóːzən
grof	ɡrɔ́f
hruška	xrúːʃka
lizati	lìːzati
pekel	pə̀kəʋ
turoben	turɔ̀ːbən
govedina	ɡɔʋéːdina
plug	plúːk
enkrat	ɛnkrát
zora	zóːra
tok	tóːk
makedonec	makɛdóːnət͡s
pivo	pìːʋɔ
val	ʋáːl
dvomiti	dʋɔmíːti
plesen	pléːsən
sposoditi	spɔsɔdíːti
hraniti	xranìːti
irsko	íːrskɔ
rezati	rèːzati
atena	atéːna
indijski	ìːndijski
nag	náːk
srečnejši	srɛt͡ʃnɛ́ːjʃi
kjer	kjéːr
kuščar	kúːʃt͡ʃar
štirideset	ʃtíːridɛsɛt
modrost	mɔdróːst
tu	tú
ol	óːl
trije	tríːjɛ
prositi	prɔsíːti
kleopatra	klɛóːpatra
hlev	xléːʋ
medved	mɛ̀ːdʋɛt
dim	dím
reč	réːt͡ʃ
nemško	nèːmʃkɔ
sesati	sɛsàːti
tišina	tiʃìːna
raca	ràːt͡sa
švedski	ʃʋéːtski
zrklo	zə̀rklɔ
norveščina	nɔrʋéːʃt͡ʃina
puščati	pùːʃt͡ʃati
ličinka	lit͡ʃíːnka
semenovod	sɛmɛnɔʋɔ́t
slad	sláːt
ptič	ptít͡ʃ
pravičen	praʋíːt͡ʃən
čoln	t͡ʃɔ́ːʋn
nepotrpežljivejši	nɛ́pɔtərpɛʒljìːʋɛjʃi
sidro	síːdrɔ
vratič	ʋratít͡ʃ
tok	tɔ́k
hrbtenjača	xərptɛnjàːt͡ʃa
francija	fràːnt͡sija
tam	tám
sibirija	sibìːrija
buda	búːda
stanje	stàːnjɛ
dejaven	dɛjàːʋən
prvi	pə́rʋi
bratranec	bratráːnət͡s
ogledalo	ɔɡlɛdàːlɔ
zaljubiti	zaljubíːti
predvidljiv	prɛdʋidljìːʋ
ona	ɔ̀ːna
dobrodošel	dɔbrɔdɔ̀ːʃəʋ
poročnica	pɔróːt͡ʃnit͡sa
prstan	pə̀rstan
odeja	ɔdɛ́ːja
višnu	ʋíːʃnu
sem	sə́m
južnoslovanski	juʒnɔslɔʋáːnski
najresničnejši	nájrɛsníːt͡ʃnɛjʃi
velik	ʋɛ̀ːlik
rektalen	rɛktáːlən
sedanjik	sədáːnjik
snuti	snùːti
portret	pɔrtréːt
časopis	t͡ʃasɔpíːs
najslabši	nájsláːpʃi
zajtrkovati	zajtərkɔʋàːti
herodot	xɛróːdɔt
sinoči	sinóːt͡ʃi
čitati	t͡ʃíːtati
enaindvajset	ɛ́ːnaindʋáːjsɛt
samozadovoljevanje	sáːmɔzadɔʋɔljɛʋàːnjɛ
dvoživka	dʋɔʒíːʋka
kača	kàːt͡ʃa
vodomec	ʋɔdóːmət͡s
guba	ɡùːba
slika	slíːka
borovnica	bɔrɔʋnìːt͡sa
vrsta	ʋə̀rsta
kokot	kɔkóːt
kladivo	kladìːʋɔ
oče	ɔ̀ːt͡ʃɛ
most	móːst
plaža	plàːʒa
dimnik	díːmnik
madžarščina	mad͡ʒáːrʃt͡ʃina
dandanes	dáːndàːnəs
modo	mòːdɔ
prednik	préːdnik
tekočina	tɛkɔt͡ʃìːna
izgubiti	izɡubíːti
apostrof	apɔstróːf
žrebec	ʒrèːbət͡s
igo	iɡóː
dirka	díːrka
mrhovina	mərxɔʋìːna
šunka	ʃúːnka
roža	róːʒa
top	tɔ́p
solza	sɔ̀ːʋza
temen	təmə́n
najsmelejši	nájsmèːlɛjʃi
najpolnejši	nájpɔ̀ːlnɛjʃi
jokati	jɔkàːti
homoseksualnost	xɔmɔsɛksuáːlnɔst
moriti	mɔrìːti
hči	xt͡ʃíː
hašiš	xáːʃiʃ
pikapolonica	pikapɔlóːnit͡sa
uho	uxóː
zadovoljevati	zadɔʋɔljɛʋàːti
miha	mìːxa
dovršen	dɔʋə́rʃən
dokler	dɔklɛ́r
kras	kráːs
zarnik	záːrnik
glasen	ɡlàːsən
sredinec	srɛdíːnət͡s
cesta	t͡sèːsta
dan	dáːn
rešeto	rɛʃɛ̀ːtɔ
krompir	krɔmpìːr
nizozemski	nizɔzéːmski
najsvobodnejši	nájsʋɔbɔ̀ːdnɛjʃi
strupen	strúːpən
notri	nóːtri
dobiti	dɔbíːti
albanec	albáːnət͡s
zrel	zréːʋ
dansko	dáːnskɔ
karta	káːrta
gorčica	ɡóːrt͡ʃit͡sa
tukaj	túːkaj
les	léːs
nič	nít͡ʃ
enaindvajset	ɛ̀ːnaindʋáːjsɛt
najživahnejši	nájʒiʋàːxnɛjʃi
delo	dèːlɔ
groziti	ɡrɔzìːti
slovensko	slɔʋèːnskɔ
geslo	ɡɛ̀ːslɔ
rožmarin	róːʒmarin
odjaviti	ɔdjàːʋiti
malti	máːlti
rodij	ròːdij
priimek	priíːmək
veniti	ʋèːniti
moldavija	mɔldàːʋija
motika	mɔtíːka
aristotel	aristóːtɛl
maltežan	maltɛʒán
kava	kàːʋa
potem	pɔtɛ́m
puran	puráːn
božanstvo	bɔʒáːnstʋɔ
epir	ɛpíːr
kopno	kɔ̀ːpnɔ
kašelj	kàːʃəl
najhitrejše	nájxitrɛ̀ːjʃɛ
razumeti	razumèːti
skusiti	skùːsiti
deva	déːʋa
črkovati	t͡ʃərkɔʋàːti
čebula	t͡ʃɛbùːla
zaspati	zaspàːti
stopiti	stòːpiti
majoneza	majɔnéːza
spustiti	spustíːti
nemčija	néːmt͡ʃija
pesnik	péːsnik
jugoslavija	juɡɔslàːʋija
metafizika	mɛtafìːzika
sovražiti	sɔʋraʒíːti
včlaniti	ʋt͡ʃláːniti
kopati	kòːpati
beloruski	bɛlɔrúːski
služba	slúːʒba
plutonij	plutòːnij
hadron	xadróːn
hrbet	xə̀rbət
slovaški	slɔʋáːʃki
obljubiti	ɔbljùːbiti
bogomolka	bɔɡɔmóːlka
bradatejši	bradàːtɛjʃi
gorčica	ɡɔrt͡ʃìːt͡sa
brdavs	bərdáːʋs
daljšati	dáːlʃati
lepota	lɛpɔ̀ːta
del	dèːʋ
gregorič	ɡrèːɡɔrit͡ʃ
od	ɔt
lok	lóːk
klobučar	klɔbut͡ʃàːr
prazniti	prazníːti
finec	fíːnət͡s
zoreti	zɔrèːti
nekje	nɛkjéː
človek	t͡ʃlɔ̀ːʋɛk
telesen	tɛléːsən
policist	pɔlit͡síːst
vendar	ʋə̀ndar
seznam	sɛznáːm
friz	fríːs
koledar	kɔlɛdàːr
skodelica	skɔdéːlit͡sa
varšava	ʋarʃáːʋa
obmodek	ɔbmóːdək
bergla	béːrɡla
veleposlanik	ʋɛ́lɛpɔslàːnik
kompas	kɔmpáːs
srebrn	srɛbə́rn
ta	táː
anomalija	anɔmalíːja
baker	bàːkər
hostnik	xóːstnik
lepiti	lèːpiti
indija	ìːndija
južen	jùːʒən
sokrat	sóːkrat
lokacija	lɔkàːt͡sija
novak	nɔʋàːk
boste	bóːstɛ
skupaj	skúːpaj
bruto	brúːtɔ
bezeg	bəzə́k
perutnina	pɛrutnìːna
vreme	ʋrɛ̀ːmɛ
oblika	ɔblíːka
čakati	t͡ʃàːkati
voditi	ʋɔdíːti
fukajoč	fukajòːt͡ʃ
pogoj	pɔɡɔ́j
erekcija	ɛrèːkt͡sija
jež	jéːʃ
ogor	ɔɡóːr
jeruzalem	jɛrúːzalɛm
zobozdravstvo	zɔbɔzdráːʋstʋɔ
sadovnjak	sadɔʋnjàːk
amarant	amaráːnt
bizgec	bíːzɡət͡s
povratnik	pɔʋráːtnik
pofukan	pɔfúːkan
žalost	ʒàːlɔst
agrumi	aɡrúːmi
mehaničen	mɛxàːnit͡ʃən
želeti	ʒɛlèːti
divjak	dìːʋjak
fotograf	fɔtɔɡráːf
poljub	pɔljúːp
kazahstan	káːzaxstan
toda	tɔda
zamuditi	zamudíːti
češnja	t͡ʃéːʃnja
vogal	ʋɔɡáːʋ
vtis	ʋtíːs
janež	jàːnɛʃ
šantati	ʃantàːti
kokalj	kòːkal
rasti	ràːsti
lombardija	lɔmbardíːja
kladivce	klàːdiʋt͡sɛ
vojvoda	ʋóːjʋɔda
poplava	pɔpláːʋa
zona	t͡sóːna
tast	táːst
begunec	bɛɡúːnət͡s
primež	príːmɛʃ
metla	mɛ̀ːtla
mitologija	mitɔlɔɡíːja
zrel	zrɛ́ʋ
presenečenje	prɛsɛnéːt͡ʃɛnjɛ
masturbacija	masturbàːt͡sija
dolgovaloven	dɔʋɡɔʋalɔ́ːʋən
bodiva	bòːdiʋa
osebnost	ɔséːbnɔst
prašnik	práːʃnik
klešče	klèːʃt͡ʃɛ
nositi	nɔsíːti
volja	ʋòːlja
žebelj	ʒɛ̀ːbəl
poročen	pɔrɔt͡ʃɛ́n
ujec	úːjət͡s
izgovoriti	izɡɔʋɔríːti
likati	líːkati
štiri	ʃtìːri
dvovidski	dʋóːʋíːtski
dvom	dʋɔ́m
wikislovar	ʋikislɔʋàːr
čustven	t͡ʃúːstʋən
one	ɔ̀ːnɛ
kino	kíːnɔ
tokata	tɔkáːta
smer	sméːr
kukavica	kùːkaʋit͡sa
drozg	dróːsk
mehek	mɛ̀ːxək
žgati	ʒɡàːti
iglica	íːɡlit͡sa
pozornost	pɔzòːrnɔst
ključ	kljùːt͡ʃ
prazniti	praznìːti
heraldika	xɛràːldika
vaterpolo	ʋàːtɛrpóːlɔ
trg	tə́rk
pi	píː
prihodnost	prixóːdnɔst
avstrijec	aʋstríːjət͡s
helij	xèːlij
nepredvidljiv	nɛ́prɛdʋidljìːʋ
obesiti	ɔbèːsiti
sok	sóːk
papež	páːpɛʃ
žagati	ʒáːɡati
grozljivejši	ɡrɔzljìːʋɛjʃi
mravlja	mráːʋlja
nizozemščina	nizɔzéːmʃt͡ʃina
želodec	ʒɛlóːdət͡s
najjasnejši	nájjàːsnɛjʃi
milo	mìːlɔ
pločevinka	plɔt͡ʃɛʋíːnka
ogor	óːɡɔr
gejzir	ɡɛjzìːr
španija	ʃpàːnija
esej	ɛsɛ́ːj
feniks	féːniks
bradavica	bradaʋìːt͡sa
prispevek	prispéːʋək
žara	ʒàːra
ustje	ùːstjɛ
vodomec	ʋɔdòːmət͡s
speti	spèːti
amerika	amɛ́ːrika
najabsurdnejši	nájapsúːrdnɛjʃi
del	déːl
miška	míːʃka
risati	ríːsati
damjak	dáːmjak
leon	léːɔn
sir	sír
počasneje	pɔt͡ʃasnɛ́ːjɛ
kola	kɔ̀ːla
triangel	trijàːnɡəl
vltava	ʋə́ltaʋa
epistemologija	ɛpistɛmɔlɔɡìːja
toplota	tɔplɔ̀ːta
izgovorjava	izɡɔʋɔrjáːʋa
brazda	bràːzda
vroč	ʋrɔ́t͡ʃ
kljun	kljúːn
osmij	òːsmij
spoznati	spɔznàːti
danka	dáːnka
uporabnik	upɔráːbnik
breg	bréːk
asteroid	astɛrɔíːt
stožec	stòːʒət͡s
erotičen	ɛròːtit͡ʃən
menjati	mèːnjati
pozitron	pɔzitróːn
bližnjica	blíːʒnjit͡sa
bratranec	bràːtranət͡s
kockati	kóːt͡skati
tla	tlá
renij	rèːnij
glodalec	ɡlɔdáːlət͡s
barva	báːrʋa
češkoslovaška	t͡ʃéːʃkɔslɔʋáːʃka
kostanj	kɔ̀ːstan
teta	tɛ̀ːta
le	lɛ́
grozdje	ɡròːzdjɛ
sesati	səsàːti
nadporočnik	natpɔróːt͡ʃnik
najpestrejši	nájpèːstrɛjʃi
znati	znàːti
družba	drúːʒba
kozel	kɔ̀ːzəʋ
levinja	lɛ̀ːʋinja
zebsti	zèːpsti
pogostejše	pɔɡóːstɛjʃɛ
hud	xúːt
mornarka	mɔrnàːrka
anakonda	anakóːnda
dob	dóːp
jazbec	jáːzbət͡s
americij	amɛrìːt͡sij
najpodlejši	nájpɔ̀ːdlɛjʃi
oster	òːstər
miti	mìːti
dihur	dixùːr
dvigniti	dʋìːɡniti
vezati	ʋɛzàːti
car	t͡sáːr
obleka	ɔbléːka
ukvarjati	ukʋàːrjati
brskati	bərskati
drkajte	də́rkajtɛ
radon	radóːn
jasnejši	jàːsnɛjʃi
kljunaš	kljunàːʃ
večerja	ʋɛt͡ʃéːrja
revolucija	rɛʋɔlùːt͡sija
ustreznejši	ustrèːznɛjʃi
suh	súːx
različen	razlìːt͡ʃən
opereta	ɔpɛréːta
barka	báːrka
poslušati	pɔslùːʃati
vas	ʋáːs
bombnik	bóːmbnik
največji	nájʋéːt͡ʃji
okopati	ɔkɔpàːti
flavta	fláːʋta
molčati	mɔʋt͡ʃàːti
moj	mòːj
zmagovalec	zmaɡɔʋáːlət͡s
miza	mìːza
jagnjec	jàːɡnjɛt͡s
najnepotrpežljivejši	nájnɛ́pɔtərpɛʒljìːʋɛjʃi
luksemburg	lúːksɛmburk
idila	idíːla
briga	bríːɡa
pav	páːʋ
streha	strèːxa
muflon	muflóːn
barion	barijóːn
andaluzija	andalùːzija
jelena	jɛléːna
depresija	dɛprɛsíːja
polbrat	pɔ́ːʋbrát
očitnejši	ɔt͡ʃìːtnɛjʃi
karamela	karaméːla
tradicionalen	tradit͡siɔnáːlən
luska	lùːska
za	za
rešiti	rèːʃiti
revnejši	rèːʋnɛjʃi
sončen	sóːnt͡ʃən
hiba	xìːba
žepar	ʒɛ́ːpar
korošec	kɔróːʃət͡s
klokan	klóːkan
ali	ali
pomagati	pɔmaɡàːti
uporabiti	upɔrabìːti
peti	pèːti
vreči	ʋrèːt͡ʃi
klobasa	klɔbàːsa
zvezek	zʋéːzək
ko	kɔ
tema	təmá
ostriga	ɔstríːɡa
prislov	prislɔ́ʋ
zgodovina	zɡɔdɔʋìːna
nekropola	nɛkróːpɔla
hladilnik	xladíːlnik
najboljše	nájbóːlʃɛ
nastati	nastàːti
žeti	ʒèːti
vhod	ʋxɔ́t
hitrejše	xitrɛ̀ːjʃɛ
dva	dʋáː
blaznik	bláːznik
ločiti	lɔt͡ʃìːti
smejati	smɛjàːti
hitreje	xitrɛ̀ːjɛ
lev	lɛ́ʋ
najpridnejši	nájprìːdnɛjʃi
lutecij	lutèːt͡sij
bližje	blíːʒjɛ
nedovršen	nɛ́dɔʋə́rʃən
do	dɔ
baskovski	báːskɔʋski
danes	dàːnəs
tramvaj	tramʋáːj
resničnejši	rɛsníːt͡ʃnɛjʃi
ljubit	ljùːbit
spomniti	spóːmniti
izpeljanka	ispɛljàːnka
poljubiti	pɔljúːbiti
piti	pìːti
nizozemska	nizɔzéːmska
kot	kòːt
praštevilo	práːʃtɛʋìːlɔ
siriščnik	siríːʃt͡ʃnik
uraden	uráːdən
amulet	amuléːt
bozon	bɔzóːn
vključiti	ʋkljùːt͡ʃiti
kad	kát
grji	ɡə́rji
bodo	bóːdɔ
človeški	t͡ʃlɔʋèːʃki
par	pàːr
starka	stáːrka
oblak	ɔbláːk
ogel	òːɡəʋ
krst	kə́rst
lavrencij	laʋrèːnt͡sij
prevod	prɛʋɔ́t
žirafa	ʒiráːfa
miš	míʃ
poljščina	póːlʃt͡ʃina
prašati	pràːʃati
pustejši	pustɛ́ːjʃi
redkev	rɛ̀ːtkəʋ
uš	úːʃ
sprememba	sprɛméːmba
pomembnost	pɔméːmbnɔst
pozabiti	pɔzabìːti
as	áːs
mešati	mɛʃàːti
pojasniti	pɔjasníːti
polnejši	pɔ̀ːʋnɛjʃi
geologija	ɡɛɔlɔɡíːja
temperatura	tɛmpɛratúːra
sinhron	sinxróːn
bretonsko	brɛtóːnskɔ
sol	sóːʋ
naenkrat	naɛ̀ːnkrat
vendar	ʋə́ndar
smola	smɔ̀ːla
okus	ɔkúːs
burja	búrja
pomenoslovje	pɔmɛnɔslɔ́ːʋjɛ
kvartet	kʋartéːt
rudnik	rúːdnik
zgodovinski	zɡɔdɔʋíːnski
hidžra	xíːd͡ʒra
srbohrvaščina	sərbɔxərʋáːʃt͡ʃina
anarhist	anarxíːst
pica	pìːt͡sa
trd	tə́rt
pornograf	pɔrnɔɡráːf
vrt	ʋə́rt
sreča	srèːt͡ʃa
osemnajst	ɔsəmnàːjst
jordanija	jɔrdàːnija
bedro	bɛ̀ːdrɔ
vretence	ʋrɛtɛ̀ːnt͡sɛ
ded	dɛ́t
golobica	ɡɔlɔbìːt͡sa
sedanjik	sɛdàːnjik
regrat	rèːɡrat
golob	ɡɔlóːp
modrost	mòːdrɔst
primež	prìːmɛʃ
najzanimivejši	nájzanimìːʋɛjʃi
kositi	kɔsìːti
pripona	pripóːna
braniti	bràːniti
najsplošnejši	nájsplɔ̀ːʃnɛjʃi
sleči	slèːt͡ʃi
kontrabas	kóːntrabáːs
klicaj	klit͡sáːj
šola	ʃóːla
diskriminacija	diskriminàːt͡sija
mrtev	mə̀rtəʋ
evropa	ɛʋróːpa
grofija	ɡrɔfíːja
jetra	jèːtra
wikipedija	ʋikipɛdíːja
slovenski	slɔʋèːnski
levinja	lɛ́ːʋinja
demiurg	dɛmijúːrk
arzen	arzéːn
časnik	t͡ʃáːsnik
kovač	kɔʋàːt͡ʃ
jutro	jùːtrɔ
peter	pèːtər
jug	júːk
pustiti	pustìːti
dajalnik	dajáːlnik
pogrešati	pɔɡrèːʃati
glasnejši	ɡlasnɛ́ːjʃi
sloka	slóːka
stoletje	stɔléːtjɛ
cvrček	t͡sʋə́rt͡ʃək
stavba	stáːʋba
kilometer	kilɔmèːtər
še	ʃɛ
mehika	méːxika
prevesti	prɛʋɛ̀ːsti
prtljaga	pərtljáːɡa
resničnejši	rɛsnìːt͡ʃnɛjʃi
maltežan	maltɛʒáːn
belgija	bèːlɡija
nekje	nɛkjèː
vran	ʋráːn
šank	ʃáːnk
last	láːst
sesti	sèːsti
dve	dʋéː
tkivo	tkìːʋɔ
tvoriti	tʋòːriti
drseti	dərsèːti
popolnoma	pɔpɔ́ːʋnɔma
ramovš	ramɔ́ːʋʃ
kaj	káj
pila	pìːla
rima	ríːma
geografija	ɡɛɔɡrafíːja
tomahavk	tɔmaxáːʋk
deček	déːt͡ʃək
tarča	táːrt͡ʃa
tudi	túːdi
zakaj	zakàːj
haag	xáːk
zgradba	zɡráːdba
mošeja	mɔʃɛ́ːja
jemati	jɛmàːti
rojen	rɔ̀ːjɛn
lokativ	lóːkatiʋ
svizec	sʋíːzət͡s
ponarediti	pɔnarɛdíːti
moder	mòːdər
imenovati	imɛnɔʋàːti
noter	nóːtɛr
zdravica	zdraʋìːt͡sa
meč	mɛ́t͡ʃ
golt	ɡɔ́ːʋt
pomembnejši	pɔméːmbnɛjʃi
priložnost	prilòːʒnɔst
pepel	pɛpéːʋ
glagolica	ɡlaɡóːlit͡sa
amper	ampɛ́ːr
deset	dɛséːt
jagnjec	jáːɡnjɛt͡s
bron	brɔ́n
bog	bóːk
kositer	kɔsìːtər
čevljekljun	t͡ʃéːʋljɛkljúːn
bogastvo	bɔɡáːstʋɔ
komunizem	kɔmunìːzəm
živahnejši	ʒiʋàːxnɛjʃi
psica	psìːt͡sa
gol	ɡóːl
dojilja	dɔjìːlja
slovar	slɔʋàːr
brca	bə́rt͡sa
slovakinja	slɔʋàːkinja
zbrati	zbràːti
cirilica	t͡siríːlit͡sa
andreaš	andrɛàːʃ
vklopiti	ʋklɔpìːti
bik	bík
dajalec	dajáːlət͡s
kralj	kràːl
svinec	sʋìːnət͡s
medicina	mɛdit͡síːna
huriska	xuríːska
eto	ɛ́tɔ
slišati	slìːʃati
kraljevina	kraljɛʋìːna
god	ɡóːt
najskromnejši	nájskrɔ̀ːmnɛjʃi
rusija	rúːsija
stotnik	stóːtnik
kita	kìːta
pravilnejše	praʋíːlnɛjʃɛ
izrael	íːzraɛl
lubenica	lúːbɛnit͡sa
deber	déːbər
glagol	ɡlàːɡɔl
zakleniti	zaklɛnìːti
taščica	tàːʃt͡ʃit͡sa
kladivce	kladíːʋt͡sɛ
različnejši	razlìːt͡ʃnɛjʃi
valj	ʋáːl
zlomljen	zlòːmljɛn
riž	ríːʃ
obraniti	ɔbraníːti
turizem	turìːzəm
radon	ráːdɔn
rozman	róːzman
liga	lìːɡa
gonoreja	ɡɔnɔrɛ́ːja
oprostite	ɔprɔstíːtɛ
epicenter	ɛpit͡sɛ́ːntər
glina	ɡlìːna
srna	sə̀rna
papiga	páːpiɡa
smisel	smíːsəʋ
vrednost	ʋrèːdnɔst
epicenter	ɛpit͡séːntər
afganistan	aʋɡáːnistan
baskovščina	báːskɔʋʃt͡ʃina
avstrijski	aʋstríːjski
vnukinja	ʋnùːkinja
devetnajst	dɛʋɛtnàːjst
drobnjak	drɔbnjàːk
sonet	sɔnéːt
priča	prìːt͡ʃa
hijena	xijéːna
prehlad	prɛxlát
trideset	tríːdɛsɛt
veber	ʋèːbər
banja	bàːnja
nekam	nèːkam
zehati	zèːxati
najpotrebnejši	nájpɔtrèːbnɛjʃi
dvojka	dʋóːjka
najmodrejši	nájmòːdrɛjʃi
počitek	pɔt͡ʃíːtək
b	béː
potreben	pɔtrèːbən
klopotača	klɔpɔtàːt͡ʃa
srečati	sréːt͡ʃati
stotnica	stóːtnit͡sa
ena	ɛ̀ːna
štirinajst	ʃtíːrinajst
vzpon	ʋspɔ́n
ultrakratkovaloven	úːltrakratkɔʋalɔ́ːʋən
dromlja	dróːmlja
bolha	bɔ̀ːʋxa
vklopiti	ʋklòːpiti
zakristija	zakristíːja
spregatev	sprɛɡáːtəʋ
poslušati	pɔsluʃàːti
ločiti	lɔt͡ʃíːti
polje	pɔljéː
vljudnost	ʋljùːdnɔst
princ	príːnt͡s
škorec	ʃkɔ̀ːrət͡s
beograd	béːɔɡrat
najneumnejši	nájnɛùːmnɛjʃi
najnevarnejši	nájnɛʋàːrnɛjʃi
srednji	sréːdnji
topel	tòːpəʋ
štor	ʃtóːr
predvidljivost	prɛdʋidljìːʋɔst
kolesariti	kɔlɛsàːriti
razpelo	raspɛ̀ːlɔ
šteti	ʃtèːti
grofica	ɡrɔfìːt͡sa
krogla	króːɡla
astrologija	astrɔlɔɡíːja
švedščina	ʃʋéːtʃt͡ʃina
kriti	krìːti
tepsti	tɛ̀ːpsti
mungo	múːnɡɔ
džamija	d͡ʒàːmija
tkati	tkàːti
kmetija	kmɛtíːja
želod	ʒɛ̀ːlòːt
dedovati	dèːdɔʋati
sladoled	sladɔléːt
strukturalen	strukturáːlən
bolan	bɔláːn
najpravilnejše	nájpraʋíːlnɛjʃɛ
mesojedec	mɛsɔjéːdət͡s
karel	kàːrəl
zona	zóːna
afna	àːfna
ljubosumen	ljubɔsùːmən
leha	lèːxa
novinec	nɔʋíːnət͡s
med	méːt
semenski	sɛméːnski
krempelj	krèːmpəl
brin	brín
evo	ɛ́ʋɔ
napaka	napáːka
padati	páːdati
danska	dáːnska
uvel	uʋɛ́ʋ
peron	pɛróːn
poljedelstvo	pɔljɛdéːlstʋɔ
prijateljstvo	prijáːtɛlstʋɔ
biser	bíːsɛr
puška	púːʃka
pluton	plúːtɔn
ti	tíː
mravlja	mràːʋlja
met	mɛ́t
vesti	ʋèːsti
muskularen	muskuláːrən
vrabec	ʋràːbət͡s
braniti	branìːti
džez	d͡ʒéːs
veličina	ʋɛlit͡ʃìːna
zelje	zèːljɛ
ženska	ʒèːnska
svetnik	sʋɛtnìːk
čeh	t͡ʃéːx
opica	óːpit͡sa
pustinja	pustìːnja
oder	òːdər
brihtnejši	brìːxtnɛjʃi
zob	zóːp
praded	práːdéːt
hafnij	xàːfnij
kaj	kàːj
vila	ʋíːla
hrvaščina	xərʋáːʃt͡ʃina
kratkovaloven	kratkɔʋalɔ́ːʋən
tod	tòːt
jarek	jáːrək
srce	sərt͡séː
računalnik	rat͡ʃunáːlnik
merjasec	mɛrjàːsət͡s
radirka	radíːrka
krščanstvo	kərʃt͡ʃáːnstʋɔ
pljuča	pljùːt͡ʃa
pisarna	pisáːrna
najbradatejši	nájbradàːtɛjʃi
z	s
paleolitik	palɛɔlìːtik
romun	rɔmúːn
gospodar	ɡɔspɔdàːr
štirje	ʃtìːrjɛ
prostitucija	prɔstitùːt͡sija
vršilec	ʋərʃíːlət͡s
selen	sɛléːn
figa	fìːɡa
dajati	dajàːti
por	póːr
božur	bɔʒùːr
izglagolski	izɡlàːɡɔlski
prestolnica	prɛstóːlnit͡sa
majorka	majóːrka
sistem	sistéːm
mejak	mɛjàːk
motor	móːtɔr
s	s
pogum	pɔɡúːm
si	sí
rosa	rɔ̀ːsa
lice	lìːt͡sɛ
hoteti	xɔtèːti
rožmarin	rɔʒmaríːn
žica	ʒìːt͡sa
grški	ɡə́rʃki
hmelj	xméːl
kupiti	kupíːti
najpodrobnejši	nájpɔdróːbnɛjʃi
zelo	zɛlóː
upanje	úːpanjɛ
muzikalen	muzikáːlən
bruselj	brùːsəl
libija	lìːbija
zel	zéːʋ
rešitev	rɛʃíːtəʋ
stopalo	stɔpàːlɔ
pena	pèːna
klati	klàːti
meriti	mèːriti
meniti	mèːniti
oltar	ɔltàːr
litovščina	lìːtɔʋʃt͡ʃina
breskev	bréːskəʋ
holm	xòːlm
temniti	təmnìːti
grlo	ɡə̀rlɔ
dolgočasen	dɔʋɡɔt͡ʃàːsən
ličnica	líːt͡ʃnit͡sa
dati	dàːti
trajekt	trajéːkt
smeti	smèːti
sam	sáːm
sklon	sklɔ́n
krma	kə̀rma
deber	dèːbər
gol	ɡɔ́ːʋ
ekonomija	ɛkɔnɔmíːja
pot	póːt
blag	bláːk
suženj	sùːʒən
koza	kɔ̀ːza
polnoč	pɔ́ːʋnɔt͡ʃ
vsejedec	ʋsɛjéːdət͡s
španka	ʃpáːnka
sejšeli	sɛjʃéːli
dan	dàːn
tekač	tɛkàːt͡ʃ
boben	bóːbən
zlaten	zláːtən
kopno	kóːpnɔ
astronomija	astrɔnɔmíːja
hektoliter	xéːktɔlìːtər
lama	làːma
prost	prɔ́st
polh	pɔ̀ːʋx
slezenovec	slɛzéːnɔʋət͡s
obsečnica	ɔpséːt͡ʃnit͡sa
butara	bùːtara
arhitektura	arxitɛktúːra
ščit	ʃt͡ʃíːt
hripav	xrìːpaʋ
grešiti	ɡrɛʃìːti
čutiti	t͡ʃùːtiti
kitajec	kitáːjət͡s
stol	stɔ́ʋ
glava	ɡlàːʋa
govoriti	ɡɔʋɔríːti
latvijka	làːtʋijka
gruzijski	ɡrúːzijski
kazen	káːzən
avstrijka	aʋstríːjka
post	pɔ́st
sloka	slòːka
urban	urbáːn
kosinus	kóːsinus
srečneje	srèːt͡ʃnɛjɛ
jemen	jèːmən
vprašanje	ʋpraʃáːnjɛ
minuta	minúːta
končno	kɔ̀ːnt͡ʃnɔ
otvoriti	ɔtʋòːriti
žolna	ʒɔ̀ːʋna
veznik	ʋéːznik
mačka	máːt͡ʃka
cigareta	t͡siɡaréːta
gozd	ɡóːst
prisotnost	prisɔ̀ːtnɔst
zajtrk	zàːjtərk
drka	də́rka
zemlja	zɛ̀ːmlja
njihov	njìːxɔʋ
grba	ɡə̀rba
tavžent	táːʋʒɛnt
sva	sʋá
starodaven	starɔdàːʋən
kako	kakóː
sirotka	sìːrɔtka
plesati	plèːsati
delfin	dɛlfíːn
neptun	nɛptúːn
žleza	ʒlèːza
nor	nɔ́r
fižol	fiʒɔ́ʋ
tvegati	tʋèːɡati
prižnica	prìːʒnit͡sa
gimnazija	ɡimnàːzija
muha	mùːxa
gol	ɡɔ́ʋ
misliti	mìːsliti
vpiti	ʋpìːti
radar	ràːdar
