girtat	kirːtaht
vihtta	vihːta
njeađgat	ɲea̯ðːkaht
ruobbut	ruo̯bːbuːht
nullen	nuːllen
gorri	korːriː
ovdamearka	ovːtamea̯rːka
hávda	haːvːta
bodda	podːda
goaski	koɑ̯sːkiː
čuohcit	t͡ʃuo̯ht͡siːht
ahte	ahte
ruibi	rujːpiː
diggi	tiɡːɡiː
ruoškit	ruo̯ʃːkiːht
sikta	sikːta
oalát	oɑ̯laːht
noga	noka
suodji	suo̯ɟɟiː
dis	tiːs
ruskat	rusːkaht
hávkka	haːvkka
čieža	t͡ʃie̯t͡ʃa
ruossat	ruo̯ssaht
gurdit	kurːtiːht
njávgut	ɲaːvːkuːht
maŋŋidis	maŋɲiːtis
šearfa	ʃea̯rːfa
reavgit	rea̯vːkiːht
mordos	moːrːtos
hirsa	hirːsa
rátnu	raːtnuː
ođđaseamos	oððase̯amos
gelde	keːlːte
lihtter	lihːter
dihkki	tihːkiː
báidnit	paːjːtniːht
čalmmas	t͡ʃalmmas
eatnagat	ea̯tnakaht
čierrut	t͡ʃie̯rruːht
viessu	vie̯ssuː
dálvat	taːlːvaht
lieđđut	lie̯ððuːht
njuolla	ɲuo̯lla
biedju	pie̯ɟɟuː
jávri	jaːvːriː
girku	kirːkuː
eallju	ea̯ʎːʎuː
meardi	mea̯rːtiː
čeahpit	t͡ʃea̯hpiːht
doaivvuhit	toɑ̯jvvuːhiht
dola	tola
rušpi	ruʃːpiː
soahti	soɑ̯htiː
čáhppadeamos	t͡ʃaːhːpate̯amos
váibmu	vaːjːpmuː
borren	porren
rukses	ruːkːses
čavgat	t͡ʃavːkaht
bákŋi	paːtɲiː
suovva	suo̯vva
sáddet	saːdːdeht
leaŋga	lea̯ŋːka
aiddolaš	ajːttolaʃ
alihit	aliːhiht
siida	sijːta
avii	avij
vuoigat	vuo̯jːkaht
nargit	narːkiːht
allet	alleht
iežaska	ie̯t͡ʃaska
dohppa	tohːpa
heavdni	hea̯vːtniː
sakka	sakka
arvvosmit	arvvosmiht
cissat	t͡sisːsaht
bihpar	pihpar
návdi	naːvːtiː
bállu	paːlːluː
idja	iɟɟa
eadnádet	ea̯dːnaːteht
bivaheapme	pivahe̯apme
hevro	hevːro
doarggistit	toɑ̯rːkkiːstiht
amastit	amastiht
allot	alloht
luondu	luo̯nːtuː
breava	prea̯va
muitu	mujːtuː
addalit	adːdaliht
riibat	rijːpaht
bikšut	pikːʃuːht
guostát	kuo̯sːtaːht
báŋku	paːŋːkuː
einnostit	eːjnnostiht
juopmu	juo̯pmuː
sápmi	saːpmiː
roavgu	roɑ̯vːkuː
fihtolaš	fiːhtolaʃ
cuovka	t͡suo̯vːka
boahtin	poɑ̯htiːn
čearret	t͡ʃe̯arreht
gahčat	kaht͡ʃaht
muohtu	muo̯htuː
rivgu	rivːkuː
aiddonassii	ajːttonassij
garvit	karːviːht
lieđbmi	lie̯ðːpmiː
garcut	karːt͡suːht
savvi	savːviː
lohku	lohkuː
amas	amas
vuodjit	vuo̯ɟɟiːht
bohtás	pohtaːs
haŋkit	haŋːkiːht
arvu	arːvuː
fállá	faːlːlaː
broma	proːma
ozan	ot͡san
dál	taːl
anáraš	anaːraʃ
ráfi	raːfiː
basten	pasːten
iras	iras
issorasat	issorasaht
bolde	poːlːte
oliiga	olijka
davvisámegiella	tavviːsaːmekie̯lla
ándaras	aːnːtaras
morde	moːrːte
loaidu	loɑ̯jːtuː
veahkehit	ve̯ahkehiht
doidit	tojːtiːht
oallut	oɑ̯lluːht
besten	peːsːten
čiegus	t͡ʃie̯kuːs
jokŋa	jotɲa
readnját	rea̯dːɲaːht
beana	pea̯na
aiddostahttit	ajːttostahːtiːht
sálga	saːlːka
lutkoseamos	luːtːkose̯amos
njáškát	ɲaːʃːkaːht
luomi	luo̯miː
dološ	toloʃ
alimas	aliːmas
nearrat	nea̯rraht
cuovkaneapmi	t͡suo̯vːkanea̯pmiː
loamši	loɑ̯mːʃiː
jarfát	jarːfaːht
njuorjju	ɲuo̯rjjuː
suovdnji	suo̯vːtɲiː
ollon	ollon
ođas	oðas
ropmi	ropmiː
čalmmehit	t͡ʃalmmehiht
málet	maːleht
almmustit	almmuːstiht
boađus	poɑ̯ðuːs
allon	allon
muollat	muo̯llaht
kruvdno	kruvːtno
veakta	vea̯kːta
dagat	takaht
vuoksa	vuo̯kːsa
gosa	kosa
gávppašit	kaːvppaʃiht
čavggat	t͡ʃavːkkaht
duottar	tuo̯ttar
beaivit	pea̯jːviːht
árrot	aːrroht
girji	kirːjiː
dát	taːht
čeabet	t͡ʃe̯apeht
gaskkas	kaskas
iežan	ie̯t͡ʃan
muinna	mujnna
gállit	kaːlliːht
fuobmát	fuo̯bːmaːht
leimmet	lejmmeht
ruvdet	ruːvːteht
čuovvut	t͡ʃuo̯vvuːht
osten	oːsːten
nuppi	nuppiː
mordet	moːrːteht
čállin	t͡ʃaːlliːn
nuorti	nuo̯rːtiː
áno	aːno
hedjonit	heːɟɟoniht
leaibi	lea̯jːpiː
na	na
ollislaš	olliːslaʃ
duodji	tuo̯ɟɟiː
cáhkkat	t͡saːhːkaht
njuoskat	ɲuo̯sːkaht
bájil	paːjiːl
minguin	miːnːkujn
ealet	e̯aleht
čávgŋi	t͡ʃaːvːtɲiː
mearas	mea̯ras
áiggi	aːjːkkiː
bures	puːres
roahttu	roɑ̯hːtuː
rievdat	rie̯vːtaht
gárbbis	kaːrːppiːs
addi	adːdiː
nearva	nea̯rːva
viellja	vie̯ʎːʎa
beassi	pea̯ssiː
astan	asːtan
ellet	eːlleht
dalle	talle
binná	pinːnaː
ođasmit	oðasmiht
ave	ave
de	te
balat	palaht
vivva	vivva
lossadit	lossatiht
dovde	tovːte
bordon	porːton
deatnu	tea̯tnuː
sadje	saɟɟe
davvenuorti	tavvenuo̯rːtiː
jahtat	jahtaht
máššat	maːʃʃaht
oadju	oɑ̯ɟɟuː
lođa	loða
linnjár	liɲːɲaːr
gádja	kaːɟɟa
imi	imiː
munnuide	munːnujte
álkit	aːlːkiːht
ráhkis	raːhkiːs
geahčastallat	kea̯ht͡ʃastallaht
deadja	tea̯ɟɟa
cummá	t͡sumːmaː
várri	vaːrriː
čorget	t͡ʃorːkeht
áilu	aːjːluː
diktit	tikːtiːht
suhkat	suhkaht
rassat	rassaht
olgeš	olːkeʃ
mielli	mie̯lːliː
dáhtolaš	taːhtolaʃ
iđit	iðiːht
dievvat	tie̯vvaht
buoidi	puo̯jːtiː
buoremus	pu̯oremus
vearru	vea̯rruː
jierbmat	jie̯rːpmaht
deasttaheapme	tea̯stahe̯apme
ii	ij
roakči	roɑ̯kːt͡ʃiː
ostot	oːsːtoht
figgat	fiɡːɡaht
sadden	sadːden
sáhkohit	saˑhkohiht
bircu	pirːt͡suː
namma	namma
mollit	molːliːht
čuorgadeamos	t͡ʃuo̯rːkate̯amos
náitit	naːjːtiːht
bumma	pumːma
leaksu	lea̯kːsuː
manat	manaht
buohcat	puo̯ht͡saht
leahkit	lea̯hkiːht
máidnut	maːjːtnuːht
agás	akaːs
rievdadit	rie̯vːtatiht
leage	le̯ake
njammat	ɲammaht
ole	ole
laman	laman
goaikut	koɑ̯jːkuːht
dáža	taːt͡ʃa
helbmo	helːpmo
gahččat	kahːt͡ʃaht
čižži	t͡ʃidːd͡ʒiː
bumbá	pumːpaː
givlo	kivːlo
bárdnat	paːrːtnaht
molan	molan
mulgut	mulːkuːht
boddu	podːduː
sohpat	sohpaht
dorvvolit	torvvoliht
lutkosit	luːtːkosiht
maŋŋá	maŋɲaː
čihkosit	t͡ʃiːhkosiht
orrut	orruːht
gorde	koːrːte
duolbmat	tuo̯lːpmaht
giđđat	kiððaht
eallisilba	ea̯lːliːsilːpa
ruoktot	ruo̯kːtoht
soavli	soɑ̯vːliː
njáhká	ɲaːhkaː
dolaheapme	tolahe̯apme
mannet	manneht
álki	aːlːkiː
čáhkat	t͡ʃaːhkaht
cieggat	t͡sie̯ɡːɡaht
sáhpán	saːhpaːn
min	miːn
dihkkat	tihːkaht
muhkki	muhːkiː
geaidu	kea̯jːtuː
sieđga	sie̯ðːka
sarvva	sarvva
goardit	koɑ̯rːtiːht
durka	turːka
reavgut	rea̯vːkuːht
bargen	parːken
lapmat	lapmaht
geavahit	kea̯vahiht
guovddi	kuo̯vːttiː
goarrat	koɑ̯rraht
seavvit	sea̯vviːht
kilo	kʰilo
cuohppa	t͡suo̯hːpa
livččen	livtt͡ʃen
mun	mun
botnjat	potɲaht
gulan	kulan
biertna	pie̯rtna
báhkka	paːhːka
mis	miːs
busir	pusiːr
mo	moː
gáibi	kaːjːpiː
daddjot	taɟːɟoht
loktit	lokːtiːht
gálgat	kaːlːkaht
ađđái	aððaːj
buođđut	puo̯ððuːht
aseheapme	asehe̯apme
abmet	abːmeht
aiddo	ajːtto
osku	osːkuː
oide	ojːte
čáhppát	t͡ʃaːhːpaːht
munnos	munːnos
gazza	kadːd͡za
jorbbas	jorːppas
rumaš	rumaʃ
olii	olij
deabbut	tea̯bːbuːht
dearbmi	tea̯rːpmiː
áksil	aːkːsiːl
leahkki	lea̯hːkiː
šerres	ʃeːrːres
ruokŋa	ruo̯tɲa
riidu	rijːtuː
doaivu	toɑ̯jːvuː
játnat	jaːtnaht
dáppe	taːppe
bihttá	pihːtaː
ollugat	olluːkaht
adni	adːniː
guhkki	kuhːkiː
rávkat	raːvːkaht
reašmi	rea̯ʃːmiː
borrat	porraht
illui	illuj
reŋgot	reŋːkoht
lávži	laːvːt͡ʃiː
ándagassii	aːnːtakassij
nie	nie̯
biro	piro
buorránit	puo̯rraːniht
njoazit	ɲoɑ̯t͡siːht
molai	molaj
bráhkka	praːhːka
maŋimus	maɲiːmus
gordos	koːrːtos
boarásit	poɑ̯raːsiht
luomin	luo̯miːn
rihta	rihta
sáttu	saːttuː
geavrát	kea̯vːraːht
miekta	mie̯kːta
njoallut	ɲoɑ̯lluːht
cuvkit	t͡suvːkiːht
njoahcut	ɲoɑ̯ht͡suːht
albmi	alːpmiː
mielga	mie̯lːka
nuollat	nuo̯llaht
rámbut	raːmːpuːht
gurroseamos	kuːrrose̯amos
garjá	karːjaː
dorvvolaš	torvvolaʃ
báhkas	paːhkas
bossu	posːsuː
deaffat	tea̯ffaht
gaskat	kasːkaht
midjiide	miɟɟijte
mearat	mea̯raht
bivvat	pivvaht
bassos	passos
roađđi	roɑ̯ððiː
gullen	kullen
párka	pʰaːrːka
veaddit	vea̯dːdiːht
meara	mea̯ra
ruvvet	ruvːveht
áibat	aːjːpaht
raŧŧi	raθθiː
avvi	avːviː
leaigga	lea̯jːkka
bistit	pisːtiːht
ahccát	ahːt͡saːht
dárbbašit	taːrːppaʃiht
vuohčit	vuo̯ht͡ʃiːht
máisa	maːjːsa
ledjon	leːɟɟon
guokte	ku̯okːte
bielka	pie̯lːka
goalo	ko̯ɑlo
morden	moːrːten
duhkki	tuhːkiː
guovlu	kuo̯vːluː
sáhppes	saːhːpes
lovde	loːvːte
kusta	kʰusːta
juolgat	juo̯lːkaht
rotnu	rotnuː
ođasmahttit	oðasmahːtiːht
sáiti	saːjːtiː
bámbu	paːmːpuː
jorrat	jorraht
rahčat	raht͡ʃaht
ajihustit	ajiːhusːtiːht
oatni	oɑ̯tniː
dami	tamiː
veahčir	vea̯ht͡ʃiːr
galbmit	kalːpmiːht
beaŋka	pea̯ŋːka
hilgut	hilːkuːht
goaro	ko̯ɑro
duolva	tuo̯lːva
nakšát	nakːʃaːht
mátki	maːtːkiː
ránes	raˑnes
bolfát	polːfaːht
johtit	johtiːht
láktat	laːkːtaht
jeagil	jea̯kiːl
jogas	jokas
ahkidis	ahkiːtis
ovccát	ovtt͡saːht
ráhkkáseamos	raːhːkaːse̯amos
rogge	roɡːɡe
ruoná	ruo̯naː
oažžut	oɑ̯dːd͡ʒuːht
dorvvuheapme	torvvuːhe̯apme
čállit	t͡ʃaːlliːht
eadnán	ea̯dːnaːn
njaldit	ɲalːtiːht
guolla	kuo̯lla
eat	ea̯ht
bassi	passiː
luhkka	luhːka
dat	taht
oahppat	oɑ̯hːpaht
dudnuin	tudːnujn
bálgán	paːlːkaːn
ruoksadeamos	ruo̯kːsate̯amos
mola	mola
čuollat	t͡ʃuo̯llaht
lassánit	lassaːniht
šiega	ʃie̯ka
áhčči	aːhːt͡ʃiː
báska	paːsːka
gáigá	kaːjːkaː
saŋas	saɲas
horti	horːtiː
assi	assiː
fiero	fi̯ero
bealjehit	pe̯aʎʎehiht
eallaseamos	ea̯llase̯amos
dásset	taˑsseht
bahta	pahta
čorbma	t͡ʃorːpma
duortnus	tuo̯rtnuːs
hekto	hekːto
lohpidit	lohpiːtiht
seahkka	sea̯hːka
lidnu	lidːnuː
buddele	pudːdele
dállu	taːlluː
sággi	saːɡːɡiː
buođgát	puo̯ðːkaːht
vuotta	vuo̯tta
coakci	t͡soɑ̯kːt͡siː
ruoida	ruo̯jːta
guoddu	kuo̯dːduː
go	ko
rieban	rie̯pan
álgga	aːlːkka
bollát	polːlaːht
báhkki	paːhːkiː
gos	kos
šaddanbeaivi	ʃadːdanpea̯jːviː
brutto	prutto
lehkoset	leːhkoseht
loažži	loɑ̯dːd͡ʒiː
jalges	jalːkes
oarri	oɑ̯rːriː
doaibmi	toɑ̯jːpmiː
gaigŋir	kajːtɲiːr
raksa	rakːsa
čeavlái	t͡ʃea̯vːlaːj
jalgat	jalːkaht
guossa	kuo̯ssa
allat	allaht
fiskat	fisːkaht
leažžat	lea̯dːd͡ʒaht
juovllat	juo̯vllaht
áibmu	aːjːpmuː
baján	pajaːn
doarvi	toɑ̯rːviː
guoskat	kuo̯sːkaht
nealgi	nea̯lːkiː
aisttan	ajstan
arvát	arːvaːht
vuohčču	vuo̯hːt͡ʃuː
čuopmat	t͡ʃuo̯pmaht
veaháš	vea̯haːʃ
doaibat	toɑ̯jːpaht
gordni	korːtniː
bastit	pasːtiːht
astat	asːtaht
leažžabeahtti	lea̯dːd͡ʒapea̯hːtiː
ruoidnát	ruo̯jːtnaːht
nohkkat	nohːkaht
guoika	kuo̯jːka
oarbbis	oɑ̯rːppiːs
galmmas	kalmmas
lohkat	lohkaht
sadji	saɟɟiː
ceakkus	t͡sea̯kkuːs
ohpit	ohpiːht
oahpaheaddji	oɑ̯hpahea̯ɟːɟiː
jápmán	jaːpmaːn
suovvi	suo̯vviː
čuovgga	t͡ʃuo̯vːkka
nábár	naːpaːr
smáhket	smaːhkeht
čorges	t͡ʃorːkes
nieidda	nie̯jːtta
leađbma	lea̯ðːpma
áhkká	aːhːkaː
muorji	muo̯rːjiː
beaivi	pea̯jːviː
muitalit	mujːtaliht
boija	pojja
gámme	kaːmːme
roggat	roɡːɡaht
oahppásit	oɑ̯hːpaːsiht
munnje	muɲɲe
bearrat	pea̯rraht
balsa	palːsa
fuotni	fuo̯tniː
heahkka	hea̯hːka
huhpat	huhpaht
bora	poːra
suhttat	suhːtaht
gártat	kaːrːtaht
áli	aːliː
cadjat	t͡saɟɟaht
logus	lokuːs
ruonas	ruo̯nas
nuorasmahttit	nuo̯rasmahːtiːht
nállat	naːllaht
njálbmi	ɲaːlːpmiː
manan	manan
balu	paluː
kursa	kʰurːsa
boalbut	poɑ̯lːpuːht
láhppit	laːhːpiːht
fáŋgal	faːŋːkal
muhtun	muhtuːn
šállo	ʃaːllo
sálti	saːlːtiː
áibmat	aːjːpmaht
buollin	puo̯lliːn
guolástit	kuo̯laːstiht
rujosmit	ruːjosmiht
hávkat	haːvːkaht
aski	asːkiː
diddi	tidːdiː
duostut	tuo̯sːtuːht
guoppar	kuo̯ppar
álás	aːlaːs
suovvi	suo̯vːviː
gaŋgát	kaŋːkaːht
addes	adːdes
bassen	passen
loatna	loɑ̯tna
sahá	sahaː
oalgi	oɑ̯lːkiː
áibbašit	aːjːppaʃiht
máttanuorti	maːttanuo̯rːtiː
toardna	tʰoɑ̯rːtna
ráššu	raːʃʃuː
dáiddalaš	taːjːttalaʃ
ja	ja
luovdi	luo̯vːtiː
njelot	ɲeːloht
čielgasit	t͡ʃie̯lːkasiht
jakŋat	jatɲaht
bákti	paːkːtiː
ipmirdit	ipmiːrtiht
doaro	to̯ɑro
mahkkit	mahːkiːht
ballát	palːlaːht
guhkit	kuhkiːht
vuogas	vuo̯kas
čagardit	t͡ʃakartiht
loahppa	loɑ̯hːpa
gesse	keːsse
mánálaš	maːnaːlaʃ
bahámus	pahaːmus
ruvke	ruvːke
itku	itːkuː
balvan	palːvan
hollen	hoːllen
guvrát	kuvːraːht
juohke	ju̯ohke
rávdná	raːvːtnaː
idjaloddi	iɟɟalodːdiː
buoiddeheapme	pu̯ojːttehe̯apme
hipmu	hipmuː
cahkat	t͡sahkaht
daga	taka
boso	poso
meaštár	mea̯ʃːtaːr
sáhppadeamos	saːhːpate̯amos
várat	vaːraht
sarri	sarriː
johttát	johːtaːht
botnet	potneht
didjiide	tiɟɟijte
nubbi	nubːbiː
ollos	oːllos
jugale	jukale
čihččet	t͡ʃiːhːt͡ʃeht
gáhkkor	kaːhːkor
olán	olaːn
ádjánit	aːɟɟaːniht
vuonjal	vuo̯ɲal
bearral	pea̯rral
suhpi	suhpiː
gasti	kasːtiː
gudden	kuːdːden
čohkkát	t͡ʃohːkaːht
albmanit	alːpmaniht
čuolda	t͡ʃuo̯lːta
hoallu	hoɑ̯lluː
gállis	kaːlliːs
vuopmi	vuo̯pmiː
jorre	jorre
álkimus	aːlːkiːmus
vaikko	vajkko
oapmi	oɑ̯pmiː
nu	nuː
giron	kiːron
rádju	raːɟɟuː
vuohčut	vuo̯ht͡ʃuːht
gollat	kollaht
almmálaš	almmaːlaʃ
bánis	paːniːs
asti	asːtiː
dihton	tiːhton
ealli	ea̯lːliː
suohkat	suo̯hkaht
goas	koɑ̯s
vuoššat	vuo̯ʃːʃaht
gielaheapme	kie̯lahe̯apme
saddit	sadːdiːht
dus	tuːs
káfe	kʰaːfe
šiggut	ʃiɡːɡuːht
doaimmaheaddji	toɑ̯jmmahea̯ɟːɟiː
gosan	kosan
jorba	jorːpa
buvssat	puvssaht
ágga	aːɡːɡa
bohccon	poːhːt͡son
čovvát	t͡ʃovːvaːht
doarrut	toɑ̯rruːht
deardna	tea̯rːtna
lea	lea̯
vuohppa	vuo̯hːpa
goarrut	koɑ̯rruːht
feret	feːreht
jorgut	jorːkuːht
geađgi	kea̯ðːkiː
máidnu	maːjːtnuː
vadjat	vaɟɟaht
navvit	navviːht
eadnáme	ea̯dːnaːme
ihtit	ihtiːht
čieŋal	t͡ʃie̯ɲal
haksit	hakːsiːht
giitu	kijːtuː
beavrrihis	pea̯vrriːhis
sivlu	sivːluː
dahppat	tahːpaht
veadjit	vea̯ɟɟiːht
luovos	lu̯ovos
dapmi	tapmiː
vizardit	vit͡sartiht
čoalli	t͡ʃoɑ̯lliː
čorgadit	t͡ʃorːkatiht
don	toːn
bohcci	pohːt͡siː
soallut	soɑ̯lluːht
maŋŋil	maŋɲiːl
lean	lea̯n
lohpi	lohpiː
dáidit	taːjːtiːht
lottiid	lottijt
gálojeatni	kaˑlojea̯tniː
dolastit	tolastiht
gordon	koːrːton
juoiggus	juo̯jːkkuːs
návli	naːvːliː
nihttit	nihːtiːht
čuodjat	t͡ʃuo̯ɟɟaht
bohkká	pohːkaː
allu	alːluː
manin	maniːn
eambbo	e̯amːppo
bátni	paːtniː
čuoika	t͡ʃuo̯jːka
máttanuorta	maːttanuo̯rːta
neavrres	ne̯avrres
duoldat	tuo̯lːtaht
sárgun	saːrːkuːn
deaššat	tea̯ʃʃaht
ráhkes	raˑhkes
lassi	lassiː
dielku	tie̯lːkuː
bággu	paːɡːɡuː
guvrut	kuvːruːht
sodjat	soɟɟaht
dihtor	tiːhtor
gužža	kudːd͡ʒa
rokkan	rokkan
fápmu	faːpmuː
miehkki	mie̯hːkiː
ciiku	t͡sijːkuː
sisa	sisa
jearahit	jea̯rahiht
jaskadeamos	jasːkate̯amos
lávlagis	laːvːlakis
ráddi	raːdːdiː
soađis	soɑ̯ðiːs
dierbbes	ti̯erːppes
addu	adːduː
bikká	pikkaː
árvu	aːrːvuː
levlo	levːlo
olggos	olːkkos
giessat	kie̯ssaht
moivi	mojːviː
fuoikit	fuo̯jːkiːht
dákti	taːkːtiː
háhtta	haːhːta
čuonjá	t͡ʃuo̯ɲaː
gazole	kat͡sole
luotni	luo̯tniː
njoarostit	ɲo̯ɑrostiht
borraba	porrapa
dal	tal
reddjo	reɟːɟo
buldu	pulːtuː
haŋŋá	haŋɲaː
roggen	roɡːɡen
áššeheapme	aˑʃʃehe̯apme
gilli	killiː
fluora	fluoːra
doavhli	toɑ̯vːl̥iː
sahát	sahaːht
alloset	alloseht
jorbasit	jorːpasiht
buđeita	puðejta
lállit	laːlliːht
laskat	lasːkaht
biigá	pijːkaː
juoddit	juo̯dːdiːht
šlahtti	ʃlahːtiː
bivval	pivval
reahccut	rea̯hːt͡suːht
ođđasit	oððasiht
mannut	manːnuːht
jurdit	jurːtiːht
deaivu	tea̯jːvuː
dego	teko
gávrut	kaːvːruːht
bássa	paːsːsa
šávge	ʃaːvːke
sulla	sulla
cisset	t͡sisːseht
bohttu	pohːtuː
buole	pu̯ole
duostil	tuo̯sːtiːl
heaibut	hea̯jːpuːht
ollis	olliːs
olloska	olloska
duorga	tuo̯rːka
gease	ke̯ase
gobi	kopiː
lasta	lasːta
cahpat	t͡sahpaht
jearaldat	jea̯raltaht
bodni	podːniː
dilljá	tiʎːʎaː
agit	akiːht
árrit	aːrriːht
dagan	takan
ollu	olːluː
šloahtta	ʃloɑ̯hːta
goarjut	koɑ̯rːjuːht
olli	olːliː
ruovji	ruo̯vːjiː
duohken	tu̯ohken
čiekŋalit	t͡ʃie̯tɲaliht
árga	aːrːka
rinčát	rinːt͡ʃaːht
bárru	paːrruː
cumpi	t͡sumːpiː
ruoinnas	ruo̯jnnas
sihtat	sihtaht
soddjil	soɟːɟiːl
gáhttu	kaːhːtuː
eaŋgals	ea̯ŋːkals
rustát	rusːtaːht
miessi	mie̯ssiː
šleađga	ʃlea̯ðːka
galge	kalːke
burru	purːruː
addesis	adːdesis
háhccát	haːhːt͡saːht
duollu	tuo̯lːluː
vávdno	vaːvːtno
buorráneaddji	puo̯rraːnea̯ɟːɟiː
čeahpimus	t͡ʃea̯hpiːmus
leatnot	le̯atnoht
gullet	kuːlːleht
lágut	laːkuːht
leasmi	lea̯sːmiː
muhtin	muhtiːn
báŋka	paːŋːka
sárgut	saːrːkuːht
sáibu	saːjːpuː
ránis	raːniːs
sitnu	sitnuː
njuorddut	ɲuo̯rːttuːht
ráhkestit	raˑhkestiht
gullet	kulleht
kilográmmá	kʰilokraːmːmaː
romimus	romiːmus
leai	lea̯j
vahkku	vahːkuː
attestit	attestiht
gaŋkát	kaŋːkaːht
riektat	rie̯kːtaht
dahkkot	tahːkoht
reahcci	rea̯hːt͡siː
árja	aːrːja
addjot	aɟːɟoht
dálvit	taːlːviːht
viergi	vie̯rːkiː
liekčát	lie̯kːt͡ʃaːht
diet	tie̯ht
molle	molle
nannet	nanːneht
ležžet	ledːd͡ʒeht
báron	paːron
čagar	t͡ʃakar
kroma	kroːma
diehko	ti̯ehko
njiedjat	ɲie̯ɟɟaht
hearvát	hea̯rːvaːht
šohkut	ʃohkuːht
diila	tijːla
jearrat	jea̯rraht
čearguladdat	t͡ʃea̯rːkuːladːdaht
rájes	raˑjes
bispa	pisːpa
oattimus	oɑ̯ttiːmus
nordon	norːton
báhkket	paːhːkeht
oanit	oɑ̯niːht
buleš	puːleʃ
luohttit	luo̯hːtiːht
duohki	tuo̯hkiː
guoggi	kuo̯ɡːɡiː
lunddolaččat	lunːttolatt͡ʃaht
láđđi	laːððiː
bone	pone
govdut	kovːtuːht
albmaduvvat	alːpmatuvvaht
láhtti	laːhːtiː
cihrra	t͡sir̥r̥a
bavhli	pavːl̥iː
ovttas	ovttas
saddos	sadːdos
vuodjat	vuo̯ɟɟaht
atnin	atniːn
čuohki	t͡ʃuo̯hkiː
arva	arːva
jaska	jasːka
litnjat	litɲaht
čiehká	t͡ʃie̯hkaː
niski	nisːkiː
loapmi	loɑ̯pmiː
čátná	t͡ʃaːtnaː
bircut	pirːt͡suːht
gitta	kitta
cagai	t͡sakaj
romsa	romːsa
gosat	kosaht
valli	valliː
áite	aːjːte
biibbal	pijːppal
čorgat	t͡ʃorːkaht
ruššat	ruʃʃaht
anihit	aniːhiht
leavdnit	lea̯vːtniːht
eske	esːke
doggi	toɡːɡiː
ceaggát	t͡sea̯ɡːɡaːht
ain	ajn
veaittalas	vea̯jttalas
gráda	kraːta
eatnis	ea̯tniːs
nanus	nanuːs
njierrá	ɲie̯rraː
leŋge	leŋːke
njoammil	ɲoɑ̯mmiːl
njárbat	ɲaːrːpaht
nalttas	nalttas
njartat	ɲarːtaht
lotnut	lotnuːht
njálla	ɲaːlla
astta	asta
buot	puo̯ht
molale	molale
jallat	jallaht
movt	movht
rissi	risːsiː
gallet	kalːleht
rievdadus	rie̯vːtatus
buoiddat	puo̯jːttaht
unni	unːniː
bilkidit	pilːkiːtiht
bealgi	pea̯lːkiː
gealbu	kea̯lːpuː
lastan	lasːtan
niillas	nijllas
viessat	vie̯ssaht
jahki	jahkiː
bealdu	pea̯lːtuː
bearjadat	pea̯rːjataht
eappir	ea̯ppiːr
bolden	poːlːten
dávda	taːvːta
dievddu	tie̯vːttuː
dierbut	tie̯rːpuːht
ruolla	ruo̯lːla
liiva	lijːva
čeŋkkeš	t͡ʃeːŋkkeʃ
oaggut	oɑ̯ɡːɡuːht
já	jaː
olgun	olːkuːn
čuorpmas	t͡ʃuo̯rpmas
leahki	lea̯hkiː
luiste	lujːste
bardit	parːtiːht
kránnjáid	kraːɲɲaːjt
bárut	paːruːht
veaksi	vea̯kːsiː
jalga	jalːka
gosse	kosse
gáddit	kaːdːdiːht
dálkkas	taːlkkas
guovža	kuo̯vːt͡ʃa
roabát	roɑ̯paːht
duvdni	tuvːtniː
guosmut	kuo̯sːmuːht
bárbmu	paːrːpmuː
árggit	aːrːkkiːht
čielgat	t͡ʃie̯lːkaht
dievasmahttit	tie̯vasmahːtiːht
geassi	kea̯sːsiː
njozet	ɲoːt͡seht
vatnat	vatnaht
giellá	kie̯llaː
eadnin	ea̯dːniːn
lossadeamos	lossate̯amos
illu	illuː
boksa	pokːsa
beštor	peʃːtor
borran	porran
váilut	vaːjːluːht
guossi	kuo̯sːsiː
bieđut	pie̯ðuːht
leavvat	lea̯vvaht
boaldit	poɑ̯lːtiːht
jallas	jallas
gessen	keːssen
gussa	kussa
dávdi	taːvːtiː
idjadit	iɟɟatiht
goikásit	kojːkaːsiht
salla	salla
mirkko	mirkko
govahallat	kovahallaht
rápmi	raːpmiː
čáhppat	t͡ʃaːhːpaht
deatte	te̯atte
goahti	koɑ̯htiː
nullet	nuːlleht
dikŋa	titɲa
sarrit	sarriːht
čielga	t͡ʃie̯lːka
čurti	t͡ʃurːtiː
issorit	issoriht
alvvaheapme	alvvahe̯apme
iskat	isːkaht
basastit	pasastiht
ŧ	θ
čakča	t͡ʃakːt͡ʃa
čuovgat	t͡ʃuo̯vːkaht
ipmi	ipmiː
árves	aːrːves
lehkos	leːhkos
buohccát	puo̯hːt͡saːht
hállan	haːllan
ahkáduvvat	ahkaːtuvvaht
muhto	muhto
šallju	ʃaʎːʎuː
burke	purːke
bala	pala
neon	neːon
suotnju	suo̯tɲuː
čealluladdat	t͡ʃea̯lluːladːdaht
beage	pe̯ake
almmuheapmi	almmuːhea̯pmiː
duipi	tujːpiː
jalkát	jalːkaːht
čitnut	t͡ʃitnuːht
luodda	luo̯dːda
dunin	tuːniːn
beallji	pea̯ʎːʎiː
aste	asːte
gealut	kea̯luːht
roŋge	roŋːke
boazu	poɑ̯t͡suː
muiten	mujːten
vuohpput	vuo̯hːpuːht
málle	maːlːle
vuoksá	vuo̯kːsaː
doaivut	toɑ̯jːvuːht
eale	e̯ale
láibu	laːjːpuː
evttohit	evttohiht
čađđa	t͡ʃaðða
gáisá	kaːjːsaː
vuohttit	vuo̯hːtiːht
lumma	lumːma
ballat	pallaht
mii	mij
ruškadeamos	ruʃːkate̯amos
don	ton
dáidda	taːjːtta
guovla	kuo̯vːla
ruopma	ruo̯pma
áibbas	aːjːppas
áddjá	aːɟːɟaː
moddját	moɟːɟaːht
bihppor	pihːpor
ohca	oht͡sa
vielppis	vie̯lppiːs
ammal	ammal
cappis	t͡sappiːs
bahát	pahaːht
bávkit	paːvːkiːht
árgges	aˑrːkkes
njuolgut	ɲuo̯lːkuːht
geassi	kea̯ssiː
ealáhus	ea̯laːhus
muohta	muo̯hta
beroštupmi	peːroʃtupmiː
dáidu	taːjːtuː
guolbmat	kuo̯lːpmaht
reavvat	rea̯vvaht
balli	palːliː
oattes	o̯ɑttes
láikkit	laːjkkiːht
vuoras	vuo̯ras
faggut	faɡːɡuːht
alloska	alloska
lávlageame	laːvːlake̯ame
riekti	rie̯kːtiː
ledjet	leɟɟeht
dáđvi	taːðːviː
čuođát	t͡ʃuo̯ðaːht
grámmá	kraːmːmaː
ráhkistit	raːhkiːstiht
caggat	t͡saɡːɡaht
bordá	porːtaː
gálgi	kaːlːkiː
ilus	iluːs
apmasit	apmasiht
borre	porre
ala	ala
jus	jus
ollán	ollaːn
galgat	kalːkaht
miehtá	mie̯htaː
dárustit	taːruːstiht
fargga	farːkka
gii	kij
áigá	aːjːkaː
riggut	riɡːɡuːht
fállat	faːllaht
bussá	pusːsaː
čeargat	t͡ʃea̯rːkaht
áibmi	aːjːpmiː
buohkat	puo̯hkaht
gákti	kaːkːtiː
geahččalit	kea̯hːt͡ʃaliht
livččiiga	livtt͡ʃijka
čaibmat	t͡ʃajːpmaht
jurdda	jurːtta
árggimus	aːrːkkiːmus
čálli	t͡ʃaːlːliː
juohkehaš	ju̯ohkehaʃ
bárdni	paːrːtniː
bahá	pahaː
dutnje	tutɲe
alva	alːva
arvvosmahttit	arvvosmahːtiːht
luiken	luːjːken
bossu	possuː
gáfe	kaːfe
du	tuː
roandit	roɑ̯nːtiːht
ođđa	oðða
klora	kloːra
cáhkit	t͡saːhkiːht
njálmmi	ɲaːlmmiː
vuohki	vuo̯hkiː
njuovvat	ɲuo̯vvaht
geafes	ke̯afes
nuorttu	nuo̯rttuː
čolga	t͡ʃolːka
sáhppadit	saːhːpatiht
oaksi	oɑ̯kːsiː
bávlos	paːvːlos
čeavlámus	t͡ʃea̯vːlaːmus
bievval	pie̯vval
eaktu	ea̯kːtuː
rievnnu	rie̯vnnuː
boson	poson
roggi	roɡːɡiː
loaktit	loɑ̯kːtiːht
čuovgadeamos	t͡ʃuo̯vːkate̯amos
jierbmi	jie̯rːpmiː
dálvi	taːlːviː
nihlla	nil̥l̥a
vuossi	vuo̯sːsiː
ruoŧŧa	ruo̯θθa
čuovga	t͡ʃuo̯vːka
buškit	puʃːkiːht
čipma	t͡ʃipma
gielddu	kie̯lːttuː
gillát	kilːlaːht
golgat	kolːkaht
dábálaš	taːpaːlaʃ
duoggi	tuo̯ɡːɡiː
rievdnu	rie̯vːtnuː
láppis	laːppiːs
ležže	ledːd͡ʒe
čiehppa	t͡ʃie̯hːpa
hoallat	hoɑ̯llaht
diibmá	tijːpmaː
ledje	leɟɟe
duovli	tuo̯vːliː
fas	fas
leagi	lea̯kiː
leažžabehtet	lea̯dːd͡ʒapeːhteht
guoggut	kuo̯ɡːɡuːht
reavrut	rea̯vːruːht
mannat	mannaht
heaibat	hea̯jːpaht
gora	kora
suovnnji	suo̯vɲɲiː
váttes	vaˑttes
on	oːn
málta	maːlːta
lákca	laːkːt͡sa
oliime	olijme
máltit	maːlːtiːht
goarkŋun	koɑ̯rtɲuːn
gávdnat	kaːvːtnaht
justa	jusːta
mokta	mokːta
čollut	t͡ʃolluːht
konto	kʰonːto
easka	ea̯sːka
doaimmahus	toɑ̯jmmahus
gutna	kutna
gihpu	kihpuː
bearal	pea̯ral
riššu	riʃʃuː
sárggis	saːrːkkiːs
jáhkkit	jaːhːkiːht
dárru	taːrruː
njukča	ɲukːt͡ʃa
dearvva	tea̯rvva
jiehtanas	jie̯htanas
doapmat	toɑ̯pmaht
huhttát	huhːtaːht
láse	laːse
teret	tʰeːreht
ballalas	pallalas
golli	kolːliː
holle	hoːlle
gáranas	kaːranas
alladávttálaš	allataːvttaːlaʃ
jorbaseamos	jorːpase̯amos
láigohit	laːjːkohiht
njuorju	ɲuo̯rːjuː
oppa	oppa
čivga	t͡ʃivːka
baldu	palːtuː
beanna	pea̯nːna
leidde	lejːtte
viehkat	vie̯hkaht
satmi	satːmiː
dudnuide	tudːnujte
vuol	vuo̯l
heaŋgát	hea̯ŋːkaːht
rádjat	raːɟɟaht
čeavlát	t͡ʃea̯vːlaːht
bealušteaddji	pea̯luːʃtea̯ɟːɟiː
boahtte	po̯ɑhːte
čuopma	t͡ʃuo̯pma
rahpat	rahpaht
luike	luːjːke
guhtta	kuhːta
anár	anaːr
olmmái	olmmaːj
jurbmát	jurːpmaːht
gohččut	kohːt͡ʃuːht
oste	oːsːte
šaddat	ʃadːdaht
oastit	oɑ̯sːtiːht
garrasit	karrasiht
bargu	parːkuː
viisses	vijsses
nuorasmit	nuo̯rasmiht
leandit	lea̯nːtiːht
beavrrehis	pe̯avrrehis
ruoksadit	ruo̯kːsatiht
villat	vilːlaht
addjohit	aɟːɟohiht
juokŋat	juo̯tɲaht
iežat	ie̯t͡ʃaht
eanodat	e̯anotaht
gealdit	kea̯lːtiːht
borgat	porːkaht
njoammut	ɲoɑ̯mmuːht
doaimmalaš	toɑ̯jmmalaʃ
gieddi	kie̯dːdiː
čuohkat	t͡ʃuo̯hkaht
lei	lej
dáigi	taːjːkiː
maŋis	maɲiːs
buotnjut	puo̯tɲuːht
riika	rijːka
muvra	muvːra
gieđbmi	kie̯ðːpmiː
lehket	leːhkeht
oahci	oɑ̯ht͡siː
romes	romes
hállu	haːlːluː
geafi	kea̯fiː
gelden	keːlːten
jorra	jorːra
ruoksi	ruo̯kːsiː
čađat	t͡ʃaðaht
logan	lokan
eadnis	ea̯dːniːs
deabbu	tea̯bːbuː
dieppe	ti̯eppe
geatki	kea̯tːkiː
darfi	tarːfiː
leahppi	lea̯hːpiː
gorro	koːrro
savu	savuː
njáldit	ɲaːlːtiːht
luiten	luːjːten
dehálaš	tehaːlaʃ
nealgut	nea̯lːkuːht
dealo	te̯alo
logat	lokaht
maŋŋit	maŋɲiːht
ráddut	raːdːduːht
mohkkámus	mohːkaːmus
duođamus	tuo̯ðamus
meahcci	mea̯hːt͡siː
ajihastit	ajiːhasːtiːht
dearvašeamos	tea̯rːvaʃe̯amos
gurut	kuruːht
njala	ɲala
giepma	kie̯pma
čavga	t͡ʃavːka
buvtta	puvtta
russo	ruːsso
eapmi	ea̯pmiː
sáibma	saːjːpma
lobis	lopiːs
labmát	labːmaːht
fidnu	fidːnuː
ivdnet	ivːtneht
suossa	suo̯ssa
rabat	rapaht
sáiva	saːjːva
hárve	haˑrːve
buoiddášit	puo̯jːttaːʃiht
saját	sajaːht
sárgi	saːrːkiː
bealkit	pea̯lːkiːht
aiddostassii	ajːttostassij
losimus	losiːmus
állát	alːlaːht
cuvket	t͡suːvːkeht
gievrramus	kie̯vrramus
njirvat	ɲirːvaht
mielas	mie̯las
ruoksat	ruo̯kːsaht
bierdni	pie̯rːtniː
bárra	paːrra
duohččat	tuo̯hːt͡ʃaht
julmmut	julmmuːht
silli	silliː
oađđit	oɑ̯ððiːht
gotka	kotːka
gargit	karːkiːht
jalŋŋis	jalŋɲiːs
ollo	oːllo
cahkkát	t͡sahːkaːht
bargat	parːkaht
ballu	palːluː
almmostahttit	almmostahːtiːht
dehálit	tehaːliht
buollát	puo̯lːlaːht
dehálaččamus	tehaːlatt͡ʃamus
vuole	vu̯ole
baldá	palːtaː
eahppi	ea̯hːpiː
ahkásaš	ahkaːsaʃ
čoavji	t͡ʃoɑ̯vːjiː
buikku	pujkkuː
boksen	pokːsen
ollibehtet	olliːpeːhteht
čuožžut	t͡ʃuo̯dːd͡ʒuːht
diibmu	tijːpmuː
horsta	horːsta
vovdna	vovːtna
gossen	kossen
buoidudit	puo̯jːtuːtiht
sámástit	saːmaːstiht
bivnnuhis	pivnnuːhis
máksit	maːkːsiːht
čielgi	t͡ʃie̯lːkiː
gudni	kudːniː
heaitit	hea̯jːtiːht
suhkkes	suːhːkes
áfáiduvvat	aːfaːjtuvvaht
bivnnuheapme	pivnnuːhe̯apme
iežas	ie̯t͡ʃas
girdno	kirːtno
goahcat	koɑ̯ht͡saht
addilit	adːdiːliht
viežžat	vie̯dːd͡ʒaht
dietnut	tie̯tnuːht
bábir	paːpiːr
guohpput	kuo̯hːpuːht
gođđit	koðːðiːht
buktu	pukːtuː
raban	rapan
nuortalaš	nuo̯rːtalaʃ
buđet	puðeht
himsi	himːsiː
dutkat	tutːkaht
birra	pirra
alvvalaš	alvvalaʃ
borri	porːriː
sarva	sarːva
gisse	kiːsse
dovddaldat	tovːttaltaht
álkes	aˑlːkes
vearri	vea̯rriː
rážžat	raːdːd͡ʒaht
garra	karra
loavdit	loɑ̯vːtiːht
nordat	norːtaht
massit	masːsiːht
ealán	ea̯laːn
dávgi	taːvːkiː
oapmet	o̯ɑpmeht
maŋit	maɲiːht
uksa	ukːsa
doboš	toːpoʃ
dállas	taːllas
čiktit	t͡ʃikːtiːht
gieggat	kie̯ɡːɡaht
human	human
dorvu	torːvuː
duolbut	tuo̯lːpuːht
logu	lokuː
njammot	ɲamːmoht
jođánis	joðaːnis
gáffe	kaːffe
márfi	maːrːfiː
doalvi	toɑ̯lːviː
ollon	oːllon
jalgadit	jalːkatiht
gáhččat	kaːhːt͡ʃaht
ceavvi	t͡sea̯vviː
butnjat	putɲaht
čeahppi	t͡ʃea̯hːpiː
gáisi	kaːjːsiː
gorru	korːruː
máhccat	maːhːt͡saht
biddu	pidːduː
ásahit	aːsahiht
fuorrá	fuo̯rraː
čákŋat	t͡ʃaːtɲaht
ane	ane
eahccit	ea̯hːt͡siːht
láikkimus	laːjkkiːmus
ieža	ie̯t͡ʃa
dolastaddat	tolastadːdaht
addámuš	adːdaːmuʃ
gulcat	kulːt͡saht
čalmmeheapme	t͡ʃalmmehe̯apme
mannan	mannan
bleahkka	plea̯hːka
muolddat	muo̯lːttaht
romis	romiːs
oza	ot͡sa
časkit	t͡ʃasːkiːht
baldit	palːtiːht
guhkes	kuhkes
gáma	kaːma
bláđđi	plaːððiː
cuovcca	t͡suo̯vtt͡sa
luite	luːjːte
áltá	aːlːtaː
amiidit	amijtiht
njuoratmánná	ɲuo̯ratmaːnnaː
čuolggu	t͡ʃuo̯lːkkuː
rátnáseamos	raːtnaːse̯amos
jugahahtti	jukahahːtiː
rimsi	rimːsiː
sullii	sullij
beastit	pea̯sːtiːht
nuorvvu	nuo̯rvvuː
cinná	t͡sinːnaː
bártni	paːrtniː
gavja	kavːja
iežade	ie̯t͡ʃate
beaiveloddi	pea̯jːvelodːdiː
vuosttaš	vuo̯staʃ
guhtemuš	kuhtemuʃ
báhcit	paːht͡siːht
goalmmát	koɑ̯lmmaːht
ellen	eːllen
násti	naːsːtiː
máhttit	maːhːtiːht
oliidet	olijteht
biera	pie̯ra
loddi	lodːdiː
sávaldat	saːvaltaht
bullet	puːlleht
guolli	kuo̯lliː
báralaš	paːralaʃ
ivdni	ivːtniː
anatomiija	anatʰomijja
dahku	tahkuː
jalgadeamos	jalːkate̯amos
čuorgat	t͡ʃuo̯rːkaht
belohahkii	peːlohahkij
din	tiːn
cabbin	t͡sabːbiːn
čeavrris	t͡ʃea̯vrriːs
ađaiduvvat	aðajtuvvaht
cillat	t͡sillaht
geavaheaddji	kea̯vahea̯ɟːɟiː
save	save
fierrut	fie̯rruːht
oston	oːsːton
ruoidna	ruo̯jːtna
márfut	maːrːfuːht
nullos	nuːllos
oaidnaleapmi	oɑ̯jːtnalea̯pmiː
suorbma	suo̯rːpma
buhtes	puhtes
davrát	tavːraːht
njárbe	ɲaːrːpe
loahppat	loɑ̯hːpaht
nummir	nummiːr
leabba	lea̯bːba
táŋka	tʰaːŋːka
beađbi	pea̯ðːpiː
danne	tanne
árbi	aːrːpiː
guoccat	kuo̯tt͡saht
njamat	ɲamaht
gáskit	kaːsːkiːht
duddjot	tuːɟːɟoht
ollen	ollen
buhttásit	puhːtaːsiht
bárbmoloddi	paːrːpmolodːdiː
gessos	keːssos
oliimet	olijmeht
ráigi	raːjːkiː
duogŋat	tuo̯dːɲaht
njavge	ɲavːke
láhčit	laːht͡ʃiːht
logai	lokaj
viššat	viʃʃaht
dáhpi	taːhpiː
addálit	adːdaːliht
cagan	t͡sakan
duski	tusːkiː
mordon	moːrːton
dárbbuheapme	taːrːppuːhe̯apme
guvri	kuvːriː
vuolgit	vuo̯lːkiːht
ciellat	t͡sie̯llaht
goivo	koːjːvo
spáillit	spaːjlliːht
muoddá	muo̯dːdaː
áppes	aːppes
gilvu	kilːvuː
duhát	tuhaːht
alli	alːliː
eahket	e̯ahkeht
bivvalis	pivvalis
čiekŋalis	t͡ʃie̯tɲalis
duháhat	tuhaːhaht
gilljut	kiʎːʎuːht
imit	imiːht
čuoldit	t͡ʃuo̯lːtiːht
riitát	rijːtaːht
alimahtes	aliːmahtes
hieibmat	hie̯jːpmaht
astu	asːtuː
ruškkut	ruʃkuːht
sarcut	sarːt͡suːht
jorgalit	jorːkaliht
lihppu	lihːpuː
oalle	o̯ɑlle
máze	maːt͡se
náđđut	naːððuːht
vuossa	vuo̯ssa
dierbi	tie̯rːpiː
albmudit	alːpmuːtiht
alimus	aliːmus
ruodnát	ruo̯dːnaːht
suohkku	suo̯hːkuː
balus	paluːs
rávis	raːviːs
duohta	tuo̯hta
veadjemeahttunvuohta	vea̯ɟɟemea̯hːtuːnvuo̯hta
ađđamahttá	aððamahːtaː
njealját	ɲea̯ʎʎaːht
njunni	ɲunniː
galle	kalːle
rádji	raːɟɟiː
guđju	kuðːjuː
bálbma	paːlːpma
rahkat	rahkaht
sahkanit	sahkaniht
boagustit	poɑ̯kuːstiht
beston	peːsːton
leaŋgga	lea̯ŋːkka
máinnastit	maːjnnastiht
muhttit	muhːtiːht
doarridit	toɑ̯rriːtiht
lokten	lokːten
cahppát	t͡sahːpaːht
leaira	lea̯jːra
dolat	tolaht
suođđat	suo̯ððaht
sávvat	saːvvaht
divvut	tivvuːht
rávdu	raːvːtuː
gullu	kulluː
addon	adːdon
ihkku	ihːkuː
skaipi	skajːpiː
atnu	atnuː
badji	paɟɟiː
borgárlaš	porːkaːrlaʃ
ilu	iluː
gossat	kossaht
doaibmat	toɑ̯jːpmaht
dápmat	taːpmaht
fuolki	fuo̯lːkiː
kálka	kʰaːlːka
balan	palan
čoavdit	t͡ʃoɑ̯vːtiːht
sáhttit	saːhːtiːht
neahpi	nea̯hpiː
báidi	paːjːtiː
čaimmas	t͡ʃajmmas
luoikat	luo̯jːkaht
čuođi	t͡ʃuo̯ðiː
jaskadit	jasːkatiht
gulaš	kulaʃ
ruonámus	ruo̯naːmus
geaŧŧu	kea̯θθuː
miella	mie̯lla
basii	pasij
átnut	aːtnuːht
biigot	pijːkoht
cuokca	t͡suo̯kːt͡sa
áiti	aːjːtiː
čorru	t͡ʃorruː
gaskavuohta	kasːkavuo̯hta
hivsset	hivsseht
garca	karːt͡sa
áitit	aːjːtiːht
hurri	hurːriː
biise	pijːse
ađahuvvat	aðahuvvaht
eatnit	ea̯tniːht
fárfu	faːrːfuː
baldi	palːtiː
njanzát	ɲanːt͡saːht
liidni	lijːtniː
friddjamus	friɟːɟamus
submi	subːmiː
áicat	aːjːt͡saht
doaimmaheapme	toɑ̯jmmahe̯apme
dorski	torːskiː
bikten	pikːten
molli	molːliː
alit	aliːht
bánno	paːnːno
snielut	snie̯luːht
balut	paluːht
ballen	pallen
ája	aːja
oasi	oɑ̯siː
jápmit	jaːpmiːht
čáhppes	t͡ʃaːhːpes
távval	tʰaːvval
duivi	tujːviː
ceggosit	t͡seːɡːɡosiht
čoalbmi	t͡ʃoɑ̯lːpmiː
joatkit	joɑ̯tːkiːht
okta	okːta
nuorat	nuo̯raht
ruossut	ruo̯ssuːht
risttalaš	ristalaʃ
livččii	livtt͡ʃij
njaŋgát	ɲaŋːkaːht
aivvefal	ajvvefal
jođánit	joðaːniht
duoršu	tuo̯rːʃuː
diksu	tikːsuː
áhtat	aːhtaht
loga	loka
náhkki	naːhːkiː
njuikut	ɲujːkuːht
biehkan	pie̯hkan
giehpa	kie̯hpa
riktes	riːkːtes
davis	taviːs
geasset	ke̯asseht
guhte	kuhte
mođđi	moððiː
ráhput	raːhpuːht
čoarvi	t͡ʃoɑ̯rːviː
goallut	koɑ̯lluːht
luli	luliː
gába	kaːpa
báhčit	paːht͡ʃiːht
báraheapme	paːrahe̯apme
fierbmi	fie̯rːpmiː
dinguin	tiːnːkujn
šaldi	ʃalːtiː
sadjit	saɟɟiːht
ruškes	ruʃːkes
čoađgi	t͡ʃoɑ̯ðːkiː
dáčča	taːtt͡ʃa
dávžat	taːvːt͡ʃaht
čivrrus	t͡ʃivrruːs
leaččan	lea̯tt͡ʃan
sohka	sohka
molat	molaht
virgi	virːkiː
gádjut	kaːɟɟuːht
njuolgat	ɲuo̯lːkaht
báze	paːt͡se
giehka	kie̯hka
čuoigát	t͡ʃuo̯jːkaːht
čigŋát	t͡ʃidːɲaːht
ruojus	ruo̯juːs
gatna	katna
ruosta	ruo̯sːta
olle	olle
gávcci	kaːvtt͡siː
čájehit	t͡ʃaˑjehiht
addit	adːdiːht
lávlageatte	laːvːlake̯atte
jástit	jaːsːtiːht
borde	porːte
bollu	polːluː
gažaldat	kat͡ʃaltaht
vahkat	vahkaht
ipmil	ipmiːl
čorga	t͡ʃorːka
mearkkašit	mea̯rkkaʃiht
gievra	kie̯vːra
bassot	passoht
njuiket	ɲujːkeht
čiehka	t͡ʃie̯hka
dearvašit	tea̯rːvaʃiht
loaidat	loɑ̯jːtaht
čuovža	t͡ʃuo̯vːt͡ʃa
ladju	laɟɟuː
duopmu	tuo̯pmuː
áksi	aːkːsiː
njassat	ɲassaht
vihpat	vihpaht
issoreamos	issore̯amos
lávki	laːvːkiː
gulkat	kulːkaht
viissis	vijssiːs
gánda	kaːnːta
goldnat	kolːtnaht
moskát	mosːkaːht
jielti	jie̯lːtiː
ađa	aða
ballu	palluː
holbi	holːpiː
maid	majt
njuolggut	ɲuo̯lːkkuːht
agálaččat	akaːlatt͡ʃaht
vejolaš	vejolaʃ
dii	tij
suovssa	suo̯vssa
eatnat	ea̯tnaht
heŋge	heŋːke
sápmelaš	saˑpmelaʃ
jorri	jorːriː
goabbá	koɑ̯bːbaː
duđaheapme	tuðahe̯apme
njárbes	ɲaːrːpes
goaivut	koɑ̯jːvuːht
čatnat	t͡ʃatnaht
jallamus	jallamus
láiki	laːjːkiː
diŋgot	tiŋːkoht
sahčat	saht͡ʃaht
luoittu	luo̯jttuː
bokten	pokːten
beaivváš	pea̯jvvaːʃ
čuohppat	t͡ʃuo̯hːpaht
mannos	mannos
navdit	navːtiːht
rahkkes	rahːkes
seassat	sea̯ssaht
vuoddji	vuo̯ɟːɟiː
addet	adːdeht
suoggat	suo̯ɡːɡaht
olliba	olliːpa
bokte	pokːte
látna	laːtna
golbma	kolːpma
doavttir	toɑ̯vttiːr
hupmat	hupmaht
ruvdet	ruvːteht
heŋgo	heŋːko
viiddidit	vijːttiːtiht
rohtu	rohtuː
agis	akiːs
bullen	puːllen
mohkkái	mohːkaːj
hihttát	hihːtaːht
biddi	pidːdiː
nuorta	nuo̯rːta
vuollat	vuo̯llaht
oaivi	oɑ̯jːviː
soabbut	soɑ̯bːbuːht
giehta	kie̯hta
fális	faːliːs
bahás	pahaːs
ordi	orːtiː
čeavlás	t͡ʃea̯vːlaːs
boagán	poɑ̯kaːn
bohtanit	pohtaniht
lodji	loɟɟiː
čáihni	t͡ʃaːjːn̥iː
eai	ea̯j
etniin	eːtnijn
čáihmi	t͡ʃaːjːm̥iː
ávus	aːvuːs
dápmot	taːpmoht
doavggus	toɑ̯vːkkuːs
vielgat	vie̯lːkaht
doallat	toɑ̯llaht
nanosmit	nanosmiht
gohcit	koht͡siːht
širrat	ʃirraht
čáhccái	t͡ʃaːhːt͡saːj
beaska	pea̯sːka
veardi	vea̯rːtiː
čoska	t͡ʃosːka
toga	tʰoːka
váso	vaːso
oahpes	o̯ɑhpes
eallit	ea̯lliːht
čábbámus	t͡ʃaːbːbaːmus
divrras	tivrras
leigga	lejːkka
soahpat	soɑ̯hpaht
hullat	hullaht
baldalit	palːtaliht
beađđat	pea̯ððaht
áisá	aːjːsaː
gálbi	kaːlːpiː
vilges	viːlːkes
adde	adːde
náráš	naːraːʃ
lávlut	laːvːluːht
meahkástat	mea̯hkaːstaht
fáddá	faːdːdaː
čájáhus	t͡ʃaːjaːhus
oidit	ojːtiːht
gazo	kat͡so
dáidduheapme	taːjːttuːhe̯apme
šuohkkit	ʃuo̯hːkiːht
hilbbut	hilːppuːht
funet	fuːneht
siessá	sie̯ssaː
eadjit	ea̯ɟɟiːht
čuovggahit	t͡ʃuo̯vːkkahiht
hápmi	haːpmiː
suddat	sudːdaht
livččet	livtt͡ʃeht
deaddit	tea̯dːdiːht
heargi	hea̯rːkiː
sákta	saːkːta
mártá	maːrːtaː
nubbin	nubːbiːn
davvi	tavviː
ruovda	ruo̯vːta
lassa	lassa
jorbbot	jorːppoht
etniide	eːtnijte
šalbmi	ʃalːpmiː
geahpis	kea̯hpiːs
iežame	ie̯t͡ʃame
figge	fiɡːɡe
baikit	pajːkiːht
čeallulit	t͡ʃea̯lluːliht
čuoigat	t͡ʃuo̯jːkaht
gaiba	kajːpa
guorsat	kuo̯rːsaht
gálašit	kaːlaʃiht
njuvdit	ɲuvːtiːht
laigat	lajːkaht
ruoivát	ruo̯jːvaːht
lieksi	lie̯kːsiː
suorgi	suo̯rːkiː
biipu	pijːpuː
reabbá	rea̯bːbaː
gastá	kasːtaː
lihkkat	lihːkaht
bázzi	paːdːd͡ziː
boadnji	poɑ̯dːɲiː
bealjeheapme	pe̯aʎʎehe̯apme
ollet	olleht
duot	tuo̯ht
baggat	paɡːɡaht
leamaš	lea̯maʃ
fuones	fu̯ones
čielgaseamos	t͡ʃie̯lːkase̯amos
mánáidgárdi	maːnaːjtkaːrːtiː
máhtu	maːhtuː
áigi	aːjːkiː
luoitu	luo̯jːtuː
lebbes	leːbːbes
romi	romiː
ovcci	ovtt͡siː
čuorvut	t͡ʃuo̯rːvuːht
latnja	latɲa
cuhllat	t͡sul̥l̥aht
jabbut	jabːbuːht
bivvát	pivvaːht
ballot	palloht
logát	lokaːht
biergu	pie̯rːkuː
muitte	mujtte
čielggas	t͡ʃie̯lːkkas
holvut	holːvuːht
joahcat	joɑ̯ht͡saht
lono	lono
aldna	alːtna
buktit	pukːtiːht
rattis	rattiːs
áittar	aːjttar
njuoršu	ɲuo̯rːʃuː
albbas	alːppas
gumpe	kumːpe
doahput	toɑ̯hpuːht
gássa	kaːssa
oasis	oɑ̯siːs
dálvet	taˑlːveht
olát	olaːht
juge	juːke
cullat	t͡sullaht
deaivat	tea̯jːvaht
áidut	aːjːtuːht
ođut	oðuːht
oassi	oɑ̯ssiː
ollá	ollaː
gákkis	kaːkkiːs
davás	tavaːs
čelo	t͡ʃeːlo
gulat	kulaht
gokčat	kokːt͡ʃaht
nisu	nisuː
dieigut	tie̯jːkuːht
sárrat	saːrraht
riegádanbeaivi	rie̯kaːtanːpea̯jvi
guorbmi	kuo̯rːpmiː
njalgat	ɲalːkaht
mielddus	mie̯lːttuːs
fákta	faːkːta
cearki	t͡sea̯rːkiː
buvru	puvːruː
dásset	taːsːseht
ahkkás	ahːkaːs
boran	poran
čeahkka	t͡ʃea̯hːka
soadji	soɑ̯ɟɟiː
beassat	pea̯ssaht
háŋgu	haːŋːkuː
doppe	toːppe
ostos	oːsːtos
veaigi	vea̯jːkiː
dolalaš	tolalaʃ
millu	milːluː
laggat	laɡːɡaht
devdot	teːvːtoht
jaskat	jasːkaht
čiekčá	t͡ʃie̯kːt͡ʃaː
luotkkus	luo̯tkuːs
bealuštit	pea̯luːʃtiht
geahčastit	kea̯ht͡ʃastiht
báiki	paːjːkiː
basson	passon
náhpi	naːhpiː
cizáš	t͡sit͡saːʃ
áhpásmit	aːhpaːsmiht
vuolpu	vuo̯lːpuː
doaimmahat	toɑ̯jmmahaht
geahčču	kea̯hːt͡ʃuː
mollen	mollen
deakčut	tea̯kːt͡ʃuːht
romit	romiːht
vuodjut	vuo̯ɟɟuːht
bilbut	pilːpuːht
vuoiga	vuo̯jːka
gohccát	kohːt͡saːht
nave	nave
buorre	pu̯orre
juga	juka
lehpet	leːhpeht
njávkat	ɲaːvːkaht
humai	humaj
siedja	sie̯ɟɟa
dudno	tudːno
nála	naːla
čábbe	t͡ʃaːbːbe
biestit	pie̯sːtiːht
bakku	pakkuː
gaskii	kasːkij
čurge	t͡ʃurːke
dievdu	tie̯vːtuː
lotti	lottiː
siellu	sie̯lluː
niitu	nijːtuː
avis	aviːs
áices	aːjːt͡ses
čeaskkut	t͡ʃea̯skuːht
dorve	torːve
gávri	kaːvːriː
šođbbut	ʃoðːppuːht
datni	tatniː
doaivvuheapme	toɑ̯jvvuːhe̯apme
liiki	lijːkiː
juogut	juo̯kuːht
doarru	toɑ̯rruː
čuoivvat	t͡ʃuo̯jvvaht
ášši	aːʃːʃiː
ruohtas	ruo̯htas
ehpet	eːhpeht
volta	volːta
gohppi	kohːpiː
niitit	nijːtiːht
einnostus	eːjnnostus
oaidu	oɑ̯jːtuː
ruovttoluotta	ruo̯vttoluo̯tta
balai	palaj
coakcut	t͡soɑ̯kːt͡suːht
ravgat	ravːkaht
láhppi	laːhːpiː
oalli	oɑ̯lliː
gávdnot	kaːvːtnoht
rievssat	rie̯vssaht
adnostit	adːnostiht
jeaggi	jea̯ɡːɡiː
almmá	almmaː
duoddi	tuo̯dːdiː
ájáhallat	aːjaːhallaht
cuhpat	t͡suhpaht
dello	teːllo
álo	aːlo
čirrat	t͡ʃirraht
balde	palːte
mánnávuohta	maːnnaːvuo̯hta
dávjá	taːvːjaː
huikit	hujːkiːht
geavvat	kea̯vvaht
dákko	taːkko
guohkkat	kuo̯hːkaht
reaisu	rea̯jːsuː
jiekŋa	jie̯tɲa
guhkimus	kuhkiːmus
borden	porːten
boanda	poɑ̯nːta
bordos	porːtos
duopma	tuo̯pma
gierdat	kie̯rːtaht
leabbat	lea̯bːbaht
guoirat	kuo̯jːraht
boaris	poɑ̯riːs
čavgadit	t͡ʃavːkatiht
agi	akiː
biebmu	pie̯bːmuː
lehkon	leːhkon
cuvzat	t͡suvːt͡saht
sevnnjodeapmi	seːvɲɲotea̯pmiː
gielda	kie̯lːta
moni	moniː
juogadit	juo̯katiht
čávdit	t͡ʃaːvːtiːht
headju	hea̯ɟɟuː
dievas	tie̯vas
goasii	koɑ̯sij
gaivát	kajːvaːht
árvidit	aːrːviːtiht
gávccát	kaːvtt͡saːht
dieigu	tie̯jːkuː
livččiidet	livtt͡ʃijteht
russat	russaht
badjel	paɟɟel
áhkku	aːhːkuː
bihkka	pihːka
gožža	kodːd͡ʒa
dálvvadis	taːlvvatis
duostat	tuo̯sːtaht
čuvges	t͡ʃuːvːkes
basaldat	pasaltaht
oalul	oɑ̯luːl
vurket	vuːrːkeht
basset	passeht
jode	jote
áddehahtti	aːdːdehahːtiː
oabbá	oɑ̯bːbaː
čiekŋaleamos	t͡ʃie̯tɲale̯amos
boaráseamos	poɑ̯raːse̯amos
luotkkos	lu̯otkos
gievrrat	kie̯vrraht
altteson	altteson
cuohkki	t͡suo̯hːkiː
njulges	ɲuːlːkes
divrasit	tivːrasiht
moardit	moɑ̯rːtiːht
bora	pora
doahkki	toɑ̯hːkiː
duohpat	tuo̯hpaht
dovtta	tovtta
aivve	ajvve
dulden	tuːlːten
oattit	oɑ̯ttiːht
káffe	kʰaːffe
buokčat	puo̯kːt͡ʃaht
birrin	pirriːn
agálaš	akaːlaʃ
čádjidit	t͡ʃaːɟɟiːtiht
čahki	t͡ʃahkiː
juolgi	juo̯lːkiː
basahat	pasahaht
oppal	oppal
vuodjaláibi	vuo̯ɟɟalaːjːpiː
ruoŧagiella	ruo̯θakie̯lla
šibit	ʃipiːht
biktit	pikːtiːht
haksi	hakːsiː
čáppat	t͡ʃaːppaht
leat	lea̯ht
bárti	paːrːtiː
dieno	ti̯eno
duinna	tujnna
ádji	aːɟɟiː
heaŋgut	hea̯ŋːkuːht
geaidut	kea̯jːtuːht
oaddi	oɑ̯dːdiː
gobmi	kobːmiː
issoras	issoras
geaidit	kea̯jːtiːht
juksu	jukːsuː
gággat	kaːɡːɡaht
rikkes	rikkes
čorggut	t͡ʃorːkkuːht
nuondat	nuo̯nːtaht
boahtit	poɑ̯htiːht
iežamet	ie̯t͡ʃameht
coakcul	t͡soɑ̯kːt͡suːl
nulle	nuːlle
gaston	kasːton
áldu	aːlːtuː
gossos	kossos
dávvir	taːvviːr
odne	odːne
lihpi	lihpiː
duđahit	tuðahiht
biegga	pie̯ɡːɡa
avvit	avviːht
luoitit	luo̯jːtiːht
earti	ea̯rːtiː
culci	t͡sulːt͡siː
ráhpásmit	raːhpaːsmiht
oanimus	oɑ̯niːmus
allodat	allotaht
leačča	lea̯tt͡ʃa
almmolaš	almmolaʃ
snávggut	snaːvːkkuːht
duostilis	tuo̯sːtiːlis
ahkásii	ahkaːsij
oahpahit	oɑ̯hpahiht
vahca	vaht͡sa
deallut	tea̯lluːht
buođđu	puo̯ððuː
čorgadeamos	t͡ʃorːkate̯amos
ahkit	ahkiːht
jođán	joðaːn
nas	nas
nisun	nisuːn
dápmu	taːpmuː
ceahkki	t͡sea̯hːkiː
ádde	aːdːde
bušku	puʃːkuː
guoddit	kuo̯dːdiːht
čeahpes	t͡ʃe̯ahpes
dáhttut	taːhːtuːht
buvri	puvːriː
breahtta	prea̯hːta
čábbáseamos	t͡ʃaːbːbaːse̯amos
irrasit	irrasiht
lehkoska	leːhkoska
fiskadit	fisːkatiht
doaivva	toɑ̯jvva
ballon	pallon
sehkket	seːhːkeht
goargŋut	koɑ̯rːtɲuːht
čoavččis	t͡ʃoɑ̯vtt͡ʃiːs
gávpot	kaːvːpoht
lávlageattet	laːvːlake̯atteht
doppe	toppe
muitalus	mujːtalus
deavdit	tea̯vːtiːht
gopmat	kopmaht
gohcu	koht͡suː
gosahit	kosahiht
goikat	kojːkaht
gilvit	kilːviːht
uhkki	uhːkiː
manne	manne
giđđa	kiðða
riggi	riɡːɡiː
rátkit	raːtːkiːht
gárpa	kaːrːpa
hárcut	haːrːt͡suːht
rusta	rusːta
viđji	viðːjiː
veret	veːreht
kárta	kʰaːrːta
fanas	fanas
vára	vaːra
boahtal	poɑ̯htal
háŋgut	haːŋːkuːht
ruonát	ruo̯naːht
duotna	tuo̯tna
senet	seːneht
reakci	rea̯kːt͡siː
soahki	soɑ̯hkiː
njuoska	ɲuo̯sːka
riehpu	rie̯hpuː
loavdda	loɑ̯vːtta
geahči	kea̯ht͡ʃiː
bulki	pulːkiː
hahppit	hahːpiːht
alla	alla
suohpput	suo̯hːpuːht
vealgi	vea̯lːkiː
peanna	pʰea̯nːna
atnit	atniːht
hávga	haːvːka
riessat	rie̯ssaht
vuotna	vuo̯tna
rássi	raːssiː
sáhppi	saːhːpiː
čájihit	t͡ʃaːjiːhiht
cealkit	t͡sea̯lːkiːht
ássat	aːssaht
dudnon	tudːnon
ean	ea̯n
joksat	jokːsaht
čulggon	t͡ʃulːkkon
čáhci	t͡ʃaːht͡siː
sávri	saːvːriː
dáiddár	taːjːttaːr
oarji	oɑ̯rːjiː
láibi	laːjːpiː
ruovdi	ruo̯vːtiː
doadjit	toɑ̯ɟɟiːht
kássa	kʰaːsːsa
čábbát	t͡ʃaːbːbaːht
buvda	puvːta
oaidnaleapmái	oɑ̯jːtnalea̯pmaːj
eadniska	ea̯dːniːska
juoigat	juo̯jːkaht
láikkes	laˑjkkes
mugga	muɡːɡa
duollji	tuo̯ʎːʎiː
ruošši	ruo̯ʃʃiː
dot	toːht
vázzit	vaːdːd͡ziːht
luokčat	luo̯kːt͡ʃaht
juná	junaː
bronsa	pronːsa
dolin	toliːn
fierpmi	fie̯rpmiː
jietna	jie̯tna
girse	kirːse
ratni	ratniː
base	pase
liepma	lie̯pma
ruodjat	ruo̯ɟɟaht
ádjit	aːɟɟiːht
guoggát	kuo̯ɡːɡaːht
gárta	kaːrːta
iežadet	ie̯t͡ʃateht
dábba	taːbːba
bára	paːra
stetoskohppa	stetoskohpːɑ
gájot	kaːjoht
bolto	polːto
dohko	tohko
čujuhus	t͡ʃujuːhus
skurtnjas	skurtɲas
vuovda	vuo̯vːta
dássi	taːssiː
doaibma	toɑ̯jːpma
nahkihit	nahkiːhiht
gáhtat	kaːhtaht
bassat	passaht
ovdagovva	ovːtakovva
doaŋgi	toɑ̯ŋːkiː
buogu	puo̯kuː
beahttit	pea̯hːtiːht
áktit	aːkːtiːht
mánnu	maːnnuː
cáhpat	t͡saːhpaht
eará	ea̯raː
rásttis	raːstiːs
helvet	helːveht
etniiguin	eːtnijkujn
dássit	taːssiːht
veadju	vea̯ɟɟuː
haddi	hadːdiː
guovgát	kuo̯vːkaːht
gossan	kossan
roaibut	roɑ̯jːpuːht
oaidnit	oɑ̯jːtniːht
mana	mana
justit	jusːtiːht
geargat	kea̯rːkaht
sáđđat	saːððaht
duhtat	tuhtaht
golgadat	kolːkataht
áiru	aːjːruː
aldi	alːtiː
vuossu	vuo̯sːsuː
leimme	lejmme
lehkot	leːhkoht
čiehkat	t͡ʃie̯hkaht
siivu	sijːvuː
bordet	porːteht
dikšu	tikːʃuː
bealjeheamos	pe̯aʎʎehe̯amos
biila	pijːla
deapmat	tea̯pmaht
čalbmi	t͡ʃalːpmiː
čuohcat	t͡ʃuo̯ht͡saht
galgan	kalːkan
eŋgelas	eŋːkelas
munno	munːno
jiellat	jie̯llaht
áigodat	aːjːkotaht
sálbma	saːlːpma
báhcci	paːhːt͡siː
dáhpáhus	taːhpaːhus
beaivet	pe̯ajːveht
deaddu	tea̯dːduː
olmmoš	olmmoʃ
áddjut	aːɟːɟuːht
bielkka	pie̯lkka
oaidnalit	oɑ̯jːtnaliht
arvi	arːviː
boaski	poɑ̯sːkiː
suossat	suo̯ssaht
lákcut	laːkːt͡suːht
mánná	maːnnaː
seaggi	sea̯ɡːɡiː
čukčá	t͡ʃukːt͡ʃaː
minin	miːniːn
golbmii	kolːpmij
guolga	kuo̯lːka
rikkis	rikkiːs
cukcat	t͡sukːt͡saht
doarrát	toɑ̯rːraːht
aliheamos	aliːhe̯amos
coggat	t͡soɡːɡaht
arvit	arːviːht
njuiken	ɲujːken
ruoksát	ruo̯kːsaːht
čalmmeheamos	t͡ʃalmmehe̯amos
letne	letne
bastil	pasːtiːl
maŋŋel	maŋɲel
lávlageaskka	laːvːlakea̯ska
reahpen	rea̯hpen
dievvaseamos	tie̯vvase̯amos
ollut	olːluːht
dorvvolaččamus	torvvolatt͡ʃamus
buoiddes	pu̯ojːttes
bikte	pikːte
gissat	kissaht
čuolbmat	t͡ʃuo̯lːpmaht
čuvdi	t͡ʃuvːtiː
juvla	juvːla
lánto	laːnːto
kránnjá	kraːɲːɲaː
nolla	nolːla
bavssa	pavssa
dellos	teːllos
eadnái	ea̯dːnaːj
lulli	lulliː
rehppo	rehːpo
imis	imiːs
várdát	vaːrːtaːht
keallir	kʰea̯lliːr
nuortu	nuo̯rːtuː
máddi	maːdːdiː
geahčastat	kea̯ht͡ʃastaht
burrus	purruːs
ruobbi	ruo̯bːbiː
addálasat	adːdaːlasaht
girona	kiːrona
basahit	pasahiht
elle	eːlle
áidnu	aːjːtnuː
girdi	kirːtiː
suoldni	suo̯lːtniː
ollos	ollos
boasta	poɑ̯sːta
astos	asːtos
gávtti	kaːvttiː
it	iht
báddat	paːdːdaht
rišša	riʃːʃa
brillat	prillaht
oskut	osːkuːht
manale	manale
koahkka	kʰoɑ̯hːka
njeazzát	ɲea̯dːd͡zaːht
dassat	tassaht
moarsi	moɑ̯rːsiː
njallat	ɲallaht
hárdit	haːrːtiːht
áhpásmahttit	aːhpaːsmahːtiːht
rišša	riʃʃa
láibut	laːjːpuːht
dáhpáhuvvat	taːhpaːhuvvaht
seaidni	sea̯jːtniː
galgen	kalːken
darvi	tarːviː
dárbu	taːrːpuː
divri	tivːriː
monni	monniː
dábálaččat	taːpaːlatt͡ʃaht
njiellat	ɲie̯llaht
avvi	avviː
báffat	paːffaht
ruoŧŧelaš	ru̯oθθelaʃ
dáški	taːʃːkiː
guovda	kuo̯vːta
geaidi	kea̯jːtiː
ološ	oːloʃ
fuotnut	fuo̯tnuːht
várju	vaːrːjuː
duldet	tuːlːteht
váivi	vaːjːviː
boaibmut	poɑ̯jːpmuːht
sevnnjodit	seːvɲɲotiht
lábbá	laːbːbaː
mollet	molleht
leabbut	lea̯bːbuːht
sáhppat	saːhːpaht
fitnat	fitnaht
doarjut	toɑ̯rːjuːht
dávgut	taːvːkuːht
muitit	mujːtiːht
čuokkis	t͡ʃuo̯kkiːs
munnon	munːnon
guđat	kuðaht
leaikut	lea̯jːkuːht
kirku	kʰirːkuː
boaggut	poɑ̯ɡːɡuːht
doavki	toɑ̯vːkiː
vuoŋas	vuo̯ɲas
huma	huma
sámi	saːmiː
leaš	lea̯ʃ
borrá	porraː
goikáseamos	kojːkaːse̯amos
gohcut	koht͡suːht
guorbát	kuo̯rːpaːht
ráhkadit	raːhkatiht
asit	asiːht
vallji	vaʎːʎiː
gievrras	kie̯vrras
eaba	ea̯pa
boaššu	poɑ̯ʃːʃuː
loktat	lokːtaht
bieđgát	pie̯ðːkaːht
duoggut	tuo̯ɡːɡuːht
ráhkkásit	raːhːkaːsiht
akta	akːta
fagŋát	fadːɲaːht
lávlageamet	laːvːlake̯ameht
balahahtti	palahahːtiː
gullat	kullaht
čoaskkis	t͡ʃoɑ̯skiːs
gođđit	koððiːht
giksat	kikːsaht
diehtu	tie̯htuː
buhttáseamos	puhːtaːse̯amos
barut	paruːht
vuorbi	vuo̯rːpiː
eanet	e̯aneht
goansta	koɑ̯nːsta
diehppi	tie̯hːpiː
cuollat	t͡suo̯llaht
vátnat	vaːtnaht
niittu	nijttuː
čoavdda	t͡ʃoɑ̯vːtta
ruhta	ruhta
láhppu	laːhːpuː
heagga	hea̯ɡːɡa
čoaskámus	t͡ʃoɑ̯sːkaːmus
vieris	vie̯riːs
humat	humaht
gursa	kurːsa
miela	mie̯la
suopma	suo̯pma
jiehkki	jie̯hːkiː
cabbi	t͡sabːbiː
árpa	aːrːpa
nuoramus	nuo̯ramus
čierrá	t͡ʃie̯rːraː
agáiduvvat	akaːjtuvvaht
gurká	kurːkaː
muŋkát	muŋːkaːht
gusa	kusa
bieggat	pie̯ɡːɡaht
nagir	nakiːr
addálas	adːdaːlas
njalla	ɲalla
sárdnut	saːrːtnuːht
beassi	pea̯sːsiː
dinin	tiːniːn
jagi	jakiː
ráhkistuvvat	raːhkiːstuvvaht
hollos	hoːllos
nogai	nokaj
etniid	eːtnijt
girdit	kirːtiːht
deret	teːreht
reive	rejːve
dálvvás	taːlvvaːs
erenoamáš	erenoɑ̯maːʃ
čala	t͡ʃala
dolle	toːlle
čierastit	t͡ʃie̯rastiht
norga	norːka
sáhka	saːhka
ruitu	rujːtuː
juorbut	juo̯rːpuːht
leažžá	lea̯dːd͡ʒaː
dorvvastit	torvvastiht
áddet	aːdːdeht
ruovgat	ruo̯vːkaht
sahkat	sahkaht
mu	muː
muohttit	muo̯hːtiːht
lunddolaš	lunːttolaʃ
lieđđi	lie̯ððiː
gosahat	kosahaht
oktii	okːtij
čihkoseamos	t͡ʃiːhkose̯amos
giella	kie̯lla
lossa	lossa
njoarrat	ɲoɑ̯rraht
gálvát	kaːlːvaːht
ramas	ramas
peara	pʰea̯ra
beasti	pea̯sːtiː
guorus	kuo̯ruːs
geallir	kea̯lliːr
munnuin	munːnujn
ealla	ea̯lla
roadda	roɑ̯dːda
horbma	horːpma
rihtu	rihtuː
bierdna	pie̯rːtna
vielti	vie̯lːtiː
čahrrat	t͡ʃar̥r̥aht
riikkat	rijkkaht
cuozza	t͡suo̯dːd͡za
alladávttat	allataːvttaht
ávki	aːvːkiː
bilidit	piliːtiht
guovlat	kuo̯vːlaht
ábbut	aːbːbuːht
nanosmahttit	nanosmahːtiːht
vuokta	vuo̯kːta
duolvva	tuo̯lvva
gobiid	kopijt
goaivu	koɑ̯jːvuː
muoldu	muo̯lːtuː
eatni	ea̯tniː
bomba	pomːpa
bindut	pinːtuːht
fearrat	fea̯rraht
árbmu	aːrːpmuː
alde	alːte
geaidnu	kea̯jːtnuː
goapma	koɑ̯pma
gapmu	kapmuː
eatnu	ea̯tnuː
beavdi	pea̯vːtiː
leaika	lea̯jːka
muovlla	muo̯vlla
easkka	ea̯ska
bidjat	piɟɟaht
doaimmahit	toɑ̯jmmahiht
deahkki	tea̯hːkiː
balden	palːten
muorra	muo̯rra
riddu	ridːduː
muitát	mujːtaːht
ákšu	aːkːʃuː
avi	aviː
siidu	sijːtuː
eallin	ea̯lliːn
fiertu	fie̯rːtuː
čohkka	t͡ʃohːka
ruoktu	ruo̯kːtuː
dolas	tolas
dálki	taːlːkiː
addáleamos	adːdaːle̯amos
addáladdat	adːdaːladːdaht
jugat	jukaht
dollen	toːllen
eanu	ea̯nuː
frákta	fraːkːta
ollu	olluː
dorvvoleamos	torvvole̯amos
joga	joka
davi	taviː
varra	varra
ruškat	ruʃːkaht
gorden	koːrːten
máhccut	maːhːt͡suːht
in	in
regole	reːkole
giemardit	kie̯martiht
bealji	pea̯ʎʎiː
savvit	savviːht
seakti	sea̯kːtiː
hoigat	hojːkaht
duvdit	tuvːtiːht
állut	aːlːluːht
muovla	muo̯vːla
guoddá	kuo̯dːdaː
hávdi	haːvːtiː
cogge	t͡soɡːɡe
buhtis	puhtiːs
nieida	nie̯jːta
ollibeahtti	olliːpea̯hːtiː
suollit	suo̯lliːht
ale	ale
guođđit	kuo̯ððiːht
manai	manaj
gieldit	kie̯lːtiːht
bokset	pokːseht
siekŋa	sie̯tɲa
basttoheapme	pastohe̯apme
čeargulit	t͡ʃea̯rːkuːliht
baika	pajːka
aiget	ajːkeht
olli	olliː
dievvasit	tie̯vvasiht
gallen	kalːlen
beste	peːsːte
liŋka	liŋːka
viertu	vie̯rːtuː
johka	johka
ŋ	ŋ
áigut	aːjːkuːht
máivi	maːjːviː
doalli	toɑ̯lliː
lahpat	lahpaht
garas	karas
čavges	t͡ʃavːkes
gaskit	kasːkiːht
mearka	mea̯rːka
duhtavaš	tuhtavaʃ
joksi	jokːsiː
háhkat	haːhkaht
čáhppadit	t͡ʃaːhːpatiht
njurgut	ɲurːkuːht
duhkku	tuhːkuː
guoros	ku̯oros
buoibmat	puo̯jːpmaht
hála	haːla
daŋas	taɲas
orda	orːta
ruossa	ruo̯sːsa
duoddut	tuo̯dːduːht
čuorgadit	t͡ʃuo̯rːkatiht
čearru	t͡ʃea̯rruː
bodnját	podːɲaːht
rusena	rusena
cuhlli	t͡sul̥ːl̥iː
lávka	laːvːka
vuođđu	vuo̯ððuː
alvvaiduvvat	alvvajtuvvaht
cibmut	t͡sibːmuːht
bossut	possuːht
seksa	sekːsa
leažžaba	lea̯dːd͡ʒapa
eadni	ea̯dːniː
boandut	poɑ̯nːtuːht
váddut	vaːdːduːht
ruivi	rujːviː
čáskat	t͡ʃaːsːkaht
norden	norːten
borramuš	porramuʃ
kárpa	kʰaːrːpa
dikšut	tikːʃuːht
lutnjat	lutɲaht
geallit	kea̯lliːht
astet	asːteht
bagadeaddji	pakatea̯ɟːɟiː
guoibmi	kuo̯jːpmiː
duolvasit	tuo̯lːvasiht
lama	lama
čuoskut	t͡ʃuo̯sːkuːht
losit	losiːht
goallát	koɑ̯lːlaːht
geallat	kea̯llaht
njoalpi	ɲoɑ̯lːpiː
lávlagan	laːvːlakan
livččiime	livtt͡ʃijme
busse	pusːse
čelččen	t͡ʃeːltt͡ʃen
álggahit	aːlːkkahiht
niibi	nijːpiː
dušše	tuʃʃe
reaŋga	rea̯ŋːka
diggot	tiɡːɡoht
bahčit	paht͡ʃiːht
čakčat	t͡ʃakːt͡ʃaht
čábbásit	t͡ʃaːbːbaːsiht
guodja	kuo̯ɟɟa
luopmu	luo̯pmuː
gili	kiliː
eastat	ea̯sːtaht
šieđđat	ʃie̯ððaht
beroštit	peːroʃtiht
silli	silːliː
dearvvaš	tea̯rvvaʃ
lávgut	laːvːkuːht
adnot	adːnoht
njárbut	ɲaːrːpuːht
vuolla	vuo̯lla
riehpat	rie̯hpaht
čuollát	t͡ʃuo̯lːlaːht
ollot	olloht
balddihahtti	palːttiːhahːtiː
lievlla	lie̯vlla
soarvi	soɑ̯rːviː
rašši	raʃʃiː
gahkit	kahkiːht
čáđbmi	t͡ʃaːðːpmiː
boktit	pokːtiːht
saje	saje
duohko	tu̯ohko
nappo	nappo
biibal	pijːpal
álgu	aːlːkuː
vašši	vaʃʃiː
ellos	eːllos
geassit	kea̯ssiːht
lievla	lie̯vːla
bagadit	pakatiht
bánžat	paːnːt͡ʃaht
árjja	aːrjja
doabo	to̯ɑpo
boltut	polːtuːht
doardna	toɑ̯rːtna
árpu	aːrːpuː
sopmu	sopmuː
gávrát	kaːvːraːht
barta	parːta
bassi	pasːsiː
šaddu	ʃadːduː
fárru	faːrruː
guktii	kukːtij
doallu	toɑ̯lluː
rievtti	rie̯vttiː
basttálmit	pastaːlmiht
maŋos	maɲos
jurddašit	jurːttaʃiht
eadnámet	ea̯dːnaːmeht
vuolli	vuo̯lliː
dieigi	tie̯jːkiː
searvi	sea̯rːviː
gaškát	kaʃːkaːht
gildát	kilːtaːht
anihahtti	aniːhahːtiː
luossa	luo̯ssa
hoallu	hoɑ̯lːluː
jugus	jukuːs
mehter	meːhter
lamai	lamaj
miehtat	mie̯htaht
náđđát	naːðːðaːht
juohkit	juo̯hkiːht
ahkahaš	ahkahaʃ
njoazimus	ɲoɑ̯t͡siːmus
dilli	tilliː
cuoppu	t͡suo̯ppuː
ohcat	oht͡saht
livčče	livtt͡ʃe
beđo	peːðo
dulde	tuːlːte
judda	judːda
leavga	lea̯vːka
čotta	t͡ʃotta
čeavži	t͡ʃea̯vːt͡ʃiː
ealihit	ea̯liːhiht
gahppat	kahːpaht
ássi	aːsːsiː
suoksa	suo̯kːsa
lávlageaset	laːvːlake̯aseht
borahahtti	porahahːtiː
oažži	oɑ̯dːd͡ʒiː
guorga	kuo̯rːka
dá	taː
suffá	suffaː
áhci	aːht͡siː
apmaseamos	apmase̯amos
oatnut	oɑ̯tnuːht
gissen	kiːssen
lievssi	lie̯vssiː
rámbi	raːmːpiː
bohčit	poht͡ʃiːht
joavdat	joɑ̯vːtaht
beavrrit	pea̯vrriːht
vuorjat	vuo̯rːjaht
aivvestassii	ajvvestassij
fárret	faːrreht
oahkut	oɑ̯hkuːht
gulla	kulːla
ráhččat	raːhːt͡ʃaht
dohpat	tohpaht
vuiges	vuːjːkes
muitaleaddji	mujːtalea̯ɟːɟiː
muohttát	muo̯hːtaːht
boares	po̯ɑres
bivnnut	pivnnuːht
ráidu	raːjːtuː
vahcut	vaht͡suːht
