گاڏڙ	ɡaːɖˈʌr.
بازي	bˈaːzi
ھوندو	hˈoːndoː
کائيندڙ	kʰˌaːindˈʌr.
سگهارو	sˌəɡhˈaːroː
ڪرسمس	kˌərəsəmˈʌs
جيوڙا	ɟjˈoːr.aː
ٿنڀا	ʈənˈʌbʰaː
ملائڪ	mˌəlaːˈɪk
پربت	pˌərəbˈʌt̪
وسڪارو	ʋˌəskˈaːroː
فلاسافر	fˌəlaːsaːfˈʌr
آندل	aːndˈʌl
افلاطون	ˌaflaːtˈoːn
نافذ	naːfˈʌz
هندو	hˈɪndoː
پسند	pəsˈʌnd
ڦري	pʰˈʌri
چٽو	cˈʌʈoː
ميرڪ	meːrˈʌk
شاھي	ʃˈaːhi
نرم	nərˈʌm
نديم	nədˈiːm
نوڙت	noːr.ˈʌt̪
ڄاڻندو	ɟaːɳˈʌndoː
ڊيگھ	ɖˈeːɡʰ
ڳالهيون	ɡˌaːlhjˈoːn
دعوت	daːˈoːt̪
مول	mˈoːl
زمانو	zəmˈaːnoː
اصلي	aʂˈʌli
عنصر	ˌanəʂˈʌr
مفلس	mˌəfəlˈʌs
گايتري	ɡˌaːit̪ˈʌri
تاليف	t̪aːlˈiːf
ناٿن	naːʈˈʌn
وحي	ʋˈʌhi
ڌاڳي	dʰˈaːɡi
ڇهه	cʰəhˈʌh
شيرين	ʃeːrˈiːn
ماليڪيول	mˌaːlikjˈoːl
خوبصورت	xˌoːbʂoːrˈʌt̪
مزيدار	mˌəzidˈaːr
وليون	ʋəljˈoːn
محل	məhˈʌl
پري	pˈʌri
اصلاحي	ˌɪʂlˈaːhi
سنڌيت	sɪndhˈiːt̪
اڌ	ˈadʰ
گندي	ɡˈʌndi
رهائشي	rˌəhaːˈɪʃi
شمع	ʃˈʌmaː
وسايو	ʋəsˈaːjoː
ايڪٽ	eːkˈʌʈ
ڳجھارت	ɡˌəɟhaːrˈʌt̪
ويڙهاڪ	ʋˌeːr.hˈaːk
مورخن	mˌoːrəxˈʌn
سوال	sʋˈaːl
منهنجي	mˌənəhənˈʌɟi
سمجهون	sˌəməɟhˈoːn
مان	mˈaːn
ڪنداسين	kˌəndaːsˈiːn
شده	ʃədˈʌh
انٽرنيٽ	ˌanəʈˌərnˈiːʈ
پڌرو	pədʰˈʌroː
ڪنڊ	kˈʌnɖ
قنڌار	qəndʰˈaːr
ڪنب	kˈʌnb
ٿر	ʈˈʌr
سٺو	sˈʌʈʰoː
گهڙين	ɡˌəhər.ˈiːn
حسام	həsˈaːm
مزدورن	mˌəzduːrˈʌn
جرمن	ɟˌərəmˈʌn
انگيز	anɡˈiːz
معمار	maːmˈaːr
هجڻ	hˈʊɟaɳ
ٻي	bˈeː
ٻيون	bjˈoːn
درٻار	dˌərbˈaːr
آفتاب	ˌaːft̪ˈaːb
جين	ɟˈeːn
هنڌان	həndʰˈaːn
وابسته	ʋˌaːbəst̪ˈʌh
ڦٽن	pʰəʈˈʌn
شمس	ʃəmˈʌs
گهٽائي	ɡˌəhəʈˈaːi
مڪان	məkˈaːn
چٽسالي	cˌəʈsˈaːli
هلڻ	həlˈʌɳ
سفرنامن	sˌəfərnaːmˈʌn
ٽنھي	ʈˈʌnhi
لاري	lˈaːri
ستت	sət̪ˈʌt̪
دم	dˈʌm
اندازن	ˌandaːzˈʌn
ڏيڍ	ɖˈeːɖʰ
جيستائين	ɟˌeːst̪aːˈiːn
ڪاڇي	kˈaːcʰi
برهان	bˌərhˈaːn
وال	ʋˈaːl
مني	mˈʌni
لڳڀڳ	lˌəɡəbʰˈʌɡ
آڏو	ˈaːɖoː
ٽالپرن	ʈˌaːləpərˈʌn
افتخار	ˌɪftɪxˈaːr
سيوا	sjʋˈaː
اوزارن	ˌuːzaːrˈʌn
جسڪاڻي	ɟˌəskˈaːɳi
اسٽيٽ	ˌasʈˈiːʈ
پيمائش	pˌeːmaːˈɪʃ
سب	sˈʌb
اسڪيم	ˌaskˈiːm
سودا	sˈoːdaː
سالڪن	sˌaːləkˈʌn
مهاجر	mˌəhaːɟˈʌr
سير	sˈeːr
عنايت	ˌanaːˈiːt̪
وسيلا	ʋəsˈiːlaː
بادشاهه	bˈaːdʃˌaːhəh
رڇ	rˈʌcʰ
آغاز	aːɣˈaːz
ڀائر	bʰaːˈɪr
سڏيائون	sˌəɖjaːˈoːn
جوائنٽ	ɟˈaʋaːˈɪnəʈ
سنگهه	sˌənɡəhˈʌh
حروف	hərˈoːf
سڀيتا	səbʰˈiːt̪aː
سڌي	sˈʌdʰi
اداڪاري	ˌadaːkˈaːri
فنن	fənˈʌn
شدت	ʃədˈʌt̪
سرمد	sˌərəmˈʌd
ڏيئي	ɖˈeːi
تارون	t̪aːrˈoːn
گج	ɡˈʌɟ
ڪٽر	kəʈˈʌr
ربيع	rəbˈiː
پڌري	pədʰˈʌri
ماڻھن	mˈaːɳhʊn
مڇ	mˈʌcʰ
جوڳا	ɟˈoːɡaː
بواسير	bʋˈaːsir
ھڏڪيون	hˌəɖkjˈoːn
بياني	bjˈaːni
فقيرن	fˌəqirˈʌn
سرڪي	sərˈʌki
رائل	raːˈɪl
تھ	t̪ˈʌh
سئي	sˈʌi
يھودين	jˌəhoːdˈiːn
کٽا	kʰˈʌʈaː
دعا	dˈaː
ٽئين	ʈəˈiːn
قيمتي	qeːmˈʌt̪i
آيس	aːˈiːs
بال	bˈaːl
جهڙن	ɟˌəhər.ˈʌn
رپورٽون	rˌəpoːrʈˈoːn
ملهائي	mˌəlhˈaːi
سني	sˈʌni
ڪروموسوم	kˌəroːmoːsˈoːm
سلطانه	sˌəltaːnˈʌh
عرفات	ˌarəfˈaːt
آهيو	ˈaːhjoː
اڄڪلھ	ˌaɟəkəlˈʌh
اهم	ahˈʌm
ڀرائي	bʰərˈaːi
انفيڪشن	ˌanfˌiːkəʃˈʌn
بھار	bəhˈaːr
هليون	həljˈoːn
ڄاڻائين	ɟˌaːɳaːˈiːn
ڪرتب	kˌərət̪ˈʌb
دهشتگرد	dˌəhəʃt̪əɡˈʌrd
لڳايل	ləɡˈaːjal
تقرير	t̪ˌəqrˈiːr
مسيح	mˈʌsih
هماليه	hˌəmaːlˈiːh
ٽکڙ	ʈəkʰˈʌr.
بلڪي	bəlˈʌki
دفعو	dəfˈaːoː
جاگيردار	ɟˌaːɡirdˈaːr
ڳالھين	ɡˌaːlhˈiːn
قفقاز	qˌəfqˈaːz
پيڙهي	peːr.ˈʌhi
جهرڪن	ɟˌəhərəkˈʌn
ڇپائيندڙ	cʰˌəpaːindˈʌr.
نوازيو	nˈaʋaːzjˌoː
پوئتي	poːˈɪt̪i
فنڪارن	fˌənkaːrˈʌn
نڪوٽين	nˌəkoːʈˈiːn
گهرڙي	ɡˌəhərˈʌr.i
ڪتي	kˈʌt̪i
ماڳ	mˈaːɡ
بيل	bˈeːl
واڱڻائي	ʋˌaːŋ̩ɳˈaːi
ڪچهرين	kˌəcəhərˈiːn
ذريعن	zərˈiːn
سوشلسٽ	sˌoːʃələsˈʌʈ
پوسٽ	poːsˈʌʈ
مفڪرن	mˌəfəkərˈʌn
زرعي	zərˈaːi
هيٺانهين	hˌeːʈʰaːnhˈiːn
فرضن	fˌərəzˈʌn
پاڪستان	pˌaːkˈɪstaːn
ابتدائي	ˌɪbtɪdˈaːi
اتريون	ˌat̪rjˈoːn
سپه	səpˈʌh
سو	sˈoː
داغن	daːɣˈʌn
طبعي	təbˈaːi
لکيو	lˈʌkʰjoː
باغبان	bˈaːɣbˈaːn
ڪرايائين	kˌəraːjaːˈiːn
ناز	nˈaːz
شرط	ʃərˈʌt
ساڙڻ	saːr.ˈʌɳ
انتقال	ˌɪntɪqˈaːl
شنڪر	ʃˌənəkˈʌr
دؤرن	dˌəa͡ʊrˈʌn
بظاهر	bˌəʐaːhˈʌr
ابراهيم	ˌabraːhˈiːm
ڌنڌو	dʰˈʌndʰoː
ڍڪ	ɖʰˈʌk
منفي	mənˈʌfi
انفارميشن	ˌanfˌaːrmiʃˈʌn
ڪلوميٽر	kˌəloːmiʈˈʌr
ويڙھ	ʋˈeːr.h
دفعا	dˈʌfaː
ويلنٽائن	ʋˌeːlənʈaːˈɪn
شريعت	ʃərˈiːt̪
معزول	maːzˈoːl
کوٽايو	kʰoːʈˈaːjoː
ڏاهپ	ɖaːhˈʌp
ارتقائي	ˌɪrtɪqˈaːi
ڊبليو	ɖəbˈʌljoː
ترخان	t̪ˌərxˈaːn
سمجهايو	sˌəməɟhˈaːjoː
آرڊر	ˌaːrəɖˈʌr
جسٽس	ɟˌəsəʈˈʌs
پروسيسنگ	pˌəroːsisˈʌnɡ
ماترائن	mˌaːt̪raːˈɪn
شاهنواز	ʃˌaːhənʋˈaːz
ڇڏين	cʰəɖˈiːn
عبادتگاهه	abˈaːdət̪ɡaːhˌəh
سنگتي	sənɡˈʌt̪i
مهاڻا	məhˈaːɳaː
ڀوري	bʰˈoːri
کنڀن	kʰˌənəbʰˈʌn
خان	xˈaːn
ايڊز	eːɖˈʌz
فلسفو	fˌələsˈʌfoː
ڪوري	kˈoːri
خواهشن	xʋˌaːhəʃˈʌn
ويزن	ʋeːzˈʌn
اهن	ahˈʌn
علائقا	ˌalaːˈɪqaː
قربت	qˌərəbˈʌt̪
پلاننگ	pˌəlaːnˈʌnɡ
باندر	bˈaːndər
اندران	ˌandərˈaːn
ڀريندا	bʰərˈiːndaː
راند	rˈaːnd
مارواڙي	maːrʋˈaːr.i
لکي	lˈʌkʰi
پڙهيل	pər.ˈʌhjal
کائين	kʰaːˈiːn
عنوانن	ʊnʋˈaːnn
جتان	ɟət̪ˈaːn
شودر	ʃoːdˈʌr
بندر	bəndˈʌr
اکر	akʰˈʌr
فرانسيسي	fˌəraːnsˈiːsi
داد	dˈaːd
وري	ʋˈʌri
سونپيو	sˈoːnpjoː
مئو	mˈʌoː
ڌاڙيل	dʰˈaːr.jal
پيرو	pˈeːroː
پرائي	pərˈaːi
سودو	sˈoːdoː
ايشور	eːʃˈoːr
ڀائي	bʰˈaːi
ڊفينس	ɖəfˈiːns
نوابشاهه	nˈaʋaːbʃaːhˌəh
ٿرڙي	ʈərˈʌr.i
ٻرن	bərˈʌn
مطمئن	mˌətəmˈʌn
انھن	ˈanhn
مردان	mərdˈaːn
آئن	aːˈɪn
بڪ	bˈʌk
قومپرستي	qˌoːmpərˈʌst̪i
ھاضمي	haːzˈʌmi
سيدن	seːdˈʌn
پنجن	pˌənəɟˈʌn
ملندا	məlˈʌndaː
ڪار	kˈaːr
ڏات	ɖˈaːt̪
ڊاڪٽر	ɖˈaːkʈar
بدين	bədˈiːn
غزل	ɣəzˈʌl
نقل	nəqˈʌl
پوندڙ	poːndˈʌr.
ناممڪن	nˌaːməməkˈʌn
اسٽاپ	ˌasʈˈaːp
ٽيڪنڪ	ʈˌeːkənˈʌk
جيئري	ɟeːˈɪri
ڪڇ	kˈʌcʰ
ميزباني	mˌeːzbˈaːni
بائيبل	bˈaːibˌəl
جهول	ɟəhˈoːl
علاؤالدين	ˌalaːˌa͡ʊaːldˈiːn
ماڻهن	mˌaːɳəhˈʌn
مريضن	mˌərizˈʌn
سورٺ	soːrˈʌʈʰ
سيڪريٽري	sˌeːkriʈˈʌri
روئي	rˈoːi
فوٽو	fˈoːʈoː
تنتن	t̪ˌənət̪ˈʌn
ٻيڻو	bˈeːɳoː
ڳائڻي	ɡaːˈɪɳi
ڄمار	ɟəmˈaːr
زويا	zʋjˈaː
واپڊا	ʋaːpˈʌɖaː
رانا	rˈaːnaː
آفيسون	ˌaːfisˈoːn
اخلاقيات	ˌaxlˌaːqiˈaːt
ٻنين	bənˈiːn
حاجب	haːɟˈʌb
رابرٽس	rˌaːbərəʈˈʌs
ٽيمپل	ʈeːmpˈʌl
موجب	moːɟˈʌb
ڍال	ɖʰˈaːl
ڍاٽ	ɖʰˈaːʈ
جناب	ɟənˈaːb
اثرات	ˌasərˈaːt
ڪشي	kˈʌʃi
چهرو	cəhˈʌroː
پيلي	pˈeːli
پهتل	pˌəhət̪ˈʌl
عبارت	abˈaːrət̪
آمر	aːmˈʌr
سريلنڪا	sˌərilənˈʌkaː
بياس	bjˈaːs
سگھون	səɡʰˈoːn
بلاول	bˌəlaːˈoːl
برفت	bˌərəfˈʌt̪
رهيو	rˈʌhjoː
اهل	ahˈʌl
ميروخان	mˌeːroːxˈaːn
جنهن	ɟˈẽhɪ̃
خبر	xəbˈʌr
وصال	ʋəʂˈaːl
نيوي	njʋˈeː
سردار	sərdˈaːr
ٽريڊ	ʈərˈiːɖ
عملو	amˈʌloː
لھجي	ləhˈʌɟi
مزارن	mˌəzaːrˈʌn
مگر	məɡˈʌr
رٽائر	rˌəʈaːˈɪr
سائين	saːˈiːn
اوطاق	uːtˈaːq
رهائش	rˌəhaːˈɪʃ
قرآني	qərˈaːni
ڏار	ɖˈaːr
زور	zˈoːr
هيري	hˈeːri
دليون	dəljˈoːn
قريبي	qˌəribˈiː
گريڊ	ɡərˈiːɖ
رايا	rˈaːjaː
هستي	hˈʌst̪i
مندرن	mˌəndərˈʌn
لڪ	lˈʌk
سڏايو	səɖˈaːjoː
ننھن	nˈʌnhn
تمنا	t̪əmˈʌnaː
ٿورا	tʰˈoːraː
اروڙ	arˈoːr.
ڳايا	ɡˈaːjaː
بطور	bətˈoːr
لوڪل	loːkˈʌl
قبي	qəbˈiː
وغيرہ	ʋˌəɣirˈʌh
مالدار	mˌaːldˈaːr
پيارجي	pjaːrˈʌɟi
پکڙجڻ	pˌəkʰər.əɟˈʌɳ
پڇيو	pˈʌcʰjoː
گهڻيون	ɡˌəhəɳjˈoːn
جهوني	ɟəhˈoːni
سفير	səfˈiːr
انکان	ˌankʰˈaːn
رامائڻ	rˌaːmaːˈɪɳ
ٻيلن	beːlˈʌn
ڪارج	kaːrˈʌɟ
ماپڻ	maːpˈʌɳ
ظاهر	ʐaːhˈʌr
مڙس	mər.ˈʌs
آبي	aːbˈiː
انهي	ɪnˈɪhi
واقعو	ʋaːqˈaːoː
راست	rˈaːst̪
ملندڙ	mˌələndˈʌr.
ٻانهي	baːnˈʌhi
ٻوڌي	bˈoːdʰi
روئڻ	roːˈɪɳ
لهرن	lˌəhərˈʌn
کاڌا	kʰˈaːdʰaː
وڙهيا	ʋər.ˈʌhjaː
ورلڊ	ʋˌərəlˈʌɖ
ھڪجھڙائي	hˌəkəɟˌəhr.ˈaːi
بادشاھن	bˈaːdʃˌaːhən
نفساني	nˌəfsˈaːni
آنڌرا	aːndʰˈʌraː
ملبار	mˌəlbˈaːr
پرکڻ	pˌərəkʰˈʌɳ
وارڊ	ʋaːrˈʌɖ
روضي	rˈoːzi
رهواسي	rəhʋˈaːsi
خيام	xjˈaːm
مرچ	mˈʌrc
عددي	adˈʌdi
ٺھندو	ʈʰəhˈʌndoː
وٽن	ʋəʈˈʌn
رڪني	rəkˈʌni
ڇلر	cʰəlˈʌr
لکڻ	lˈɪkʰaɳ
ڪتاب	kɪtˈaːb
مارواڙ	maːrʋˈaːr.
مارڪ	maːrˈʌk
لکجي	ləkʰˈʌɟi
آندو	ˈaːndoː
اداڪارا	ˌadaːkˈaːraː
منهنجا	mˌənəhənˈʌɟaː
داعي	daːˈaːi
ٽريننگ	ʈˌərinˈʌnɡ
ترياق	t̪ərjˈaːq
ڌاڳن	dʰaːɡˈʌn
نٿ	nˈʌʈ
شوقين	ʃoːqˈiːn
تيزي	t̪ˈeːzi
ٽامي	ʈˈaːmi
بيسڪ	bˈeːsək
جيوڻي	ɟjˈoːɳi
اديب	adˈiːb
قائداعظم	qˌaːɪdˌaːaːʐˈʌm
صدين	ʂədˈiːn
چوماسي	coːmˈaːsi
سئوٽ	səˈoːʈ
جماليات	ɟˌəmaːliˈaːt
موجود	moːɟˈuːd
ٿڌو	ʈˈʌdʰoː
شي	ʃˈeː
جنگين	ɟənɡˈiːn
ويڪرائي	ʋˌeːkrˈaːi
پھتا	pəhˈʌt̪aː
دؤر	dəˈa͡ʊr
وڙهندو	ʋˌər.əhˈʌndoː
ڪرايا	kərˈaːjaː
لائبيريا	lˌaːɪbˈiːrjaː
غيرقانوني	ɣˌeːrqaːnˈoːni
رھيا	rˈʌhjaː
ايترا	eːt̪ˈʌraː
گولڊن	ɡˌoːləɖˈʌn
درياه	dərjˈaːh
مدد	mədˈʌd
عيسائي	ˌaisˈaːi
ڏنڊ	ɖˈʌnɖ
ڳولهڻ	ɡˌoːləhˈʌɳ
مھينا	məhˈiːnaː
لاٽ	lˈaːʈ
شعري	ʃˈaːri
ويڪريون	ʋˌeːkrjˈoːn
مساوي	məsˈaːʋi
سنڀاليندڙ	sˌənbʰˌaːlindˈʌr.
نسلن	nˌəsəlˈʌn
رکڻ	rəkʰˈʌɳ
مقناطيسي	mˌəqnaːtˈiːsi
نھايت	nhaːˈiːt̪
راڌا	rˈaːdʰaː
ڪيميا	kˈeːmjaː
نصرت	nˌəʂərˈʌt̪
ستون	sət̪ˈoːn
آئل	aːˈɪl
ادارت	ˌadaːrˈʌt̪
هين	hˈeːn
هٿيار	hətʰjˈaːr
بخوبي	bˌəxoːbˈiː
رڪاوٽون	rˌəkaːoːʈˈoːn
برهما	bˌərəhˈʌmaː
هلائيندڙ	hˌəlaːindˈʌr.
ٻاٻيهو	baːbˈiːhoː
عيب	aˈiːb
گڏاپ	ɡəɖˈaːp
طفيل	tˈʌfjal
دليلن	dˌəlilˈʌn
شيطان	ʃeːtˈaːn
ڏيڻو	ɖˈeːɳoː
برادرين	bˌəraːdrˈiːn
ڦريون	pʰərjˈoːn
موقعي	moːqˈaːi
بيوس	bjˈoːs
ڏي	ɖˈeː
مليا	mˈʌljaː
شانتي	ʃaːnˈʌt̪i
ڊوڙ	ɖˈoːr.
ول	ʋˈʌl
فرحت	fˌərəhˈʌt̪
ڏهي	ɖˈʌhi
ڳڙ	ɡˈʌr.
سوٽي	sˈoːʈi
ورھايو	ʋˌərhˈaːjoː
اختياري	axt̪jˈaːri
حديثن	hˌədisˈʌn
ڄمڻ	ɟəmˈʌɳ
پنھنجي	pənhnˈʌɟi
محاورو	mˌəhaːˈoːroː
عشرت	ˌaʃərˈʌt̪
ڪائونٽي	kˌaːoːnˈʌʈi
جنڪشن	ɟˌənəkəʃˈʌn
سلا	sˈʌlaː
سلسلو	sˈɪlsˌɪloː
رورل	roːrˈʌl
سوانح	sʋˌaːnˈah
ايئن	eːˈɪn
طبقاتي	tˌəbqˈaːt̪i
ماڇي	mˈaːcʰi
ترين	t̪ərˈiːn
هئائون	hˌəaːˈoːn
لو	lˈoː
ڪولن	koːlˈʌn
جمھوري	ɟˌəmhˈuːri
آرمينيا	ˌaːrmˈiːnjaː
مٽجي	məʈˈʌɟi
تقريبا	t̪ˌəqribˈaː
اتهاسن	ˌat̪haːsˈʌn
روزي	rˈoːzi
هاڪڙي	haːkˈʌr.i
ڪرائيندو	kˌəraːˈiːndoː
جھڙن	ɟˌəhər.ˈʌn
طي	tˈeː
منجھان	mˌənəɟhˈaːn
مهمانن	mˌəhəmaːnˈʌn
ڇٽ	cʰˈʌʈ
والي	ʋˈaːli
آئرس	ˌaːɪrˈʌs
دوهي	dˈoːhi
پولنگ	poːlˈʌnɡ
ساداتن	sˌaːdaːt̪ˈʌn
ايڇ	ˈeːcʰ
سنسڪرت	sˌənsəkərˈʌt̪
حر	hˈʌr
واٽر	ʋaːʈˈʌr
پڇا	pˈʌcʰaː
ايلسا	eːlˈʌsaː
منطق	mˌənətˈʌq
قطار	qətˈaːr
ڀڃڻ	bʰəɲˈʌɳ
پاتا	pˈaːt̪aː
همايوني	hˌəmaːjˈoːni
اصول	ʊʂˈuːl
رندن	rəndˈʌn
اڳيون	aɡjˈoːn
عباسي	abˈaːsi
ليبر	leːbˈʌr
جاين	ɟaːˈiːn
برداشت	bərdˈaːʃt̪
خيرپور	xˌeːrpˈoːr
ٻئي	bˈʌi
ميلن	meːlˈʌn
مٿاڇري	mˌətʰaːcʰˈʌri
ايڪسچينج	ˌeːkəscinˈʌɟ
گشت	ɡˈʌʃt̪
ڇپيون	cʰəpjˈoːn
ظهور	ʐəhˈoːr
ني	nˈeː
چشمو	cəʃˈʌmoː
فيصلي	feːʂˈʌli
فولاد	foːlˈaːd
افسوس	ˌafsˈoːs
هائڊروجن	hˌaːɪɖroːɟˈʌn
سڪي	sˈʌki
مڱڻي	mˌəŋ̩ˈʌɳi
جيسلمير	ɟˌeːsəlmˈiːr
شاگردي	ʃaːɡˈʌrdi
سگھندا	səɡʰˈʌndaː
همه	həmˈʌh
ٻن	bˈʌn
پروسيس	pˌəroːsˈiːs
ڪڙو	kˈʌr.oː
توکان	t̪oːkʰˈaːn
ته	t̪ˈʌh
باگي	bˈaːɡi
بحالي	bəhˈaːli
پرواز	pərʋˈaːz
انجنيئر	ˌanəɟniˈɪr
ارادو	arˈaːdoː
ڪميونٽي	kˌəmjoːnˈʌʈi
خبرون	xˌəbrˈuːn
ڊرامه	ɖˌəraːmˈʌh
سنسار	sənsˈaːr
ڏٺائين	ɖˌəʈʰaːˈiːn
نر	nˈʌr
ڍانچو	ɖʰˈaːncoː
ٻوليء	bˈoːli
تحرير	t̪ˌəhrˈiːr
نامي	nˈaːmi
مفصل	mˌəfəʂˈʌl
امامن	ˌamaːmˈʌn
ٻاجهري	bˌaːɟəhˈʌri
قصن	qəʂˈʌn
پيڇو	pˈeːcʰoː
سلامت	sˌəlaːmˈʌt̪
حضرت	hˌəzərˈʌt̪
ليپ	lˈeːp
ابڙي	abˈʌr.i
سريلي	sərˈiːli
مصنوعي	mˌəʂnʋˈaːi
بچيل	bacˈɪal
براهمڻ	bˌəraːhəmˈʌɳ
محافظ	mˌəhaːfˈʌʐ
فڪشن	fˌəkəʃˈʌn
گھيريل	ɡʰˈeːrjal
صحت	ʂəhˈʌt̪
سورنهن	sˌoːrənəhˈʌn
اوچو	ˈuːcoː
ضابطي	zaːbˈʌti
مهل	məhˈʌl
سڏائي	səɖˈaːi
فعل	fˈaːl
ڊيموڪريٽڪ	ɖˌeːmoːkriʈˈʌk
ڀيٽا	bʰˈeːʈaː
ميرپورخاص	mˌeːrpˌoːrxˈaːʂ
نھ	nh
ڊيلٽا	ɖeːlˈʌʈaː
مسلمان	mʊsˈalmˌaːn
خوبصورتي	xˌoːbʂoːrˈʌt̪i
يادگيري	jˌaːdɡˈiːri
چي	cˈeː
پمفليٽ	pˌəməflˈiːʈ
ٻڌائين	bˌədʰaːˈiːn
ٻڌندا	bədʰˈʌndaː
ٻين	bˈɪan
ملوڪ	məlˈoːk
مڪلي	məkˈʌli
ھڪڙي	həkˈʌr.i
سگهندي	sˌəɡəhˈʌndi
گردي	ɡˈʌrdi
طبقي	təbˈʌqi
ٿرپارڪر	ʈˌərpˌaːrəkˈʌr
مقبرا	mˌəqəbˈʌraː
قاف	qˈaːf
عھدي	ahˈʌdi
پنھنجون	pˌənhnəɟˈoːn
ذخيرو	zəxˈiːroː
نوجوان	noːɟʋˈaːn
ڏير	ɖˈeːr
ڪرپشن	kˌərəpəʃˈʌn
بحري	bəhˈʌri
کيس	kʰˈeːs
مٿاڇرو	mˌətʰaːcʰˈʌroː
مٽيارين	mˌəʈjaːrˈiːn
تائيوان	t̪aːjʋˈaːn
آکيرو	aːkʰˈiːroː
مھم	məhˈʌm
جھانگير	ɟˌəhaːnɡˈiːr
خطيب	xətˈiːb
نقصانڪار	nˌəqʂˌaːnkˈaːr
سيدنا	seːdˈʌnaː
چهنب	cəhˈʌnb
ايڊيوڪيشن	ˌeːɖjoːkiʃˈʌn
جمنا	ɟəmˈʌnaː
دستي	dˈʌst̪i
نسخ	nəsˈʌx
صنفن	ʂˌənəfˈʌn
سراج	sərˈaːɟ
ڏسندي	ɖɪsˈʌndi
رائيفل	rˌaːifˈʌl
اسٽيشن	ˌasʈiʃˈʌn
اثير	asˈiːr
ٺٽي	ʈʰˈʌʈi
ڊگهيون	ɖˌəɡhjˈoːn
طرحين	tˌərhˈiːn
قدم	qədˈʌm
شيدائي	ʃeːdˈaːi
وڌ	ʋˈʌdʰ
لاهوري	laːhˈoːri
پٽين	pəʈˈiːn
مدير	mədˈiːr
ترجمان	t̪ˌərəɟmˈaːn
ڳولها	ɡoːlˈʌhaː
ڏاکڻي	ɖaːkʰˈʌɳi
گهٽجڻ	ɡˌəhəʈəɟˈʌɳ
سليمان	sˌəlimˈaːn
اشوڪ	aʃˈoːk
ترڪ	t̪ərˈʌk
دھشلا	dˌəhəʃˈʌlaː
عنصرن	ˌanəʂərˈʌn
نشين	nəʃˈiːn
پڙھي	pˈʌr.hi
موئن	moːˈɪn
ڪلوميٽرن	kˌəloːmˌiːʈərˈʌn
شفا	ʃˈʌfaː
پٺڀرائي	pˌəʈʰəbʰrˈaːi
سورهين	sˌoːrhˈiːn
لڙاين	lˌər.aːˈiːn
مسالي	məsˈaːli
ڪمان	kəmˈaːn
چورس	coːrˈʌs
اليگزينڊر	ˌaliɡzinɖˈʌr
فرنٽ	fˌərənˈʌʈ
جمالياتي	ɟˌəmaːljˈaːt̪i
بئڪٽيريا	bˌəkʈˈiːrjaː
اوپيرا	uːpˈiːraː
اصلاح	ˌɪʂlˈaːh
لهجا	ləhˈʌɟaː
ورهاست	ʋˌərhˈaːst̪
پراڻو	pərˈaːɳoː
جهڙيون	ɟˌəhər.jˈoːn
نقطو	nəqˈʌtoː
بيهن	bˈeːhən
شريف	ʃərˈiːf
تفھيم	t̪ˌəfhˈiːm
موسمن	mˌoːsəmˈʌn
گاجي	ɡˈaːɟi
نظمن	nˌəʐəmˈʌn
گزيٽيئر	ɡˌəziʈiˈɪr
مريض	mərˈiːz
نيٽ	nˈeːʈ
مقابلن	mˌəqaːbəlˈʌn
ڪالاباغ	kˌaːlaːbˈaːɣ
لالواڻي	laːlʋˈaːɳi
قبيلن	qəbˈiːlən
چندو	cˈʌndoː
وڏي	ʋˈʌɖi
عطر	atˈʌr
گردن	ɡərdˈʌn
محاورا	mˌəhaːˈoːraː
امامت	ˌamaːmˈʌt̪
دو	dˈoː
سڪل	səkˈʌl
وجه	ʋəɟˈʌh
چيا	cjˈaː
خوشبو	xˈʊʃbˈoː
مامون	maːmˈoːn
رحمت	rˌəhəmˈʌt̪
ڀرڳڙي	bʰˌərəɡˈʌr.i
ھو	hˈoː
آريجا	aːrˈiːɟaː
گلستان	ɡˌəlˈɪstaːn
ذرن	zərˈʌn
ڳر	ɡˈʌr
جام	ɟˈaːm
نوشهرو	nˌoːʃəhˈʌroː
تغلق	t̪ˌəɣəlˈʌq
کوھ	kʰˈoːh
حڪمت	hˌəkəmˈʌt̪
رشتا	rˈʌʃt̪aː
تعظيم	t̪aːʐˈiːm
لوھ	lˈoːh
محفلن	mˈɛhfˌɪln
ھونديون	hoːndjˈoːn
شهريار	ʃˌəhərjˈaːr
آزادي	aːzˈaːdi
سيف	sˈeːf
ڇپائي	cʰəpˈaːi
شاهڪار	ʃˌaːhəkˈaːr
ٻارڻ	baːrˈʌɳ
چوڏهن	cˌoːɖəhˈʌn
چنڊ	cˈʌnɖ
چونڊن	coːnɖˈʌn
ڊگري	ɖəɡˈʌri
مشاهدي	mˌəʃaːhˈʌdi
سادگي	saːdˈʌɡi
مٺاڻ	məʈʰˈaːɳ
اصحاب	ˌaʂhˈaːb
آنند	aːnˈʌnd
ڪائونسل	kˌaːoːnsˈʌl
امداد	ˌɪmdˈaːd
شاهد	ʃaːhˈʌd
حسين	həsˈiːn
اعزازي	eːzˈaːzi
شهيد	ʃəhˈiːd
شاهوڪار	ʃˌaːhoːkˈaːr
ڪچين	kəcˈiːn
ٿامس	tʰaːmˈʌs
ورھاڱي	ʋˌərhaːˈŋ̩i
امتيازي	ˌamt̪jˈaːzi
صفت	ʂɪfˈata
ھميشہ	hˌəmiʃˈʌh
برابري	bˌəraːbˈʌri
خانقاهه	xˌaːnqaːhˈʌh
سگھندو	səɡʰˈʌndoː
امرتسر	ˌamərˌət̪əsˈʌr
پرڀرو	pˌərəbʰˈʌroː
ساليانو	saːljˈaːnoː
انچن	ancˈʌn
سمورن	sˌəmoːrˈʌn
شھزادي	ʃˌəhzˈaːdi
عورتون	ˌaoːrt̪ˈoːn
سامهون	sˌaːmhˈoːn
محنت	mˌəhənˈʌt̪
صنعتي	ʂənˈaːt̪i
سرگرمي	sˌarɡˈarmi
چئني	cˈʌni
ٻڌو	bˈʌdʰoː
پڪ	pˈʌk
عينيه	ˌainˈiːh
ڪنديون	kəndjˈoːn
ويڙهه	ʋˌeːr.əhˈʌh
شجرو	ʃəɟˈʌroː
ڪعبي	kaːbˈiː
ايڪٽر	ˌeːkəʈˈʌr
آمدني	ˌaːmədˈʌni
گهرڻ	ɡˌəhərˈʌɳ
ميدان	meːdˈaːn
لکمير	lˌəkʰmˈiːr
مذهب	mˌəzəhˈʌb
اترپرديش	ˌat̪ərˌəprdˈiːʃ
مشتمل	mˌəʃt̪əmˈʌl
ٺڪر	ʈʰəkˈʌr
بدلائي	bˌədlˈaːi
مجدد	mˌəɟədˈʌd
جهازن	ɟˌəhaːzˈʌn
هئا	hˈʊaː
ڌٻڻ	dʰəbˈʌɳ
ٻانهين	bˌaːnhˈiːn
جاپان	ɟaːpˈaːn
ڦڪو	pʰˈʌkoː
تعلقو	t̪aːlˈʌqoː
مک	mˈʌkʰ
تنهنڪري	t̪ˌənəhˌənəkˈʌri
ٿلهو	ʈəlˈʌhoː
دماغ	dəmˈaːɣ
چري	cˈʌri
شھتيرن	ʃˌəht̪irˈʌn
گروھن	ɡˌəroːhˈʌn
پرهه	pˌərəhˈʌh
ميوزم	mjoːzˈʌm
چاڙهڻ	cˌaːr.əhˈʌɳ
اوچتي	uːcˈʌt̪i
حميده	hˌəmidˈʌh
جماعتون	ɟˌəmaːaːt̪ˈoːn
مبارڪ	məbˈaːrək
دان	dˈaːn
وفا	ʋˈʌfaː
طواف	tʋˈaːf
سامھون	sˌaːmhˈoːn
جمالي	ɟəmˈaːli
دراوڙن	dˌəraːoːr.ˈʌn
پانيلن	pˌaːnilˈʌn
وڃجي	ʋəɲˈʌɟi
جيروسلم	ɟˌeːroːsəlˈʌm
يني	jˈʌni
باس	bˈaːs
مين	mˈeːn
ٿل	ʈˈʌl
اذان	azˈaːn
لياري	ljˈaːri
کنڊر	kʰənɖˈʌr
هئاسين	hˌəaːsˈiːn
کائجن	kʰˌaːɪɟˈʌn
سگهيا	səɡˈʌhjaː
صلي	ʂˈʌli
عقلي	aqˈʌli
اسپتالن	ˌasəpt̪aːlˈʌn
سنڌي	sˈɪndhi
ڪپتان	kˌəpt̪ˈaːn
ڪيفيت	keːfˈiːt̪
اپيل	ˈapjal
سامان	saːmˈaːn
لکندا	ləkʰˈʌndaː
بنگالي	bənɡˈaːli
حقدار	hˌəqdˈaːr
اماڻيو	amˈaːɳjoː
بيٺي	bˈeːʈʰi
سالار	saːlˈaːr
الائي	alˈaːi
بقول	bəqˈoːl
گوهر	ɡoːhˈʌr
ھرھڪ	hˌərəhˈʌk
دستياب	dəst̪jˈaːb
ماپ	mˈaːp
ڇانو	cʰˈaːnoː
جنگن	ɟənɡˈʌn
پاڇو	pˈaːcʰoː
ڪارروايون	kˌaːrrʋaːjˈoːn
لڳائڻ	lˌəɡaːˈɪɳ
قصا	qˈʌʂaː
عبادت	abˈaːdət̪
اديبن	ˌadibˈʌn
ڇوڙ	cʰˈoːr.
سويڊن	sʋeːɖˈʌn
اکري	akʰˈʌri
ھاجرہ	hˌaːɟərˈʌh
پرين	pərˈiːn
درين	dərˈiːn
ڪاليجن	kˌaːliɟˈʌn
ا	ˈalɪf
ڳنڍيون	ɡˌənɖʰjˈoːn
راوي	rˈaːʋi
ماتحت	mˌaːt̪əhˈʌt̪
رنگا	rˈʌnɡaː
بلو	bˈʌloː
ڌيئرون	dʰeːˈɪroːn
ڌڪ	dʰˈʌk
کاتا	kʰˈaːt̪aː
بڻجي	bəɳˈʌɟi
رکندا	rəkʰˈʌndaː
احتجاجي	ˌɛht̪əɟˈaːɟi
دوري	dˈoːri
پيشو	pˈeːʃoː
سماجيات	sˌəmaːɟiˈaːt
بغداد	bˌəɣdˈaːd
ٻيلو	bˈeːloː
ڪوھ	kˈoːh
ينگ	jˈʌnɡ
الانا	alˈaːnaː
پهلوي	pəhˈʌlʋi
ويڳي	ʋˈeːɡi
جهنگلي	ɟˌəhənɡˈʌli
بھ	bˈʌh
ننجا	nənˈʌɟaː
نثار	nəsˈaːr
ايڌي	ˈeːdʰi
حافظ	haːfˈʌʐ
سختيون	səxt̪jˈoːn
سائو	sˈaːoː
پاهڙ	paːhˈʌr.
نمائندا	nˈʊmaːˈɪndaː
مخلوط	mˌəxlˈuːt
بطوطه	bˌətoːtˈʌh
ڀٽن	bʰəʈˈʌn
ڏوھ	ɖˈoːh
ضرورتن	zˌaruːrət̪ˈʌn
پنڊي	pˈʌnɖi
سافٽويئر	sˌaːfʈʋiˈɪr
الرحمان	ˌalərˌəhmˈaːn
تبتي	t̪əbˈʌt̪i
ملاڪا	məlˈaːkaː
نموني	nəmˈoːni
ٻڌجي	bədʰˈʌɟi
وڄ	ʋˈʌɟ
ڪڪڙن	kˌəkər.ˈʌn
هوء	hˈoː
بيدي	bˈeːdi
چاهين	caːhˈiːn
رليون	rəljˈoːn
اولين	uːlˈiːn
ڏنو	ɖˈɪnoː
لاڙي	lˈaːr.i
قاضي	qˈaːzi
ايل	ˈeːl
ساڳيا	sˈaːɡjaː
منجهانئن	mˌənəɟhaːnˈʌn
حاصل	haːʂˈʌl
رومانس	roːmˈaːns
گڏھ	ɡəɖˈʌh
ٻيڙيون	beːr.jˈoːn
بھی	bˈʌhi
ووٽن	ʋoːʈˈʌn
پڪيون	pəkjˈoːn
روش	rˈoːʃ
قطر	qətˈʌr
ڏسي	ɖˈɪsi
اجمل	ˌaɟəmˈʌl
ڪابينه	kaːbˈiːnəh
بنا	bˈʌnaː
مڙي	mˈʌr.i
گمنام	ɡˌəmnˈaːm
سنهي	sənˈʌhi
ڇاڙهه	cʰˌaːr.əhˈʌh
جشن	ɟəʃˈʌn
ڪوپرنيڪس	kˌoːpərnikˈʌs
درياھ	dərjˈaːh
ويسر	ʋeːsˈʌr
لاڏاڻي	laːɖˈaːɳi
عمر	ˈʊmr
وايومنڊل	ʋˌaːjoːmənɖˈʌl
روماني	roːmˈaːni
تاجر	t̪aːɟˈʌr
لڳل	ləɡˈʌl
هه	hˈʌh
وهنجڻ	ʋˌəhənəɟˈʌɳ
چانڊيو	cˈaːnɖjoː
ساڌو	sˈaːdʰoː
اٽلي	aʈˈʌli
ڳوڙهيون	ɡˌoːr.hjˈoːn
دفن	dəfˈʌn
تائين	t̪aːˈiːn
ٻڌي	bˈʌdʰi
زيتون	zeːt̪ˈoːn
گرمي	ɡərˈʌmi
زئي	zˈʌi
بصر	bəʂˈʌr
نفعي	nəfˈaːi
برلا	bərˈʌlaː
انومان	ˌanoːmˈaːn
سگهوئي	sˌəɡhˈoːi
سانگ	sˈaːnɡ
لاهوت	laːhˈoːt̪
بگڙي	bəɡˈʌr.i
قياس	qjˈaːs
ڪورٽن	kˌoːrəʈˈʌn
ڇاڙ	cʰˈaːr.
ڏياري	ɖjˈaːri
نظربند	naʐˈarbənd
ميوا	mjʋˈaː
گهيري	ɡəhˈiːri
مقبرو	mˌəqəbˈʌroː
راهه	raːhˈʌh
زياده	zjaːdˈʌh
حاڪميت	hˌaːkmˈiːt̪
ڊيگهه	ɖˌeːɡəhˈʌh
سکر	səkʰˈʌr
ڀرو	bʰˈʌroː
مسلمانن	mʊsˈalmˌaːnən
بوڪ	bˈoːk
آثار	aːsˈaːr
دٻائي	dəbˈaːi
چادر	caːdˈʌr
اڀرڻ	ˌabʰərˈʌɳ
عاليشان	ˌaːliʃˈaːn
شڪاگو	ʃəkˈaːɡoː
ٿيس	tʰˈeːs
هاء	hˈaː
آزار	aːzˈaːr
تنظيمي	t̪ˌənʐˈiːmi
ڪوانٽم	kʋˌaːnəʈˈʌm
ائين	aˈiːn
دھشتگردي	dˌəhəʃt̪əɡˈʌrdi
مراد	mərˈaːd
پچڻ	pəcˈʌɳ
بانس	bˈaːns
اصطلاحن	ˌɪʂtɪlaːhˈʌn
مشوري	məʃˈoːri
سر	sˈʌr
جنت	ɟənˈʌt̪
جمعي	ɟəmˈaːi
ريتن	reːt̪ˈʌn
تيرن	t̪eːrˈʌn
هلندو	həlˈʌndoː
گفتگو	ɡˌəfət̪ˈʌɡoː
پارڪ	paːrˈʌk
رانديگر	rˌaːndiɡˈʌr
محبتي	mˌəhəbˈʌt̪i
خطي	xˈʌti
حجاز	həɟˈaːz
ڳجهارت	ɡˌəɟhaːrˈʌt̪
ڄڻن	ɟəɳˈʌn
پيدائشي	pˌeːdaːˈɪʃi
پئرس	pərˈʌs
راهي	rˈaːhi
ڳالهائيندڙ	ɡˌaːlhˌaːindˈʌr.
ايف	ˈeːf
مچائي	məcˈaːi
عمارتون	ˌamaːrt̪ˈoːn
مداخلت	mˌədaːxəlˈʌt̪
يونس	jˈoːns
ٻٽير	bəʈˈiːr
شاگردن	ʃˌaːɡərdˈʌn
ٺاڪر	ʈʰaːkˈʌr
رڳن	rəɡˈʌn
نشونما	nˌəʃoːnˈʌmaː
سڌار	sədʰˈaːr
پرن	pərˈʌn
ھر	hˈʌr
ڪتبا	kˌət̪bˈaː
لڳن	ləɡˈʌn
بندرگاهه	bˌəndərɡaːhˈʌh
ڪيم	kˈeːm
تعصب	t̪aːʂˈʌb
وجهجي	ʋˌəɟəhˈʌɟi
تختو	t̪ˈʌxt̪oː
آبادي	aːbˈaːdi
ڏيهي	ɖˈeːhi
يارڪ	jaːrˈʌk
فائرنگ	fˌaːɪrˈʌnɡ
مدار	mədˈaːr
جنھنڪري	ɟˌənhnəkˈʌri
قبضو	qəbˈʌzoː
پريشان	pˌəriʃˈaːn
آباد	aːbˈaːd
فورسز	fˌoːrəsˈʌz
سينٽي	seːnˈʌʈi
برک	bərˈʌkʰ
پڳ	pˈʌɡ
چرٻي	cərˈʌbi
برنس	bərˈʌns
شهرن	ʃˌəhərˈʌn
مستحڪم	mˌəst̪əhəkˈʌm
ڪيترو	keːt̪ˈʌroː
وچم	ʋəcˈʌm
پکيڙ	pəkʰˈiːr.
جوت	ɟˈoːt̪
هنڌ	hˈʌndʰ
دريافت	dˌərjaːfˈʌt̪
سمجهه	sˌəməɟəhˈʌh
بدلي	bədˈʌli
امان	amˈaːn
غلطين	ɣˌəltˈiːn
لڌل	lədʰˈʌl
مشھور	mˌəʃhˈuːr
ٽو	ʈˈoː
پشت	pˈʌʃt̪
ڪمري	kəmˈʌri
ھڏين	həɖˈiːn
قنبر	qənbˈʌr
علمن	ˌaləmˈʌn
شاگردياڻي	ʃˌaːɡrdjˈaːɳi
ڪئلينڊر	kˌəlinɖˈʌr
گھميل	ɡʰˈʌmjal
نقص	nəqˈʌʂ
گئسن	ɡəsˈʌn
اوارڊ	ˌuːaːrˈʌɖ
ڪائنات	kˌaːɪnˈaːt
ماهوار	maːhʋˈaːr
کائيندا	kʰaːˈiːndaː
جيل	ɟˈeːl
ٽنڊو	ʈˈʌnɖoː
جواني	ɟˈaʋaːnˌiː
لهرون	lˌəhərˈuːn
استحصال	ˌɪstɛhʂˈaːl
ذرڙن	zˌərər.ˈʌn
پد	pˈʌd
سڊني	səɖˈʌni
اطالوي	atˈaːlʋi
گناهه	ɡˌənaːhˈʌh
گلي	ɡˈʌli
لحاظ	ləhˈaːʐ
واکاڻ	ʋaːkʰˈaːɳ
ابتدا	ɪbtˈɪdaː
شھر	ʃəhˈʌr
بيڪس	bˈeːkəs
ٻج	bˈʌɟ
دوستن	doːst̪ˈʌn
سلون	səlˈoːn
بيٺڪي	bˈeːʈʰkˌiː
وقف	ʋəqˈʌf
جيئن	ɟˈiːʌ̃
ڳالهه	ɡˌaːləhˈʌh
کونگهرن	kʰˌoːnɡəhərˈʌn
چئبو	cəbˈoː
اندر	andˈʌr
ساوڪ	saːˈoːk
افضل	ˌafəzˈʌl
عمري	ˈʊmri
تير	t̪ˈeːr
مختيارڪار	mˌəxt̪jaːrkˈaːr
چئي	cˈʌi
ويجها	ʋeːɟˈʌhaː
مسلم	mˈʊslˌɪm
ڪوئلي	koːˈɪli
عملدار	ˌaməldˈaːr
ماھر	maːhˈʌr
گوڏن	ɡoːɖˈʌn
پڙهي	pər.ˈʌhi
چاچڙ	caːcˈʌr.
ڀڪشو	bʰəkˈʌʃoː
هشام	həʃˈaːm
تنوير	t̪ənʋˈiːr
سرائڪي	sˌəraːˈɪki
ديھون	deːhˈoːn
ٿئي	tʰˈɪeː
منصوبا	mˌənʂuːbˈaː
جادوگر	ɟˌaːdoːɡˈʌr
نسخا	nəsˈʌxaː
منجهس	mˌənəɟəhˈʌs
الوداع	alˈoːdaː
بهاولپور	bˌəhaːˌoːlpˈoːr
سينگاريو	seːnɡˈaːrjoː
جنيد	ɟənˈiːd
چاڳلي	caːɡˈʌli
دمشق	dˌəməʃˈʌq
مونث	moːnˈʌs
گھٽجي	ɡʰəʈˈʌɟi
ت	tˈeː
ر	rˈeː
جوڻو	ɟˈoːɳoː
لکتون	lˌəkʰt̪ˈuːn
ڪيمبرج	kˌeːmbərˈʌɟ
هيٺ	hˈeːʈʰ
هيٺئين	hˌeːʈʰˈiːn
اولڊ	uːlˈʌɖ
حدن	hədˈʌn
مٺائي	məʈʰˈaːi
کارائيندا	kʰˌaːraːˈiːndaː
سڏبي	sˌəɖbˈiː
ڀڳوت	bʰəɡˈoːt̪
تيرھين	t̪ˌeːrhˈiːn
لتاڙي	lət̪ˈaːr.i
ٻيڻي	bˈeːɳi
انناس	ˌannˈaːs
ڏانڊي	ɖˈaːnɖi
ٺاھيا	ʈʰˈaːhjaː
تصنيف	t̪ˌəʂnˈiːf
روڳ	rˈoːɡ
ڪيميائي	keːmjˈaːi
ڪنڊن	kənɖˈʌn
پيس	pˈeːs
ستار	sɪtˈaːr
ڳايو	ɡˈaːjoː
عدل	adˈʌl
جوڻيجي	ɟoːɳˈiːɟi
نقطا	nəqˈʌtaː
شفقت	ʃˌəfəqˈʌt̪
رچرڊ	rˌəcərˈʌɖ
مڪران	mˌəkrˈaːn
ملاکڙو	mˌəlaːkʰˈʌr.oː
رکما	rəkʰˈʌmaː
وٺڻ	ʋəʈʰˈʌɳ
مهتا	məhˈʌt̪aː
ڍورن	ɖʰoːrˈʌn
محترم	mˌəhət̪ərˈʌm
ڪڍن	kəɖʰˈʌn
يو	jˈoː
کائبو	kʰˌaːɪbˈoː
سولو	sˈoːloː
جز	ɟˈʌz
ڀيم	bʰˈeːm
ڪهاڻيڪار	kˌəhaːɳikˈaːr
حقن	həqˈʌn
نشانن	nɪʃˈaːnn
طئي	tˈʌi
نازي	nˈaːzi
سرحدن	sˌərəhədˈʌn
دلي	dˈʌli
ليزر	leːzˈʌr
فحش	fəhˈʌʃ
افسانوي	ˌafsˈaːnʋi
ٽارين	ʈaːrˈiːn
نفسياتي	nˌəfsjˈaːt̪i
مشاهدا	mˌəʃaːhˈʌdaː
مخلص	mˌəxəlˈʌʂ
ڪمائي	kəmˈaːi
پرائمري	pˌəraːɪmˈʌri
لڳيون	ləɡjˈoːn
تذڪرن	t̪ˌəzəkərˈʌn
اسٽالن	ˌasʈaːlˈʌn
ڏنگ	ɖˈʌnɡ
نديون	nədjˈoːn
پڪڙي	pəkˈʌr.i
گھرڙي	ɡʰərˈʌr.i
عڪس	akˈʌs
زماني	zəmˈaːni
ھڻي	hˈʌɳi
چوڏھن	cˌoːɖəhˈʌn
ڇاپا	cʰˈaːpaː
اموي	ˈamʋi
جهڙوڪ	ɟˌəhər.ˈuːk
نئي	nˈʌi
فائدي	faːˈɪdi
امرڪوٽ	ˌamərkˈoːʈ
ڪابہ	kaːbˈɪh
مرڪب	mˌərəkˈʌb
شان	ʃˈaːn
اھڙي	ahˈʌr.i
ڪهڙي	kəhˈʌr.i
ھلائي	həlˈaːi
مٺا	mˈʌʈʰaː
ڦول	pʰˈoːl
وڄائيندا	ʋˌəɟaːˈiːndaː
ڪاميابيون	kˌaːmjaːbjˈoːn
چيئرمين	ceːˈɪrmˌiːn
ورنيڪيولر	ʋˌərnˌiːkjoːlˈʌr
اصغر	ˌaʂəɣˈʌr
مصر	məʂˈʌr
خود	xˈʊd
ڀائٽي	bʰˈaːʈi
ڇڙوڇڙ	cʰˌər.oːcʰˈʌr.
نعت	nˈaːt̪
سڏبا	sˌəɖbˈaː
ستاري	sɪtˈaːri
ھ	dˌɔcaʃmˈiːheː
جوهري	ɟoːhˈʌri
سمن	səmˈʌn
پروٽو	pərˈoːʈoː
اظھار	ˌaʐhˈaːr
ڀڄي	bʰˈʌɟi
اچار	acˈaːr
وٺي	ʋˈʌʈʰi
بندن	bəndˈʌn
پشتو	pˈʌʃt̪oː
ڏيهه	ɖeːhˈʌh
رکندڙن	rˌəkʰəndər.ˈʌn
ڪيائين	kjaːˈiːn
شيشي	ʃˈeːʃi
وشنداس	ʋˌəʃndˈaːs
اتان	at̪ˈaːn
گدري	ɡədˈʌri
ٿڪ	ʈˈʌk
تحريڪون	t̪ˌəhrikˈoːn
لوھھ	loːhˈʌh
تاريخدان	t̪ˌaːrixdˈaːn
مقصد	mˌəqəʂˈʌd
پبلشنگ	pˌəbələʃˈʌnɡ
نارا	nˈaːraː
ڇڪي	cʰˈʌki
خاڪا	xˈaːkaː
ليک	lˈeːkʰ
داڻن	daːɳˈʌn
ماء	mˈaː
سمايل	səmˈaːjal
ذخيرن	zˌəxirˈʌn
لسانيات	lˌəsaːniˈaːt
ڪجهه	kˈʊɟʰʊ
برتري	bˌərət̪ˈʌri
گهٽتائي	ɡˌəhəʈt̪ˈaːi
نڪرندو	nˈɪkrndoː
حتمي	hət̪ˈʌmi
ساندهه	sˌaːndəhˈʌh
گپت	ɡəpˈʌt̪
هلن	həlˈʌn
مڌيه	mədʰˈiːh
صحافي	ʂəhˈaːfi
زهريلي	zˌəhərˈiːli
هالي	hˈaːli
ايشياٽڪ	ˌeːʃjaːʈˈʌk
ڳالهايو	ɡˌaːlhˈaːjoː
چن	cˈʌn
ڀرپور	bʰˌərpˈuːr
سمجھندا	sˌəməɟəhˈʌndaː
گرام	ɡərˈaːm
زندگي	zˈɪndɡi
ٻيھر	beːhˈʌr
کاتن	kʰaːt̪ˈʌn
آرگنائيزيشن	ˌaːrəɡnaːˌiːziʃˈʌn
لکين	ləkʰˈiːn
پهچائڻ	pˌəhəcaːˈɪɳ
صفوي	ʂˈʌfʋi
تھن	t̪əhˈʌn
متعدد	mˌət̪aːdˈʌd
نصيرآباد	nˌəʂiraːbˈaːd
حيوانن	hjʋaːnˈʌn
راه	rˈaːh
افغاني	ˌafɣˈaːni
گم	ɡˈʌm
ڪيپيٽل	kˌeːpiʈˈʌl
مائڪرو	mˌaːɪkˈʌroː
ادبي	ˌadbˈiː
ڊويزنل	ɖʋˌeːzənˈʌl
اهڙن	ˌahər.ˈʌn
نامياري	naːmjˈaːri
طبيب	təbˈiːb
منگول	mənɡˈuːl
آرٽيڪل	ˌaːrʈikˈʌl
خطاب	xətˈaːb
سومرا	soːmˈʌraː
مهين	məhˈiːn
ڪانه	kaːnˈʌh
فٽن	fəʈˈʌn
تختن	t̪əxt̪ˈʌn
گهاٽو	ɡəhˈaːʈoː
تحقيقات	t̪ˌəhqˌiːqˈaːt
هوشيار	hoːʃjˈaːr
ماڇين	maːcʰˈiːn
صورتخطي	ʂˌoːrət̪əxˈʌti
حسابي	hˌəsaːbˈiː
پوء	pˈoː
عبيدالله	abˈiːdaːlˌələh
تعليمي	t̪aːlˈiːmi
مڱڻهار	mˌəŋ̩ˌəɳhˈaːr
طريقن	tˌəriqˈʌn
گلشن	ɡˌələʃˈʌn
کاڻين	kʰaːɳˈiːn
ڳڙهي	ɡər.ˈʌhi
مساوات	mˌəsaːoːˈaːt
وجهي	ʋəɟˈʌhi
خانصاحب	xˌaːnʂaːhˈʌb
ڳچ	ɡˈʌc
دي	dˈeː
ٽڪرو	ʈəkˈʌroː
تيز	t̪ˈeːz
راجپوتانا	rˌaːɟpoːt̪ˈaːnaː
رنگين	rənɡˈiːn
ڌمڪي	dʰəmˈʌki
معروف	maːrˈoːf
گورنر	ɡˌoːrənˈʌr
اداره	ˌadaːrˈʌh
اڻويهين	ˌaɳʋihˈiːn
پنھنجا	pənhnˈʌɟaː
سارس	saːrˈʌs
کائيندو	kʰaːˈiːndoː
منظوري	mˌanʐˈuːri
آمريڪن	ˌaːmrikˈʌn
پوکيل	pˈoːkʰjal
سادي	sˈaːdi
ندين	nədˈiːn
قيمتن	qˌeːmət̪ˈʌn
هڪدم	hˌəkədˈʌm
قاعدي	qˈaːjdi
جزا	ɟˈʌzaː
چوٽيون	coːʈjˈoːn
پروٽين	pˌəroːʈˈiːn
ويلٿ	ʋeːlˈʌʈ
ٽوڙي	ʈˈoːr.i
تقي	t̪ˈʌqi
موج	mˈoːɟ
وريل	ʋˈʌrjal
ازبڪستان	ˌazəbˌəkˈɪstaːn
جمن	ɟəmˈʌn
ستين	sət̪ˈiːn
ديو	djˈoː
موقعن	moːqˈaːn
سائل	saːˈɪl
باليووڊ	bˈaːljʋoːɖ
اهائي	ahˈaːi
ٿانو	tʰˈaːnoː
قاهره	qˌaːhərˈʌh
آگسٽ	ˌaːɡəsˈʌʈ
هيگ	hˈeːɡ
قانع	qˈaːneː
ڀريل	bʰˈʌrjal
کہ	kʰˈʌh
شھريت	ʃˌəhrˈiːt̪
ونگن	ʋənɡˈʌn
پا	pˈaː
شاعر	ʃaːˈaːɪr
چيني	cˈeːni
پريان	pərjˈaːn
پچ	pˈʌc
شھابي	ʃˌəhaːbˈiː
چشمي	cəʃˈʌmi
آفريقا	ˌaːfrˈiːqaː
جولائي	ɟoːlˈaːi
سنڌيانا	sɪndhjˈaːnaː
سيڪڙي	seːkˈʌr.i
ڪئي	kˈʌi
اجمير	ˌaɟmˈiːr
وٺنديون	ʋˌəʈʰndjˈoːn
سٺا	sˈʌʈʰaː
ايندو	ˈeːndoː
گنجائش	ɡˌənɟaːˈɪʃ
تعلق	t̪aːlˈʌq
گھربل	ɡʰˌərəbˈʌl
ڪيتري	keːt̪ˈʌri
ويون	ʋjˈoːn
نسخي	nəsˈʌxi
امتحان	ˌɪmtɪhˈaːn
هندن	hɪndˈʌn
ڊالرن	ɖˌaːlərˈʌn
ڪورائي	koːrˈaːi
ساري	sˈaːri
بهاول	bˌəhaːˈoːl
معاهدن	mˌaːhədˈʌn
پٺيان	pəʈʰjˈaːn
زرخيز	zˌərxˈiːz
معزز	maːzˈʌz
ڪندو	kˈʌndoː
موڪليندا	mˌoːklˈiːndaː
لپري	ləpˈʌri
ٺاٺ	ʈʰˈaːʈʰ
ٻيلا	bˈeːlaː
ڪا	kˈaː
تپي	t̪ˈʌpi
لڳندو	ləɡˈʌndoː
پيڊيا	pˈeːɖjaː
انڊو	ˈɪnɖoː
متناسب	mˌət̪naːsˈʌb
سيارا	sjˈaːraː
ست	sˈʌt̪
مؤرخن	mˌəa͡ʊrəxˈʌn
شرڪت	ʃˌərəkˈʌt̪
پاڙون	paːr.ˈoːn
نيلام	neːlˈaːm
ٻوڏن	boːɖˈʌn
ذري	zˈʌri
نورالدين	nˌoːraːldˈiːn
هنيا	hˈʌnjaː
احڪام	ɛhkˈaːm
انسانيت	ɪnsˈaːnit̪
تيسين	t̪eːsˈiːn
خال	xˈaːl
عبدالغفار	ˌabdˌaːləɣfˈaːr
ڪرامت	kˌəraːmˈʌt̪
ڦار	pʰˈaːr
ڪاريگرن	kˌaːriɡərˈʌn
پٺتي	pəʈʰˈʌt̪i
ارب	arˈʌb
ڏهاڙي	ɖəhˈaːr.i
ڏهر	ɖəhˈʌr
تيلي	t̪ˈeːli
فائديمند	fˌaːɪdimˈʌnd
اٽڪل	ˌaʈəkˈʌl
مشرف	mˌəʃərˈʌf
ڊگھو	ɖˈʌɡʰoː
ضد	zˈʌd
مريخ	mərˈiːx
رسالت	rˌəsaːlˈʌt̪
نمائش	nˈʊmaːˈɪʃ
دنیا	dˈʌnjaː
پسمنظر	pˌəsmˌanʐˈar
نبين	nəbˈiːn
هٽي	hˈʌʈi
ورڪنگ	ʋˌərəkˈʌnɡ
تاریخ	t̪aːrˈiːx
سوليماني	sˌoːlimˈaːni
ڪينسر	keːnsˈʌr
گهڻي	ɡəhˈʌɳi
ڪامياب	kaːmjˈaːb
ڪڪر	kəkˈʌr
عيش	aˈiːʃ
انيس	anˈiːs
نه	nˈʌh
ڀٽو	bʰˈʌʈoː
نشاني	nɪʃˈaːni
مجاهد	mˌəɟaːhˈʌd
طبقن	tˌəbəqˈʌn
اللو	alˈʌloː
اچڻ	acˈaɳʊ
حڪم	həkˈʌm
هسٽري	hˌəsəʈˈʌri
پهچائيندو	pˌəhəcaːˈiːndoː
جئان	ɟəˈaːn
واحد	ʋaːhˈʌd
شادي	ʃˈaːdi
هيٺيان	heːʈʰjˈaːn
ترجما	t̪ˌərəɟˈʌmaː
ملهائڻ	mˌəlhaːˈɪɳ
ڪيائون	kjaːˈoːn
مهاڳ	məhˈaːɡ
هاڪ	hˈaːk
جتي	ɟˈʌt̪i
سرهاڻ	sˌərhˈaːɳ
ابوالفضل	abʋˈaːləfˌəzəl
ريجن	reːɟˈʌn
ڪيترائي	kˌeːt̪rˈaːi
کلن	kʰəlˈʌn
مخفف	mʊxˈaffaf
ڪرڻن	kˌərəɳˈʌn
ستارو	sɪtˈaːroː
بنگلي	bənɡˈʌli
ترڪستان	t̪ˌərəkˈɪstaːn
خنجر	xˌənəɟˈʌr
فتوا	fˈʌt̪ʋaː
علاقائي	ˌalaːqˈaːi
تفريحي	t̪ˌəfrˈiːhi
مزي	mˈʌzi
وھي	ʋˈʌhi
غلام	ɣəlˈaːm
فلاڻي	fəlˈaːɳi
الهداد	ˌaləhədˈaːd
رسائي	rəsˈaːi
خور	xˈoːr
ٽڙي	ʈˈʌr.i
گوتم	ɡoːt̪ˈʌm
بليدي	bəlˈiːdi
هادي	hˈaːdi
مٽياري	məʈjˈaːri
نشانيون	nɪʃˈaːnjoːn
پاليو	pˈaːljoː
درجابندي	dˈarɟaːbndi
واسين	ʋaːsˈiːn
ننڍڙن	nˌənəɖʰər.ˈʌn
پرمار	pˌərmˈaːr
صليبي	ʂˌəlibˈiː
تاڪيد	t̪aːkˈiːd
شهيدن	ʃˌəhidˈʌn
جزوي	ɟˈʌzʋi
ڪثير	kəsˈiːr
رجعت	rəɟˈaːt̪
رواج	rʋˈaːɟ
حياتي	hjˈaːt̪i
انگريزن	ˌanɡərizˈʌn
انگلنڊ	ˌanɡəlˈʌnɖ
ڦرندو	pʰərˈʌndoː
سرانجام	sˌəraːnɟˈaːm
ليڊرن	lˌeːɖərˈʌn
امام	amˈaːm
جملو	ɟˈʊmloː
اڪرام	ˌakrˈaːm
ڇھن	cʰəhˈʌn
چاڙهي	caːr.ˈʌhi
معذور	maːzˈoːr
آکاڻي	aːkʰˈaːɳi
کڻي	kʰˈʌɳi
آروهي	aːrˈoːhi
بنيادن	bˌənjaːdˈʌn
سال	sˈaːl
ڪاهه	kaːhˈʌh
اعتدال	ˌeːtɪdˈaːl
سوئيڊن	sˌoːiɖˈʌn
ڊگهو	ɖəɡˈʌhoː
حيدرآباد	hˌeːdraːbˈaːd
ورج	ʋərˈʌɟ
ڏاڏي	ɖˈaːɖi
مڃي	mˈʌɲi
ڄڻڪ	ɟəɳˈʌk
آئوٽ	aːˈoːʈ
ايٽمن	ˌeːʈəmˈʌn
لاش	lˈaːʃ
ترسي	t̪ərˈʌsi
بحر	bəhˈʌr
عروج	arˈoːɟ
ڊينمارڪ	ɖˌeːnmaːrˈʌk
ڳانڍاپو	ɡˌaːnɖʰˈaːpoː
سائنس	saːˈɪns
ملڪ	mˈʊlk
رهندا	rəhˈʌndaː
آمد	aːmˈʌd
ڪونه	koːnˈʌh
سنجر	sˌənəɟˈʌr
دائم	daːˈɪm
اسپنوزا	ˌasəpnˈoːzaː
شرح	ʃˌərˈah
استنبول	ˌɪstɪnbˈoːl
ڪيمپ	kˈeːmp
قطع	qˈʌtaː
ڪافين	kaːfˈiːn
سينيما	seːnˈiːmaː
قلمن	qˌələmˈʌn
ايرانين	ˌeːraːnˈiːn
مدرسي	mˌədərˈʌsi
سراسر	sˌəraːsˈʌr
معصوم	maːʂˈoːm
مسند	məsˈʌnd
چوري	cˈoːri
سک	sˈʌkʰ
آڻين	aːɳˈiːn
ڪمائتو	kˌəmaːˈɪt̪oː
چانورن	cˌaːnoːrˈʌn
منسوب	mənsˈuːb
اٿينس	atʰˈiːns
ايگزيڪيوٽو	ˌeːɡzikjˈoːʈoː
سنگين	sənɡˈiːn
رايو	rˈaːjoː
لاٿو	lˈaːtʰoː
صبح	ʂˌəbˈah
ايڪسپو	ˌeːkəsˈʌpoː
ڪويتا	kʋˈeːt̪aː
اهو	ˈɪhoː
ٽماهي	ʈəmˈaːhi
زلزلي	zˌalzˈali
بمبئي	bəmbˈʌi
تعليمات	t̪ˌaːlimˈaːt
ڳڻپيوڪر	ɡˌəɳpjoːkˈʌr
مغل	məɣˈʌl
حب	hˈʌb
عامل	aːmˈʌl
پوکبا	pˌoːkʰbˈaː
اثرائتو	ˌasraːˈɪt̪oː
وزير	ʋəzˈiːr
ٺيڪ	ʈʰˈeːk
سنهيون	sˌənhjˈoːn
تمام	t̪əmˈaːm
خاندانن	xˌaːndaːnˈʌn
ٻاهر	baːhˈʌr
الڪرام	ˌaləkrˈaːm
ڪيو	kˈajoː
صہ	ʂˈʌh
جهوڪ	ɟəhˈoːk
ارادي	arˈaːdi
آرين	aːrˈiːn
پنچم	pəncˈʌm
دس	dˈʌs
يونٽن	jˌoːnəʈˈʌn
نڪو	nˈʌkoː
دشمنن	dˌəʃəmənˈʌn
بزم	bəzˈʌm
حيوانات	hjʋˌaːnˈaːt
پارليامينٽري	pˌaːrljˌaːminəʈˈʌri
ڊپ	ɖˈʌp
واپسي	ʋaːpˈʌsi
ھٿيارن	hˌətʰjaːrˈʌn
نظاماڻي	nɪʐˈaːmaːɳˌiː
مجاور	mˌəɟaːˈoːr
معبود	maːbˈoːd
اسڪاٽلينڊ	ˌaskˌaːʈlˈiːnɖ
داؤد	daːˈa͡ʊd
پارسين	pˌaːrsˈiːn
تبليغ	t̪ˌəblˈiːɣ
بيٺڪ	bˈeːʈʰək
سرون	sərˈoːn
لڳ	lˈʌɡ
فاتح	fˌaːt̪ˈah
فضيلت	fˌəzilˈʌt̪
امت	amˈʌt̪
چوٽين	coːʈˈiːn
رڌي	rˈʌdʰi
لالا	lˈaːlaː
فصاحت	fˌəʂaːhˈʌt̪
ڇڄي	cʰˈʌɟi
چانڊيي	cˈaːnɖji
ڍورو	ɖʰˈoːroː
ابوبڪر	abˈoːbəkˌər
گذريل	ɡəzˈʌrjal
آڻيندي	aːɳˈiːndi
ٽيليڪاسٽ	ʈˌeːlikaːsˈʌʈ
شڪر	ʃəkˈʌr
کليو	kʰˈʌljoː
ڇوڪرن	cʰˌoːkərˈʌn
لوئر	loːˈɪr
ٽائمز	ʈˌaːɪmˈʌz
طلاق	təlˈaːq
اٺون	aʈʰˈoːn
مصالحي	mˌəʂaːlˈʌhi
پسي	pˈʌsi
نڪرندڙ	nɪkrndˈʌr.
آتما	aːt̪ˈʌmaː
ڦڦڙن	pʰˌəpʰər.ˈʌn
سيٽلائيٽ	sˌeːʈlaːˈiːʈ
ورزش	ʋˌərəzˈʌʃ
فورٽ	foːrˈʌʈ
ھنر	hənˈʌr
زينب	zˈeːnb
پاڙو	pˈaːr.oː
غيب	ɣˈeːb
رپورٽر	rˌəpoːrəʈˈʌr
وقار	ʋəqˈaːr
چشما	cəʃˈʌmaː
نارين	naːrˈiːn
پرده	pərdˈʌh
ڳرو	ɡˈʌroː
حادثو	haːdˈʌsoː
حدون	hədˈoːn
داڻي	dˈaːɳi
روڪڻ	roːkˈʌɳ
ڀڄائي	bʰəɟˈaːi
ڪشادي	kəʃˈaːdi
مصرع	məʂˈʌraː
مل	mˈʌl
نک	nˈʌkʰ
مديني	mədˈiːni
عظمت	ˌaʐəmˈʌt̪
مظفر	mˌəʐəfˈʌr
ڪرسي	kərˈʌsi
ذخيرا	zəxˈiːraː
شيوا	ʃjʋˈaː
حوصلي	hoːʂˈʌli
هضم	həzˈʌm
وسارڻ	ʋˌəsaːrˈʌɳ
تبسم	t̪ˌəbəsˈʌm
ڪلچرل	kˌələcərˈʌl
مسئلو	məsˈʌloː
ملنديون	mˌəlndjˈoːn
کوٽائي	kʰoːʈˈaːi
بورڊ	bˈoːrəɖ
پاسا	pˈaːsaː
رچنا	rəcˈʌnaː
ارغون	ˌarɣˈoːn
ڪنڊي	kˈʌnɖi
سعيد	saːˈiːd
دستاويز	dˌəst̪aːʋˈiːz
ٻوٽي	bˈoːʈi
آھي	ˌaːheː
پٽي	pˈʌʈi
سور	sˈoːr
ويهاريو	ʋeːhˈaːrjoː
وياڪرڻ	ʋjˌaːkərˈʌɳ
حيدر	heːdˈʌr
چانڊڪا	caːnɖˈʌkaː
ممڪن	mˌəməkˈʌn
چير	cˈeːr
مليل	mɪlˈɪal
ڪتبخاني	kˌət̪əbxˈaːni
فٽبال	fˌəʈbˈaːl
بيڪن	bˈeːkən
سنئين	sˌənˈiːn
اميرن	ˌamirˈʌn
منع	mˈʌnaː
بدعت	bədˈaːt̪
پهريدار	pˌəhəridˈaːr
پڙهايو	pˌər.hˈaːjoː
منڍ	mənˈʌɖʰ
بنارس	bˌənaːrˈʌs
ٽنگيل	ʈˈʌnɡjal
ڊگھي	ɖˈʌɡʰi
پختي	pˈʌxt̪i
پاڇي	pˈaːcʰi
جيترو	ɟeːt̪ˈʌroː
ٺهي	ʈʰˈʌhi
نوشهري	nˌoːʃəhˈʌri
چارٽر	cˌaːrəʈˈʌr
بٽالين	bˌəʈaːlˈiːn
حفظ	həfˈʌʐ
نافرماني	nˌaːfərmˈaːni
قبيلو	qəbˈiːloː
ايجنسي	eːɟˈʌnsi
پريزيڊنٽ	pˌərizˌiːɖənˈʌʈ
ماڻي	mˈaːɳi
کنگھ	kʰˈʌnɡʰ
ستر	sət̪ˈʌr
حرف	hərˈʌf
هاڪڙو	haːkˈʌr.oː
باب	bˈaːb
گهري	ɡəhˈʌri
آواز	aːʋˈaːz
شاعراڻي	ʃaːˈaːɪrˌaːɳi
ذائقي	zaːˈɪqi
سخاوت	sˌəxaːˈoːt̪
ھيٺان	heːʈʰˈaːn
جوڙي	ɟˈoːr.i
ڪوئي	kˈoːi
ڪٿي	kˈʌtʰi
دائرو	daːˈɪroː
موتين	moːt̪ˈiːn
گھڻ	ɡʰˈʌɳ
فلڪيات	fˌəlkiˈaːt
ڪامورن	kˌaːmoːrˈʌn
گهمڻ	ɡˌəhəmˈʌɳ
تجربي	t̪ˌəɟərbˈiː
تحريرون	t̪ˌəhrirˈoːn
ايڊورڊ	ˌeːɖoːrˈʌɖ
گنجي	ɡənˈʌɟi
چيئرپرسن	ceːˈɪrəpˌərəsˌən
ٽه	ʈˈʌh
صدمو	ʂədˈʌmoː
چئن	cˈʌn
ڪينجھر	kˌeːnəɟəhˈʌr
مجبور	mˌəɟbˈuːr
ٻڌائڻ	bˌədʰaːˈɪɳ
ڏيکارڻ	ɖˌeːkʰaːrˈʌɳ
ٻاهرين	bˌaːhərˈiːn
روزو	rˈoːzoː
گذاريندو	ɡˌəzaːrˈiːndoː
ڪئمپ	kˈʌmp
جلاب	ɟəlˈaːb
سپهه	sˌəpəhˈʌh
ڀڃڪڙي	bʰˌəɲəkˈʌr.i
گهٽي	ɡəhˈʌʈi
تہ	t̪ˈʌh
تيستائين	t̪ˌeːst̪aːˈiːn
گريٽر	ɡˌəriʈˈʌr
پنهجي	pˌənəhˈʌɟi
تحصيل	t̪əhˈʌʂjal
کائيندي	kʰaːˈiːndi
دامن	daːmˈʌn
فرم	fərˈʌm
باغ	bˈaːɣ
اضافو	ɪzˈaːfoː
مکيہ	məkʰˈiːh
کنئي	kʰənˈʌi
تيئن	t̪eːˈɪn
روڪيو	rˈoːkjoː
ليٿو	lˈeːtʰoː
جت	ɟˈʌt̪
تمثيلي	t̪ˌəmsˈiːli
جوڙن	ɟoːr.ˈʌn
جمعو	ɟəmˈaːoː
جهولي	ɟəhˈoːli
ٽاڪرو	ʈaːkˈʌroː
زمري	zəmˈʌri
لکنؤ	lˌəkʰənˈʌa͡ʊ
زمينداري	zˌəmindˈaːri
فتحن	fˌət̪əhˈʌn
ڀلو	bʰˈʌloː
لائق	laːˈɪq
لائي	lˈaːi
جانشين	ɟˌaːnʃˈiːn
اونهائي	ˌuːnhˈaːi
ڪميٽي	kəmˈiːʈi
رڪ	rˈʌk
سم	sˈʌm
ليگ	lˈeːɡ
منهنجو	mˌənəhənˈʌɟoː
امجد	ˌaməɟˈʌd
ذي	zˈeː
برقعي	bˌərqˈaːi
حضور	həzˈoːr
ھائر	haːˈɪr
فاصلو	faːʂˈʌloː
مجددي	mˌəɟədˈʌdi
سيڪس	seːkˈʌs
صحتمند	ʂˌəhət̪əmˈʌnd
تنهنجو	t̪ˌənəhənˈʌɟoː
پستڪ	pəst̪ˈʌk
ڊجيٽل	ɖˌəɟiʈˈʌl
وچئين	ʋˌəcˈiːn
ٺاھ	ʈʰˈaːh
خانان	xaːnˈaːn
فوجن	foːɟˈʌn
رهنديون	rˌəhəndjˈoːn
قبيلا	qəbˈiːlaː
نشو	nˈʌʃoː
منتظم	mˌənət̪əʐˈʌm
ويندڙ	ʋeːndˈʌr.
کنگهه	kʰˌənɡəhˈʌh
صاحب	ʂaːhˈʌb
امپيريل	ampˈiːrjal
سڏيندو	səɖˈiːndoː
بنياد	bənjˈaːd
قادري	qaːdˈʌri
عقيل	ˈaqjal
ويڪرو	ʋeːkˈʌroː
ڪرائڻ	kˌəraːˈɪɳ
جا	ɟˈaː
وڪٽوريا	ʋˌəkʈˈoːrjaː
برانچ	bərˈaːnc
سياسي	sjˈaːsi
رتبي	rˌət̪bˈiː
اخبارون	ˌaxbˈaːroːn
رٽائرمينٽ	rˌəʈaːˌɪrminˈʌʈ
ويٽو	ʋˈeːʈoː
مريدن	mˌəridˈʌn
مارڻ	maːrˈʌɳ
سڪ	sˈʌk
ساهڙ	saːhˈʌr.
رو	rˈoː
ھلي	hˈʌli
کائينديون	kʰˌaːindjˈoːn
انگريز	ˌanɡərˈiːz
چند	cˈʌnd
تڏھن	t̪ˌəɖəhˈʌn
ڪريان	kərjˈaːn
گڏجاڻي	ɡˌəɖɟˈaːɳi
محققن	mʊhˈaqɪqn
ڳالھيون	ɡˌaːlhjˈoːn
ھار	hˈaːr
فاضل	faːzˈʌl
نگار	nəɡˈaːr
امر	amˈʌr
ميونسپلٽي	mjˌoːnsəpəlˈʌʈi
سنت	sənˈʌt̪
ڪجي	kˈʌɟi
مغرب	mˈaɣrˌɪb
محروم	mˌəhrˈuːm
ماسٽر	mˌaːsəʈˈʌr
ٻڌايل	bədʰˈaːjal
ڀڳ	bʰˈʌɡ
رجحان	rˌəɟhˈaːn
گهرا	ɡəhˈʌraː
ساٿي	sˈaːtʰi
ننڍو	nənˈʌɖʰoː
اڳواڻن	ˌaɡʋaːɳˈʌn
بزنس	bəzˈʌns
منڊلي	mənɖˈʌli
بيجنگ	bˈeːɟənɡ
اوچائي	uːcˈaːi
لکندڙ	lˌəkʰəndˈʌr.
تاندورا	t̪aːndˈoːraː
نگراني	nˌəɡrˈaːni
اين	ˈeːn
دفنايو	dˌəfnˈaːjoː
جمھوريہ	ɟˌəmhuːrˈiːh
پروفيسر	pˌəroːfisˈʌr
سون	sˈoːn
عارف	aːrˈʌf
هيستائين	hˌeːst̪aːˈiːn
افتتاحي	ˌɪftɪt̪ˈaːhi
ڳوڙهن	ɡˌoːr.əhˈʌn
قلم	qəlˈʌm
ماڻيائين	mˌaːɳjaːˈiːn
بڻيو	bˈʌɳjoː
ڇڪجي	cʰəkˈʌɟi
طرز	tərˈʌz
ترتيب	t̪ˌərt̪ˈiːb
گھمڻ	ɡʰəmˈʌɳ
مھراڻ	mˌəhrˈaːɳ
علحده	ˌaləhədˈʌh
ترجماني	t̪ˌərəɟmˈaːni
دهلن	dˌəhəlˈʌn
بندوق	bəndˈuːq
چانور	caːnˈoːr
ڪورس	koːrˈʌs
اڻاٺ	aɳˈaːʈʰ
بوقت	bˈoːqət̪
تلهار	t̪ˌəlhˈaːr
ڪنفيڊريشن	kˌənfˌiːɖriʃˈʌn
مشينون	mˌəʃinˈoːn
مورتيون	mˌoːrt̪jˈoːn
ادب	adˈʌb
ديري	dˈeːri
ضامن	zaːmˈʌn
ناول	naːˈoːl
ڏٺا	ɖˈʌʈʰaː
سمو	sˈʌmoː
ظلم	ʐəlˈʌm
فن	fˈʌn
علامتون	ˌalaːmt̪ˈoːn
تنهن	t̪ˌənəhˈʌn
بليڪ	bəlˈiːk
شوڪت	ʃoːkˈʌt̪
هڏي	hˈʌɖi
ڌرتي	dʰərˈʌt̪i
اگني	aɡˈʌni
هلڪو	həlˈʌkoː
سونهن	sˌoːnəhˈʌn
مسجد	mˈasɟˌɪd
احمد	ɛhmˈʌd
فار	fˈaːr
پليگ	pəlˈiːɡ
اهڙو	ahˈʌr.oː
ماڻهون	mˌaːɳhˈoːn
ڪمپنيون	kˌəmpənjˈoːn
ڪامن	kaːmˈʌn
ڀاڳو	bʰˈaːɡoː
طاقت	taːqˈʌt̪
هاشم	haːʃˈʌm
شوال	ʃʋˈaːl
لتا	lˈʌt̪aː
حالت	haːlˈʌt̪
پتي	pˈʌt̪i
واجب	ʋaːɟˈʌb
ملاح	mˈʌlaːh
صلاحيتون	ʂˌəlaːhit̪ˈoːn
هڻندو	həɳˈʌndoː
ليڪچر	lˌeːkəcˈʌr
الله	ˈallaːh
منزلون	mˈanzˌɪloːn
صلاحيتن	ʂˌəlaːhit̪ˈʌn
ڀڃي	bʰˈʌɲi
کائجي	kʰaːˈɪɟi
بينگال	bˈeːnɡaːl
درٻاري	dˌərbˈaːri
اڇو	ˈacʰoː
ڍڪيل	ɖʰˈʌkjal
اخباري	ˌaxbˈaːri
ڪرائجي	kˌəraːˈɪɟi
انتظاميا	ˌɪntɪʐˈaːmjaː
ڍوري	ɖʰˈoːri
سيتا	sˈeːt̪aː
غريبن	ɣˌəribˈʌn
بنايو	bənˈaːjoː
ايسوسيئيشن	ˌeːsoːsˌiːiʃˈʌn
سٽون	səʈˈoːn
قبيلائي	qəbˈiːlaːˌiː
دعويدار	dˌaːʋidˈaːr
درٻارين	dˌərbaːrˈiːn
پوسٽل	pˌoːsəʈˈʌl
جوڙيندا	ɟoːr.ˈiːndaː
سنڀاليو	sˌənbʰˈaːljoː
چڪيون	cəkjˈoːn
مهاڀارت	mˌəhaːbʰaːrˈʌt̪
ويڙهيل	ʋeːr.ˈʌhjal
ڪئنال	kənˈaːl
نذير	nəzˈiːr
ناقابل	nˌaːqaːbˈʌl
قوت	qˈoːt̪
بادام	bˈaːdaːm
سمٿ	səmˈʌʈ
زميندارن	zˌəmindaːrˈʌn
تجربو	t̪ˌəɟərbˈoː
جانورن	ɟˌaːnoːrˈʌn
ڏڻ	ɖˈʌɳ
افسانه	ˌafsaːnˈʌh
پهريائين	pˌəhərjaːˈiːn
يونيورسٽين	jˌoːnjoːrˌəsʈˈiːn
دين	dˈeːn
جيئڻ	ɟeːˈɪɳ
پرک	pərˈʌkʰ
ڀوڏيسر	bʰˌoːɖisˈʌr
مضبوط	mˌəzbˈuːt
ترڪن	t̪ˌərəkˈʌn
مٿاهون	mˌətʰaːhˈoːn
فري	fˈʌri
جاگيرون	ɟˌaːɡirˈoːn
درميان	dˌərmjˈaːn
ڀت	bʰˈʌt̪
ڳائڻو	ɡaːˈɪɳoː
سناتن	sˌənaːt̪ˈʌn
دارومدار	dˌaːroːmdˈaːr
هارڊ	haːrˈʌɖ
ايما	ˈeːmaː
منڇر	mˌənəcʰˈʌr
بالله	bˈaːləlˌəh
رخصت	rˈʊxʂət̪
ڏجي	ɖˈʌɟi
آڱرين	ˌaːŋ̩rˈiːn
ڏاڍيون	ɖaːɖʰjˈoːn
ڪشتو	kˈʌʃt̪oː
ڪاريگر	kˌaːriɡˈʌr
واه	ʋˈaːh
پل	pˈʌl
صحرا	ʂəhˈʌraː
هلنديون	hˌəlndjˈoːn
اشارا	aʃˈaːraː
ڪنارو	kənˈaːroː
ڪٽي	kˈʌʈi
پڪل	pəkˈʌl
مادا	mˈaːdaː
عبدالعزيز	ˌabdˌaːlaːzˈiːz
هوتچند	hˌoːt̪əcˈʌnd
هيڪاري	heːkˈaːri
ڏاڏو	ɖˈaːɖoː
اڏي	ˈaɖi
خاطر	xaːtˈʌr
ناليوارو	naːljʋˈaːroː
رسالن	rˌəsaːlˈʌn
اسيمبلي	ˌasimbˈʌli
محترمه	mˌəhət̪ˌərəmˈʌh
نستعليق	nˌəst̪aːlˈiːq
ڏيئا	ɖˈeːaː
مھينو	məhˈiːnoː
روي	rʋˈeː
جنهنکي	ɟˌənəhənˈʌkʰi
عرصي	arˈʌʂi
ترانو	t̪ərˈaːnoː
ورهايو	ʋˌərhˈaːjoː
نمبرن	nˌəmbərˈʌn
ساراهيو	saːrˈaːhjoː
ننڍن	nˌənəɖʰˈʌn
نکاد	nəkʰˈaːd
درزي	dərˈʌzi
پايو	pˈaːjoː
ڊبل	ɖəbˈʌl
تازا	t̪ˈaːzaː
چونڊي	cˈoːnɖi
همت	həmˈʌt̪
جهم	ɟəhˈʌm
وٺو	ʋˈʌʈʰoː
ھن	hˈɪna
ويجھ	ʋeːɟˈʌh
روسي	rˈoːsi
اڪ	ˈak
معاهدو	maːhˈʌdoː
سگھيا	sˈʌɡʰjaː
ڊائجسٽ	ɖˌaːɪɟəsˈʌʈ
رھڻ	rəhˈʌɳ
چاهيندا	caːhˈiːndaː
هونئن	hoːnˈʌn
عبدالحسين	ˌabdˌaːləhsˈiːn
يقيني	jəqˈiːni
پاڻيء	pˈaːɳi
هڪڙا	həkˈʌr.aː
ڪرائيندا	kˌəraːˈiːndaː
ٿڃ	ʈˈʌɲ
کانئس	kʰaːnˈʌs
ٽڪرن	ʈˌəkərˈʌn
انتشار	ˌɪntɪʃˈaːr
ڌاتو	dʰˈaːt̪oː
نسبتي	nˌəsəbˈʌt̪i
ڳائو	ɡˈaːoː
ڏاڍ	ɖˈaːɖʰ
هيڏانهن	hˌeːɖaːnəhˈʌn
گڏجاڻين	ɡˌəɖɟaːɳˈiːn
اطلاع	atˈʌlaː
اڀو	ˈabʰoː
اوهان	uːhˈaːn
گرو	ɡˈʌroː
رپين	rəpˈiːn
شعبن	ʃˈɔbn
نقشي	nəqˈʌʃi
مرثيو	mərˈʌsjoː
ڪلفٽن	kˌələfəʈˈʌn
خارجي	xaːrˈʌɟi
محفل	mˈɛhfˌɪl
ڪارنامو	kˌaːrnˈaːmoː
ڪمپيوٽر	kˌəmpjoːʈˈʌr
پيار	pjˈaːr
وادي	ʋˈaːdi
پيالو	pjˈaːloː
جيڏي	ɟˈeːɖi
ڪيان	kjˈaːn
قرآن	qərˈaːn
چنيسر	cˌənisˈʌr
فرزند	fˌərəzˈʌnd
نئيگ	nəˈiːɡ
نشيني	nəʃˈiːni
ڪئمبرج	kˌəmbərˈʌɟ
گال	ɡˈaːl
هدايت	hˌədaːˈiːt̪
محرم	mˌəhərˈʌm
فضول	fəzˈoːl
روشن	roːʃˈʌn
ڊانس	ɖˈaːns
ڇڏيون	cʰəɖjˈoːn
هيل	hˈeːl
گذار	ɡəzˈaːr
هلڪا	həlˈʌkaː
دستخط	dˌəst̪əxˈʌt
وسي	ʋˈʌsi
روبرو	roːbˈʌroː
ناناڻن	nˌaːnaːɳˈʌn
مٿانهون	mˌətʰaːnhˈoːn
کڏي	kʰˈʌɖi
گانڌي	ɡˈaːndʰi
نہ	nˈʌh
رمضان	rˌəmzˈaːn
مڃڻ	məɲˈʌɳ
ارشد	ˌarəʃˈʌd
رٿيل	rˈʌtʰjal
ريتي	rˈeːt̪i
رات	rˈaːt̪
وڙھي	ʋˈʌr.hi
پيشاب	peːʃˈaːb
ٽاپ	ʈˈaːp
فرق	fərˈʌq
مظاهرا	mˌəʐaːhˈʌraː
ويندا	ʋˈeːndaː
سموريون	sˌəmoːrjˈoːn
ڊاهي	ɖˈaːhi
ڪانگريس	kˌaːnɡərˈiːs
ڌاڙيلن	dʰˌaːr.ilˈʌn
کارو	kʰˈaːroː
لاڳاپن	lˌaːɡaːpˈʌn
گھڻيون	ɡʰəɳjˈoːn
دهلوي	dəhˈʌlʋi
ڳايل	ɡˈaːjal
پولو	pˈoːloː
جهلڻ	ɟˌəhəlˈʌɳ
ڀل	bʰˈʌl
راڻا	rˈaːɳaː
تبديل	t̪əbˈʌdjal
حقيقي	həqˈiːqi
نج	nˈʌɟ
واٽون	ʋaːʈˈoːn
روايتون	rʋˌaːit̪ˈoːn
هڻندا	həɳˈʌndaː
يارهن	jˌaːrəhˈʌn
فلپ	fəlˈʌp
رزميه	rˌəzmˈiːh
سيد	saˈiːad
اڻويھين	ˌaɳʋihˈiːn
سندن	səndˈʌn
چنبي	cənbˈiː
ٿاڻو	tʰˈaːɳoː
اڄ	ˈaɟ
برهمڻي	bˌərəhəmˈʌɳi
ناھن	naːhˈʌn
حساب	həsˈaːb
پاٺ	pˈaːʈʰ
واهه	ʋaːhˈʌh
بيت	bˈeːt̪
يارھن	jˌaːrəhˈʌn
وفادار	ʋˌəfaːdˈaːr
صوبو	ʂuːbˈoː
علائقي	ˌalaːˈɪqi
مذڪوره	mˌəzkuːrˈʌh
زوردار	zoːrdˈaːr
حمل	həmˈʌl
وفات	ʋˌəfˈaːt
راجائون	rˌaːɟaːˈoːn
مغلن	mˌəɣəlˈʌn
اوندهه	ˌuːndəhˈʌh
نومبر	noːmbˈʌr
ولي	ʋˈʌli
ويهن	ʋeːhˈʌn
فلم	fˈɪlm
ڳالهايون	ɡˌaːlhaːjˈoːn
ڳاله	ɡaːlˈʌh
گهران	ɡˌəhərˈaːn
منظم	mˌənəʐˈʌm
جوزف	ɟoːzˈʌf
ڪڍيائين	kˌəɖʰjaːˈiːn
گا	ɡˈaː
ويجهي	ʋeːɟˈʌhi
پائونڊ	paːˈoːnɖ
ايوارڊ	ˌeːʋaːrˈʌɖ
کل	kʰˈʌl
ھئڻ	hˈʌɳ
مشترڪ	mˌəʃt̪ərˈʌk
ڪنوينشن	kˌənʋinəʃˈʌn
نامزد	nˌaːməzˈʌd
مدفن	mˌədəfˈʌn
طبعزاد	təbˈaːzaːd
خرابين	xˌəraːbˈiːn
قبرن	qˌəbərˈʌn
جذب	ɟəzˈʌb
مجازي	məɟˈaːzi
انور	anˈoːr
فرهنگ	fˌərəhˈʌnɡ
سرن	sərˈʌn
سرشتن	sˌərəʃt̪ˈʌn
نگاهه	nˌəɡaːhˈʌh
کٻڙ	kʰəbˈʌr.
راس	rˈaːs
بالٽڪ	bˈaːləʈˌək
جسامت	ɟˌəsaːmˈʌt̪
اسپيشل	ˌaspiʃˈʌl
آڪٽوبر	ˌaːkʈoːbˈʌr
شاهدي	ʃaːhˈʌdi
مند	mˈʌnd
ڦرلٽ	pʰˌərəlˈʌʈ
راقم	raːqˈʌm
ڀي	bʰˈeː
خوبي	xoːbˈiː
ٽم	ʈˈʌm
انڊيز	ɪnɖˈiːz
ڪاٺ	kˈaːʈʰ
سسئي	səsˈʌi
برف	bərˈʌf
ڪپڙي	kəpˈʌr.i
سرمائيدار	sˌərmˌaːidˈaːr
ڌار	dʰˈaːr
هوس	hˈoːs
وڊيوز	ʋəɖjˈoːz
دانهون	dˌaːnhˈoːn
سرڪار	sˌərkˈaːr
خيالات	xjˌaːlˈaːt
ڪلي	kˈʌli
پاڳارو	paːɡˈaːroː
حد	hˈʌd
تخيل	t̪ˈʌxjal
لڙائين	lˌər.aːˈiːn
گيتن	ɡeːt̪ˈʌn
بااختيار	bˈaːaːxt̪jˌaːr
عهدا	ahˈʌdaː
دنگ	dˈʌnɡ
ورهائي	ʋˌərhˈaːi
صاحبي	ʂˌaːhbˈiː
ٿرين	ʈərˈiːn
ڦاٽ	pʰˈaːʈ
شهنشاهه	ʃˌəhənʃaːhˈʌh
پھريان	pˌəhrjˈaːn
ون	ʋˈʌn
فيصلا	feːʂˈʌlaː
خاطري	xaːtˈʌri
سميجن	sˌəmiɟˈʌn
استعمال	ɪstˈeːmaːl
ہے	hˈʌeː
نانگ	nˈaːnɡ
ڪوڊ	kˈoːɖ
تاڪن	t̪aːkˈʌn
ضابطن	zˌaːbətˈʌn
طهر	təhˈʌr
بندش	bəndˈʌʃ
شاهپور	ʃˌaːhəpˈoːr
وديا	ʋˈʌdjaː
ملھائيندا	mˌəlhaːˈiːndaː
هونديون	hũːdjˈoːn
ڪمپيوٽرن	kˌəmpjoːʈərˈʌn
اسراڻ	ˌasrˈaːɳ
اوائلي	ˌuːaːˈɪli
وٿي	ʋˈʌtʰi
ڀيلن	bʰeːlˈʌn
ڇپي	cʰˈʌpi
ڊگهن	ɖˌəɡəhˈʌn
ثقل	səqˈʌl
ٺهيو	ʈʰˈʌhjoː
نڪتل	nˌəkət̪ˈʌl
پڇ	pˈʌcʰ
چوهاڻ	coːhˈaːɳ
گئسي	ɡˈʌsi
پوکجي	poːkʰˈʌɟi
پوٽو	pˈoːʈoː
بچائي	bəcˈaːi
يونيورسٽي	jˌoːnjoːrəsˈʌʈi
ھجرت	hˌəɟərˈʌt̪
ھيو	hjˈoː
ممبئي	məmbˈʌi
سفارتي	sˌəfaːrˈʌt̪i
گهڻين	ɡˌəhəɳˈiːn
بابا	bˈaːbˈaː
مدرسا	mˌədərˈʌsaː
جانچ	ɟˈaːnc
بکر	bəkʰˈʌr
ڪنوار	kənʋˈaːr
چارلس	cˌaːrəlˈʌs
ــ	lˈetəcʰˈahacˈaːrbˈʊr.ilˈetəcʰˈahacˈaːrbˈʊr.i
ڏيندا	ɖˈeːndaː
سماچار	sˌəmaːcˈaːr
ڪيمپس	keːmpˈʌs
معائنو	maːˈɪnoː
ڪمايو	kəmˈaːjoː
آخرڪار	ˌaːxərkˈaːr
ھندو	hˈʌndoː
اوھان	uːhˈaːn
آڱر	ˌaːŋ̩ˈʌr
رھنمائي	rˌəhənmˈaːi
شئي	ʃˈʌi
اڪليز	ˌaklˈiːz
الائنس	ˌalaːˈɪns
ايئر	eːˈɪr
بيزار	bˈeːzaːr
وهڪري	ʋˌəhəkˈʌri
انداز	andˈaːz
گھوڙو	ɡʰˈoːr.oː
هدايتڪار	hˌədaːˌiːt̪kˈaːr
اوسط	uːsˈʌt
ڏوهن	ɖoːhˈʌn
پسارڪي	pˌəsaːrˈʌki
اسٿان	ˌastʰˈaːn
هيٺان	heːʈʰˈaːn
ڪلا	kˈʌlaː
مڪتبه	mˌəkət̪əbˈʌh
داستانن	dˌaːst̪aːnˈʌn
ڊگھيون	ɖəɡʰjˈoːn
جوڙڻ	ɟoːr.ˈʌɳ
گوگل	ɡoːɡˈʌl
جر	ɟˈʌr
استاد	ast̪ˈaːd
ذريعو	zərˈiːoː
هليو	hˈʌljoː
يوسي	jˈoːsi
هڪجهڙائي	hˌəkəɟˌəhər.ˈaːi
موڙي	mˈoːr.i
ڪندس	kəndˈʌs
جهمر	ɟˌəhəmˈʌr
روايت	rʋaːˈiːt̪
چيل	cˈeːl
مطلق	mˌətəlˈʌq
ڌيء	dʰˈeː
شهري	ʃəhˈʌri
درهم	dˌərəhˈʌm
سرواڻي	sərʋˈaːɳi
گئس	ɡˈʌs
لاڳاتار	lˌaːɡaːt̪ˈaːr
ڀاڳ	bʰˈaːɡ
زوري	zˈoːri
ٽوڙڻ	ʈoːr.ˈʌɳ
پهچايو	pˌəhəcˈaːjoː
ساز	sˈaːz
کوڙي	kʰˈoːr.i
پرست	pərˈʌst̪
گھرڙيائي	ɡʰˌərr.jˈaːi
سانوڻ	saːnˈoːɳ
اويس	uːˈiːs
رت	rˈʌt̪
پاپولر	pˌaːpoːlˈʌr
آف	ˈaːf
تخت	t̪ˈʌxt̪
کارائجي	kʰˌaːraːˈɪɟi
خانم	xaːnˈʌm
امتياز	ˌamt̪jˈaːz
ورتي	ʋərˈʌt̪i
ايڊيشنل	ˌeːɖiʃənˈʌl
سوٽ	sˈoːʈ
فدا	fˈʌdaː
گولڊ	ɡoːlˈʌɖ
نمڪين	nˌəmkˈiːn
ادارن	ˌadaːrˈʌn
ھمايون	hˌəmaːjˈoːn
جملن	ɟˈʊmln
سينٽرل	sˌeːnəʈərˈʌl
ڌريون	dʰərjˈoːn
ٻھ	bˈʌh
سلهاڙيل	sˌəlhˈaːr.jal
اصحابي	ˌaʂhaːbˈiː
سڏي	sˈʌɖi
عطا	ˈataː
لاء	lˈaː
عربستان	ˌarəbˈɪstaːn
حوالي	haʋˈaːli
مرڪزن	mˌərəkəzˈʌn
ويڪرا	ʋeːkˈʌraː
حلقي	həlˈʌqi
ٻيجل	beːɟˈʌl
مارڪس	mˌaːrəkˈʌs
سوڙهو	soːr.ˈʌhoː
ٻچن	bəcˈʌn
قبيلي	qəbˈiːli
ڪردار	kərdˈaːr
برهم	bˌərəhˈʌm
چيف	cˈeːf
دست	dˈʌst̪
سرگرمين	sˌarɡˈarmin
کارائڻ	kʰˌaːraːˈɪɳ
سين	sˈeːn
گھرجي	ɡʰərˈʌɟi
تفصيلي	t̪ˌəfʂˈiːli
اتحادين	ˌat̪haːdˈiːn
آڳاٽو	aːɡˈaːʈoː
موسي	mˈoːsi
اسپيڪر	ˌaspikˈʌr
رسمون	rˌəsmˈuːn
ھوائن	hʋaːˈɪn
استادن	ˌast̪aːdˈʌn
معاهدي	maːhˈʌdi
رکي	rˈʌkʰi
ساڃاهه	sˌaːɲaːhˈʌh
موڪل	moːkˈʌl
ايٽ	ˈeːʈ
بهتر	bˌəhət̪ˈʌr
نياز	njˈaːz
آنرري	ˌaːnərˈʌri
معمولي	maːmˈoːli
اچارن	ˌacaːrˈʌn
ڪرڻي	kərˈʌɳi
ضبط	zəbˈʌt
سڌارڻ	sˌədʰaːrˈʌɳ
ضرورت	zˌaruːrˈʌt̪
حقيقت	hˌəqiqˈʌt̪
پڄاڻي	pəɟˈaːɳi
ٻڌائن	bˌədʰaːˈɪn
پويون	pʋjˈoːn
رڪارڊ	rˌəkaːrˈʌɖ
کوٽيل	kʰˈoːʈjal
بونا	bˈoːnaː
سنٿالن	sˌəntʰaːlˈʌn
اهيو	ˈahjoː
کيڏي	kʰˈeːɖi
گھڻو	ɡʰˈʌɳoː
ساڪن	saːkˈʌn
منجھ	mˌənəɟˈʌh
لاکاٽ	laːkʰˈaːʈ
معلوماتي	mˌaːloːmˈaːt̪i
چناب	cənˈaːb
ڏسجي	ɖɪsˈʌɟi
سنڍ	sənˈʌɖʰ
مصلحت	mˌəʂələhˈʌt̪
ضعيف	zaːˈiːf
ميٿيو	mˈeːtʰjoː
روح	rˈoːh
منظور	mˌanʐˈuːr
مهرباني	mˌəhərbˈaːni
ڏھون	ɖəhˈoːn
منعقد	mˌənaːqˈʌd
قد	qˈʌd
سومر	soːmˈʌr
فرمائش	fˌərmaːˈɪʃ
رهايو	rəhˈaːjoː
اڇي	ˈacʰi
ٽٽي	ʈˈʌʈi
فائدا	faːˈɪdaː
صوبيدار	ʂuːbˈiːdaːr
ماکي	mˈaːkʰi
فاطمي	faːtˈʌmi
صديون	ʂədjˈoːn
يورپ	joːrˈʌp
گڏو	ɡˈʌɖoː
ساڻس	saːɳˈʌs
وينجهري	ʋˌeːnəɟəhˈʌri
جئين	ɟəˈiːn
ٻارن	baːrˈʌn
هيرا	hˈeːraː
عوامي	aʋˈaːmi
ماريو	mˈaːrjoː
ايڏي	ˈeːɖi
ڦاٽي	pʰˈaːʈi
ترديد	t̪ərdˈiːd
روم	rˈoːm
خانا	xˈaːnaː
رابطن	rˌaːbətˈʌn
چادرون	cˌaːdrˈoːn
رهجي	rəhˈʌɟi
آچر	aːcˈʌr
لڪيل	lˈʌkjal
ڇتي	cʰˈʌt̪i
اشتهار	ˌɪʃtɪhˈaːr
تقريرن	t̪ˌəqrirˈʌn
ڪرنل	kˌərənˈʌl
چاڙھيو	cˈaːr.hjoː
گلاس	ɡəlˈaːs
ٿوري	tʰˈoːri
مقدس	mˌəqədˈʌs
ڪلاڪ	kəlˈaːk
سڪون	səkˈoːn
ڀائيچاري	bʰˌaːicˈaːri
پرديسي	pərdˈiːsi
جگر	ɟəɡˈʌr
ڍڳي	ɖʰˈʌɡi
خالي	xˈaːli
نڪرڻ	nˈɪkrɳ
علحدگي	ˌaləhədˈʌɡi
گپتا	ɡəpˈʌt̪aː
راء	rˈaː
ڄاول	ɟaːˈoːl
ڊرامو	ɖərˈaːmoː
ٻوڙا	bˈoːr.aː
سؤٽ	səˈa͡ʊʈ
خضدار	xˌəzdˈaːr
سام	sˈaːm
روحانيت	rˌoːhaːnˈiːt̪
ننڍپڻ	nˌənəɖʰəpˈʌɳ
ذميدار	zˌəmidˈaːr
ملازمت	mˌəlaːzəmˈʌt̪
نياڻين	njaːɳˈiːn
هائوس	haːˈoːs
سيٺ	sˈeːʈʰ
ميڊل	meːɖˈʌl
فال	fˈaːl
درگاهه	dˌərɡaːhˈʌh
آڻبو	ˌaːɳbˈoː
قابليت	qˌaːblˈiːt̪
پنهنجون	pʌ̃hnɟˈoːn
پبلشر	pˌəbələʃˈʌr
وڍي	ʋˈʌɖʰi
آئلينڊز	ˌaːɪlinɖˈʌz
نمونن	nˌəmoːnˈʌn
ڪمپنين	kˌəmpənˈiːn
خسرو	xəsˈʌroː
ٽائيلن	ʈˌaːilˈʌn
ھلايو	həlˈaːjoː
واسديو	ʋaːsˈʌdjoː
پنج	pənˈʌɟ
پيدا	pˈeːdaː
بادي	bˈaːdi
تراب	t̪ərˈaːb
جميعت	ɟəmˈiːt̪
هال	hˈaːl
بيلي	bˈeːli
ڇاڇري	cʰaːcʰˈʌri
سٽ	sˈʌʈ
بارود	bˈaːroːd
سورج	soːrˈʌɟ
ڀڳو	bʰˈʌɡoː
ملت	məlˈʌt̪
وارياسي	ʋaːrjˈaːsi
ڀلي	bʰˈʌli
طريقا	tərˈiːqaː
مفت	məfˈʌt̪
خاصخيلي	xˌaːʂxˈiːli
سڪن	səkˈʌn
محاصرو	mˌəhaːʂˈʌroː
سوم	sˈoːm
هجرت	hˌəɟərˈʌt̪
ڪڍڻ	kəɖʰˈʌɳ
وڪڙن	ʋˌəkər.ˈʌn
ورھين	ʋˌərhˈiːn
ڪاٺين	kaːʈʰˈiːn
ڏھن	ɖəhˈʌn
ابوالبقا	abʋˈaːləbqaː
قيمتون	qˌeːmt̪ˈoːn
فيچر	feːcˈʌr
ساگر	saːɡˈʌr
اطمينان	ˌatminˈaːn
علاوہ	ˌalaːˈoːh
تڪن	t̪əkˈʌn
ايسٽ	eːsˈʌʈ
حوض	hˈoːz
سيني	sˈeːni
وصفون	ʋˌəʂfˈoːn
ٽڪرائجي	ʈˌəkraːˈɪɟi
مشاعرن	mˌəʃaːˈaːɪrn
بادشاھ	bˈaːdʃˌaːh
عهدو	ahˈʌdoː
زندهه	zˈɪndhəh
ارتقا	ˌɪrtˈɪqaː
ابوالحسن	abʋˈaːləhˌəsən
وڌندا	ʋədʰˈʌndaː
هزارين	hˌəzaːrˈiːn
سمجهن	sˌəməɟəhˈʌn
طرح	tˌərˈah
مليو	mˈʌljoː
پئي	pˈʌi
ابدي	abˈʌdi
جلندر	ɟˌələndˈʌr
عجائب	ˌaɟaːˈɪb
قطعي	qətˈaːi
ملائي	məlˈaːi
ڏاڪڻ	ɖaːkˈʌɳ
راحت	raːhˈʌt̪
سوئي	sˈoːi
اسڪين	ˌaskˈiːn
پوليٽيڪل	pˌoːliʈikˈʌl
ويڙھاڪ	ʋeːr.hˈaːk
ميلو	mˈeːloː
ورڇ	ʋərˈʌcʰ
نادر	naːdˈʌr
ذاتين	zaːt̪ˈiːn
گدلاڻ	ɡˌədlˈaːɳ
غير	ɣˈeːr
ٻچي	bˈʌci
سچي	sˈʌci
مورتي	moːrˈʌt̪i
سيارچن	sjaːrcˈʌn
سگهجي	sˌəɡəhˈʌɟi
عضوي	ˈazʋi
دسترس	dˌəst̪ərˈʌs
ڪين	kˈeːn
وسندي	ʋəsˈʌndi
شر	ʃˈʌr
لڳولڳ	lˌəɡoːlˈʌɡ
ڦڙا	pʰˈʌr.aː
شوري	ʃˈoːri
رقص	rəqˈʌʂ
خانه	xaːnˈʌh
اسٽوڊيو	ˌasʈˈoːɖjoː
گز	ɡˈʌz
هيٺاهين	hˌeːʈʰaːhˈiːn
اسٽيٽس	ˌasʈiʈˈʌs
خانپور	xaːnpˈoːr
ڪوٽڙي	koːʈˈʌr.i
معافي	mˈaːfi
دوا	dʋˈaː
مقدار	mˌəqdˈaːr
مذهبن	mˌəzəhəbˈʌn
وڙهڻ	ʋˌər.əhˈʌɳ
ڏنل	ɖˈɪnal
هارمون	hˌaːrmˈoːn
عددن	ˌadədˈʌn
داٻ	dˈaːb
فردن	fərdˈʌn
سوا	sʋˈaː
متن	mət̪ˈʌn
ثابت	saːbˈɪt̪
ٿورڙو	tʰoːrˈʌr.oː
پاليسي	paːlˈiːsi
مقصدن	mˌəqəʂədˈʌn
روپيه	roːpˈiːh
تجرباتي	t̪ˌəɟərbˈaːt̪i
سرو	sˈʌroː
پوکڻ	poːkʰˈʌɳ
ويٺل	ʋeːʈʰˈʌl
مرحلي	mˌərəhˈʌli
دير	dˈeːr
پرواهه	pˌərʋaːhˈʌh
تيليگو	t̪eːlˈiːɡoː
فطرت	fˌətərˈʌt̪
عرساڻي	ˌarsˈaːɳi
هوڏي	hˈoːɖi
پراڻيون	pˌəraːɳjˈoːn
تجربن	t̪ˌəɟərəbˈʌn
شڪايت	ʃˌəkaːˈiːt̪
بگھڙ	bəɡʰˈʌr.
الثاني	ˌalsˈaːni
اوسي	ˈuːsi
تازي	t̪ˈaːzi
عيسوي	aˈiːsʋi
پروڊيوسر	pˌəroːɖjoːsˈʌr
ڇاڻي	cʰˈaːɳi
دستور	dəst̪ˈuːr
ڇاپاڪو	cʰaːpˈaːkoː
گاه	ɡˈaːh
مشاهدو	mˌəʃaːhˈʌdoː
عبدالڪريم	ˌabdˌaːləkrˈiːm
تجربيڪار	t̪ˌəɟərbˈiːkaːr
اڏيرولال	ˌaɖiroːlˈaːl
شين	ʃˈeːn
برعڪس	bˌəraːkˈʌs
لوڪلبورڊ	lˌoːkəlbˈoːrəɖ
ريت	rˈeːt̪
شاھپور	ʃˌaːhpˈoːr
ياسين	jaːsˈiːn
انبن	anbˈʌn
گرامر	ɡˌəraːmˈʌr
لڏپلاڻ	lˌəɖəplˈaːɳ
سهولتون	sˌəhoːlt̪ˈoːn
ڦٽل	pʰəʈˈʌl
وان	ʋˈaːn
ڳنڍين	ɡˌənɖʰˈiːn
سيکاٽ	seːkʰˈaːʈ
ويلي	ʋˈeːli
ڌوئي	dʰˈoːi
اعتراض	ˌeːtɪrˈaːz
نياڻي	njˈaːɳi
ڌوڙ	dʰˈoːr.
آنرس	ˌaːnərˈʌs
يوروپا	joːrˈoːpaː
معاشرتي	mˌaːʃərˈʌt̪i
سڳورن	sˌəɡoːrˈʌn
موريا	mˈoːrjaː
پوشاڪ	poːʃˈaːk
پاڻهي	paːɳˈʌhi
ٿيڻو	tʰˈeːɳoː
ڳولڻ	ɡoːlˈʌɳ
بل	bˈʌl
رنگريز	rˌənɡərˈiːz
احد	ˈɛhd
چنبا	cənbˈaː
حالتن	hˌaːlət̪ˈʌn
برجن	bˌərəɟˈʌn
ريڻ	rˈeːɳ
پئجي	pˈʌɟi
صاحبن	ʂˌaːhəbˈʌn
پنجاهه	pˌənɟaːhˈʌh
نتيجي	nət̪ˈiːɟi
ورسي	ʋərˈʌsi
ٺوڙهي	ʈʰoːr.ˈʌhi
ڳالهائيندو	ɡˌaːlhaːˈiːndoː
بيضوي	bˈeːzʋi
گروهه	ɡˌəroːhˈʌh
آهيان	aːhjˈaːn
عرصو	arˈʌʂoː
ڦهلجي	pʰˌəhəlˈʌɟi
گهير	ɡəhˈiːr
فهميده	fˌəhəmidˈʌh
الحسين	ˌaləhsˈiːn
وڪالت	ʋˌəkaːlˈʌt̪
علامتن	ˌalaːmət̪ˈʌn
مرتبو	mˌərət̪bˈoː
چوپايو	coːpˈaːjoː
ويڙهي	ʋeːr.ˈʌhi
سرجن	sˌərəɟˈʌn
چنگيز	cənɡˈiːz
چيائين	cjaːˈiːn
پڪو	pˈʌkoː
مهلب	mˌəhəlˈʌb
سهڻي	səhˈʌɳi
لوهه	loːhˈʌh
شڪاري	ʃəkˈaːri
نظريا	naʐˈarjaː
اوني	ˈuːni
ڪجھہ	kˌəɟəhˈʌh
محبت	mˌəhəbˈʌt̪
نبي	nəbˈiː
اڻلڀ	ˌaɳəlˈʌbʰ
گرلس	ɡˌərəlˈʌs
سٺن	səʈʰˈʌn
سونو	sˈoːnoː
گهوڙن	ɡˌəhoːr.ˈʌn
صورت	ʂoːrˈʌt̪
تقويت	t̪əqʋˈiːt̪
ويهاري	ʋeːhˈaːri
دوست	dˈoːst̪
شارٽ	ʃaːrˈʌʈ
قابض	qaːbˈɪz
درويشن	dˌərʋiʃˈʌn
بابن	bˈaːbɪn
مگسي	məɡˈʌsi
نظارو	nəʐˈaːroː
شمل	ʃəmˈʌl
منتقل	mˌənət̪əqˈʌl
ٽئي	ʈˈʌi
سرگس	sˌərəɡˈʌs
سربراهي	sˌərəbrˈaːhi
رستم	rəst̪ˈʌm
بھاول	bˌəhaːˈoːl
منظرن	mˌanʐˈarn
مبني	məbˈʌni
ٽيليفون	ʈˌeːlifˈoːn
خلجي	xəlˈʌɟi
ذرو	zˈʌroː
آڪاش	aːkˈaːʃ
شهزادو	ʃˌəhəzˈaːdoː
صلح	ʂˌəlˈah
چئجي	cˈʌɟi
مجرب	mˌəɟərˈʌb
ماڻيندڙ	mˌaːɳindˈʌr.
ڦرڙين	pʰˌərr.ˈiːn
اڳوڻي	aɡˈoːɳi
دوائن	dʋaːˈɪn
ساڙيو	sˈaːr.joː
چڙهيو	cər.ˈʌhjoː
مشين	məʃˈiːn
تيرهن	t̪ˌeːrəhˈʌn
ويل	ʋˈajal
نظرئي	naʐˈari
لانگ	lˈaːnɡ
ديوارون	djʋaːrˈoːn
وارهه	ʋˌaːrəhˈʌh
سلطان	sˌəltˈaːn
مکڻ	məkʰˈʌɳ
مزاجن	mˌəzaːɟˈʌn
فلمساز	fˈɪlmsaːz
پاڳاري	paːɡˈaːri
چندي	cˈʌndi
ٻاراڻو	baːrˈaːɳoː
ڪاراباخ	kˌaːraːbˈaːx
ڪاما	kˈaːmaː
ٿيا	tʰjˈaː
منوره	mˌənoːrˈʌh
چوٿين	coːtʰˈiːn
ڪوٺجي	koːʈʰˈʌɟi
ڪرن	kərˈʌn
ڄامشوري	ɟˌaːmʃˈoːri
ڊارون	ɖaːrˈoːn
ال	ˈal
ناهن	naːhˈʌn
نظرداري	naʐˈardaːrˌiː
نورجهان	nˌoːrəɟhˈaːn
رياض	rjˈaːz
ٽيڪ	ʈˈeːk
رفيق	rəfˈiːq
ھجن	həɟˈʌn
گروه	ɡərˈoːh
واضح	ʋˌaːzˈah
شام	ʃˈaːm
واڳون	ʋaːɡˈoːn
هير	hˈeːr
جھڙو	ɟəhˈʌr.oː
ضلعو	zəlˈaːoː
خزانو	xəzˈaːnoː
عربي	ˌarbˈiː
حساس	həsˈaːs
ورھائي	ʋˌərhˈaːi
دانشورن	dˌaːnʃoːrˈʌn
سندري	səndˈʌri
لنگر	lənɡˈʌr
گيلاني	ɡeːlˈaːni
والدين	ʋˌaːldˈiːn
آمريڪا	ˌaːmrˈiːkaː
گوڪل	ɡoːkˈʌl
گهمي	ɡəhˈʌmi
جيترا	ɟeːt̪ˈʌraː
بيتن	bˈeːt̪ən
قاعدن	qˈaːjdn
پيتي	pˈeːt̪i
ڀتين	bʰət̪ˈiːn
لڪائي	ləkˈaːi
لڳندي	ləɡˈʌndi
وٽامن	ʋˌəʈaːmˈʌn
سلطانن	sˌəltaːnˈʌn
صفحن	ʂˌəfəhˈʌn
انفرا	ˌanəfˈʌraː
فوجون	foːɟˈoːn
ذڪر	zəkˈʌr
پکيڙڻ	pˌəkʰir.ˈʌɳ
پهچندو	pˌəhəcˈʌndoː
افساني	ˌafsˈaːni
پڻي	pˈʌɳi
ڪھاڻين	kˌəhaːɳˈiːn
ٻڌبو	bˌədʰbˈoː
زباني	zəbˈaːni
عهدن	ˌahədˈʌn
غلبو	ɣˌəlbˈoː
لئنگئيج	lˌənɡəˈiːɟ
مهدي	məhˈʌdi
پراڻ	pərˈaːɳ
اوڏانهن	ˌuːɖaːnəhˈʌn
کتري	kʰət̪ˈʌri
انٽرنيشنل	ˌanəʈˌərnˌiːʃənˈʌl
رٻڙ	rəbˈʌr.
جلي	ɟˈʌli
ميڙ	mˈeːr.
ذمري	zəmˈʌri
طاقتن	tˌaːqət̪ˈʌn
ھي	hˈeː
ملٽي	məlˈʌʈi
پروڊيوس	pˌəroːɖjˈoːs
طاهر	taːhˈʌr
زالن	zaːlˈʌn
اربن	ˌarəbˈʌn
شاعري	ʃaːˈaːɪrˌiː
فنا	fˈʌnaː
اسٽور	ˌasʈˈoːr
لاگ	lˈaːɡ
سوسائٽي	soːsˈaːʈi
گهوٽالي	ɡˌəhoːʈˈaːli
توکي	t̪ˈoːkʰi
وهڪرن	ʋˌəhəkərˈʌn
عقيدن	ˌaqidˈʌn
لهندو	ləhˈʌndoː
حلال	həlˈaːl
مڪي	mˈʌki
صالح	ʂˌaːlˈah
درجن	dˈarɟn
دائود	daːˈoːd
ڪکن	kəkʰˈʌn
ڳاڙهي	ɡaːr.ˈʌhi
پوڙهو	poːr.ˈʌhoː
انچارج	ˌancaːrˈʌɟ
حبشي	həbˈʌʃi
جائز	ɟaːˈɪz
ڇڏيل	cʰˈʌɖjal
رلي	rˈʌli
آرمي	aːrˈʌmi
مرحوم	mˌərhˈuːm
فجر	fəɟˈʌr
يوناني	joːnˈaːni
تتر	t̪ət̪ˈʌr
ڇڪڻ	cʰəkˈʌɳ
ڀڄڻ	bʰəɟˈʌɳ
سرگرم	sˌarɡˈarm
مخزن	mˌəxəzˈʌn
کٽ	kʰˈʌʈ
ڪيس	kˈeːs
ڏس	ɖˈɪs
مڇي	mˈʌcʰi
قوميت	qoːmˈiːt̪
ٻولن	boːlˈʌn
گهڙيال	ɡˌəhər.jˈaːl
لٽي	lˈʌʈi
ھند	hˈʌnd
گورڪي	ɡoːrˈʌki
سينگاريل	seːnɡˈaːrjal
سومرن	sˌoːmərˈʌn
نوشي	nˈoːʃi
تاثرات	t̪ˌaːsərˈaːt
ايوڌيا	eːˈoːdʰjaː
رڪنيت	rˌəknˈiːt̪
ملين	məlˈiːn
وڏ	ʋˈʌɖ
حاتم	haːt̪ˈʌm
پورهيي	poːrˈʌhji
گدرا	ɡədˈʌraː
نازل	naːzˈʌl
ساراھ	saːrˈaːh
ناما	nˈaːmaː
طبيبن	təbˈiːbən
جيون	ɟjˈoːn
مارڪيٽ	mˌaːrkˈiːʈ
خليفي	xəlˈiːfi
ٻه	bˈʌh
سڌو	sˈʌdʰoː
ڀر	bʰˈʌr
انتخاب	ˌɪntɪxˈaːb
سيرت	seːrˈʌt̪
گريٽ	ɡərˈiːʈ
مدينه	mˌədinˈʌh
محصولن	mˌəhʂuːlˈʌn
ائٽلانٽڪ	ˌaʈlˌaːnəʈˈʌk
مفهوم	mˌəfhˈuːm
رخن	rˈʊxn
تاجل	t̪aːɟˈʌl
سسٽم	sˈɪsʈam
اٿئي	aʈˈʌi
هلندا	həlˈʌndaː
مکيه	məkʰˈiːh
تبديليون	t̪ˌəbdiljˈoːn
منصوبو	mˌənʂuːbˈoː
مھر	məhˈʌr
موضوعن	moːzʋˈaːn
ڪيلينڊر	kˌeːlinɖˈʌr
ڇڏجن	cʰˌəɖəɟˈʌn
معاشرن	mˌaːʃərˈʌn
ٿينس	tʰˈeːns
ڪيترا	keːt̪ˈʌraː
ڪورنگي	koːrˈʌnɡi
قريش	qərˈiːʃ
پچائي	pəcˈaːi
ڇتو	cʰˈʌt̪oː
ماٿري	maːʈˈʌri
ڦهليل	pʰəhˈʌljal
چوان	cʋˈaːn
مسئلي	məsˈʌli
ڊيمي	ɖˈeːmi
ڀاء	bʰˈaː
ويٽنامي	ʋˌeːʈnˈaːmi
جڏهين	ɟˌəɖhˈiːn
زمين	zəmˈiːn
توجھ	t̪oːɟˈʌh
با	bˈaː
خواجه	xʋaːɟˈʌh
ڪون	kˈoːn
حرام	hərˈaːm
رڪنن	rˌəkənˈʌn
عضوو	ˈazʋoː
حصي	hˈʌʂi
پرنسپال	pˌərənsəpˈaːl
جمهوريه	ɟˌəmhuːrˈiːh
ڪونوڪارپس	kˌoːnoːkˌaːrəpˈʌs
پوڄا	pˈoːɟaː
رحه	rəhˈʌh
پوکيو	pˈoːkʰjoː
ابڙا	abˈʌr.aː
آس	ˈaːs
شمالي	ʃəmˈaːli
ڪوارٽر	kʋˌaːrəʈˈʌr
حادثي	haːdˈʌsi
چوڏهين	cˌoːɖhˈiːn
جند	ɟˈʌnd
ڪنگڊم	kˌənɡəɖˈʌm
الحق	ˌaləhˈʌq
ڇپائڻ	cʰˌəpaːˈɪɳ
تشدد	t̪ˌəʃədˈʌd
زبير	zəbˈiːr
نما	nˈʊmaː
سوچ	sˈoːc
مقدمو	mʊqˈadmoː
ٻوٽن	boːʈˈʌn
رجب	rəɟˈʌb
نيڪ	nˈeːk
لڳندا	ləɡˈʌndaː
ڇاپاڪي	cʰaːpˈaːki
ٽريفڪ	ʈˌərifˈʌk
سادو	sˈaːdoː
تخليق	t̪ˌəxlˈiːq
اسلوب	ˌaslˈoːb
سجاد	səɟˈaːd
خيرو	xˈeːroː
حس	hˈʌs
مخدوم	mˌəxdˈuːm
ٽٽڻ	ʈəʈˈʌɳ
مقبري	mˌəqəbˈʌri
موجوده	moːɟˈuːdh
مشڪلات	mˌəʃəkˌəlˈaːt
ڳالهائيندي	ɡˌaːlhaːˈiːndi
بلغمي	bˌələɣˈʌmi
رشيد	rəʃˈiːd
چپ	cˈʌp
گوريلا	ɡoːrˈiːlaː
نااميد	nˌaːaːmˈiːd
بڻيل	bˈʌɳjal
بدي	bˈʌdi
چمڙي	cəmˈʌr.i
گورنمنٽ	ɡˌoːrənˌəmənˈʌʈ
پوڙهي	poːr.ˈʌhi
ھئي	hˈʊi
هرگز	hˌərəɡˈʌz
گرامي	ɡərˈaːmi
ڌيوت	dʰjˈoːt̪
بخارا	bəxˈaːraː
مرمر	mˌərəmˈʌr
روٽ	rˈoːʈ
مخالفن	mʊxˈaːlɪfn
سعودي	saːˈoːdi
تبصرو	t̪ˌəbəʂˈʌroː
اڏام	aɖˈaːm
تاريخن	t̪ˌaːrixˈʌn
صوفي	ʂˈoːfi
سٺي	sˈʌʈʰi
جاچڻ	ɟaːcˈʌɳ
نبوت	nəbˈoːt̪
صدرمقام	ʂˌədərˌəmqˈaːm
جوڙايل	ɟoːr.ˈaːjal
سيکارڻ	sˌeːkʰaːrˈʌɳ
رھندو	rəhˈʌndoː
رائچند	rˌaːɪcˈʌnd
ايسرداس	ˌeːsrdˈaːs
پڙهيو	pər.ˈʌhjoː
ڪور	kˈoːr
متعارف	mˌət̪aːrˈʌf
لوهار	loːhˈaːr
ڪرمان	kˌərmˈaːn
لاطيني	laːtˈiːni
ٻڌندڙ	bˌədʰəndˈʌr.
سردي	sˈʌrdi
ڪتبو	kˌət̪bˈoː
زناني	zənˈaːni
ميدانن	mˌeːdaːnˈʌn
بيروني	bˈeːroːnˌiː
پيرن	peːrˈʌn
اسڪول	ˌaskˈoːl
فلسفين	fˌələsfˈiːn
ابخازيه	ˌabxaːzˈiːh
ڄم	ɟˈʌm
لانچر	laːncˈʌr
ساڍن	saːɖʰˈʌn
ڪيڪ	kˈeːk
روز	rˈoːz
غرق	ɣərˈʌq
السلام	ˌaləslˈaːm
گنج	ɡənˈʌɟ
بني	bˈʌni
خبرن	xˌəbərˈʌn
رح	rəˈah
نقش	nəqˈʌʃ
ديهه	deːhˈʌh
ڪاظم	kaːʐˈʌm
ٿائيلينڊ	tʰˌaːilˈiːnɖ
سوڍي	sˈoːɖʰi
مانجهند	mˌaːnəɟəhˈʌnd
لوڪن	loːkˈʌn
سياحتي	sjaːhˈʌt̪i
فني	fˈʌni
عبدالمجيد	ˌabdˌaːləmɟˈiːd
رستي	rˈʌst̪i
رشين	rəʃˈiːn
ڌنڌي	dʰˈʌndʰi
هٽلر	hˌəʈəlˈʌr
سڌارو	sədʰˈaːroː
ويچار	ʋeːcˈaːr
نڪري	nˈɪkri
الحرام	ˌaləhrˈaːm
جاري	ɟˈaːri
چانڊڪي	caːnɖˈʌki
سنگ	sˈʌnɡ
هوٿل	hoːʈˈʌl
لاهڻ	laːhˈʌɳ
حصو	hˈʌʂoː
ڪلھوڙن	kˌəlhuːr.ˈʌn
جيان	ɟjˈaːn
مينار	meːnˈaːr
چوي	cʋˈeː
سرسبز	sˌərəsəbˈʌz
ھضم	həzˈʌm
سرداري	sərdˈaːri
ڳڻيو	ɡˈʌɳjoː
افسانو	ˌafsˈaːnoː
تاج	t̪ˈaːɟ
رگ	rˈʌɡ
وڄي	ʋˈʌɟi
مظھر	mˌəʐəhˈʌr
چونڊيل	cˈoːnɖjal
محصول	mˌəhʂˈuːl
احتياط	ɛht̪jˈaːt
پالڻ	paːlˈʌɳ
مذھبن	mˌəzəhəbˈʌn
لهن	ləhˈʌn
انعام	ɪnˈaːm
محلي	məhˈʌli
نمايان	nˈʊmaːjˌaːn
ڪٽنب	kəʈˈʌnb
ڇپجندڙ	cʰˌəpəɟəndˈʌr.
لکڻيون	lˌəkʰɳjˈoːn
ننڍيون	nˌənɖʰjˈoːn
وڳوڙ	ʋəɡˈoːr.
مٺو	mˈʌʈʰoː
نيپچون	nˌeːpcˈoːn
اتحادي	ˌat̪hˈaːdi
شگر	ʃəɡˈʌr
سڄو	sˈʌɟoː
سينٽر	sˌeːnəʈˈʌr
جبران	ɟˌəbrˈaːn
مخاطب	mˌəxaːtˈʌb
المومنين	ˌalmˌoːmnˈiːn
ڪوالالمپور	kʋˌaːlaːlmpˈoːr
ھڪڙو	həkˈʌr.oː
گني	ɡˈʌni
حڪمن	hˌəkəmˈʌn
ايڪن	eːkˈʌn
سمورين	sˌəmoːrˈiːn
اصل	aʂˈʌl
پرائيويٽ	pˌəraːjʋˈiːʈ
نارو	nˈaːroː
ترميم	t̪ˌərmˈiːm
درياء	dˈʌrjaː
مسجدون	mˈasɟˌɪdoːn
ظلمن	ʐˌələmˈʌn
تختي	t̪ˈʌxt̪i
پوزيشن	pˌoːziʃˈʌn
المال	ˌalmˈaːl
ٻرهل	bˌərəhˈʌl
لھرون	lˌəhrˈuːn
کوسو	kʰˈoːsoː
ھاء	hˈaː
وسيلي	ʋəsˈiːli
بيچلر	bˈeːcəlˌər
قومپرست	qˌoːmpərˈʌst̪
تن	t̪ˈʌn
مقيم	məqˈiːm
مئل	mˈʌl
سکي	sˈʌkʰi
مثاني	məsˈaːni
ڏ	ɖˈeː
اسٽون	ˌasʈˈoːn
فيلڊ	feːlˈʌɖ
ريگستاني	rˌeːɡɪstˈaːni
اور	ˈuːr
سچو	sˈʌcoː
ڪجه	kəɟˈʌh
ڀرجي	bʰərˈʌɟi
نو	nˈoː
ڌام	dʰˈaːm
بيھي	bˈeːhi
گهرڙن	ɡˌəhərər.ˈʌn
مشاهدن	mˌəʃaːhədˈʌn
ايتري	eːt̪ˈʌri
بلبل	bˌələbˈʌl
لذت	ləzˈʌt̪
پهچندي	pˌəhəcˈʌndi
رائج	raːˈɪɟ
ھنڌ	hˈʌndʰ
ڪافر	kaːfˈʌr
فرعون	fˌəraːˈoːn
مٺ	mˈʌʈʰ
اشتر	aʃt̪ˈʌr
جوڙ	ɟˈoːr.
رابطا	raːbˈʌtaː
پرديش	pərdˈiːʃ
واهي	ʋˈaːhi
مسدس	mˌəsədˈʌs
اسپتالون	ˌasəpt̪aːlˈoːn
اھل	ahˈʌl
اهلڪارن	ˌahəlkaːrˈʌn
مهاراشٽر	mˌəhaːrˌaːʃəʈˈʌr
قدمي	qədˈʌmi
يافته	jˌaːfət̪ˈʌh
ڪپڙا	kəpˈʌr.aː
ھگانا	həɡˈaːnaː
نمائندي	nˈʊmaːˈɪndi
شراب	ʃərˈaːb
کڻائي	kʰəɳˈaːi
حفاظتي	hˌəfaːʐˈʌt̪i
ڪانفرنس	kˌaːnəfərˈʌns
درج	dˈarɟ
صنف	ʂənˈʌf
سيوستان	sjoːst̪ˈaːn
سخن	səxˈʌn
اينڊروئيڊ	ˌeːnɖəroːˈiːɖ
سفيرن	sˌəfirˈʌn
ٽڪ	ʈˈʌk
ملتان	mˌəlt̪ˈaːn
ليجسليٽو	lˌeːɟəslˈiːʈoː
آيت	aːˈiːt̪
صورتون	ʂˌoːrt̪ˈoːn
مثبت	mˌəsəbˈʌt̪
ساهتي	saːhˈʌt̪i
امير	amˈiːr
نشانين	nɪʃˈaːnin
سربيا	sˌərbjˈaː
آفيسن	ˌaːfisˈʌn
ڪلپنا	kˌələpˈʌnaː
ٽي	ʈˈeː
پويان	pʋjˈaːn
سورتون	sˌoːrt̪ˈoːn
قرار	qərˈaːr
لهجي	ləhˈʌɟi
سڌارن	sˌədʰaːrˈʌn
ھلڻ	həlˈʌɳ
مجيب	məɟˈiːb
منجهن	mˌənəɟəhˈʌn
دروازو	dərʋˈaːzoː
مروج	mərˈoːɟ
اندريون	ˌandərjˈoːn
آئرش	ˌaːɪrˈʌʃ
متبادل	mˌət̪bˈaːdəl
ڊوڙي	ɖˈoːr.i
داخلا	daːxˈʌlaː
زمانن	zˌəmaːnˈʌn
ساحلي	saːhˈʌli
سگهڙن	sˌəɡəhər.ˈʌn
شڪ	ʃˈʌk
ايمپائر	ˌeːmpaːˈɪr
ڏاکڻين	ɖˌaːkʰɳˈiːn
ٽرانس	ʈərˈaːns
چيس	cˈeːs
ھجڻ	həɟˈʌɳ
گولائي	ɡoːlˈaːi
سنڌڙي	sˈɪndhr.i
زيادتي	zjaːdˈʌt̪i
قانونساز	qˌaːnoːnsˈaːz
سانگهڙ	sˌaːnɡəhˈʌr.
ڀاڻيجو	bʰaːɳˈiːɟoː
ورائي	ʋərˈaːi
چؤسٽا	cˌəa͡ʊsˈʌʈaː
وصول	ʋəʂˈoːl
خاني	xˈaːni
انگلستان	ˌanɡəlˈɪstaːn
مفاصلو	mˌəfaːʂˈʌloː
لڙايون	lˌər.aːjˈoːn
اينٽي	eːnˈʌʈi
امروٽي	ˌamrˈoːʈi
الهامي	ˌalhˈaːmi
ڍولڪ	ɖʰoːlˈʌk
معنائن	mˌaːnaːˈɪn
ڪيچ	kˈeːc
برلن	bˌərəlˈʌn
حاجي	hˈaːɟi
بچڻ	bəcˈʌɳ
صحيون	ʂəhjˈoːn
سهوليت	sˌəhoːlˈiːt̪
بيانن	bjˈaːnən
جھنڊي	ɟəhˈʌnɖi
نامه	naːmˈʌh
مورو	mˈoːroː
مجموعو	mˌəɟmʋˈaːoː
راجپوت	rˌaːɟpˈoːt̪
ٺاهيندا	ʈʰaːhˈiːndaː
ڇوڪرو	cʰoːkˈʌroː
سگھي	sˈaɡʰeː
نالين	naːlˈiːn
قلات	qˌəlˈaːt
ڄائو	ɟˈaːoː
گجر	ɡəɟˈʌr
بابل	bˈaːbɪl
اوبلاسٽ	ˌuːblaːsˈʌʈ
دڪانن	dˌəkaːnˈʌn
پرمانند	pˌərmaːnˈʌnd
سفارتڪاري	sˌəfaːrˌət̪kˈaːri
چوگرد	coːɡˈʌrd
ماڊرن	mˌaːɖərˈʌn
دريا	dˈʌrjaː
رحلت	rˌəhəlˈʌt̪
بم	bˈʌm
مقامي	məqˈaːmi
عهدنامي	ˌahədnˈaːmi
عراقي	arˈaːqi
مسلسل	mˌəsələsˈʌl
عيسي	aˈiːsi
معاملات	mˌaːməlˈaːt
تبديلين	t̪ˌəbdilˈiːn
انسپيڪٽر	ˌansəpˌiːkəʈˈʌr
تڪرارن	t̪ˌəkraːrˈʌn
رتوديرو	rˌət̪oːdˈiːroː
ٻانهون	bˌaːnhˈoːn
سردارن	sˌərdaːrˈʌn
وڌندو	ʋədʰˈʌndoː
ڪولهي	koːlˈʌhi
تمغو	t̪əmˈʌɣoː
بيگ	bˈeːɡ
ڀڳل	bʰəɡˈʌl
شاھد	ʃaːhˈʌd
اڏرڻ	ˌaɖərˈʌɳ
الاباما	ˌalaːbˈaːmaː
پٽو	pˈʌʈoː
مذمت	mˌəzəmˈʌt̪
ڪڏهن	kˌəɖəhˈʌn
ڪثرت	kˌəsərˈʌt̪
دوزخ	doːzˈʌx
جيو	ɟjˈoː
آڱوٺي	ˌaːŋ̩ˈoːʈʰi
موٽواڻي	moːʈʋˈaːɳi
زار	zˈaːr
همٿ	həmˈʌʈ
مثالن	mˌəsaːlˈʌn
شهاب	ʃəhˈaːb
رشد	rəʃˈʌd
نيون	njˈoːn
غدودن	ɣˌədoːdˈʌn
ايبرڊين	ˌeːbərɖˈiːn
ٺهرايائين	ʈʰˌəhərˌaːjaːˈiːn
حج	hˈʌɟ
اوڻويھين	ˌuːɳʋihˈiːn
ڇوڏا	cʰˈoːɖaː
بذات	bˌəzˈaːt
الفضل	ˌaləfəzˈʌl
پنهنجين	pʌ̃hnɟˈiːn
سيڪڙو	seːkˈʌr.oː
ڪوي	kʋˈeː
سلو	sˈʌloː
تقريب	t̪ˌəqrˈiːb
سبي	səbˈiː
ڪسي	kˈʌsi
برازيل	bərˈaːzjal
رڳو	rˈʌɡoː
نند	nˈʌnd
عنوان	ʊnʋˈaːn
جواهر	ɟˈaʋaːhˌər
ڏسندڙ	ɖˌɪsəndˈʌr.
تسلسل	t̪ˌəsələsˈʌl
مشاعري	mˌəʃaːˈaːɪrˌiː
پائيندو	paːˈiːndoː
اڳي	ˈaɡi
مچي	mˈʌci
توڙي	t̪ˈoːr.i
ڀڳتن	bʰˌəɡət̪ˈʌn
ماھرن	mˌaːhərˈʌn
خلا	xˈʌlaː
بشارت	bˌəʃaːrˈʌt̪
چڙهيل	cər.ˈʌhjal
سمجهندا	sˌəməɟəhˈʌndaː
اڀي	ˈabʰi
اڪاين	ˌakaːˈiːn
ورتيون	ʋˌərt̪jˈoːn
چڱا	cəˈŋ̩aː
ڪافرن	kˌaːfərˈʌn
ڪاريون	kaːrjˈoːn
ديال	djˈaːl
نهرو	nəhˈʌroː
هميشہ	hˌəmiʃˈʌh
لاڙن	laːr.ˈʌn
آرٽسٽ	ˌaːrəʈəsˈʌʈ
بااثر	bˈaːaːsˌər
اوڌ	ˈuːdʰ
عام	ˈaːm
ڪاٺياواڙ	kˌaːʈʰjaːʋˈaːr.
ننڍڙي	nˌənəɖʰˈʌr.i
روس	rˈoːs
پيماني	peːmˈaːni
انگن	anɡˈʌn
المقدس	ˌaləmˌəqədˈʌs
مضبوطي	mˌəzbˈuːti
رکجي	rəkʰˈʌɟi
ساهت	saːhˈʌt̪
ڪائونسلر	kˌaːoːnsəlˈʌr
نياپو	njˈaːpoː
مرادياب	mˌəraːdjˈaːb
رحم	rəhˈʌm
سگھن	səɡʰˈʌn
زين	zˈeːn
بيحد	bˈeːhəd
آکاڻين	ˌaːkʰaːɳˈiːn
پور	pˈoːr
ڪھڙي	kəhˈʌr.i
پرچا	pˈʌrcaː
هت	hˈʌt̪
لاڳاپا	laːɡˈaːpaː
بچايو	bəcˈaːjoː
عالمن	ˌaːləmˈʌn
مفيد	məfˈiːd
ويتر	ʋeːt̪ˈʌr
تسليم	t̪ˌəslˈiːm
باري	bˈaːri
يونين	joːnˈiːn
خالص	xaːlˈʌʂ
فقري	fəqˈʌri
جيتن	ɟeːt̪ˈʌn
پوک	pˈoːkʰ
مجنون	mˌəɟnˈuːn
ڊسپينسري	ɖˌəspinsˈʌri
ڳوڙهين	ɡˌoːr.hˈiːn
شرڪ	ʃərˈʌk
تلڪ	t̪əlˈʌk
گهڻن	ɡˌəhəɳˈʌn
ٻنڌ	bˈʌndʰ
تعريف	t̪aːrˈiːf
ھموار	həmʋˈaːr
پرڪاش	pˌərkˈaːʃ
سس	sˈʌs
لاجواب	laːɟʋˈaːb
بيهوش	bˈeːhoːʃ
لافاني	laːfˈaːni
غار	ɣˈaːr
حارث	haːrˈʌs
سمجھي	sˈamɟʰi
سارنگ	saːrˈʌnɡ
شعبا	ʃˈɔbaː
آدرشي	ˌaːdərˈʌʃi
ترخانن	t̪ˌərxaːnˈʌn
فرينچ	fərˈiːnc
حسن	həsˈʌn
رولنگ	roːlˈʌnɡ
جوئر	ɟoːˈɪr
گرفتار	ɡˈɪrɪftˌaːr
چينل	ceːnˈʌl
سمجهيو	sˌəməɟˈʌhjoː
ملازمن	mˌəlaːzəmˈʌn
ميداني	meːdˈaːni
راجا	rˈaːɟaː
مالڪن	mˌaːləkˈʌn
پڙهندڙن	pˌər.əhˌəndər.ˈʌn
ڊڀري	ɖəbʰˈʌri
بحث	bəhˈʌs
آهنگي	aːhˈʌnɡi
اگرچ	aɡˈʌrc
ڊوائيسز	ɖʋˌaːisˈʌz
هنگامي	hənɡˈaːmi
عقل	aqˈʌl
اقتدار	ˌɪqtɪdˈaːr
پي	pˈeː
سگهاري	sˌəɡhˈaːri
ڊٺل	ɖəʈʰˈʌl
رايل	rˈaːjal
اڏيري	aɖˈiːri
ڪربلا	kˌərəbˈʌlaː
موتي	mˈoːt̪i
ڪوڙي	kˈoːr.i
برڪت	bˌərəkˈʌt̪
ويدن	ʋeːdˈʌn
اقتصاديات	ˌɪqtɪʂˌaːdiˈaːt
عسڪري	ˌasəkˈʌri
بلدياتي	bˌəldjˈaːt̪i
صحبت	ʂˌəhəbˈʌt̪
والا	ʋˈaːlaː
کهڙي	kʰəhˈʌr.i
ذميواري	zəmjʋˈaːri
حق	hˈʌq
ڪارائتو	kˌaːraːˈɪt̪oː
جهيڙو	ɟəhˈiːr.oː
کوسي	kʰˈoːsi
بعد	bˈaːd
کوليو	kʰˈoːljoː
ارباب	ˌarbˈaːb
لڳائي	ləɡˈaːi
روٽي	rˈoːʈi
اضافي	ɪzˈaːfi
گير	ɡˈeːr
وڌن	ʋədʰˈʌn
ملڻ	məlˈʌɳ
ملڪي	məlˈʌki
رابرٽ	rˌaːbərˈʌʈ
ادا	ˈadaː
معنائون	mˌaːnaːˈoːn
پير	pˈeːr
ڇيڙي	cʰˈeːr.i
ٿلهي	ʈəlˈʌhi
تور	t̪ˈoːr
ٽالپر	ʈˌaːləpˈʌr
ڳائيندو	ɡaːˈiːndoː
هڪٻئي	hˌəkəbˈʌi
گهرندا	ɡˌəhərˈʌndaː
اڳين	aɡˈiːn
نئيون	nəjˈoːn
آئين	aːˈiːn
فائيل	fˈaːjal
ڪيريبين	kˌeːribˈiːn
مائونٽ	mˌaːoːnˈʌʈ
ماتر	maːt̪ˈʌr
بنجڻ	bˌənəɟˈʌɳ
ٺل	ʈʰˈʌl
گذاريا	ɡəzˈaːrjaː
سرمائيداري	sˌərmˌaːidˈaːri
بدلجي	badˈalɟi
تھذيب	t̪ˌəhzˈiːb
نجوم	nəɟˈoːm
زرداري	zərdˈaːri
بگ	bˈʌɡ
وکر	ʋəkʰˈʌr
عبوري	abˈoːri
عباس	abˈaːs
بٺي	bˈʌʈʰi
لکندو	ləkʰˈʌndoː
چونڊيا	cˈoːnɖjaː
قسمين	qˌəsmˈiːn
کاتي	kʰˈaːt̪i
ڪام	kˈaːm
ڏجين	ɖəɟˈiːn
ماريندا	maːrˈiːndaː
هفتن	hˌəfət̪ˈʌn
ڪنواري	kənʋˈaːri
چاهيو	cˈaːhjoː
خصوصيتن	xˌəʂoːʂit̪ˈʌn
ڏهاڪن	ɖˌəhaːkˈʌn
ڄڻا	ɟˈʌɳaː
مداح	mˈʌdaːh
ويجهو	ʋeːɟˈʌhoː
سهروردي	sˌəhərˈuːrdi
چئون	cəˈoːn
نارايڻ	nˌaːraːˈiːɳ
پلاسٽڪ	pˌəlaːsəʈˈʌk
جرنل	ɟˌərənˈʌl
ڪيل	kˈajal
واري	ʋˈaːri
گهرڙا	ɡˌəhərˈʌr.aː
عيسائين	ˌaisaːˈiːn
هيا	hjˈaː
ورتل	ʋˈartal
موبائل	moːbˈaːɪl
ٽنڊي	ʈˈʌnɖi
سرشتي	sərˈʌʃt̪i
نعرو	nˈaːroː
نڪ	nˈʌk
ڪارناما	kˌaːrnˈaːmaː
ڳالھائڻ	ɡˌaːlhaːˈɪɳ
ھاڻي	hˈaːɳi
سگھجن	sˌəɡʰəɟˈʌn
جيڪا	ɟˈeːkaː
گورنري	ɡˌoːrənˈʌri
پٺ	pˈʌʈʰ
موقعا	mˈoːqaː
نحو	nˈʌhoː
سياح	sjˈaːh
شخصيت	ʃˈaxʂit̪
سحر	səhˈʌr
ماڱر	mˌaːŋ̩ˈʌr
ڪوٺيندا	koːʈʰˈiːndaː
انتھائي	ˌɪntɪhˈaːi
ٻاهريون	bˌaːhərjˈoːn
سرخ	sˈʊrx
مقدمن	mʊqˈadmn
روڊ	rˈoːɖ
وڇون	ʋəcʰˈoːn
رومانوي	roːmˈaːnʋi
هئو	hˈʌoː
الحسن	ˌaləhəsˈʌn
ريزيڊنٽ	rˌeːziɖənˈʌʈ
خاصي	xˈaːʂi
پيشي	pˈeːʃi
ليفٽيننٽ	lˌeːfʈˌiːnənˈʌʈ
ناميارو	naːmjˈaːroː
لطف	lətˈʌf
دونهين	dˌoːnhˈiːn
ايڏو	ˈeːɖoː
چٽيو	cˈʌʈjoː
سوڄن	soːɟˈʌn
پکين	pəkʰˈiːn
ميچ	mˈeːc
چوڻ	cˈoːɳ
جهلي	ɟəhˈʌli
سادن	saːdˈʌn
ڏياچ	ɖjˈaːc
ڀاڻ	bʰˈaːɳ
دادو	dˈaːdoː
سيمينٽ	sˌeːminˈʌʈ
ميمبرن	mˌeːmbərˈʌn
تابع	t̪aːbˈeː
ادارا	adˈaːraː
سيالڪوٽ	sjˌaːlkˈoːʈ
اليڪٽرڪ	ˌalikˌəʈərˈʌk
اسلامڪ	ˌɪslˈaːmk
مئي	mˈʌi
ماھرين	mˌaːhrˈiːn
شروعاتي	ʃərʋˈaːt̪i
عبدالوهاب	ˌabdˌaːloːhˈaːb
بلڊنگ	bˌələɖˈʌnɡ
ڪانهي	kaːnˈʌhi
التمش	ˌalət̪əmˈʌʃ
محمود	mˌəhmˈuːd
بيبي	bˈeːbˈiː
باقيات	bˈaːqiˈaːt
ٽرانزسٽر	ʈˌəraːnˌəzəsəʈˈʌr
شعبو	ʃˈɔboː
صوبي	ʂuːbˈiː
نمائنده	nˈʊmaːˈɪndəh
ڪتابڙو	kˌɪtaːbˈʌr.oː
سچ	sˈʌc
فلمي	fˈɪlmi
اڇلائي	ˌacʰlˈaːi
پهلوان	pˌəhəlʋˈaːn
ايڪڙ	eːkˈʌr.
ڪيپ	kˈeːp
جنسن	ɟˈɪnsn
ڇپايل	cʰəpˈaːjal
سونا	sˈoːnaː
همعصرن	hˌəmaːʂərˈʌn
روينيو	rʋˈeːnjoː
گوليون	ɡoːljˈoːn
دک	dˈʌkʰ
آھيون	aːhjˈoːn
فرھنگ	fˌərəhˈʌnɡ
نيڪالي	neːkˈaːli
ٻوڙو	bˈoːr.oː
سجاڳ	səɟˈaːɡ
لاڳاپي	laːɡˈaːpi
آڻي	ˈaːɳi
ڇهن	cʰəhˈʌn
انگ	ˈanɡ
آفريڪا	ˌaːfrˈiːkaː
آنن	aːnˈʌn
ٺهندا	ʈʰəhˈʌndaː
حجر	həɟˈʌr
پئسا	pˈʌsaː
ميراث	meːrˈaːs
گذاريائين	ɡˌəzaːrjaːˈiːn
الاهي	alˈaːhi
غم	ɣˈʌm
چاهيان	caːhjˈaːn
مرحلو	mˌərəhˈʌloː
پروجيڪٽ	pˌəroːɟikˈʌʈ
همايون	hˌəmaːjˈoːn
جيتوڻيڪ	ɟˌeːt̪oːɳˈiːk
بيدل	bˈeːdəl
قلندر	qˌələndˈʌr
پھچڻ	pˌəhəcˈʌɳ
رهيس	rəhˈiːs
محفلون	mˈɛhfˌɪloːn
واد	ʋˈaːd
ٺهرايو	ʈʰˌəhərˈaːjoː
رحيم	rəhˈiːm
ڪاميڊي	kaːmˈiːɖi
اڪريل	akˈʌrjal
اصلوڪن	ˌaʂloːkˈʌn
تشريح	t̪əʃˈʌrih
ڀڳتي	bʰəɡˈʌt̪i
جمهوريت	ɟˌəmhuːrˈiːt̪
آئون	ˈaːũː
شهداد	ʃˌəhədˈaːd
غوث	ɣˈoːs
ايلزبيٿ	ˌeːləzbˈiːʈ
دلگير	dˌəlɡˈiːr
سوچي	sˈoːci
يادگار	jˌaːdɡˈaːr
ڪپھ	kəpˈʌh
هيئت	heːˈɪt̪
نصر	nəʂˈʌr
تياريون	t̪jaːrjˈoːn
ھاري	hˈaːri
آبادڪاري	aːbˈaːdkˌaːri
باغن	bˈaːɣən
روهڙي	roːhˈʌr.i
ڏانهن	ɖˌaːnəhˈʌn
پھرين	pˌəhrˈiːn
مٿاھين	mˌətʰaːhˈiːn
آسا	ˈaːsaː
قافلا	qaːfˈʌlaː
سيٽن	seːʈˈʌn
مير	mˈeːr
بنو	bˈʌnoː
ياد	jˈaːd
رسي	rˈʌsi
ريحان	reːhˈaːn
ورتا	ʋərˈʌt̪aː
جڏھن	ɟˌəɖəhˈʌn
لائبرري	lˌaːɪbərˈʌri
اسپيني	ˌaspˈiːni
ماڪڙ	maːkˈʌr.
نين	nˈeːn
بيگم	bˈeːɡəm
ايندڙ	eːndˈʌr.
ڪتا	kˈʌt̪aː
ڪارائتا	kˌaːraːˈɪt̪aː
سيڪٽر	sˌeːkəʈˈʌr
بندي	bˈʌndi
فاتحن	fˌaːt̪əhˈʌn
دوستي	dˈoːst̪i
چيلھ	ceːlˈʌh
فرانس	fərˈaːns
لس	lˈʌs
ٻڌڻ	bədʰˈʌɳ
ايڪو	ˈeːkoː
فراق	fərˈaːq
اڪيلائي	ˌakilˈaːi
پٹ	pˈʌʈ
صابر	ʂaːbˈɪr
ويهين	ʋˈiːhĩː
ڪارخانن	kˌaːrxaːnˈʌn
صحيحون	ʂˌəhihˈoːn
احساسن	ˌɛhsaːsˈʌn
جاگير	ɟaːɡˈiːr
وهم	ʋəhˈʌm
سڪو	sˈʌkoː
ڏهرن	ɖˌəhərˈʌn
حياتياتي	hjaːt̪jˈaːt̪i
عبدالقادر	ˌabdˌaːlqaːdˈʌr
نمبر	nəmbˈʌr
سلام	səlˈaːm
بنيو	bˈʌnjoː
ڪن	kˈʌn
آبھوا	aːbˈʌhʋaː
ٺلهه	ʈʰˌələhˈʌh
بس	bˈʌs
آندائون	ˌaːndaːˈoːn
عبدالحفيظ	ˌabdˌaːləhfˈiːʐ
ٽيسٽ	ʈeːsˈʌʈ
دار	dˈaːr
گندگي	ɡəndˈʌɡi
چهري	cəhˈʌri
مٿانئس	mˌətʰaːnˈʌs
جوان	ɟˈaʋaːn
نامياتي	naːmjˈaːt̪i
چڙھي	cˈʌr.hi
غزني	ɣəzˈʌni
چراغ	cərˈaːɣ
ٽاري	ʈˈaːri
قانون	qaːnˈoːn
دال	dˈaːl
بشير	bəʃˈiːr
اصليت	ˌaʂlˈiːt̪
ھندستان	hˌəndəˈɪstaːn
سنگم	sənɡˈʌm
پورا	pˈoːraː
آرپار	ˌaːrpˈaːr
اصطلاح	ɪʂtˈɪlaːh
پڙاڏو	pər.ˈaːɖoː
بلاذري	bˌəlaːzˈʌri
مهينن	mˌəhinˈʌn
بهار	bəhˈaːr
گذرن	ɡˌəzərˈʌn
وعظ	ʋˈaːʐ
ناٽڪ	naːʈˈʌk
گوشت	ɡˈoːʃt̪
ڏيارڻ	ɖjaːrˈʌɳ
ٽيگ	ʈˈeːɡ
آڌار	aːdʰˈaːr
مادري	maːdˈʌri
معلوم	maːlˈoːm
راڄو	rˈaːɟoː
رياستي	rjˈaːst̪i
ڪنول	kənˈoːl
ڪنڊياري	kənɖjˈaːri
ايترو	eːt̪ˈʌroː
ڪرندو	kərˈʌndoː
حاضري	haːzˈʌri
ٻورو	bˈoːroː
ڇڏبو	cʰˌəɖbˈoː
محدث	mˌəhədˈʌs
ڪاروبار	kˌaːroːbˈaːr
قبا	qəbˈaː
منطقي	mˌənətˈʌqi
ٺھڻ	ʈʰəhˈʌɳ
چشم	cəʃˈʌm
انڊس	ˈɪnɖas
ٻڌائيندو	bˌədʰaːˈiːndoː
وڃ	ʋˈʌɲ
مشتاق	məʃt̪ˈaːq
ابجد	ˌabəɟˈʌd
خديجه	xˌədiɟˈʌh
ٻيرن	beːrˈʌn
جهل	ɟəhˈʌl
جيڪي	ɟˈeːki
ٻڪري	bəkˈʌri
صورتحال	ʂˌoːrət̪hˈaːl
تهذيب	t̪ˌəhəzˈiːb
الفاظ	ˌalfˈaːʐ
نرالي	nərˈaːli
ڏني	ɖˈʌni
منتقلي	mˌənət̪əqˈʌli
ڳچي	ɡˈʌci
گلوبل	ɡˌəloːbˈʌl
ٿيو	tʰjˈoː
سامراجي	sˌaːmrˈaːɟi
پشاور	pˌəʃaːˈoːr
سهراب	sˌəhərˈaːb
بالي	bˈaːli
اعتبار	ˌeːtɪbˈaːr
سيپٽمبر	sˌeːpəʈəmbˈʌr
سونهري	sˌoːnəhˈʌri
سند	sˈʌnd
مهرچند	mˌəhərcˈʌnd
ڊچ	ɖˈʌc
ويندي	ʋˈeːndi
اندازي	andˈaːzi
ناڪامي	naːkˈaːmi
ويدڪ	ʋeːdˈʌk
هڪڙو	həkˈʌr.oː
ڀاڱن	bʰˌaːŋ̩ˈʌn
الهاس	ˌalhˈaːs
ڏھاڪي	ɖəhˈaːki
جھازن	ɟˌəhaːzˈʌn
شھيد	ʃəhˈiːd
رائس	raːˈɪs
رڪن	rəkˈʌn
ديوبند	djoːbˈʌnd
فانٽ	faːnˈʌʈ
زخمي	zəxˈʌmi
پارليامينٽ	pˌaːrljˌaːminˈʌʈ
ننگرپارڪر	nˌənɡərpaːrəkˈʌr
کائنس	kʰaːˈɪns
جهڙوڪر	ɟˌəhər.uːkˈʌr
ميگا	mˈeːɡaː
ويران	ʋeːrˈaːn
ھڏن	həɖˈʌn
ڀرڻ	bʰərˈʌɳ
ڪوڏر	koːɖˈʌr
فتح	fˌət̪ˈah
حاڪم	haːkˈʌm
جاگيردارن	ɟˌaːɡirdaːrˈʌn
جهنگلن	ɟˌəhənɡəlˈʌn
تصويرون	t̪ˌəʂʋirˈoːn
برابر	bˌəraːbˈʌr
سوڀارو	soːbʰˈaːroː
گھڻا	ɡʰˈʌɳaː
آهستي	aːhˈʌst̪i
ويب	ʋˈeːb
عماد	amˈaːd
گرانٽ	ɡˌəraːnˈʌʈ
غسل	ɣəsˈʌl
گهم	ɡəhˈʌm
ٽيوب	ʈjˈoːb
سوجھرو	sˌoːɟəhˈʌroː
سترهن	sˌət̪ərəhˈʌn
قصو	qˈʌʂoː
سگهبو	sˌəɡəhəbˈoː
پول	pˈoːl
ڪرڪيٽ	kˌərkˈiːʈ
مچ	mˈʌc
اپٽار	ˌapʈˈaːr
ٺٽوي	ʈʰˈʌʈʋi
مشاھدو	mˌəʃaːhˈʌdoː
ڏاکڻو	ɖaːkʰˈʌɳoː
يونائيٽيڊ	jˌoːnaːiʈˈiːɖ
هيڊ	hˈeːɖ
علامه	ˌalaːmˈʌh
منصوره	mˌənʂuːrˈʌh
ڇوجو	cʰˈoːɟoː
ڪڇي	kˈʌcʰi
عهد	ahˈʌd
ڪانفرنسن	kˌaːnəfˌərənsˈʌn
ڏيھي	ɖˈeːhi
اقليتن	ˌaqlit̪ˈʌn
درپيش	dˌərpˈiːʃ
تربيت	t̪ˌərbˈiːt̪
ڪير	kˈeːr
اندرا	andˈʌraː
صفتن	ʂˌəfət̪ˈʌn
کاڌائين	kʰˌaːdʰaːˈiːn
چاهه	caːhˈʌh
بيهڻ	bˈeːhəɳ
حمد	həmˈʌd
ڪھاڻيون	kˌəhaːɳjˈoːn
نرمي	nərˈʌmi
مدرس	mˌədərˈʌs
ٻارھين	bˌaːrhˈiːn
مصري	məʂˈʌri
پاڻمرادو	pˌaːɳəmrˈaːdoː
مرڪ	mərˈʌk
مهيسر	mˌəhisˈʌr
قطب	qətˈʌb
مهينا	məhˈiːnaː
قبضي	qəbˈʌzi
ٻائي	bˈaːi
ننڍڙا	nˌənəɖʰˈʌr.aː
ٽولي	ʈˈoːli
فخر	fəxˈʌr
ڊولپمينٽ	ɖˌoːləpminˈʌʈ
ٺاھڻ	ʈʰaːhˈʌɳ
مقالي	məqˈaːli
سورهيه	sˌoːrhˈiːh
فرشن	fˌərəʃˈʌn
هڪجهڙي	hˌəkəɟəhˈʌr.i
درجو	dˈarɟoː
شاعره	ʃaːˈaːɪrh
گليشيئر	ɡˌəliʃiˈɪr
جسمم	ɟˌəsəmˈʌm
کاهي	kʰˈaːhi
سينيٽر	sˌeːniʈˈʌr
خريد	xərˈiːd
قبل	qəbˈʌl
هفتا	həfˈʌt̪aː
ٽرين	ʈərˈiːn
گورک	ɡoːrˈʌkʰ
راڳ	rˈaːɡ
ٽيڪنالاجي	ʈˌeːknaːlˈaːɟi
سروي	sˈʌrʋi
وطن	ʋətˈʌn
وچين	ʋəcˈiːn
پيروي	pˈeːrʋi
ساڙي	sˈaːr.i
پاڪ	pˈaːk
ڏٺو	ɖˈʌʈʰoː
نانڪ	naːnˈʌk
صحارا	ʂəhˈaːraː
ڇلي	cʰˈʌli
ولين	ʋəlˈiːn
ايندا	ˈeːndaː
ڪانڪريٽ	kˌaːnəkrˈiːʈ
پهچڻ	pˌəhəcˈʌɳ
ميٽرڪ	mˌeːʈərˈʌk
اهڙيون	ˌahər.jˈoːn
چڱن	cˌəŋ̩ˈʌn
پهچن	pˌəhəcˈʌn
بسنت	bˌəsənˈʌt̪
ڊائريڪٽوريٽ	ɖˌaːɪrˌiːkʈoːrˈiːʈ
ضلعن	zəlˈaːn
نفس	nəfˈʌs
معاويه	maːʋˈiːh
وارد	ʋˈaːrd
پنير	pənˈiːr
برصغير	bˌərəʂɣˈiːr
مڃائڻ	mˌəɲaːˈɪɳ
سومري	soːmˈʌri
پين	pˈeːn
زڪريا	zəkˈʌrjaː
اٽو	ˈaʈoː
ڀرپاسي	bʰˌərpˈaːsi
چار	cˈaːr
اسسٽنٽ	ˌasəsˌəʈənˈʌʈ
ٽپي	ʈˈʌpi
سابق	saːbˈɪq
روپين	roːpˈiːn
ڳجهي	ɡəɟˈʌhi
جهانگير	ɟˌəhaːnɡˈiːr
ٿڌي	ʈˈʌdʰi
ڊالر	ɖaːlˈʌr
موقعو	moːqˈaːoː
ڊويزنون	ɖʋˌeːznˈoːn
وليم	ʋəlˈiːm
ٺاهيندڙ	ʈʰˌaːhindˈʌr.
عثماني	ˌasmˈaːni
چڱو	cəˈŋ̩oː
ڀنگ	bʰˈʌnɡ
سڪندراعظم	sˌəkəndˌəraːaːʐˈʌm
ناريل	nˈaːrjal
آگاهي	aːɡˈaːhi
ارجن	ˌarəɟˈʌn
انسانن	ɪnsˈaːnn
مالهي	maːlˈʌhi
بڻيا	bˈʌɳjaː
استوا	ˈast̪ʋaː
ڀڳت	bʰəɡˈʌt̪
ھڪ	hˈɪkʊ
ٻيلي	bˈeːli
خضر	xəzˈʌr
پوڻا	pˈoːɳaː
تحت	t̪əhˈʌt̪
سيلون	seːlˈoːn
ٻارھن	bˌaːrəhˈʌn
رضيه	rəzˈiːh
گولي	ɡˈoːli
ترقي	t̪ərˈʌqi
ھندن	həndˈʌn
رکجن	rˌəkʰəɟˈʌn
وندر	ʋəndˈʌr
آفيم	aːfˈiːm
مٽ	mˈʌʈ
مهر	məhˈʌr
پرنس	pərˈʌns
برساتي	bˌərsˈaːt̪i
لاڙ	lˈaːr.
تحرڪ	t̪ˌəhərˈʌk
ڄاتو	ɟˈaːt̪oː
مهاڀاري	mˌəhaːbʰˈaːri
تيلگو	t̪eːlˈʌɡoː
طريقيڪار	tˌəriqikˈaːr
ڪهڪشان	kˌəhəkʃˈaːn
واپس	ʋaːpˈʌs
دشمن	dˌəʃəmˈʌn
ٻاجهر	bˌaːɟəhˈʌr
ڪنور	kənˈoːr
عملي	amˈʌli
زيوس	zjˈoːs
تماچي	t̪əmˈaːci
اردو	ˈardoː
باقر	bˈaːqər
گوني	ɡˈoːni
جلندڙ	ɟˌələndˈʌr.
ايمنسٽي	ˌeːmənsˈʌʈi
رٿ	rˈʌʈ
ٻئين	bəˈiːn
ڌر	dʰˈʌr
رکيائون	rˌəkʰjaːˈoːn
گاهن	ɡaːhˈʌn
مڃين	məɲˈiːn
اندروني	ˌandərˈoːni
ڪمانڊر	kˌəmaːnɖˈʌr
آرڪائيوز	ˌaːrkaːjˈoːz
ھندستاني	hˌəndəɪstˈaːni
هلائيندو	hˌəlaːˈiːndoː
وجدان	ʋˌəɟdˈaːn
کوپڙي	kʰoːpˈʌr.i
معاشرو	maːʃˈʌroː
مزدڪ	mˌəzədˈʌk
غلطي	ɣəlˈʌti
ضخيم	zəxˈiːm
فيڊرل	fˌeːɖərˈʌl
منتر	mˌənət̪ˈʌr
سياحت	sjaːhˈʌt̪
اسٽڊيز	ˌasəʈɖˈiːz
هلي	hˈʌli
نيري	nˈeːri
ان	ˈɪna
تعلقي	t̪aːlˈʌqi
پالڪ	paːlˈʌk
اھو	ˈahoː
باڪس	bˈaːkəs
سڄي	sˈʌɟi
درياهن	dˌərjaːhˈʌn
وزيرن	ʋˌəzirˈʌn
فقيري	fəqˈiːri
موڪليندو	mˌoːklˈiːndoː
سيال	sjˈaːl
رافيل	rˈaːfjal
جنھن	ɟˈʌnhn
چوڌري	coːdʰˈʌri
پرڏيهه	pˌərɖihˈʌh
تحقيقي	t̪ˌəhqˈiːqi
ضلعا	zˈʌlaː
چمڪدار	cˌəməkdˈaːr
وٽ	ʋˈʌʈ
ڪارگر	kˌaːrəɡˈʌr
دوران	doːrˈaːn
ريسرچ	reːsˈʌrc
چوندي	cˈoːndi
خط	xˈʌt
فريڊرڪ	fˌəriɖərˈʌk
اصولن	ˌʊʂuːlˈʌn
نامعلوم	nˌaːmaːlˈoːm
ڪرايون	kˌəraːjˈoːn
ابا	abˈaː
جماعتي	ɟˌəmaːˈaːt̪i
اوتري	uːt̪ˈʌri
چيائينس	cjaːˈiːns
موهن	moːhˈʌn
جيد	ɟˈeːd
ذوق	zˈoːq
مٺڻ	məʈʰˈʌɳ
فون	fˈoːn
پلانٽ	pˌəlaːnˈʌʈ
شڪتي	ʃəkˈʌt̪i
پٿر	pəʈˈʌr
پردا	pˈʌrdaː
ڳوڙها	ɡoːr.ˈʌhaː
اباڻو	abˈaːɳoː
قانونن	qˌaːnoːnˈʌn
منڊ	mˈʌnɖ
فرنيچر	fˌərnicˈʌr
شادين	ʃaːdˈiːn
بـ	bˈeːlˈetəcʰˈahacˈaːrbˈʊr.i
سازگار	sˌaːzɡˈaːr
پهاڙي	pəhˈaːr.i
ايڪسپريس	ˌeːkəsˌəprˈiːs
ايڪ	ˈeːk
غزنوي	ɣəzˈʌnʋi
حملن	hˌəməlˈʌn
تلائن	t̪ˌəlaːˈɪn
ڏنس	ɖˈʌns
نهر	nəhˈʌr
گرنٿ	ɡˌərənˈʌʈ
سڪائي	səkˈaːi
تڪميل	t̪əkˈʌmjal
ٿلها	ʈəlˈʌhaː
سبڪتگين	sˌəbəkˌət̪ɡˈiːn
ٻڌا	bˈʌdʰaː
لڌيون	lədʰjˈoːn
شڪل	ʃəkˈʌl
ننڍڙو	nˌənəɖʰˈʌr.oː
پيل	pˈeːl
تهذيبي	t̪ˌəhəzibˈiː
گهوٽي	ɡəhˈoːʈi
ڪاوش	kaːˈoːʃ
گهٽ	ɡəhˈʌʈ
بھادر	bˌəhaːdˈʌr
سڀني	səbʰˈʌni
ڪلب	kəlˈʌb
هوريان	hoːrjˈaːn
لغوي	lˈʌɣʋi
بنگلا	bənɡˈʌlaː
اثرانداز	ˌasraːndˈaːz
زمينن	zˌəminˈʌn
رکيائين	rˌəkʰjaːˈiːn
ڪوئيٽا	koːˈiːʈaː
چرچ	cˈʌrc
الف	alˈʌf
رسالا	rəsˈaːlaː
پائينديون	pˌaːindjˈoːn
اھي	ˈahi
جياپي	ɟjˈaːpi
ڀان	bʰˈaːn
سٺيون	səʈʰjˈoːn
پاڻ	pˈaːɳ
عزت	azˈʌt̪
ٿولهه	tʰˌoːləhˈʌh
حنيف	hənˈiːf
تذڪره	t̪ˌəzəkərˈʌh
پندرهين	pˌəndərhˈiːn
گهي	ɡˈʌhi
زخم	zəxˈʌm
ايراني	eːrˈaːni
اڪادمي	ˌakaːdˈʌmi
مرضي	mərˈʌzi
ملهه	mˌələhˈʌh
منگهارام	mˌənɡəhaːrˈaːm
رهيل	rˈʌhjal
ٿانون	tʰaːnˈoːn
آڳاٽي	aːɡˈaːʈi
سفارتڪار	sˌəfaːrˌət̪kˈaːr
ٽولو	ʈˈoːloː
وارو	ʋˈaːroː
جستجو	ɟəst̪ˈʌɟoː
معنا	mˈaːnaː
ڪاھ	kˈaːh
سرپرستي	sˌərəpərˈʌst̪i
چاچو	cˈaːcoː
ناياب	naːjˈaːb
ڪلاسيڪي	kˌəlaːsˈiːki
نالي	nˈaːli
رياضيدان	rjˌaːzidˈaːn
هيروئن	hˌeːroːˈɪn
سمجهندو	sˌəməɟəhˈʌndoː
شهادت	ʃˌəhaːdˈʌt̪
ڇوڪريون	cʰˌoːkrjˈoːn
گيان	ɡjˈaːn
نظامن	nɪʐˈaːmn
ڀانئجي	bʰaːnˈʌɟi
ڏاج	ɖˈaːɟ
جيسيه	ɟeːsˈiːh
وڌيل	ʋˈʌdʰjal
ڪاڙهي	kaːr.ˈʌhi
ڪجھھ	kˌəɟəhˈʌh
جھڙا	ɟəhˈʌr.aː
فيڊريشن	fˌeːɖriʃˈʌn
س	sˈiːn
فوجداري	fˌoːɟdˈaːri
سواري	sʋˈaːri
قتل	qət̪ˈʌl
پالتو	paːlˈʌt̪oː
بندرن	bˌəndərˈʌn
پڇڻ	pəcʰˈʌɳ
عبدالجبار	ˌabdˌaːləɟbˈaːr
خليفو	xəlˈiːfoː
ڌڪي	dʰˈʌki
دليل	dˈʌljal
لبنان	lˌəbnˈaːn
العارفين	ˌalaːrfˈiːn
ٽيچر	ʈeːcˈʌr
خاتمو	xaːt̪ˈʌmoː
سمائجي	sˌəmaːˈɪɟi
فتوح	fˈʌt̪oːh
جوهر	ɟoːhˈʌr
راڻي	rˈaːɳi
پيچيده	pˌeːcidˈʌh
موافق	mʋaːfˈʌq
مائل	maːˈɪl
سوڍو	sˈoːɖʰoː
جهڙي	ɟəhˈʌr.i
بھتر	bˌəhət̪ˈʌr
ڪمزوري	kˌəmzˈuːri
زويگ	zʋˈeːɡ
هٽ	hˈʌʈ
بلغم	bˌələɣˈʌm
ڦيرائي	pʰeːrˈaːi
جلد	ɟəlˈʌd
رشتي	rˈʌʃt̪i
خصوصيت	xˌəʂoːʂˈiːt̪
وڳڻ	ʋəɡˈʌɳ
نوڪرين	nˌoːkrˈiːn
ھا	hˈaː
جيوتي	ɟjˈoːt̪i
گلن	ɡəlˈʌn
گهاٽا	ɡəhˈaːʈaː
نالا	nˈaːlaː
چواڻي	cʋˈaːɳi
پيالي	pjˈaːli
درگا	dərˈʌɡaː
ورهايل	ʋˌərhˈaːjal
ڳالھ	ɡaːlˈʌh
سفر	səfˈʌr
ڪمرو	kəmˈʌroː
پکڙي	pəkʰˈʌr.i
ياترا	jaːt̪ˈʌraː
انب	ˈanb
روسو	rˈoːsoː
ڏسڻو	ɖɪsˈʌɳoː
معتقد	mˌaːt̪əqˈʌd
عجيب	aɟˈiːb
تاثير	t̪aːsˈiːr
دڙن	dər.ˈʌn
هڻي	hˈʌɳi
سگھبو	sˌəɡʰbˈoː
رامچندر	rˌaːməcəndˈʌr
سياسيات	sjˌaːsiˈaːt
رھجي	rəhˈʌɟi
ظهير	ʐəhˈiːr
سرمايو	sˌərmˈaːjoː
روزاني	roːzˈaːni
پيو	pjˈoː
مهرن	mˌəhərˈʌn
نون	nˈoːn
ٽائٽانڪ	ʈˌaːʈaːnˈʌk
پارٽي	paːrˈʌʈi
واقع	ʋˈaːqeː
خصوصيتون	xˌəʂoːʂit̪ˈoːn
پمپ	pˈʌmp
بارگاهه	bˈaːrɡˌaːhəh
خيز	xˈeːz
ڏسبا	ɖˌɪsbˈaː
لاشاري	laːʃˈaːri
اوٽ	ˈuːʈ
سگهو	səɡˈʌhoː
زالون	zaːlˈoːn
ٺيڪيدار	ʈʰˌeːkidˈaːr
ورھايل	ʋˌərhˈaːjal
پوڄيندا	poːɟˈiːndaː
لٽجي	ləʈˈʌɟi
اڏائي	aɖˈaːi
قيدي	qˈeːdi
سڃاڻپ	sˌəɲaːɳˈʌp
امانت	ˌamaːnˈʌt̪
جزو	ɟˈʌzoː
پکڙيو	pəkʰˈʌr.joː
اڪبري	ˌakəbˈʌri
احساس	ɛhsˈaːs
هڪ	hˈɪkʊ
بيھڪ	bˈeːhək
مامو	mˈaːmoː
الوحيد	ˌaloːhˈiːd
وڻن	ʋəɳˈʌn
ڀروسو	bʰərˈoːsoː
رسالي	rəsˈaːli
ڇڏيائين	cʰˌəɖjaːˈiːn
ٽيهن	ʈeːhˈʌn
انساني	ɪnsˈaːni
ارڙهين	ˌarər.hˈiːn
ما	mˈaː
خواه	xʋˈaːh
ڪوبه	koːbˈʌh
گوشه	ɡoːʃˈʌh
ويھي	ʋˈeːhi
وچ	ʋˈʌc
فصلن	fˌəʂəlˈʌn
نعرا	nˈaːraː
وسندڙ	ʋˌəsəndˈʌr.
مٿرا	məʈˈʌraː
مظاهرو	mˌəʐaːhˈʌroː
علاؤ	alˈaːa͡ʊ
تڏهين	t̪ˌəɖhˈiːn
ناري	nˈaːri
ڪتبي	kˌət̪bˈiː
ڦيرو	pʰˈeːroː
ڪرايو	kərˈaːjoː
ڪهڙيون	kˌəhər.jˈoːn
بدرآن	bˌədrˈaːn
آفندي	aːfˈʌndi
خواب	xʋˈaːb
اھوئي	ahˈoːi
تختگاه	t̪ˌəxt̪əɡˈaːh
کيرائين	kʰˌeːraːˈiːn
خيال	xjˈaːl
ناڻي	nˈaːɳi
هر	hˈʌr
اندازو	andˈaːzoː
مدائني	mˌədaːˈɪni
ڪهاڻين	kˌəhaːɳˈiːn
مڙهي	mər.ˈʌhi
تلور	t̪əlˈoːr
ماتا	mˈaːt̪aː
ڪامپليڪس	kˌaːmpəlikˈʌs
ٺاھن	ʈʰaːhˈʌn
پونديون	poːndjˈoːn
زنده	zˈɪndh
نارائڻ	nˌaːraːˈɪɳ
ڇوڪري	cʰoːkˈʌri
ڇوڪرين	cʰˌoːkrˈiːn
ننڍي	nənˈʌɖʰi
وفاقي	ʋəfˈaːqi
بلوچي	bəlˈoːci
صف	ʂˈʌf
ڪارڪنن	kˌaːrəkənˈʌn
دوڙ	dˈoːr.
ڦهلائڻ	pʰˌəhəlaːˈɪɳ
سولنڪي	sˌoːlənˈʌki
جمع	ɟˈʌmaː
شيخ	ʃˈeːx
ڀاڱو	bʰaːˈŋ̩oː
روان	rʋˈaːn
احاطي	ahˈaːti
پار	pˈaːr
حلاج	həlˈaːɟ
اشاعت	ˌaʃaːˈaːt̪
گرهه	ɡˌərəhˈʌh
ديواني	djʋˈaːni
جئسيه	ɟəsˈiːh
ترجمن	t̪ˌərəɟəmˈʌn
عبور	abˈoːr
تهران	t̪ˌəhərˈaːn
ٿيون	tʰjˈoːn
ايڪي	ˈeːki
مغليه	mˌəɣlˈiːh
ڄاڻون	ɟaːɳˈoːn
ڪاميٽي	kaːmˈiːʈi
ڪڏھن	kˌəɖəhˈʌn
سستي	sˈʌst̪i
هدايتون	hˌədaːit̪ˈoːn
حنفي	hənˈʌfi
پنڌ	pˈʌndʰ
موڪلڻ	mˌoːkəlˈʌɳ
موومينٽ	mʋˌoːminˈʌʈ
سڌيون	sədʰjˈoːn
رضه	rəzˈʌh
هوم	hˈoːm
ڏيکاريا	ɖeːkʰˈaːrjaː
سازي	sˈaːzi
قرضن	qˌərəzˈʌn
مؤثر	mˌəa͡ʊsˈʌr
خشڪي	xəʃˈʌki
گذاريندا	ɡˌəzaːrˈiːndaː
نابالغ	naːbˈaːləɣ
ٻاونجاهه	bˌaːoːnɟaːhˈʌh
مصرعون	mˌəʂraːˈoːn
سياستدانن	sjˌaːst̪ədaːnˈʌn
شاخن	ʃaːxˈʌn
ڊپٽي	ɖəpˈʌʈi
ويئي	ʋˈeːi
ٿي	tʰi
اٺن	aʈʰˈʌn
نئن	nˈʌn
پیدا	pˈeːdaː
ڪڻڪ	kəɳˈʌk
ڌارا	dʰˈaːraː
ڏوهي	ɖˈoːhi
کاڌ	kʰˈaːdʰ
خوشگوار	xˈʊʃɡʋaːr
مارجي	maːrˈʌɟi
خطن	xətˈʌn
رني	rˈʌni
پرسرام	pˌərəsrˈaːm
شاهہ	ʃaːhˈʌh
ٺھيل	ʈʰˈʌhjal
دٻائڻ	dˌəbaːˈɪɳ
پٽيل	pˈʌʈjal
قبول	qəbˈoːl
محور	məhˈoːr
بابر	bˈaːbɪr
وقتي	ʋəqˈʌt̪i
ٽپو	ʈˈʌpoː
پورن	poːrˈʌn
سنگهڻ	sˌənɡəhˈʌɳ
شرف	ʃərˈʌf
نوي	nʋˈeː
نوري	nˈoːri
گلزار	ɡˌəlzˈaːr
وقتن	ʋˌəqət̪ˈʌn
مشهوري	mˌəʃhˈuːri
غرض	ɣərˈʌz
قانوني	qaːnˈoːni
چيٽ	cˈeːʈ
ملڪيتون	mˌəlkit̪ˈoːn
فارسي	faːrˈʌsi
وجود	ʋəɟˈoːd
حفص	həfˈʌʂ
سندرو	səndˈʌroː
رهنما	rˌəhənˈʌmaː
عبدالرزاق	ˌabdˌaːlərzˈaːq
اڳيان	aɡjˈaːn
چيئرمئن	ceːˈɪrəmˌən
ڪپڙو	kəpˈʌr.oː
آڻيندا	aːɳˈiːndaː
لڌي	lˈʌdʰi
ڳالهائي	ɡˌaːlhˈaːi
ملائيشيا	mˌəlaːˈiːʃjaː
راولپنڊي	rˌaːoːləpˈʌnɖi
ڇڪتاڻ	cʰˌəkt̪ˈaːɳ
جيڪر	ɟeːkˈʌr
کنيو	kʰˈʌnjoː
لازمي	laːzˈʌmi
تاجڪ	t̪aːɟˈʌk
پرنٽر	pˌərənəʈˈʌr
سرشار	sˌərʃˈaːr
سڌارڪ	sˌədʰaːrˈʌk
الھيار	ˌalhjˈaːr
ڄمون	ɟəmˈoːn
تحفته	t̪ˌəhəfət̪ˈʌh
کیا	kʰjˈaː
پلستر	pˌələst̪ˈʌr
ايجاد	eːɟˈaːd
ڏوھاري	ɖoːhˈaːri
بسم	bəsˈʌm
پيپلزپارٽي	pˌeːpəlˌəzpaːrˈʌʈi
فرش	fərˈʌʃ
اندرئين	ˌandərˈiːn
ڄميل	ɟˈʌmjal
ميوزيم	mjoːzˈiːm
آني	ˈaːni
سمجهڻ	sˌəməɟəhˈʌɳ
شاعرن	ʃaːˈaːɪrn
پڪڙ	pəkˈʌr.
رڍ	rˈʌɖʰ
ويهڻ	ʋeːhˈʌɳ
هوائي	hʋˈaːi
سلطنت	sˌələtənˈʌt̪
مولوي	mˈoːlʋi
عظيم	aʐˈiːm
سختي	sˈʌxt̪i
نگورنو	nˌəɡoːrˈʌnoː
سگهيو	səɡˈʌhjoː
يونيسڪو	jˌoːnisˈʌkoː
جعفر	ɟaːfˈʌr
اڀريو	abʰˈʌrjoː
ديدار	deːdˈaːr
شهزادي	ʃˌəhəzˈaːdi
ڪرايل	kərˈaːjal
چالاڪ	caːlˈaːk
مشڪن	mˌəʃəkˈʌn
وايون	ʋaːjˈoːn
ڳالهين	ɡˌaːlhˈiːn
تحقيق	t̪ˌəhqˈiːq
عبدالستار	ˌabdˌaːlst̪ˈaːr
سئو	sˈʌoː
جامع	ɟˈaːmeː
ڪمپيئر	kˌəmpiˈɪr
هڏا	hˈʌɖaː
جھڙيون	ɟˌəhr.jˈoːn
ٻاري	bˈaːri
نفيس	nəfˈiːs
عھد	ahˈʌd
فضا	fˈʌzaː
جاچ	ɟˈaːc
ھيرو	hˈeːroː
اپر	apˈʌr
چڙهڻ	cˌər.əhˈʌɳ
لينن	leːnˈʌn
رسد	rəsˈʌd
ڍنڍون	ɖʰˌənɖʰˈoːn
کان	kʰˈãː
گهڻ	ɡəhˈʌɳ
پسائي	pəsˈaːi
مشابهت	mˌəʃaːbəhˈʌt̪
سزا	sˈʌzaː
پوپ	pˈoːp
ڪرشن	kˌərəʃˈʌn
اترئين	ˌat̪ərˈiːn
جامعه	ɟaːmˈaːh
ڏکڻ	ɖəkʰˈʌɳ
ڏندڻ	ɖəndˈʌɳ
ترغيب	t̪ˌərɣˈiːb
تصوف	t̪əʂˈoːf
رضاڪار	rˌəzaːkˈaːr
منڊل	mənɖˈʌl
شخص	ʃˈaxʂ
نيٽو	nˈeːʈoː
ٻرندڙ	bˌərəndˈʌr.
ارشاد	ˌarʃˈaːd
چاڙهه	cˌaːr.əhˈʌh
لاکي	lˈaːkʰi
سومرو	soːmˈʌroː
پينٽنگ	pˌeːnəʈˈʌnɡ
واعدو	ʋaːˈaːdoː
سرڪٽ	sˌərəkˈʌʈ
پرچي	pˈʌrci
ناٽيڪل	nˌaːʈikˈʌl
اڏامندڙ	ˌaɖaːməndˈʌr.
هنن	hənˈʌn
اربين	ˌarbˈiːn
نوعيت	nʋaːˈiːt̪
وڌايو	ʋədʰˈaːjoː
بانيڪارن	bˈaːnikˌaːrən
ڪفايت	kˌəfaːˈiːt̪
جاکوڙ	ɟaːkʰˈoːr.
تون	t̪ˈoːn
ڌا	dʰˈaː
هٿان	hətʰˈaːn
بنت	bənˈʌt̪
سھراب	sˌəhrˈaːb
ٻري	bˈʌri
خارش	xaːrˈʌʃ
ڪاروباري	kˌaːroːbˈaːri
ڪيڙن	keːr.ˈʌn
ڪاغذن	kˌaːɣəzˈʌn
قوس	qˈoːs
پوڪرداس	pˌoːkrdˈaːs
ڪي	kˈeː
سوز	sˈoːz
هدايتن	hˌədaːit̪ˈʌn
چالو	cˈaːloː
لنگ	lˈʌnɡ
الحاق	ˌalhˈaːq
سوين	sʋˈeːn
ڊيوڊ	ɖjˈoːɖ
ھڻڻ	həɳˈʌɳ
هاسٽل	hˌaːsəʈˈʌl
مٽاسٽا	mˌəʈaːsˈʌʈaː
ڀونگر	bʰoːnɡˈʌr
خاڪي	xˈaːki
رکندي	rəkʰˈʌndi
تحفو	t̪əhˈʌfoː
حامي	hˈaːmi
سچائي	səcˈaːi
ازخود	ˌazxˈoːd
کلاڙي	kʰəlˈaːr.i
ناڪاري	naːkˈaːri
پوندو	pˈoːndoː
ڪوريائي	koːrjˈaːi
منظوم	mˌənʐˈuːm
زينت	zeːnˈʌt̪
ميرپور	mˌeːrpˈoːr
سپت	səpˈʌt̪
ڳوٺاڻن	ɡˌoːʈʰaːɳˈʌn
ڪيناڊا	keːnˈaːɖaː
ٺهيا	ʈʰˈʌhjaː
ڄاوا	ɟˈaːʋaː
سلمان	sˌəlmˈaːn
هرهڪ	hˌərəhˈʌk
کڻندا	kʰəɳˈʌndaː
فوجين	foːɟˈiːn
اھڙيون	ˌahr.jˈoːn
ڪشمير	kˌəʃmˈiːr
رائيٽر	rˌaːiʈˈʌr
پايون	paːjˈoːn
بيري	bˈeːri
صدارت	ʂˌədaːrˈʌt̪
پھتو	pəhˈʌt̪oː
قلعن	qəlˈaːn
ڊائون	ɖaːˈoːn
ايڪس	eːkˈʌs
وجهه	ʋˌəɟəhˈʌh
آدم	aːdˈʌm
گذارش	ɡˌəzaːrˈʌʃ
پئسن	pəsˈʌn
اجاگر	ˌaɟaːɡˈʌr
ساڄي	sˈaːɟi
ڇپيو	cʰˈʌpjoː
اهي	ˈɪheː
ڇانوڻي	cʰaːnˈoːɳi
برپا	bərˈʌpaː
ڪمشنر	kˌəməʃənˈʌr
گھرو	ɡʰˈʌroː
صوتي	ʂˈoːt̪i
آريه	aːrˈiːh
ٺيڪي	ʈʰˈeːki
رياضت	rjaːzˈʌt̪
ناراض	naːrˈaːz
عبرت	ˌabərˈʌt̪
مهار	məhˈaːr
ڏسبو	ɖˌɪsbˈoː
ڏاڪي	ɖˈaːki
وغيره	ʋˌəɣirˈʌh
اجرڪ	ˌaɟərˈʌk
فلاسافي	fˌəlaːsˈaːfi
افغانستان	ˌafɣaːnˈɪstaːn
چاڳلا	caːɡˈʌlaː
مايوس	maːjˈoːs
انفراديت	ˌanəfraːdˈiːt̪
انڊسٽري	ˌɪnɖasʈˈʌri
نسيم	nəsˈiːm
باقراڻي	bˈaːqrˌaːɳi
بيان	bjˈaːn
ڇھين	cʰəhˈiːn
خون	xˈoːn
کپن	kʰəpˈʌn
رابطي	raːbˈʌti
بدر	bədˈʌr
موٽر	moːʈˈʌr
هتي	hˈʌt̪i
ڍنڍن	ɖʰˌənəɖʰˈʌn
تهن	t̪əhˈʌn
جتوئي	ɟət̪ˈoːi
شناس	ʃənˈaːs
صديقي	ʂədˈiːqi
مارٽن	mˌaːrəʈˈʌn
خطو	xˈʌtoː
اهڙا	ahˈʌr.aː
آدي	ˈaːdi
هري	hˈʌri
معاملن	mˌaːməlˈʌn
پو	pˈoː
زنداوستا	zˈɪndaːˌoːst̪aː
ڳولهي	ɡoːlˈʌhi
اسرائيل	ˌasrˈaːjal
سيراب	seːrˈaːb
رھائشي	rˌəhaːˈɪʃi
ورهائڻ	ʋˌərhaːˈɪɳ
خلطن	xˌələtˈʌn
ڪليسا	kəlˈiːsaː
ڊاڪٽريٽ	ɖˌaːkəʈrˈiːʈ
بچائڻ	bˌəcaːˈɪɳ
مزاج	məzˈaːɟ
سانگھڙ	saːnɡʰˈʌr.
سرمائي	sˌərmˈaːi
مالا	mˈaːlaː
انهن	ˌanəhˈʌn
ھينري	heːnˈʌri
شبد	ʃəbˈʌd
خودڪار	xˈʊdkaːr
ڪڙي	kˈʌr.i
پنهنجو	pˈʌ̃hnɟoː
باراني	bˈaːraːnˌiː
شماري	ʃəmˈaːri
حمزه	hˌəməzˈʌh
وسڻ	ʋəsˈʌɳ
اس	ˈas
ڌارين	dʰaːrˈiːn
سڄڻ	səɟˈʌɳ
پولينڊ	poːlˈiːnɖ
روپيا	rˈoːpjaː
وڏين	ʋəɖˈiːn
جديد	ɟədˈiːd
پڙهيائين	pˌər.hjaːˈiːn
من	mˈʌn
ٻرڙي	bərˈʌr.i
رويي	rʋjˈeː
ٻانھن	bˈaːnhn
شاھراھ	ʃˌaːhrˈaːh
سمجھڻ	sˌəməɟəhˈʌɳ
نائب	naːˈɪb
منور	mənˈoːr
ليول	ljˈoːl
ڪاميابي	kˌaːmjaːbˈiː
سربراهه	sˌərəbraːhˈʌh
دفتر	dˌəfət̪ˈʌr
دريون	dərjˈoːn
ھٿيار	hətʰjˈaːr
گهوٽڪي	ɡˌəhoːʈˈʌki
کوهه	kʰoːhˈʌh
ڦاسي	pʰˈaːsi
گرين	ɡərˈiːn
ڏک	ɖˈʌkʰ
ڪوٺي	kˈoːʈʰi
ٻوڙي	bˈoːr.i
سگھڙ	səɡʰˈʌr.
العلماء	ˌalaːlˈʌmaː
زير	zˈeːr
آسٽريا	ˌaːsəʈˈʌrjaː
پوٽا	pˈoːʈaː
هزار	həzˈaːr
وٺن	ʋəʈʰˈʌn
خالد	xaːlˈʌd
ورڪس	ʋˌərəkˈʌs
چڱيون	cˌəŋ̩jˈoːn
چرخي	cərˈʌxi
ايپ	ˈeːp
ليکيا	lˈeːkʰjaː
گجراتي	ɡˌəɟrˈaːt̪i
ميگزين	mˌeːɡzˈiːn
سٽن	səʈˈʌn
باهمي	bˈaːhəmˌiː
ڪيڏانهن	kˌeːɖaːnəhˈʌn
اقليت	ˌaqlˈiːt̪
تيل	t̪ˈeːl
کنڊن	kʰənɖˈʌn
جزن	ɟəzˈʌn
آهيون	aːhjˈoːn
مولچند	mˌoːləcˈʌnd
مڇيون	məcʰjˈoːn
صوبدار	ʂˌuːbdˈaːr
رکندو	rəkʰˈʌndoː
سهائتا	sˌəhaːˈɪt̪aː
ڄاڻائي	ɟaːɳˈaːi
مهاجرن	mˌəhaːɟərˈʌn
لفظن	lˌəfəʐˈʌn
جايون	ɟaːjˈoːn
درجي	dˈarɟi
گرھن	ɡˌərəhˈʌn
رستن	rəst̪ˈʌn
سياست	sjˈaːst̪
ديوار	djʋˈaːr
تشڪيل	t̪əʃˈʌkjal
سرس	sərˈʌs
سبق	səbˈʌq
پوکي	pˈoːkʰi
طوھر	toːhˈʌr
ڊگهين	ɖˌəɡhˈiːn
جارج	ɟaːrˈʌɟ
اگهن	ˌaɡəhˈʌn
مادو	mˈaːdoː
جيم	ɟˈeːm
وسائي	ʋəsˈaːi
سميجو	səmˈiːɟoː
بورڊنگ	bˈoːrəɖˌənɡ
ڏاهر	ɖaːhˈʌr
نسلي	nəsˈʌli
بينظيرآباد	bˈeːnʐˌiːraːbˈaːd
ڄاڻايل	ɟaːɳˈaːjal
جيلاني	ɟeːlˈaːni
زحل	zəhˈʌl
مار	mˈaːr
ايليٽ	eːlˈiːʈ
درياخان	dˌərjaːxˈaːn
نفسيات	nˌəfsiˈaːt
معطل	maːtˈʌl
چارئي	caːrˈʌi
جمھوريت	ɟˌəmhuːrˈiːt̪
نشاندهي	nɪʃˈaːndəhˌiː
مقبول	mˌəqbˈuːl
ھڪدم	hˌəkədˈʌm
پڙهائڻ	pˌər.haːˈɪɳ
پگهار	pˌəɡhˈaːr
روايتي	rʋaːˈiːt̪i
عزيز	azˈiːz
خورشيد	xˌoːrʃˈiːd
سلسلن	sˈɪlsˌɪln
سمي	sˈʌmi
پ	pˈeː
منگي	mˈʌnɡi
ڪرندڙ	kˌərəndˈʌr.
قدمن	qˌədəmˈʌn
هاڻ	hˈaːɳ
ھنڌن	həndʰˈʌn
چئو	cˈʌoː
ناني	nˈaːni
گهراڻن	ɡˌəhəraːɳˈʌn
ڀاڻس	bʰaːɳˈʌs
ميجر	meːɟˈʌr
اڏاوت	ˌaɖaːˈoːt̪
پوپٽي	poːpˈʌʈi
ڀيل	bʰˈeːl
لب	lˈʌb
نظريو	naʐˈarjoː
تناظر	t̪ˌənaːʐˈʌr
ھئا	hˈʌaː
بلندي	bəlˈʌndi
منشور	mˌənʃˈuːr
غيرآباد	ɣˌeːraːbˈaːd
ورتو	ʋərˈʌt̪oː
ڪارخانا	kˌaːrxˈaːnaː
ضلعي	zəlˈaːi
پڙھڻ	pər.hˈʌɳ
طنزيه	tˌənzˈiːh
پاسيرو	paːsˈiːroː
ورتائين	ʋˌərt̪aːˈiːn
اوج	ˈuːɟ
ھليو	hˈʌljoː
بين	bˈeːn
ورھائجي	ʋˌərhaːˈɪɟi
پورچوگيز	pˌoːrcoːɡˈiːz
وزن	ʋəzˈʌn
شاھہ	ʃaːhˈʌh
پبلڪيشن	pˌəbəlkiʃˈʌn
مهرون	mˌəhərˈuːn
شالا	ʃˈaːlaː
ڪنگ	kˈʌnɡ
اڻ	ˈaɳ
ناسي	nˈaːsi
ڀريا	bʰˈʌrjaː
کوٽ	kʰˈoːʈ
اداڪارائن	ˌadaːkˌaːraːˈɪn
بالڪل	bˈaːləkˌəl
وڄايو	ʋəɟˈaːjoː
ٿينديون	tʰĩːdjˈoːn
بدلائڻ	bˌədlaːˈɪɳ
برساتن	bˌərsaːt̪ˈʌn
نٽشي	nəʈˈʌʃi
پسندن	pˌəsəndˈʌn
سببان	sˌəbbˈaːn
ڪيرائڻ	kˌeːraːˈɪɳ
مايو	mˈaːjoː
اونهي	uːnˈʌhi
اوائل	ˌuːaːˈɪl
وڌندڙ	ʋˌədʰəndˈʌr.
ڇاڻ	cʰˈaːɳ
ايٽم	eːʈˈʌm
سچل	səcˈʌl
ڪنٽرول	kˌənəʈrˈoːl
گھيري	ɡʰˈeːri
ضلع	zˈʌlaː
توهان	t̪oːhˈaːn
ملھ	məlˈʌh
مقالات	mˌəqaːlˈaːt
ڦاهي	pʰˈaːhi
سهڪار	sˌəhəkˈaːr
تعاون	t̪aːˈoːn
ٿيٽر	tʰeːʈˈʌr
اسد	asˈʌd
انتظامي	ˌɪntɪʐˈaːmi
ديس	dˈeːs
دلڪش	dˌələkˈʌʃ
ملايو	məlˈaːjoː
رھندا	rəhˈʌndaː
جارجيا	ɟaːrˈʌɟjaː
کري	kʰˈʌri
مشڪل	mˌəʃəkˈʌl
ڪعب	kˈaːb
پڇاڙي	pəcʰˈaːr.i
پانڊون	paːnɖˈoːn
اڳواڻي	aɡʋˈaːɳi
ڪر	kˈʌr
آيون	aːjˈoːn
اوزار	uːzˈaːr
ناڪام	naːkˈaːm
توحيد	t̪oːhˈiːd
ڪچهريون	kˌəcəhərjˈoːn
ماھوار	maːhʋˈaːr
زخمن	zˌəxəmˈʌn
ڪرائون	kˌəraːˈoːn
نوراني	noːrˈaːni
جوڙيل	ɟˈoːr.jal
دور	dˈoːr
ظفر	ʐəfˈʌr
حڪيمن	hˌəkimˈʌn
ٻهراڙين	bˌəhəraːr.ˈiːn
آشرم	ˌaːʃərˈʌm
رستو	rˈʌst̪oː
پهچ	pəhˈʌc
مخصوص	mˌəxʂˈuːʂ
اقتصادي	ˌɪqtɪʂˈaːdi
ڳالھائيندا	ɡˌaːlhaːˈiːndaː
وائي	ʋˈaːi
يونان	joːnˈaːn
مد	mˈʌd
ثابتي	saːbˈʌt̪i
کوجنا	kʰoːɟˈʌnaː
صفر	ʂəfˈʌr
ٺهرائڻ	ʈʰˌəhəraːˈɪɳ
اڃان	aɲˈaːn
عبدالغفور	ˌabdˌaːləɣfˈoːr
ڪلھوڙا	kˌəlhˈuːr.aː
گلابي	ɡˌəlaːbˈiː
ڏهون	ɖəhˈoːn
وسلم	ʋˌəsəlˈʌm
ليمي	lˈeːmi
چڪاس	cəkˈaːs
معقول	maːqˈoːl
ڊگھا	ɖˈʌɡʰaː
خاموش	xaːmˈoːʃ
والٽئر	ʋˌaːləʈˈʌr
نظرن	naʐˈarn
موبائيل	moːbˈaːjal
کاڌو	kʰˈaːdʰoː
نرالو	nərˈaːloː
راڻو	rˈaːɳoː
جوڙجڪ	ɟˌoːr.əɟˈʌk
اھميت	ˌahmˈiːt̪
سالڪ	saːlˈʌk
فوٽان	foːʈˈaːn
چانھن	cˈaːnhn
ٺاهيو	ʈʰˈaːhjoː
جوڊيشل	ɟˌoːɖiʃˈʌl
ڏهن	ɖəhˈʌn
ڪتو	kˈʌt̪oː
صفائي	ʂəfˈaːi
آئينو	aːˈiːnoː
صلاح	ʂˈʌlaːh
مدرسن	mˌədərəsˈʌn
دهلي	dəhˈʌli
بلاڪ	bəlˈaːk
پڪين	pəkˈiːn
شعور	ʃaːˈoːr
ٽڪراء	ʈəkˈʌraː
سوڀي	sˈoːbʰi
ڪيلو	kˈeːloː
الطاف	ˌaltˈaːf
ڪوچ	kˈoːc
لغاري	ləɣˈaːri
چھري	cəhˈʌri
وچڙ	ʋəcˈʌr.
هانگ	hˈaːnɡ
گذارڻ	ɡˌəzaːrˈʌɳ
ساهي	sˈaːhi
عيد	aˈiːd
دريائن	dˌərjaːˈɪn
بانسري	bˈaːnsərˌiː
جميل	ɟˈʌmjal
ڪالوني	kaːlˈoːni
اسود	asˈoːd
سوراخن	sˌoːraːxˈʌn
چال	cˈaːl
مهارت	mˌəhaːrˈʌt̪
موتمار	mˌoːt̪mˈaːr
هٽائي	həʈˈaːi
ٽنگن	ʈənɡˈʌn
چندن	cəndˈʌn
پيداوار	pˌeːdaːʋˈaːr
اسٽائيل	ˌasʈˈaːjal
لهي	lˈʌhi
لوهي	lˈoːhi
خداآباد	xˌədaːaːbˈaːd
مودي	mˈoːdi
سڏجن	sˌəɖəɟˈʌn
بيهاريو	bˈeːhaːrjˌoː
موجد	moːɟˈʌd
ھوا	hʋˈaː
سارا	sˈaːraː
سمجهاڻي	sˌəməɟhˈaːɳi
لنڊن	lənɖˈʌn
وڏيون	ʋəɖjˈoːn
پانيل	pˈaːnjal
راتيون	raːt̪jˈoːn
مشترڪه	mˌəʃt̪ərəkˈʌh
اوڀر	uːbʰˈʌr
الفابيٽ	ˌalfaːbˈiːʈ
صفراوي	ʂˌəfrˈaːʋi
چپن	cəpˈʌn
تحريڪن	t̪ˌəhrikˈʌn
هجن	hˈʊɟan
رفتي	rˈafətˌiː
جيوت	ɟjˈoːt̪
پيون	pjˈoːn
بلال	bəlˈaːl
دراني	dərˈaːni
پناهگيرن	pˌənaːhˌəɡirˈʌn
گھر	ɡʰˈʌr
رابطو	raːbˈʌtoː
عمرڪوٽ	ˈʊmrkoːʈ
دستن	dəst̪ˈʌn
انڊلٺ	ˌɪnɖəlˈʌʈʰ
ڇڏيائون	cʰˌəɖjaːˈoːn
وڍ	ʋˈʌɖʰ
اوچي	ˈuːci
ڏيکاريندا	ɖˌeːkʰaːrˈiːndaː
مجسمو	mˌəɟəsˈʌmoː
مشهور	mˌəʃhˈuːr
ڳوٺاڻي	ɡoːʈʰˈaːɳi
ساڳئي	saːɡˈʌi
کڻڻ	kʰəɳˈʌɳ
مشڪلاتن	mˌəʃəklaːt̪ˈʌn
شھادت	ʃˌəhaːdˈʌt̪
ٻوٽو	bˈoːʈoː
ريپبلڪ	rˌeːpəbəlˈʌk
ساٿ	sˈaːʈ
ٻاھرين	bˌaːhrˈiːn
عدالت	ˌadaːlˈʌt̪
چيلهه	cˌeːləhˈʌh
ائٽم	aʈˈʌm
مختيار	məxt̪jˈaːr
نئشنل	nˌəʃənˈʌl
نسبت	nˌəsəbˈʌt̪
ھندوستان	hˌənduːst̪ˈaːn
سهولت	sˌəhoːlˈʌt̪
انفرادي	ˌanəfrˈaːdi
اينگلو	eːnɡˈʌloː
غريب	ɣərˈiːb
گوادر	ɡʋaːdˈʌr
سائنسز	sˌaːɪnsˈʌz
آمدورفت	ˌaːmdˌoːrəfˈʌt̪
ورڪ	ʋərˈʌk
نيوڪليائي	njˌoːkljˈaːi
فيسٽيول	fˌeːsʈjˈoːl
عمارتن	ˌamaːrət̪ˈʌn
هلايو	həlˈaːjoː
وڪري	ʋəkˈʌri
افسانا	ˌafsˈaːnaː
رڪاوٽ	rˌəkaːˈoːʈ
موروثي	moːrˈoːsi
دوائون	dʋaːˈoːn
سعادت	saːdˈʌt̪
والاري	ʋaːlˈaːri
ترڪي	t̪ərˈʌki
ميسوپوٽيميا	mˌeːsoːpoːʈˈiːmjaː
مورثي	moːrˈʌsi
قسطن	qˈɪstn
بشمول	bˌəʃmˈuːl
مهذب	mˌəhəzˈʌb
پنهنجا	pˈʌ̃hnɟaː
ٿوهر	tʰoːhˈʌr
پهڻ	pəhˈʌɳ
وقت	ʋˈaqt
نيڪال	neːkˈaːl
پوڄاري	poːɟˈaːri
رکيل	rˈʌkʰjal
لقب	ləqˈʌb
غازي	ɣˈaːzi
اکرن	ˌakʰərˈʌn
قبرص	qˌəbərˈʌʂ
تصورن	t̪ˌəʂoːrˈʌn
دانشور	dˌaːnʃˈoːr
پاس	pˈaːs
ذهني	zəhˈʌni
غلبي	ɣˌəlbˈiː
نظم	nəʐˈʌm
ڪراس	kərˈaːs
فرقو	fərˈʌqoː
مسواڙ	məsʋˈaːr.
ڏھين	ɖəhˈiːn
بت	bˈʌt̪
سڳوري	səɡˈoːri
گاني	ɡˈaːni
سدائين	sˌədaːˈiːn
سائمن	sˌaːɪmˈʌn
ڳنڍيو	ɡənˈʌɖʰjoː
شپ	ʃˈʌp
جهنڊ	ɟəhˈʌnɖ
ڳالهائيندا	ɡˌaːlhaːˈiːndaː
لفظ	lˈafʐa
جيئي	ɟˈeːi
ڪنس	kˈʌns
جھوڪ	ɟəhˈoːk
ڪهڙو	kəhˈʌr.oː
جڳهن	ɟˌəɡəhˈʌn
ڳائيندا	ɡaːˈiːndaː
مقبرن	mˌəqəbərˈʌn
تنت	t̪ənˈʌt̪
زم	zˈʌm
بندوبست	bˌənduːbˈʌst̪
آيتون	ˌaːit̪ˈoːn
ملڪه	mˌələkˈʌh
انڌو	ˈandʰoː
چيائون	cjaːˈoːn
سهاري	səhˈaːri
خاڪو	xˈaːkoː
ماحولياتي	mˌaːhoːljˈaːt̪i
الدين	ˌaldˈiːn
ڳائبي	ɡˌaːɪbˈiː
رومي	rˈoːmi
حلف	həlˈʌf
دٻدٻي	dˌəbədˈʌbi
بهرام	bˌəhərˈaːm
ڪليات	kˌəliˈaːt
ٻارهن	bˌaːrəhˈʌn
مزور	məzˈoːr
البته	ˌaləbət̪ˈʌh
علی	ˈali
هٿياربند	hˌətʰjaːrəbˈʌnd
رجسٽرڊ	rˌəɟəsˌəʈərˈʌɖ
تعميراتي	t̪ˌaːmirˈaːt̪i
جوڌپور	ɟˌoːdʰpˈoːr
ٻانهن	bˌaːnəhˈʌn
تباھ	t̪əbˈaːh
ساقي	sˈaːqi
سوچڻ	soːcˈʌɳ
سمجھيو	sˈamɟʰjoː
خالق	xaːlˈʌq
ڪهڙا	kəhˈʌr.aː
مڪو	mˈʌkoː
سيوهڻ	sjoːhˈʌɳ
تختگاهه	t̪ˌəxt̪əɡaːhˈʌh
تند	t̪ˈʌnd
سھولت	sˌəhoːlˈʌt̪
اصلوڪا	ˌaʂlˈoːkaː
مشھوري	mˌəʃhˈuːri
غفار	ɣəfˈaːr
گهاري	ɡəhˈaːri
پابندي	paːbˈʌndi
مقابلو	mˌəqaːbˈʌloː
ٺارو	ʈʰˈaːroː
زبانون	zəbˈaːnoːn
اليڪشن	ˌalikəʃˈʌn
تاحيات	t̪ˌaːhiˈaːt
مالٽا	maːlˈʌʈaː
ٻچا	bˈʌcaː
مري	mˈʌri
پاتل	paːt̪ˈʌl
صاحبه	ʂˌaːhəbˈʌh
تاريخون	t̪ˌaːrixˈoːn
مڙني	mər.ˈʌni
ڪرين	kərˈiːn
دائري	daːˈɪri
اسپيس	ˌaspˈiːs
ڄاري	ɟˈaːri
ڦرندي	pʰərˈʌndi
وبا	ʋəbˈaː
حڪومتون	hˌəkoːmt̪ˈoːn
مرمت	mˌərəmˈʌt̪
جوانن	ɟˈaʋaːnˌən
رسالو	rəsˈaːloː
ماپن	maːpˈʌn
پلو	pˈʌloː
ٽوڙ	ʈˈoːr.
افروز	ˌafrˈoːz
حيثيت	heːsˈiːt̪
بابت	bˈaːbɪt̪
باد	bˈaːd
وڏو	ʋˈʌɖoː
ويهه	ʋeːhˈʌh
فھرست	fˌəhərˈʌst̪
ڪلھوڙي	kˌəlhˈuːr.i
چارج	caːrˈʌɟ
صغير	ʂəɣˈiːr
انتظام	ˌɪntɪʐˈaːm
ٻہ	bˈʌh
فيصلو	feːʂˈʌloː
جڳھ	ɟəɡˈʌh
فوجي	fˈoːɟi
مها	mˈʌhaː
رشوت	rəʃˈoːt̪
عاشق	aːʃˈʌq
تندن	t̪əndˈʌn
نانو	nˈaːnoː
ثاني	sˈaːni
رحمان	rˌəhmˈaːn
بار	bˈaːr
وفاق	ʋəfˈaːq
نثر	nəsˈʌr
وآله	ʋaːlˈʌh
قومي	qˈoːmi
پرچار	pərcˈaːr
پهرين	pˌəhərˈiːn
ايڊيوڪيشنل	ˌeːɖjoːkˌiːʃənˈʌl
چيئر	ceːˈɪr
نانگن	naːnɡˈʌn
آرڪڊ	ˌaːrəkˈʌɖ
پهلو	pəhˈʌloː
ٽيهه	ʈeːhˈʌh
محيط	məhˈiːt
بينظير	bˈeːnʐˌiːr
اپ	ˈap
مدي	mˈʌdi
ساون	saːˈoːn
مودودي	moːdˈoːdi
نڀايو	nəbʰˈaːjoː
چترال	cˌət̪rˈaːl
ٿڙ	ʈˈʌr.
ليٽويا	lˈeːʈʋjaː
ملازم	mˌəlaːzˈʌm
مصطفي	mˌəʂətˈʌfi
ڏاڙهون	ɖˌaːr.hˈoːn
شھري	ʃəhˈʌri
آخرين	ˌaːxrˈiːn
آسمان	ˌaːsmˈaːn
سائيٽ	saːˈiːʈ
ملڪيت	mˌəlkˈiːt̪
پلان	pəlˈaːn
ڇڪ	cʰˈʌk
بابو	bˈaːbˈoː
اداڪار	ˌadaːkˈaːr
نشي	nˈʌʃi
جهڙو	ɟəhˈʌr.oː
وڇوڙي	ʋəcʰˈoːr.i
يڪدم	jˌəkədˈʌm
لارڊ	laːrˈʌɖ
الخط	ˌaləxˈʌt
نام	nˈaːm
ٻاھر	baːhˈʌr
ڀٽائي	bʰəʈˈaːi
ذاتيون	zaːt̪jˈoːn
تعين	t̪aːˈiːn
دالين	daːlˈiːn
اسڪالرشپ	ˌaskˌaːlərəʃˈʌp
سنگل	sənɡˈʌl
سائوٿ	saːˈoːʈ
هندي	hˈɪndi
کڻندڙ	kʰˌəɳəndˈʌr.
بخشڻ	bˌəxəʃˈʌɳ
تجارت	t̪ˌəɟaːrˈʌt̪
ڊپلوما	ɖˌəplˈuːmaː
ڀيرو	bʰˈeːroː
گاهه	ɡaːhˈʌh
گوري	ɡˈoːri
منصوبي	mˌənʂuːbˈiː
جل	ɟˈʌl
مياڻ	mjˈaːɳ
قديم	qədˈiːm
ٽيبل	ʈeːbˈʌl
قباچي	qəbˈaːci
دهشت	dəhˈʌʃt̪
گهراڻي	ɡˌəhərˈaːɳi
ٻاهريان	bˌaːhərjˈaːn
جيڪڏهن	ɟˌeːkəɖəhˈʌn
انسائيڪلو	ˌansaːikˈʌloː
واضع	ʋˈaːzeː
زال	zˈaːl
بي	bˈeː
خشڪ	xəʃˈʌk
صبغت	ʂˌəbəɣˈʌt̪
چٽا	cˈʌʈaː
فساد	fəsˈaːd
افسانن	ˌafsaːnˈʌn
وڃان	ʋəɲˈaːn
ڪرمنل	kˌərəmənˈʌl
ماڻڪاڻي	mˌaːɳkˈaːɳi
آرامگاهه	ˌaːraːmɡaːhˈʌh
ڪوئپر	koːˈɪpər
ڪاپيون	kaːpjˈoːn
مهن	məhˈʌn
آرٽس	ˌaːrəʈˈʌs
ادائگي	ˌadaːˈɪɡi
خدمت	xˌədəmˈʌt̪
ٻاھران	bˌaːhrˈaːn
ڏوري	ɖˈoːri
لنگهه	lˌənɡəhˈʌh
آڇ	ˈaːcʰ
رھندڙ	rˌəhəndˈʌr.
وايو	ʋˈaːjoː
فرد	fˈʌrd
منصوري	mˌənʂˈuːri
عابد	aːbˈʌd
ريڪجاويڪ	rˌeːkɟaːʋˈiːk
يار	jˈaːr
مندر	məndˈʌr
فهم	fəhˈʌm
جمهوري	ɟˌəmhˈuːri
نيشنل	nˌeːʃənˈʌl
گيڙو	ɡˈeːr.oː
بدل	bədˈʌl
خزاني	xəzˈaːni
لڪل	ləkˈʌl
اٽڪ	aʈˈʌk
ريلوي	rˈeːlʋi
جهڙين	ɟˌəhər.ˈiːn
هڏين	həɖˈiːn
ڊويزنن	ɖʋˌeːzənˈʌn
اترين	ˌat̪rˈiːn
پلوٽو	pəlˈoːʈoː
ٽڪيٽ	ʈəkˈiːʈ
شھابا	ʃˌəhaːbˈaː
گهريو	ɡəhˈʌrjoː
سامي	sˈaːmi
برقعو	bˌərqˈaːoː
بيٺا	bˈeːʈʰaː
رکندڙ	rˌəkʰəndˈʌr.
اوهين	uːhˈiːn
پڳدار	pˌəɡdˈaːr
توسيع	t̪ˈoːsi
فياض	fjˈaːz
هاڻي	hˈaːɳi
تشبيهه	t̪ˌəʃbˈiːhəh
موھن	moːhˈʌn
مهمان	mˌəhəmˈaːn
پھريون	pˌəhrjˈoːn
امرت	ˌamərˈʌt̪
جٿي	ɟˈʌtʰi
ڪڙيو	kˈʌr.joː
پرچو	pˈʌrcoː
بينڪ	bˈeːnək
اولمپڪ	ˌuːləmpˈʌk
ساوا	sˈaːʋaː
نورمحمد	nˌoːrəmˌəhəmˈʌd
وڌنديون	ʋˌədʰndjˈoːn
سميت	səmˈiːt̪
غنيمت	ɣˌənimˈʌt̪
خوردبيني	xʊɾdbˈiːni
ڏنيون	ɖˈɪnjũː
ريجنل	rˌeːɟənˈʌl
ڊگها	ɖəɡˈʌhaː
ڏنائين	ɖˌənaːˈiːn
سيزن	seːzˈʌn
العلوم	ˌalaːlˈoːm
ڏاهي	ɖˈaːhi
هاٿي	hˈaːtʰi
هينري	heːnˈʌri
ڪنيت	kənˈiːt̪
موهي	mˈoːhi
ضرب	zərˈʌb
آرو	ˈaːroː
پراجيڪٽ	pˌəraːɟikˈʌʈ
پراڻا	pərˈaːɳaː
مڃائي	məɲˈaːi
مٿانهين	mˌətʰaːnhˈiːn
علامتي	ˌalaːmˈʌt̪i
نويسن	nʋeːsˈʌn
تماڪ	t̪əmˈaːk
ڪاراڻ	kaːrˈaːɳ
درخت	dərˈʌxt̪
جاسوسي	ɟaːsˈoːsi
گڏجي	ɡəɖˈʌɟi
کيرٿر	kʰˌeːrəʈˈʌr
ميدن	meːdˈʌn
ماستر	maːst̪ˈʌr
شينهن	ʃˌeːnəhˈʌn
نڙي	nˈʌr.i
گهڙيل	ɡəhˈʌr.jal
سپر	səpˈʌr
مقدمي	mʊqˈadmi
سعيدآباد	sˌaːidaːbˈaːd
گهڻائي	ɡˌəhəɳˈaːi
چيون	cjˈoːn
ميئر	meːˈɪr
وارھ	ʋaːrˈʌh
لکن	ləkʰˈʌn
مذڪر	mʊzˈakːar
جنرل	ɟˌənərˈʌl
هٽائڻ	hˌəʈaːˈɪɳ
باني	bˈaːni
هميشه	hˌəmiʃˈʌh
اهڙي	ahˈʌr.i
چيو	cˈajoː
کوج	kʰˈoːɟ
ماحوليات	mˌaːhoːliˈaːt
مٽر	məʈˈʌr
تاري	t̪ˈaːri
اسٽوپا	ˌasʈˈoːpaː
کرج	kʰərˈʌɟ
ساڙ	sˈaːr.
حصن	həʂˈʌn
ليز	lˈeːz
ھيٺيون	heːʈʰjˈoːn
ساراهه	sˌaːraːhˈʌh
يڪسان	jˌəksˈaːn
ڪٿان	kətʰˈaːn
اجتماع	ɪɟtˈɪmaː
ڪميشن	kˌəmiʃˈʌn
چشمن	cˌəʃəmˈʌn
اخلاقي	ˌaxlˈaːqi
جي	ɟˈeː
ٽوپ	ʈˈoːp
حرم	hərˈʌm
سينا	sˈeːnaː
عهديدار	ˌahədidˈaːr
ڪلامن	kˌəlaːmˈʌn
سڀئي	səbʰˈʌi
معدني	maːdˈʌni
درٻيلي	dˌərbˈiːli
ٽاڊ	ʈˈaːɖ
قيدين	qeːdˈiːn
ٽڪنڊي	ʈəkˈʌnɖi
ڇٽي	cʰˈʌʈi
تڪڙ	t̪əkˈʌr.
ڪيترين	kˌeːt̪rˈiːn
چوٿون	coːtʰˈoːn
پھچائي	pˌəhcˈaːi
سائنسدانن	sˌaːɪnsˌədaːnˈʌn
رکبو	rˌəkʰbˈoː
سرپرست	sˌərəpərˈʌst̪
ڏاھر	ɖaːhˈʌr
داني	dˈaːni
تاريخ	t̪aːrˈiːx
گاڏيون	ɡaːɖjˈoːn
نڪي	nˈʌki
صدي	ʂˈʌdi
يڪتاري	jˌəkt̪ˈaːri
ھڏڪي	həɖˈʌki
دوهن	doːhˈʌn
اڪبر	ˌakəbˈʌr
منتشر	mˌənət̪əʃˈʌr
وڳي	ʋˈʌɡi
مثنوي	məsˈʌnʋi
سائينداد	sˌaːindˈaːd
حالانڪ	hˌaːlaːnˈʌk
ڪيرت	keːrˈʌt̪
جمعيت	ɟˌəmaːˈiːt̪
وڌائي	ʋədʰˈaːi
لاڳاپيل	laːɡˈaːpjal
اخر	axˈʌr
آهن	ˈaːhɪn
وفاداري	ʋˌəfaːdˈaːri
پڙهائيندو	pˌər.haːˈiːndoː
چپلن	cˌəpəlˈʌn
وراثت	ʋˌəraːsˈʌt̪
گروھ	ɡərˈoːh
رٿا	rˈʌtʰaː
تنظيمن	t̪ˌənʐimˈʌn
توڻي	t̪ˈoːɳi
هندستان	hɪnɖˈʊstaːn
وجهندا	ʋˌəɟəhˈʌndaː
جهونا	ɟəhˈoːnaː
سفرناما	sˌəfərnˈaːmaː
ملهائيندا	mˌəlhaːˈiːndaː
درسي	dərˈʌsi
مدرسه	mˌədərəsˈʌh
حقيقتون	hˌəqiqt̪ˈoːn
بلا	bˈʌlaː
جنون	ɟənˈoːn
راغب	raːɣˈʌb
شڌ	ʃˈʌdʰ
فلسطيني	fˌələstˈiːni
لا	lˈaː
جوڙيندو	ɟoːr.ˈiːndoː
يوروپي	joːrˈoːpi
انسائيڪلوپيڊيا	ˌansaːˌiːkloːpˈiːɖjaː
جوڙايو	ɟoːr.ˈaːjoː
پنٿ	pənˈʌʈ
پيروڪار	pˌeːroːkˈaːr
گھڻن	ɡʰəɳˈʌn
سلفر	sˌələfˈʌr
سوامي	sʋˈaːmi
بڻائڻ	bˌəɳaːˈɪɳ
طب	tˈʌb
پيٽر	peːʈˈʌr
ڪوٺيو	kˈoːʈʰjoː
لائينز	lˌaːinˈʌz
اوترو	uːt̪ˈʌroː
شخصي	ʃˈaxʂi
منھن	mˈʌnhn
ايٽلانٽڪ	ˌeːʈlˌaːnəʈˈʌk
نوڪر	noːkˈʌr
ڀڄ	bʰˈʌɟ
خودڪشي	xˈʊdkəʃˌiː
دھلي	dəhˈʌli
پٽ	pˈʌʈ
ڳالھھ	ɡˌaːləhˈʌh
ويڪسين	ʋˌeːksˈiːn
حوالن	haʋˈaːln
مروان	mərʋˈaːn
جوڙيا	ɟˈoːr.jaː
راجسٿان	rˌaːɟəstʰˈaːn
مبلغ	mˌəbəlˈʌɣ
سپريم	sˌəprˈiːm
مدو	mˈʌdoː
نيم	nˈeːm
جوش	ɟˈoːʃ
رنگي	rˈʌnɡi
گاڏي	ɡˈaːɖi
بيهندا	bˈeːhəndˌaː
کٽڻ	kʰəʈˈʌɳ
درگاھ	dˌərɡˈaːh
ويو	ʋˈajoː
نگران	nˌəɡrˈaːn
رنگن	rənɡˈʌn
ڪوٺائي	koːʈʰˈaːi
اجلاس	ˌaɟlˈaːs
جوڙا	ɟˈoːr.aː
آ	ˈaː
لهر	ləhˈʌr
ڪرڻا	kərˈʌɳaː
آڪسفورڊ	ˌaːkəsfoːrˈʌɖ
ماڻڪ	maːɳˈʌk
آرمينيائي	ˌaːrminjˈaːi
مائٽن	maːʈˈʌn
وراڻي	ʋərˈaːɳi
تفسير	t̪ˌəfsˈiːr
اومان	uːmˈaːn
ھلندي	həlˈʌndi
جنم	ɟənˈʌm
هند	hˈɪnd
فارم	faːrˈʌm
سيزر	seːzˈʌr
ڪاوڙجي	kˌaːoːr.ˈʌɟi
معاملا	maːmˈʌlaː
فيبروري	fˌeːbrˈoːri
سماٽ	səmˈaːʈ
خام	xˈaːm
سوراخ	soːrˈaːx
پروٽان	pˌəroːʈˈaːn
زميني	zəmˈiːni
تان	t̪ˈaːn
سجدو	səɟˈʌdoː
امروٽ	ˌamrˈoːʈ
بڻ	bˈʌɳ
گهوڙو	ɡəhˈoːr.oː
لساني	ləsˈaːni
ٿري	ʈˈʌri
سپاهي	səpˈaːhi
فلسفي	fˌələsˈʌfi
اسٽيفن	ˌasʈifˈʌn
فنڊ	fˈʌnɖ
بجيٽ	bəɟˈiːʈ
اثرن	ˌasərˈʌn
تنظيمون	t̪ˌənʐimˈoːn
مرهم	mˌərəhˈʌm
مسیح	mˈʌsih
بنجي	bənˈʌɟi
آڏ	ˈaːɖ
ٻوڏ	bˈoːɖ
ايسوسيئيٽ	ˌeːsoːsiˈiːʈ
رپيا	rˈʌpjaː
ٻيهر	beːhˈʌr
باقاعده	bˈaːqˈaːjdh
الاقوامي	ˌalaːqʋˈaːmi
پائلٽ	pˌaːɪlˈʌʈ
سماع	sˈʌmaː
پاڙي	pˈaːr.i
آنا	ˈaːnaː
عدالتن	ˌadaːlət̪ˈʌn
ڇڄ	cʰˈʌɟ
خاتمي	xaːt̪ˈʌmi
اخبار	ˌaxbˈaːr
بيٺل	bˈeːʈʰəl
سافٽ	saːfˈʌʈ
ڌنڌ	dʰˈʌndʰ
اثر	asˈʌr
وادين	ʋaːdˈiːn
غور	ɣˈoːr
اٿڻ	aʈˈʌɳ
وارن	ʋaːrˈʌn
بچل	bəcˈʌl
ڀاتين	bʰaːt̪ˈiːn
ستارن	sɪtˈaːrn
حديث	hədˈiːs
اڏايو	aɖˈaːjoː
مستقبل	mˌəst̪əqəbˈʌl
مغربي	mˈaɣrˌɪbi
ڇپر	cʰəpˈʌr
ڍانچي	ɖʰˈaːnci
ڦليلي	pʰəlˈiːli
کؤنر	kʰˌəa͡ʊnˈʌr
تسلط	t̪ˌəsəlˈʌt
عادي	ˈaːdi
چنانچه	cˌənaːncˈʌh
آڻ	ˈaːɳ
شيون	ʃjˈoːn
لنڪن	lˌənəkˈʌn
پنجابي	pˌənɟaːbˈiː
منش	mənˈʌʃ
ٽيون	ʈjˈoːn
سجاول	sˌəɟaːˈoːl
پوٽن	poːʈˈʌn
تڪليف	t̪ˌəklˈiːf
ساٿين	saːtʰˈiːn
رقم	rəqˈʌm
اتساهه	ˌat̪saːhˈʌh
نيٽورڪ	nˌeːʈoːrˈʌk
موسيقي	moːsˈiːqi
پوندا	pˈoːndaː
عرض	arˈʌz
خوابن	xʋaːbˈʌn
بک	bˈʌkʰ
هن	hˈɪna
چونس	cˈoːns
لڳايون	lˌəɡaːjˈoːn
طريقو	tərˈiːqoː
زيب	zˈeːb
ھتي	hˈʌt̪i
چونڊيندا	coːnɖˈiːndaː
گروپ	ɡərˈoːp
بهاري	bəhˈaːri
ادو	ˈadoː
محب	məhˈʌb
مقرر	mˌəqərˈʌr
ونسي	ʋˈʌnsi
اڄڪلهه	ˌaɟəkˌələhˈʌh
پبلڪ	pˌəbəlˈʌk
حديثون	hˌədisˈoːn
ڦيرڦار	pʰˌeːrpʰˈaːr
وي	ʋˈeː
ڪلثوم	kˌəlsˈuːm
فرضي	fərˈʌzi
ماڻھو	maːɳˈʌhoː
ٻڌن	bədʰˈʌn
ھٿن	həʈˈʌn
ھيٺ	hˈeːʈʰ
تقاضا	t̪əqˈaːzaː
ٻيا	bjˈaː
فرقي	fərˈʌqi
نوابن	nˈaʋaːbˌən
سطحي	sətˈʌhi
ڪندا	kˈʌndaː
بهرو	bəhˈʌroː
نامور	naːmˈoːr
ڪومل	koːmˈʌl
وھن	ʋəhˈʌn
مناسب	mˌənaːsˈʌb
پهاڙ	pəhˈaːr.
چڪر	cəkˈʌr
ايڊيشن	ˌeːɖiʃˈʌn
اھڙين	ˌahr.ˈiːn
پراڻين	pˌəraːɳˈiːn
پارڪر	pˌaːrəkˈʌr
خيبرپختونخوا	xˌeːbərˌəpxt̪oːnˈʌxʋaː
اداري	adˈaːri
ڀٽ	bʰˈʌʈ
پهر	pəhˈʌr
ڪاڪي	kˈaːki
آرا	ˈaːraː
بغاوت	bˌaɣaːʋˈat
آستان	aːst̪ˈaːn
خارج	xaːrˈʌɟ
راجائن	rˌaːɟaːˈɪn
جيتريون	ɟˌeːt̪rjˈoːn
ٻرڙو	bərˈʌr.oː
صادق	ʂaːdˈʌq
لاڙو	lˈaːr.oː
ساحل	saːhˈʌl
خلائي	xəlˈaːi
نيڪي	nˈeːki
ٽن	ʈˈʌn
واشنگٽن	ʋˌaːʃənɡəʈˈʌn
ماڊل	maːɖˈʌl
ترڪيب	t̪ˌərkˈiːb
ويساک	ʋeːsˈaːkʰ
ھارمون	hˌaːrmˈoːn
ڇوٽ	cʰˈoːʈ
پھرئين	pˌəhərˈiːn
واسطيدار	ʋˌaːstidˈaːr
شاهه	ʃaːhˈʌh
گنگا	ɡˈʌnɡaː
پيغام	peːɣˈaːm
عالمي	aːlˈʌmi
رفتار	rˈafətˌaːr
جڏهن	ɟaɖˈẽhɪ̃
پٺاڻن	pˌəʈʰaːɳˈʌn
دڙا	dˈʌr.aː
ڪچري	kəcˈʌri
صوف	ʂˈoːf
قائد	qaːˈɪd
رونق	roːnˈʌq
اڃ	ˈaɲ
پروگرامن	pˌəroːɡraːmˈʌn
اونھاري	uːnhˈaːri
علامہ	ˌalaːmˈʌh
ٻڙي	bˈʌr.i
آکاڻيون	ˌaːkʰaːɳjˈoːn
واڻي	ʋˈaːɳi
لائبريري	lˌaːɪbrˈiːri
تراني	t̪ərˈaːni
ڪنڊو	kˈʌnɖoː
نصرپور	nˌəʂərpˈoːr
جتن	ɟət̪ˈʌn
پھچائڻ	pˌəhcaːˈɪɳ
ليکڪن	lˌeːkʰəkˈʌn
ڊگھائي	ɖəɡʰˈaːi
نار	nˈaːr
رهواسين	rˌəhʋaːsˈiːn
ڪيا	kjˈaː
جهنڊو	ɟəhˈʌnɖoː
وڙھڻ	ʋər.hˈʌɳ
بولي	bˈoːli
آھستي	aːhˈʌst̪i
حشر	həʃˈʌr
پٽن	pəʈˈʌn
انضمام	ˌanəzmˈaːm
لکيون	ləkʰjˈoːn
چيڪي	cˈeːki
جھلم	ɟˌəhəlˈʌm
عبدالله	ˌabdˌaːləlˈʌh
بارڪ	bˈaːrək
رب	rˈʌb
ليکراج	lˌeːkʰrˈaːɟ
ليکيو	lˈeːkʰjoː
طرفن	tˌərəfˈʌn
لکندي	ləkʰˈʌndi
ٽڪي	ʈˈʌki
گھري	ɡʰˈʌri
ويچارن	ʋˌeːcaːrˈʌn
ڇنڊ	cʰˈʌnɖ
طبقو	təbˈʌqoː
منزل	mˈanzˌɪl
ڏامر	ɖaːmˈʌr
ڀرسان	bʰˌərsˈaːn
وٺندڙ	ʋˌəʈʰəndˈʌr.
حالات	hˌaːlˈaːt
براهوي	bərˈaːhʋi
پردي	pˈʌrdi
آشا	ˈaːʃaː
خانقاه	xˌaːnqˈaːh
ڌرمي	dʰərˈʌmi
دفعي	dəfˈaːi
چڪو	cˈʌkoː
قصيدا	qəʂˈiːdaː
آلات	ˌaːlˈaːt
ڪڍيا	kˈʌɖʰjaː
پان	pˈaːn
سڌوسنئون	sˌədʰoːsˌənˈoːn
آيا	ˈaːjaː
آلي	ˈaːli
قلندري	qˌələndˈʌri
فائنل	fˌaːɪnˈʌl
ڇاپيو	cʰˈaːpjoː
حلقو	həlˈʌqoː
جرنيل	ɟərˈʌnjal
ڀيٽي	bʰˈeːʈi
ٺاهه	ʈʰaːhˈʌh
حيرت	heːrˈʌt̪
بدقسمتي	bˌədəqˌəsəmˈʌt̪i
باهه	bˈaːhəh
خودمختياري	xˈʊdməxt̪jˌaːri
هندستاني	hˌɪndəɪstˈaːni
ارادن	ˌaraːdˈʌn
ٻاهرئين	bˌaːhərˈiːn
اوڏ	ˈuːɖ
نمائندن	nˈʊmaːˈɪndən
نندو	nˈʌndoː
عمدا	amˈʌdaː
ٺري	ʈʰˈʌri
کرب	kʰərˈʌb
عدالتي	ˌadaːlˈʌt̪i
ڪائونسلون	kˌaːoːnsəlˈoːn
مزار	məzˈaːr
کا	kʰˈaː
متاثر	mˌət̪aːsˈʌr
ڪلام	kəlˈaːm
ٽيڪس	ʈeːkˈʌs
ڊان	ɖˈaːn
نمائندگي	nˈʊmaːˈɪndəɡˌiː
ڪوهستان	kˌoːhəˈɪstaːn
براڊ	bərˈaːɖ
متعلق	mˌət̪aːlˈʌq
بن	bˈʌn
يعقوبي	jˌaːqoːbˈiː
دڪان	dəkˈaːn
سگھو	sˈʌɡʰoː
منجهائن	mˌənəɟhaːˈɪn
موڪلي	moːkˈʌli
ھينئر	heːnˈʌr
ھڪٻئي	hˌəkəbˈʌi
لکندڙن	lˌəkʰəndər.ˈʌn
گيهه	ɡeːhˈʌh
ٻٻر	bəbˈʌr
توازن	t̪ʋaːzˈʌn
بحرين	bˌəhrˈiːn
رام	rˈaːm
مدافعت	mˌədaːfˈaːt̪
ڳوٺاڻا	ɡoːʈʰˈaːɳaː
شمار	ʃəmˈaːr
ڪالم	kaːlˈʌm
ويھ	ʋˈeːh
ڇا	cʰˈaː
معاف	mˈaːf
سرحدون	sˌərəhdˈoːn
ٻور	bˈoːr
ٽرمپ	ʈərˈʌmp
شاهاڻي	ʃaːhˈaːɳi
سماجي	səmˈaːɟi
وحداني	ʋˌəhdˈaːni
ڀيد	bʰˈeːd
ڏينديون	ɖeːndjˈoːn
غارن	ɣaːrˈʌn
رسايو	rəsˈaːjoː
جنتا	ɟənˈʌt̪aː
چارڻ	caːrˈʌɳ
ڦٽندو	pʰəʈˈʌndoː
آمري	aːmˈʌri
رطوبت	rˌətoːbˈʌt̪
باڪو	bˈaːkoː
اجتماعي	ˌɪɟtɪmaːˈaːi
ڳڻتي	ɡəɳˈʌt̪i
اوليت	uːlˈiːt̪
ڪمرا	kəmˈʌraː
رساله	rˌəsaːlˈʌh
مائيڪل	mˌaːikˈʌl
عاقل	aːqˈʌl
پائي	pˈaːi
يونيسيف	jˌoːnisˈiːf
گهرجي	ɡˌəhərˈʌɟi
آريا	ˈaːrjaː
ڪلراٺي	kˌəlrˈaːʈʰi
ھيس	hˈeːs
مرتب	mˌərət̪ˈʌb
چمڪ	cəmˈʌk
انڪري	ˌanəkˈʌri
سرمست	sˌərəmˈʌst̪
راھ	rˈaːh
واعظ	ʋaːˈaːʐ
لڌا	lˈʌdʰaː
نيت	nˈeːt̪
اھا	ˈahaː
مقالو	məqˈaːloː
ڪانہ	kaːnˈʌh
اڳوڻو	aɡˈoːɳoː
جنگيون	ɟənɡjˈoːn
آسٽريليا	ˌaːsəʈrˈiːljaː
اختيارن	ˌaxt̪jaːrˈʌn
پڄي	pˈʌɟi
نشريات	nˌəʃriˈaːt
شريڪ	ʃərˈiːk
نسل	nəsˈʌl
سڏائيندا	sˌəɖaːˈiːndaː
ايوب	eːˈoːb
مڙئي	mər.ˈʌi
حفاظت	hˌəfaːʐˈʌt̪
مڌم	mədʰˈʌm
ھنن	hənˈʌn
گرھ	ɡərˈʌh
پارا	pˈaːraː
پھتي	pəhˈʌt̪i
ڌوئڻ	dʰoːˈɪɳ
معنوي	mˈaːnʋi
آگ	ˈaːɡ
قديمه	qˌədimˈʌh
ٽيليويزن	ʈˌeːljʋizˈʌn
ٽنگون	ʈənɡˈoːn
مي	mˈeː
خلاف	xəlˈaːf
فيصد	feːʂˈʌd
ميرزا	meːrˈʌzaː
آفت	aːfˈʌt̪
ٽينس	ʈˈeːns
مسجدن	mˈasɟˌɪdn
نشاستي	nəʃˈaːst̪i
رھاڪو	rəhˈaːkoː
موضوع	mˈoːzuː
گانن	ɡaːnˈʌn
ٻڌندو	bədʰˈʌndoː
ائسوسيئيشن	ˌaːɪsˌoːsiiʃˈʌn
ايليا	ˈeːljaː
مرحلا	mˌərəhˈʌlaː
بهرحال	bˌəhərhˈaːl
ھدايت	hˌədaːˈiːt̪
امريڪا	ˌamrˈiːkaː
ڪڪرن	kˌəkərˈʌn
آفاق	aːfˈaːq
عراق	arˈaːq
شاھ	ʃˈaːh
شيعا	ʃˈiːaː
انٽرويو	ˌanəʈˈʌrʋjoː
نندي	nˈʌndi
ايپليڪيشن	ˌeːplˌiːkiʃˈʌn
ڇڏيندو	cʰəɖˈiːndoː
جاٽن	ɟaːʈˈʌn
ٺهيل	ʈʰˈʌhjal
ڦوڳ	pʰˈoːɡ
لطيف	lətˈiːf
ايڊ	ˈeːɖ
ماد	mˈaːd
ڀريو	bʰˈʌrjoː
جويو	ɟʋjˈoː
کين	kʰˈeːn
ڀينر	bʰeːnˈʌr
حصيدار	hˌəʂidˈaːr
ميڊيڪل	mˌeːɖikˈʌl
وارثن	ʋˌaːrəsˈʌn
مدراس	mˌədrˈaːs
ملي	mˈʌli
جينياتي	ɟeːnjˈaːt̪i
اجائي	aɟˈaːi
آکيري	aːkʰˈiːri
وسڪاري	ʋˌəskˈaːri
چرڪس	cˌərəkˈʌs
خدمتن	xˌədəmət̪ˈʌn
ائڪٽ	ˌaːɪkˈʌʈ
ملڪاڻي	mˌəlkˈaːɳi
جاميٽري	ɟˌaːmiʈˈʌri
ڍڳيون	ɖʰəɡjˈoːn
اپڀرنش	ˌapəbʰˌərənˈʌʃ
ٻول	bˈoːl
ميسارجي	mˌeːsaːrˈʌɟi
بيس	bˈeːs
جڙيل	ɟˈʌr.jal
پراڻن	pˌəraːɳˈʌn
ڀرين	bʰərˈiːn
ڦڦڙ	pʰəpʰˈʌr.
وٽس	ʋəʈˈʌs
منفرد	mˌənəfˈʌrd
مرزا	mərˈʌzaː
ڪان	kˈaːn
سرٽيفڪيٽ	sˌərʈˌiːfkˈiːʈ
صدر	ʂədˈʌr
طارق	taːrˈʌq
ٽرانسپورٽ	ʈˌəraːnsˌəpoːrˈʌʈ
سرفراز	sˌərəfrˈaːz
ٻيڙا	bˈeːr.aː
مينهون	mˌeːnhˈoːn
نمونو	nəmˈoːnoː
پلاڻ	pəlˈaːɳ
جاسوسن	ɟˌaːsoːsˈʌn
ڇهين	cʰəhˈiːn
سوشل	soːʃˈʌl
بديع	bˈʌdi
برقي	bərˈʌqi
سيڪيورٽي	sˌeːkjoːrˈʌʈi
خادم	xaːdˈʌm
وڏيرو	ʋəɖˈiːroː
مولا	mˈoːlaː
طرف	tərˈʌf
سگهه	sˌəɡəhˈʌh
وڏيري	ʋəɖˈiːri
قيصر	qeːʂˈʌr
وڄائين	ʋˌəɟaːˈiːn
طلب	təlˈʌb
هفتي	həfˈʌt̪i
خواجن	xʋaːɟˈʌn
بيلجيم	bˈeːlɟˌiːm
اطلاعات	ˌatlaːˈaːt̪
عبدالحڪيم	ˌabdˌaːləhkˈiːm
تولا	t̪ˈoːlaː
تياري	t̪jˈaːri
لاهيندي	laːhˈiːndi
ويانا	ʋjˈaːnaː
ٻالڪ	baːlˈʌk
ڪاپي	kˈaːpi
جاندار	ɟaːndˈaːr
ڪاربن	kˌaːrəbˈʌn
برٽش	bˌərəʈˈʌʃ
شايع	ʃˈaːjaː
رعيت	raːˈiːt̪
ڏيتي	ɖˈeːt̪i
شبير	ʃəbˈiːr
صفحي	ʂəfˈʌhi
سلسلا	sˈɪlsˌɪlaː
قريشي	qərˈiːʃi
سائٽ	sˈaːʈ
مهراڻي	mˌəhərˈaːɳi
ماڻڻ	maːɳˈʌɳ
لڳڻ	ləɡˈʌɳ
پراچين	pˌəraːcˈiːn
واپاري	ʋaːpˈaːri
سوچن	soːcˈʌn
ڪجهہ	kˈʊɟʰʊ
مقالن	mˌəqaːlˈʌn
بلوچستان	bˌəloːcˈɪstaːn
ميرس	meːrˈʌs
ٿيل	tʰˈɪal
ڪوڪا	kˈoːkaː
ڪاربان	kˌaːrbˈaːn
ملھايو	mˌəlhˈaːjoː
تباهه	t̪əbˈaːhəh
سڙي	sˈʌr.i
ٻولي	bˈoːli
اٿس	aʈˈʌs
ڪيليفورنيا	kˌeːlifoːrˈʌnjaː
ميين	mjˈeːn
وڪيپيڊيا	ʋˌəkipˈiːɖjaː
ڍاٽڪي	ɖʰaːʈˈʌki
تباهي	t̪əbˈaːhi
قافيي	qˈaːfji
جيتري	ɟeːt̪ˈʌri
پورهيو	poːrˈʌhjoː
تخلص	t̪ˌəxəlˈʌʂ
کلڻ	kʰəlˈʌɳ
اقرار	ˌaqrˈaːr
سيڪنڊري	sˌeːkənɖˈʌri
بادشاهت	bˈaːdʃˌaːhət̪
ڪسٽم	kˌəsəʈˈʌm
ڪٿائن	kˌətʰaːˈɪn
ڦاڙي	pʰˈaːr.i
رول	rˈoːl
رد	rˈʌd
رخ	rˈʊx
پيري	pˈeːri
عبدالرحمان	ˌabdˌaːlərˌəhmˈaːn
عصمت	ˌaʂəmˈʌt̪
آرام	aːrˈaːm
چوندا	cˈoːndaː
گيت	ɡˈeːt̪
پرولي	pərˈoːli
ماڃر	maːɲˈʌr
آبائي	aːbˈaːi
پيداواري	pˌeːdaːʋˈaːri
سندس	səndˈʌs
مياڻي	mjˈaːɳi
عبدالملڪ	ˌabdˌaːləməlˈʌk
پکي	pˈʌkʰi
بيشڪ	bˈeːʃək
فضائي	fəzˈaːi
رڳ	rˈʌɡ
ويجهڙائي	ʋˌeːɟəhər.ˈaːi
ترجمو	t̪ˌərəɟˈʌmoː
بزرگ	bˈʊzʊɾɡ
مواد	mʋˈaːd
ڌرين	dʰərˈiːn
ڪٽيل	kˈʌʈjal
راشد	raːʃˈʌd
مقام	məqˈaːm
آدمشماري	ˌaːdəmˌəʃmˈaːri
نگر	nəɡˈʌr
حڪمران	hˌəkəmrˈaːn
ڌماڪي	dʰəmˈaːki
جيت	ɟˈeːt̪
ريڪارڊ	rˌeːkaːrˈʌɖ
لکيل	lˈʌkʰjal
مڏ	mˈʌɖ
ناريون	naːrjˈoːn
رئيس	rəˈiːs
ماسا	mˈaːsaː
وڪڻڻ	ʋˌəkəɳˈʌɳ
ڏيکاريل	ɖeːkʰˈaːrjal
اونڌو	ˈuːndʰoː
قربان	qˌərbˈaːn
اسڪرپٽ	ˌasəkˌərəpˈʌʈ
سٽا	sˈʌʈaː
جمادي	ɟəmˈaːdi
رھيو	rˈʌhjoː
هٿي	hˈʌtʰi
فيس	fˈeːs
تبصرا	t̪ˌəbəʂˈʌraː
لڏ	lˈʌɖ
فطري	fətˈʌri
ٿنڀن	ʈˌənəbʰˈʌn
مزاحيه	mˌəzaːhˈiːh
معدنيات	mˌaːdniˈaːt
جذبن	ɟˌəzəbˈʌn
شمسي	ʃəmˈʌsi
وائيس	ʋaːˈiːs
گذرندڙ	ɡˌəzərəndˈʌr.
ڪک	kˈʌkʰ
پاران	paːrˈaːn
گذران	ɡˌəzrˈaːn
جدائي	ɟˈʊdaːˌiː
ڊين	ɖˈeːn
وگهي	ʋəɡˈʌhi
مڇين	məcʰˈiːn
ڊزائين	ɖˌəzaːˈiːn
ڇڊي	cʰˈʌɖi
گهر	ɡəhˈʌr
شورو	ʃˈoːroː
ڪمي	kˈʌmi
سيڪشن	sˌeːkəʃˈʌn
ڍير	ɖʰˈeːr
جھنڊو	ɟəhˈʌnɖoː
چنا	cˈʌnaː
رشي	rˈʌʃi
صنعتون	ʂˌənaːt̪ˈoːn
جيسين	ɟeːsˈiːn
باگڙي	bˈaːɡr.ˌiː
پر	pˈʌr
دل	dˈʌl
وڌيا	ʋˈʌdʰjaː
مستطيل	məst̪ˈʌtjal
چاڪر	caːkˈʌr
معروضي	maːrˈoːzi
اسٽاڪ	ˌasʈˈaːk
نئون	nəˈoːn
ڏيپلي	ɖeːpˈʌli
پيٽرول	pˌeːʈrˈoːl
ڍاڪا	ɖʰˈaːkaː
وريو	ʋˈʌrjoː
گورنمينٽ	ɡˌoːrənminˈʌʈ
سھڪار	sˌəhkˈaːr
هينئر	heːnˈʌr
ذات	zˈaːt̪
واڻ	ʋˈaːɳ
اکيون	akʰjˈoːn
نائون	naːˈoːn
لطيفي	lətˈiːfi
تصور	t̪əʂˈoːr
باغين	bˈaːɣin
ڇپرائي	cʰˌəprˈaːi
ڪائي	kˈaːi
لاڳاپو	laːɡˈaːpoː
ڌاتن	dʰaːt̪ˈʌn
گادي	ɡˈaːdi
تهذيبن	t̪ˌəhəzibˈʌn
فرائيڊ	fˌəraːˈiːɖ
راڳڻي	raːɡˈʌɳi
ميون	mjˈoːn
لاهن	laːhˈʌn
آلبم	ˌaːləbˈʌm
گولن	ɡoːlˈʌn
بئراج	bərˈaːɟ
نڀائي	nəbʰˈaːi
ٻارهين	bˌaːrhˈiːn
امڪان	ˌamkˈaːn
ليڪچرر	lˌeːkəcərˈʌr
فنڪار	fˌənkˈaːr
منير	mənˈiːr
منجهانئس	mˌənəɟhaːnˈʌs
راڳن	raːɡˈʌn
روزا	rˈoːzaː
حوالا	haʋˈaːlaː
پوش	pˈoːʃ
ٺهندي	ʈʰəhˈʌndi
مدح	mˌədˈah
ڇاڪاڻ	cʰaːkˈaːɳ
ء	hˈamzah
گھوڙي	ɡʰˈoːr.i
کجور	kʰəɟˈoːr
موجودہ	moːɟˈuːdh
چيمبر	ceːmbˈʌr
مسلڪ	mˌəsəlˈʌk
سئفٽ	səfˈʌʈ
ڪارپوريشن	kˌaːrpˌoːriʃˈʌn
پختون	pəxt̪ˈuːn
شاهي	ʃˈaːhi
ايس	ˈeːs
بيڪ	bˈeːk
ماهر	maːhˈʌr
هڏ	hˈʌɖ
عبراني	ˌabrˈaːni
مصور	məʂˈoːr
بمباري	bəmbˈaːri
محسن	mˈoːhsˌɪn
رپورٽ	rˌəpoːrˈʌʈ
جذباتي	ɟˌəzbˈaːt̪i
لڳائيندا	lˌəɡaːˈiːndaː
عرق	arˈʌq
ڊائريا	ɖaːˈɪrjaː
تعلقن	t̪ˌaːləqˈʌn
ڀلا	bʰˈʌlaː
جهليو	ɟəhˈʌljoː
آزاد	aːzˈaːd
سڃاتو	səɲˈaːt̪oː
پڙهندو	pˌər.əhˈʌndoː
ع	ˈa͡ɪn
مدنظر	mˌədənəʐˈʌr
ميوي	mjʋˈeː
سونھن	sˈoːnhn
منسٽر	mˌənsəʈˈʌr
هوائون	hʋaːˈoːn
رھي	rˈʌhi
زڪوات	zˌəkoːˈaːt
ڳتيل	ɡˈʌt̪jal
ديوي	djʋˈeː
پوٽر	poːʈˈʌr
پتڻ	pət̪ˈʌɳ
سوار	sʋˈaːr
عليہ	alˈiːh
گڏ	ɡˈʌɖ
رڪارڊنگ	rˌəkaːrəɖˈʌnɡ
ٻڌائيندي	bˌədʰaːˈiːndi
رهيا	rˈʌhjaː
اوچا	ˈuːcaː
ٻارڙن	bˌaːrər.ˈʌn
هرات	hˌərˈaːt
جلدن	ɟˌələdˈʌn
آبادين	aːbˈaːdin
ڇڏيندي	cʰəɖˈiːndi
ڪارگل	kˌaːrəɡˈʌl
طبي	təbˈiː
کرل	kʰərˈʌl
سورهن	sˌoːrəhˈʌn
دراصل	dˌəraːʂˈʌl
پٽاندڙ	pˌəʈaːndˈʌr.
ڳنڍجي	ɡˌənəɖʰˈʌɟi
جلاوطن	ɟˌəlaːoːtˈʌn
استعفي	ast̪ˈaːfi
وجهندڙ	ʋˌəɟəhəndˈʌr.
پليو	pˈʌljoː
برفي	bərˈʌfi
بربر	bˌərəbˈʌr
قول	qˈoːl
ويھين	ʋeːhˈiːn
بهترين	bˌəhət̪rˈiːn
محڪمي	mˌəhəkˈʌmi
محض	məhˈʌz
مائٽي	mˈaːʈi
الوجود	ˌaloːɟˈoːd
ماري	mˈaːri
مايي	mˈaːji
گيتا	ɡˈeːt̪aː
نئين	nəˈiːn
سيشن	seːʃˈʌn
لٿي	lˈʌtʰi
مستقل	mˌəst̪əqˈʌl
ڪلڪتي	kˌələkˈʌt̪i
اچي	ˈaci
انتهائي	ˌɪntɪhˈaːi
ڏسندا	ɖɪsˈʌndaː
هڻنديون	hˌəɳndjˈoːn
ڪاڇو	kˈaːcʰoː
دودو	dˈoːdoː
گهيريل	ɡəhˈiːrjal
ثقافت	sˌəqaːfˈʌt̪
مشينن	mˌəʃinˈʌn
منڊي	mˈʌnɖi
وڙهندي	ʋˌər.əhˈʌndi
ارسطو	ˌarəsˈʌtoː
سڌارا	sədʰˈaːraː
نبيري	nəbˈiːri
کاڄ	kʰˈaːɟ
وهندڙ	ʋˌəhəndˈʌr.
حڪومتي	hˌəkoːmˈʌt̪i
رياضي	rjˈaːzi
شموليت	ʃˌəmoːlˈiːt̪
جوڌا	ɟˈoːdʰaː
رديف	rədˈiːf
ملٽن	mˌələʈˈʌn
سنهري	sˌənəhˈʌri
مجمدار	mˌəɟəmdˈaːr
مهاڻي	məhˈaːɳi
بادشاھتون	bˈaːdʃˌaːht̪ˌoːn
نقشبندي	nˌəqəʃəbˈʌndi
دارالعلوم	dˌaːraːlaːlˈoːm
طريقت	tˌəriqˈʌt̪
پيٽ	pˈeːʈ
وڻندو	ʋəɳˈʌndoː
ڇپيل	cʰˈʌpjal
وحدت	ʋˌəhədˈʌt̪
مشرق	mˈaʃrˌɪq
تقدير	t̪ˌəqdˈiːr
ورھاست	ʋˌərhˈaːst̪
اولهندي	ˌuːləhˈʌndi
پڙهندي	pˌər.əhˈʌndi
وس	ʋˈʌs
غربت	ɣˌərəbˈʌt̪
ڀرت	bʰərˈʌt̪
وئي	ʋˈʌi
ڏاڪا	ɖˈaːkaː
جنيوا	ɟˈʌnjʋaː
ارڙھين	ˌarr.hˈiːn
گهرن	ɡˌəhərˈʌn
وڙهي	ʋər.ˈʌhi
ليکبو	lˌeːkʰbˈoː
اوڀرندي	ˌuːbʰərˈʌndi
معين	maːˈiːn
يوسف	joːsˈʌf
خاندان	xaːndˈaːn
کاڌي	kʰˈaːdʰi
ڪش	kˈʌʃ
بجي	bˈʌɟi
عامر	aːmˈʌr
مت	mˈʌt̪
صليب	ʂəlˈiːb
مٿي	mˈʌtʰi
مقابلا	mˌəqaːbˈʌlaː
سڌين	sədʰˈiːn
ساڻ	sˈaːɳ
پيڙهه	pˌeːr.əhˈʌh
مهاڻن	mˌəhaːɳˈʌn
دماغي	dəmˈaːɣi
ڀڃ	bʰˈʌɲ
ڇڏي	cʰˈʌɖi
چٽيل	cˈʌʈjal
قانونسازي	qˌaːnoːnsˈaːzi
سماج	səmˈaːɟ
نيرو	nˈeːroː
الاساطير	ˌalaːsaːtˈiːr
لھي	lˈʌhi
گھڙي	ɡʰˈʌr.i
اعتقاد	ˌeːtɪqˈaːd
نقادن	nˌəqaːdˈʌn
شروعات	ʃʊrˈuːaːt
ڪورٽون	kˌoːrʈˈoːn
خيالي	xjˈaːli
پهچندا	pˌəhəcˈʌndaː
معني	mˈaːni
وعدو	ʋˈaːdoː
پٺاڻ	pəʈʰˈaːɳ
حڪومتن	hˌəkoːmət̪ˈʌn
نارنگي	naːrˈʌnɡi
ساموئي	saːmˈoːi
سنجيده	sˌənɟidˈʌh
ڀاشا	bʰˈaːʃaː
فيلو	fˈeːloː
رکيو	rˈʌkʰjoː
پاتو	pˈaːt̪oː
جئن	ɟˈʌn
ڊگهائي	ɖˌəɡhˈaːi
ڳنڍيل	ɡənˈʌɖʰjal
ڀارت	bʰaːrˈʌt̪
ردعمل	rˌədaːmˈʌl
ڄمي	ɟˈʌmi
بيمارين	bˈeːmaːrˌiːn
ڍل	ɖʰˈʌl
ٿاڻي	tʰˈaːɳi
ايٿوپيا	eːtʰˈoːpjaː
پروهت	pˌəroːhˈʌt̪
پڌرا	pədʰˈʌraː
آذربائيجاني	ˌaːzərbˈaːiɟˌaːni
ورثي	ʋərˈʌsi
ڇني	cʰˈʌni
اداڪارن	ˌadaːkaːrˈʌn
طاري	tˈaːri
سمجهيا	sˌəməɟˈʌhjaː
سادات	sˌaːdˈaːt
مشروط	mˌəʃrˈuːt
مثالي	məsˈaːli
آرٽ	aːrˈʌʈ
نتاشا	nət̪ˈaːʃaː
گلگت	ɡˌələɡˈʌt̪
ڪفن	kəfˈʌn
تفريح	t̪əfˈʌrih
ڇر	cʰˈʌr
ليڪچرار	lˌeːkəcrˈaːr
زبيده	zəbˈiːdəh
خواهش	xʋaːhˈʌʃ
سهوليتون	sˌəhoːlit̪ˈoːn
مجلس	mˌəɟəlˈʌs
پريفيڪچر	pˌərifˌiːkəcˈʌr
فقير	fəqˈiːr
اوپن	uːpˈʌn
بدران	bˌədrˈaːn
عبدالغني	ˌabdˌaːləɣˈʌni
ڪمپيئرنگ	kˌəmpiˈɪrənɡ
نيو	njˈoː
کنيل	kʰˈʌnjal
پٽيون	pəʈjˈoːn
عمودي	amˈoːdi
ٺاھيندا	ʈʰaːhˈiːndaː
مارو	mˈaːroː
بيابان	bjˈaːbˈaːn
کٻي	kʰˈʌbi
دلين	dəlˈiːn
مزدور	mˌəzdˈuːr
ڪوئن	koːˈɪn
مشائخ	mˌəʃaːˈɪx
کوليون	kʰoːljˈoːn
ڪلمتي	kˌələmˈʌt̪i
گوئٽي	ɡˈoːʈi
مٿيون	mətʰjˈoːn
جهنڊي	ɟəhˈʌnɖi
وڪي	ʋˈʌki
باوجود	bˈaːoːɟˌoːd
پيسا	pˈeːsaː
ڪڍبو	kˌəɖʰbˈoː
آتم	aːt̪ˈʌm
جوڙيون	ɟoːr.jˈoːn
گانا	ɡˈaːnaː
ڪريون	kərjˈoːn
کوجنائون	kʰˌoːɟnaːˈoːn
ٻيڙو	bˈeːr.oː
مرهٺي	mˌərəhˈʌʈʰi
لاڙڪاڻو	lˌaːr.kˈaːɳoː
اسمن	ˌasəmˈʌn
اسم	ˈɪsm
پريشاني	pˌəriʃˈaːni
سنڀاليندو	sˌənbʰaːlˈiːndoː
گذرندي	ɡˌəzərˈʌndi
مهم	məhˈʌm
لڳي	lˈʌɡi
شهنشاهت	ʃˌəhənʃaːhˈʌt̪
مھيني	məhˈiːni
ٻڌائيندا	bˌədʰaːˈiːndaː
مذھبي	mˌəzəhbˈiː
فعال	fˈaːl
لڪي	lˈʌki
ڏهاڙن	ɖˌəhaːr.ˈʌn
ڪجن	kəɟˈʌn
فرمانبرداري	fˌərmˌaːnbərdˈaːri
والد	ʋaːlˈʌd
نے	nˈʌeː
اسين	asˈiːn
ڪرام	kərˈaːm
آنو	ˈaːnoː
پوئلڳن	poːˈɪləɡˌən
مطلب	mˌətəlˈʌb
آنديون	aːndjˈoːn
ڀتيون	bʰət̪jˈoːn
ارڙهن	ˌarər.əhˈʌn
ذوالفقار	zʋˌaːləfqˈaːr
اوس	ˈuːs
جـي	ɟˈiːmlˈetəcʰˈahacˈaːrbˈʊr.ijˈeː
ديرو	dˈeːroː
ھٽائي	həʈˈaːi
سالم	saːlˈʌm
ناميارا	naːmjˈaːraː
سيريز	seːrˈiːz
وچون	ʋəcˈoːn
چارڻن	cˌaːrəɳˈʌn
نور	nˈoːr
برخلاف	bˌərəxlˈaːf
يقين	jəqˈiːn
عبدالرحيم	ˌabdˌaːlərhˈiːm
ھلڪي	həlˈʌki
جلسي	ɟəlˈʌsi
صوفين	ʂoːfˈiːn
مشق	məʃˈʌq
هاڃو	hˈaːɲoː
ڌڻ	dʰˈʌɳ
حصا	hˈʌʂaː
سڀيئي	səbʰˈiːi
آگري	aːɡˈʌri
ويئر	ʋeːˈɪr
قمبر	qəmbˈʌr
هلال	həlˈaːl
ڀاڱا	bʰaːˈŋ̩aː
شهنشاه	ʃˌəhənʃˈaːh
يڪ	jˈʌk
ڇٽو	cʰˈʌʈoː
نيويارڪ	njʋjaːrˈʌk
ميلا	mˈeːlaː
زر	zˈʌr
ٽڻ	ʈˈʌɳ
ڀاٽيا	bʰˈaːʈjaː
ڪارآمد	kˌaːraːmˈʌd
ويهندا	ʋeːhˈʌndaː
ستارا	sɪtˈaːraː
ڀنڀور	bʰˌənbʰˈuːr
لهه	ləhˈʌh
بلوچ	bəlˈoːc
آقا	ˈaːqaː
کن	kʰˈʌn
ڏيڻي	ɖˈeːɳi
مصالحو	mˌəʂaːlˈʌhoː
محسوس	mˌəhsˈuːs
ڪاوڙ	kaːˈoːr.
اپگرھ	ˌapəɡərˈʌh
چاڙھي	cˈaːr.hi
ضايع	zˈaːjaː
وات	ʋˈaːt̪
پڻس	pəɳˈʌs
ٻولين	boːlˈiːn
ترنم	t̪ˌərənˈʌm
لٽ	lˈʌʈ
لاڳيتو	laːɡˈiːt̪oː
مخالف	mʊxˈaːlɪf
راڄڙ	raːɟˈʌr.
سڃاتل	sˌəɲaːt̪ˈʌl
ٿورڙي	tʰoːrˈʌr.i
اردن	ardˈʌn
ڪامريڊ	kˌaːmrˈiːɖ
عبدالخالق	ˌabdˌaːlxaːlˈʌq
واهن	ʋaːhˈʌn
وڏيرا	ʋəɖˈiːraː
ملفوظات	mˌəlfˌuːʐˈaːt
صاف	ʂˈaːf
گھريلو	ɡʰərˈiːloː
معتبر	mˌaːt̪əbˈʌr
ٽيڪسٽ	ʈˌeːkəsˈʌʈ
نوڪري	noːkˈʌri
پڻ	pˈɪɳ
وٺندي	ʋəʈʰˈʌndi
ابو	abˈoː
معاملو	maːmˈʌloː
بوٽ	bˈoːʈ
روانو	rʋˈaːnoː
حيض	hˈeːz
ڪوڙا	kˈoːr.aː
دهل	dəhˈʌl
را	rˈaː
فضل	fəzˈʌl
ٺاهي	ʈʰˈaːhi
مشغول	mˌəʃɣˈuːl
سوداگر	sˌoːdaːɡˈʌr
ڪافيون	kaːfjˈoːn
جرئت	ɟərˈʌt̪
ستم	sət̪ˈʌm
زبر	zəbˈʌr
ٽيڪنالوجي	ʈˌeːknaːlˈoːɟi
سيٽ	sˈeːʈ
پروگرام	pˌəroːɡrˈaːm
نوجوانن	nˌoːɟʋaːnˈʌn
چيڪ	cˈeːk
صنعت	ʂənˈaːt̪
ڪاروائي	kaːrʋˈaːi
ڪميونسٽ	kˌəmjoːnsˈʌʈ
ويٽنام	ʋˌeːʈnˈaːm
آسان	aːsˈaːn
منزلن	mˈanzˌɪln
پنجين	pˌənɟˈiːn
جهليندو	ɟˌəhəlˈiːndoː
ڏهاڪي	ɖəhˈaːki
دورو	dˈoːroː
وهي	ʋˈʌhi
پورٽ	poːrˈʌʈ
ٻاڦ	bˈaːpʰ
موڪليو	moːkˈʌljoː
ملئي	məlˈʌi
حفيظ	həfˈiːʐ
ڪنڌ	kˈʌndʰ
پيغمبر	pˌeːɣəmbˈʌr
ساڪري	saːkˈʌri
داغستان	dˌaːɣˈɪstaːn
ڪانڀو	kaːnˈʌbʰoː
چئلينج	cˌəlinˈʌɟ
هيمون	heːmˈoːn
ڏيک	ɖˈeːkʰ
لاڏاڻو	laːɖˈaːɳoː
سوالن	sʋaːlˈʌn
بيهڪ	bˈeːhək
جناح	ɟˈʌnaːh
نمونا	nəmˈoːnaː
خوشحالي	xˈʊʃhaːlˌiː
تيزاب	t̪eːzˈaːb
سڏائڻ	sˌəɖaːˈɪɳ
ايران	eːrˈaːn
قبوليو	qəbˈoːljoː
ڳائينديون	ɡˌaːindjˈoːn
خليفن	xˌəlifˈʌn
درياهه	dˌərjaːhˈʌh
ڪڍيو	kˈʌɖʰjoː
شھاب	ʃəhˈaːb
ادارو	adˈaːroː
رباني	rəbˈaːni
ڏاڍا	ɖˈaːɖʰaː
يهودي	jəhˈoːdi
ڊھي	ɖˈʌhi
ڏاڏا	ɖˈaːɖaː
هيرانند	hˌeːraːnˈʌnd
تنقيدي	t̪ˌənqˈiːdi
متان	mət̪ˈaːn
الشان	ˌalʃˈaːn
کير	kʰˈeːr
قافين	qaːfˈiːn
آئيس	aːˈiːs
ڀينرن	bʰˌeːnərˈʌn
سلسلي	sˈɪlsˌɪli
بعض	bˈaːz
پادرين	pˌaːdrˈiːn
ڪاٿو	kˈaːtʰoː
انجڻ	ˌanəɟˈʌɳ
بسر	bəsˈʌr
فقهه	fˌəqəhˈʌh
پيتو	pˈeːt̪oː
اهوئي	ahˈoːi
وٺندو	ʋəʈʰˈʌndoː
فاسفورس	fˌaːsfoːrˈʌs
پاشا	pˈaːʃaː
ڀرتي	bʰərˈʌt̪i
ڪوتا	kˈoːt̪aː
رضي	rˈʌzi
عبادتگاهن	abˈaːdət̪ɡaːhˌən
برطانيه	bˌərtaːnˈiːh
قبائلي	qəbˈaːɪlˌiː
جمھوريه	ɟˌəmhuːrˈiːh
مفڪر	mˌəfəkˈʌr
ڪچو	kˈʌcoː
نتيجو	nət̪ˈiːɟoː
شھباز	ʃˌəhbˈaːz
گرمکي	ɡˌərəmˈʌkʰi
دڙي	dˈʌr.i
ڪبي	kəbˈiː
ادل	adˈʌl
وينديون	ʋeːndjˈoːn
شهر	ʃəhˈʌr
اھڙن	ˌahər.ˈʌn
محمد	mˌəhəmˈʌd
جراثيم	ɟˌəraːsˈiːm
سفارتخاني	sˌəfaːrˌət̪xˈaːni
غيبي	ɣeːbˈiː
تربت	t̪ˌərəbˈʌt̪
ٻڌايا	bədʰˈaːjaː
هندوستاني	hˌɪnduːst̪ˈaːni
آسپاس	ˌaːspˈaːs
سوراشٽر	sˌoːraːʃəʈˈʌr
نروار	nərʋˈaːr
داڻو	dˈaːɳoː
پاليندا	paːlˈiːndaː
شاندار	ʃaːndˈaːr
ووڊ	ʋˈoːɖ
پچائڻ	pˌəcaːˈɪɳ
اعلان	eːlˈaːn
هوندي	hˈũːdi
ڪارڪن	kˌaːrəkˈʌn
ذرڙا	zərˈʌr.aː
ارڙ	arˈʌr.
بخاري	bəxˈaːri
تفاوت	t̪ˌəfaːˈoːt̪
جهاد	ɟəhˈaːd
ڪوٽڏجي	kˌoːʈəɖˈʌɟi
ڳولا	ɡˈoːlaː
لٿوينيا	lətʰʋˈiːnjaː
سپرنٽينڊنٽ	sˌəpərˌənʈˌiːnɖənˈʌʈ
زندہ	zˈɪndh
ٽالپور	ʈˌaːlpˈoːr
سے	sˈʌeː
خير	xˈeːr
خدابخش	xˌədaːbəxˈʌʃ
گو	ɡˈoː
ڪابه	kaːbˈɪh
سگهجن	sˌəɡəhəɟˈʌn
پارٽ	paːrˈʌʈ
ٽڪريون	ʈˌəkrjˈoːn
ٻيڙي	bˈeːr.i
لبرل	lˌəbərˈʌl
هيرو	hˈeːroː
پورچوگيزي	pˌoːrcoːɡˈiːzi
اڏامڻ	ˌaɖaːmˈʌɳ
مونکي	moːnˈʌkʰi
جسماني	ɟˌəsmˈaːni
صبر	ʂəbˈʌr
عمارت	ˌamaːrˈʌt̪
متحد	mʊtˈahɪd
نياڻيون	njaːɳjˈoːn
درويش	dərʋˈiːʃ
ايواني	eːʋˈaːni
لغتن	lˌəɣət̪ˈʌn
سرمائيدارن	sˌərmˌaːidaːrˈʌn
لٺ	lˈʌʈʰ
مئٽرڪ	mˌəʈərˈʌk
ماريندڙ	mˌaːrindˈʌr.
خيرات	xˌeːrˈaːt
جاوا	ɟˈaːʋaː
ڀومي	bʰˈoːmi
خليفا	xəlˈiːfaː
ڦٽو	pʰˈʌʈoː
بمطابق	bˌəmtaːbˈʌq
گروپن	ɡˌəroːpˈʌn
ڪوششون	kˌoːʃʃˈoːn
جنسون	ɟˈɪnsuːn
بسال	bəsˈaːl
چاليهه	cˌaːlihˈʌh
البت	ˌaləbˈʌt̪
نوع	nˈuː
گهور	ɡəhˈoːr
شائر	ʃaːˈɪr
متفق	mˌət̪əfˈʌq
پارس	paːrˈʌs
وياج	ʋjˈaːɟ
ساساني	saːsˈaːni
موقف	moːqˈʌf
هلڪي	həlˈʌki
شناخت	ʃənˈaːxt̪
سگنل	sˌəɡənˈʌl
مٽائي	məʈˈaːi
وڳوڙن	ʋˌəɡoːr.ˈʌn
ڏيان	ɖjˈaːn
الهندي	ˌaləhˈʌndi
سنڌوندي	sɪndhˈuːndi
ساڳين	saːɡˈiːn
ڪپهه	kˌəpəhˈʌh
آچاريا	aːcˈaːrjaː
ڪيئي	kˈeːi
ڪاف	kˈaːf
عملدارن	ˌaməldaːrˈʌn
مليون	məljˈoːn
لڌو	lˈʌdʰoː
تعليمدان	t̪ˌaːlimdˈaːn
گهيرو	ɡəhˈiːroː
النساء	alˈʌnsaː
اڳواٽ	aɡʋˈaːʈ
وساري	ʋəsˈaːri
گرائونڊ	ɡˌəraːˈoːnɖ
تڏهن	t̪ˌəɖəhˈʌn
ڌنار	dʰənˈaːr
ميراڻي	meːrˈaːɳi
ادراڪ	ˌadrˈaːk
آمريڪي	ˌaːmrˈiːki
ڪاٽي	kˈaːʈi
ٽراپيڪل	ʈˌəraːpikˈʌl
پرهيزگار	pˌərhˌiːzɡˈaːr
پئسفڪ	pˌəsəfˈʌk
آخري	aːxˈʌri
پنھنجن	pˌənhnəɟˈʌn
الفا	alˈʌfaː
بروهين	bˌəroːhˈiːn
ڇھ	cʰˈʌh
اخلاق	ˌaxlˈaːq
صوبن	ʂuːbˈʌn
مخفي	məxˈʌfi
اسپين	ˌaspˈiːn
اسماعيلي	ˌasmˌaːaːˈiːli
ختم	xət̪ˈʌm
جڳهه	ɟˌəɡəhˈʌh
ڪريو	kˈʌrjoː
ڪتابي	kˌɪtaːbˈiː
ھيء	hˈeː
ڪنارن	kˌənaːrˈʌn
واڌو	ʋˈaːdʰoː
ڪمپني	kəmpˈʌni
ٺاهين	ʈʰaːhˈiːn
انجي	anˈʌɟi
روحاني	roːhˈaːni
نڪتو	nəkˈʌt̪oː
هالا	hˈaːlaː
غيرت	ɣeːrˈʌt̪
سعدي	sˈaːdi
مسيحي	məsˈiːhi
ڏهين	ɖəhˈiːn
گرجا	ɡərˈʌɟaː
بچيو	bˈʌcjoː
فرات	fˌərˈaːt
چاڙھڻ	caːr.hˈʌɳ
جاگرافيائي	ɟˌaːɡraːfjˈaːi
چڱي	cəˈŋ̩i
ٻڏي	bˈʌɖi
سرڪاري	sˌərkˈaːri
ڳالهائيندڙن	ɡˌaːlhˌaːindər.ˈʌn
ڪاڻ	kˈaːɳ
معلم	maːlˈʌm
بدترين	bˌədət̪rˈiːn
ڪچا	kˈʌcaː
مطابقت	mˌətaːbəqˈʌt̪
بنگلو	bənɡˈʌloː
عرب	arˈʌb
ڏاڍي	ɖˈaːɖʰi
آلو	ˈaːloː
نهايت	nˌəhaːˈiːt̪
ڪانگ	kˈaːnɡ
اي	ˈeː
کوکر	kʰoːkʰˈʌr
بنهه	bˌənəhˈʌh
هجو	hˈʌɟoː
پهاڙن	pˌəhaːr.ˈʌn
ڦٽ	pʰˈʌʈ
پنري	pənˈʌri
گريجوئيٽ	ɡˌəriɟoːˈiːʈ
علمي	alˈʌmi
لاهري	laːhˈʌri
لائجي	laːˈɪɟi
ٽڪرين	ʈˌəkrˈiːn
پرنسپل	pˌərənsəpˈʌl
پورس	poːrˈʌs
ساک	sˈaːkʰ
اوکا	ˈuːkʰaː
پڪي	pˈʌki
ڀلائي	bʰəlˈaːi
فرار	fərˈaːr
چوڻي	cˈoːɳi
سنها	sənˈʌhaː
منٽن	mˌənəʈˈʌn
تجارتي	t̪ˌəɟaːrˈʌt̪i
پهچي	pəhˈʌci
ساھ	sˈaːh
نصابي	nˌəʂaːbˈiː
اڻبڻت	ˌaɳəbəɳˈʌt̪
ميونسپالٽي	mjˌoːnsəpaːlˈʌʈi
واقعي	ʋaːqˈaːi
شيڪسپيئر	ʃˌeːkəspiˈɪr
ڳرا	ɡˈʌraː
حاجيبايوف	hˌaːɟibˈaːjoːf
مرض	mərˈʌz
اسڪالر	ˌaskaːlˈʌr
ڪناري	kənˈaːri
گند	ɡˈʌnd
پيوتن	pjoːt̪ˈʌn
تصديق	t̪ˌəʂdˈiːq
پناه	pənˈaːh
ناولن	nˌaːoːlˈʌn
اعلي	ˈaːli
چاڙهيو	caːr.ˈʌhjoː
مرحلن	mˌərəhəlˈʌn
توري	t̪ˈoːri
شاه	ʃˈaːh
فڪر	fəkˈʌr
فائينل	fˌaːinˈʌl
جيڏا	ɟˈeːɖaː
ٿو	tʰˈoː
گذارو	ɡəzˈaːroː
ضمير	zəmˈiːr
نيچ	nˈeːc
سيڪنڊ	seːkˈʌnɖ
تباه	t̪əbˈaːh
درست	dərˈʌst̪
پرڳڻي	pˌərəɡˈʌɳi
ھير	hˈeːr
فرمايائون	fˌərmˌaːjaːˈoːn
داخل	daːxˈʌl
طرفين	tˌərfˈiːn
نوح	nˈoːh
غياث	ɣjˈaːs
مقداري	mˌəqdˈaːri
بگهڙ	bˌəɡəhˈʌr.
ڳڙھ	ɡˈʌr.h
ڪرڻو	kərˈʌɳoː
نصيب	nəʂˈiːb
پابنديون	pˌaːbndjˈoːn
تيمور	t̪eːmˈoːr
سنهڙو	sˌənəhˈʌr.oː
ڪڍندي	kəɖʰˈʌndi
گذريو	ɡəzˈʌrjoː
آهين	aːhˈiːn
سنان	sənˈaːn
لاڳت	laːɡˈʌt̪
ياب	jˈaːb
ذريعا	zərˈiːaː
باڊي	bˈaːɖi
لاڙڪاڻي	lˌaːr.kˈaːɳi
دراز	dərˈaːz
پنڊ	pˈʌnɖ
سخي	sˈʌxi
عدن	adˈʌn
رئفلس	rˌəfəlˈʌs
ڪيون	kjˈoːn
تسڪين	t̪ˌəskˈiːn
ڌمال	dʰəmˈaːl
معيشت	maːˈiːʃt̪
پکڙجي	pˌəkʰər.ˈʌɟi
ڀائرن	bʰˌaːɪrˈʌn
دعوا	dˈaːʋaː
پائوڊر	pˌaːoːɖˈʌr
کے	kʰˈʌeː
سياحن	sjaːhˈʌn
وڃائي	ʋəɲˈaːi
بيمار	bˈeːmaːr
گري	ɡˈʌri
انڪشاف	ˌanəkʃˈaːf
المعروف	ˌalmaːrˈoːf
مربي	mˌərbˈiː
ٿڌ	ʈˈʌdʰ
منٺار	mˌənʈʰˈaːr
لسي	lˈʌsi
لٽريچر	lˌəʈricˈʌr
صرف	ʂərˈʌf
بيهاري	bˈeːhaːrˌiː
ڏسڻ	ɖɪsˈʌɳ
ڄاڻايو	ɟaːɳˈaːjoː
سڪڻ	səkˈʌɳ
طرفي	tərˈʌfi
ساڻن	saːɳˈʌn
نباتات	nəbˈaːtˈaːt
اڍائي	aɖʰˈaːi
بينگ	bˈeːnɡ
طالب	taːlˈʌb
پن	pˈʌn
جائداد	ɟˌaːɪdˈaːd
اسٽار	ˌasʈˈaːr
پرنٽ	pˌərənˈʌʈ
دروازن	dˌərʋaːzˈʌn
کلي	kʰˈʌli
چيتن	ceːt̪ˈʌn
صلاحڪار	ʂˌəlaːhkˈaːr
حيات	hjˈaːt̪
سينيٽ	seːnˈiːʈ
زرتشتي	zˌərət̪ˈʌʃt̪i
لڙائي	lər.ˈaːi
عضوا	ˈazʋaː
هارائي	haːrˈaːi
ويلفيئر	ʋˌeːlfiˈɪr
کائي	kʰˈaːi
آخوند	aːxˈoːnd
نوابشاھ	nˈaʋaːbʃaːh
ڪاٽن	kaːʈˈʌn
حصول	həʂˈoːl
اورنگ	uːrˈʌnɡ
ڪچهري	kˌəcəhˈʌri
هزاري	həzˈaːri
لاھي	lˈaːhi
ٺاھيون	ʈʰaːhjˈoːn
رھندي	rəhˈʌndi
چين	cˈeːn
گڏي	ɡˈʌɖi
نباتاتي	nəbˈaːt̪aːt̪ˌiː
ويندو	ʋˈeːndoː
برهمڻ	bˌərəhəmˈʌɳ
کنيا	kʰˈʌnjaː
ڪيڙا	kˈeːr.aː
ڪارنامن	kˌaːrnaːmˈʌn
لپي	lˈʌpi
آن	ˈaːn
ڊائريڪشن	ɖˌaːɪrˌiːkəʃˈʌn
ٿيسز	tʰeːsˈʌz
ڏوھن	ɖoːhˈʌn
نجات	nˌəɟˈaːt
انڊيا	ˈɪnɖjaː
ٻڪرين	bˌəkrˈiːn
پرهيز	pˌərhˈiːz
جائزو	ɟaːˈɪzoː
مٿس	məʈˈʌs
واسطي	ʋaːsˈʌti
ويدانتي	ʋˌeːdaːnˈʌt̪i
حال	hˈaːl
گهٽجي	ɡˌəhəʈˈʌɟi
ميڪسيڪو	mˌeːksˈiːkoː
سست	sˈʌst̪
ٽيپ	ʈˈeːp
نيل	nˈeːl
سجاڳي	səɟˈaːɡi
ڳڀ	ɡˈʌbʰ
فاطمہ	fˌaːtəmˈʌh
بخارن	bˌəxaːrˈʌn
انوکو	anˈoːkʰoː
سولي	sˈoːli
ڪلهوڙو	kˌəlhˈuːr.oː
سائنسي	saːˈɪnsi
علائقو	ˌalaːˈɪqoː
تفصيل	t̪əfˈʌʂjal
جنگي	ɟˈʌnɡi
حڪمراني	hˌəkəmrˈaːni
مالي	mˈaːli
ڌرم	dʰərˈʌm
ڪيرائي	keːrˈaːi
سهرو	səhˈʌroː
ڪلياڻ	kəljˈaːɳ
ائٽمن	ˌaʈəmˈʌn
برطانيائي	bˌərtaːnjˈaːi
ٽيڪسٽائيل	ʈˌeːkəsʈˈaːjal
ڏسن	ɖɪsˈʌn
ٻيٽن	beːʈˈʌn
پروڙ	pərˈoːr.
سٿين	sətʰˈiːn
پيدائش	pˌeːdaːˈɪʃ
افغان	ˌafɣˈaːn
ورق	ʋərˈʌq
فاعل	faːˈaːl
ڳن	ɡˈʌn
ذهين	zəhˈiːn
بيهندو	bˈeːhəndˌoː
مطالبو	mʊtˈaːlɪbˌoː
هم	hˈʌm
فلاحي	fəlˈaːhi
استقبال	ˌɪstɪqbˈaːl
خوشحال	xˈʊʃhaːl
ڄام	ɟˈaːm
شغل	ʃəɣˈʌl
ايستائين	ˌeːst̪aːˈiːn
ايڊنبرا	ˌeːɖənbˈʌraː
تڏهوڪي	t̪ˌəɖhˈuːki
ارطغرل	ˌarətˌəɣərˈʌl
ڏڪار	ɖəkˈaːr
سينيئر	sˌeːniˈɪr
کنڊرن	kʰˌənɖərˈʌn
پارٽين	pˌaːrʈˈiːn
اھڃاڻ	ˌahɲˈaːɳ
پرچارڪ	pˌərcaːrˈʌk
انتظاميه	ˌɪntɪʐaːmˈiːh
ڊيگھھ	ɖeːɡʰˈʌh
شھنشاھ	ʃˌəhənʃˈaːh
مظاهرن	mˌəʐaːhərˈʌn
آڻيندو	aːɳˈiːndoː
صحيح	ʂˈʌhih
پوتر	poːt̪ˈʌr
تلاوت	t̪ˌəlaːˈoːt̪
اونهاري	ˌuːnhˈaːri
پٽالا	pəʈˈaːlaː
محدود	mˌəhdˈuːd
لغارين	lˌəɣaːrˈiːn
مسعود	mˌəsaːˈoːd
جولاء	ɟˈoːlaː
مست	mˈʌst̪
قدرتي	qˌədərˈʌt̪i
پرورش	pˌəroːrˈʌʃ
تجزئي	t̪ˌəɟəzˈʌi
توانائي	t̪ʋaːnˈaːi
وسري	ʋəsˈʌri
لهجو	ləhˈʌɟoː
التحصيل	ˌalət̪əhˈʌʂjal
اسٽئنڊرڊ	ˌasəʈˌənɖərˈʌɖ
سپڙ	səpˈʌr.
تڪسيد	t̪ˌəksˈiːd
لاس	lˈaːs
سرحدي	sˌərəhˈʌdi
گهرو	ɡəhˈʌroː
معراج	maːrˈaːɟ
حملي	həmˈʌli
واٽ	ʋˈaːʈ
ڏهاڪو	ɖəhˈaːkoː
ڪلاڪن	kˌəlaːkˈʌn
تڪراري	t̪ˌəkrˈaːri
ميٽر	meːʈˈʌr
فاصلي	faːʂˈʌli
هيڊڪوارٽر	hˌeːɖkʋˌaːrəʈˈʌr
ليکجي	leːkʰˈʌɟi
برطانيہ	bˌərtaːnˈiːh
نم	nˈʌm
چونڊ	cˈoːnɖ
جيڪڏھن	ɟˌeːkəɖəhˈʌn
وهڻ	ʋəhˈʌɳ
آبپاشي	ˌaːbpˈaːʃi
نابود	naːbˈoːd
ڏيو	ɖjˈoː
سنهو	sənˈʌhoː
رهندي	rəhˈʌndi
ميٽرن	mˌeːʈərˈʌn
لکيا	lˈʌkʰjaː
پھاڙ	pəhˈaːr.
منسلڪ	mˌənsəlˈʌk
ٻاهران	bˌaːhərˈaːn
نير	nˈeːr
ڪابل	kaːbˈɪl
حليم	həlˈiːm
ڄاڻن	ɟaːɳˈʌn
ڳوڙهو	ɡoːr.ˈʌhoː
پوريون	poːrjˈoːn
آمريت	ˌaːmrˈiːt̪
جذبا	ɟˌəzbˈaː
بپتسما	bˌəpət̪əsˈʌmaː
پختو	pˈʌxt̪oː
شھابن	ʃˌəhaːbˈʌn
بلتستان	bˌələt̪ˈɪstaːn
هوبهو	hoːbˈʌhoː
هيئن	hˈiːʌ̃
وهڪرو	ʋˌəhəkˈʌroː
روپوش	roːpˈoːʃ
برطرف	bˌərətərˈʌf
قطارون	qˌətaːrˈoːn
ججن	ɟəɟˈʌn
دٻي	dˈʌbi
گھاٽائي	ɡʰaːʈˈaːi
ظالم	ʐaːlˈʌm
فيض	fˈeːz
تارن	t̪aːrˈʌn
ايمرجنسي	ˌeːmərəɟˈʌnsi
جاندارن	ɟˌaːndaːrˈʌn
ويٺا	ʋˈeːʈʰaː
وڪٽوريه	ʋˌəkʈoːrˈiːh
ميلاپ	meːlˈaːp
هوندو	hˈũːdoː
بغير	bəɣˈiːr
مڃتا	məɲˈʌt̪aː
هنيو	hˈʌnjoː
ڪتابت	kˌɪtaːbˈʌt̪
پنجويهه	pˌənɟʋihˈʌh
دفاعي	dˈɪfaːˌiː
جيڏو	ɟˈeːɖoː
ڪاميٽيون	kˌaːmiʈjˈoːn
ڏهه	ɖəhˈʌh
هيلٿ	heːlˈʌʈ
لينڊ	lˈeːnɖ
وڇائي	ʋəcʰˈaːi
ڇپرايو	cʰˌəprˈaːjoː
دستبردار	dˌəst̪əbrdˈaːr
حامل	haːmˈʌl
سڄا	sˈʌɟaː
رازن	raːzˈʌn
پهرئين	pˌəhərˈiːn
مستند	məst̪ˈʌnd
ڳاڙها	ɡaːr.ˈʌhaː
ٽائون	ʈaːˈoːn
داستان	daːst̪ˈaːn
بحال	bəhˈaːl
ڇڏائي	cʰəɖˈaːi
خدائي	xədˈaːi
مليريا	məlˈiːrjaː
خانگي	xˈaːnɡi
ڳاڙھي	ɡˈaːr.hi
بحران	bˌəhrˈaːn
اھم	ahˈʌm
ميوو	mjʋˈoː
اھڙا	ahˈʌr.aː
لسان	ləsˈaːn
ڪم	kˈʌm
جم	ɟˈʌm
مختصرن	mˌəxt̪əʂərˈʌn
سرور	sərˈoːr
مٿڀرو	mˌəʈəbʰˈʌroː
آبشار	ˌaːbʃˈaːr
عنه	anˈʌh
وڌا	ʋˈʌdʰaː
سڏيا	sˈʌɖjaː
آنڊي	ˈaːnɖi
سنگر	sənɡˈʌr
اڄوڪي	aɟˈoːki
ساٺ	sˈaːʈʰ
زمينون	zˌəminˈoːn
روپ	rˈoːp
جبريت	ɟˌəbrˈiːt̪
اولھ	uːlˈʌh
شعبي	ʃˈɔbi
ثقافتي	sˌəqaːfˈʌt̪i
مشن	məʃˈʌn
ڇهون	cʰəhˈoːn
ڪلر	kəlˈʌr
جسم	ɟəsˈʌm
فائز	faːˈɪz
درخواست	dˌarxʋˈaːst
عشق	aʃˈʌq
کتل	kʰət̪ˈʌl
برٽن	bˌərəʈˈʌn
لياقت	ljaːqˈʌt̪
اميدوار	ˌamidʋˈaːr
یا	jˈaː
ڪارڪردگي	kˌaːrəkərdˈʌɡi
پڙهڻ	pˌər.əhˈʌɳ
جبر	ɟəbˈʌr
معيار	maːjˈaːr
دانائي	daːnˈaːi
مغيره	mˌəɣirˈʌh
مالش	maːlˈʌʃ
راهو	rˈaːhoː
غلامي	ɣəlˈaːmi
نوان	nˈaʋaːn
پوئلڳ	poːˈɪləɡ
بڻجڻ	bˌəɳəɟˈʌɳ
باغي	bˈaːɣi
رتي	rˈʌt̪i
اينجلس	ˌeːnəɟəlˈʌs
مقالا	məqˈaːlaː
چنڊن	cənɖˈʌn
سنھي	sˈʌnhi
آئيني	aːˈiːni
مدبر	mˌədəbˈʌr
ملوث	məlˈoːs
قافلو	qaːfˈʌloː
ديسي	dˈeːsi
ناميارن	nˌaːmjaːrˈʌn
مارائي	maːrˈaːi
يورپين	jˌoːrpˈiːn
موکي	mˈoːkʰi
جبل	ɟəbˈʌl
جنوري	ɟənˈoːri
صحافت	ʂˌəhaːfˈʌt̪
ٺهرايل	ʈʰˌəhərˈaːjal
ڪاٿي	kˈaːtʰi
سپرد	sʊpˈʊrd
سان	sˈãː
لکڻين	lˌəkʰɳˈiːn
دونهون	dˌoːnhˈoːn
آل	ˈaːl
پارو	pˈaːroː
گھرائي	ɡʰərˈaːi
روھڙي	roːhˈʌr.i
فلمن	fˈɪlmn
فرقن	fˌərəqˈʌn
کيڏڻ	kʰeːɖˈʌɳ
تعمير	t̪aːmˈiːr
پرستن	pˌərəst̪ˈʌn
وجهڻ	ʋˌəɟəhˈʌɳ
ننڍين	nˌənɖʰˈiːn
ڊيم	ɖˈeːm
ڏئي	ɖˈʌi
وچان	ʋəcˈaːn
جاپاني	ɟaːpˈaːni
پرفارمنس	pˌərfˌaːrəmˈʌns
باطني	bˈaːtnˌiː
سجدي	səɟˈʌdi
پوکيندا	poːkʰˈiːndaː
شال	ʃˈaːl
باز	bˈaːz
امن	amˈʌn
نت	nˈʌt̪
ڏٺي	ɖˈʌʈʰi
ٽٽل	ʈəʈˈʌl
ڪٿ	kˈʌʈ
ارغونن	ˌarɣoːnˈʌn
ماڻهو	mˈaːɳhuː
سامونڊري	sˌaːmoːnɖˈʌri
شهباز	ʃˌəhəbˈaːz
بيماريون	bˈeːmaːrjˌoːn
جڳهہ	ɟˌəɡəhˈʌh
منجھس	mˌənəɟəhˈʌs
آئرلينڊ	ˌaːɪrlˈiːnɖ
سليس	səlˈiːs
ڪچيون	kəcjˈoːn
ٽورنامينٽ	ʈˌoːrnˌaːminˈʌʈ
گهڻو	ɡəhˈʌɳoː
حڪمرانن	hˌəkəmraːnˈʌn
عدم	adˈʌm
کاڻ	kʰˈaːɳ
ڪارا	kˈaːraː
ٻير	bˈeːr
جاڳرتا	ɟˌaːɡərˈʌt̪aː
ڏند	ɖˈʌnd
ڪونهي	koːnˈʌhi
اٿينز	ˌatʰinˈʌz
وڌل	ʋədʰˈʌl
ڙي	r.ˈeː
رحيمداد	rˌəhimdˈaːd
ڏينهن	ɖˈĩːhʊ̃
وانگر	ʋaːnɡˈʌr
ڪرم	kərˈʌm
مؤرخ	mˌəa͡ʊrˈʌx
ڊرگھ	ɖərˈʌɡʰ
رجسٽرار	rˌəɟəsˌəʈrˈaːr
حامد	haːmˈʌd
جوهي	ɟˈoːhi
طبقا	təbˈʌqaː
نائين	naːˈiːn
قابل	qaːbˈɪl
زراعت	zˌəraːˈaːt̪
فوڊ	fˈoːɖ
ڳائڻ	ɡaːˈɪɳ
لغت	ləɣˈʌt̪
ليڪا	lˈeːkaː
جذبات	ɟˌəzəbˈaːt
چاچي	cˈaːci
نمونيا	nəmˈoːnjaː
فوت	fˈoːt̪
ڪماري	kəmˈaːri
لسو	lˈʌsoː
منات	mˌənˈaːt
ٽيمن	ʈeːmˈʌn
لکنو	ləkʰˈʌnoː
ڳنڍڻ	ɡˌənəɖʰˈʌɳ
مولانا	moːlˈaːnaː
سڏيو	sˈʌɖjoː
پئدائش	pˌədaːˈɪʃ
احسان	ɛhsˈaːn
تاڙي	t̪ˈaːr.i
دکن	dəkʰˈʌn
مشڪون	mˌəʃkˈuːn
اٽل	aʈˈʌl
ھزار	həzˈaːr
ٿلھي	ʈəlˈʌhi
آئي	ˈaːi
رشتو	rˈʌʃt̪oː
ڄيٺانند	ɟˌeːʈʰaːnˈʌnd
ڦريل	pʰˈʌrjal
مشرقي	mˈaʃrˌɪqi
ڇانئجي	cʰaːnˈʌɟi
تڪليفون	t̪ˌəklifˈoːn
شڪارپور	ʃˌəkaːrpˈoːr
ھلندڙ	hˌələndˈʌr.
پختا	pˈʌxt̪aː
ڪاسٽ	kaːsˈʌʈ
پرڪشش	pˌərəkəʃˈʌʃ
يا	jˈaː
اثرائتي	ˌasraːˈɪt̪i
ثبوت	səbˈoːt̪
ترجمي	t̪ˌərəɟˈʌmi
ٺھرائي	ʈʰˌəhrˈaːi
دارا	dˈaːraː
شيعه	ʃˈiːh
ھوندا	hˈoːndaː
تاهم	t̪aːhˈʌm
رڌل	rədʰˈʌl
ياقوت	jaːqˈoːt̪
ھيٺيان	heːʈʰjˈaːn
ڌاڳو	dʰˈaːɡoː
برطانوي	bˌərtˈaːnʋi
آر	ˈaːr
بهادري	bˌəhaːdˈʌri
سالن	saːlˈʌn
پنو	pˈʌnoː
سربراھ	sˌərəbrˈaːh
قلمبند	qˌələmbˈʌnd
هل	hˈʌl
شهرت	ʃˌəhərˈʌt̪
نيشاپور	nˌeːʃaːpˈoːr
انڙ	anˈʌr.
ايشيائي	eːʃjˈaːi
هاشمي	haːʃˈʌmi
وجهبا	ʋˌəɟəhəbˈaː
جابر	ɟaːbˈɪr
کلون	kʰəlˈoːn
بنيا	bˈʌnjaː
مٿان	mətʰˈaːn
ڪراچي	kərˈaːci
سهڪاري	sˌəhəkˈaːri
فيصلن	fˌeːʂəlˈʌn
لازم	laːzˈʌm
ڪڪڙ	kəkˈʌr.
ڪس	kˈʌs
پاسن	paːsˈʌn
سورن	soːrˈʌn
سهي	sˈʌhi
ديوارن	djʋaːrˈʌn
پس	pˈʌs
ڊرائيونگ	ɖˌəraːjˈoːnɡ
فلسطين	fˌələstˈiːn
منجهان	mˌənəɟhˈaːn
ڏسندو	ɖɪsˈʌndoː
اوسر	uːsˈʌr
ايئرپورٽ	eːˈɪrpˌoːrəʈ
لئي	lˈʌi
قاضن	qaːzˈʌn
حماد	həmˈaːd
خلق	xəlˈʌq
صحرائي	ʂˌəhrˈaːi
اينديون	eːndjˈoːn
تميم	t̪əmˈiːm
گهوٽ	ɡəhˈoːʈ
ولد	ʋəlˈʌd
ميانوال	mjaːnʋˈaːl
ساخت	sˈaːxt̪
بگاڙ	bəɡˈaːr.
مينگهواڙ	mˌeːnɡəhʋˈaːr.
ڦولن	pʰoːlˈʌn
لهري	ləhˈʌri
ڊگرين	ɖˌəɡrˈiːn
نعمت	naːmˈʌt̪
شخصن	ʃˈaxʂn
راڄن	raːɟˈʌn
وڌيون	ʋədʰjˈoːn
مانجھند	mˌaːnəɟəhˈʌnd
طيب	tˈeːb
عزيزن	ˌazizˈʌn
خاتون	xaːt̪ˈoːn
ڄڃ	ɟˈʌɲ
ڊاڪٽرن	ɖˌaːkəʈərˈʌn
آفريڪي	ˌaːfrˈiːki
جهنگ	ɟəhˈʌnɡ
ديش	dˈeːʃ
ڄامن	ɟaːmˈʌn
ڪردارن	kˌərdaːrˈʌn
علت	alˈʌt̪
باطن	bˈaːtən
وڃائڻ	ʋˌəɲaːˈɪɳ
سويت	sʋˈeːt̪
بلوچن	bˌəloːcˈʌn
استعيفا	ˌast̪aːˈiːfaː
سڪندر	sˌəkəndˈʌr
ملائڪن	mˌəlaːɪkˈʌn
خليل	xˈʌljal
فرائض	fˌəraːˈɪz
ٿورو	tʰˈoːroː
ڪمار	kəmˈaːr
ڄاتل	ɟaːt̪ˈʌl
صدرالدين	ʂˌədrˌaːldˈiːn
چٽي	cˈʌʈi
موڪليا	moːkˈʌljaː
بچو	bˈʌcoː
سترھين	sˌət̪ərhˈiːn
هرڻ	hərˈʌɳ
ڪينجهر	kˌeːnəɟəhˈʌr
ڪيڏو	kˈeːɖoː
پڙھندڙ	pˌər.həndˈʌr.
برھمڻ	bˌərəhəmˈʌɳ
رنگ	rˈʌnɡ
نوٽ	nˈoːʈ
ڌوم	dʰˈoːm
سفرنامي	sˌəfərnˈaːmi
لاهور	laːhˈoːr
نمائندو	nˈʊmaːˈɪndoː
ٽين	ʈˈeːn
اظهار	ˌaʐhˈaːr
موٽائي	moːʈˈaːi
سونھري	sˈoːnhri
پيچ	pˈeːc
حوالو	haʋˈaːloː
فراھم	fˌəraːhˈʌm
وفائي	ʋəfˈaːi
خراسان	xˌəraːsˈaːn
گڏوگڏ	ɡˌəɖoːɡˈʌɖ
موڪليون	mˌoːkljˈoːn
منجهيل	mˌənəɟˈʌhjal
فيروز	feːrˈoːz
ديهانت	dˌeːhaːnˈʌt̪
ٺاهيا	ʈʰˈaːhjaː
واقفيت	ʋˌaːqfˈiːt̪
نوبل	noːbˈʌl
ڪنگز	kənɡˈʌz
کٽيو	kʰˈʌʈjoː
رسوخ	rəsˈoːx
اڳواڻ	aɡʋˈaːɳ
ستلج	sˌət̪əlˈʌɟ
قلعي	qəlˈaːi
حرڪت	hˌərəkˈʌt̪
ضياء	zjˈaː
فٽ	fˈʌʈ
تڪڙي	t̪əkˈʌr.i
لاڏائو	laːɖˈaːoː
تخمينو	t̪ˌəxmˈiːnoː
پھچي	pəhˈʌci
سياستدان	sjˌaːst̪ədˈaːn
ڪائناتي	kˌaːɪnˈaːt̪i
اڀياس	abʰjˈaːs
وسيع	ʋˈʌsi
ڦٽي	pʰˈʌʈi
لھرن	lˌəhərˈʌn
باگڙين	bˈaːɡr.ˌiːn
عھدو	ahˈʌdoː
ايراضي	eːrˈaːzi
ھوابازي	hʋaːbˈaːzi
ٽپال	ʈəpˈaːl
ڏيندو	ɖˈeːndoː
اڀري	abʰˈʌri
تازو	t̪ˈaːzoː
پون	pˈoːn
ڄامشورو	ɟˌaːmʃˈoːroː
پاڙن	paːr.ˈʌn
ايڊٽ	eːɖˈʌʈ
تو	t̪ˈoː
قاعدو	qˈaːjdoː
آڻڻ	aːɳˈʌɳ
چوپائي	coːpˈaːi
سوڊان	soːɖˈaːn
مخلوق	mˌəxlˈuːq
معصومي	maːʂˈoːmi
ڪپور	kəpˈoːr
لائيو	lˈaːjoː
ڊرائيور	ɖˌəraːjˈoːr
طبيعت	təbˈiːt̪
پرڏيهي	pˌərɖˈiːhi
بگهاڙ	bˌəɡhˈaːr.
ڪاليج	kaːlˈiːɟ
ڏسو	ɖˈɪsoː
ڪري	kˈareː
ٻڌ	bˈʌdʰ
تجربا	t̪ˌəɟərbˈaː
جھلي	ɟəhˈʌli
جاگرافي	ɟˌaːɡrˈaːfi
نصب	nəʂˈʌb
پناھ	pənˈaːh
مسڪين	mˌəskˈiːn
نظارن	nˌəʐaːrˈʌn
ٻوڙن	boːr.ˈʌn
زنجبار	zˌənəɟbˈaːr
ويڪري	ʋeːkˈʌri
شاهجهان	ʃˌaːhəɟhˈaːn
وڻ	ʋˈʌɳ
اسلامي	ˌɪslˈaːmi
ڪيڊٽ	keːɖˈʌʈ
خرچ	xˈʌrc
لاهوتي	laːhˈoːt̪i
ٽرسٽ	ʈˌərəsˈʌʈ
سينگار	seːnɡˈaːr
ڇاتي	cʰˈaːt̪i
حرفن	hˌərəfˈʌn
زهري	zəhˈʌri
روانگي	rʋˈaːnɡi
لٿل	ləʈˈʌl
معتدل	mˌaːt̪ədˈʌl
تقابلي	t̪ˌəqaːbˈʌli
ورڻ	ʋərˈʌɳ
جهان	ɟəhˈaːn
الفريڊ	ˌaləfrˈiːɖ
نبوي	nəbʋˈiː
زيد	zˈeːd
اينٽلانٽڪ	ˌeːnəʈlaːnəʈˈʌk
کوهن	kʰoːhˈʌn
ڊسٽرڪٽ	ɖˌəsəʈˌərəkˈʌʈ
فرمان	fˌərmˈaːn
رهندو	rəhˈʌndoː
ڦاڪ	pʰˈaːk
ٿيندڙ	tʰĩːdˈʌr.
ماخذ	maːxˈʌz
پائليٽ	pˌaːɪlˈiːʈ
بلبن	bˌələbˈʌn
منصب	mˌənəʂˈʌb
ڇند	cʰˈʌnd
ڪبوتر	kəbˈoːt̪ər
رياستون	rjaːst̪ˈoːn
ابتڙ	ˌabət̪ˈʌr.
آزمائي	ˌaːzmˈaːi
چئنلن	cˌənəlˈʌn
محاذ	məhˈaːz
کی	kʰˈeː
به	bˈɪ
بعضي	bˈaːzi
هٽايو	həʈˈaːjoː
ڪيريئر	kˌeːriˈɪr
محمدي	mˌəhəmˈʌdi
آسام	aːsˈaːm
ﷺ	lˈetəˈefdˈiːˈefˈeːj
مثل	məsˈʌl
پورو	pˈoːroː
ڏڪر	ɖəkˈʌr
راضي	rˈaːzi
پائڻ	paːˈɪɳ
نجي	nˈʌɟi
گڻ	ɡˈʌɳ
بادشاهن	bˈaːdʃˌaːhən
آريسر	ˌaːrisˈʌr
تصنيفون	t̪ˌəʂnifˈoːn
روزانو	roːzˈaːnoː
هنري	hənˈʌri
اولاهين	ˌuːlaːhˈiːn
وڻج	ʋəɳˈʌɟ
شديد	ʃədˈiːd
ملائڻ	mˌəlaːˈɪɳ
ڊرامن	ɖˌəraːmˈʌn
جلاوطني	ɟˌəlaːoːtˈʌni
عيال	ajˈaːl
اڳڀرو	ˌaɡəbʰˈʌroː
غسان	ɣəsˈaːn
ٺاهيل	ʈʰˈaːhjal
بزرگن	bˈʊzʊɾɡn
يورپي	joːrˈʌpi
پيشڪش	pˌeːʃəkˈʌʃ
ناجائز	nˌaːɟaːˈɪz
مجيد	məɟˈiːd
داغ	dˈaːɣ
سن	sˈʌn
آزمائش	ˌaːzmaːˈɪʃ
وسيلن	ʋˌəsilˈʌn
پيوند	pjˈoːnd
تابڪاري	t̪ˌaːbkˈaːri
لک	lˈʌkʰ
سگهون	sˌəɡhˈuːn
شڪست	ʃəkˈʌst̪
وچن	ʋəcˈʌn
قسط	qˈɪst
سمجهو	sˌəməɟˈʌhoː
دروازي	dərʋˈaːzi
عبدالحق	ˌabdˌaːləhˈʌq
پلي	pˈʌli
ريشمي	reːʃˈʌmi
اهتمام	ˌahət̪mˈaːm
ڪينئان	kˌeːnˈaːn
جاٽ	ɟˈaːʈ
درجا	dˈarɟaː
آرڪيالاجيڪل	ˌaːrkjˌaːlaːɟikˈʌl
سڀا	sˈʌbʰaː
وارا	ʋˈaːraː
خراج	xərˈaːɟ
پيش	pˈeːʃ
ڪندڙ	kəndˈʌr.
دخل	dəxˈʌl
متحرڪ	mˌət̪əhərˈʌk
آيتن	ˌaːit̪ˈʌn
افاديت	ˌafaːdˈiːt̪
ڇھون	cʰəhˈoːn
ويجھو	ʋeːɟˈʌhoː
ڪلو	kˈʌloː
پوئين	poːˈiːn
دينيات	dˌeːniˈaːt
پسنديده	pˌəsndidˈʌh
امروهي	ˌamrˈoːhi
ٽيڪنيڪي	ʈˌeːknˈiːki
زرخيزي	zˌərxˈiːzi
هرچند	hərcˈʌnd
اسرائيلي	ˌasraːˈiːli
اسانجي	ˌasaːnˈʌɟi
ملاوٽ	mˌəlaːˈoːʈ
سڏجڻ	sˌəɖəɟˈʌɳ
سگھيو	sˈʌɡʰjoː
راندين	raːndˈiːn
ناتو	nˈaːt̪oː
بنگال	bənɡˈaːl
باھ	bˈaːh
اشاعتي	ˌaʃaːˈaːt̪i
فرخ	fərˈʌx
ڪپر	kəpˈʌr
تعميرات	t̪ˌaːmirˈaːt
ڪينال	keːnˈaːl
جلدي	ɟəlˈʌdi
ٻيو	bjˈoː
اسڪندر	ˌasəkəndˈʌr
مکي	mˈʌkʰi
سوڄ	sˈoːɟ
ٻڌل	bədʰˈʌl
اشارن	ˌaʃaːrˈʌn
ڪلاڪار	kˌəlaːkˈaːr
قائل	qaːˈɪl
گھڻائي	ɡʰəɳˈaːi
ووٽنگ	ʋoːʈˈʌnɡ
پليجي	pəlˈiːɟi
حسد	həsˈʌd
غلامن	ɣˌəlaːmˈʌn
عقيدي	aqˈiːdi
سوڍا	sˈoːɖʰaː
شڪلين	ʃˌəklˈiːn
بيماري	bˈeːmaːrˌiː
ٺاھيو	ʈʰˈaːhjoː
لڳندڙ	lˌəɡəndˈʌr.
اکين	akʰˈiːn
ضرورتون	zˌaruːrt̪ˈoːn
لھجو	ləhˈʌɟoː
انقلابي	ˌɪnqɪlaːbˈiː
عدالتون	ˌadaːlt̪ˈoːn
تبليغي	t̪ˌəblˈiːɣi
دستاويزن	dˌəst̪aːʋizˈʌn
هلائڻ	hˌəlaːˈɪɳ
وڙهندا	ʋˌər.əhˈʌndaː
رهندڙ	rˌəhəndˈʌr.
پيارڻ	pjaːrˈʌɳ
سوڻ	sˈoːɳ
ٿيندو	tʰˈĩːdoː
شاخون	ʃaːxˈoːn
خصوصي	xəʂˈoːʂi
جون	ɟˈoːn
روايتن	rʋˌaːit̪ˈʌn
چرين	cərˈiːn
سکيو	sˈʌkʰjoː
ڪشمڪش	kˌəʃəməkˈʌʃ
ڪرڙ	kərˈʌr.
اولاد	uːlˈaːd
ملاحن	mˌəlaːhˈʌn
برطانيا	bˌərtˈaːnjaː
سهڻو	səhˈʌɳoː
پارن	paːrˈʌn
ستابو	sˌət̪aːbˈoː
سار	sˈaːr
ڪڍي	kˈʌɖʰi
جيمز	ɟeːmˈʌz
انگريزي	ˌanɡərˈiːzi
سڃاتي	səɲˈaːt̪i
پيپر	peːpˈʌr
کاري	kʰˈaːri
گائيڊ	ɡaːˈiːɖ
گهمندو	ɡˌəhəmˈʌndoː
جاگرافيدان	ɟˌaːɡrˌaːfidˈaːn
فريئر	fˌəriˈɪr
تڪليفن	t̪ˌəklifˈʌn
درجہ	dˈarɟh
جنسي	ɟˈɪnsi
لوڻ	lˈoːɳ
خلافت	xˌəlaːfˈʌt̪
ڀوپال	bʰoːpˈaːl
ناليواري	naːljʋˈaːri
شوق	ʃˈoːq
نيوز	njˈoːz
پاڻياٺ	paːɳjˈaːʈʰ
عيسائيت	ˌaisaːˈiːt̪
نفاذ	nəfˈaːz
اپريل	apˈʌrjal
زبون	zəbˈoːn
چمپا	cˈʌmpaː
وضاحت	ʋˌəzaːhˈʌt̪
پرزائيڊنگ	pˌərzˌaːiɖˈʌnɡ
عهدي	ahˈʌdi
لکپڙهه	lˌəkʰəpˌər.əhˈʌh
ڪٺو	kˈʌʈʰoː
طبع	təbˈaː
ڇپايو	cʰəpˈaːjoː
نظرين	naʐˈarin
پت	pˈʌt̪
ميل	mˈeːl
علميت	ˌalmˈiːt̪
گهڙيو	ɡəhˈʌr.joː
برقرار	bˌərəqrˈaːr
ٽنڊوالهيار	ʈˌənɖʋaːlhjˈaːr
ياتري	jaːt̪ˈʌri
جوڙيو	ɟˈoːr.joː
شروع	ʃˈʊruː
ٿولھھ	tʰˌoːləhˈʌh
لي	lˈeː
ميرن	meːrˈʌn
وانگي	ʋˈaːnɡi
سازن	saːzˈʌn
سهولتن	sˌəhoːlət̪ˈʌn
سموري	səmˈoːri
ڳاڙهن	ɡˌaːr.əhˈʌn
تقريبن	t̪ˌəqribˈʌn
سياري	sjˈaːri
پوپٽ	poːpˈʌʈ
مور	mˈoːr
پريس	pərˈiːs
لالچند	lˌaːləcˈʌnd
موڪليل	moːkˈʌljal
بالا	bˈaːlaː
بڪين	bəkˈiːn
نگارن	nˌəɡaːrˈʌn
يمن	jəmˈʌn
واقعات	ʋaːqˈaːt̪
سگريٽ	sˌəɡrˈiːʈ
فقط	fəqˈʌt
ويد	ʋˈeːd
الزام	ˌɪlzˈaːm
آب	ˈaːb
سروس	sərˈoːs
آرڊيننس	ˌaːrɖinˈʌns
آھن	ˈaːhɪn
نوڪرن	nˌoːkərˈʌn
ڪيپٽن	kˌeːpəʈˈʌn
لاڏ	lˈaːɖ
بيڪار	bˈeːkaːr
واڌاري	ʋaːdʰˈaːri
راڳي	rˈaːɡi
رهڻي	rəhˈʌɳi
علوم	alˈoːm
گھراڻي	ɡʰərˈaːɳi
راشدي	raːʃˈʌdi
ڍڪڻ	ɖʰəkˈʌɳ
جابلو	ɟaːbˈʌloː
لائبريرين	lˌaːɪbrirˈiːn
بلڪہ	bˌələkˈʌh
قاصد	qaːʂˈʌd
مثال	məsˈaːl
پرفارم	pˌərfaːrˈʌm
هوندا	hˈũːdaː
مطلع	mətˈʌlaː
ڪٺي	kˈʌʈʰi
ص	sˈʊaːd
دوها	dˈoːhaː
سمجھن	sˌəməɟəhˈʌn
صفحو	ʂəfˈʌhoː
ظاھر	ʐaːhˈʌr
ڏوهه	ɖoːhˈʌh
باريڪ	bˈaːrik
جمالو	ɟəmˈaːloː
سلامي	səlˈaːmi
تعبير	t̪aːbˈiːr
وليج	ʋəlˈiːɟ
مجاهدن	mˌəɟaːhədˈʌn
گڏهه	ɡˌəɖəhˈʌh
هوائن	hʋaːˈɪn
ملڪن	mˌələkˈʌn
سوات	sʋˈaːt̪
قليچ	qəlˈiːc
دستاويزي	dˌəst̪aːʋˈiːzi
ماس	mˈaːs
گاج	ɡˈaːɟ
امين	amˈiːn
کنڀ	kʰənˈʌbʰ
ٻوٽا	bˈoːʈaː
شعر	ʃˈaːr
وڌي	ʋˈʌdʰi
زبان	zəbˈaːn
ڪتبخانو	kˌət̪əbxˈaːnoː
پڪڙڻ	pˌəkər.ˈʌɳ
ڊسڪ	ɖəsˈʌk
پٽاندر	pˌəʈaːndˈʌr
حڪومت	hˌəkoːmˈʌt̪
اختيار	axt̪jˈaːr
ورهين	ʋˌərhˈiːn
کاتو	kʰˈaːt̪oː
شهدادڪوٽ	ʃˌəhədˌaːdkˈoːʈ
ڪٺا	kˈʌʈʰaː
مشير	məʃˈiːr
پيروڪارن	pˌeːroːkaːrˈʌn
ڪرنٽ	kˌərənˈʌʈ
اٿن	aʈˈʌn
ايوانن	ˌeːʋaːnˈʌn
ڪاؤنسلون	kˌaːa͡ʊnsəlˈoːn
تامل	t̪aːmˈʌl
محراب	mˌəhrˈaːb
گرلز	ɡˌərəlˈʌz
لهجن	lˌəhəɟˈʌn
بخشي	bəxˈʌʃi
دولتمند	dˌoːlət̪əmˈʌnd
وصيت	ʋəʂˈiːt̪
فوٽن	foːʈˈʌn
ايوان	eːʋˈaːn
جڏنهن	ɟˌəɖənəhˈʌn
ظاهري	ʐaːhˈʌri
حمايت	hˌəmaːˈiːt̪
لڳايا	ləɡˈaːjaː
علاج	alˈaːɟ
خليفه	xˌəlifˈʌh
ويهندو	ʋeːhˈʌndoː
عيدي	aˈiːdi
عدد	adˈʌd
رڍن	rəɖʰˈʌn
ملتوي	məlˈʌt̪ʋi
دراوڙي	dˌəraːˈoːr.i
قافيه	qaːfˈiːh
جويي	ɟʋjˈeː
محاوري	mˌəhaːˈoːri
اسحاق	ˌashˈaːq
انڊين	ɪnɖˈiːn
ملڪا	məlˈʌkaː
ڳالهائڻ	ɡˌaːlhaːˈɪɳ
ھارون	haːrˈoːn
سمجهجي	sˌəməɟəhˈʌɟi
ڳڙھي	ɡˈʌr.hi
سرجري	sˌərəɟˈʌri
وڪيل	ʋˈʌkjal
ڳڻي	ɡˈʌɳi
بجلي	bəɟˈʌli
مهيا	mˈʌhjaː
نشان	nɪʃˈaːn
تجويز	t̪əɟʋˈiːz
فيملي	feːmˈʌli
صلاحيت	ʂˌəlaːhˈiːt̪
عمدي	amˈʌdi
مٿن	məʈˈʌn
گهراڻو	ɡˌəhərˈaːɳoː
خطرو	xətˈʌroː
سينٽ	seːnˈʌʈ
پيغمبرن	pˌeːɣəmbərˈʌn
چشتي	cˈʌʃt̪i
ويٺي	ʋˈeːʈʰi
تکي	t̪ˈʌkʰi
شهدادپور	ʃˌəhədˌaːdpˈoːr
ٺٽو	ʈʰˈʌʈoː
ڪافي	kˈaːfi
مظلوم	mˌəʐlˈuːm
انصاري	ˌanʂˈaːri
هارون	haːrˈoːn
چڪ	cˈʌk
اهميت	ˌahəmˈiːt̪
مٿين	mətʰˈiːn
ڪهي	kˈʌhi
خطا	xˈʌtaː
حاصلات	hˌaːʂəlˈaːt
عمدو	amˈʌdoː
ٿيڻ	tʰˈɪaɳ
ڊائريڪٽر	ɖˌaːɪrˌiːkəʈˈʌr
شاھه	ʃaːhˈʌh
مرڪبن	mˌərəkəbˈʌn
ڏور	ɖˈoːr
قومون	qoːmˈoːn
اعتراف	ˌeːtɪrˈaːf
گھوٽڪي	ɡʰoːʈˈʌki
ڇنڇر	cʰˌənəcʰˈʌr
بڻايائين	bˌəɳaːjaːˈiːn
اهڙين	ˌahər.ˈiːn
ناگپور	nˌaːɡpˈoːr
الور	alˈoːr
قنوج	qənˈoːɟ
منارو	mənˈaːroː
ٺھندا	ʈʰəhˈʌndaː
تخليقي	t̪ˌəxlˈiːqi
ماٹھن	mˌaːʈəhˈʌn
اڀرندي	ˌabʰərˈʌndi
فل	fˈʌl
مينهن	mˌeːnəhˈʌn
حلقن	hˌələqˈʌn
ميونسپل	mjˌoːnsəpˈʌl
سنڌين	sɪndhˈiːn
پاليسين	pˌaːlisˈiːn
عملن	ˌaməlˈʌn
بچي	bˈʌci
ٻرڻ	bərˈʌɳ
وتايو	ʋət̪ˈaːjoː
پاڙيسري	pˌaːr.isˈʌri
مڻ	mˈʌɳ
تنظيم	t̪ˌənʐˈiːm
رکيون	rəkʰjˈoːn
ٻنھي	bˈʌnhi
غذائي	ɣəzˈaːi
پوين	pʋˈeːn
ڪفر	kəfˈʌr
ڌڙ	dʰˈʌr.
ٻاويهه	bˌaːʋihˈʌh
نقطه	nˌəqətˈʌh
ڳائي	ɡˈaːi
چونڊجڻ	cˌoːnɖəɟˈʌɳ
سوڙهي	soːr.ˈʌhi
ڪاتب	kaːt̪ˈʌb
چرپر	cˌərəpˈʌr
مسئلن	mˌəsəlˈʌn
نقد	nəqˈʌd
گهربل	ɡˌəhərəbˈʌl
اسٽوڊنٽس	ˌasʈˌoːɖənəʈˈʌs
پٺن	pəʈʰˈʌn
واٽس	ʋaːʈˈʌs
سوئر	soːˈɪr
ھڪڙا	həkˈʌr.aː
في	fˈeː
حبيب	həbˈiːb
پيرزادي	pˌeːrzˈaːdi
رفته	rˈafəth
منحصر	mˌənəhəʂˈʌr
ڏهاڙو	ɖəhˈaːr.oː
پوليس	poːlˈiːs
برسات	bˌərəsˈaːt
حوارين	hʋaːrˈiːn
آپريٽنگ	ˌaːpriʈˈʌnɡ
جهڳٽو	ɟˌəhəɡˈʌʈoː
ڪنڀار	kˌənbʰˈaːr
قوتن	qoːt̪ˈʌn
بکري	bəkʰˈʌri
پنھنجو	pənhnˈʌɟoː
سلسليوار	sˈɪlsˌɪljʋaːr
نينهن	nˌeːnəhˈʌn
تقليد	t̪ˌəqlˈiːd
ڏياريو	ɖjˈaːrjoː
جيڪو	ɟˈeːkoː
مجموعا	məɟˈʌmʋaː
داڻا	dˈaːɳaː
انتظار	ˌɪntɪʐˈaːr
اقبال	ˌaqbˈaːl
حاوي	hˈaːʋi
گوپال	ɡoːpˈaːl
نيوٽن	njoːʈˈʌn
وٺ	ʋˈʌʈʰ
پيرون	peːrˈoːn
وھندڙ	ʋˌəhəndˈʌr.
ارتسخ	ˌɪrtɪsˈʌx
ڪشمور	kˌəʃmˈuːr
ونگ	ʋˈʌnɡ
کارائي	kʰaːrˈaːi
رشتن	rəʃt̪ˈʌn
هئي	hˈʊi
مضمونن	mˌəzmuːnˈʌn
گهاٽ	ɡəhˈaːʈ
سيٽون	seːʈˈoːn
ڪچي	kˈʌci
دؤران	dˌəa͡ʊrˈaːn
رهاڻ	rəhˈaːɳ
نرواڻ	nərʋˈaːɳ
سيوهاڻي	sjoːhˈaːɳi
ايندي	ˈeːndi
آهسته	ˌaːhəst̪ˈʌh
نيوزيلينڊ	njˌoːzilˈiːnɖ
سيوھڻ	sjoːhˈʌɳ
لائيف	laːˈiːf
ڇاتين	cʰaːt̪ˈiːn
ريڊ	rˈeːɖ
ڳالهائين	ɡˌaːlhaːˈiːn
مات	mˈaːt̪
استثنا	ˌɪstˈasnaː
ڇوته	cʰoːt̪ˈʌh
چانڊين	caːnɖˈiːn
آپريشن	ˌaːpriʃˈʌn
سندون	səndˈuːn
ڪالونيون	kˌaːloːnjˈoːn
جيئندي	ɟeːˈɪndi
ميان	mjˈaːn
محلن	mˌəhəlˈʌn
جج	ɟˈʌɟ
ٽڪر	ʈəkˈʌr
تنقيد	t̪ˌənqˈiːd
ايسڊ	eːsˈʌɖ
ميري	mˈeːri
آڏواڻي	aːɖʋˈaːɳi
ٽيلي	ʈˈeːli
ڪالي	kˈaːli
باقاعدي	bˈaːqˈaːjdi
شهرين	ʃˌəhərˈiːn
شڪوه	ʃəkˈoːh
صوبا	ʂuːbˈaː
آگاهه	ˌaːɡaːhˈʌh
پنجاب	pˌənɟˈaːb
قلعا	qˈʌlaː
مسالو	məsˈaːloː
چونڊيو	cˈoːnɖjoː
سنڌ	sˈɪndh
لائيٽ	laːˈiːʈ
جڙي	ɟˈʌr.i
شعوري	ʃaːˈoːri
واڳيل	ʋˈaːɡjal
قافلي	qaːfˈʌli
ڄمائي	ɟəmˈaːi
فرمائي	fˌərmˈaːi
ويجهه	ʋˌeːɟəhˈʌh
شيدي	ʃˈeːdi
واپارين	ʋˌaːpaːrˈiːn
نماز	namˈaːz
رسول	rəsˈoːl
افتتاح	ɪftˈɪt̪aːh
مھينن	mˌəhinˈʌn
بنائي	bənˈaːi
بينڪاڪ	bˈeːnkˌaːk
رتو	rˈʌt̪oː
ڇوٽڪارو	cʰˌoːʈkˈaːroː
اتفاق	ˌɪtɪfˈaːq
فوري	fˈoːri
ڏيڻ	ɖˈɪaɳ
فلمون	fˈɪlmuːn
نصيحت	nˌəʂihˈʌt̪
دستاربندي	dˌəst̪aːrəbˈʌndi
سبڻ	səbˈʌɳ
ڪاؤنسل	kˌaːa͡ʊnsˈʌl
خانو	xˈaːnoː
هٿن	həʈˈʌn
ڪرشنا	kˌərəʃˈʌnaː
ترن	t̪ərˈʌn
ڇڏينديون	cʰˌəɖindjˈoːn
گروهن	ɡˌəroːhˈʌn
مالوند	maːlˈoːnd
لاتعداد	lˌaːt̪aːdˈaːd
پندرهن	pˌəndərəhˈʌn
مستي	mˈʌst̪i
ويسٽ	ʋeːsˈʌʈ
الهه	ˌaləhˈʌh
دلچسپ	dˌɪlcˈasp
قيد	qˈeːd
ناڻو	nˈaːɳoː
روزگار	rˌoːzɡˈaːr
ليٽر	leːʈˈʌr
اليڪٽرانڪ	ˌalikˌəʈraːnˈʌk
بڙدي	bər.ˈʌdi
ٻڍل	bəɖʰˈʌl
جو	ɟˈoː
خوفناڪ	xˌoːfnˈaːk
نفرت	nˌəfərˈʌt̪
میں	mˈiːmjˈeːlˈetəcʰˈahabˈiːˈeːj
اسڪرين	ˌasəkrˈiːn
گنڌار	ɡəndʰˈaːr
انچ	ˈanc
پڇڙ	pəcʰˈʌr.
ڏاڏن	ɖaːɖˈʌn
عضون	azˈoːn
مترجم	mˌət̪ərəɟˈʌm
پناهه	pˌənaːhˈʌh
يعني	jˈaːni
سوويت	sʋʋˈeːt̪
الوطني	ˌaloːtˈʌni
جهيڙي	ɟəhˈiːr.i
ڄيٺمل	ɟˌeːʈʰəmˈʌl
مقدما	mʊqˈadmaː
اباڻي	abˈaːɳi
بيورو	bjˈoːroː
مختصر	mˌəxt̪əʂˈʌr
ڦڪا	pʰˈʌkaː
اڪثر	ˌakəsˈʌr
دڳ	dˈʌɡ
وٺرائڻ	ʋˌəʈʰraːˈɪɳ
جهاز	ɟəhˈaːz
جھنگ	ɟəhˈʌnɡ
سمنڊ	səmˈʌnɖ
ڪمپوز	kəmpˈuːz
رڻ	rˈʌɳ
عزم	azˈʌm
سوڍن	soːɖʰˈʌn
چانسلر	cˌaːnsəlˈʌr
انھي	ˈanhi
ڪتابن	kˌɪtaːbˈʌn
ماٿيلي	maːtʰˈiːli
ڇڏائڻ	cʰˌəɖaːˈɪɳ
چڙهائي	cˌər.hˈaːi
لنگهي	lənɡˈʌhi
گذريا	ɡəzˈʌrjaː
مصيبتن	mˌəʂibət̪ˈʌn
مشتري	məʃt̪ˈʌri
معمول	maːmˈoːl
اقوام	aqʋˈaːm
گيس	ɡˈeːs
الملڪ	ˌaləməlˈʌk
مذاق	məzˈaːq
انڪار	ˌankˈaːr
اوڏن	uːɖˈʌn
کانپوء	kʰˈaːnpoː
سفرنامو	sˌəfərnˈaːmoː
هار	hˈaːr
علامت	ˌalaːmˈʌt̪
ٻوڙ	bˈoːr.
ڪٽ	kˈʌʈ
ورهائجي	ʋˌərhaːˈɪɟi
سڏائين	sˌəɖaːˈiːn
ميڻ	mˈeːɳ
نويس	nʋˈeːs
ساڳيون	saːɡjˈoːn
ڪاهي	kˈaːhi
قرض	qərˈʌz
اڇن	acʰˈʌn
چور	cˈoːr
ڪامرس	kˌaːmərˈʌs
ريڊيي	rˈeːɖji
عوام	aʋˈaːm
ڳاڙهو	ɡaːr.ˈʌhoː
عمرو	ˈʊmroː
سيکاريو	seːkʰˈaːrjoː
تنھن	t̪ˈʌnhn
ڊي	ɖˈeː
سمجھ	sˌəməɟˈʌh
سوڌو	sˈoːdʰoː
تپ	t̪ˈʌp
ڪنگراڻي	kˌənɡərˈaːɳi
نٿو	nˈʌtʰoː
سانگي	sˈaːnɡi
آکيرا	aːkʰˈiːraː
ميرا	mˈeːraː
جوائن	ɟˈaʋaːˈɪn
اصطلاحي	ˌɪʂtɪlˈaːhi
مٺي	mˈʌʈʰi
اڀرندو	ˌabʰərˈʌndoː
نسب	nəsˈʌb
ڪوڏي	kˈoːɖi
ابي	abˈiː
شڪليون	ʃˌəkljˈoːn
هنڌن	həndʰˈʌn
پاڻي	pˈaːɳi
واپار	ʋaːpˈaːr
مزارون	mˌəzaːrˈoːn
منصور	mˌənʂˈuːr
محمدن	mˌəhəmədˈʌn
عمران	ˈʊmraːn
اڏاوتي	ˌaɖaːˈoːt̪i
اھن	ahˈʌn
ڳائيندي	ɡaːˈiːndi
پاسو	pˈaːsoː
موت	mˈoːt̪
تحريرن	t̪ˌəhrirˈʌn
شرم	ʃərˈʌm
ٺيٺ	ʈʰˈeːʈʰ
ڇو	cʰˈoː
ٽائيٽل	ʈˌaːiʈˈʌl
تکو	t̪ˈʌkʰoː
سهڻا	səhˈʌɳaː
قسمن	qˌəsəmˈʌn
ڳنڍ	ɡənˈʌɖʰ
وسن	ʋəsˈʌn
ور	ʋˈʌr
وزارت	ʋˌəzaːrˈʌt̪
سمرقند	sˌəmərəqˈʌnd
ٻيٽ	bˈeːʈ
ليلي	lˈeːli
ڪبا	kəbˈaː
کولڻ	kʰoːlˈʌɳ
اجلاسن	ˌaɟlaːsˈʌn
دوربين	dˌoːrbˈiːn
ڄاڻ	ɟˈaːɳ
رٽائرڊ	rˌəʈaːɪrˈʌɖ
اختلافن	ˌɪxtɪlaːfˈʌn
صدف	ʂədˈʌf
مهمن	mˌəhəmˈʌn
کوٽڻ	kʰoːʈˈʌɳ
شعبان	ʃˈɔbaːn
ڪني	kˈʌni
ڳوٺ	ɡˈoːʈʰ
خميس	xəmˈiːs
هاڪي	hˈaːki
وڃو	ʋˈʌɲoː
شڪار	ʃəkˈaːr
پاڻيٺ	paːɳˈiːʈʰ
ميمبر	meːmbˈʌr
ڪئين	kəˈiːn
ڪنھن	kˈʌnhn
ڪلاس	kəlˈaːs
وڻندڙ	ʋˌəɳəndˈʌr.
وغيرھ	ʋˌəɣirˈʌh
تھذيبن	t̪ˌəhzibˈʌn
ڪاڪا	kˈaːkaː
ديوتا	djˈoːt̪aː
ام	ˈam
ذمي	zˈʌmi
نڪرندا	nˈɪkrndaː
پامير	paːmˈiːr
بروھي	bərˈoːhi
ٽيريٽري	ʈˌeːriʈˈʌri
ڏکيائي	ɖəkʰjˈaːi
ڪوثر	koːsˈʌr
ڪانھي	kˈaːnhi
ڦاٽڻ	pʰaːʈˈʌɳ
چڪا	cˈʌkaː
رومن	roːmˈʌn
شھرين	ʃˌəhrˈiːn
همراهه	hˌəmraːhˈʌh
بائيڪاٽ	bˈaːikˌaːʈ
ميٽروپوليٽن	mˌeːʈrˌoːpoːliʈˈʌn
سپ	sˈʌp
اگر	aɡˈʌr
بلوغت	bˌəloːɣˈʌt̪
تصنيفن	t̪ˌəʂnifˈʌn
اونهو	uːnˈʌhoː
نيپال	neːpˈaːl
ڀيرومل	bʰˌeːroːmˈʌl
ملان	məlˈaːn
بلڪ	bəlˈʌk
بياض	bjˈaːz
ج	ɟˈiːm
سڀ	sˈʌbʰ
روغن	roːɣˈʌn
ڪلهي	kəlˈʌhi
درڪار	dˌərkˈaːr
سڏ	sˈʌɖ
حواس	hʋˈaːs
تحليل	t̪əhˈʌljal
چندر	cəndˈʌr
ايجنسين	ˌeːɟnsˈiːn
يوٽوپيا	joːʈˈoːpjaː
آسماني	ˌaːsmˈaːni
اڪثريتي	ˌakəsrˈiːt̪i
لهڻ	ləhˈʌɳ
زيارت	zjaːrˈʌt̪
ريج	rˈeːɟ
مملڪتي	mˌəmələkˈʌt̪i
قرارداد	qˌəraːrdˈaːd
ماٹھو	maːʈˈʌhoː
ڪميون	kəmjˈoːn
لکتن	lˌəkʰət̪ˈʌn
بدوش	bədˈoːʃ
عباسين	abˈaːsin
ڪيٿائيئرليخ	kˌeːtʰaːiˈɪrlˌiːx
بصري	bəʂˈʌri
ريگستان	rˌeːɡˈɪstaːn
گهرندو	ɡˌəhərˈʌndoː
رومين	roːmˈiːn
مدن	mədˈʌn
ڌيان	dʰjˈaːn
چوٽي	cˈoːʈi
الاول	ˌalaːˈoːl
ذميداري	zˌəmidˈaːri
ڊپارٽمينٽ	ɖˌəpaːrˌəʈminˈʌʈ
ريڊيو	rˈeːɖjoː
ميلي	mˈeːli
وحيد	ʋəhˈiːd
ماضي	mˈaːzi
دراوڙ	dˌəraːˈoːr.
بندو	bˈʌndoː
نازڪ	naːzˈʌk
گذرڻ	ɡˌəzərˈʌɳ
تنتي	t̪ənˈʌt̪i
معاوضو	maːˈoːzoː
حواسن	hʋaːsˈʌn
ڏسون	ɖɪsˈoːn
حامين	haːmˈiːn
آفيسرن	ˌaːfisərˈʌn
ماهي	mˈaːhi
پورچوگيزن	pˌoːrcoːɡizˈʌn
وڃڻ	ʋəɲˈʌɳ
معرفت	mˌaːrəfˈʌt̪
ٻنهي	bənˈʌhi
خاصو	xˈaːʂoː
عروضي	arˈoːzi
بخار	bəxˈaːr
قسطنطنيه	qˈɪstnətnih
پهاڪا	pəhˈaːkaː
جنگ	ɟˈʌnɡ
جيني	ɟˈeːni
لاشعور	lˌaːʃaːˈoːr
بلڪه	bˌələkˈʌh
گھرجن	ɡʰˌərəɟˈʌn
ٽيڪنيڪل	ʈˌeːknikˈʌl
صوفياڻي	ʂoːfjˈaːɳi
ڪپي	kˈʌpi
ڇت	cʰˈʌt̪
يعقوب	jaːqˈoːb
سڏيندا	səɖˈiːndaː
ساڳ	sˈaːɡ
سھارو	səhˈaːroː
کپري	kʰəpˈʌri
مختلف	mʊxtˈalɪf
ڊراما	ɖərˈaːmaː
لعل	lˈaːl
هجي	hˈʊɟeː
ٻنهين	bˌənhˈiːn
پڙهيا	pər.ˈʌhjaː
واقعن	ʋaːqˈaːn
ري	rˈeː
الدوله	ˌaldoːlˈʌh
پريزيڊنسي	pˌəriziɖˈʌnsi
گوبند	ɡoːbˈʌnd
پريل	pˈʌrjal
کڏ	kʰˈʌɖ
غدار	ɣədˈaːr
جملي	ɟˈʊmli
مرڪز	mˌərəkˈʌz
غائب	ɣaːˈɪb
آتش	ˈaːtɪʃ
پاري	pˈaːri
بنائڻ	bˌənaːˈɪɳ
قرب	qərˈʌb
مغز	məɣˈʌz
برادرس	bˌəraːdərˈʌs
الڳ	alˈʌɡ
فيڪٽري	fˌeːkəʈˈʌri
ململ	mˌələmˈʌl
سنئون	sˌənˈoːn
گهرواري	ɡˌəhərʋˈaːri
پٽڪو	pəʈˈʌkoː
ھاشم	haːʃˈʌm
آهر	aːhˈʌr
رک	rˈʌkʰ
ڳهه	ɡəhˈʌh
ڊيوڪ	ɖjˈoːk
پنهنجيون	pʌ̃hnɟjˈoːn
نيپئر	neːpˈʌr
جهرڪ	ɟˌəhərˈʌk
چٽ	cˈʌʈ
مدت	mədˈʌt̪
پالش	paːlˈʌʃ
زون	zˈoːn
ٿئيس	ʈəˈiːs
نشر	nəʃˈʌr
درس	dərˈʌs
فزڪس	fˌəzəkˈʌs
انجمن	ˌanəɟəmˈʌn
برفاني	bˌərfˈaːni
قديمي	qədˈiːmi
موري	mˈoːri
مسئلا	məsˈʌlaː
نامو	nˈaːmoː
سموادي	səmʋˈaːdi
وڌيڪ	ʋədʰˈiːk
پراڻي	pərˈaːɳi
وڪڻي	ʋəkˈʌɳi
نقشن	nˌəqəʃˈʌn
پتل	pət̪ˈʌl
مصالحن	mˌəʂaːləhˈʌn
قائم	qaːˈɪm
ڳولي	ɡˈoːli
پوني	pˈoːni
هاڻوڪي	haːɳˈoːki
بيڪٽيريا	bˈeːkʈˌiːrjaː
ٻاروتڻ	bˌaːroːt̪ˈʌɳ
طرفان	tˌərfˈaːn
ڪنڊا	kˈʌnɖaː
سفارش	sˌəfaːrˈʌʃ
اٿي	ˈatʰi
ڳئون	ɡəˈoːn
لالو	lˈaːloː
مردن	mərdˈʌn
پئسو	pˈʌsoː
ھيليم	heːlˈiːm
جدت	ɟədˈʌt̪
ميڊيا	mˈeːɖjaː
اڱڻ	ˌaŋ̩ˈʌɳ
نوبت	noːbˈʌt̪
ڳڙهه	ɡˌər.əhˈʌh
رھائش	rˌəhaːˈɪʃ
باشعور	bˈaːʃaːˌoːr
آفاقي	aːfˈaːqi
هاڻوڪو	haːɳˈoːkoː
پرايو	pərˈaːjoː
ٿلهيون	ʈˌəlhjˈoːn
ڪلهوڙن	kˌəlhuːr.ˈʌn
چچ	cˈʌc
پاور	paːˈoːr
ڌرمداس	dʰˌərəmdˈaːs
تبديلي	t̪ˌəbdˈiːli
قافلن	qˌaːfəlˈʌn
لقبن	lˌəqəbˈʌn
آڏي	ˈaːɖi
ھزارين	hˌəzaːrˈiːn
قراقرم	qˌəraːqərˈʌm
جيلن	ɟeːlˈʌn
مصوري	məʂˈoːri
اخبارن	ˌaxbˈaːrən
ٽائيم	ʈaːˈiːm
منسوخ	mənsˈuːx
خدائن	xˌədaːˈɪn
ايجوڪيشن	ˌeːɟoːkiʃˈʌn
لباس	ləbˈaːs
ڪروڙين	kˌəroːr.ˈiːn
منتخب	mˌənət̪əxˈʌb
تڪ	t̪ˈʌk
ڏھ	ɖˈʌh
نقطي	nəqˈʌti
لسٻيلي	lˌəsbˈiːli
شاهجهاني	ʃˌaːhəɟhˈaːni
ھيڊوجن	hˌeːɖoːɟˈʌn
پنهور	pˌənhˈuːr
همدرد	hˌəmədˈʌrd
خطري	xətˈʌri
ڪيمسٽري	kˌeːməsəʈˈʌri
فورم	foːrˈʌm
شفيع	ʃˈʌfi
سوچيو	sˈoːcjoː
صديق	ʂədˈiːq
روڪي	rˈoːki
قادن	qaːdˈʌn
اونھو	ˈuːnhoː
ایک	ˈeːkʰ
بندرگاھ	bˌəndərɡˈaːh
ٽنڊوآدم	ʈˌənɖʋaːdˈʌm
فوج	fˈoːɟ
وزيراعظم	ʋˌəzirˌaːaːʐˈʌm
فلابرٽ	fˌəlaːbərˈʌʈ
ڪيرالا	keːrˈaːlaː
ٻجن	bəɟˈʌn
کنڊ	kʰˈʌnɖ
ريپبلڪن	rˌeːpəbˌələkˈʌn
ايڪشن	ˌeːkəʃˈʌn
نوبيل	noːbjˈal
رکڻو	rəkʰˈʌɳoː
باقي	bˈaːqi
سٽي	sˈʌʈi
خانہ	xaːnˈʌh
پورهيتن	pˌoːrhit̪ˈʌn
هيس	hˈeːs
ڍڪي	ɖʰˈʌki
قيدخاني	qˌeːdxˈaːni
ڪوٽا	kˈoːʈaː
مصرعن	mˌəʂrˈaːn
هي	hˈiː
اميه	amˈiːh
شيء	ʃˈeː
مراڪش	mˌəraːkˈʌʃ
پاليسيون	pˌaːlisjˈoːn
فيصل	feːʂˈʌl
ڪريم	kərˈiːm
اپت	apˈʌt̪
تهه	t̪əhˈʌh
صورتن	ʂˌoːrət̪ˈʌn
دريائي	dərjˈaːi
ڇوتہ	cʰoːt̪ˈʌh
هندومت	hˌɪnduːmˈʌt̪
رائي	rˈaːi
ليکي	lˈeːkʰi
ڀورو	bʰˈoːroː
دلير	dəlˈiːr
اونھي	ˈuːnhi
نيپيئر	nˌeːpiˈɪr
انت	anˈʌt̪
ڏيکاريو	ɖeːkʰˈaːrjoː
ملير	məlˈiːr
بزرگوار	bˈʊzʊɾɡʋˌaːr
گهڻا	ɡəhˈʌɳaː
طبقات	tˌəbəqˈaːt
کپي	kʰˈʌpi
شامل	ʃˈaːmɪl
انقلاب	ˌɪnqɪlˈaːb
مفتي	məfˈʌt̪i
ناچ	nˈaːc
سما	sˈʌmaː
مددگار	mˌədədɡˈaːr
گلوڪار	ɡˌəloːkˈaːr
ڪوٺين	koːʈʰˈiːn
ڪشميري	kˌəʃmˈiːri
نائٽروجن	nˌaːʈroːɟˈʌn
انگور	anɡˈoːr
ٻيئي	bˈeːi
پنن	pənˈʌn
لکڻي	ləkʰˈʌɳi
پکيڙي	pəkʰˈiːr.i
مشروب	mˌəʃrˈuːb
ڊسمبر	ɖˌəsəmbˈʌr
انقلابن	ˌɪnqɪlaːbˈʌn
وارث	ʋaːrˈʌs
برهمڻن	bˌərəhˌəməɳˈʌn
موٽيو	mˈoːʈjoː
سليم	səlˈiːm
ندي	nˈʌdi
پائيندا	paːˈiːndaː
ڦٽا	pʰˈʌʈaː
آندا	ˈaːndaː
اسلام	ˌɪslˈaːm
سطح	sˌətˈah
سرمايي	sˌərmˈaːji
ڇڏجي	cʰəɖˈʌɟi
هليا	hˈʌljaː
احوال	ahʋˈaːl
پڪا	pˈʌkaː
ڏجن	ɖəɟˈʌn
ڦھلجي	pʰˌəhəlˈʌɟi
هاجره	hˌaːɟərˈʌh
اسلم	ˌasəlˈʌm
ڊيٽا	ɖˈeːʈaː
وڏا	ʋˈʌɖaː
تلوار	t̪əlʋˈaːr
رهن	rəhˈʌn
خوشي	xˈʊʃi
ق	qˈaːf
حميد	həmˈiːd
ٻيڙين	beːr.ˈiːn
گوئي	ɡˈoːi
مرثيا	mərˈʌsjaː
ياسر	jaːsˈʌr
شيعن	ʃˈiːn
ٺهندڙ	ʈʰˌəhəndˈʌr.
ڪليڪٽر	kˌəlikəʈˈʌr
نصاب	nəʂˈaːb
اسٽيڊيم	ˌasʈiɖˈiːm
لاچار	laːcˈaːr
علائقائي	ˌalaːɪqˈaːi
ڏاهري	ɖaːhˈʌri
خاصيتن	xˌaːʂit̪ˈʌn
حملو	həmˈʌloː
قلب	qəlˈʌb
وحشي	ʋəhˈʌʃi
ڦرين	pʰərˈiːn
خوراڪ	xoːrˈaːk
هڙاپا	hər.ˈaːpaː
اک	ˈakʰ
فيضياب	feːzjˈaːb
ڪارخانو	kˌaːrxˈaːnoː
نڪاح	nˈʌkaːh
پورهيت	pˌoːrhˈiːt̪
پيرا	pˈeːraː
پيشوا	pˈeːʃʋaː
عبد	abˈʌd
جان	ɟˈaːn
گهاٽن	ɡˌəhaːʈˈʌn
اوڀارين	ˌuːbʰaːrˈiːn
فقدان	fˌəqdˈaːn
سيارو	sjˈaːroː
پرائيمري	pˌəraːimˈʌri
وجهندو	ʋˌəɟəhˈʌndoː
نان	nˈaːn
قدس	qədˈʌs
ڪجھ	kəɟˈʌh
تھھ	t̪əhˈʌh
فلڪياتي	fˌəlkjˈaːt̪i
پرڳڻن	pˌərəɡəɳˈʌn
مصيبت	mˌəʂibˈʌt̪
آهوجا	aːhˈoːɟaː
بدن	bədˈʌn
اسرار	ˌasrˈaːr
ٻوليون	boːljˈoːn
قريب	qərˈiːb
نالن	naːlˈʌn
ڇڻي	cʰˈʌɳi
عه	ˈah
سا	sˈaː
سڏبو	sˌəɖbˈoː
ترقياتي	t̪ˌərqjˈaːt̪i
يونانين	jˌoːnaːnˈiːn
عثمان	ˌasmˈaːn
هڙتال	hˌər.t̪ˈaːl
سنڀال	sˌənbʰˈaːl
بيعت	bˈiːt̪
شرعي	ʃərˈaːi
چاليهن	cˌaːlihˈʌn
هئس	hˈʌs
معاون	maːˈoːn
ڊڪشنري	ɖˌəkəʃənˈʌri
جوڳين	ɟoːɡˈiːn
فارغ	faːrˈʌɣ
رانديگرن	rˌaːndiɡərˈʌn
رومال	roːmˈaːl
جاڳندي	ɟaːɡˈʌndi
ٻنيون	bənjˈoːn
اڇا	ˈacʰaː
قادر	qaːdˈʌr
نقصانن	nˌəqʂaːnˈʌn
ھميشه	hˌəmiʃˈʌh
گهرايل	ɡˌəhərˈaːjal
سورتن	sˌoːrət̪ˈʌn
بڊو	bˈʌɖoː
چهچ	cəhˈʌc
سيلرا	seːlˈʌraː
جوڙو	ɟˈoːr.oː
تضاد	t̪əzˈaːd
دادا	dˈaːdaː
مونو	mˈoːnoː
کڻندو	kʰəɳˈʌndoː
طويل	tʋˈeːl
ذڪريا	zəkˈʌrjaː
رهبر	rˌəhəbˈʌr
فرمايو	fˌərmˈaːjoː
کڙي	kʰˈʌr.i
پرڳڻو	pˌərəɡˈʌɳoː
تقسيم	t̪ˌəqsˈiːm
پوري	pˈoːri
سڏجي	səɖˈʌɟi
ڍڪجي	ɖʰəkˈʌɟi
وڄائي	ʋəɟˈaːi
چاند	cˈaːnd
پرامن	pˌəraːmˈʌn
مصنف	mˌəʂənˈʌf
نڪتي	nəkˈʌt̪i
ننڍا	nənˈʌɖʰaː
مالڪ	maːlˈʌk
قبض	qəbˈʌz
شاهديون	ʃˌaːhədjˈoːn
پناهگير	pˌənaːhəɡˈiːr
زڪام	zəkˈaːm
رياستن	rjaːst̪ˈʌn
کانئن	kʰaːnˈʌn
آئس	aːˈɪs
برادري	bˌəraːdˈʌri
آڻيندڙ	ˌaːɳindˈʌr.
ورهيه	ʋˌərhˈiːh
چون	cˈoːn
سمجهندي	sˌəməɟəhˈʌndi
پدم	pədˈʌm
ڪپڙن	kˌəpər.ˈʌn
واڌارو	ʋaːdʰˈaːroː
ٻچو	bˈʌcoː
ڪٿائون	kˌətʰaːˈoːn
لئمبرڪ	lˌəmbərˈʌk
ڀاڪر	bʰaːkˈʌr
کوليائين	kʰˌoːljaːˈiːn
دالان	daːlˈaːn
پراڪرت	pˌəraːkərˈʌt̪
فيشن	feːʃˈʌn
ابوالقاسم	abʋˈaːlqˌaːsəm
لڪسمبرگ	lˌəkəsˌəmbərˈʌɡ
فردوس	fərdˈuːs
پاڪستاني	pˌaːkɪstˈaːni
مڪاني	məkˈaːni
بناوت	bˌənaːˈoːt̪
حرڪتون	hˌərəkt̪ˈoːn
پيشنگوئي	pˌeːʃnɡˈoːi
ماسڪو	maːsˈʌkoː
منجهه	mˌənəɟəhˈʌh
ڀارتي	bʰaːrˈʌt̪i
ڪولمبيا	kˌoːlmbjˈaː
عقيدت	ˌaqidˈʌt̪
روين	rʋˈeːn
جوڙائي	ɟoːr.ˈaːi
پردن	pərdˈʌn
مورخ	moːrˈʌx
ڪاسٽر	kˌaːsəʈˈʌr
علاوه	ˌalaːˈoːh
آڪسائيڊ	ˌaːksaːˈiːɖ
سيل	sˈeːl
ڊهي	ɖˈʌhi
شعاع	ʃˈaːaː
نا	nˈaː
ساڳي	sˈaːɡi
ڏائڻ	ɖaːˈɪɳ
ميسر	meːsˈʌr
ٺهڻ	ʈʰəhˈʌɳ
محال	məhˈaːl
اٿم	aʈˈʌm
خاصيتون	xˌaːʂit̪ˈoːn
آور	aːˈoːr
مشورو	məʃˈoːroː
رهاڪو	rəhˈaːkoː
لوڪ	lˈoːk
جنڊ	ɟˈʌnɖ
بلور	bəlˈoːr
ٺاهيندي	ʈʰaːhˈiːndi
دبئي	dəbˈʌi
پادري	paːdˈʌri
ڪيلشم	kˌeːləʃˈʌm
ڪيلي	kˈeːli
صفرا	ʂəfˈʌraː
ضم	zˈʌm
تاثر	t̪aːsˈʌr
سفيد	səfˈiːd
اهنسا	ahˈʌnsaː
تعليم	t̪aːlˈiːm
پٺي	pˈʌʈʰi
برگ	bərˈʌɡ
اونداهي	uːndˈaːhi
عروض	arˈoːz
الا	ˈalaː
نظر	naʐˈar
ماحول	maːhˈoːl
پهتا	pəhˈʌt̪aː
وهنوار	ʋˌəhənʋˈaːr
اعجاز	aːɟˈaːz
ھلندو	həlˈʌndoː
برنارڊشا	bˌərnˌaːrəɖˈʌʃaː
ساهه	saːhˈʌh
ترڪمانستان	t̪ˌərəkmaːnˈɪstaːn
پوٽي	pˈoːʈi
سج	sˈʌɟ
ڪوريا	kˈoːrjaː
مقرري	mˌəqərˈʌri
وزني	ʋəzˈʌni
پليٽ	pəlˈiːʈ
اربع	ˌarbˈaː
ٻارنهن	bˌaːrənəhˈʌn
محقق	mʊhˈaqɪq
گهرائي	ɡˌəhərˈaːi
جھاز	ɟəhˈaːz
ڀٽي	bʰˈʌʈi
ولادت	ʋˌəlaːdˈʌt̪
سهارو	səhˈaːroː
ڇڏڻ	cʰaɖˈɪɳʊ
خريف	xərˈiːf
درگاهن	dˌərɡaːhˈʌn
علييف	aljˈiːf
قاتل	qaːt̪ˈʌl
جوڳ	ɟˈoːɡ
پرايائين	pˌəraːjaːˈiːn
لامحدود	lˌaːməhdˈoːd
سرندي	sərˈʌndi
بجا	bˈʌɟaː
ٽيم	ʈˈeːm
مقبوليت	mˌəqbˈuːlit̪
تر	t̪ˈʌr
ملا	mˈʌlaː
وجهن	ʋˌəɟəhˈʌn
سراسري	sˌəraːsˈʌri
ھلائڻ	hˌəlaːˈɪɳ
ڪڙڇ	kər.ˈʌcʰ
پيلا	pˈeːlaː
محلو	məhˈʌloː
آڳاٽا	aːɡˈaːʈaː
تارا	t̪ˈaːraː
گهوڙي	ɡəhˈoːr.i
البيروني	ˌalbˈiːroːnˌiː
مصنفن	mˌəʂənəfˈʌn
کاٻي	kʰˈaːbi
ڪورونا	koːrˈoːnaː
جوڙيندڙ	ɟˌoːr.indˈʌr.
شور	ʃˈoːr
تري	t̪ˈʌri
عالم	aːlˈʌm
گپ	ɡˈʌp
هوا	hʋˈaː
مهاراجا	mˌəhaːrˈaːɟaː
القرآن	ˌaləqrˈaːn
سرد	sˈʌrd
حاضر	haːzˈʌr
گول	ɡˈoːl
واقعا	ʋˈaːqaː
ڦڪي	pʰˈʌki
ٻار	bˈaːr
فريم	fərˈiːm
روزمره	rˌoːzəmərˈʌh
لڪياري	ləkjˈaːri
چانهه	cˌaːnəhˈʌh
ڪشور	kəʃˈoːr
پهچائي	pˌəhəcˈaːi
سنڌو	sˈɪndhoː
حيواني	hjʋˈaːni
پنهنجي	pˈʌ̃hnɟi
ڀائٽيو	bʰˈaːʈjoː
ديوناگري	djˌoːnaːɡˈʌri
رچاء	rˈʌcaː
آرڪيالاجي	ˌaːrkjaːlˈaːɟi
موجودگي	moːɟˈuːdɡi
ٿلھو	ʈəlˈʌhoː
ڪوسٽ	koːsˈʌʈ
پائيپ	paːˈiːp
ذريعي	zərˈiːi
ديول	djˈoːl
ماڻيو	mˈaːɳjoː
هنگلاج	hˌənɡəlˈaːɟ
هلت	həlˈʌt̪
پاڙا	pˈaːr.aː
پورائي	poːrˈaːi
ماني	mˈaːni
ايشيا	ˈeːʃjaː
برائي	bərˈaːi
سھڻي	səhˈʌɳi
مئگزين	mˌəɡzˈiːn
ڪلهوڙا	kˌəlhˈuːr.aː
ارڙھن	ˌarər.hˈʌn
ڳڻپ	ɡəɳˈʌp
اداڪاره	ˌadaːkaːrˈʌh
آڱريون	ˌaːŋ̩rjˈoːn
ٺڪراٺو	ʈʰˌəkrˈaːʈʰoː
ڪوڙ	kˈoːr.
سوارن	sʋaːrˈʌn
ترار	t̪ərˈaːr
اسٽريٽ	ˌasəʈrˈiːʈ
پهتو	pəhˈʌt̪oː
انگلينڊ	ˌanɡəlˈiːnɖ
پختونخوا	pˌəxt̪uːnˈʌxʋaː
خفيه	xəfˈiːh
واسي	ʋˈaːsi
علوي	ˈalʋi
وڌندي	ʋədʰˈʌndi
بلڙي	bəlˈʌr.i
ڦر	pʰˈʌr
ڪانگو	kˈaːnɡoː
مضمون	mˌəzmˈuːn
ناھي	nˈaːhi
العين	ˌalaːˈiːn
رستا	rˈʌst̪aː
شق	ʃˈʌq
ھيٺئين	hˌeːʈʰˈiːn
همعصر	hˌəmaːʂˈʌr
انجام	ˌanɟˈaːm
عربن	ˌarəbˈʌn
آپ	ˈaːp
ماروي	mˈaːrʋi
ساڳيو	sˈaːɡjoː
قدامت	qˌədaːmˈʌt̪
موسمي	moːsˈʌmi
بلند	bəlˈʌnd
راجپوتن	rˌaːɟpoːt̪ˈʌn
ڪ	kˈaːf
زيورن	zjoːrˈʌn
مٿئين	mˌəʈˈiːn
ڊگريون	ɖˌəɡrjˈoːn
خوش	xˈʊʃ
شھرت	ʃˌəhərˈʌt̪
اسڪردو	ˌasəkˈʌrdoː
خميسو	xəmˈiːsoː
پوي	pʋˈeː
اشارو	aʃˈaːroː
خنساء	xˈʌnsaː
وائرس	ʋˌaːɪrˈʌs
پرتي	pərˈʌt̪i
لائڻ	laːˈɪɳ
محلات	mˌəhəlˈaːt
خطبو	xˌətbˈoː
پٿريلي	pˌəʈrˈiːli
ملٽري	mˌələʈˈʌri
ميربحر	mˌeːrəbəhˈʌr
ڄاڻايا	ɟaːɳˈaːjaː
لاهي	lˈaːhi
اولھندي	ˌuːləhˈʌndi
وفد	ʋəfˈʌd
ثنا	sˈʌnaː
ٺاھي	ʈʰˈaːhi
ثانوي	sˈaːnʋi
ڇتين	cʰət̪ˈiːn
ڪجھه	kˌəɟəhˈʌh
مٿا	mˈʌtʰaː
ايتريقدر	ˌeːt̪rˌiːqədˈʌr
درآمد	dˌəraːmˈʌd
ذهن	zəhˈʌn
چاهي	cˈaːhi
فيئر	feːˈɪr
مائٽ	mˈaːʈ
ڪئپٽن	kˌəpəʈˈʌn
مدرسو	mˌədərˈʌsoː
معاملي	maːmˈʌli
چئنل	cənˈʌl
سرواڻ	sərʋˈaːɳ
م	mˈiːm
ڳاتو	ɡˈaːt̪oː
سنگهار	sˌənɡəhˈaːr
معاشري	maːʃˈʌri
اصحابن	ˌaʂhaːbˈʌn
ممتاز	mˌəmt̪ˈaːz
تڙ	t̪ˈʌr.
سگھجي	səɡʰˈʌɟi
شخصيتون	ʃˈaxʂit̪ˌoːn
عيوض	ajˈoːz
جماعتن	ɟˌəmaːaːt̪ˈʌn
انگي	ˈanɡi
سالياني	saːljˈaːni
علماء	alˈʌmaː
پيئي	pˈeːi
تنھنڪري	t̪ˌənhnəkˈʌri
لکيائين	lˌəkʰjaːˈiːn
ڦيري	pʰˈeːri
چونڊون	coːnɖˈoːn
سائنسدان	sˌaːɪnsədˈaːn
واڪ	ʋˈaːk
ڊرامي	ɖərˈaːmi
نڙ	nˈʌr.
رسيو	rˈʌsjoː
جذبي	ɟˌəzbˈiː
يھودي	jəhˈoːdi
گيٽ	ɡˈeːʈ
رھيون	rəhjˈoːn
مڪانن	mˌəkaːnˈʌn
شل	ʃˈʌl
جھڙي	ɟəhˈʌr.i
تمدن	t̪ˌəmədˈʌn
غزلن	ɣˌəzəlˈʌn
اياز	eːˈaːz
پڌرنامي	pˌədʰərnˈaːmi
ويس	ʋˈeːs
گمان	ɡəmˈaːn
فائلم	fˌaːɪlˈʌm
روزانه	rˌoːzaːnˈʌh
ڏوڪري	ɖoːkˈʌri
تحفا	t̪əhˈʌfaː
چمڪندڙ	cˌəməkəndˈʌr.
ڀيري	bʰˈeːri
فهرست	fˌəhərˈʌst̪
گچ	ɡˈʌc
وٺرائي	ʋˌəʈʰrˈaːi
تيرهين	t̪ˌeːrhˈiːn
بالغ	bˈaːləɣ
پاڙ	pˈaːr.
نقوي	nˈʌqʋi
هٿ	hˈʌʈ
نڪرنديون	nɪkrndjˈoːn
روانا	rʋˈaːnaː
قمر	qəmˈʌr
ڳڻ	ɡˈʌɳ
مڌيا	mˈʌdʰjaː
دري	dˈʌri
ابوذر	abˈoːzər
سمپورن	sˌəmpuːrˈʌn
مايا	mˈaːjaː
ريزڪي	reːzˈʌki
ڪورٽ	koːrˈʌʈ
فلڪي	fəlˈʌki
سدا	sˈʌdaː
پانڌي	pˈaːndʰi
ويهي	ʋˈeːhi
عصر	aʂˈʌr
ذميواريون	zˌəmjʋaːrjˈoːn
آوازن	ˌaːʋaːzˈʌn
قرباني	qˌərbˈaːni
محبوب	mˌəhbˈuːb
قصور	qəʂˈoːr
ھيڊ	hˈeːɖ
ڪاٺي	kˈaːʈʰi
هنر	hənˈʌr
سمجهي	sˌəməɟˈʌhi
ڪمند	kəmˈʌnd
سندين	səndˈiːn
اڪيلو	akˈiːloː
ڳائيندڙ	ɡˌaːindˈʌr.
ئي	ˈiː
ي	jˈeː
سرچشمو	sˌərcəʃˈʌmoː
کوليا	kʰˈoːljaː
بناوٽ	bˌənaːˈoːʈ
نقشو	nəqˈʌʃoː
پريا	pˈʌrjaː
مهينو	məhˈiːnoː
وجھڻ	ʋˌəɟəhˈʌɳ
ججهو	ɟəɟˈʌhoː
مارشل	mˌaːrəʃˈʌl
فاطمه	fˌaːtəmˈʌh
برو	bˈʌroː
ڀيٽ	bʰˈeːʈ
ٽربيونل	ʈˌərbjˈoːnəl
پياري	pjˈaːri
تحفظ	t̪ˌəhəfˈʌʐ
بانو	bˈaːnoː
پڙھندا	pər.hˈʌndaː
اپٻيٽ	ˌapbˈiːʈ
حاڪمن	hˌaːkəmˈʌn
رهي	rˈʌhi
مفاد	məfˈaːd
انسان	ɪnsˈaːn
چلم	cəlˈʌm
شمر	ʃəmˈʌr
ٿڌيون	ʈədʰjˈoːn
عذاب	azˈaːb
هموار	həmʋˈaːr
سڏڻ	səɖˈʌɳ
پليجو	pəlˈiːɟoː
اعزاز	eːzˈaːz
ڏنا	ɖˈʌnaː
يادگيرين	jˌaːdɡirˈiːn
اليڪٽران	ˌalikˌəʈrˈaːn
مولابخش	mˌoːlaːbəxˈʌʃ
فطرتي	fˌətərˈʌt̪i
واهپو	ʋaːhˈʌpoː
نتيجن	nˌət̪iɟˈʌn
جدا	ɟˈʊdaː
پاسي	pˈaːsi
هاري	hˈaːri
ڇنڊڇاڻ	cʰˌənɖəcʰˈaːɳ
اسڪولن	ˌaskoːlˈʌn
وهندي	ʋəhˈʌndi
شايد	ʃaːˈiːd
ڪهاڻيون	kˌəhaːɳjˈoːn
معشوق	maːʃˈoːq
آڪسيجن	ˌaːksiɟˈʌn
يافتہ	jˌaːfət̪ˈʌh
ضابطو	zaːbˈʌtoː
عبدالقيوم	ˌabdˌaːlqjˈoːm
هڪجهڙا	hˌəkəɟəhˈʌr.aː
ابڙو	abˈʌr.oː
ـ	lˈetəcʰˈahacˈaːrbˈʊr.i
سنڌن	sˈɪndhn
سامونڊي	saːmˈoːnɖi
ياداشت	jaːdˈaːʃt̪
مقابلي	mˌəqaːbˈʌli
پگهر	pˌəɡəhˈʌr
چوندو	cˈoːndoː
تحريڪ	t̪ˌəhrˈiːk
ڪيٽي	kˈeːʈi
لنڪيش	lˌənkˈiːʃ
کڏون	kʰəɖˈoːn
گرڊرن	ɡˌərəɖərˈʌn
وڌائڻ	ʋˌədʰaːˈɪɳ
جاء	ɟˈaː
جعفري	ɟaːfˈʌri
وجد	ʋəɟˈʌd
چاندي	cˈaːndi
خودمختيار	xˈʊdməxt̪jˌaːr
ڏندن	ɖəndˈʌn
هيلن	heːlˈʌn
دربار	dˌərbˈaːr
ڪنهن	kˈʌ̃hɪ̃
رسا	rˈʌsaː
ڇپايا	cʰəpˈaːjaː
نظرياتي	naʐˈarjaːt̪ˌiː
ڪنن	kənˈʌn
کوسا	kʰˈoːsaː
زلزلو	zˌalzˈaloː
ڦل	pʰˈʌl
ڪچرو	kəcˈʌroː
ڍنگ	ɖʰˈʌnɡ
ڄاڻو	ɟˈaːɳoː
مرد	mˈʌrd
گهٽين	ɡˌəhəʈˈiːn
وجھي	ʋəɟˈʌhi
مسٽر	mˌəsəʈˈʌr
مظهر	mˌəʐəhˈʌr
فڪري	fəkˈʌri
ڌوڪي	dʰˈoːki
ٺھيو	ʈʰˈʌhjoː
راتين	raːt̪ˈiːn
چوڻيون	coːɳjˈoːn
آندي	ˈaːndi
نٿي	nˈʌtʰi
مون	mˈũː
وسيلو	ʋəsˈiːloː
ساهتيه	sˌaːhət̪ˈiːh
اڪثريت	ˌakəsrˈiːt̪
نظامي	nɪʐˈaːmi
اشاري	aʃˈaːri
رٿون	rətʰˈoːn
رند	rˈʌnd
اينڊ	ˈeːnɖ
چوڏھين	cˌoːɖhˈiːn
تنهنجي	t̪ˌənəhənˈʌɟi
مملڪت	mˌəmələkˈʌt̪
رضوان	rəzʋˈaːn
گائڪ	ɡaːˈɪk
روڪ	rˈoːk
سنگيت	sənɡˈiːt̪
ويجهن	ʋˌeːɟəhˈʌn
شرطن	ʃˌərətˈʌn
برباد	bˌərbˈaːd
سگهندا	sˌəɡəhˈʌndaː
ڪينيا	kˈeːnjaː
گرد	ɡˈʌrd
ايماندار	ˌeːmaːndˈaːr
ڪٿا	kˈʌtʰaː
موڪليائين	mˌoːkljaːˈiːn
راما	rˈaːmaː
کهڙو	kʰəhˈʌr.oː
انجنيئرنگ	ˌanəɟniˈɪrənɡ
سمورا	səmˈoːraː
ڌيئرن	dʰeːˈɪrən
ڏاڍو	ɖˈaːɖʰoː
مينھن	mˈeːnhn
انيڪ	anˈiːk
قسمت	qˌəsəmˈʌt̪
رھن	rəhˈʌn
سڪرنڊ	sˌəkərˈʌnɖ
پورچوگال	pˌoːrcoːɡˈaːl
رکيا	rˈʌkʰjaː
فراهم	fˌəraːhˈʌm
ڏکيو	ɖˈʌkʰjoː
وٺندا	ʋəʈʰˈʌndaː
پيء	pˈeː
مٿاهين	mˌətʰaːhˈiːn
شجاع	ʃˈʌɟaː
پنڊت	pənɖˈʌt̪
والده	ʋˌaːlədˈʌh
ملن	məlˈʌn
تعلقا	t̪aːlˈʌqaː
پيرس	peːrˈʌs
ڳري	ɡˈʌri
مٽائڻ	mˌəʈaːˈɪɳ
سانت	saːnˈʌt̪
سدن	sədˈʌn
گردش	ɡərdˈʌʃ
عادل	aːdˈʌl
تا	t̪ˈaː
چراگاھون	cˌəraːɡaːhˈoːn
خطرناڪ	xˌətərnˈaːk
سارين	saːrˈiːn
ڇپيا	cʰˈʌpjaː
حرن	hərˈʌn
مرهٽن	mˌərəhəʈˈʌn
پرنٽنگ	pˌərənəʈˈʌnɡ
گهرايو	ɡˌəhərˈaːjoː
پريم	pərˈiːm
ٺاهيندو	ʈʰaːhˈiːndoː
سري	sˈʌri
ڪيٿولڪ	kˌeːtʰoːlˈʌk
مليس	məlˈiːs
ادريس	ˌadrˈiːs
ريل	rˈeːl
ڪشش	kəʃˈʌʃ
منھنجي	mənhnˈʌɟi
کڏن	kʰəɖˈʌn
تجزيي	t̪əɟˈʌzji
عرفان	ˌarfˈaːn
آذربائيجان	ˌaːzərbˈaːiɟˌaːn
جس	ɟˈʌs
تڪڙو	t̪əkˈʌr.oː
داري	dˈaːri
شرما	ʃərˈʌmaː
آڊيشن	ˌaːɖiʃˈʌn
بنان	bənˈaːn
معلومات	mˌaːloːmˈaːt
ماسٽرس	mˌaːsəʈərˈʌs
فالج	faːlˈʌɟ
اٽي	ˈaʈi
اول	ˈuːl
چاھ	cˈaːh
وڌو	ʋˈʌdʰoː
ڪرنسي	kərˈʌnsi
پرلوڪ	pˌərlˈuːk
صنفون	ʂˌənfˈuːn
اها	ˈɪhaː
نارٿ	naːrˈʌʈ
آري	ˈaːri
خواجہ	xʋaːɟˈʌh
آرائين	ˌaːraːˈiːn
هئائين	hˌəaːˈiːn
ساڍا	sˈaːɖʰaː
پٿري	pəʈˈʌri
خاڪ	xˈaːk
هڏن	həɖˈʌn
بانڊ	bˈaːnɖ
وليد	ʋəlˈiːd
گنبذ	ɡənbˈʌz
عورتن	ˌaoːrət̪ˈʌn
سوکڙي	soːkʰˈʌr.i
ناتا	nˈaːt̪aː
ميران	meːrˈaːn
هئڻ	hˈʌɳ
آرسي	aːrˈʌsi
آفيس	aːfˈiːs
اسٽيم	ˌasʈˈiːm
فصل	fəʂˈʌl
ڌي	dʰˈeː
جلال	ɟəlˈaːl
ايتريون	ˌeːt̪rjˈoːn
ڪال	kˈaːl
آريائي	aːrjˈaːi
ڏينهون	ɖˌeːnhˈoːn
کو	kʰˈoː
مادي	mˈaːdi
امڙ	amˈʌr.
گل	ɡˈʌl
ڪھڪشان	kˌəhəkʃˈaːn
گاھ	ɡˈaːh
برکا	bərˈʌkʰaː
گجرات	ɡˌəɟərˈaːt
رڪجي	rəkˈʌɟi
گچيري	ɡəcˈiːri
يهودين	jˌəhoːdˈiːn
شيراز	ʃeːrˈaːz
بطوطا	bətˈoːtaː
ڪمرشل	kˌəmərəʃˈʌl
خواجا	xʋˈaːɟaː
بلڪل	bˌələkˈʌl
ڪاغذ	kaːɣˈʌz
ڪارڻ	kaːrˈʌɳ
ذرا	zˈʌraː
پارسي	paːrˈʌsi
مارڪو	maːrˈʌkoː
خدمتگار	xˌədəmˌət̪ɡˈaːr
فريد	fərˈiːd
پايه	paːˈiːh
موٽڻ	moːʈˈʌɳ
ھاڻوڪي	haːɳˈoːki
وائس	ʋaːˈɪs
ننڍڙيون	nˌənəɖʰr.jˈoːn
تدريس	t̪ˌədrˈiːs
ٺھي	ʈʰˈʌhi
پڃري	pəɲˈʌri
پتو	pˈʌt̪oː
تلقين	t̪ˌəlqˈiːn
غذا	ɣˈʌzaː
لڳاتار	lˌəɡaːt̪ˈaːr
بازار	bˈaːzaːr
اسپورٽس	ˌaspˌoːrəʈˈʌs
اٺ	ˈaʈʰ
بارٽل	bˈaːrəʈˌəl
وٽان	ʋəʈˈaːn
فنون	fənˈoːn
سنوارڻ	sˌənʋaːrˈʌɳ
ناصرالدين	nˌaːʂrˌaːldˈiːn
پنھجي	pˈʌnhɟi
شھرن	ʃˌəhərˈʌn
کجين	kʰəɟˈiːn
تي	t̪ˈeː
ايڪڙن	ˌeːkər.ˈʌn
خرابي	xˌəraːbˈiː
ڪندڙن	kˌəndər.ˈʌn
ريا	rjˈaː
ٺاھيل	ʈʰˈaːhjal
اصولي	ʊʂˈuːli
سمهڻ	sˌəməhˈʌɳ
لڳس	ləɡˈʌs
حويلي	hʋˈeːli
يزيد	jəzˈiːd
ڄاريون	ɟaːrjˈoːn
فقه	fəqˈʌh
عمل	amˈʌl
لٽر	ləʈˈʌr
بجار	bəɟˈaːr
ها	hˈaː
اندرين	ˌandərˈiːn
وڪڻندا	ʋˌəkəɳˈʌndaː
جنس	ɟˈɪns
سوري	sˈoːri
انڊونيشيا	ˌɪnɖoːnˈiːʃjaː
تندون	t̪əndˈuːn
ڪوهن	koːhˈʌn
اجازت	ˌaɟaːzˈʌt̪
سئنيما	sənˈiːmaː
پالي	pˈaːli
ماريا	mˈaːrjaː
شو	ʃˈoː
رس	rˈʌs
اوزون	uːzˈoːn
ڪوه	kˈoːh
سمنڊن	sˌəmənɖˈʌn
ڪيتريون	kˌeːt̪rjˈoːn
ذميوار	zəmjʋˈaːr
ڪارروائي	kˌaːrrʋˈaːi
دلچسپي	dˌɪlcˈaspi
اڪيڊمي	ˌakiɖˈʌmi
نوڪدار	nˌoːkdˈaːr
سگهيون	sˌəɡhjˈoːn
مهيني	məhˈiːni
ديني	dˈeːni
صفا	ʂˈʌfaː
سول	sˈoːl
ميمڻ	meːmˈʌɳ
نڪتا	nəkˈʌt̪aː
ليکڪا	leːkʰˈʌkaː
جھنگلي	ɟˌəhənɡˈʌli
ٻاراڻي	baːrˈaːɳi
منصوبن	mˌənʂuːbˈʌn
ڪارن	kaːrˈʌn
ستن	sət̪ˈʌn
گاري	ɡˈaːri
سچا	sˈʌcaː
بئريسٽر	bˌərisəʈˈʌr
معيشيت	mˌaːiʃˈiːt̪
سنگت	sənɡˈʌt̪
رکنديون	rˌəkʰndjˈoːn
فقہ	fəqˈʌh
تعارف	t̪aːrˈʌf
اسماعيل	ˌasmaːˈaːjal
ڪٽڪ	kəʈˈʌk
ولايتي	ʋˌəlaːˈiːt̪i
مٽي	mˈʌʈi
زبردستي	zˌəbərdˈʌst̪i
قضا	qˈʌzaː
ٺاهيون	ʈʰaːhjˈoːn
اصفهان	ˌaʂəfhˈaːn
مڃيو	mˈʌɲjoː
قبرستان	qˌəbərˈɪstaːn
ٿا	tʰˈaː
ڌماڪن	dʰˌəmaːkˈʌn
ٽوٽل	ʈoːʈˈʌl
ٽيھ	ʈˈeːh
پنجاھ	pˌənɟˈaːh
مئنيجر	mˌəniɟˈʌr
نبض	nəbˈʌz
نزلي	nəzˈʌli
جدوجھد	ɟˌədoːɟəhˈʌd
ايبڪ	eːbˈʌk
مرڻ	mərˈʌɳ
رپورٽن	rˌəpoːrəʈˈʌn
ضرور	zarˈuːr
وڌائين	ʋˌədʰaːˈiːn
سوير	sʋˈeːr
زوال	zʋˈaːl
ڊاک	ɖˈaːkʰ
مڃن	məɲˈʌn
بادشاه	bˈaːdʃˌaːh
هو	hˈoː
واسطو	ʋaːsˈʌtoː
نثري	nəsˈʌri
ذھن	zəhˈʌn
نيپولين	nˌeːpoːlˈiːn
ڪوڪ	kˈoːk
نسخو	nəsˈʌxoː
دروازا	dərʋˈaːzaː
تيرٿ	t̪eːrˈʌʈ
نظرانداز	naʐˈaraːndˌaːz
درياهي	dərjˈaːhi
ڀڳوان	bʰəɡʋˈaːn
دلشاد	dˌəlʃˈaːd
نوڪريون	nˌoːkrjˈoːn
نشانو	nɪʃˈaːnoː
ڀٽون	bʰəʈˈoːn
جهڪر	ɟˌəhəkˈʌr
ڊيورنٽ	ɖjˌoːrənˈʌʈ
محنتي	mˌəhənˈʌt̪i
کار	kʰˈaːr
دودي	dˈoːdi
مسرور	mˌəsrˈuːr
ماٺ	mˈaːʈʰ
ڪوئلو	koːˈɪloː
شيام	ʃjˈaːm
جملا	ɟˈʊmlaː
ڦوڪ	pʰˈoːk
ڳوٺن	ɡoːʈʰˈʌn
ويلز	ʋeːlˈʌz
اڻٿڪ	ˌaɳəʈˈʌk
فسادن	fˌəsaːdˈʌn
رسمن	rˌəsəmˈʌn
پڌرنامو	pˌədʰərnˈaːmoː
مراٺي	mərˈaːʈʰi
خبردار	xˌəbrdˈaːr
آسٽريلين	ˌaːsəʈrilˈiːn
متي	mˈʌt̪i
ڀاڱي	bʰaːˈŋ̩i
ايمان	eːmˈaːn
اٿائين	ˌatʰaːˈiːn
ميٿين	meːtʰˈiːn
ڪلهوڙي	kˌəlhˈuːr.i
خانن	xaːnˈʌn
جمال	ɟəmˈaːl
حرمين	hˌərmˈiːn
ڪبو	kəbˈoː
گلو	ɡˈʌloː
کڙو	kʰˈʌr.oː
تولد	t̪oːlˈʌd
سامراج	sˌaːmrˈaːɟ
ناظم	naːʐˈʌm
مطالعي	mˌətaːlˈaːi
ڪوششن	kˌoːʃəʃˈʌn
ڪميونزم	kˌəmjoːnəzˈʌm
قاسم	qaːsˈʌm
خانبهادر	xˌaːnbəhaːdˈʌr
سنڀالڻ	sˌənbʰaːlˈʌɳ
ڄائي	ɟˈaːi
ريڙهي	reːr.ˈʌhi
جاني	ɟˈaːni
پرڻو	pərˈʌɳoː
عورت	ˌaoːrˈʌt̪
رتن	rət̪ˈʌn
سيوي	sjʋˈeː
ٺهرايا	ʈʰˌəhərˈaːjaː
صه	ʂˈʌh
اڳتي	aɡˈʌt̪i
رنڊڪ	rənɖˈʌk
يتيم	jət̪ˈiːm
اللہ	ˈallaːh
ورلي	ʋərˈʌli
گريجوئيشن	ɡˌəriɟˌoːiʃˈʌn
هلائيندا	hˌəlaːˈiːndaː
مزدوري	mˌəzdˈuːri
صفي	ʂˈʌfi
آئنسٽائن	ˌaːɪnsˌəʈaːˈɪn
ٽيئي	ʈˈeːi
ڪاٺيون	kaːʈʰjˈoːn
راڄڌاني	rˌaːɟdʰˈaːni
ڇپجڻ	cʰˌəpəɟˈʌɳ
پڙهندا	pˌər.əhˈʌndaː
منصوب	mˌənʂˈuːb
ٻھراڙي	bˌəhrˈaːr.i
پذير	pəzˈiːr
وڪرو	ʋəkˈʌroː
بخش	bəxˈʌʃ
اڇاڻ	acʰˈaːɳ
پنهنجن	pʌ̃hnɟˈʌn
صدارتي	ʂˌədaːrˈʌt̪i
منهن	mˌənəhˈʌn
هريجن	hˌəriɟˈʌn
نڪرن	nˈɪkrn
فوٽ	fˈoːʈ
سبز	səbˈʌz
ميهار	meːhˈaːr
ڏيئو	ɖˈeːoː
منظر	mˌanʐˈar
جانور	ɟaːnˈoːr
روشني	roːʃˈʌni
اولياء	ˈuːljaː
اتر	at̪ˈʌr
مذھب	mˌəzəhˈʌb
جڪ	ɟˈʌk
گھڻي	ɡʰˈʌɳi
ھٿ	hˈʌʈ
وڪٽر	ʋˌəkəʈˈʌr
ڪلاسيڪل	kˌəlaːsikˈʌl
ٻڌمت	bˌədʰəmˈʌt̪
منگولن	mˌənɡuːlˈʌn
بازنطيني	bˈaːzəntinˌiː
آبهوا	aːbˈʌhʋaː
دشمني	dˌəʃəmˈʌni
افقي	afˈʌqi
گلان	ɡəlˈaːn
ڪامل	kaːmˈʌl
لشڪر	lˌəʃəkˈʌr
تار	t̪ˈaːr
بڻايو	bəɳˈaːjoː
مڇر	məcʰˈʌr
ڪئلشم	kˌələʃˈʌm
شيو	ʃjˈoː
وڌڻ	ʋədʰˈʌɳ
وسنديون	ʋˌəsndjˈoːn
وچولي	ʋəcˈoːli
هون	hˈoːn
فبروري	fˌəbrˈuːri
ھيون	hjˈoːn
توهين	t̪oːhˈiːn
بھترين	bˌəhət̪rˈiːn
ترت	t̪ərˈʌt̪
پئسي	pˈʌsi
خانداني	xaːndˈaːni
ورهاڱو	ʋˌərhaːˈŋ̩oː
پيسيفڪ	pˌeːsifˈʌk
مدني	mədˈʌni
ونيونٽ	ʋˌənjoːnˈʌʈ
ملتاني	mˌəlt̪ˈaːni
قيمت	qeːmˈʌt̪
ڪو	kˈoː
لبريشن	lˌəbriʃˈʌn
جڙيو	ɟˈʌr.joː
پايي	pˈaːji
ذخيري	zəxˈiːri
لاڙا	lˈaːr.aː
ٻارهون	bˌaːrhˈoːn
ووٽر	ʋoːʈˈʌr
ووٽ	ʋˈoːʈ
اورنگزيب	ˌuːrənɡəzˈiːb
هلچل	hˌələcˈʌl
سڙهه	sˌər.əhˈʌh
ٿهيم	ʈəhˈiːm
جهٽ	ɟəhˈʌʈ
هيڊي	hˈeːɖi
عليه	alˈiːh
چڙهي	cər.ˈʌhi
سائيز	saːˈiːz
ڪانگن	kaːnɡˈʌn
گائڪي	ɡaːˈɪki
مريم	mərˈiːm
وبائي	ʋəbˈaːi
ڪرت	kərˈʌt̪
خونريزي	xˌoːnrˈiːzi
لبيا	ləbjˈaː
رکن	rəkʰˈʌn
اڏامي	aɖˈaːmi
منشيات	mˌənʃiˈaːt
موزون	moːzˈoːn
وهندو	ʋəhˈʌndoː
مطالعو	mˌətaːlˈaːoː
ڪارل	kaːrˈʌl
پذيرائي	pˌəzirˈaːi
بايزيد	bˈaːizˌiːd
پابند	paːbˈʌnd
ٻڌائي	bədʰˈaːi
رضوي	rˈʌzʋi
فارس	faːrˈʌs
هالائي	haːlˈaːi
هٿرادو	hˌəʈrˈaːdoː
ڊنڊي	ɖˈʌnɖi
جڳ	ɟˈʌɡ
اوتار	uːt̪ˈaːr
شمشير	ʃˌəmʃˈiːr
خوبين	xoːbˈiːn
سرشتو	sərˈʌʃt̪oː
جيمس	ɟeːmˈʌs
ڀيرا	bʰˈeːraː
ليڪن	leːkˈʌn
تعجب	t̪aːɟˈʌb
بهتري	bˌəhət̪ˈʌri
ٺهرائي	ʈʰˌəhərˈaːi
منو	mˈʌnoː
قبو	qəbˈoː
گڏيل	ɡˈʌɖjal
ڇڏيا	cʰˈʌɖjaː
نقاب	nəqˈaːb
زمان	zəmˈaːn
ڪرڻ	kərˈʌɳ
وومين	ʋoːmˈiːn
ديھ	dˈeːh
بدليل	bədˈʌljal
گرمين	ɡˌərmˈiːn
مارئي	maːrˈʌi
سڪونت	sˌəkoːnˈʌt̪
زنجيرن	zˌənɟirˈʌn
ايم	ˈeːm
ابن	abˈʌn
علي	ˈali
تلاش	t̪əlˈaːʃ
بقا	bˈʌqaː
وڙهيو	ʋər.ˈʌhjoː
جواب	ɟˈaʋaːb
لڳنديون	lˌəɡndjˈoːn
پتر	pət̪ˈʌr
شير	ʃˈeːr
لغات	lˈʊɣaːt
ويچارا	ʋeːcˈaːraː
الهام	ˌalhˈaːm
آخرت	ˌaːxərˈʌt̪
بنيادي	bənjˈaːdi
پنجون	pˌənɟˈuːn
مھيا	mˈʌhjaː
گذاريو	ɡəzˈaːrjoː
سھولتن	sˌəhoːlət̪ˈʌn
لينس	lˈeːns
ڪهاڻي	kəhˈaːɳi
لائن	laːˈɪn
ٽاور	ʈaːˈoːr
لائين	laːˈiːn
مولائي	moːlˈaːi
پتا	pˈʌt̪aː
نالو	nˈaːloː
پراسرار	pˌəraːsrˈaːr
لنڪا	lənˈʌkaː
بڻائي	bəɳˈaːi
رابن	raːbˈɪn
ڏيپلو	ɖeːpˈʌloː
اڳئين	ˌaɡˈiːn
از	ˈaz
ڇپجندا	cʰˌəpəɟˈʌndaː
ٻني	bˈʌni
عالمگير	ˌaːləmɡˈiːr
باعث	bˈaːaːs
الهند	ˌaləhˈʌnd
ڏانھن	ɖˈaːnhn
ڪشنچند	kˌəʃəncˈʌnd
عقيدتمند	ˌaqidˌət̪əmˈʌnd
پيرين	peːrˈiːn
دولت	doːlˈʌt̪
الاسلام	alˌɪslˈaːm
ميندي	mˈeːndi
تذڪرو	t̪ˌəzəkˈʌroː
ڏسجن	ɖˌɪsəɟˈʌn
ڪلچر	kˌələcˈʌr
ڍنڍ	ɖʰənˈʌɖʰ
مهاتما	mˌəhaːt̪ˈʌmaː
معياري	maːjˈaːri
مسافر	mˌəsaːfˈʌr
هيرڻ	heːrˈʌɳ
معاھدو	maːhˈʌdoː
جليل	ɟˈʌljal
نجم	nəɟˈʌm
اغوا	ˈaɣʋaː
گي	ɡˈeː
او	ˈuː
ھيا	hjˈaː
ٽنگ	ʈˈʌnɡ
هائي	hˈaːi
گرڙيون	ɡˌərr.jˈoːn
سخت	sˈʌxt̪
مھارت	mˌəhaːrˈʌt̪
ڏنائون	ɖˌənaːˈoːn
ٻڪريون	bˌəkrjˈoːn
سواد	sʋˈaːd
تائيد	t̪aːˈiːd
پالنا	paːlˈʌnaː
وشنو	ʋəʃˈʌnoː
ڄاڻڻ	ɟaːɳˈʌɳ
نعمتن	nˌaːmət̪ˈʌn
اسٽيشنن	ˌasʈˌiːʃənˈʌn
تصويرن	t̪ˌəʂʋirˈʌn
نقصان	nˌəqʂˈaːn
زبانن	zəbˈaːnən
تندور	t̪əndˈuːr
عين	aˈiːn
يونيڪوڊ	jˌoːnikˈoːɖ
تحريري	t̪ˌəhrˈiːri
سرائي	sərˈaːi
سترهين	sˌət̪ərhˈiːn
نواب	nˈaʋaːb
جاتي	ɟˈaːt̪i
زبردست	zˌəbərdˈʌst̪
زاهد	zaːhˈʌd
قطارن	qˌətaːrˈʌn
گرونانڪ	ɡˌəroːnaːnˈʌk
ايڊيٽوريل	ˌeːɖiʈˈoːrjal
ملايا	məlˈaːjaː
نواز	nˈaʋaːz
محي	mˈʌhi
ٽيمون	ʈeːmˈoːn
پورھيت	pˌoːrhˈiːt̪
مائي	mˈaːi
سکڻ	səkʰˈʌɳ
گذري	ɡəzˈʌri
کي	kʰˈeː
هول	hˈoːl
پڙهندڙ	pˌər.əhəndˈʌr.
هيٺيون	heːʈʰjˈoːn
مجاهدين	mˌəɟaːhədˈiːn
آفيسر	ˌaːfisˈʌr
پتلو	pət̪ˈʌloː
ماٿر	maːʈˈʌr
وڌائيندو	ʋˌədʰaːˈiːndoː
گهميل	ɡəhˈʌmjal
ڪيلٽڪ	kˌeːləʈˈʌk
رڍون	rəɖʰˈoːn
لازوال	laːzʋˈaːl
گھرڙن	ɡʰˌərər.ˈʌn
ھوائي	hʋˈaːi
تصويري	t̪əʂʋˈiːri
وسعت	ʋəsˈaːt̪
مصروف	mˌəʂrˈuːf
ويهارو	ʋeːhˈaːroː
لاھور	laːhˈoːr
ڏيندڙ	ɖeːndˈʌr.
بري	bˈʌri
اقليتي	ˌaqlˈiːt̪i
نظام	nɪʐˈaːm
پنهون	pˌənhˈuːn
ترجيح	t̪ərˈʌɟih
اطاعت	ˌataːˈaːt̪
ڳڀيرڻ	ɡˌəbʰirˈʌɳ
مارچ	mˈaːrc
سولائي	soːlˈaːi
آجو	ˈaːɟoː
اناج	anˈaːɟ
پني	pˈʌni
مهراڻ	mˌəhərˈaːɳ
الهڏنو	ˌaləhəɖˈʌnoː
سگھ	sˈʌɡʰ
پیش	pˈeːʃ
ڇيڙن	cʰeːr.ˈʌn
رواني	rʋˈaːni
تصوير	t̪əʂʋˈiːr
عبدالواحد	ˌabdˌaːlʋaːhˈʌd
سوني	sˈoːni
سيمينارن	sˌeːminaːrˈʌn
جمشيد	ɟˌəmʃˈiːd
حرارت	hˌəraːrˈʌt̪
والٽر	ʋˌaːləʈˈʌr
سڄاڻ	səɟˈaːɳ
نٿا	nˈʌtʰaː
مريد	mərˈiːd
بلاغت	bˌəlaːɣˈʌt̪
نقاد	nəqˈaːd
اگهه	ˌaɡəhˈʌh
آغا	ˈaːɣaː
وقفي	ʋəqˈʌfi
چوڌاري	coːdʰˈaːri
نزديڪ	nˌəzdˈiːk
پيارو	pjˈaːroː
غداري	ɣədˈaːri
اڏو	ˈaɖoː
ڪيڏي	kˈeːɖi
راڄ	rˈaːɟ
آدرش	ˌaːdərˈʌʃ
بهڻ	bəhˈʌɳ
عارضي	aːrˈʌzi
چورائيندو	cˌoːraːˈiːndoː
جيري	ɟˈeːri
سنڌالاجي	sˌɪndhaːlˈaːɟi
ٿيندي	tʰˈĩːdi
ڪوشش	koːʃˈʌʃ
سگهن	sˌəɡəhˈʌn
دڙو	dˈʌr.oː
مقصود	mˌəqʂˈuːd
پاٽ	pˈaːʈ
دنيا	dˈʌnjaː
ھجي	hˈʌɟi
اڳ	ˈaɡ
مٽن	məʈˈʌn
مڪمل	mˌəkəmˈʌl
تيليون	t̪eːljˈoːn
هٿيارن	hˌətʰjaːrˈʌn
مصرين	mˌəʂrˈiːn
ويا	ʋˈajaː
صلعم	ʂəlˈaːm
اولهه	ˌuːləhˈʌh
ڪونڊين	koːnɖˈiːn
انديشو	andˈiːʃoː
براهوئي	bˌəraːhˈoːi
رپيو	rˈʌpjoː
ڪمائڻ	kˌəmaːˈɪɳ
بر	bˈʌr
ڏيا	ɖjˈaː
ملهايو	mˌəlhˈaːjoː
طاقتور	tˌaːqt̪ˈoːr
ٺٽ	ʈʰˈʌʈ
آثارن	ˌaːsaːrˈʌn
مولود	moːlˈoːd
سيڪيولر	sˌeːkjoːlˈʌr
اتحاد	ˌat̪hˈaːd
وارين	ʋaːrˈiːn
واقف	ʋaːqˈʌf
رهيون	rəhjˈoːn
مٿيان	mətʰjˈaːn
عمارتي	ˌamaːrˈʌt̪i
صدمي	ʂədˈʌmi
آء	ˈaː
گرفتاري	ɡˈɪrɪftˌaːri
تل	t̪ˈʌl
اسپتال	ˌasəpt̪ˈaːl
ڪبير	kəbˈiːr
فائدو	faːˈɪdoː
بڻي	bˈʌɳi
ھول	hˈoːl
مسافرن	mˌəsaːfərˈʌn
الحال	ˌalhˈaːl
برما	bərˈʌmaː
ڇوڪر	cʰoːkˈʌr
بادشاھت	bˈaːdʃˌaːhət̪
برآمد	bˌəraːmˈʌd
ڪاري	kˈaːri
حلب	həlˈʌb
محتاج	mˌəht̪ˈaːɟ
چونڊجي	coːnɖˈʌɟi
موسم	moːsˈʌm
معاشيات	mˌaːʃiˈaːt
ولايت	ʋˌəlaːˈiːt̪
انفرميشن	ˌanəfˌərmiʃˈʌn
جيسينا	ɟeːsˈiːnaː
مال	mˈaːl
عالي	ˈaːli
مڊل	məɖˈʌl
مئجسٽريٽ	mˌəɟəsˌəʈrˈiːʈ
ڳنڍي	ɡənˈʌɖʰi
ٽئگور	ʈəɡˈoːr
وڃن	ʋəɲˈʌn
ڊرائنگ	ɖˌəraːˈɪnɡ
صابڻ	ʂaːbˈɪɳ
ڀڄن	bʰəɟˈʌn
ڪارونجهر	kˌaːroːnˌəɟəhˈʌr
ستاره	sɪtˈaːrh
ڏکن	ɖəkʰˈʌn
فورس	foːrˈʌs
وک	ʋˈʌkʰ
قلعو	qəlˈaːoː
حوا	hʋˈaː
خوب	xˈoːb
ڏيارام	ɖjaːrˈaːm
تاريخي	t̪aːrˈiːxi
سرائيڪي	sˌəraːˈiːki
معاھدي	maːhˈʌdi
خدا	xˈʌdaː
چڪي	cˈʌki
ڪونج	koːnˈʌɟ
پرائڻ	pˌəraːˈɪɳ
طريقي	tərˈiːqi
سنگاپور	sˌənɡaːpˈoːr
گدو	ɡˈʌdoː
ورثو	ʋərˈʌsoː
بھاولپور	bˌəhaːˌoːlpˈoːr
ڏاڙھون	ɖaːr.hˈoːn
پرنسلي	pˌərənsˈʌli
ڏيپلائي	ɖˌeːplˈaːi
اڳٺ	aɡˈʌʈʰ
جوڻيجو	ɟoːɳˈiːɟoː
جوابي	ɟˈaʋaːbˈiː
هڪڙي	həkˈʌr.i
مبتلا	mˌəbət̪ˈʌlaː
مصنوعات	mˌəʂnʋˈaːt̪
سيارن	sjaːrˈʌn
آڊيو	ˈaːɖjoː
روڊن	roːɖˈʌn
گهوڙا	ɡəhˈoːr.aː
مزو	mˈʌzoː
سهاسي	səhˈaːsi
شامي	ʃˈaːmi
سورھين	sˌoːrhˈiːn
منٽ	mənˈʌʈ
ڪروڙن	kˌəroːr.ˈʌn
ڀاڄي	bʰˈaːɟi
رفت	rˈafət
گهرج	ɡˌəhərˈʌɟ
ٽاريون	ʈaːrjˈoːn
احسن	ɛhsˈʌn
فرض	fərˈʌz
نائو	nˈaːoː
وڄائڻ	ʋˌəɟaːˈɪɳ
حافظي	haːfˈʌʐi
سالو	sˈaːloː
دائمي	daːˈɪmi
بوائز	bʋˈaːɪz
ٿين	tʰˈeːn
گھاٽي	ɡʰˈaːʈi
جدوجهد	ɟˌədoːɟəhˈʌd
بانين	bˈaːnin
ڪيترن	kˌeːt̪ərˈʌn
ويلڻ	ʋeːlˈʌɳ
ججهي	ɟəɟˈʌhi
لذيذ	ləzˈiːz
آساني	aːsˈaːni
تحفي	t̪əhˈʌfi
فاروق	faːrˈoːq
انجير	ˌanɟˈiːr
واريون	ʋaːrjˈoːn
ھجري	həɟˈʌri
کولي	kʰˈoːli
جادو	ɟˈaːdoː
جرمني	ɟˌərəmˈʌni
دفتري	dˌəfət̪ˈʌri
هاسارام	hˌaːsaːrˈaːm
سڌريل	sədʰˈʌrjal
ريلي	rˈeːli
نظريي	naʐˈarji
گولو	ɡˈoːloː
شاديون	ʃaːdjˈoːn
ابدالي	ˌabdˈaːli
ستي	sˈʌt̪i
قميص	qəmˈiːʂ
ڪالمن	kˌaːləmˈʌn
خواهه	xʋaːhˈʌh
هارين	haːrˈiːn
مرشد	mˌərəʃˈʌd
آڳاٽن	ˌaːɡaːʈˈʌn
قافيہ	qaːfˈiːh
رهنمائي	rˌəhənmˈaːi
طوفان	toːfˈaːn
خدمتون	xˌədəmt̪ˈoːn
ٻٽي	bˈʌʈi
سڃاڻي	səɲˈaːɳi
سقراط	sˌəqrˈaːt
شاهراهه	ʃˌaːhəraːhˈʌh
ڇلو	cʰˈʌloː
سگهندو	sˌəɡəhˈʌndoː
طرفو	tərˈʌfoː
شاخ	ʃˈaːx
مفعول	mˌəfaːˈoːl
لفظي	ləfˈʌʐi
تعداد	t̪aːdˈaːd
پئماني	pəmˈaːni
شاھجھان	ʃˌaːhəɟhˈaːn
سوڀ	sˈoːbʰ
بيٺڪون	bˈeːʈʰkˌoːn
ٿيڻي	tʰˈeːɳi
پات	pˈaːt̪
سڏين	səɖˈiːn
ٽوليون	ʈoːljˈoːn
قابو	qaːbˈoː
ڪندي	kˈʌndi
سائيڪل	sˌaːikˈʌl
لاکا	lˈaːkʰaː
چورن	coːrˈʌn
هيونسانگ	hjoːnsˈaːnɡ
آئيوري	aːjˈoːri
اڪيلي	akˈiːli
شخصيتن	ʃˈaxʂit̪ˌən
پٽڻ	pəʈˈʌɳ
اسڪائوٽ	ˌaskaːˈoːʈ
سرڪل	sˌərəkˈʌl
سينئر	seːnˈʌr
پرستي	pərˈʌst̪i
برج	bərˈʌɟ
اسٽوريج	ˌasʈoːrˈiːɟ
ڳلي	ɡˈʌli
تڻو	t̪ˈʌɳoː
آسو	ˈaːsoː
وجهبو	ʋˌəɟəhəbˈoː
چاري	cˈaːri
ڪاروهنوار	kˌaːroːhənʋˈaːr
آيو	ˈaːjoː
سڪا	sˈʌkaː
بگڙيل	bəɡˈʌr.jal
سرزمين	sˌərəzmˈiːn
ڊائري	ɖaːˈɪri
لکت	lˈɪkʰat
ائٽمي	aʈˈʌmi
مسڪن	mˌəsəkˈʌn
ڪوهه	koːhˈʌh
آهي	ˌaːheː
جيڪب	ɟeːkˈʌb
ليڪ	lˈeːk
نواڻ	nˈaʋaːɳ
گذرندو	ɡˌəzərˈʌndoː
پارلياماني	pˌaːrljaːmˈaːni
يڪي	jˈʌki
زيور	zjˈoːr
قبر	qəbˈʌr
جنهنڪري	ɟˌənəhˌənəkˈʌri
بٺوري	bəʈʰˈoːri
ارنيسٽ	ˌarnisˈʌʈ
کوٽي	kʰˈoːʈi
تيار	t̪jˈaːr
تال	t̪ˈaːl
پڙھيو	pˈʌr.hjoː
صوبائي	ʂuːbˈaːi
پوريل	pˈoːrjal
پاپ	pˈaːp
آمدرفت	ˌaːmədˌərəfˈʌt̪
ازم	azˈʌm
ميوزڪ	mjoːzˈʌk
بدو	bˈʌdoː
ترتيبوار	t̪ˌərt̪ibʋˈaːr
ھندي	hˈʌndi
لاکو	lˈaːkʰoː
ننگر	nənɡˈʌr
گهڙڻ	ɡˌəhər.ˈʌɳ
پئدا	pˈʌdaː
نال	nˈaːl
رائو	rˈaːoː
غالب	ɣaːlˈʌb
سازش	saːzˈʌʃ
چارو	cˈaːroː
محفوظ	mˌəhfˈuːʐ
حالتون	hˌaːlt̪ˈoːn
پچي	pˈʌci
عبدالحميد	ˌabdˌaːləhmˈiːd
اڏڻ	aɖˈʌɳ
پريميئر	pˌərimiˈɪr
سگهڻ	sˌəɡəhˈʌɳ
جيڏيون	ɟeːɖjˈoːn
جاگيرداري	ɟˌaːɡirdˈaːri
ملندي	məlˈʌndi
هيون	hjˈoːn
ڪئناڊا	kənˈaːɖaː
پٿرن	pˌəʈərˈʌn
رضا	rˈʌzaː
هاضمي	haːzˈʌmi
پهلوئن	pˌəhəloːˈɪn
ٽئڪس	ʈəkˈʌs
لنڊ	lˈʌnɖ
ڏبو	ɖəbˈoː
گورنرن	ɡˌoːrənərˈʌn
ڪونھي	kˈoːnhi
ڇڏيو	cʰˈʌɖjoː
اسان	ˈasãː
بلين	bəlˈiːn
پرديس	pərdˈiːs
چاليھ	caːlˈiːh
ڪڍندو	kəɖʰˈʌndoː
گھٽ	ɡʰˈʌʈ
ڳالھائيندڙ	ɡˌaːlhˌaːindˈʌr.
قدر	qədˈʌr
رن	rˈʌn
چوويهه	cʋʋeːhˈʌh
وڪيلن	ʋˌəkilˈʌn
تمر	t̪əmˈʌr
موڙ	mˈoːr.
گارڊن	ɡˌaːrəɖˈʌn
اچيو	ˈacjoː
ڇانگ	cʰˈaːnɡ
ن	nˈuːn
چونديون	coːndjˈoːn
کٽو	kʰˈʌʈoː
لسٽ	ləsˈʌʈ
ڏيکارين	ɖˌeːkʰaːrˈiːn
السنڌ	ˌaləsˈʌndʰ
عتاب	at̪ˈaːb
قافيو	qˈaːfjoː
گبسن	ɡˌəbəsˈʌn
ڄاڻي	ɟˈaːɳi
وصف	ʋəʂˈʌf
کوڙ	kʰˈoːr.
سرگرميون	sˌarɡˈarmjoːn
پرٿوي	pərˈʌtʰʋi
وقوع	ʋˈʌquː
ڪوڏ	kˈoːɖ
گهرائڻ	ɡˌəhəraːˈɪɳ
ماڙيون	maːr.jˈoːn
لاڳو	lˈaːɡoː
واڌ	ʋˈaːdʰ
ٺاهڻ	ʈʰaːhˈʌɳ
ھوندي	hˈoːndi
جبلن	ɟˌəbəlˈʌn
همير	həmˈiːr
مزاح	mˈʌzaːh
طباعت	təbˈaːaːt̪
رغبت	rˌəɣəbˈʌt̪
انکي	anˈʌkʰi
بروهي	bərˈoːhi
اتهاس	ˌat̪hˈaːs
بہ	bˈɪ
چلي	cˈʌli
گروئن	ɡˌəroːˈɪn
افغانن	ˌafɣaːnˈʌn
پهتي	pəhˈʌt̪i
خوف	xˈoːf
آورن	ˌaːoːrˈʌn
چانڊيا	cˈaːnɖjaː
داخلي	daːxˈʌli
پروفيشنل	pˌəroːfˌiːʃənˈʌl
ڪابينا	kaːbˈiːnaː
بدلو	bədˈʌloː
مومل	moːmˈʌl
سوء	sˈoː
ويجھي	ʋeːɟˈʌhi
عرس	arˈʌs
جست	ɟˈʌst̪
پورب	poːrˈʌb
مخالفت	mˌʊxaːlɪfˈat
هيڪٽر	hˌeːkəʈˈʌr
خوشبودار	xˈʊʃbˈoːdaːr
ٿيندا	tʰˈĩːdaː
مجاز	məɟˈaːz
العابدين	ˌalaːbdˈiːn
اختلاف	ˌɪxtɪlˈaːf
آگرو	aːɡˈʌroː
ڪيسن	keːsˈʌn
نيرون	neːrˈoːn
بد	bˈʌd
اهڃاڻ	ˌahəɲˈaːɳ
سوڀو	sˈoːbʰoː
زنجير	zˌənɟˈiːr
قيادت	qjaːdˈʌt̪
انصاف	ˌanʂˈaːf
ڄيٺ	ɟˈeːʈʰ
انتقام	ˌɪntɪqˈaːm
گھڻين	ɡʰəɳˈiːn
انسٽيٽيوٽ	ˌansəʈiʈjˈoːʈ
غيرجانبدار	ɣˌeːrɟˈaːnɪbdˌaːr
مجلسون	mˌəɟəlsˈoːn
اڃا	ˈaɲaː
عرف	arˈʌf
ڇوڪرا	cʰoːkˈʌraː
انر	anˈʌr
خيبر	xeːbˈʌr
پيا	pjˈaː
جبري	ɟəbˈʌri
اميد	amˈiːd
ٺهندو	ʈʰəhˈʌndoː
جيئرو	ɟeːˈɪroː
هلندڙ	hˌələndˈʌr.
خاص	xˈaːʂ
سلامتي	sˌəlaːmˈʌt̪i
آصف	aːʂˈʌf
عبدالمطلب	ˌabdˌaːləmˌətəlˈʌb
سيريل	sˈeːrjal
ذهنن	zˌəhənˈʌn
دورا	dˈoːraː
تجزيو	t̪əɟˈʌzjoː
دٻاء	dˈʌbaː
مهارن	mˌəhaːrˈʌn
موٽ	mˈoːʈ
قدرن	qˌədərˈʌn
واھ	ʋˈaːh
سٿ	sˈʌʈ
و	ʋˈaːɔ
ماجسٽريٽ	mˌaːɟəsˌəʈrˈiːʈ
ريفرينڊم	rˌeːfrinɖˈʌm
ڏيڏر	ɖeːɖˈʌr
بڻياد	bəɳjˈaːd
هيڏي	hˈeːɖi
مختار	məxt̪ˈaːr
مامي	mˈaːmi
بلب	bəlˈʌb
چنگ	cˈʌnɡ
راج	rˈaːɟ
ابراھام	ˌabraːhˈaːm
سيکاري	seːkʰˈaːri
يرقان	jˌərqˈaːn
ڪڍندا	kəɖʰˈʌndaː
ذاتي	zˈaːt̪i
ذھني	zəhˈʌni
شهريت	ʃˌəhərˈiːt̪
پورهئي	pˌoːrəhˈʌi
پوندي	pˈoːndi
پاتي	pˈaːt̪i
تصوراتي	t̪ˌəʂoːrˈaːt̪i
گڏائي	ɡəɖˈaːi
سڃاڻڻ	sˌəɲaːɳˈʌɳ
برساتون	bˌərsaːt̪ˈoːn
کاڌن	kʰaːdʰˈʌn
وڃي	ʋˈʌɲi
عنات	ˌanˈaːt
ڪچن	kəcˈʌn
نسخن	nˌəsəxˈʌn
عبدالطيف	ˌabdˌaːltˈiːf
سارو	sˈaːroː
بادشاهي	bˈaːdʃˌaːhi
صحافتي	ʂˌəhaːfˈʌt̪i
وياراوالا	ʋjˌaːraːʋˈaːlaː
ذوالحج	zʋˌaːləhˈʌɟ
چيز	cˈeːz
ڏورانهن	ɖˌoːraːnəhˈʌn
رليز	rəlˈiːz
ڏاند	ɖˈaːnd
ليڊر	leːɖˈʌr
امڪاني	ˌamkˈaːni
ڏيکاري	ɖeːkʰˈaːri
حيران	heːrˈaːn
ديوتائن	djˌoːt̪aːˈɪn
ھاسپيٽل	hˌaːspiʈˈʌl
ثقافتن	sˌəqaːfət̪ˈʌn
ميزبان	mˌeːzbˈaːn
سربراه	sˌərəbrˈaːh
ليلا	lˈeːlaː
ٽلٽي	ʈəlˈʌʈi
مفھوم	mˌəfhˈuːm
قدرت	qˌədərˈʌt̪
قصي	qˈʌʂi
جلسو	ɟəlˈʌsoː
جذبو	ɟˌəzbˈoː
ٺھرايو	ʈʰˌəhrˈaːjoː
تقريرون	t̪ˌəqrirˈoːn
حشو	hˈʌʃoː
ذيلي	zˈeːli
فائر	faːˈɪr
قوتون	qoːt̪ˈoːn
دورن	doːrˈʌn
سنبت	sənbˈʌt̪
نظير	nəʐˈiːr
ڇاپي	cʰˈaːpi
ميلبورن	mˌeːlbˈoːrən
هتان	hət̪ˈaːn
ٽنهي	ʈənˈʌhi
ڪمرن	kˌəmərˈʌn
انٽر	ˌanəʈˈʌr
معزالدين	mˌaːzaːldˈiːn
ريڍار	reːɖʰˈaːr
جواز	ɟˈaʋaːz
سڌاري	sədʰˈaːri
هفتيوار	hˌəft̪jʋˈaːr
هزارن	hˌəzaːrˈʌn
آخر	ˈaːxɪr
احترام	ˌɛht̪ərˈaːm
مردم	mərdˈʌm
زهر	zəhˈʌr
سڙڪ	sər.ˈʌk
ماليڪيولن	mˌaːlikjoːlˈʌn
ورهاڱي	ʋˌərhaːˈŋ̩i
سکن	səkʰˈʌn
ٽري	ʈˈʌri
الياس	aljˈaːs
ڏنگي	ɖˈʌnɡi
لڏي	lˈʌɖi
مڃيل	mˈʌɲjal
ابوالڪلام	abʋˈaːləklaːm
املهه	ˌamələhˈʌh
مجذوب	mˌəɟzˈuːb
