மாங்காய்	mɑːŋɡɑːj
சிற	sɨra
உயிர்	ʔɯjɨɾ̪
அங்ஙனம்	ʔʌŋːʌnʌm
திதி	t̪ɨd̪i
வழிச்செலவு	ʋʌɻɨsːel̪ʌʋɯ
சீடை	siːɖʌɪ̯
கொழுப்பு	koɻɯpːɯ
தரூடம்	t̪ʌɾ̪uːɖʌm
ஜந்து	d͡ʑʌn̪d̪ɯ
ஔ	ʔʌʊ̯
விழுதி	ʋɨɻɯd̪i
கலுழ்ச்சி	kʌl̪ɯɻsːi
இருள்	ʔɨɾ̪ɯɭ
பன்றி	pʌnri
உளவு	ʔɯɭʌʋɯ
போனகம்	poːnʌɡʌm
உயிரியல்	ʔɯjɨɾ̪ɨjʌl̪
உள்	ʔɯɭ
சரிவு	sʌɾ̪ɨʋɯ
சாளம்	sɑːɭʌm
நீராவி	n̪iːɾ̪ɑːʋi
மாமிசம்	mɑːmɨsʌm
நீத்து	n̪iːt̪ːɯ
மழைக்காலம்	mʌɻʌɪ̯kːɑːl̪ʌm
ருத்திரசடை	ɾ̪ɯt̪ːɨɾ̪ʌsʌɖʌɪ̯
அக்கினிச்சுவாலை	ʔʌkːɨnɨsːɯʋɑːl̪ʌɪ̯
ச	sa
குலை	kɯl̪ʌɪ̯
குட்டி	kɯʈːi
வாராவதி	ʋɑːɾ̪ɑːʋʌd̪i
குரங்கு	kɯɾ̪ʌŋɡɯ
விதை	ʋɨd̪ʌɪ̯
தேவையான	t̪eːʋʌɪ̯jɑːna
உழவு	ʔɯɻʌʋɯ
வாக்களிப்பு	ʋɑːkːʌɭɨpːɯ
வேலைவளர்	ʋeːl̪ʌɪ̯ʋʌɭʌɾ̪
நகரப்பதி	n̪ʌɡʌɾ̪ʌpːʌd̪i
நெசவு	n̪esʌʋɯ
உதடு	ʔɯd̪ʌɖɯ
மிக	mɨɡa
பாயசம்	pɑːjʌsʌm
வியாழன்	ʋɨjɑːɻʌn
ஸாயகம்	sɑːjʌɡʌm
குள்ளம்	kɯɭːʌm
கல்வெட்டியல்	kʌl̪ʋeʈːɨjʌl̪
கோயில்	koːjɨl̪
நீளிப்பு	n̪iːɭɨpːɯ
உண்மை	ʔɯɳmʌɪ̯
நிறம்	n̪ɨrʌm
இலக்கணம்	ʔɨl̪ʌkːʌɳʌm
யாவரும்	jɑːʋʌɾ̪ɯm
சாவல்	sɑːʋʌl̪
இயல்புகணம்	ʔɨjʌl̪pɯɡʌɳʌm
கடை	kʌɖʌɪ̯
முதலீடு	mɯd̪ʌl̪iːɖɯ
நன்றி	n̪ʌnri
இல்லை	ʔɨl̪ːʌɪ̯
வெளியீடு	ʋeɭɨjiːɖɯ
சொற்பொழிவு	sorpoɻɨʋɯ
கரும்பு	kʌɾ̪ɯmbɯ
பின்	pɨn
உரிமை	ʔɯɾ̪ɨmʌɪ̯
கடுங்கோபம்	kʌɖɯŋɡoːbʌm
இவள்	ʔɨʋʌɭ
முஸ்லீம்	mɯsl̪iːm
வீட்டுக்காரி	ʋiːʈːɯkːɑːɾ̪i
உன்	ʔɯn
துறை	t̪ɯrʌɪ̯
தமிழ்	t̪ʌmɨɻ
அடிகேயா	ʔʌɖɨɡeːjɑː
விருஷ்டி	ʋɨɾ̪ɯʂʈi
மகிழ்ச்சி	mʌɡɨɻsːi
அரைநெல்லி	ʔʌɾ̪ʌɪ̯n̪el̪ːi
பன்றிக்குட்டி	pʌnrɨkːɯʈːi
பிறிதுசாபம்	pɨrɨd̪ɯsɑːbʌm
இங்கே	ʔɨŋɡeː
கலைச்சொல்	kʌl̪ʌɪ̯sːol̪
செய்	sej
உடல்	ʔɯɖʌl̪
இலக்கியம்	ʔɨl̪ʌkːɨjʌm
ஐயம்	ʔʌɪ̯jʌm
கிறிஸ்து	kɨrɨst̪ɯ
பாலூட்டி	pɑːl̪uːʈːi
அசர்த்து	ʔʌsʌɾ̪t̪ːɯ
வண்டு	ʋʌɳɖɯ
தாகெஸ்தான்	t̪ɑːɡest̪ɑːn
பட்டு	pʌʈːɯ
பரிவு	pʌɾ̪ɨʋɯ
இறைச்சி	ʔɨrʌɪ̯sːi
தில்லம்	t̪ɨl̪ːʌm
அறிப்பு	ʔʌrɨpːɯ
கட்டியடுப்பு	kʌʈːɨjʌɖɯpːɯ
அகலம்	ʔʌɡʌl̪ʌm
வடிவம்	ʋʌɖɨʋʌm
மரம்	mʌɾ̪ʌm
பெருக்கல்	peɾ̪ɯkːʌl̪
இல்லக்கிழத்தி	ʔɨl̪ːʌkːɨɻʌt̪ːi
கலப்பை	kʌl̪ʌpːʌɪ̯
ஜப்பான்	d͡ʑʌpːɑːn
இல்லாள்	ʔɨl̪ːɑːɭ
பிசறுதல்	pɨsʌrɯd̪ʌl̪
பூண்டு	puːɳɖɯ
சொற்பு	sorpɯ
பணிதி	pʌɳɨd̪i
பிரமாதமான	pɨɾ̪ʌmɑːd̪ʌmɑːna
காவு	kɑːʋɯ
ஆசிருந்தம்	ʔɑːsɨɾ̪ɯn̪d̪ʌm
சிவ	sɨʋa
அகரவரிசை	ʔʌɡʌɾ̪ʌʋʌɾ̪ɨsʌɪ̯
சேர்த்தி	seːɾ̪t̪ːi
பேச்சு	peːsːɯ
சிவப்புக்கல்	sɨʋʌpːɯkːʌl̪
புற்றுநோய்	pɯʈːɾɯn̪oːj
பெண்கள்	peɳkʌɭ
திருக்கார்த்திகை	t̪ɨɾ̪ɯkːɑːɾ̪t̪ːɨɡʌɪ̯
செடி	seɖi
சந்திப்பு	sʌn̪d̪ɨpːɯ
வழக்கு	ʋʌɻʌkːɯ
மர்தோவியா	mʌɾ̪t̪oːʋɨjɑː
நினைவு	n̪ɨnʌɪ̯ʋɯ
நிஷ்டை	n̪ɨʂʈʌɪ̯
பிசிறுலாடு	pɨsɨrɯl̪ɑːɖɯ
பவழம்	pʌʋʌɻʌm
விரிகாசம்	ʋɨɾ̪ɨɡɑːsʌm
கூலம்	kuːl̪ʌm
ஈரல்	ʔiːɾ̪ʌl̪
மந்தினி	mʌn̪d̪ɨni
இந்தியர்	ʔɨn̪d̪ɨjʌɾ̪
ஶஸ்யம்	ɕʌsjʌm
கருமம்	kʌɾ̪ɯmʌm
வாக்காளர்	ʋɑːkːɑːɭʌɾ̪
ஜிராயதி	d͡ʑɨɾ̪ɑːjʌd̪i
வல்லடி	ʋʌl̪ːʌɖi
பேரினம்	peːɾ̪ɨnʌm
தலையல்	t̪ʌl̪ʌɪ̯jʌl̪
தேசபாஷை	t̪eːsʌbɑːʂʌɪ̯
மாதறி	mɑːd̪ʌri
அந்தந்த	ʔʌn̪d̪ʌn̪d̪a
அந்நிலை	ʔʌn̪ːɨl̪ʌɪ̯
பைவன்	pʌɪ̯ʋʌn
கூரைவீடு	kuːɾ̪ʌɪ̯ʋiːɖɯ
நேர்ச்சி	n̪eːɾ̪sːi
லுங்கி	l̪ɯŋɡi
சிங்கம்	sɨŋɡʌm
மேய்ப்பு	meːjpːɯ
ஆண்டு	ʔɑːɳɖɯ
உறவு	ʔɯrʌʋɯ
ரகசியம்	ɾ̪ʌɡʌsɨjʌm
செங்	seŋ
ஆசீர்வதி	ʔɑːsiːɾ̪ʋʌd̪i
நோக்கு	n̪oːkːɯ
நடு	n̪ʌɖɯ
பழைய	pʌɻʌɪ̯ja
மேரை	meːɾ̪ʌɪ̯
தெரு	t̪eɾ̪ɯ
முட்டுக்கால்	mɯʈːɯkːɑːl̪
மாவு	mɑːʋɯ
வாள்	ʋɑːɭ
கூத்து	kuːt̪ːɯ
நொடிப்பு	n̪oɖɨpːɯ
அப்பால்	ʔʌpːɑːl̪
ஏலம்	ʔeːl̪ʌm
சீழ்	siːɻ
நிலவு	n̪ɨl̪ʌʋɯ
காளை	kɑːɭʌɪ̯
விழுக்காடு	ʋɨɻɯkːɑːɖɯ
சாம்பல்	sɑːmbʌl̪
வாழ்வு	ʋɑːɻʋɯ
கணக்காளர்	kʌɳʌkːɑːɭʌɾ̪
பதிமுகம்	pʌd̪ɨmɯɡʌm
வடை	ʋʌɖʌɪ̯
இரண்டு	rɛɳɖɯ
விளா	ʋiɭaː
கை	kʌɪ̯
உரோமம்	ʔɯɾ̪oːmʌm
வீராங்கனை	ʋiːɾ̪ɑːŋɡʌnʌɪ̯
வேலைநாணயம்	ʋeːl̪ʌɪ̯n̪ɑːɳʌjʌm
தியானம்	t̪ɨjɑːnʌm
ஆடை	ʔɑːɖʌɪ̯
பழம்பாடம்	pʌɻʌmbɑːɖʌm
சதை	sʌd̪ʌɪ̯
கல்விக்கூடம்	kʌl̪ʋɨkːuːɖʌm
குடம்	kɯɖʌm
சிருஷ்டி	sɨɾ̪ɯʂʈi
பண்டம்	pʌɳɖʌm
மதறாஸ்	mʌd̪ʌrɑːs
மந்து	mʌn̪d̪ɯ
சாளரம்	sɑːɭʌɾ̪ʌm
கதம்பகம்	kʌd̪ʌmbʌɡʌm
கார்	kɑːɾ̪
மணித்தக்காளி	mʌɳɨt̪ːʌkːɑːɭi
லங்கர்	l̪ʌŋɡʌɾ̪
உன்னம்	ʔɯnːʌm
இரை	ʔɨɾ̪ʌɪ̯
வதி	ʋʌd̪i
சிதல்	sɨd̪ʌl̪
மாங்கிஸ்	mɑːŋɡɨs
கண்டங்கத்தரி	kaɳɖəŋɡət̪ːəɾɨ
காப்ச்சா	kɑːpsːɑː
இங்ஙனம்	ʔɨŋːʌnʌm
அயோத்தி	ʔʌjoːt̪ːi
பக்கம்	pʌkːʌm
மனைவி	mʌnʌɪ̯ʋi
பெண்பால்	peɳpɑːl̪
நடிகர்	n̪ʌɖɨɡʌɾ̪
தூக்கு	t̪uːkːɯ
குரல்வளை	kɯɾ̪ʌl̪ʋʌɭʌɪ̯
உச்சரிப்பு	ʔɯsːʌɾ̪ɨpːɯ
சுரை	sɯɾ̪ʌɪ̯
படம்	pʌɖʌm
அதிகாரம்	ʔʌd̪ɨɡɑːɾ̪ʌm
சத்து	sʌt̪ːɯ
காபி	kɑːbi
காற்று	kɑːʈːɾɯ
அரசி	ʔʌɾ̪ʌsi
கூடாரம்	kuːɖɑːɾ̪ʌm
பணாகரம்	pʌɳɑːɡʌɾ̪ʌm
கடிதம்	kʌɖɨd̪ʌm
குடுவை	kɯɖɯʋʌɪ̯
அவதாரம்	ʔʌʋʌd̪ɑːɾ̪ʌm
கிருபை	kɨɾ̪ɯbʌɪ̯
திருப்பு	t̪ɨɾ̪ɯpːɯ
வங்காளம்	ʋʌŋɡɑːɭʌm
ஐதரசன்	ʔʌɪ̯t̪ʌɾ̪ʌsʌn
கன்னம்	kʌnːʌm
நிலக்கடலை	n̪ɨl̪ʌkːʌɖʌl̪ʌɪ̯
மலர்	mʌl̪ʌɾ̪
முட்டை	mɯʈːʌɪ̯
வாரம்	ʋɑːɾ̪ʌm
பதவி	pʌd̪ʌʋi
முன்னேற்றம்	mɯnːeːʈːɾʌm
ரோமம்	ɾ̪oːmʌm
புயல்	pɯjʌl̪
தன்மை	t̪ʌnmʌɪ̯
போன்றீயம்	poːnriːjʌm
பிசாசர்	pɨsɑːsʌɾ̪
விவசாயம்	ʋɨʋʌsɑːjʌm
பரங்கி	pʌɾ̪ʌŋɡi
மடுத்தல்	mʌɖɯt̪ːʌl̪
மதிப்பு	mʌd̪ɨpːɯ
அக்கச்சி	ʔʌkːʌsːi
கத்திரிணி	kʌt̪ːɨɾ̪ɨɳi
அருமை	ʔʌɾ̪ɯmʌɪ̯
தொடர்வண்டி	t̪oɖʌɾ̪ʋʌɳɖi
குழப்பம்	kɯɻʌpːʌm
பிரபை	pɨɾ̪ʌbʌɪ̯
கல்	kʌl̪
வரகு	ʋʌɾ̪ʌɡɯ
வேலை	ʋeːl̪ʌɪ̯
மைதா	mʌɪ̯t̪ɑː
வல்லேறு	ʋʌl̪ːeːrɯ
பொந்து	pon̪d̪ɯ
மாத்து	mɑːt̪ːɯ
நீலம்	n̪iːl̪ʌm
பட	pʌɖa
தோகம்	t̪oːɡʌm
நீண்டாயம்	n̪iːɳɖɑːjʌm
தேசம்	t̪eːsʌm
இலத்தீன்	ʔɨl̪ʌt̪ːiːn
தாய்மொழி	t̪ɑːjmoɻi
சதுரங்கம்	sʌd̪ɯɾ̪ʌŋɡʌm
எருமை	ʔeɾ̪ɯmʌɪ̯
மேயல்	meːjʌl̪
மான்	mɑːn
வரம்	ʋʌɾ̪ʌm
ஆணையம்	ʔɑːɳʌɪ̯jʌm
மேகம்	meːɡʌm
பூகண்டம்	puːɡʌɳɖʌm
இந்தி	ʔɨn̪d̪i
சிதர்	sɨd̪ʌɾ̪
சின்ன	sɨnːa
பெரியோன்	peɾ̪ɨjoːn
புதுச்சேரி	pɯd̪ɯsːeːɾ̪i
அப்படி	ʔʌpːʌɖi
உணர்த்தி	ʔɯɳʌɾ̪t̪ːi
உண்டாக்கு	ʔɯɳɖɑːkːɯ
கிரி	kɨɾ̪i
முருங்கை	mɯɾ̪ɯŋɡʌɪ̯
கிறிஸ்துமஸ்	kɨrɨst̪ɯmʌs
பறப்பன்	pʌrʌpːʌn
பலாப்பழம்	pʌl̪ɑːpːʌɻʌm
நெஞ்சு	n̪eɲd͡ʑɯ
வேலைவாங்கு	ʋeːl̪ʌɪ̯ʋɑːŋɡɯ
சினை	sɨnʌɪ̯
மேசை	meːsʌɪ̯
ஸார்த்தகம்	sɑːɾ̪t̪ːʌɡʌm
புறா	pɯrɑː
நாக்கு	n̪ɑːkːɯ
ரூபாய்	ɾ̪uːbɑːj
பர்வதம்	pʌɾ̪ʋʌd̪ʌm
நதிகேள்வன்	n̪ʌd̪ɨɡeːɭʋʌn
வருக்கணம்	ʋʌɾ̪ɯkːʌɳʌm
பளு	pʌɭɯ
பிசாசன்	pɨsɑːsʌn
பெருக்கம்	peɾ̪ɯkːʌm
சொந்த	son̪d̪a
பிறவிக்கடல்	pɨrʌʋɨkːʌɖʌl̪
வேண்டிய	ʋeːɳɖɨja
அது	ʔʌd̪ɯ
மேஜை	meːd͡ʑʌɪ̯
ருசரகம்	ɾ̪ɯsʌɾ̪ʌɡʌm
அந்நின்று	ʔʌn̪ːɨnrɯ
சர்ச்சை	sʌɾ̪sːʌɪ̯
அண்ணா	ʔʌɳːɑː
போற்று	poːʈːɾɯ
மணல்	mʌɳʌl̪
நதி	n̪ʌd̪i
மெய்யெழுத்து	mejːeɻɯt̪ːɯ
சுவாசியா	sɯʋɑːsɨjɑː
ஆயுதம்	ʔɑːjɯd̪ʌm
குடும்பம்	kɯɖɯmbʌm
இளம்பிறை	ʔɨɭʌmbɨrʌɪ̯
தளர்ச்சி	t̪ʌɭʌɾ̪sːi
அசர்	ʔʌsʌɾ̪
துப்பல்	t̪ɯpːʌl̪
தவளை	t̪ʌʋʌɭʌɪ̯
பூரணமி	puːɾ̪ʌɳʌmi
கோடரி	koːɖʌɾ̪i
மரக்கட்டை	mʌɾ̪ʌkːʌʈːʌɪ̯
கூடம்	kuːɖʌm
தெஹரான்	t̪ehʌɾ̪ɑːn
கணுமருது	kʌɳɯmʌɾ̪ɯd̪ɯ
தான்	t̪ɑːn
மறுபரிசீலனை	mʌrɯbʌɾ̪ɨsiːl̪ʌnʌɪ̯
நிமிஷம்	n̪ɨmɨʂʌm
வல்லுரம்	ʋʌl̪ːɯɾ̪ʌm
வரப்பு	ʋʌɾ̪ʌpːɯ
வழி	ʋʌɻi
கோடிமுனை	koːɖɨmɯnʌɪ̯
அம்பரம்	ʔʌmbʌɾ̪ʌm
நூலகம்	n̪uːl̪ʌɡʌm
சிதறியம்	sɨd̪ʌrɨjʌm
அரண்மனை	ʔʌɾ̪ʌɳmʌnʌɪ̯
சூரியன்	suːɾ̪ɨjʌn
பீர்க்கம்	piːɾ̪kːʌm
சின்னக்கரடி	sɨnːʌkːʌɾ̪ʌɖi
அரிசி	ʔʌɾ̪ɨsi
ரிஷி	ɾ̪ɨʂi
சாயங்காலம்	sɑːjʌŋɡɑːl̪ʌm
அபிஷேகம்	ʔʌbɨʂeːɡʌm
பாரதம்	pɑːɾ̪ʌd̪ʌm
தள்ளை	t̪ʌɭːʌɪ̯
பாட்டி	pɑːʈːi
மறை	mʌrʌɪ̯
பறவை	pʌrʌʋʌɪ̯
குளியல்	kɯɭɨjʌl̪
வெல்லம்	ʋel̪ːʌm
கண்	kʌɳ
பங்களா	pʌŋɡʌɭɑː
பின்லாந்து	pɨnl̪ɑːn̪d̪ɯ
யார்	jɑːɾ̪
தாளித்தல்	t̪ɑːɭɨt̪ːʌl̪
குளிர்மை	kɯɭɨɾ̪mʌɪ̯
மகரந்தம்	mʌɡʌɾ̪ʌn̪d̪ʌm
கவிதை	kʌʋɨd̪ʌɪ̯
அல்	ʔʌl̪
பசு	pʌsɯ
அருக்கன்வீதி	ʔʌɾ̪ɯkːʌnʋiːd̪i
குறங்கு	kɯrʌŋɡɯ
கல்வி	kʌl̪ʋi
கருவி	kʌɾ̪ɯʋi
கொண்டாட்டம்	koɳɖɑːʈːʌm
கிழக்கு	kɨɻʌkːɯ
கோட்டம்	koːʈːʌm
இப்பொழுது	ʔɨpːoɻɯd̪ɯ
எடுத்துக்காட்டு	ʔeɖɯt̪ːɯkːɑːʈːɯ
வகு	ʋʌɡɯ
மருந்துக்கடை	mʌɾ̪ɯn̪d̪ɯkːʌɖʌɪ̯
தலைமாறு	t̪ʌl̪ʌɪ̯mɑːrɯ
குணிப்பு	kɯɳɨpːɯ
இரசிதம்	ʔɨɾ̪ʌsɨd̪ʌm
நாங்கள்	n̪ɑːŋɡʌɭ
நெய்ப்பு	n̪ejpːɯ
பழக்கம்	pʌɻʌkːʌm
அபிமானம்	ʔʌbɨmɑːnʌm
பிசினி	pɨsɨni
சுனாமி	sɯnɑːmi
இந்த	ʔɨn̪d̪a
கொல்லற்றுவேலை	kol̪ːʌʈːɾɯʋeːl̪ʌɪ̯
விண்மீன்	ʋɨɳmiːn
தொழிற்சாலை	t̪oɻɨrsɑːl̪ʌɪ̯
நட்சத்திரம்	n̪ʌʈsʌt̪ːɨɾ̪ʌm
சோபானம்	soːbɑːnʌm
ரம்பம்	ɾ̪ʌmbʌm
வங்கி	ʋʌŋɡi
பேராசிரியர்	peːɾ̪ɑːsɨɾ̪ɨjʌɾ̪
துவக்கு	t̪ɯʋʌkːɯ
அகங்காரம்	ʔʌɡʌŋɡɑːɾ̪ʌm
கோடாலி	koːɖɑːl̪i
மக	mʌɡa
மூளை	muːɭʌɪ̯
எலும்பு	ʔel̪ɯmbɯ
இடப்பெயர்	ʔɨɖʌpːejʌɾ̪
கழுவு	kʌɻɯʋɯ
ஆயுள்	ʔɑːjɯɭ
தம்பம்	t̪ʌmbʌm
ஞானம்	ɲɑːnʌm
தீமுறி	t̪iːmɯri
பஞ்சாப்	pʌɲd͡ʑɑːp
திரவம்	t̪ɨɾ̪ʌʋʌm
உயிர்த்தெழு	ʔɯjɨɾ̪t̪ːeɻɯ
காகம்	kɑːɡʌm
சிரித்தை	sɨɾ̪ɨt̪ːʌɪ̯
பெயர்ச்சி	pejʌɾ̪sːi
வரடம்	ʋʌɾ̪ʌɖʌm
பல்வலம்	pʌl̪ʋʌl̪ʌm
அமைதி	ʔʌmʌɪ̯t̪i
சேர்ப்பு	seːɾ̪pːɯ
பெயர்	pejʌɾ̪
மனம்	mʌnʌm
செடிகொடி	seɖɨɡoɖi
தேசீயவியக்கம்	t̪eːsiːjʌʋɨjʌkːʌm
பெயலை	pejʌl̪ʌɪ̯
பிகுபண்ணுதல்	pɨɡɯbʌɳːɯd̪ʌl̪
செவ்வனம்	seʋːʌnʌm
மாட்டு	mɑːʈːɯ
முட்டாள்	mɯʈːɑːɭ
அடர்த்தி	ʔʌɖʌɾ̪t̪ːi
சூறை	suːrʌɪ̯
கத்திரி	kʌt̪ːɨɾ̪i
இத்தனை	ʔɨt̪ːʌnʌɪ̯
அந்தண்டை	ʔʌn̪d̪ʌɳɖʌɪ̯
பிசங்குதல்	pɨsʌŋɡɯd̪ʌl̪
அறம்	ʔʌrʌm
தேர்ச்சி	t̪eːɾ̪sːi
இருமல்	ʔɨɾ̪ɯmʌl̪
உபோதம்	ʔɯboːd̪ʌm
கணையாழி	kʌɳʌɪ̯jɑːɻi
அப்பம்	ʔʌpːʌm
புலி	pɯl̪i
பழிச்சு	pʌɻɨsːɯ
நிகழ்ச்சி	n̪ɨɡʌɻsːi
இழிவு	ʔɨɻɨʋɯ
இரைப்பை	ʔɨɾ̪ʌɪ̯pːʌɪ̯
நிலம்	n̪ɨl̪ʌm
திருப்புகை	t̪ɨɾ̪ɯpːɯɡʌɪ̯
புடவை	pɯɖʌʋʌɪ̯
கர்நாடகம்	kʌɾ̪n̪ɑːɖʌɡʌm
சமயம்	sʌmʌjʌm
ஒப்புகை	ʔopːɯɡʌɪ̯
ருப்புலக்கை	ɾ̪ɯpːɯl̪ʌkːʌɪ̯
உணர்ச்சி	ʔɯɳʌɾ̪sːi
பாம்பு	pɑːmbɯ
இலங்கை	ʔɨl̪ʌŋɡʌɪ̯
சாப்பாட்டுக்கடை	sɑːpːɑːʈːɯkːʌɖʌɪ̯
உருத்திரன்	ʔɯɾ̪ɯt̪ːɨɾ̪ʌn
அப்பா	ʔʌpːɑː
துயில்	t̪ɯjɨl̪
அம்பு	ʔʌmbɯ
சென்னை	senːʌɪ̯
அடிமை	ʔʌɖɨmʌɪ̯
எல்லை	ʔel̪ːʌɪ̯
ஸாஹுகார்	sɑːhɯɡɑːɾ̪
ஆய்வு	ʔɑːjʋɯ
சமவெளி	sʌmʌʋeɭi
நோக்காடு	n̪oːkːɑːɖɯ
சுற்றுச்சூழல்	sɯʈːɾɯsːuːɻʌl̪
கணக்கியல்	kʌɳʌkːɨjʌl̪
மெய்யியல்	mejːɨjʌl̪
சொல்வளம்	sol̪ʋʌɭʌm
ஆசிரியர்	ʔɑːsɨɾ̪ɨjʌɾ̪
பாறை	pɑːrʌɪ̯
தொற்று	t̪oʈːɾɯ
ஆமை	ʔɑːmʌɪ̯
வலங்கம்	ʋʌl̪ʌŋɡʌm
செந்தமிழ்	sen̪d̪ʌmɨɻ
குண்டம்	kɯɳɖʌm
பிங்கலகேசி	pɨŋɡʌl̪ʌɡeːsi
நாடா	n̪ɑːɖɑː
பனாயிப்பு	pʌnɑːjɨpːɯ
காளான்	kɑːɭɑːn
மேய்ச்சல்	meːjsːʌl̪
சலவைக்காரர்	sʌl̪ʌʋʌɪ̯kːɑːɾ̪ʌɾ̪
நட்டம்	n̪ʌʈːʌm
உறல்	ʔɯrʌl̪
எழுத்து	ʔeɻɯt̪ːɯ
கைப்பை	kʌɪ̯pːʌɪ̯
நகரம்	n̪ʌɡʌɾ̪ʌm
வார்த்தை	ʋɑːɾ̪t̪ːʌɪ̯
மிளகு	mɨɭʌɡɯ
பங்குரம்	pʌŋɡɯɾ̪ʌm
வாகடம்	ʋɑːɡʌɖʌm
சத்திரம்	sʌt̪ːɨɾ̪ʌm
பின்னிரக்கம்	pɨnːɨɾ̪ʌkːʌm
ஆடல்	ʔɑːɖʌl̪
கிராம்பு	kɨɾ̪ɑːmbɯ
அறிவு	ʔʌrɨʋɯ
சதகுப்பி	sadəɣʉpːɨ
ஆறு	ʔɑːrɯ
இங்குஷேத்தியா	ʔɨŋɡɯʂeːt̪ːɨjɑː
வியாழம்	ʋɨjɑːɻʌm
செச்சினியா	sesːɨnɨjɑː
கனவு	kʌnʌʋɯ
கிழவி	kɨɻʌʋi
கனடா	kʌnʌɖɑː
ஆயிட்டு	ʔɑːjɨʈːɯ
தங்கை	t̪ʌŋɡʌɪ̯
விஷாதம்	ʋɨʂɑːd̪ʌm
சினேகம்	sɨneːɡʌm
ராஜீயவாதி	ɾ̪ɑːd͡ʑiːjʌʋɑːd̪i
அடிக்கடி	ʔʌɖɨkːʌɖi
மாரிகாலம்	mɑːɾ̪ɨɡɑːl̪ʌm
ஸாலியானா	sɑːl̪ɨjɑːnɑː
உத்தரி	ʔɯt̪ːʌɾ̪i
நேர்வு	n̪eːɾ̪ʋɯ
அலர்த்தி	ʔʌl̪ʌɾ̪t̪ːi
விளக்கு	ʋɨɭʌkːɯ
கவிஞர்	kʌʋɨɲʌɾ̪
அடங்கு	ʔʌɖʌŋɡɯ
வலசை	ʋʌl̪ʌsʌɪ̯
கள்ளம்	kʌɭːʌm
கணவன்	kʌɳʌʋʌn
கிளம்பினவேலை	kɨɭʌmbɨnʌʋeːl̪ʌɪ̯
மொழிபெயர்ப்பு	moɻɨbejʌɾ̪pːɯ
மா	mɑː
மயில்	mʌjɨl̪
வன்முறை	ʋʌnmɯrʌɪ̯
வலுப்பு	ʋʌl̪ɯpːɯ
முகை	mɯɡʌɪ̯
உதவி	ʔɯd̪ʌʋi
கோளாறு	koːɭɑːrɯ
படிவம்	pʌɖɨʋʌm
அடிமுடி	ʔʌɖɨmɯɖi
ஈகை	ʔiːɡʌɪ̯
வினைவியம்	ʋɨnʌɪ̯ʋɨjʌm
யோசனை	joːsʌnʌɪ̯
நீண்மை	n̪iːɳmʌɪ̯
தலைவன்	t̪ʌl̪ʌɪ̯ʋʌn
அவர்	ʔʌʋʌɾ̪
ஐநூறு	ʔʌɪ̯n̪uːrɯ
மறுக்கம்	mʌrɯkːʌm
சமாதானம்	sʌmɑːd̪ɑːnʌm
கத்திரிக்காய்	kʌt̪ːɨɾ̪ɨkːɑːj
போது	poːd̪ɯ
பயம்	pʌjʌm
மூடு	muːɖɯ
வடக்கு	ʋʌɖʌkːɯ
இட்டம்	ʔɨʈːʌm
நாட்டாண்மை	n̪ɑːʈːɑːɳmʌɪ̯
அம்மா	ʔʌmːɑː
சினகர்	sɨnʌɡʌɾ̪
மஞ்சள்முள்ளங்கி	mʌɲd͡ʑʌɭmɯɭːʌŋɡi
பிசனம்	pɨsʌnʌm
விதி	ʋɨd̪i
அகற்று	ʔʌɡʌʈːɾɯ
பவ்வம்	pʌʋːʌm
துருக்மெனிஸ்தான்	t̪ɯɾ̪ɯkmenɨst̪ɑːn
வினவு	ʋɨnʌʋɯ
மெல்லிய	mel̪ːɨja
விமானம்	ʋɨmɑːnʌm
கன்று	kʌnrɯ
விலை	ʋɨl̪ʌɪ̯
அணியம்	ʔʌɳɨjʌm
உலகம்	ʔɯl̪ʌɡʌm
எரிமலை	ʔeɾ̪ɨmʌl̪ʌɪ̯
வேம்பு	ʋeːmbɯ
இரவு	ʔɨɾ̪ʌʋɯ
முலை	mɯl̪ʌɪ̯
அவதி	ʔʌʋʌd̪i
அவ்	ʔʌʋ
எங்கு	ʔeŋɡɯ
வயல்	ʋʌjʌl̪
சர்வத்திர	sʌɾ̪ʋʌt̪ːɨɾ̪a
கறி	kʌri
குமிழி	kɯmɨɻi
செயசூறை	sejʌsuːrʌɪ̯
பாப்பா	pɑːpːɑː
குடல்வால்	kɯɖʌl̪ʋɑːl̪
விநாடி	ʋɨn̪ɑːɖi
பிங்கம்	pɨŋɡʌm
பாவிப்பு	pɑːʋɨpːɯ
இயேசு	ʔɨjeːsɯ
பருவதம்	pʌɾ̪ɯʋʌd̪ʌm
வாய்க்கால்	ʋɑːjkːɑːl̪
கித்தார்	kɨt̪ːɑːɾ̪
மிகுதல்	mɨɡɯd̪ʌl̪
பசளி	pʌsʌɭi
குண்டி	kɯɳɖi
கடற்கரை	kʌɖʌrkʌɾ̪ʌɪ̯
புசிப்பு	pɯsɨpːɯ
மண்டலம்	mʌɳɖʌl̪ʌm
உன்னு	ʔɯnːɯ
குங்கிலியம்	kɯŋɡɨl̪ɨjʌm
செம்பு	sembɯ
வங்கிக்கடன்	ʋʌŋɡɨkːʌɖʌn
பிரிவு	pɨɾ̪ɨʋɯ
மாய்ச்சி	mɑːjsːi
அரிவாள்மணை	ʔʌɾ̪ɨʋɑːɭmʌɳʌɪ̯
கோரிக்கை	koːɾ̪ɨkːʌɪ̯
கிளர்	kɨɭʌɾ̪
கலை	kʌl̪ʌɪ̯
கட்டி	kʌʈːi
அழிவு	ʔʌɻɨʋɯ
குரல்	kɯɾ̪ʌl̪
நல்லவர்	n̪ʌl̪ːʌʋʌɾ̪
நீக்கம்	n̪iːkːʌm
திருட்டு	t̪ɨɾ̪ɯʈːɯ
பெருக்கு	peɾ̪ɯkːɯ
இணக்கு	ʔɨɳʌkːɯ
மந்திரர்	mʌn̪d̪ɨɾ̪ʌɾ̪
ரிஷபம்	ɾ̪ɨʂʌbʌm
பிசின்பட்டை	pɨsɨnpʌʈːʌɪ̯
முரி	mɯɾ̪i
மதிநுட்பமிக்க	mʌd̪ɨn̪ɯʈpʌmɨkːa
தந்திரவாயன்	t̪ʌn̪d̪ɨɾ̪ʌʋɑːjʌn
பிசுக்கோத்து	pɨsɯkːoːt̪ːɯ
கிருத்திரம்	kɨɾ̪ɯt̪ːɨɾ̪ʌm
சீக்கிரம்	siːkːɨɾ̪ʌm
பண்பு	pʌɳpɯ
சமைவு	sʌmʌɪ̯ʋɯ
பேதிமருந்து	peːd̪ɨmʌɾ̪ɯn̪d̪ɯ
மாசவிடாய்	mɑːsʌʋɨɖɑːj
எங்கண்	ʔeŋɡʌɳ
ஜனவரி	d͡ʑʌnʌʋʌɾ̪i
தீவு	t̪iːʋɯ
காமம்	kɑːmʌm
குளி	kɯɭi
பிச்சுப்பை	pɨsːɯpːʌɪ̯
தேங்காய்	t̪eːŋɡɑːj
வால்	ʋɑːl̪
திறவுகோல்	t̪ɨrʌʋɯɡoːl̪
ஊதியம்	ʔuːd̪ɨjʌm
கிட்ட	kɨʈːa
மூக்கு	muːkːɯ
கொக்கு	kokːɯ
பங்களிப்பு	pʌŋɡʌɭɨpːɯ
மாதுபாகம்	mɑːd̪ɯbɑːɡʌm
கப்பல்	kʌpːʌl̪
சுண்ணம்	sɯɳːʌm
தம்புரா	t̪ʌmbɯɾ̪ɑː
அமிர்தம்	ʔʌmɨɾ̪t̪ʌm
மாமரம்	mɑːmʌɾ̪ʌm
உதவு	ʔɯd̪ʌʋɯ
தர்ஜமா	t̪ʌɾ̪d͡ʑʌmɑː
உள்ளங்கை	ʔɯɭːʌŋɡʌɪ̯
ஆண்	ʔɑːɳ
கின்னம்	kɨnːʌm
பிசம்	pɨsʌm
தொண்டு	t̪oɳɖɯ
ஐரோப்பா	ʔʌɪ̯ɾ̪oːpːɑː
குறித்து	kɯrɨt̪ːɯ
அகழி	ʔʌɡʌɻi
பெயர்த்துரை	pejʌɾ̪t̪ːɯɾ̪ʌɪ̯
நரம்பு	n̪ʌɾ̪ʌmbɯ
எடு	ʔeɖɯ
தெரிவி	t̪eɾ̪ɨʋi
அஹம்	ʔʌhʌm
வேர்வை	ʋeːɾ̪ʋʌɪ̯
சலகம்	sʌl̪ʌɡʌm
எங்கும்	ʔeŋɡɯm
நீளம்	n̪iːɭʌm
சகதி	sʌɡʌd̪i
உயிரிழப்பு	ʔɯjɨɾ̪ɨɻʌpːɯ
போலிஷ்	poːl̪ɨʂ
செங்கல்	seŋɡʌl̪
முழை	mɯɻʌɪ̯
மூலக்கூறு	muːl̪ʌkːuːrɯ
நினை	n̪ɨnʌɪ̯
வாக்கியம்	ʋɑːkːɨjʌm
வழலிக்கை	ʋʌɻʌl̪ɨkːʌɪ̯
அங்கு	ʔʌŋɡɯ
ஊற்று	ʔuːʈːɾɯ
பரோட்டா	pʌɾ̪oːʈːɑː
நரம்பியல்	n̪ʌɾ̪ʌmbɨjʌl̪
உகளம்	ʔɯɡʌɭʌm
காட்டெருமை	kɑːʈːeɾ̪ɯmʌɪ̯
சிதடு	sɨd̪ʌɖɯ
கழித்தல்	kʌɻɨt̪ːʌl̪
குருடன்	kɯɾ̪ɯɖʌn
வார்	ʋɑːɾ̪
மூங்கில்	muːŋɡɨl̪
ஆலயம்	ʔɑːl̪ʌjʌm
வடைப்பருப்பு	ʋʌɖʌɪ̯pːʌɾ̪ɯpːɯ
கூடு	kuːɖɯ
கடம்பு	kaɖəmbʉ
திராவிட	t̪ɨɾ̪ɑːʋɨɖa
குதிரை	kɯd̪ɨɾ̪ʌɪ̯
கிளிமெண்டி	kɨɭɨmeɳɖi
கட்கம்	kʌʈkʌm
மண்வளம்	mʌɳʋʌɭʌm
சைகதம்	sʌɪ̯kʌd̪ʌm
கல்வெட்டு	kʌl̪ʋeʈːɯ
சிசு	sɨsɯ
மிகை	mɨɡʌɪ̯
காபூல்	kɑːbuːl̪
ஊர்வலம்	ʔuːɾ̪ʋʌl̪ʌm
இழப்பீடு	ʔɨɻʌpːiːɖɯ
கிருட்டிணன்	kɨɾ̪ɯʈːɨɳʌn
பித்தப்பை	pɨt̪ːʌpːʌɪ̯
வெட்டுக்கிளி	ʋeʈːɯkːɨɭi
இஞ்சி	ʔɨɲd͡ʑi
வேண்டியமட்டும்	ʋeːɳɖɨjʌmʌʈːɯm
கொட்டகை	koʈːʌɡʌɪ̯
தடி	t̪ʌɖi
மலச்சிக்கல்	mʌl̪ʌsːɨkːʌl̪
அகப்பு	ʔʌɡʌpːɯ
விதைப்பை	ʋɨd̪ʌɪ̯pːʌɪ̯
பிருதிவி	pɨɾ̪ɯd̪ɨʋi
அங்குலி	ʔʌŋɡɯl̪i
தாயகம்	t̪ɑːjʌɡʌm
பொம்மை	pomːʌɪ̯
அடை	ʔʌɖʌɪ̯
வகை	ʋʌɡʌɪ̯
ரோதம்	ɾ̪oːd̪ʌm
சத்தியம்	sʌt̪ːɨjʌm
மணிக்கட்டு	mʌɳɨkːʌʈːɯ
வல்லிதின்	ʋʌl̪ːɨd̪ɨn
மிதழ்	mɨd̪ʌɻ
பிசகுசொல்லுதல்	pɨsʌɡɯsol̪ːɯd̪ʌl̪
உசுபெக்கிசுத்தான்	ʔɯsɯbekːɨsɯt̪ːɑːn
கைது	kʌɪ̯t̪ɯ
அம்மாய்	ʔʌmːɑːj
உறுகோள்	ʔɯrɯɡoːɭ
நான்கு	n̪ɑːnkɯ
இராசி	ʔɨɾ̪ɑːsi
உணவு	ʔɯɳʌʋɯ
கிரேக்கம்	kɨɾ̪eːkːʌm
பேச்சாளர்	peːsːɑːɭʌɾ̪
குறி	kɯri
பிங்கதிருட்டி	pɨŋɡʌd̪ɨɾ̪ɯʈːi
திரிதடையம்	t̪ɨɾ̪ɨd̪ʌɖʌɪ̯jʌm
எழுதுகோல்	ʔeɻɯd̪ɯɡoːl̪
ஓடம்	ʔoːɖʌm
ஆதி	ʔɑːd̪i
கந்தகம்	kʌn̪d̪ʌɡʌm
குமார்	kɯmɑːɾ̪
பேரருவி	peːɾ̪ʌɾ̪ɯʋi
செவ்வள்ளி	seʋːʌɭːi
கற்கம்	kʌrkʌm
காலணி	kɑːl̪ʌɳi
கட்சி	kʌʈsi
அவ்வோ	ʔʌʋːoː
ஒழுங்கை	ʔoɻɯŋɡʌɪ̯
செங்கோல்	seŋɡoːl̪
ஒன்பது	ʔonpʌd̪ɯ
விண்கலம்	ʋɨɳkʌl̪ʌm
பள்ளி	pʌɭːi
சுரம்	sɯɾ̪ʌm
சொல்	sol̪
சுவையான	sɯʋʌɪ̯jɑːna
கோயம்புத்தூர்	koːjʌmbɯt̪ːuːɾ̪
தம்பி	t̪ʌmbi
இயக்குரோதம்	ʔɨjʌkːɯɾ̪oːd̪ʌm
காய்	kɑːj
மீண்டும்	miːɳɖɯm
முன்னடியில்	mɯnːʌɖɨjɨl̪
ஆர்மீனியா	ʔɑːɾ̪miːnɨjɑː
முகக்குறி	mɯɡʌkːɯri
போராட்டம்	poːɾ̪ɑːʈːʌm
உயரம்	ʔɯjʌɾ̪ʌm
மழைத்துளி	mʌɻʌɪ̯t̪ːɯɭi
இரு	ʔɨɾ̪ɯ
ஆயர்	ʔɑːjʌɾ̪
நல்	n̪ʌl̪
துண்டு	t̪ɯɳɖɯ
நிலா	n̪ɨl̪ɑː
வல்லாமை	ʋʌl̪ːɑːmʌɪ̯
அருகு	ʔʌɾ̪ɯɡɯ
ஸீமை	siːmʌɪ̯
இசை	ʔɨsʌɪ̯
நாணயம்	n̪ɑːɳʌjʌm
பட்சி	pʌʈsi
ஸாவகாம்	sɑːʋʌɡɑːm
இழுப்பறை	ʔɨɻɯpːʌrʌɪ̯
அவ்வண்ணம்	ʔʌʋːʌɳːʌm
தானியம்	t̪ɑːnɨjʌm
குஞ்சி	kɯɲd͡ʑi
அக்காள்	ʔʌkːɑːɭ
அத்தியாபகன்	ʔʌt̪ːɨjɑːbʌɡʌn
பிறவி	pɨrʌʋi
மாளிகை	mɑːɭɨɡʌɪ̯
ஜீரகம்	d͡ʑiːɾ̪ʌɡʌm
கொறுக்கை	korɯkːʌɪ̯
நாளை	n̪ɑːɭʌɪ̯
அம்பர்	ʔʌmbʌɾ̪
மேற்கு	meːkkɯ
மென்தங்கம்	ment̪ʌŋɡʌm
சிறுநீரகம்	sɨrɯn̪iːɾ̪ʌɡʌm
மூக்கண்ணாடி	muːkːʌɳːɑːɖi
தாலாட்டு	t̪ɑːl̪ɑːʈːɯ
எண்ணம்	ʔeɳːʌm
செந்தாமரை	sen̪d̪ɑːmʌɾ̪ʌɪ̯
அக்கி	ʔʌkːi
அங்கிட்டு	ʔʌŋɡɨʈːɯ
இல்	ʔɨl̪
சகோதரன்	sʌɡoːd̪ʌɾ̪ʌn
சாய்ப்பிடம்	sɑːjpːɨɖʌm
அவண்	ʔʌʋʌɳ
கொடுவாள்	koɖɯʋɑːɭ
வருஷம்	ʋʌɾ̪ɯʂʌm
பண்டிதன்	pʌɳɖɨd̪ʌn
வளம்	ʋʌɭʌm
பிசுனம்	pɨsɯnʌm
கவர்வு	kʌʋʌɾ̪ʋɯ
மாரடைப்பு	mɑːɾ̪ʌɖʌɪ̯pːɯ
புத்தகம்	pɯt̪ːʌɡʌm
குயில்	kɯjɨl̪
தன்னுணர்வு	t̪ʌnːɯɳʌɾ̪ʋɯ
தாமிரபருணி	t̪ɑːmɨɾ̪ʌbʌɾ̪ɯɳi
கூட்டல்	kuːʈːʌl̪
பிறை	pɨrʌɪ̯
பெரியவெள்ளிக்கிழமை	peɾ̪ɨjʌʋeɭːɨkːɨɻʌmʌɪ̯
நித்திலம்	n̪ɨt̪ːɨl̪ʌm
சௌக்கியமா	sʌʊ̯kːɨjʌmɑː
பகல்	pʌɡʌl̪
இனம்	ʔɨnʌm
கொழும்பு	koɻɯmbɯ
நாம்	n̪ɑːm
இலக்கிய	ʔɨl̪ʌkːɨja
பலம்	pʌl̪ʌm
உடனே	ʔɯɖʌneː
சார்வு	sɑːɾ̪ʋɯ
நன்மை	n̪ʌnmʌɪ̯
கொள்ளை	koɭːʌɪ̯
மனை	mʌnʌɪ̯
அதோள்	ʔʌd̪oːɭ
கூறு	kuːrɯ
லோகம்	l̪oːɡʌm
இராகம்	ʔɨɾ̪ɑːɡʌm
பாரிசவாதம்	pɑːɾ̪ɨsʌʋɑːd̪ʌm
மஞ்சள்	mʌɲd͡ʑʌɭ
கிறி	kɨri
திருகாணி	t̪ɨɾ̪ɯɡɑːɳi
கபிலம்	kʌbɨl̪ʌm
உண்டாக	ʔɯɳɖɑːɡa
ஆகையால்	ʔɑːɡʌɪ̯jɑːl̪
தேசாதிபதி	t̪eːsɑːd̪ɨbʌd̪i
வறட்சி	ʋʌrʌʈsi
திராட்சை	t̪ɨɾ̪ɑːʈsʌɪ̯
லீக்டன்ஸ்டைன்	l̪iːkʈʌnsʈʌɪ̯n
கடைவாய்ப்பல்	kʌɖʌɪ̯ʋɑːjpːʌl̪
முடி	mɯɖi
தெள்ளு	t̪eɭːɯ
ரப்பர்	ɾ̪ʌpːʌɾ̪
யுத்தம்	jɯt̪ːʌm
காது	kɑːd̪ɯ
உம்	ʔɯm
லடாய்	l̪ʌɖɑːj
வன்மை	ʋʌnmʌɪ̯
ஓடை	ʔoːɖʌɪ̯
வெப்பநிலை	ʋepːʌn̪ɨl̪ʌɪ̯
முழுமை	mɯɻɯmʌɪ̯
திரியும்	t̪ɨɾ̪ɨjɯm
பாசம்	pɑːsʌm
கிற்பு	kɨrpɯ
நுழைவாசல்	n̪ɯɻʌɪ̯ʋɑːsʌl̪
சிதாரி	sɨd̪ɑːɾ̪i
போற்றுநர்	poːʈːɾɯn̪ʌɾ̪
முன்னர்	mɯnːʌɾ̪
தாவரவியல்	t̪ɑːʋʌɾ̪ʌʋɨjʌl̪
நிஷானி	n̪ɨʂɑːni
அமெரிக்கா	ʔʌmeɾ̪ɨkːɑː
செள்ளு	seɭːɯ
அண்ணி	ʔʌɳːi
விருட்சம்	ʋɨɾ̪ɯʈsʌm
ஜலம்	d͡ʑʌl̪ʌm
அந்த	ʔʌn̪d̪a
கத்தி	kʌt̪ːi
அங்கதம்	ʔʌŋɡʌd̪ʌm
ஊடகம்	ʔuːɖʌɡʌm
வன்பொருள்	ʋʌnpoɾ̪ɯɭ
மன்னிப்பு	mʌnːɨpːɯ
தருமன்	t̪ʌɾ̪ɯmʌn
மனிதவியல்	mʌnɨd̪ʌʋɨjʌl̪
முப்புவனம்	mɯpːɯʋʌnʌm
காதரம்	kɑːd̪ʌɾ̪ʌm
சூழலியல்	suːɻʌl̪ɨjʌl̪
தொடருந்து	t̪oɖʌɾ̪ɯn̪d̪ɯ
உருமேறு	ʔɯɾ̪ɯmeːrɯ
வௌவால்	ʋʌʊ̯ʋɑːl̪
அங்கோடிங்கோடு	ʔʌŋɡoːɖɨŋɡoːɖɯ
புகை	pɯɡʌɪ̯
பொறுப்பு	porɯpːɯ
ஓட்டல்	ʔoːʈːʌl̪
மீனவர்	miːnʌʋʌɾ̪
நாடகம்	n̪ɑːɖʌɡʌm
தெலுங்கு	t̪el̪ɯŋɡɯ
பெயர்வழி	pejʌɾ̪ʋʌɻi
தொன்று	t̪onrɯ
மாடு	mɑːɖɯ
ஊது	ʔuːd̪ɯ
செம்	sem
வினைமுற்று	ʋɨnʌɪ̯mɯʈːɾɯ
இடியாப்பம்	ʔɨɖɨjɑːpːʌm
கபோதகம்	kʌboːd̪ʌɡʌm
மாப்பு	mɑːpːɯ
உ	ʔɯ
ஆக்கம்	ʔɑːkːʌm
மஞ்சன்	mʌɲd͡ʑʌn
நாடோடி	n̪ɑːɖoːɖi
நேர்மை	n̪eːɾ̪mʌɪ̯
அங்கே	ʔʌŋɡeː
கீழ்மை	kiːɻmʌɪ̯
ஆசினி	ʔɑːsɨni
பிசாசக்கை	pɨsɑːsʌkːʌɪ̯
பள்ளிக்கல்வி	pʌɭːɨkːʌl̪ʋi
வாயின்மாடம்	ʋɑːjɨnmɑːɖʌm
பேசு	peːsɯ
புதன்	pɯd̪ʌn
பணி	pʌɳi
வறுமை	ʋʌrɯmʌɪ̯
அலை	ʔʌl̪ʌɪ̯
புஷபராகம்	pɯʂʌbʌɾ̪ɑːɡʌm
உலோகம்	ʔɯl̪oːɡʌm
பாலுறவு	pɑːl̪ɯrʌʋɯ
தெற்கு	t̪erkɯ
முள்ளங்கி	mɯɭːʌŋɡi
நேற்று	n̪eːʈːɾɯ
உடுக்கை	ʔɯɖɯkːʌɪ̯
சேர்	seːɾ̪
சுட்டுவிரல்	sɯʈːɯʋɨɾ̪ʌl̪
ஆடுமாடு	ʔɑːɖɯmɑːɖɯ
நுரையீரல்	n̪ɯɾ̪ʌɪ̯jiːɾ̪ʌl̪
ஏதடை	ʔeːd̪ʌɖʌɪ̯
திரவிடம்	t̪ɨɾ̪ʌʋɨɖʌm
கூட்டம்	kuːʈːʌm
வேலைநேரம்	ʋeːl̪ʌɪ̯n̪eːɾ̪ʌm
பதிவகம்	pʌd̪ɨʋʌɡʌm
எழுச்சி	ʔeɻɯsːi
தப்பு	t̪ʌpːɯ
சாறு	sɑːrɯ
கிளர்த்து	kɨɭʌɾ̪t̪ːɯ
வேறுபாடு	ʋeːrɯbɑːɖɯ
விலங்கி	ʋɨl̪ʌŋɡi
மிதியடி	mɨd̪ɨjʌɖi
உறப்பு	ʔɯrʌpːɯ
உவர்மம்	ʔɯʋʌɾ̪mʌm
திருமண்	t̪ɨɾ̪ɯmʌɳ
வன்பால்	ʋʌnpɑːl̪
காப்பியம்	kɑːpːɨjʌm
வழிப்பயணம்	ʋʌɻɨpːʌjʌɳʌm
பசலிப்பழம்	pʌsʌl̪ɨpːʌɻʌm
பறவையியல்	pʌrʌʋʌɪ̯jɨjʌl̪
கோட்பாடு	koːʈpɑːɖɯ
கஸாயி	kʌsɑːji
சப்பாத்தி	sʌpːɑːt̪ːi
மஹால்	mʌhɑːl̪
அருக்கன்	ʔʌɾ̪ɯkːʌn
அலுவல்	ʔʌl̪ɯʋʌl̪
வெப்புள்	ʋepːɯɭ
தொன்னை	t̪onːʌɪ̯
வேண்டியவன்	ʋeːɳɖɨjʌʋʌn
பச்சை	pʌsːʌɪ̯
அக்கினிகுண்டம்	ʔʌkːɨnɨɡɯɳɖʌm
வியாபாரம்	ʋɨjɑːbɑːɾ̪ʌm
தங்கம்	t̪ʌŋɡʌm
அகவன்மகள்	ʔʌɡʌʋʌnmʌɡʌɭ
அங்கம்	ʔʌŋɡʌm
யமன்	jʌmʌn
அக்குள்	ʔʌkːɯɭ
விடை	ʋɨɖʌɪ̯
உண்	ʔɯɳ
ஜனாபா	d͡ʑʌnɑːbɑː
ஆவல்	ʔɑːʋʌl̪
இணை	ʔɨɳʌɪ̯
தகடி	t̪ʌɡʌɖi
கயவாய்	kʌjʌʋɑːj
வில்	ʋɨl̪
கட்டிமை	kʌʈːɨmʌɪ̯
பொருள்	poɾ̪ɯɭ
காகிதம்	kɑːɡɨd̪ʌm
விரிகோணம்	ʋɨɾ̪ɨɡoːɳʌm
வெங்காயம்	ʋeŋɡɑːjʌm
காரணம்	kɑːɾ̪ʌɳʌm
இடு	ʔɨɖɯ
மும்பை	mɯmbʌɪ̯
தோலியல்	t̪oːl̪ɨjʌl̪
தலை	t̪ʌl̪ʌɪ̯
சொல்லெச்சம்	sol̪ːesːʌm
அகத்துக்காரி	ʔʌɡʌt̪ːɯkːɑːɾ̪i
ஊர்க்கதை	ʔuːɾ̪kːʌd̪ʌɪ̯
முட்டு	mɯʈːɯ
கறுவா	kʌrɯʋɑː
கட்டளை	kʌʈːʌɭʌɪ̯
பனி	pʌni
பணிமுட்டு	pʌɳɨmɯʈːɯ
மணி	mʌɳi
நரகம்	n̪ʌɾ̪ʌɡʌm
விரல்	ʋɨɾ̪ʌl̪
பெண்டாட்டி	peɳɖɑːʈːi
வம்சம்	ʋʌmsʌm
இழுக்கம்	ʔɨɻɯkːʌm
பதுமம்	pʌd̪ɯmʌm
வேகம்	ʋeːɡʌm
பகர்ச்சி	pʌɡʌɾ̪sːi
பனிமூட்டம்	pʌnɨmuːʈːʌm
இல்லகம்	ʔɨl̪ːʌɡʌm
கஞ்சாவை	kʌɲd͡ʑɑːʋʌɪ̯
சுனை	sɯnʌɪ̯
மிளகாய்	mɨɭʌɡɑːj
தளர்வு	t̪ʌɭʌɾ̪ʋɯ
வீடு	ʋiːɖɯ
வருடம்	ʋʌɾ̪ɯɖʌm
பொருளட்டவணை	poɾ̪ɯɭʌʈːʌʋʌɳʌɪ̯
பணிகோள்	pʌɳɨɡoːɭ
முடியாட்சி	mɯɖɨjɑːʈsi
ஆடம்பரம்	ʔɑːɖʌmbʌɾ̪ʌm
இரசாயனம்	ʔɨɾ̪ʌsɑːjʌnʌm
இள	ʔɨɭa
வனம்	ʋʌnʌm
சுருட்டு	sɯɾ̪ɯʈːɯ
பெண்சனம்	peɳsʌnʌm
விரயம்	ʋɨɾ̪ʌjʌm
காறையெலும்பு	kɑːrʌɪ̯jel̪ɯmbɯ
சின்டி	sɨnʈi
அளி	ʔʌɭi
சட்டை	sʌʈːʌɪ̯
பழுவம்	pʌɻɯʋʌm
மாற்றுமருந்து	mɑːʈːɾɯmʌɾ̪ɯn̪d̪ɯ
பசுமை	pʌsɯmʌɪ̯
பயப்படு	pʌjʌpːʌɖɯ
உண்டுபடு	ʔɯɳɖɯbʌɖɯ
தொடர்பு	t̪oɖʌɾ̪pɯ
சொற்றொடர்	soʈːɾoɖʌɾ̪
பிரசங்கம்	pɨɾ̪ʌsʌŋɡʌm
சிஷ்யன்	sɨʂjʌn
கல்விநிலையம்	kʌl̪ʋɨn̪ɨl̪ʌɪ̯jʌm
அட்டை	ʔʌʈːʌɪ̯
கூத்தாட	kuːt̪ːɑːɖa
பணப்பை	pʌɳʌpːʌɪ̯
குழி	kɯɻi
தேற்கு	t̪eːkkɯ
சேதி	seːd̪i
கலகம்	kʌl̪ʌɡʌm
விசனம்	ʋɨsʌnʌm
தாளம்	t̪ɑːɭʌm
இசுலாம்	ʔɨsɯl̪ɑːm
இலக்கு	ʔɨl̪ʌkːɯ
வாந்தி	ʋɑːn̪d̪i
இட்லி	ʔɨʈl̪i
குவியம்	kɯʋɨjʌm
இயைபு	ʔɨjʌɪ̯pɯ
மரவள்ளி	mʌɾ̪ʌʋʌɭːi
வரத்து	ʋʌɾ̪ʌt̪ːɯ
விழைவு	ʋɨɻʌɪ̯ʋɯ
தேவை	t̪eːʋʌɪ̯
முழங்கால்	mɯɻʌŋɡɑːl̪
அகங்கை	ʔʌɡʌŋɡʌɪ̯
கரு	kʌɾ̪ɯ
மிகுந்த	mɨɡɯn̪d̪a
செல்வநூல்	sel̪ʋʌn̪uːl̪
கிணறு	kɨɳʌrɯ
நேர்பாடு	n̪eːɾ̪pɑːɖɯ
கருப்பு	kʌɾ̪ɯpːɯ
மகிமை	mʌɡɨmʌɪ̯
கலவி	kʌl̪ʌʋi
நிரந்தர	n̪ɨɾ̪ʌn̪d̪ʌɾ̪a
வியாபாரி	ʋɨjɑːbɑːɾ̪i
தொழிலாளி	t̪oɻɨl̪ɑːɭi
லாடம்	l̪ɑːɖʌm
சுந்தரம்	sɯn̪d̪ʌɾ̪ʌm
வேற்றுமை	ʋeːʈːɾɯmʌɪ̯
கானலி	kɑːnʌl̪i
பிங்கலை	pɨŋɡʌl̪ʌɪ̯
ஓய்வூதியம்	ʔoːjʋuːd̪ɨjʌm
கொல்லறு	kol̪ːʌrɯ
குளிர்ச்சி	kɯɭɨɾ̪sːi
விண்ணுளவி	ʋɨɳːɯɭʌʋi
அவ்விடம்	ʔʌʋːɨɖʌm
வெம்பகல்	ʋembʌɡʌl̪
மாட்டிடையன்	mɑːʈːɨɖʌɪ̯jʌn
மரக்கலம்	mʌɾ̪ʌkːʌl̪ʌm
பாதுகாப்பு	pɑːd̪ɯɡɑːpːɯ
முழுவதும்	mɯɻɯʋʌd̪ɯm
துரியான்	t̪ɯɾ̪ɨjɑːn
செவ்விரும்பு	seʋːɨɾ̪ɯmbɯ
நபம்	n̪ʌbʌm
வாழை	ʋɑːɻʌɪ̯
ஆளுவல்லி	ʔɑːɭɯʋʌl̪ːi
கமலம்	kʌmʌl̪ʌm
பெருக்கல்வாய்பாடு	peɾ̪ɯkːʌl̪ʋɑːjpɑːɖɯ
காற்றழுத்தம்	kɑːʈːɾʌɻɯt̪ːʌm
அடிக்கொருக்கால்	ʔʌɖɨkːoɾ̪ɯkːɑːl̪
அடிநிலை	ʔʌɖɨn̪ɨl̪ʌɪ̯
ஆபரணம்	ʔɑːbʌɾ̪ʌɳʌm
முன்னடியார்	mɯnːʌɖɨjɑːɾ̪
நிலை	n̪ɨl̪ʌɪ̯
சாதிக்காய்	sɑːd̪ɨkːɑːj
முதலாளி	mɯd̪ʌl̪ɑːɭi
பாற்பசு	pɑːrpʌsɯ
போதை	poːd̪ʌɪ̯
அராவாரம்	ʔʌɾ̪ɑːʋɑːɾ̪ʌm
பணவீக்கம்	pʌɳʌʋiːkːʌm
எழுவாய்	ʔeɻɯʋɑːj
குசராத்	kɯsʌɾ̪ɑːt̪
வாக்குவாதம்	ʋɑːkːɯʋɑːd̪ʌm
சொத்து	sot̪ːɯ
இயங்குதளம்	ʔɨjʌŋɡɯd̪ʌɭʌm
ஆண்குறி	ʔɑːɳkɯri
குடிசை	kɯɖɨsʌɪ̯
வேலைமினக்கெட்டவன்	ʋeːl̪ʌɪ̯mɨnʌkːeʈːʌʋʌn
சர்பராஜ்	sʌɾ̪pʌɾ̪ɑːd͡ʑ
இகழ்ச்சி	ʔɨɡʌɻsːi
முதிர்ச்சி	mɯd̪ɨɾ̪sːi
உட்கருத்து	ʔɯʈkʌɾ̪ɯt̪ːɯ
இருப்பை	iɾʉpːaɪ
அலைப்பு	ʔʌl̪ʌɪ̯pːɯ
பிசங்கற்சீலை	pɨsʌŋɡʌrsiːl̪ʌɪ̯
சிற்றூர்	sɨʈːɾuːɾ̪
மயடம்	mʌjʌɖʌm
வானம்பாடி	ʋɑːnʌmbɑːɖi
புணர்ச்சி	pɯɳʌɾ̪sːi
அறிவி	ʔʌrɨʋi
மந்தை	mʌn̪d̪ʌɪ̯
எறும்பு	ʔerɯmbɯ
கஞ்சா	kʌɲd͡ʑɑː
ஊர்வன	ʔuːɾ̪ʋʌna
கங்கு	kʌŋɡɯ
நிறமாலையியல்	n̪ɨrʌmɑːl̪ʌɪ̯jɨjʌl̪
சுவடி	sɯʋʌɖi
அளவு	ʔʌɭʌʋɯ
பெயரெச்சம்	pejʌɾ̪esːʌm
சேறு	seːrɯ
பிசிர்தல்	pɨsɨɾ̪t̪ʌl̪
காதை	kɑːd̪ʌɪ̯
ஜீதம்	d͡ʑiːd̪ʌm
கணினியியல்	kʌɳɨnɨjɨjʌl̪
வெற்றிலை	ʋeʈːɾɨl̪ʌɪ̯
கணம்	kʌɳʌm
முன்னே	mɯnːeː
நீந்து	n̪iːn̪d̪ɯ
விரைவில்	ʋɨɾ̪ʌɪ̯ʋɨl̪
நிர்வாகம்	n̪ɨɾ̪ʋɑːɡʌm
மண்	mʌɳ
புத்தாண்டு	pɯt̪ːɑːɳɖɯ
வாயன்	ʋɑːjʌn
பிசான்	pɨsɑːn
சினைப்பை	sɨnʌɪ̯pːʌɪ̯
பிச்சு	pɨsːɯ
பாலாறு	pɑːl̪ɑːrɯ
அன்று	ʔʌnrɯ
இறக்கை	ʔɨrʌkːʌɪ̯
எஃகு	ʔeɡɯ
ரத்தினம்	ɾ̪ʌt̪ːɨnʌm
கிளவி	kɨɭʌʋi
கணிதம்	kʌɳɨd̪ʌm
லகரி	l̪ʌɡʌɾ̪i
கிளை	kɨɭʌɪ̯
நிலையம்	n̪ɨl̪ʌɪ̯jʌm
கொம்பு	kombɯ
அக்கினி	ʔʌkːɨni
கலயம்	kʌl̪ʌjʌm
படைப்பு	pʌɖʌɪ̯pːɯ
எத்தனை	ʔet̪ːʌnʌɪ̯
மன்றம்	mʌnrʌm
ஒரு	ʔoɾ̪ɯ
பறந்தலை	pʌrʌn̪d̪ʌl̪ʌɪ̯
அசாம்	ʔʌsɑːm
இலை	ʔɨl̪ʌɪ̯
நடை	n̪ʌɖʌɪ̯
தோட்டம்	t̪oːʈːʌm
ஒப்புமை	ʔopːɯmʌɪ̯
மூக்குத்தி	muːkːɯt̪ːi
அண்ணன்	ʔʌɳːʌn
கயிரவம்	kʌjɨɾ̪ʌʋʌm
கரியமிலவாயு	kʌɾ̪ɨjʌmɨl̪ʌʋɑːjɯ
ஏதின்மை	ʔeːd̪ɨnmʌɪ̯
மாடம்	mɑːɖʌm
முன்னாடி	mɯnːɑːɖi
அப்புறம்	ʔʌpːɯrʌm
குகை	kɯɡʌɪ̯
பிறப்பு	pɨrʌpːɯ
பானை	pɑːnʌɪ̯
சிறுவன்	sɨrɯʋʌn
தோசம்	t̪oːsʌm
குன்றின்	kɯnrɨn
அச்சுவினி	ʔʌsːɯʋɨni
சற்பிரசாதம்	sʌrpɨɾ̪ʌsɑːd̪ʌm
அளேரியம்	ʔʌɭeːɾ̪ɨjʌm
வைணவி	ʋʌɪ̯ɳʌʋi
அழகு	ʔʌɻʌɡɯ
ககனம்	kʌɡʌnʌm
அறிவிப்பு	ʔʌrɨʋɨpːɯ
மொட்டு	moʈːɯ
பித்தம்	pɨt̪ːʌm
கட்டல்	kʌʈːʌl̪
கபடம்	kʌbʌɖʌm
உயிரணு	ʔɯjɨɾ̪ʌɳɯ
அடக்கு	ʔʌɖʌkːɯ
விளக்கம்	ʋɨɭʌkːʌm
பய்யன்	pʌjːʌn
எழுது	ʔeɻɯd̪ɯ
மிகவும்	mɨɡʌʋɯm
லதி	l̪ʌd̪i
இயக்கு	ʔɨjʌkːɯ
பர்ணம்	pʌɾ̪ɳʌm
பரிதி	pʌɾ̪ɨd̪i
புரவு	pɯɾ̪ʌʋɯ
நெருப்பு	n̪eɾ̪ɯpːɯ
இராஜாளி	ʔɨɾ̪ɑːd͡ʑɑːɭi
பார்வை	pɑːɾ̪ʋʌɪ̯
மகிழ்	mʌɡɨɻ
கூவிளம்	kuːʋɨɭəm
மம்மர்	mʌmːʌɾ̪
முதலுதவி	mɯd̪ʌl̪ɯd̪ʌʋi
அன்பு	ʔʌnpɯ
அகம்	ʔʌɡʌm
சுற்று	sɯʈːɾɯ
லக்ஷம்	l̪ʌkʂʌm
நின்று	n̪ɨnrɯ
பாகற்காய்	pɑːɡʌrkɑːj
பரணி	pʌɾ̪ʌɳi
இசைக்கருவி	ʔɨsʌɪ̯kːʌɾ̪ɯʋi
மாதிரு	mɑːd̪ɨɾ̪ɯ
பிசாசுபிடித்தல்	pɨsɑːsɯbɨɖɨt̪ːʌl̪
ஓநாய்	ʔoːn̪ɑːj
பெளதிகம்	peɭʌd̪ɨɡʌm
வல்	ʋʌl̪
மந்தைவெளி	mʌn̪d̪ʌɪ̯ʋeɭi
கவல்	kʌʋʌl̪
மேய்ப்பன்	meːjpːʌn
அவுஸ்திரேலியா	ʔʌʋɯst̪ɨɾ̪eːl̪ɨjɑː
அறி	ʔʌri
தாய்லாந்து	t̪ɑːjl̪ɑːn̪d̪ɯ
எட்டு	ʔeʈːɯ
உயர்ச்சி	ʔɯjʌɾ̪sːi
செய்தித்தாள்	sejt̪ɨt̪ːɑːɭ
புதிய	pɯd̪ɨja
கயம்	kʌjʌm
உண்ணி	ʔɯɳːi
கிளி	kɨɭi
கன்னடம்	kʌnːʌɖʌm
இளைப்பாற்று	ʔɨɭʌɪ̯pːɑːʈːɾɯ
முச்சம்	mɯsːʌm
நீரகம்	n̪iːɾ̪ʌɡʌm
மந்துரை	mʌn̪d̪ɯɾ̪ʌɪ̯
வளையல்	ʋʌɭʌɪ̯jʌl̪
கோட்டை	koːʈːʌɪ̯
பசியம்	pʌsɨjʌm
செங்கல்மால்	seŋɡʌl̪mɑːl̪
ரவை	ɾ̪ʌʋʌɪ̯
ஸாராம்ம்	sɑːɾ̪ɑːmː
போறை	poːrʌɪ̯
சயிக்கம்	sʌjɨkːʌm
வியர்	ʋɨjʌɾ̪
வல்லை	ʋʌl̪ːʌɪ̯
இடுப்பு	ʔɨɖɯpːɯ
பெயர்ப்பு	pejʌɾ̪pːɯ
தரியாபத்து	t̪ʌɾ̪ɨjɑːbʌt̪ːɯ
சாலை	sɑːl̪ʌɪ̯
உருப்பு	ʔɯɾ̪ɯpːɯ
மோடு	moːɖɯ
அக்கை	ʔʌkːʌɪ̯
தலைவர்	t̪ʌl̪ʌɪ̯ʋʌɾ̪
கூறை	kuːrʌɪ̯
அறுதி	ʔʌrɯd̪i
கற்பூரம்	kʌrpuːɾ̪ʌm
தேக்கு	t̪eːkːɯ
சுண்டெலி	sɯɳɖel̪i
மென்மை	menmʌɪ̯
வழிநடை	ʋʌɻɨn̪ʌɖʌɪ̯
தளப்பு	t̪ʌɭʌpːɯ
பின்மொழிநிலையல்	pɨnmoɻɨn̪ɨl̪ʌɪ̯jʌl̪
கோமான்	koːmɑːn
முறுக்கு	mɯrɯkːɯ
உரும்	ʔɯɾ̪ɯm
தேர்தல்	t̪eːɾ̪t̪ʌl̪
மலேசியா	mʌl̪eːsɨjɑː
வெளிச்சம்	ʋeɭɨsːʌm
ஏனம்	ʔeːnʌm
கோலம்	koːl̪ʌm
பயனர்	pʌjʌnʌɾ̪
காரம்	kɑːɾ̪ʌm
கிழமை	kɨɻʌmʌɪ̯
குமாரத்தி	kɯmɑːɾ̪ʌt̪ːi
பங்கம்	pʌŋɡʌm
வன்தங்கம்	ʋʌnt̪ʌŋɡʌm
இங்கண்	ʔɨŋɡʌɳ
வழிஞ்சி	ʋʌɻɨɲd͡ʑi
வானவில்	ʋɑːnʌʋɨl̪
ஸாஹசர்யம்	sɑːhʌsʌɾ̪jʌm
மலர்க்கடை	mʌl̪ʌɾ̪kːʌɖʌɪ̯
கூகை	kuːɡʌɪ̯
விதவை	ʋɨd̪ʌʋʌɪ̯
ஸாரட்டு	sɑːɾ̪ʌʈːɯ
வருகமஞ்சள்	ʋʌɾ̪ɯɡʌmʌɲd͡ʑʌɭ
சினம்	sɨnʌm
இறகு	ʔɨrʌɡɯ
அலகு	ʔʌl̪ʌɡɯ
பம்பரம்	pʌmbʌɾ̪ʌm
கருணை	kʌɾ̪ɯɳʌɪ̯
ஔடதம்	ʔʌʊ̯ʈʌd̪ʌm
அடித்தட்டு	ʔʌɖɨt̪ːʌʈːɯ
இன்னும்	ʔɨnːɯm
மனநலம்	mʌnʌn̪ʌl̪ʌm
கரடி	kʌɾ̪ʌɖi
பாசுரம்	pɑːsɯɾ̪ʌm
காலை	kɑːl̪ʌɪ̯
காரீயக்கல்	kɑːɾ̪iːjʌkːʌl̪
வல்லுளி	ʋʌl̪ːɯɭi
சிலந்தி	sɨl̪ʌn̪d̪i
சோலை	soːl̪ʌɪ̯
நக்கு	n̪ʌkːɯ
கடல்	kʌɖʌl̪
பழமை	pʌɻʌmʌɪ̯
வெந்தயம்	ʋen̪d̪ʌjʌm
மாப்பிசின்	mɑːpːɨsɨn
சோளம்	soːɭʌm
வாயில்	ʋɑːjɨl̪
தமிழ்நாடு	t̪ʌmɨɻn̪ɑːɖɯ
சேய்மை	seːjmʌɪ̯
திருவனந்தபுரம்	t̪ɨɾ̪ɯʋʌnʌn̪d̪ʌbɯɾ̪ʌm
கட்டு	kʌʈːɯ
பார்வையாளர்	pɑːɾ̪ʋʌɪ̯jɑːɭʌɾ̪
பாடகர்	pɑːɖʌɡʌɾ̪
தினம்	t̪ɨnʌm
எசுத்தோனியா	ʔesɯt̪ːoːnɨjɑː
ஆண்டவன்	ʔɑːɳɖʌʋʌn
பெண்கரு	peɳkʌɾ̪ɯ
நாளும்	n̪ɑːɭɯm
போதைமருந்து	poːd̪ʌɪ̯mʌɾ̪ɯn̪d̪ɯ
சுதந்தரம்	sɯd̪ʌn̪d̪ʌɾ̪ʌm
வரவேற்கிறேன்	ʋʌɾ̪ʌʋeːrkɨreːn
தொழுவு	t̪oɻɯʋɯ
களை	kʌɭʌɪ̯
தூவல்	t̪uːʋʌl̪
சமம்	sʌmʌm
நா	n̪ɑː
பழுது	pʌɻɯd̪ɯ
அர்ஜுனன்	ʔʌɾ̪d͡ʑɯnʌn
காண்டாமிருகம்	kɑːɳɖɑːmɨɾ̪ɯɡʌm
புத்தன்	pɯt̪ːʌn
வளப்பம்	ʋʌɭʌpːʌm
ஏவாள்	ʔeːʋɑːɭ
வானம்	ʋɑːnʌm
நீக்கல்	n̪iːkːʌl̪
இன்கண்	ʔɨnkʌɳ
சிற்பம்	sɨrpʌm
துவக்கூசி	t̪ɯʋʌkːuːsi
லட்சம்	l̪ʌʈsʌm
கருமுட்டை	kʌɾ̪ɯmɯʈːʌɪ̯
நடுவடிக்கை	n̪ʌɖɯʋʌɖɨkːʌɪ̯
விளைவு	ʋɨɭʌɪ̯ʋɯ
அரசாங்கம்	ʔʌɾ̪ʌsɑːŋɡʌm
குடி	kɯɖi
சிறுமை	sɨrɯmʌɪ̯
அவசியம்	ʔʌʋʌsɨjʌm
அறுப்பு	ʔʌrɯpːɯ
லத்தாடு	l̪ʌt̪ːɑːɖɯ
இசைப்பாட்டு	ʔɨsʌɪ̯pːɑːʈːɯ
யானை	jɑːnʌɪ̯
இடப்பு	ʔɨɖʌpːɯ
மூச்சு	muːsːɯ
பிறப்புவழி	pɨrʌpːɯʋʌɻi
வவ்வு	ʋʌʋːɯ
தொழும்பு	t̪oɻɯmbɯ
நெகிழ்ச்சி	n̪eɡɨɻsːi
மாணாக்கி	mɑːɳɑːkːi
சனி	sʌni
துளசி	t̪ɯɭʌsi
வில்வம்	ʋilʋəm
செய்தல்	sejt̪ʌl̪
மேற்பார்வை	meːrpɑːɾ̪ʋʌɪ̯
அலுவீகம்	alʉʋɨːɣəm
உறுப்பிசைக்குறி	ʔɯrɯpːɨsʌɪ̯kːɯri
எற்பாடு	ʔerpɑːɖɯ
வக்கிரகட்கம்	ʋʌkːɨɾ̪ʌɡʌʈkʌm
கிழவன்	kɨɻʌʋʌn
அடிப்பகுதி	ʔʌɖɨpːʌɡɯd̪i
களம்	kʌɭʌm
ஐம்பது	ʔʌɪ̯mbʌd̪ɯ
கருவிளா	kaɾʉʋɨɭaː
அழு	ʔʌɻɯ
மின்சாரம்	mɨnsɑːɾ̪ʌm
உப்புமா	ʔɯpːɯmɑː
உணர்ப்பு	ʔɯɳʌɾ̪pːɯ
மாண்பு	mɑːɳpɯ
வேதவியல்	ʋeːd̪ʌʋɨjʌl̪
உண்டா	ʔɯɳɖɑː
காண்டீவம்	kɑːɳɖiːʋʌm
உயிர்வேதியியல்	ʔɯjɨɾ̪ʋeːd̪ɨjɨjʌl̪
மெய்ப்பாட்டிசைக்குறி	mejpːɑːʈːɨsʌɪ̯kːɯri
காண்டம்	kɑːɳɖʌm
அடைக்காய்	ʔʌɖʌɪ̯kːɑːj
அன்பளிப்பு	ʔʌnpʌɭɨpːɯ
போக்குவரத்து	poːkːɯʋʌɾ̪ʌt̪ːɯ
எருது	ʔeɾ̪ɯd̪ɯ
பழம்	pʌɻʌm
நகை	n̪ʌɡʌɪ̯
தயிர்	t̪ʌjɨɾ̪
தூரம்	t̪uːɾ̪ʌm
பிசக்குதல்	pɨsʌkːɯd̪ʌl̪
தொழினுட்பம்	t̪oɻɨnɯʈpʌm
நன்றாக	n̪ʌnrɑːɡa
ஆண்பால்	ʔɑːɳpɑːl̪
புரிவு	pɯɾ̪ɨʋɯ
பராமரிப்பு	pʌɾ̪ɑːmʌɾ̪ɨpːɯ
ஸ்தலம்	st̪ʌl̪ʌm
மயக்கடி	mʌjʌkːʌɖi
திநாரம்	t̪ɨn̪ɑːɾ̪ʌm
எண்ணிக்கை	ʔeɳːɨkːʌɪ̯
அனை	ʔʌnʌɪ̯
கார்த்தூம்	kɑːɾ̪t̪ːuːm
அவ்வது	ʔʌʋːʌd̪ɯ
வங்கிக்கணக்கு	ʋʌŋɡɨkːʌɳʌkːɯ
இபங்கம்	ʔɨbʌŋɡʌm
மாதனம்	mɑːd̪ʌnʌm
சிற்றுண்டி	sɨʈːɾɯɳɖi
பரிமாற்றம்	pʌɾ̪ɨmɑːʈːɾʌm
இயல்	ʔɨjʌl̪
மாட்டுக்கிடை	mɑːʈːɯkːɨɖʌɪ̯
காத்திரம்	kɑːt̪ːɨɾ̪ʌm
குலிகம்	kɯl̪ɨɡʌm
திங்கள்	t̪ɨŋɡʌɭ
சொற்பிறப்பியல்	sorpɨrʌpːɨjʌl̪
புழு	pɯɻɯ
கல்யாணம்	kʌl̪jɑːɳʌm
அறிஞர்	ʔʌrɨɲʌɾ̪
இழுதை	ʔɨɻɯd̪ʌɪ̯
பிசின்	pɨsɨn
சிறுகதை	sɨrɯɡʌd̪ʌɪ̯
சரி	sʌɾ̪i
இயம்	ʔɨjʌm
பிரபந்தம்	pɨɾ̪ʌbʌn̪d̪ʌm
சிவளிகைக்கச்சு	sɨʋʌɭɨɡʌɪ̯kːʌsːɯ
ஒப்பு	ʔopːɯ
மலையாளம்	mʌl̪ʌɪ̯jɑːɭʌm
உவமை	ʔɯʋʌmʌɪ̯
மிகுதியும்	mɨɡɯd̪ɨjɯm
வரன்முறை	ʋʌɾ̪ʌnmɯrʌɪ̯
ரோகம்	ɾ̪oːɡʌm
சர்க்கரை	sʌɾ̪kːʌɾ̪ʌɪ̯
சேர்ந்தலை	seːɾ̪n̪d̪ʌl̪ʌɪ̯
பரிதியம்	pʌɾ̪ɨd̪ɨjʌm
இனப்படுகொலை	ʔɨnʌpːʌɖɯɡol̪ʌɪ̯
பிசினரக்கு	pɨsɨnʌɾ̪ʌkːɯ
வண்ணாத்திப்பூச்சி	ʋʌɳːɑːt̪ːɨpːuːsːi
தவம்	t̪ʌʋʌm
பணவன்	pʌɳʌʋʌn
உணர்வு	ʔɯɳʌɾ̪ʋɯ
விலங்கு	ʋɨl̪ʌŋɡɯ
பிறிதின்கிழமை	pɨrɨd̪ɨnkɨɻʌmʌɪ̯
ஆண்மை	ʔɑːɳmʌɪ̯
கணக்கு	kʌɳʌkːɯ
பேராலயம்	peːɾ̪ɑːl̪ʌjʌm
குலம்	kɯl̪ʌm
முன்முகனை	mɯnmɯɡʌnʌɪ̯
கத்தரி	kʌt̪ːʌɾ̪i
காதம்	kɑːd̪ʌm
ஈட்டு	ʔiːʈːɯ
ஆசை	ʔɑːsʌɪ̯
பிசண்டம்	pɨsʌɳɖʌm
ஆடு	ʔɑːɖɯ
மூது	muːd̪ɯ
இறால்	ʔɨrɑːl̪
இளைப்பு	ʔɨɭʌɪ̯pːɯ
நல்வாக்கு	n̪ʌl̪ʋɑːkːɯ
பழமொழி	pʌɻʌmoɻi
மஞ்ஞை	mʌɲːʌɪ̯
அகற்சி	ʔʌɡʌrsi
சிகப்பு	sɨɡʌpːɯ
வழக்கம்	ʋʌɻʌkːʌm
பலவு	pʌl̪ʌʋɯ
வாகனம்	ʋɑːɡʌnʌm
கிளம்பு	kɨɭʌmbɯ
வலை	ʋʌl̪ʌɪ̯
கோடர்	koːɖʌɾ̪
கிளைப்பு	kɨɭʌɪ̯pːɯ
பகர்த்து	pʌɡʌɾ̪t̪ːɯ
அறை	ʔʌrʌɪ̯
மலம்	mʌl̪ʌm
மொய்ம்பு	mojmbɯ
கபுரம்	kʌbɯɾ̪ʌm
இழுக்கு	ʔɨɻɯkːɯ
கலைஞர்	kʌl̪ʌɪ̯ɲʌɾ̪
தீனிப்பை	t̪iːnɨpːʌɪ̯
மயிர்	mʌjɨɾ̪
இது	ʔɨd̪ɯ
செப்பு	sepːɯ
கல்லீரல்	kʌl̪ːiːɾ̪ʌl̪
ரஷ்யா	ɾ̪ʌʂjɑː
வன்வெள்ளி	ʋʌnʋeɭːi
கர்த்தர்	kʌɾ̪t̪ːʌɾ̪
அவ்வழி	ʔʌʋːʌɻi
முகம்	mɯɡʌm
செய்தி	sejt̪i
கடனாளி	kʌɖʌnɑːɭi
மோதிரம்	moːd̪ɨɾ̪ʌm
சீமைச்சீரகம்	siːmʌɪ̯sːiːɾ̪ʌɡʌm
பிறவிக்குணம்	pɨrʌʋɨkːɯɳʌm
கொஞ்சம்	koɲd͡ʑʌm
தோட்டிமை	t̪oːʈːɨmʌɪ̯
கரை	kʌɾ̪ʌɪ̯
வா	ʋɑː
கணு	kʌɳɯ
சுவடு	sɯʋʌɖɯ
பழச்சாறு	pʌɻʌsːɑːrɯ
மாம்பழம்	mɑːmbʌɻʌm
அலைதாடி	ʔʌl̪ʌɪ̯t̪ɑːɖi
கபோதம்	kʌboːd̪ʌm
வேளாண்மை	ʋeːɭɑːɳmʌɪ̯
இசைவு	ʔɨsʌɪ̯ʋɯ
நாளுக்கு	n̪ɑːɭɯkːɯ
விலங்கியல்	ʋɨl̪ʌŋɡɨjʌl̪
சோம்பு	soːmbɯ
வளர்ச்சி	ʋʌɭʌɾ̪sːi
தேவாலயம்	t̪eːʋɑːl̪ʌjʌm
ஹக்காசியா	hʌkːɑːsɨjɑː
காதணி	kɑːd̪ʌɳi
பிசிதாசனர்	pɨsɨd̪ɑːsʌnʌɾ̪
கரடகம்	kʌɾ̪ʌɖʌɡʌm
வில்வித்தை	ʋɨl̪ʋɨt̪ːʌɪ̯
அறுகோணம்	ʔʌrɯɡoːɳʌm
இமம்	ʔɨmʌm
இளைப்பாறுதல்	ʔɨɭʌɪ̯pːɑːrɯd̪ʌl̪
பிற்பக்கம்	pɨrpʌkːʌm
பயணம்	pʌjʌɳʌm
சிநேகிதன்	sɨn̪eːɡɨd̪ʌn
உலர்ச்சி	ʔɯl̪ʌɾ̪sːi
தட்டு	t̪ʌʈːɯ
பீர்க்கங்காய்	piːɾ̪kːʌŋɡɑːj
வழிவகை	ʋʌɻɨʋʌɡʌɪ̯
மாதிரி	mɑːd̪ɨɾ̪i
வடிவியல்	ʋʌɖɨʋɨjʌl̪
குளிப்பு	kɯɭɨpːɯ
பிசாசாடுதல்	pɨsɑːsɑːɖɯd̪ʌl̪
தர்ச்சனி	t̪ʌɾ̪sːʌni
விடு	ʋɨɖɯ
தருமம்	t̪ʌɾ̪ɯmʌm
செருமு	seɾ̪ɯmɯ
உஃப	ʔɯfa
மதியம்	mʌd̪ɨjʌm
மாணவன்	mɑːɳʌʋʌn
அறுவடை	ʔʌrɯʋʌɖʌɪ̯
மட்டு	mʌʈːɯ
குடில்	kɯɖɨl̪
திருமணம்	t̪ɨɾ̪ɯmʌɳʌm
வரலாறு	ʋʌɾ̪ʌl̪ɑːrɯ
ஒக்கல்	ʔokːʌl̪
செபக்குடம்	sebʌkːɯɖʌm
ஆள்	ʔɑːɭ
வலிப்பு	ʋʌl̪ɨpːɯ
அகப்பை	ʔʌɡʌpːʌɪ̯
தாடி	t̪ɑːɖi
தேக்கர்	t̪eːkːʌɾ̪
மற்றும்	mʌʈːɾɯm
தனியா	t̪ʌnɨjɑː
சந்தை	sʌn̪d̪ʌɪ̯
ஆன்மீகம்	ʔɑːnmiːɡʌm
சங்கம்	sʌŋɡʌm
எப்படி	ʔepːʌɖi
ஓவியம்	ʔoːʋɨjʌm
சுறா	sɯrɑː
சொல்லாட்சி	sol̪ːɑːʈsi
சுட்டாமுட்டி	sɯʈːɑːmɯʈːi
பிசுமந்தச்சூரணம்	pɨsɯmʌn̪d̪ʌsːuːɾ̪ʌɳʌm
படிப்பு	pʌɖɨpːɯ
தேவன்	t̪eːʋʌn
லதை	l̪ʌd̪ʌɪ̯
ரொஷ்டு	ɾ̪oʂʈɯ
மதம்	mʌd̪ʌm
யூதம்	juːd̪ʌm
உறுதி	ʔɯrɯd̪i
மேற்றளம்	meːʈːɾʌɭʌm
செருப்பு	seɾ̪ɯpːɯ
இலுப்பை	ilʉpːaɪ
மூன்று	muːɳɯ
இன்பம்	ʔɨnpʌm
கண்மாய்	kʌɳmɑːj
வங்காளதேசம்	ʋʌŋɡɑːɭʌd̪eːsʌm
பிசுகுதல்	pɨsɯɡɯd̪ʌl̪
தொழில்	t̪oɻɨl̪
குறுமை	kɯrɯmʌɪ̯
சேர்க்கை	seːɾ̪kːʌɪ̯
அனுபவம்	ʔʌnɯbʌʋʌm
ரேவு	ɾ̪eːʋɯ
வைப்பு	ʋʌɪ̯pːɯ
தேற்கு	t̪eːrkɯ
கட்டிடக்கலை	kʌʈːɨɖʌkːʌl̪ʌɪ̯
பஞ்சை	pʌɲd͡ʑʌɪ̯
ஊர்காவல்	ʔuːɾ̪kɑːʋʌl̪
குயவன்	kɯjʌʋʌn
பெருச்சாளி	peɾ̪ɯsːɑːɭi
தொலைக்காட்சி	t̪ol̪ʌɪ̯kːɑːʈsi
கீரை	kiːɾ̪ʌɪ̯
பெயர்புறம்	pejʌɾ̪pɯrʌm
கடல்நீர்	kʌɖʌl̪n̪iːɾ̪
அவை	ʔʌʋʌɪ̯
பக்குவம்	pʌkːɯʋʌm
மேற்கு	meːrkɯ
குளம்	kɯɭʌm
அற்பகதம்	ʔʌrpʌɡʌd̪ʌm
என்னர்	ʔenːʌɾ̪
ஊனம்	ʔuːnʌm
பேச்சுவார்த்தை	peːsːɯʋɑːɾ̪t̪ːʌɪ̯
பதிப்பகம்	pʌd̪ɨpːʌɡʌm
கேரளா	keːɾ̪ʌɭɑː
மனிதன்	mʌnɨd̪ʌn
பார்லி	pɑːɾ̪l̪i
நான்	n̪ɑːn
வாயு	ʋɑːjɯ
இக்கு	ʔɨkːɯ
துணி	t̪ɯɳi
குருத்து	kɯɾ̪ɯt̪ːɯ
விந்து	ʋɨn̪d̪ɯ
கவற்சி	kʌʋʌrsi
போதைப்பொருள்	poːd̪ʌɪ̯pːoɾ̪ɯɭ
இருளுவா	ʔɨɾ̪ɯɭɯʋɑː
ஐந்து	ʔʌɲd͡ʑɯ
செயலிழ	sejʌl̪ɨɻa
சிந்து	sɨn̪d̪ɯ
செவி	seʋi
நிவப்பு	n̪ɨʋʌpːɯ
தீமை	t̪iːmʌɪ̯
செவ்வாய்	seʋːɑːj
சாணைக்கல்	sɑːɳʌɪ̯kːʌl̪
தாவரம்	t̪ɑːʋʌɾ̪ʌm
காசு	kɑːsɯ
ஒட்டகம்	ʔoʈːʌɡʌm
பலுக்கல்	pʌl̪ɯkːʌl̪
நெருஞ்சி	n̪eɾʉɲd͡ʒɨ
வண்டி	ʋʌɳɖi
முன்னதாக	mɯnːʌd̪ɑːɡa
ஒழுக்கம்	ʔoɻɯkːʌm
இலட்சம்	ʔɨl̪ʌʈsʌm
லிஸ்பன்	l̪ɨspʌn
விடர்	ʋɨɖʌɾ̪
கனிமம்	kʌnɨmʌm
மீக்கணினி	miːkːʌɳɨni
பாஷ்கொர்டொஸ்தான்	pɑːʂkoɾ̪ʈost̪ɑːn
மாண்டல்	mɑːɳɖʌl̪
சிறகு	sɨrʌɡɯ
திறமை	t̪ɨrʌmʌɪ̯
மேலும்	meːl̪ɯm
பட்டாணி	pʌʈːɑːɳi
கூனைப்பூ	kuːnʌɪ̯pːuː
தாஸ்மானியா	t̪ɑːsmɑːnɨjɑː
வரணம்	ʋʌɾ̪ʌɳʌm
சம்பளம்	sʌmbʌɭʌm
கோணவியல்	koːɳʌʋɨjʌl̪
இலட்சுமணன்	ʔɨl̪ʌʈsɯmʌɳʌn
பிசண்டிலன்	pɨsʌɳɖɨl̪ʌn
அழி	ʔʌɻi
கரண்டி	kʌɾ̪ʌɳɖi
கருவீரல்	kʌɾ̪ɯʋiːɾ̪ʌl̪
பிகு	pɨɡɯ
தறி	t̪ʌri
அகரம்	ʔʌɡʌɾ̪ʌm
சேவல்	seːʋʌl̪
ஒன்பது	ʷombʌd̪ɯ
ஐம்பொன்	ʔʌɪ̯mbon
அழிவாய்	ʔʌɻɨʋɑːj
கிடை	kɨɖʌɪ̯
வாழ்ச்சி	ʋɑːɻsːi
அயர்ச்சி	ʔʌjʌɾ̪sːi
புளி	pɯɭi
ரசம்	ɾ̪ʌsʌm
சுவாசம்	sɯʋɑːsʌm
நாத்திகம்	n̪ɑːt̪ːɨɡʌm
மலை	mʌl̪ʌɪ̯
உள்ளுறை	ʔɯɭːɯrʌɪ̯
ஞாயிறு	ɲɑːjɨrɯ
குணம்	kɯɳʌm
காண்டு	kɑːɳɖɯ
கருமையான	kʌɾ̪ɯmʌɪ̯jɑːna
மாந்தர்	mɑːn̪d̪ʌɾ̪
குழிவு	kɯɻɨʋɯ
மாநாடு	mɑːn̪ɑːɖɯ
மார்	mɑːɾ̪
பார்	pɑːɾ̪
முன்னொட்டு	mɯnːoʈːɯ
மயல்	mʌjʌl̪
ஏரணம்	ʔeːɾ̪ʌɳʌm
ஊடுகதிர்	ʔuːɖɯɡʌd̪ɨɾ̪
வலுமை	ʋʌl̪ɯmʌɪ̯
இராசகுமாரி	ʔɨɾ̪ɑːsʌɡɯmɑːɾ̪i
சாதம்	sɑːd̪ʌm
ஆணை	ʔɑːɳʌɪ̯
ஒப்பம்	ʔopːʌm
அத்தனை	ʔʌt̪ːʌnʌɪ̯
தினந்தோறும்	t̪ɨnʌn̪d̪oːrɯm
முதலை	mɯd̪ʌl̪ʌɪ̯
வலம்	ʋʌl̪ʌm
அழிபு	ʔʌɻɨbɯ
செவியன்	seʋɨjʌn
மேற்கூரை	meːrkuːɾ̪ʌɪ̯
பிறந்தை	pɨrʌn̪d̪ʌɪ̯
குமாரன்	kɯmɑːɾ̪ʌn
புலமை	pɯl̪ʌmʌɪ̯
திருவாத்தி	t̪iɾʉʋaːt̪ːɨ
மொழியியல்	moɻɨjɨjʌl̪
பிசாத்து	pɨsɑːt̪ːɯ
கிழவு	kɨɻʌʋɯ
மாசம்	mɑːsʌm
சருமம்	sʌɾ̪ɯmʌm
வையை	ʋʌɪ̯jʌɪ̯
பிசகுதல்	pɨsʌɡɯd̪ʌl̪
மழை	mʌɻʌɪ̯
மனிதவளம்	mʌnɨd̪ʌʋʌɭʌm
நில்	n̪ɨl̪
கோபம்	koːbʌm
பிசாசடித்தல்	pɨsɑːsʌɖɨt̪ːʌl̪
தற்சனி	t̪ʌrsʌni
கதவு	kʌd̪ʌʋɯ
அறிவாய்வியல்	ʔʌrɨʋɑːjʋɨjʌl̪
சச்சம்	sʌsːʌm
கண்ணன்	kʌɳːʌn
நிகழ்வு	n̪ɨɡʌɻʋɯ
நீலக்கல்	n̪iːl̪ʌkːʌl̪
ஆய்	ʔɑːj
பாசை	pɑːsʌɪ̯
குருதி	kɯɾ̪ɯd̪i
மதிராஸ்	mʌd̪ɨɾ̪ɑːs
பண்டிகை	pʌɳɖɨɡʌɪ̯
ஸ்வரம்	sʋʌɾ̪ʌm
கத்தரிக்காய்	kʌt̪ːʌɾ̪ɨkːɑːj
ரும்மான்	ɾ̪ɯmːɑːn
மருந்து	mʌɾ̪ɯn̪d̪ɯ
படகு	pʌɖʌɡɯ
ஶல்யம்	ɕʌl̪jʌm
முன்னுற	mɯnːɯra
மேம்பாடு	meːmbɑːɖɯ
அவ்வோன்	ʔʌʋːoːn
சம்புநாவல்	sʌmbɯn̪ɑːʋʌl̪
தும்மல்	t̪ɯmːʌl̪
கனமழை	kʌnʌmʌɻʌɪ̯
குளிர்ப்பு	kɯɭɨɾ̪pːɯ
கறவை	kʌrʌʋʌɪ̯
பண்டாரவாய்க்கால்	pʌɳɖɑːɾ̪ʌʋɑːjkːɑːl̪
ஏராளம்	ʔeːɾ̪ɑːɭʌm
பயிற்சி	pʌjɨrsi
புட்பம்	pɯʈpʌm
நகர்	n̪ʌɡʌɾ̪
இலவசம்	ʔɨl̪ʌʋʌsʌm
புஸ்தகம்	pɯst̪ʌɡʌm
ஜீவவிருட்சம்	d͡ʑiːʋʌʋɨɾ̪ɯʈsʌm
தெகுரான்	t̪eɡɯɾ̪ɑːn
சட்டமன்றம்	sʌʈːʌmʌnrʌm
சிதமை	sɨd̪ʌmʌɪ̯
குன்று	kɯnrɯ
பெயர்த்திரிசொல்	pejʌɾ̪t̪ːɨɾ̪ɨsol̪
அமையம்	ʔʌmʌɪ̯jʌm
தொழுவன்	t̪oɻɯʋʌn
இழுது	ʔɨɻɯd̪ɯ
உருளைக்கிழங்கு	ʔɯɾ̪ɯɭʌɪ̯kːɨɻʌŋɡɯ
படிப்பறிவு	pʌɖɨpːʌrɨʋɯ
சதகுப்பை	sadəɣʉpːaɪ
கடிகாரம்	kʌɖɨɡɑːɾ̪ʌm
உறுதிபூசுதல்	ʔɯrɯd̪ɨbuːsɯd̪ʌl̪
மந்திரகூர்மை	mʌn̪d̪ɨɾ̪ʌɡuːɾ̪mʌɪ̯
மலர்ச்சி	mʌl̪ʌɾ̪sːi
உச்சவம்	ʔɯsːʌʋʌm
புட்டி	pɯʈːi
மார்பகம்	mɑːɾ̪pʌɡʌm
சாலி	sɑːl̪i
ஆதாம்	ʔɑːd̪ɑːm
ஜனகம்	d͡ʑʌnʌɡʌm
காப்பீடு	kɑːpːiːɖɯ
முள்நாறிப்	mɯɭn̪ɑːrɨp
ஆளி	ʔɑːɭi
சீனா	siːnɑː
அவர்கள்	ʔʌʋʌɾ̪kʌɭ
மறுசுழற்சி	mʌrɯsɯɻʌrsi
நகரமாந்தர்	n̪ʌɡʌɾ̪ʌmɑːn̪d̪ʌɾ̪
சுரும்பு	sɯɾ̪ɯmbɯ
ஜங்கிள்	d͡ʑʌŋɡɨɭ
சரித்திரம்	sʌɾ̪ɨt̪ːɨɾ̪ʌm
நாகரிகம்	n̪ɑːɡʌɾ̪ɨɡʌm
யாழ்	jɑːɻ
சேர்ந்தார்	seːɾ̪n̪d̪ɑːɾ̪
முளைக்கீரை	mɯɭʌɪ̯kːiːɾ̪ʌɪ̯
புருவம்	pɯɾ̪ɯʋʌm
ஆட்டுப்பால்	ʔɑːʈːɯpːɑːl̪
வரம்பு	ʋʌɾ̪ʌmbɯ
அணிகம்	ʔʌɳɨɡʌm
நடனம்	n̪ʌɖʌnʌm
வாகை	ʋaːɣaɪ
பயிர்	pʌjɨɾ̪
ஜெருசலேம்	d͡ʑeɾ̪ɯsʌl̪eːm
காதல்	kɑːd̪ʌl̪
மண்டபம்	mʌɳɖʌbʌm
மருத்துவர்	mʌɾ̪ɯt̪ːɯʋʌɾ̪
பெருங்காயம்	peɾ̪ɯŋɡɑːjʌm
காய்கறி	kɑːjkʌri
புது	pɯd̪ɯ
கலைக்களஞ்சியம்	kʌl̪ʌɪ̯kːʌɭʌɲd͡ʑɨjʌm
அக்காமார்	ʔʌkːɑːmɑːɾ̪
கம்பம்	kʌmbʌm
அலைப்	ʔʌl̪ʌɪ̯p
பகரம்	pʌɡʌɾ̪ʌm
நல்லொழுக்கம்	n̪ʌl̪ːoɻɯkːʌm
ஆங்கிலம்	ʔɑːŋɡɨl̪ʌm
இளநீர்	ʔɨɭʌn̪iːɾ̪
ஆவி	ʔɑːʋi
ஊழல்	ʔuːɻʌl̪
ஆபிச்	ʔɑːbɨs
கிளர்ச்சி	kɨɭʌɾ̪sːi
பிற்பகல்	pɨrpʌɡʌl̪
வல்லவன்	ʋʌl̪ːʌʋʌn
சிங்கப்பூர்	sɨŋɡʌpːuːɾ̪
ஆணவம்	ʔɑːɳʌʋʌm
மிருகம்	mɨɾ̪ɯɡʌm
அரவிந்தம்	ʔʌɾ̪ʌʋɨn̪d̪ʌm
பேனா	peːnɑː
வலி	ʋʌl̪i
எதிர்பால்சேர்க்கை	ʔed̪ɨɾ̪pɑːl̪seːɾ̪kːʌɪ̯
ஆம்பி	ʔɑːmbi
அவல்	ʔʌʋʌl̪
காந்தவண்டி	kɑːn̪d̪ʌʋʌɳɖi
கருது	kʌɾ̪ɯd̪ɯ
பாதம்	pɑːd̪ʌm
சித்திரை	sɨt̪ːɨɾ̪ʌɪ̯
இங்கிட்டு	ʔɨŋɡɨʈːɯ
கண்டு	kʌɳɖɯ
மூடுபனி	muːɖɯbʌni
கும்பிடு	kɯmbɨɖɯ
பிசுபிசுத்தவன்	pɨsɯbɨsɯt̪ːʌʋʌn
பொறியாளர்	porɨjɑːɭʌɾ̪
தொன்மை	t̪onmʌɪ̯
வேலைக்காரன்	ʋeːl̪ʌɪ̯kːɑːɾ̪ʌn
பல்	pʌl̪
பிரபஞ்சம்	pɨɾ̪ʌbʌɲd͡ʑʌm
பாஷ்தூ	pɑːʂt̪uː
பிசி	pɨsi
அளவை	ʔʌɭʌʋʌɪ̯
நிர்ணயம்	n̪ɨɾ̪ɳʌjʌm
புண்டை	pɯɳɖʌɪ̯
பிங்கலம்	pɨŋɡʌl̪ʌm
பாட்டு	pɑːʈːɯ
சப்போட்டா	sʌpːoːʈːɑː
எமன்	ʔemʌn
மடிக்கணினி	mʌɖɨkːʌɳɨni
உறுகண்	ʔɯrɯɡʌɳ
இன்று	ʔɨnrɯ
கருமை	kʌɾ̪ɯmʌɪ̯
தோண்டான்	t̪oːɳɖɑːn
அடித்தளம்	ʔʌɖɨt̪ːʌɭʌm
நிகர்ப்பு	n̪ɨɡʌɾ̪pːɯ
ஈழம்	ʔiːɻʌm
பிகுப்பட்டை	pɨɡɯpːʌʈːʌɪ̯
ஜிந்தகி	d͡ʑɨn̪d̪ʌɡi
முன்றுறை	mɯnrɯrʌɪ̯
ஓடு	ʔoːɖɯ
இயல்பு	ʔɨjʌl̪pɯ
வேலைக்கூலி	ʋeːl̪ʌɪ̯kːuːl̪i
