ayam	ʔajɐm
diskuwalipikasyon	dɪskʊɐlɪpɪxɐʃon
tsempedak	t͡ʃempedɐk
habi	habɪ
apatnapu	ʔɐpɐtnɐpuʔ
hugis	huɰɪs
sagimuymoy	saɰimujmoj
biyopisika	bɪopisɪxa
pandemya	pɐndemjɐ
lula	lulɐʔ
dumaguing	dʊmaɰɪŋ
iwi	ʔiwɪ
bogota	boɰota
istatuwa	ʔɪstatwa
estratehiko	ʔestɾɐtehɪxo
manlililok	mɐnlɪlilok
tayo	tɐjoʔ
balaan	balɐɐn
laway	lawaɪ̯
silidlawas	sɪlɪdlawɐs
olalia	ʔolalɪɐ
hasain	hɐsaʔɪn
diyametro	d͡ʒametɾo
mesa	mesɐ
dilambuwaya	dilɐmbwajɐ
barbero	bɐɾbeɾo
tinapay	tɪnapaɪ̯
calis	kxalɪs
butaka	bʊtaxɐ
halasan	hɐlasɐn
donasyon	donɐʃon
palomares	pɐlomaɾes
hilatsa	hɪlɐt͡ʃa
ibasco	ʔɪbasko
sepulturero	sepʊltʊɾeɾo
chiyoko	t͡ʃɪoxo
binalalak	bɪnɐlalɐk
hatiin	hɐtiʔɪn
tubero	tʊbeɾo
alat	ʔalɐt
klinika	kxlinɪxɐ
itim	ʔɪtim
hagibis	hɐɰɪbis
diamante	dɪɐmante
bigat	bɪɡʔat
eksperimento	ʔekspeɾɪmento
sira	siɾɐʔ
imperial	ʔɪmpeɾjɐl
dagisik	dɐɰɪsik
dao	dɐʔo
salitre	sɐlitɾe
basar	bɐsaɾ
islogan	ʔɪsloɰɐn
kalookan	kxɐloʔoxɐn
diblinig	dɪblɪniɡ
lakit	laxɪt
bawian	bɐwiʔɐn
amapola	ʔɐmɐpolɐ
sipsip	sipsɪp
saging	saɰɪŋ
balingit	bɐliŋɪt
komedya	kxomed͡ʒɐ
antukin	ʔɐntuxɪn
duguan	dʊɰʊʔan
destabilisasyon	destɐbɪlɪsɐʃon
langlang	lɐŋlaŋ
kasambahay	kxɐsɐmbɐhaɪ̯
laban	labɐn
gitling	ɡɪtliŋ
embalsama	ʔembɐlsɐma
liha	lihɐ
isipin	ʔɪsipɪn
balewala	bɐlewɐlaʔ
saksi	sɐksi
lablab	lɐblab
kapagka	kxɐpɐɡkaʔ
bakol	baxol
papasyalan	papɐʃɐlan
inhenyero	ʔɪŋheɲeɾo
himatayin	hɪmɐtɐjin
binundok	bɪnʊndok
buwag	bwaɡ
bayabas	bɐjabɐs
awtor	ʔaʊ̯toɾ
bubuli	bʊbʊli
departamento	depɐɾtɐmento
salonga	sɐloŋɡɐ
bigotilyo	bɪɰotiljo
aywan	ʔaɪ̯wan
malinis	mɐlinɪs
gantihan	ɡɐntɪhan
aboy	ʔɐboɪ̯
instansiya	ʔɪnstanʃa
akumulasyon	ʔɐxʊmʊlɐʃon
adulto	ʔɐdulto
habambuhay	hɐbɐmbuhaɪ̯
adajar	ʔɐdɐhaɾ
yakap	jaxɐp
lirot	lɪɾot
minako	mɪnaxo
atip	ʔɐtip
harot	hɐɾot
idalum	ʔɪdalʊm
aktres	ʔɐktɾes
hayaan	hɐjaʔɐn
tunay	tunaɪ̯
kustodiya	kxʊstodiɐ
betis	betɪs
amerika	ʔɐmeɾɪxa
bulilyaso	bʊlɪljaso
bunto	bʊnto
alangan	ʔɐlɐŋan
bentilador	bentɪlɐdoɾ
balimbing	bɐlɪmbiŋ
industriyalismo	ʔɪndʊstɾɪɐlismo
hugas	huɰɐs
nakakaloko	nɐxɐkɐloxo
iwang	ʔiwɐŋ
insenso	ʔɪnsenso
halhal	hɐlhal
alas	ʔɐlas
bulilit	bʊlilɪt
liway	lɪwaɪ̯
tria	tɾɪɐ
iha	ʔihɐ
corrales	kxoɾɾales
'y	ɪ
lura	lʊɾaʔ
itsa	ʔɪt͡ʃa
latayan	lɐtajɐn
magsuntukan	mɐɡsʊntuxɐn
maulan	mɐʔʊlan
kanluran	kxɐnluɾɐn
coronel	kxoɾonel
aklat	ʔɐklat
sapodilya	sɐpodiljɐ
maanghang	mɐɐŋhaŋ
hikaw	hixaʊ̯
diyamante	dɪɐmante
makabuluhan	mɐxɐbʊlʊhan
kapiraso	kxɐpɪɾaso
pigsa	pɪɡsaʔ
tabla	tablɐ
inanak	ʔɪnɐnak
kabisado	kxɐbɪsado
puki	puxɪ
akyatin	ʔɐkjɐtin
asya	ʔaʃɐ
krusipiho	kxɾʊsɪpiho
buyaya	bʊjajɐʔ
katibayan	kxɐtɪbajɐn
mabagsik	mɐbɐɡsik
siga	sɪɰaʔ
hukom	hʊxom
luminaw	lʊminaʊ̯
kapisanan	kxɐpɪsanɐn
barnis	bɐɾnis
versoza	beɾsosɐ
labatiba	lɐbɐtibɐ
umutot	ʔʊmʊtot
katoliko	kxɐtolɪxo
batingawan	bɐtɪŋawɐn
lasgas	lɐsɡas
tansan	tansɐn
alaala	ʔɐlɐʔalɐ
maniquiz	mɐnixɪs
limsiha	lɪmsihɐʔ
galit	ɡalɪt
matibag	mɐtibɐɡ
dedikasyon	dedɪxɐʃon
duwende	dwende
hardinero	hɐɾdɪneɾo
kandidato	kxɐndɪdato
sugarol	sʊɰɐɾol
hinahagkan	hɪnahɐɡkan
hapis	hɐpis
liya	ljaʔ
dulugan	dʊlʊɰan
agham	ʔɐɡham
rombaoa	ɾumbawɐ
initan	ʔinitɐn
balabal	bɐlabɐl
bisiro	bɪsiɾo
ingklinasyon	ʔɪŋklɪnɐʃon
aawat	ʔɐʔawɐt
ikaw	ʔɪxaʊ̯
lubak	lʊbak
baino	bɐʔɪno
hati	hɐtiʔ
dalubhasa	dɐlʊbhasɐʔ
hiwis	hɪwis
datapuwa	dɐtɐpwaʔ
asendero	ʔɐsendeɾo
istorbo	ʔɪstoɾbo
naku	nɐxu
harap	hɐɾap
hibaybay	hɪbaɪ̯baɪ̯
iloilo	ʔɪloʔilo
bakli	bɐkliʔ
palamuti	pɐlɐmʊtiʔ
espiya	ʔespja
lulay	lulaɪ̯
bagok	bɐɰok
anga	ʔɐŋaʔ
saan	sɐʔan
buhol	bʊhol
agwaras	ʔɐɡwɐɾas
buhok	bʊhok
lamang	lamɐŋ
bisa	bisɐʔ
manilaw	mɐnilaʊ̯
lantad	lɐntad
konserbatismo	kxonseɾbɐtismo
lawi	lɐwi
lanting	lantɪŋ
bulastog	bʊlɐstoɡ
gapo	ɡɐpoʔ
lihis	lɪhis
analitika	ʔɐnɐlitɪxa
gaas	ɡɐʔas
calinawan	kxɐlɪnawɐn
makakaliwa	mɐxakɐlɪwaʔ
banban	bɐnban
apostasiya	ʔɐpostɐsiɐ
kabikulan	kxɐbɪxulɐn
balahibo	bɐlɐhibo
litas	litɐs
magbati	mɐɡbɐti
kambing	kxɐmbiŋ
dugtong	dʊɡtoŋ
tira	tɪɾa
ayuno	ʔɐjuno
manghusga	mɐŋhʊsɡa
inupas	ʔɪnupɐs
suntukan	sʊntuxɐn
mamulaklak	mɐmʊlɐklak
piga	pɪɰaʔ
montecalvo	montexalbo
junichi	d͡ʒʊnit͡ʃɪ
maglangib	mɐɡlɐŋib
labas	labɐs
burma	buɾmɐ
bandila	bɐndilɐʔ
pagi	paɰɪ
bingi	bɪŋi
lawing	lɐwiŋ
konsentrasyon	kxonsentɾɐʃon
dayang	dɐjaŋ
dayukyok	dɐjʊkdok
dignidad	dɪɡnɪdad
tamod	tɐmod
bulak	bʊlak
angat	ʔɐŋat
bilao	bɪlaʔo
itineraryo	ʔɪtɪneɾaɾjo
dikta	dɪkta
pareño	pɐɾeɲo
lawak	lawɐk
parayno	pɐɾaɪ̯no
altar	ʔɐltaɾ
mabato	mabɐto
haba	hɐbaʔ
baba	babɐʔ
limatik	lɪmatɪk
lohikal	lohɪxal
badminton	bɐdmɪnton
taning	tanɪŋ
sultan	sultɐn
abuluyan	ʔabʊlʊjan
maliban	mɐlibɐn
luad	lʊʔad
bodabil	bodɐbil
antraks	ʔantɾɐks
anislag	ʔɐnislɐɡ
ganiri	ɡɐnɪɾi
anghel	ʔɐŋhel
duyan	dujɐn
adikto	ʔɐdikto
ebanghelyo	ʔebɐŋheljo
luko	luxo
dalanghita	dɐlɐŋhitɐ
kalbaryo	kxɐlbaɾjo
aguirre	ʔɐɰiɾe
hambing	hɐmbiŋ
apo	ʔɐpo
hithit	hɪthit
amerikano	ʔɐmeɾɪxano
anonang	ʔɐnonɐŋ
lambal	lɐmbal
kalawangin	kxɐlɐwaŋɪn
huramentado	hʊɾɐmentado
mancao	maŋkaʊ̯
masukal	mɐsuxɐl
linggo	lɪŋɡo
bulahaw	bʊlɐhaʊ̯
lakatan	lɐxɐtan
baang	bɐʔaŋ
kaligkig	kxɐlɪɡkiɡ
lingil	lɪŋil
ino	ʔɪno
cometa	kxometɐ
manalad	mɐnalɐd
ate	ʔɐteʔ
digos	diɰos
bakante	bɐxante
higliknayan	hɪɡlɪknajɐn
bumata	bʊmatɐʔ
gukgok	ɡʊkɡok
linisin	lɪnɪsin
apalit	ʔɐpalɪt
labandero	lɐbɐndeɾo
cantos	kxantos
haro	hɐɾo
hanunuo	hanʊnuʔo
bidbiran	bɪdbɪɾan
diskompiyado	dɪskumpjɐdo
bumaba	bʊmɐbaʔ
luto	lʊto
loka	loxɐ
maghalili	mɐɡhɐlilɪ
halikan	halixɐn
ligao	lɪɰaʊ̯
tiklop	tɪklop
impilya	ʔɪmpiljɐ
lagyo	lɐɡjoʔ
maagrabyado	mɐʔɐʔɡɾɐbjado
palaman	pɐlɐman
lumad	lumɐd
tumanggap	tʊmɐŋɡap
lazarte	lɐsaɾte
luningning	lʊnɪŋniŋ
eksaherado	ʔeksɐheɾado
sitwasyon	sɪtwɐʃon
daspan	daspɐn
laya	lɐjaʔ
lababo	lɐbabo
dalawampu	dɐlɐwɐmpuʔ
ginto	ɡɪntoʔ
aguas	ʔaɰʊɐs
batiti	bɐtitɪʔ
hawayana	hɐwɐjanɐ
daya	dajɐʔ
indibidwal	ʔɪndɪbɪdwal
bumatak	bʊmatɐk
gunita	ɡʊnɪtaʔ
bawat	bawɐt
mabutig	mɐbʊtiɡ
umabyad	ʔʊmɐbjad
hiwalay	hɪwalaɪ̯
magrasa	mɐɡɾasɐ
lumi	lumɪʔ
pilipinas	pɪlɪpinɐs
langaw	laŋaʊ̯
balakyot	bɐlɐkjot
lalang	lɐlaŋ
labnot	lɐbnot
agong	ʔaɰoŋ
hagdanan	hɐɡdanɐn
dalaginding	dɐlaɰɪndiŋ
itmo	ʔɪtmo
anyaya	ʔɐɲɐjɐ
lulan	lulɐn
bloke	bloxe
tumacder	tʊmakdeɾ
datiles	datɪles
banday	bandaɪ̯
visaya	bɪsajɐʔ
anluwagi	ʔɐnlwɐɰɪ
bida	bidɐ
humiga	hʊmɪɰaʔ
umayos	ʔʊmajos
instituto	ʔɪnstɪtuto
luping	lʊpiŋ
kredensiyal	kxɾedenʃal
venturina	bentʊɾinɐ
dayan	dɐjan
pustiso	pʊstiso
limjoco	lɪmd͡ʒoxo
abaniko	ʔɐbɐnixo
hayag	hajɐɡ
lumakdang	lʊmɐkdaŋ
yumabang	jʊmabɐŋ
setsuko	set͡ʃuxo
litigasyon	lɪtɪɰɐʃon
maunahan	maʊ̯nahɐn
ikalabinsiyam	ʔɪxɐlɐbinʃam
mangaoang	mɐŋawɐŋ
buwis	bwis
almarez	ʔɐlmɐɾes
dalusong	dɐlusoŋ
kompartment	kxumpaɾtment
labintatlo	lɐbntɐtlo
hiklas	hɪklas
iset	ʔɪset
kaputsino	kxɐpʊt͡ʃino
ibayo	ʔɪbɐjo
sitse	sɪt͡ʃe
lambayog	lɐmbajoɡ
aklatan	ʔɐklatɐn
lunas	lunɐs
sosa	sosɐ
higa	hɪɰaʔ
titik	titɪk
saburo	sɐbuɾo
gisantes	ɡɪsantes
ka	kxɐ
lanubo	lɐnuboʔ
direktiba	dɪɾektibɐ
bugat	bʊɰat
dagatan	dɐɰatɐn
maligaw	malɪɰaʊ̯
arina	ʔɐɾinɐ
masurot	mɐsuɾot
ilusyon	ʔɪlʊʃon
analohiya	ʔɐnɐlohiɐ
hilo	hɪlo
lantsa	lant͡ʃɐ
manlapaz	mɐnlapɐs
dutaliknayan	dʊtɐlɪknajɐn
manyak	maɲɐk
linis	linɪs
villegas	bɪljeɰɐs
butiki	bʊtɪxiʔ
uhaw	ʔuhaʊ̯
ibis	ʔɪbis
dulas	dʊlas
tasa	tɐsa
umurong	ʔʊmuɾoŋ
bunyi	buɲɪ
bascoguin	bɐskoɰɪn
ursula	ʔuɾsʊlɐ
kakaphay	kxɐxɐphaɪ̯
baling	balɪŋ
balisakang	bɐlɪsɐxaŋ
aliw	ʔalɪʊ̯
pandikit	pɐndɪxit
bayno	baɪ̯no
hukbo	hʊkboʔ
hibang	hibɐŋ
abutin	ʔɐbʊtin
aktor	ʔɐktoɾ
tsikot	t͡ʃɪxot
puhunan	pʊhunɐn
kulog	kxʊloɡ
birey	biɾeɪ̯
ipa	ʔɪpa
arzadon	ʔɐɾsadon
inggo	ʔɪŋɡo
bakit	bɐt
shohei	shoheɪ̯
magrenta	mɐɡɾentɐ
baliwag	bɐliwɐɡ
lalanghutan	lɐlɐŋhʊtan
alindog	ʔɐlɪndoɡ
hina	hinɐʔ
ari	ʔɐɾe
palaaway	pɐlɐʔɐwaɪ̯
peñaranda	peɲɐɾandɐ
dosena	dosenɐ
bango	bɐŋo
akreditasyon	ʔɐkɾedɪtɐʃon
makalat	mɐxalɐt
baksa	bɐksa
kilogramo	kxɪloɡɾamo
bambo	bɐmbo
limit	limɪt
pasiya	pɐʃa
malambot	mɐlambot
gumuho	ɡʊmuhoʔ
bangko	bɐŋkoʔ
tayabas	tɐjabɐs
bisyo	biʃo
lilok	lɪlok
bigas	bɪɰas
iso	ʔɪsoʔ
ditdit	dɪtdit
diretso	dɪɾet͡ʃo
ifugao	ʔɪpʊɰaʊ̯
hasinto	hɐsinto
danes	dɐnes
panlinis	pɐnlinɪs
navoa	naboɐ
kalamansanay	kxɐlɐmɐnsanaɪ̯
buwa	bwaʔ
alalahanin	ʔalɐlɐhɐnin
amaranto	ʔɐmɐɾanto
disaluyan	dɪsɐlujɐn
kumupas	kxʊmupɐs
ishinare	ʔɪshɪneɾ
deklara	deklɐɾa
langkap	lɐŋkap
gaya	ɡajɐ
gapos	ɡɐpos
gayak	ɡɐjak
isangla	ʔɪsɐnlaʔ
dagikapnayan	dɐɰɪxɐpnajɐn
abogado	ʔɐboɰado
peking	pexɪŋ
aloy	ʔaloɪ̯
dalubtala	dɐlubtalɐʔ
ayusin	ʔɐjʊsin
belat	belɐt
isigan	ʔɪsiɰɐn
kautusan	kxaʊ̯tʊsan
espongha	ʔespoŋhɐ
li	lɪ
bulo	bʊloʔ
bunso	bʊnso
aksibal	ʔɐksibɐl
kampanaryo	kxɐmpɐnaɾjo
lichauco	lɪt͡ʃaʊ̯xo
aghimuan	ʔɐɡhimʊɐn
binagre	bɪnaɡɾe
raliyista	ɾɐlɪjistɐ
abusado	ʔɐbʊsado
hindi	hɪndeʔ
maniago	mɐniɐɰo
alyansa	ʔɐljansɐ
flora	floɾɐ
laginit	lɐɰɪnit
hangal	hɐŋal
manghuthot	mɐŋhʊthot
takbo	tɐkbo
aklas	ʔɐklas
tiyangge	t͡ʃaŋɡeʔ
buntot	bʊntot
boltiyo	bolt͡ʃo
huthot	hʊthot
bunggabilya	bʊŋɡɐbiljɐ
umaakyat	ʔʊmɐʔɐkjat
alimpayawan	ʔɐlɪmpɐjawɐn
kosta	kxostɐ
basangal	bɐsaŋɐl
bubungan	bʊbʊŋan
bawas	bɐwas
virus	baɪ̯ɾʊs
lunaw	lʊnaʊ̯
kompositor	kxumposɪtoɾ
estratehiya	ʔestɾɐtehiɐ
inip	ʔɪnip
dubdob	dʊbdob
manlapig	mɐnlapɪɡ
bami	bamɪ
araru	ʔɐɾɐɾu
haribon	haɾɪbon
estudyante	ʔestʊd͡ʒante
gulat	ɡulɐt
mitsa	mɪt͡ʃa
montinola	montɪnolɐ
capiz	kxapɪs
litis	litɪs
magmaniobra	mɐɡmɐniobɾɐ
antipalo	ʔɐntɪpalo
komentarista	kxomentɐɾistɐ
hapin	hɐpin
yuvienco	jʊbieŋko
botanika	botanɪxa
agipo	ʔɐɰɪpo
bigote	bɪɰote
katha	kxɐthaʔ
pangngalan	pɐŋŋalɐn
tapos	tɐs
suha	suhɐʔ
ampibyan	ʔɐmpibjɐn
mandaragat	mɐndɐɾɐɰat
cariaso	kxɐɾjaso
dipende	dɪpende
agatat	ʔɐɰɐtat
dalublasunan	dɐlublasʊnan
gulod	ɡʊlod
antipona	ʔɐntipona
pista	pɪsta
dantaon	dɐntɐʔon
ayusin	ʔɐjusɪn
pagtalikod	pɐɡtɐlixod
daloy	daloɪ̯
lasa	lɐsaʔ
bagol	bɐɰol
insurekto	ʔɪnsʊɾekto
iti	ʔitɪ
batangas	bɐtaŋɡɐs
kahihiyan	kxahɪhɪan
direktora	dɪɾektoɾɐ
bakat	baxɐt
dighay	dɪɡhaɪ̯
lugot	luɰot
batalyon	bɐtɐljon
kaktus	kxaktʊs
inglesero	ʔɪŋɡleseɾo
pensiyon	penʃon
lakdaw	lɐkdaʊ̯
apaya	ʔɐpajɐ
pangangasiwa	pɐŋɐŋɐsiwɐʔ
dormitoryo	doɾmɪtoɾjo
boya	bojɐ
kimkim	kxɪmkim
quiapo	kjɐpoʔ
lumundag	lʊmʊndaɡ
supil	sʊpil
lamig	lɐmiɡ
hudyo	hʊd͡ʒo
lagari	lɐɰaɾɪʔ
bretanya	bɾetaɲɐ
alok	ʔɐlok
dagsa	dɐɡsaʔ
leksikograpo	leksɪxoɡɾɐpo
eskoba	ʔeskobɐ
alpaka	ʔɐlpaxɐ
sihay	sihaɪ̯
nasaan	nasɐʔan
abulencia	ʔɐbʊlenʃɐ
diba	dɪba
manhid	mɐŋhid
hatak	hɐtak
bulakbol	bʊlɐkbol
lasa	lasɐ
artista	ʔɐɾtistɐ
manguiat	maŋɪɐt
macapinlac	mɐxɐpinlɐk
montillano	montɪllano
kantahin	kxɐntɐhin
akayin	ʔɐxajɪn
hagap	haɰɐp
maghirap	mɐɡhiɾɐp
hirat	hiɾɐt
kuya	kxujɐ
gumanap	ɡʊmɐnap
siyesta	ʃestɐ
limbaga	lɪmbaɰɐ
lusong	lʊsoŋ
balam	bɐlam
durian	dʊɾjan
dumapa	dʊmɐpaʔ
tato	tɐtoʔ
dikiam	dɪkjam
habol	hɐbol
pinagtalunan	pɪnaɡtɐlunɐn
maglingkod	mɐɡlɪŋkod
alemanya	ʔɐlemaɲɐ
hinaw	hinaʊ̯
pagkakataon	pɐɡkɐxɐtɐʔon
bigaw	bɪɰaʊ̯
kiling	kxɪliŋ
mabuhol	mɐbʊhol
asukarera	ʔɐsʊxɐɾeɾɐ
belosidad	belosɪdad
laswa	lɐswaʔ
maglapa	mɐɡlapɐʔ
diyakono	d͡ʒaxono
alarma	ʔɐlaɾmɐ
buhay	bʊhaɪ̯
akma	ʔɐkmaʔ
dimalanta	dɪmɐlantɐ
libuntaon	libʊntɐʔon
babaye	bɐbaje
lanap	lɐnap
kroniyismo	kxɾonɪjismo
abuab	ʔɐbʊʔab
balbula	balbʊla
bantod	bɐntod
busilak	bʊsilɐk
apula	ʔɐpʊlaʔ
masamid	masɐmid
balas	bɐlas
magsaliksik	mɐɡsɐlɪksik
baritono	bɐɾitono
balangaw	bɐlɐŋaʊ̯
balino	bɐlɪno
bakla	bɐkla
pasugalan	pasʊɰalɐn
balibol	bɐlibol
quitain	kxitaɪ̯n
hagakhak	hɐɰɐkhak
likas	lixɐs
anarkiya	ʔɐnɐɾkiɐ
lala	lalɐ
sarimanok	sɐɾɪmɐnok
awat	ʔawɐt
anatomiya	ʔɐnɐtomiɐ
cabungcal	kxɐbuŋkɐl
higop	hiɰop
butlig	bʊtliɡ
huweteng	hʊeteŋ
cabanatuan	kxɐbɐnɐtuʔɐn
ay	ʔaɪ̯
bejasa	behasɐ
labindalawa	lɐbɪndɐlɐwa
bukol	buxol
liwas	lɪwas
magsapatos	mɐɡsɐpatos
resurreccion	ɾesʊɾekʃon
higlikas	hɪɡlɪxas
laksa	lɐksa
keiko	kxeɪ̯xo
ganito	ɡɐnɪto
bila	bilɐ
ataud	ʔɐtɐʔud
campo	kxampo
lunot	lʊnot
abellera	ʔɐbeljeɾɐ
nasaan	nasɐn
magluwat	mɐɡlwat
iniba	ʔɪnibɐʔ
dugas	duɰɐs
haklit	hɐklit
katagalugan	kxɐtɐɰɐluɰɐn
bumagal	bʊmaɰɐl
sigarilyas	sɪɰɐɾiljɐs
gilik	ɡilɪk
atubili	ʔɐtʊbɪli
kontrobersiya	kxontɾobeɾsiɐ
maalat	mɐʔalɐt
madaldal	mɐdɐldal
eskultura	ʔeskʊltuɾɐ
ilat	ʔilɐt
elaborasyon	ʔelɐboɾɐʃon
endaya	ʔendajɐ
idolatriya	ʔɪdolɐtɾiɐ
talong	tɐloŋ
pagsuway	pɐɡswaɪ̯
buksan	bʊksan
pasukan	pɐsʊxan
saga	saɰɐʔ
tagapagmana	tɐɰɐpɐɡmanɐ
atleta	ʔɐtletɐ
labing	lɐbiŋ
apostata	ʔɐpostɐta
gulong	ɡʊloŋ
limandaan	lɪmɐndɐʔan
bandyo	band͡ʒo
pamamanhikan	pɐmɐmɐŋhixɐn
laroy	laɾoɪ̯
sentensiyahan	sentenʃɐhan
ina	ʔɪnaʔ
dyanitor	d͡ʒanɪtoɾ
medina	medinɐ
dilaw	dɪlaʊ̯
elamparo	ʔelɐmpaɾo
kagawaran	kxɐɰɐwɐɾan
yoshiko	joshixo
akma	ʔɐkma
apostolado	ʔɐpostolado
katungkulan	kxɐtʊŋkulɐn
daing	daʔɪŋ
bulanadi	bʊlɐnadɪ
lanting	lɐntiŋ
bawi	bɐwiʔ
indiyan	ʔind͡ʒan
nibel	nɪbel
lihiya	lɪhɪa
bulutunggo	bʊlʊtʊŋɡo
hagip	hɐɰip
pugot	pʊɰot
tarik	tɐɾik
bunga	buŋɐ
bagaman	bɐɰɐman
aroma	ʔɐɾomɐ
aap	ʔɐʔap
manalo	mɐnalo
dagundong	dɐɰʊndoŋ
galaw	ɡalaʊ̯
atik	ʔɐtik
lalab	lalɐb
dyologs	d͡ʒoloɡs
ipadala	ʔɪpɐdɐla
tumbaga	tumbaɰɐ
dimaala	dɪmaɐlɐ
halaman	hɐlamɐn
emperadora	ʔempeɾɐdoɾɐ
gabi	ɡɐbi
kuripot	kxʊɾipot
amante	ʔɐmante
punsalang	pʊnsalɐŋ
bukong	buxoŋ
acebedo	ʔɐsebedo
lagi	laɰɪ
gahol	ɡɐhol
bonifacio	bonɪpaʃo
ngayon	ŋɐjon
bara	bɐɾa
banda	bɐnda
kabihasnan	kxɐbɪhɐsnan
alguwasil	ʔɐlɡʊɐsil
pilosopo	pɪlosopo
langit	laŋɪt
noriko	noɾixo
dungon	dʊŋon
oribello	ʔoɾɪbello
palabasa	pɐlɐbɐsa
bukot	buxot
agam	ʔaɰɐm
sinamomo	sɪnɐmomo
siason	ʃɐson
hinang	hinɐŋ
tenga	teŋɐ
mananghalian	mɐnɐŋhɐliʔɐn
dagitab	dɐɰitɐb
mayumi	mɐjumɪ
ekis	ʔexɪs
kasera	kxɐseɾɐ
tapsilog	tɐpsɪloɡ
banayad	bɐnajɐd
lupig	lʊpiɡ
gala	ɡɐlaʔ
kritiko	kxɾitɪxo
nakakabuwisit	nɐxɐkɐbwisɪt
awit	ʔawɪt
paninigarilyo	pɐnɪnɪɰɐɾiljo
ngimay	ŋimaɪ̯
lalay	lɐlaɪ̯
diyes	d͡ʒes
eyre	ʔeɪ̯ɾe
bata	batɐʔ
buking	bʊxiŋ
hawsyaw	haʊ̯ʃaʊ̯
kambyo	kxambjo
dabdab	dɐbdab
ardilya	ʔɐɾdiljɐ
boksing	boksɪŋ
dulang	dulɐŋ
tinidor	tɪnɪdoɾ
salumbides	sɐlumbides
ismagler	ʔɪsmaɡleɾ
pagitan	pɐɰitɐn
lagablab	lɐɰɐblab
kudkurin	kxʊdkʊɾin
huma	hʊma
igting	ʔɪɡtiŋ
lawig	lawɪɡ
dani	dɐniʔ
balumbalunan	bɐlumbɐlunɐn
eskuwelahan	ʔeskwelɐhan
handusay	hɐndʊsaɪ̯
umalingawngaw	ʔʊmɐlɪŋaʊ̯ŋaʊ̯
bakal	baxɐl
motoko	motoxo
hingal	hiŋɐl
babad	babɐd
bulag	bʊlaɡ
idlip	ʔɪdlip
espiritu	ʔespiɾɪtu
bangkilas	bɐŋkilɐs
dakma	dɐkmaʔ
maglanggas	mɐɡlɐŋɡas
dalubkulisap	dɐlubkʊlisɐp
oligopolyo	ʔolɪɰopoljo
bini	binɪʔ
bumagsak	bʊmɐɡsak
kabaro	kxɐbaɾoʔ
balisong	bɐlɪsoŋ
ginang	ɡinɐŋ
salawal	sɐlɐwal
abla	ʔablɐ
hanginsigan	hɐŋɪnsiɰɐn
karitela	kxɐɾɪtelɐ
hapo	hɐpoʔ
lantay	lɐntaɪ̯
turok	tʊɾok
balarila	bɐlɐɾilɐʔ
lastiko	lastɪxo
maliksi	mɐliksɪ
lapurit	lɐpʊɾit
madlangbayan	mɐdlɐŋbajɐn
inspektor	ʔɪnspektoɾ
biyahero	bɪɐheɾo
bayarin	bɐjɐɾin
bulaos	bʊlaʔos
giggi	ɡɪɡɡiʔ
sinigwelas	sɪnɪɡwelɐs
busangot	bʊsɐŋot
asamblea	ʔɐsɐmblejɐ
intensibo	ʔɪntensibo
tiraniya	tɪɾɐniɐ
larga	laɾɡɐ
lambang	lɐmbaŋ
patintero	pɐtɪnteɾo
basag	bɐsaɡ
takal	tɐxal
zoleta	soletɐ
juntilla	d͡ʒʊntillɐ
bilig	bɪliɡ
pilat	pilɐt
limos	lɪmos
lumipol	lʊmipol
himay	hɪmaɪ̯
balana	bɐlanɐʔ
mamboso	mɐmboso
gumilid	ɡʊmilɪd
gayas	ɡajɐs
amos	ʔɐmos
buyunin	bujunɪn
dula	dʊlaʔ
loryat	loɾjɐt
baldado	bɐldado
armonika	ʔɐɾmonɪxa
landa	lɐnda
bitamina	bɪtɐminɐ
amerikana	ʔɐmeɾɪxanɐ
canicosa	kxɐnɪxosɐ
lingawngaw	lɪŋaʊ̯ŋaʊ̯
labaskaphay	lɐbɐskɐphaɪ̯
kinauukulan	kxɪnaʊ̯ʊxulɐn
ahang	ʔɐhaŋ
pinggan	pɪŋɡan
diyablo	d͡ʒablo
klaro	kxlɐɾo
aborsiyonista	ʔɐboɾsɪonistɐ
naptalina	nɐptɐlinɐ
haspe	hɐspe
lapirot	lɐpiɾot
mangailangan	mɐŋɐʔɪlaŋɐn
gulat	ɡʊlat
hukuman	huxumɐn
damay	damaɪ̯
ibis	ʔibɪs
korinto	kxoɾinto
bartolome	bɐɾtolome
mambiktima	mɐmbɪktimɐ
ilag	ʔɪlaɡ
lipya	lɪpjaʔ
dalisay	dɐlisaɪ̯
baisan	bɐʔɪsan
piyano	pjɐno
tagupa	tɐɰupɐ
anit	ʔanɪt
bokabularyo	boxɐbʊlaɾjo
hilamos	hɪlamos
inay	ʔɪnaɪ̯
bukambibig	bʊxɐmbɪbiɡ
nakakabobo	nɐxɐkɐbobo
habilin	hɐbilɪn
giting	ɡitɪŋ
tatlonghari	tɐtloŋhaɾɪ
duhagi	dʊhɐɰi
harurot	hɐɾuɾot
alambrera	ʔɐlɐmbɾeɾɐ
gana	ɡanɐ
sibayan	sɪbajɐn
gumi	ɡumɪ
hiringgilya	hɪɾɪŋɡiljɐ
gulo	ɡʊlo
matae	mɐtɐʔe
din	dɪn
baba	bɐbaʔ
cosico	kxosixo
eredera	ʔeɾedeɾɐ
bosing	bosɪŋ
arcega	ʔɐɾseɰɐ
ga	ɡɐ
andap	ʔɐndap
kilusan	kxilʊsan
gansa	ɡɐnsaʔ
laguslos	lɐɰʊslos
italyano	ʔɪtɐljano
luwa	lwaʔ
banta	bantɐʔ
andal	ʔɐndal
lampaso	lɐmpaso
ilao	ʔilaʊ̯
monako	monɐxo
agaran	ʔaɰaɾɐn
buraot	bʊɾaʔot
magatas	mɐɰatɐs
hawi	hawɪʔ
lanao	lanaʊ̯
bagwis	bɐɡwis
bohaghag	bohɐɡhaɡ
bakulo	baxʊlo
kataga	kxɐtɐɰaʔ
haling	halɪŋ
konyo	kxoɲo
indonesa	ʔɪndonesɐ
teritoryo	teɾɪtoɾjo
buboy	buboɪ̯
bilas	bɪlas
miklawas	mɪklawɐs
manligaw	mɐnliɰaʊ̯
mamintog	mɐmɪntoɡ
apuybilos	ʔɐpʊɪbilos
bagahe	bɐɰahe
karamihan	kxɐɾɐmihɐn
bitin	bitɪn
apganistan	ʔɐpɡɐnɪstan
magnipikador	mɐɡnɪpɪxɐdoɾ
balanan	bɐlanɐn
dragon	dɾɐɰon
bihag	bihɐɡ
baldahin	bɐldɐhin
rehas	ɾehɐs
kupido	kxupɪdo
kutsara	kxʊt͡ʃaɾɐ
sasakyan	sɐsɐkjan
mijares	mɪd͡ʒaɾes
siguraduhin	sɪɰʊɾɐduhɪn
bukong	bʊxoŋ
arkanghel	ʔɐɾkɐŋhel
bukalkal	bʊxɐlkal
aristoteles	ʔɐɾɪstoteles
kubeta	kxʊbetɐ
bayan	bajɐn
bahasa	bɐhasɐ
kupon	kxʊpon
boykot	boɪ̯xot
pitumbuko	pɪtumbʊxo
alkaldesa	ʔɐlkɐldesɐ
bihasa	bɪhasɐ
yena	jenɐ
habagat	hɐbaɰɐt
palabasan	palɐbasɐn
labinlima	lɐbinlɪma
armadilyo	ʔɐɾmɐdiljo
isa	ʔɪsa
bituin	bɪtuin
estapador	ʔestɐpɐdoɾ
lamay	lamaɪ̯
literasya	lɪteɾaʃɐ
espasyo	ʔespaʃo
pistola	pɪstolɐ
bumbunan	bumbʊnan
dalawit	dɐlawɪt
alamin	ʔɐlɐmin
epiko	ʔepɪxo
hamil	hɐmil
dugo	dʊɰoʔ
abukanin	ʔɐbʊxanɪn
baitang	bɐʔitɐŋ
padilla	pɐdiljɐ
tina	tinɐʔ
lalin	lalɪn
lagod	laɰod
dinggin	dɪŋɡin
arabo	ʔɐɾabo
magsimba	mɐɡsɪmba
palaisipan	pɐlaɪ̯sɪpan
mabulo	mɐbulo
bihilante	bɪhɪlante
manggagantso	mɐŋɡɐɰant͡ʃo
dayanghirang	dɐjɐŋhiɾɐŋ
ginaw	ɡɪnaʊ̯
bumili	bʊmɪli
abangan	ʔabaŋɐn
magkeyk	mɐɡkeɪ̯k
gagad	ɡɐɰad
espiritwalidad	ʔespɪɾɪtwɐlɪdad
libang	lɪbaŋ
gulang	ɡulɐŋ
hibi	hibɪ
kamukha	kxɐmʊkhaʔ
fajardo	pɐhaɾdo
baka	bɐxaʔ
benggala	beŋɡalɐ
sigwasan	sɪɡwasɐn
aguhon	ʔɐɰʊhon
gitisig	ɡɪtisɪɡ
benepisyo	benepiʃo
balda	bɐlda
danggit	dɐŋɡit
labanos	labɐnos
biso	bɪsoʔ
salvatierra	salbɐt͡ʃeɾɐ
patiag	pat͡ʃɐɡ
laspag	lɐspaɡ
estabillo	ʔestɐbillo
tupad	tʊpad
pagbati	pɐɡbɐti
mapalad	mɐpalɐd
batid	bɐtid
magdemanda	mɐɡdemandɐ
lakan	laxɐn
forteza	foɾtesɐ
tipak	tɪpak
hipik	hɪpik
paupahan	paʊ̯pɐhan
impapawid	ʔɪmpɐpɐwid
iwal	ʔiwɐl
lutang	lutɐŋ
karampatan	kxɐɾɐmpatɐn
lulong	lʊloŋ
batallones	bɐtɐllones
tumira	tʊmɪɾa
iilan	ʔɪʔɪlan
makunat	mɐxunɐt
magbilad	mɐɡbɪlad
bigay	bɪɰaɪ̯
kayamanan	kxɐjɐmanɐn
abelgas	ʔɐbelɡɐs
ebakwasyon	ʔebɐkwɐʃon
mabula	mɐbʊlaʔ
arnis	ʔɐɾnis
kabukiran	kxɐbʊxiɾɐn
lising	lisɪŋ
balinghoy	bɐlɪŋhoɪ̯
limita	lɪmɪta
leksikograpiya	leksɪxoɡɾɐpiɐ
barcelona	bɐɾselonɐ
manloko	mɐnloxo
kamyas	kxɐmjas
halal	hɐlal
balibat	bɐlɪbat
diitan	diʔɪtɐn
panlaqui	pɐnlaxɪ
eleksiyon	ʔelekʃon
bagko	bɐɡkoʔ
alingawngaw	ʔɐlɪŋaʊ̯ŋaʊ̯
indotsina	ʔɪndot͡ʃinɐ
inampalan	ʔɪnɐmpalɐn
ipabasa	ʔɪpɐbɐsaʔ
agila	ʔaɰɪla
antot	ʔɐntot
pamaypay	pɐmaɪ̯paɪ̯
hinaw	hɪnaʊ̯
makiko	mɐxiko
insensaryo	ʔɪnsensaɾjo
ilohikal	ʔɪlohɪxal
galang	ɡalɐŋ
binabae	bɪnɐbɐʔe
bulutong	bʊlutoŋ
abayan	ʔɐbɐjan
kortina	kxoɾtinɐ
lamasin	lɐmasɪn
bululos	bʊlʊlos
tago	taɰoʔ
balibol	balɪbol
kinang	kxɪnaŋ
linggal	lɪŋɡal
wika	wixɐʔ
lampa	lɐmpa
inggitero	ʔɪŋɡɪteɾo
dighal	dɪɡhal
tsikinini	t͡ʃɪxɪninɪʔ
linggaw	lɪŋɡaʊ̯
sirwelas	sɪɾwelɐs
bataan	bɐtaʔɐn
letmaku	letmɐxu
abejuela	ʔɐbehuelɐ
lumamig	lʊmɐmiɡ
makaluma	mɐxɐlumɐʔ
layas	lajɐs
mabilis	mɐbɪlis
daluro	dɐlʊɾoʔ
kerry	kxeɾɾɪ
lugay	luɰaɪ̯
hinayang	hɪnajɐŋ
corpus	kxoɾpʊs
ispanismo	ʔɪspɐnismo
tangkal	tɐŋkal
bakahan	bɐxɐhan
lasing	lɐsiŋ
tiyaga	tɪɐɰaʔ
bangon	bɐŋon
kagaw	kxaɰaʊ̯
alakdan	ʔɐlɐkdan
akuin	ʔɐxuʔɪn
pagtaluhan	pɐɡtɐluhɐn
pamamaril	pɐmɐmɐɾil
sanggol	sɐŋɡol
jacinto	hɐsinto
katolisismo	kxɐtolɪsismo
batuta	bɐtutɐʔ
sibug	sibʊɡ
ingay	ʔiŋaɪ̯
gayari	ɡɐjɐɾi
ipaayos	ʔɪpɐʔajos
dula	dulɐʔ
laylay	laɪ̯laɪ̯
paraan	pɐɾɐʔan
manganak	mɐŋɐnak
sisid	sisɪd
inaanak	ʔɪnaʔɐnak
lugnas	lʊɡnas
busisi	bʊsɪsiʔ
aborsyonista	ʔɐboɾʃonistɐ
makipagbati	mɐxɪpɐɡbɐtiʔ
liham	lihɐm
aktibismo	ʔɐktɪbismo
balatik	bɐlatɪk
pinlandiya	pɪnland͡ʒa
dagalwak	dɐɰɐlwak
pitumpu	pɪtumpuʔ
bagoong	bɐɰoʔoŋ
lizada	lɪsadɐ
lapag	lɐpaɡ
balintunay	bɐlɪntunaɪ̯
alin	ʔɐlin
dilis	dɪlis
adya	ʔɐd͡ʒa
salap	sɐlap
dawit	dawɪt
himlay	hɪmlaɪ̯
agwa	ʔaɡwɐ
tuwalya	twɐljɐ
mahalay	mɐhalaɪ̯
elizaga	ʔelɪsaɰɐ
kaibigan	kxaibɪɰan
hagok	haɰok
igorot	ʔɪɰoɾot
liha	lɪha
hitad	hɪtad
hamon	hɐmon
dalita	dɐlɪtaʔ
duhasik	dʊhasɪk
guyabano	ɡʊjɐbano
miksipat	mɪksɪpat
siyete	ʃete
dagison	dɐɰison
mangalunya	mɐŋɐlʊɲaʔ
barbosa	bɐɾbosɐ
dumog	dʊmoɡ
gets	ɡet͡s
lamira	lɐmɪɾaʔ
kaladkad	kxɐlɐdkad
batag	batɐɡ
anaman	ʔɐnɐman
latak	latɐk
lantot	lɐmbiŋ
himbabahay	hɪmbɐbahaɪ̯
juarez	hwɐɾes
babala	bɐbɐlaʔ
marcial	maɾʃɐl
manlaban	mɐnlɐban
espanya	ʔespaɲɐ
imbudo	ʔɪmbudo
agas	ʔaɰɐs
cabahug	kxɐbahʊɡ
lublob	lʊblob
alegre	ʔɐleɡɾe
bilang	bilɐŋ
halubid	hɐlʊbid
agwa	ʔɐɡwa
gagamba	ɡɐɰɐmba
ehersito	ʔeheɾsɪto
pundasyon	pʊndaʃon
salud	salʊd
loko	loxo
lupig	lupɪɡ
pagkabuhay	pɐɡkɐbuhaɪ̯
ligat	liɰɐt
bala	balɐʔ
balidasyon	bɐlɪdɐʃon
tindig	tɪndiɡ
dali	dalɪʔ
galak	ɡɐlak
lingo	lɪŋo
pinya	pɪɲa
tanauan	tɐnʔawɐn
determinasyon	deteɾmɪnɐʃon
hasik	hɐsik
mabini	mɐbinɪʔ
dalubhayupan	dɐlubhɐjupɐn
kolonyalismo	kxoloɲɐlismo
lagmak	lɐɡmak
mallari	mɐljaɾɪ
lugo	lʊɰo
hilaw	hɪlaʊ̯
alaskador	ʔɐlɐskɐdoɾ
galauran	ɡɐlɐʔuɾɐn
agas	ʔɐɰas
lathala	lɐthɐlaʔ
alusema	ʔɐlʊsemɐ
tambakol	tɐmbaxol
langkaan	lɐŋkaʔɐn
lubigan	lʊbiɰɐn
inaaban	ʔɪnɐʔɐban
aburido	ʔɐbʊɾido
himagsikan	hɪmɐɡsixɐn
kaliwanagan	kxɐlɪwɐnaɰɐn
krisantemo	kxɾɪsɐntemo
sakit	sɐxit
saba	sɐba
dagos	daɰos
lugi	luɰɪʔ
asyenda	ʔɐʃendɐ
are	ʔɐɾe
bumerang	bʊmeɾaŋ
bali	bɐliʔ
iyan	ʔɪan
dagat	daɰɐt
beysbol	beɪ̯sbol
kugon	kxʊɰon
magbubukid	mɐɡbʊbʊxid
amag	ʔamɐɡ
mahinay	mɐhinaɪ̯
wu	wʊ
alalay	ʔɐlɐlaɪ̯
koronahan	kxoɾonahɐn
tunog	tʊnoɡ
ahit	ʔɐhit
tanso	tɐnsoʔ
hilom	hɪlom
lukban	lukbɐn
maghangad	mɐɡhɐŋad
limbay	lɪmbaɪ̯
balabiga	bɐlɐbiɰɐʔ
eksaminador	ʔeksɐmɪnɐdoɾ
hikbi	hɪkbiʔ
ishay	ʔishaɪ̯
lumikha	lʊmɪkhaʔ
belhiko	belhɪxo
historyador	hɪstoɾjɐdoɾ
jumarang	d͡ʒʊmaɾɐŋ
dali	dalɪ
independensiya	ʔɪndependenʃa
siksin	sɪksin
tiyan	t͡ʃan
abuhin	ʔɐbʊhin
mabasa	mɐbɐsaʔ
danumsigwasan	dɐnʊmsɪɡwasɐn
linatsay	lɪnɐt͡ʃaɪ̯
dakota	dɐxotɐ
bangin	bɐŋin
anit	ʔɐnit
takahashi	tɐxɐhaʃɪ
impis	ʔɪmpis
cayetano	kxɐjetano
lahid	lahɪd
garahe	ɡɐɾahe
ilegalidad	ʔɪleɰɐlɪdad
hingan	hɪŋan
alkalde	ʔɐlkalde
ideal	ʔɪdejal
batangueño	bɐtɐŋɡeɲo
haruko	hɐɾuxo
dumura	dʊmʊɾaʔ
elegansiya	ʔeleɰanʃa
biskondesa	bɪskondesɐ
gumiran	ɡʊmiɾɐn
eliseo	ʔelɪsejo
leyte	leɪ̯te
halikan	hɐlɪxan
pulikat	pʊlixɐt
balubad	bɐlubɐd
lumapirot	lʊmɐpɪɾot
haha	hɐhaʔ
grasa	ɡɾasɐ
mabali	mɐbalɪʔ
astrolohiya	ʔɐstɾolohiɐ
baybayin	baɪ̯bɐjin
dalao	dalaʊ̯
dalawa	dɐlɐwa
libano	libɐno
gahaman	ɡɐhɐman
bintana	bɪntanɐʔ
batanes	bɐtanes
alabwab	ʔɐlɐbwab
abutan	ʔɐbutɐn
bagnet	bɐɡnet
angal	ʔɐŋal
asog	ʔɐsoɡ
dacanay	dɐxanaɪ̯
bakay	baxaɪ̯
dilikas	dɪlɪxas
gerilya	ɡeɾiljɐ
dismayado	dɪsmɐjado
dini	dinɪ
managinip	mɐnɐɰinɪp
capitan	kxɐpɪtan
antay	ʔɐntaɪ̯
sadie	seɪ̯dɪ
dukwang	dʊkwaŋ
hikahos	hɪxahos
buyo	bʊjo
hilam	hilɐm
kalaliman	kxɐlɐlimɐn
hapit	hɐpit
perya	peɾjɐ
linya	liɲɐ
lungaw	lʊŋaʊ̯
magdeliryo	mɐɡdeliɾjo
replyan	ɾeplɐjan
samahan	sɐmahɐn
sakali	sɐxalɪʔ
hinanakit	hɪnɐnɐxit
laman	lɐman
magbakal	mɐɡbaxɐl
lagabog	lɐɰɐboɡ
epidemya	ʔepɪdemjɐ
mayuga	mɐjuɰɐ
olongapo	ʔoloŋɐpo
abucay	ʔɐbuxaɪ̯
canilao	kxɐnilaʊ̯
gapang	ɡɐpaŋ
halang	hɐlaŋ
gasera	ɡɐseɾɐ
buhat	bʊhat
kapabayaan	kxɐpɐbɐjaan
mutuc	mutʊk
hindi	hɪndiʔ
handog	hɐndoɡ
pasonanca	pɐsonaŋkɐ
varias	baɾɪɐs
magbanda	mɐɡbandɐ
bodka	bodkɐ
dyudo	d͡ʒudo
pulo	pʊloʔ
akusado	ʔɐxʊsado
hikmat	hɪkmat
konotasyon	kxonotɐʃon
importante	ʔɪmpoɾtante
pinagsamantalahan	pɪnɐɡsɐmɐntɐlɐhan
bata	bɐta
aguilera	ʔɐɰɪleɾɐ
planeta	plɐnetɐ
kuha	kxuhɐʔ
krimen	kxɾɪmen
bugayong	bʊɰajoŋ
filipinas	fɪlɪpinɐs
bareta	bɐɾetɐ
kunwari	kxʊnwɐɾiʔ
pawis	pɐwis
initkapnayan	ʔinɪtkɐpnajɐn
lapi	lapɪʔ
batayan	bɐtɐjan
alipunga	ʔɐlɪpʊŋa
dalubwika	dɐlubwixɐʔ
baso	bɐso
huni	hunɪ
nilabasan	nɪlɐbɐsan
pako	paxoʔ
pulubi	pʊlubɪ
tala	tɐlaʔ
lamesa	lɐmesɐ
segismundo	seɰɪsmundo
k	kxeɪ̯
belarus	belaɾʊs
panelo	pɐnelo
tibig	tɪbiɡ
bikolano	bɪxolano
limas	lɪmas
ybañez	ʔɪbaɲes
pastol	pɐstol
korupsiyon	kxoɾʊpʃon
damag	dɐmaɡ
lila	lilɐ
lahok	lɐhok
baksa	bɐksaʔ
sahog	sɐhoɡ
agnas	ʔɐɡnas
bahing	bɐhiŋ
hilahil	hɪlahɪl
pangalan	pɐŋalɐn
gusto	ɡʊsto
alabastro	ʔɐlɐbastɾo
habonera	hɐboneɾɐ
hakbang	hɐkbaŋ
awak	ʔawɐk
butigan	bʊtɪɰan
pamahiin	pamɐhɪʔin
bayad	bajɐd
mental	mentɐl
dayami	dɐjamɪ
vitales	bɪtales
alpabeto	ʔɐlpɐbeto
darasigsukat	dɐɾɐsɪɡsuxɐt
lindol	lɪndol
algodon	ʔɐlɡodon
lee	lɪ
magkakarne	mɐɡkɐxɐɾne
masabon	masɐbon
bibingka	bɪbiŋkɐ
bulalakaw	bʊlɐlaxaʊ̯
mananakop	mɐnɐnaxop
pintuan	pɪntuʔɐn
quiambao	kjɐmbaʊ̯
inisyatiba	ʔɪnɪʃɐtibɐ
intensiyonal	ʔɪntensɪonal
bakbak	bɐkbak
laping	lɐpiŋ
imbalido	ʔɪmbalɪdo
direktoryo	dɪɾektoɾjo
santiago	sɐnt͡ʃaɰo
tirik	tiɾɪk
igat	ʔiɰɐt
imbentaryo	ʔɪmbentaɾjo
dayap	dajɐp
hugasan	hʊɰɐsan
bagbag	bɐɡbaɡ
gulanit	ɡʊlɐnit
konsehal	kxonsehal
ipakuha	ʔɪpɐxuhɐʔ
beripika	beɾɪpɪxa
galanggalangan	ɡɐlaŋɡɐlɐŋan
krus	kxɾʊs
konduktor	kxondʊktoɾ
reaño	ɾeɐɲo
bahin	bɐhiŋ
luslos	lʊslos
kidnaper	kxɪdnapeɾ
kumuyakoy	kxʊmʊjaxoɪ̯
bardagol	bɐɾdɐɰol
alabok	ʔɐlɐbok
bituin	bɪtuʔɪn
bingot	bɪŋot
apela	ʔɐpela
abno	ʔɐbnoʔ
bumiyahe	bʊmjɐhe
atig	ʔɐtiɡ
akin	ʔaxɪn
apresasyon	ʔɐpɾesɐʃon
luwas	lwas
itapon	ʔɪtɐpon
pipi	pɪpi
makiapid	mɐxiʔɐpid
pua	pʊɐ
kaedad	kxɐʔedad
bandeha	bɐndehɐ
lapad	lɐpad
busbos	bʊsbos
balanoy	bɐlanoɪ̯
labinlima	lɐbɪnlɪma
lutas	lʊtas
desesperasyon	desespeɾɐʃon
abwab	ʔɐbwab
linib	lɪnib
gera	ɡeɾɐ
lampik	lɐmpik
interogasyon	ʔɪnteɾoɰɐʃon
rekisito	ɾexɪsito
yaeko	jaexo
heograpiko	heoɡɾapɪxo
mamihasa	mɐmɪhasɐ
luto	lʊtoʔ
ananapla	ʔɐnɐnɐpla
butete	bʊteteʔ
kabit	kxɐbit
inag	ʔinɐɡ
maglarawan	mɐɡlɐɾawɐn
duryan	dʊɾjan
bagting	bɐɡtiŋ
galing	ɡɐliŋ
sumadsad	sʊmadsɐd
abyarin	ʔɐbjɐɾin
maangas	mɐʔɐŋas
manok	mɐnok
barong	bɐɾoŋ
dating	dɐtiŋ
akawntant	ʔɐxaʊ̯ntɐnt
cabanlit	kxɐbanlɪt
kural	kxʊɾal
gahak	ɡahɐk
ambulansiya	ʔɐmbʊlanʃa
luma	lʊma
hinay	hinaɪ̯
lumon	lʊmon
gipit	ɡɪpit
biyernes	bjeɾnes
cariñosa	kxɐɾɪɲosɐ
anubing	ʔɐnubɪŋ
kapre	kxapɾe
magalona	mɐɰɐlonɐ
lahoy	lahoɪ̯
lumay	lumaɪ̯
lalawigan	lɐlɐwiɰɐn
manarang	mɐnaɾɐŋ
luping	lupɪŋ
rehimen	ɾehɪmen
kapitan	kxɐpitɐn
sabana	sɐbanɐ
seminar	seminɐɾ
kabatuganan	kxɐbɐtʊɰanɐn
historya	hɪstoɾjɐ
alangilan	ʔɐlɐŋilɐn
magbukid	mɐɡbuxɪd
hambalos	hɐmbalos
ligwan	lɪɡwan
bangaw	bɐŋaʊ̯
gunimbilang	ɡʊnɪmbilɐŋ
mabait	mɐbɐʔit
dimagiba	dɪmɐɰibɐ
ongkiko	ʔoŋkixo
agaas	ʔaɰɐɐs
barya	bɐɾja
magbati	mɐɡbɐtiʔ
aliw	ʔɐliʊ̯
ha	hɐ
piloto	pɪloto
yosi	josɪ
isalba	ʔɪsɐlba
habag	hɐbaɡ
konstelasyon	kxonstelɐʃon
abitsuwela	ʔɐbɪt͡ʃʊelɐ
matauhan	mɐtɐʔuhɐn
consolacion	kxonsolɐʃon
tamis	tɐmis
maangas	mɐʔaŋɐs
pusod	pʊsod
eskuwela	ʔeskwelɐ
abrasyete	ʔɐbɾɐʃete
koreograpiya	kxoɾeoɡɾɐpiɐ
pulutan	pʊlutɐn
himbing	hɪmbiŋ
abutin	ʔɐbutɪn
hithitin	hɪthɪtin
agosto	ʔɐɰosto
likop	lɪxop
gayat	ɡajɐt
blusa	blusɐ
abuhan	ʔɐbʊhan
gasolina	ɡɐsolinɐ
gangsa	ɡɐŋsa
luwat	lwat
kostado	kxostado
abuhin	ʔabʊhin
adorador	ʔɐdoɾɐdoɾ
mananahi	mɐnɐnɐhiʔ
bumatik	bʊmɐtik
lunggati	lʊŋɡɐtiʔ
bingi	bɪŋiʔ
deang	d͡ʒɐŋ
diktadura	dɪktɐduɾɐ
bisita	bɪsitɐ
batyaw	bɐt͡ʃaʊ̯
bitso	bɪt͡ʃo
oportunista	ʔopoɾtʊnistɐ
gitna	ɡɪtnaʔ
lima	lɪma
ilokano	ʔɪloxano
limahi	lɪmɐhiʔ
indahin	ʔɪndɐhin
tumukso	tʊmʊkso
himpapawid	hɪmpɐpɐwid
kiling	kxilɪŋ
pizarro	pɪsaɾɾo
harapan	haɾapɐn
nabasa	nabasɐ
himas	himɐs
integridad	ʔɪnteɡɾɪdad
hintutubi	hɪntʊtʊbi
daan	dɐʔan
lathala	lɐthalɐʔ
ermitanyo	ʔeɾmɪtaɲo
eksklusibo	ʔeksklʊsibo
pagala	pɐɰalɐʔ
bahon	bɐhon
kalawang	kxɐlawɐŋ
aluminyo	ʔɐlʊmiɲo
macapagal	mɐxɐpɐɰal
baklita	bɐklitɐ
sirain	sɪɾaʔɪn
ama	ʔɐma
palasihayanan	pɐlasihɐjɐnan
tagunya	tɐɰʊɲaʔ
ipagsanggalang	ʔɪpɐɡsɐŋɡɐlaŋ
klinik	kxlɪnɪk
kakanin	kxɐxɐnin
isaw	ʔisaʊ̯
likaw	lɪxaʊ̯
demandado	demɐndado
abat	ʔɐbat
biskonde	bɪskonde
lingguwistika	lɪŋɡwistɪxa
hinhin	hɪŋhin
dapit	dapɪt
laksa	lɐksaʔ
ekipahe	ʔexɪpahe
binsa	bɪnsaʔ
dukot	duxot
hinggigitna	hɪŋɡɪɰɪtnaʔ
ambisyosa	ʔɐmbɪʃosɐ
brad	bɾɐd
anasan	ʔanasɐn
makahiya	mɐxɐhɪaʔ
balaid	bɐlɐʔid
alimuom	ʔɐlɪmʊʔom
anga	ʔɐŋa
baat	bɐʔat
hipno	hɪpno
kadyos	kxɐd͡ʒos
butse	bʊt͡ʃe
gumaling	ɡɐɰɐliŋ
aguha	ʔɐɰuhɐ
lunak	lʊnak
kaha	kxahɐ
magpasubasta	mɐɡpɐsʊbastɐ
pelikula	pelixʊla
duhagi	dʊhaɰɪ
batak	bɐtak
halimaw	hɐlimaʊ̯
bahaghari	bɐhɐɡhaɾɪʔ
olaivar	ʔolaɪ̯bɐɾ
kabuluhan	kxɐbʊlʊhan
dipasupil	dɪpɐsupɪl
alkatsopas	ʔɐlkɐt͡ʃopɐs
batukan	bɐtuxɐn
laro	lɐɾo
bartender	bɐɾtendeɾ
katangahan	kxɐtɐŋɐhan
elektrisista	ʔelektɾɪsistɐ
mamaril	mɐmaɾɪl
dapa	dɐpaʔ
imprastruktura	ʔɪmpɾɐstɾʊktuɾɐ
basanlot	bɐsɐnlot
lubyak	lʊbjak
lipas	lɪpas
hatsing	hɐt͡ʃiŋ
kanyon	kxɐɲon
martilyo	mɐɾtiljo
awat	ʔɐwat
loterya	loteɾjɐ
kunan	kxunɐn
balisacan	bɐlɪsaxɐn
dayuhan	dɐjuhɐn
hirap	hiɾɐp
anghit	ʔɐŋhit
puday	pʊdaɪ̯
haligi	hɐliɰɪ
halili	hɐlɪli
botika	botixɐ
ginoo	ɡɪnoʔo
haliryo	hɐlɪɾjo
lagumlalangin	lɐɰʊmlalaŋɪn
lona	lonɐ
langkayan	lɐŋkajɐn
kurbata	kxʊɾbatɐ
demokrasya	demokɾaʃɐ
istratehiya	ʔɪstɾɐtehiɐ
hati	hatɪʔ
basta	bastɐ
agulo	ʔɐɰulo
balakil	bɐlaxɪl
butig	bʊtiɡ
igop	ʔiɰop
gulpi	ɡʊlpi
laki	lɐxi
niyo	ɲo
ibayo	ʔɪbajo
bertdey	beɾtdeɪ̯
intensiyon	ʔɪntenʃon
himok	hɪmok
lamba	lɐmbaʔ
hardin	hɐɾdin
alagad	ʔɐlɐɰad
igkas	ʔɪɡkas
pagpag	pɐɡpaɡ
lagusan	lɐɰʊsan
balag	bɐlaɡ
tiburcio	tɪbuɾʃo
batikos	bɐtixos
kamandag	kxɐmɐndaɡ
budhi	bʊdhiʔ
kusina	kxʊsinɐ
liderato	lɪdeɾato
halungkat	hɐlʊŋkat
itsura	ʔɪt͡ʃuɾɐ
guwano	ɡwɐno
pilantik	pɪlɐntik
halata	hɐlɐtaʔ
estampa	ʔestampɐ
pagdudahan	pɐɡdʊdahɐn
palafox	pɐlafoks
laas	lɐʔas
bayag	bɐjaɡ
paguia	paɡjɐ
daplis	dɐplis
hingi	hɪŋiʔ
intsik	ʔɪnt͡ʃik
baybayin	baɪ̯bajɪn
magtalas	mɐɡtalɐs
bagsak	bɐɡsak
beripikasyon	beɾɪpɪxɐʃon
ingklusibo	ʔɪŋklʊsibo
galugad	ɡɐlʊɰad
malatala	mɐlɐtalɐʔ
ladya	lad͡ʒɐ
basagulero	bɐsɐɰʊleɾo
aparato	ʔɐpɐɾato
langayak	lɐŋɐjak
zamora	sɐmoɾɐ
surimbangkay	suɾɪmbɐŋkaɪ̯
pindot	pɪndot
lagis	lɐɰis
balisong	bɐlisoŋ
debosyon	deboʃon
kuwan	kwan
konsentidor	kxonsentɪdoɾ
sosyal	soʃal
asusena	ʔɐsʊsenɐ
bikat	bixɐt
bilasa	bɪlasɐʔ
labi	lɐbi
bubong	bʊboŋ
bansa	bɐnsa
butas	butɐs
arkitekto	ʔɐɾkɪtekto
arseniko	ʔɐɾsenɪxo
tanghalian	tɐŋhɐliʔɐn
umebak	ʔʊmebɐk
tagiliran	tɐɰɪliɾɐn
hangarin	hɐŋɐɾin
pasaway	pɐsawaɪ̯
banyuhay	bɐɲʊhaɪ̯
kamatayan	kxɐmɐtajɐn
bukid	buxɪd
davao	dabaʊ̯
likom	lɪxom
lakdang	lɐkdaŋ
puyod	pʊjod
nanlilimahid	nɐnlɪlɪmahɪd
binibini	bɪnɪbinɪ
mindanaw	mɪndanaʊ̯
bagama't	bɐɰɐmat
lumaya	lʊmajɐʔ
piskal	pɪskal
kilikili	kxɪlɪxilɪ
detonasyon	detonɐʃon
gambagamba	ɡɐmbaɰɐmba
angkan	ʔɐŋkan
eksklusyon	ʔeksklʊʃon
inhinyero	ʔɪŋhɪɲeɾo
bangkiling	bɐŋkɪliŋ
lambot	lɐmbot
amas	ʔɐmas
herarkiya	heɾɐɾkiɐ
militante	mɪlɪtante
gastusin	ɡɐstusɪn
ikabit	ʔɪxɐbit
alimis	ʔɐlɪmis
birimbaw	bɪɾɪmbaʊ̯
cahinaan	kxɐhɪnaʔɐn
lorenzana	loɾensanɐ
desimpeksiyon	desɪmpekʃon
arenas	ʔɐɾenɐs
hantikan	hɐntixɐn
michelena	mɪt͡ʃelenɐ
pagdilao	pɐɡdilaʊ̯
hanga	haŋɐʔ
dalubkatawan	dɐlubkɐtɐwan
diborsiyo	dɪboɾʃo
barumbado	bɐɾumbado
eskultor	ʔeskʊltoɾ
bantay	bɐntaɪ̯
dyaryo	d͡ʒaɾjo
malabuntala	mɐlɐbʊntalɐʔ
hiwas	hɪwas
angas	ʔɐŋas
dingig	dɪŋiɡ
eskandaloso	ʔeskɐndɐloso
laray	laɾaɪ̯
gisi	ɡɪsiʔ
damo	dɐmo
kerubin	kxeɾʊbin
bangkarote	bɐŋkɐɾote
salazar	sɐlɐsaɾ
graba	ɡɾabɐ
bilibid	bɪlibɪd
palayan	pɐlɐjan
balnian	bɐlniʔɐn
alulong	ʔɐlʊloŋ
domino	domɪno
tala	talɐʔ
lapurit	lɐpuɾɪt
lumuwag	lʊmwaɡ
ligaya	lɪɰajɐ
iyo	ʔɪo
hugasan	hʊɰasɐn
mangamba	mɐŋɐmba
insentibo	ʔɪnsentibo
balita	bɐlitɐʔ
dimacali	dɪmɐxalɪ
malihan	mɐlihɐn
tiyanak	t͡ʃanɐk
catral	kxatɾɐl
kambas	kxambɐs
butil	butɪl
ortega	ʔoɾteɰɐ
maneho	mɐneho
biya	bjaʔ
politiko	politɪxo
udyukan	ʔʊd͡ʒʊxan
lipunan	lɪpʊnan
mamuyac	mɐmujɐk
buling	bulɪŋ
nakamulaga	nɐxɐmʊlɐɰaʔ
lagaylay	lɐɰaɪ̯laɪ̯
ita	ʔitɐ
ragsak	ɾɐɡsak
balikwas	bɐlɪkwas
brodkaster	bɾodkɐsteɾ
tiamson	t͡ʃamson
sinturon	sɪntʊɾon
langgotse	lɐŋɡot͡ʃe
isangla	ʔɪsɐŋlaʔ
arestado	ʔɐɾestado
ipangako	ʔɪpɐŋaxoʔ
bahagan	bɐhɐɰan
estasyon	ʔestɐʃon
casal	kxasɐl
ligoy	liɰoɪ̯
akademya	ʔɐxɐdemjɐ
laga	laɰɐʔ
baynilya	baɪ̯niljɐ
hawa	hawɐʔ
baga	baɰɐʔ
bantil	bɐntil
binta	bintɐ
konseho	kxonseho
gamboa	ɡɐmboɐ
liwanag	lɪwanɐɡ
peke	pexeʔ
bagyuhin	bɐɡjʊhin
borlas	boɾlɐs
mahalaga	mɐhɐlɐɰa
kadugo	kxɐdʊɰoʔ
guzman	ɡʊsman
lozada	losadɐ
kangkungan	kxɐŋkuŋɐn
manabat	mɐnabɐt
pananawagan	pɐnɐnɐwaɰɐn
mabalot	mɐbalot
kutsara	kxʊt͡sɐɾɐ
likop	lixop
ligalig	lɪɰalɪɡ
dokumentaryo	doxʊmentaɾjo
kimiko	kximɪxo
astaka	ʔɐstaxɐʔ
likuran	lɪxʊɾan
babaan	bɐbɐʔan
galaiti	ɡɐlɐʔitɪ
ampaw	ʔɐmpaʊ̯
imbento	ʔɪmbento
aranya	ʔɐɾɐɲa
paa	pɐʔa
daktinig	dɐktinɪɡ
hinayupak	hɪnɐjupɐk
mansanas	mɐnsanɐs
la	lɐ
hinlalato	hɪnlɐlatoʔ
bibliya	biblja
kamangmangan	kxɐmɐŋmɐŋan
araw	ʔɐɾaʊ̯
ulnungkuro	ʔʊlnʊŋkuɾoʔ
ponema	ponemɐ
bilangan	bɪlɐŋan
trangkaso	tɾɐŋkaso
kiyampong	kjɐmpoŋ
pakla	pɐkla
landrito	lɐndɾito
magtalo	mɐɡtalo
pag	pɐɡ
sumemplang	sʊmemplɐŋ
isyu	ʔiʃʊ
kalansay	kxɐlɐnsaɪ̯
barquilla	bɐɾkiljɐ
lusay	lʊsaɪ̯
samaniego	sɐmɐɲeɰo
aam	ʔɐʔam
huk	hʊk
fung	fʊŋ
halimuyak	hɐlɪmujɐk
ragudo	ɾɐɰudo
gawak	ɡawɐk
imperensiya	ʔɪmpeɾenʃa
kalabog	kxɐlɐboɡ
sinag	sinɐɡ
pananim	pɐnɐnim
alpay	ʔalpaɪ̯
olanda	ʔolandɐ
isaulo	ʔɪsɐʔulo
lusot	lʊsot
dian	dɪʔan
entusyasmo	ʔentʊʃɐsmo
lila	lilɐʔ
hanggang	hɐŋɡaŋ
isip	ʔisɪp
bukaka	bʊxɐkaʔ
adhikain	ʔɐdhɪxaʔɪn
pisngi	pɪsŋi
biyanan	bɪɐnan
saquing	saxɪŋ
deskubri	deskʊbɾi
barok	bɐɾok
alkansiya	ʔɐlkɐnʃa
malaluan	mɐlalʊɐn
wag	wɐɡ
hulog	hʊloɡ
minami	mɪnamɪ
kilates	kxɪlates
misako	mɪsaxo
maghiyas	mɐɡhɪas
pagmamadali	pɐɡmɐmɐdɐliʔ
binabasa	bɪnɐbasɐ
lamukos	lɐmuxos
magallanes	mɐɰɐljanes
dingal	diŋɐl
arañas	ʔɐɾaɲɐs
dahan	dahɐn
dumpit	dumpɪt
deskuwento	deskwento
bawang	bawɐŋ
ikalawa	ʔɪxɐlɐwa
condez	kxondes
pala	palɐ
ilustre	ʔɪlustɾe
bito	bɪtoʔ
alalay	ʔɐlalaɪ̯
insulto	ʔɪnsulto
halangan	hɐlaŋɐn
mahikaw	mɐhixaʊ̯
callao	kaʎaʊ
balete	bɐlete
asahan	ʔɐsahɐn
gilyotina	ɡɪljotinɐ
kantot	kxɐntot
eksplanasyon	ʔeksplɐnɐʃon
iskedyul	ʔɪsked͡ʒʊl
hitsura	hɪt͡ʃuɾɐ
kaagulo	kxɐʔɐɰulo
magbanua	mɐɡbanʊɐ
kalangay	kxɐlaŋaɪ̯
anonas	ʔɐnonɐs
buti	butɪ
kopya	kxopjɐ
balkonahe	bɐlkonahe
arroyo	ʔɐɾojo
gawalagad	ɡɐwɐlɐɰad
fonacier	fonasɪeɾ
anito	ʔɐnɪto
acierto	ʔɐʃeɾto
lakihan	lɐxɪhan
barikod	bɐɾɪxod
burges	bʊɾɡes
kakilala	kxɐxɪlalɐ
kumbensiyon	kxumbenʃon
dagsin	dɐɡsin
dinuguan	dɪnʊɰʊʔan
ibig	ʔibɪɡ
villablanca	bɪllɐblaŋkɐ
sawa	sawɐʔ
droga	dɾoɰɐ
kabaka	kxɐbaxɐ
katang	kxatɐŋ
husay	hʊsaɪ̯
sapok	sɐpok
sisi	sisɪ
manaog	manɐoɡ
aralin	ʔɐɾalɪn
baligtarin	bɐlɪɡtɐɾin
limon	lɪmon
dili	dilɪ
bulgaro	bʊlɡɐɾo
gaseta	ɡɐsetɐ
wala	walɐʔ
mabasa	mɐbɐsa
lata	latɐ
abandonado	ʔɐbɐndonado
seremonya	seɾemoɲɐ
masaker	mɐsaxeɾ
henerasyon	heneɾɐʃon
despedida	despedidɐ
baywang	baɪ̯waŋ
busina	bʊsinɐ
tapulaw	tɐpulaʊ̯
laquindanum	lɐxɪndanʊm
bilang	bɪlaŋ
bilanggo	bɪlɐŋɡoʔ
buwelta	bweltɐ
beki	bexɪ
inda	ʔɪndaʔ
islobenya	ʔɪslobeɲɐ
galitin	ɡɐlitɪn
natae	nɐtɐʔe
istres	ʔɪstɾes
balido	balɪdo
puyat	pʊjat
lagot	lɐɰot
dilis	dilɪs
hardinera	hɐɾdɪneɾɐ
heko	hexo
agsikap	ʔɐɡsixɐp
eskandalo	ʔeskandɐlo
agimatan	ʔɐɰɪmatɐn
aguilar	ʔɐɰɪlaɾ
bersikulo	beɾsixʊlo
brandi	bɾandɪ
hira	hɪɾaʔ
artiaga	ʔɐɾʃɐɰɐ
garupa	ɡɐɾupɐ
kabig	kxabɪɡ
lubid	lʊbid
capinpin	kxɐpinpɪn
hukot	hʊxot
igik	ʔɪɰik
haha	hahɐʔ
balino	bɐlino
parada	pɐɾadɐ
himbak	hɪmbak
bihis	bihɪs
nako	nɐxo
himig	himɪɡ
lundo	lʊndoʔ
magbabaon	nɐɡbaʔon
aakyat	ʔɐʔɐkjat
labada	lɐbadɐ
villacarlos	bɪllɐxaɾlos
lapyad	lɐpjad
plais	plaɪ̯s
lawin	lawɪn
buhagsigan	bʊhɐɡsiɰɐn
kapsula	kxapsʊla
baklas	bɐklas
bawang	bɐwaŋ
panirahan	panɪɾahɐn
kalis	kxalɪs
diitan	dɪʔɪtan
lapat	lɐpat
lubot	lʊbot
miyuki	mjʊxɪ
digmaan	dɪɡmaʔɐn
baluyot	bɐlujot
magpaubaya	mɐɡpaʊ̯bajɐʔ
karupukan	kxɐɾʊpʊxan
maglalako	mɐɡlɐlaxoʔ
lubo	lʊboʔ
baunan	bɐʔʊnan
plawta	plaʊ̯tɐ
ibabaw	ʔɪbabaʊ̯
baklain	bɐklaʔɪn
insidente	ʔɪnsɪdente
daing	dɐʔiŋ
lanay	lɐnaɪ̯
hawayano	hɐwɐjano
awtorisasyon	ʔotoɾɪsɐʃon
iyan	jɐn
dipolog	dɪpoloɡ
puwes	pwes
hari	haɾɪ
halimbawa	hɐlɪmbawɐʔ
basuka	bɐsuxɐ
durugista	dʊɾʊɰistɐ
macaspac	mɐxaspɐk
abayan	ʔɐbajɐn
manghalik	mɐŋhɐlik
tinda	tindɐ
ganap	ɡɐnap
villavicencio	bɪllɐbɪsenʃo
isisi	ʔɪsisɪ
parusa	pɐɾusɐ
hoy	hoɪ̯
peklat	peklɐt
langib	lɐŋib
inspeksiyunin	ʔɪnspeksɪʊ̯nin
buod	bʊʔod
eskinita	ʔeskɪnitɐ
perera	peɾeɾɐ
bakit	baxɪt
villaverde	bɪllɐbeɾde
lohuwa	lohʊa
ampunan	ʔɐmpʊnan
lait	laʔɪt
bombero	bumbeɾo
gimik	ɡimɪk
macalindong	mɐxɐlindoŋ
kabiling	kxɐbilɪŋ
hugot	hʊɰot
kartero	kxɐɾteɾo
kondisyoner	kxondɪʃoneɾ
labuyo	lɐbujoʔ
liberalisasyon	lɪbeɾɐlɪsɐʃon
magbababoy	mɐɡbɐbɐboɪ̯
karakter	kxaɾɐkteɾ
irlanda	ʔɪɾlandɐ
kemikal	kxemɪxal
bulay	bulaɪ̯
ibahaw	ʔɪbahaʊ̯
listahan	lɪstɐhan
sakuna	sɐxʊna
instruksiyon	ʔɪnstɾʊkʃon
bentaha	bentahɐ
mulapik	mʊlapɪk
arpiya	ʔɐɾpiɐ
alahas	ʔɐlahɐs
pangako	pɐŋaxoʔ
kabarkada	kxɐbɐɾkadɐ
zuñiga	sʊɲɪɰɐ
atribido	ʔɐtɾɪbido
iskuwater	ʔɪskwɐteɾ
gansal	ɡɐnsal
isigan	ʔisiɰɐn
ehersisyo	ʔeheɾsiʃo
dawdaw	daʊ̯daʊ̯
beneswela	beneswelɐ
iyon	ʔɪon
penikula	penixʊla
init	ʔinɪt
balian	bɐliʔɐn
hamil	hamɪl
diyosa	d͡ʒosɐ
laso	lɐsoʔ
mainit	mɐʔinɪt
hawi	hɐwiʔ
arangkada	ʔɐɾɐŋkadɐ
aghambuhay	ʔɐɡhambuhaɪ̯
mabalahibo	mɐbɐlɐhibo
suot	sʊot
makulog	mɐxʊloɡ
laktaw	lɐktaʊ̯
aproba	ʔɐpɾoba
kaserola	kxɐseɾolɐ
lantak	lɐntak
salap	salɐp
dalubtalain	dɐlʊbtalain
maalintana	mɐʔɐlɪntanɐ
ambubuyog	ʔɐmbʊbujoɡ
lamat	lamɐt
isauli	ʔɪsɐʔulɪʔ
saing	saʔɪŋ
dukado	dʊxado
irlandes	ʔɪɾlɐndes
bawtisteryo	baʊ̯tɪsteɾjo
lodi	lodɪ
armalayt	ʔaɾmɐlaɪ̯t
lagikway	lɐɰɪkwaɪ̯
huli	hulɪ
lumakad	lʊmaxɐd
malbarosa	mɐlbɐɾosɐ
baluga	bɐluɰɐ
diglap	dɪɡlap
acuña	ʔɐxuɲɐ
panitikan	panɪtɪxan
iwan	ʔiwɐn
ipagawa	ʔɪpɐɰɐwaʔ
armenya	ʔɐɾmeɲɐ
katigbak	kxɐtiɡbɐk
dumagsin	dʊmɐɡsin
inday	ʔɪndaɪ̯
haling	hɐliŋ
aguhilya	ʔɐɰʊhiljɐ
montoya	montojɐ
magbihis	mɐɡbihɪs
bungkos	bʊŋkos
hatimbilang	hɐtɪmbilɐŋ
lagitlit	lɐɰɪtlit
sala	salɐ
basakay	bɐsaxaɪ̯
andaderas	ʔɐndɐdeɾɐs
habitsuwelas	hɐbɪt͡ʃʊelɐs
banda	bandɐ
britanya	bɾɪtaɲɐ
likod	lɪxod
maglalako	mɐɡlɐlɐxoʔ
insekto	ʔɪnsekto
ilohiko	ʔɪlohɪxo
gacusan	ɡɐxusɐn
gradweyt	ɡɾadweɪ̯t
busal	bʊsal
lapnis	lɐpnis
hanggan	hɐŋɡan
dayalogo	dɐjaloɰo
impakto	ʔɪmpakto
bulawan	bʊlawɐn
lapat	lapɐt
babat	babɐt
lamuymoy	lɐmʊɪmoɪ̯
kuliti	kxʊlitɪʔ
godoy	ɡodoɪ̯
almario	ʔɐlmaɾɪo
baguntao	bɐɰʊntaʔo
legazpi	leɰaspɪ
katang	kxɐtaŋ
baligtad	bɐlɪɡtad
gumalaw	ɡʊmɐlaʊ̯
tulad	tulɐd
latok	lɐtok
andora	ʔɐndoɾɐ
baang	baʔɐŋ
langal	lɐŋal
mahamog	mɐhɐmoɡ
almaden	ʔɐlmɐden
gatang	ɡatɐŋ
hilatsa	hɪlat͡ʃɐ
tamiko	tɐmixo
baluktot	bɐlʊktot
riyan	ɾjan
diskuwalipika	dɪskʊɐlɪpɪxa
humatsing	hʊmɐt͡ʃiŋ
aguho	ʔɐɰuhoʔ
granada	ɡɾɐnadɐ
biak	bɪʔak
iloko	ʔɪloxo
iskultura	ʔɪskʊltuɾɐ
k	x
mamamayan	mɐmɐmɐjan
bakunahan	bɐxʊnahɐn
asoge	ʔɐsoɰe
malibiran	mɐlɪbiɾɐn
disiotso	dɪsɪʔot͡ʃo
kapalit	kxɐpɐlit
hipnosis	hɪpnosɪs
kilusan	kxɪlusɐn
danyos	daɲos
bikig	bɪxiɡ
aprikana	ʔɐpɾɪxanɐ
laganap	lɐɰanɐp
manikin	mɐnɪxin
lalagyan	lɐlɐɡjan
nobleza	noblesɐ
artikulo	ʔɐɾtixʊlo
kalakaran	kxɐlɐxɐɾan
lelang	lelɐŋ
bakya	bɐkjaʔ
gresya	ɡɾeʃɐ
babuyan	bɐbujɐn
dalaw	dalaʊ̯
kumiko	kxʊmixo
brillantes	bɾɪljantes
impeksiyon	ʔɪmpekʃon
landas	landɐs
asngal	ʔɐsŋal
huwad	hʊad
kapon	kxɐpon
ladrilyo	lɐdɾiljo
hiram	hɪɾam
mangikil	mɐŋixɪl
gusgos	ɡʊsɡos
estruktura	ʔestɾʊktuɾɐ
interseksiyon	ʔɪnteɾsekʃon
palahaw	pɐlahaʊ̯
ligaw	lɪɰaʊ̯
saranggola	sɐɾɐŋɡolɐ
tagtuyot	tɐɡtʊjot
alkohol	ʔɐlkohol
pabor	pɐboɾ
mauleon	maʊ̯leon
binokulo	bɪnoxʊlo
madalas	mɐdɐlas
anuhin	ʔɐnʊhin
amonya	ʔɐmoɲɐ
lingad	liŋɐd
apula	ʔɐpulɐʔ
apostol	ʔɐpostol
bantayog	bɐntajoɡ
giit	ɡɪit
marupok	mɐɾʊpok
dutdutin	dʊtdʊtin
abla	ʔɐbla
apyak	ʔɐpjak
pg	pid͡ʒɪ
pinagtalunan	pɪnaɡtɐlʊnan
adyo	ʔɐd͡ʒo
tawanan	tawanɐn
apilado	ʔɐpɪlado
kastigo	kxɐstiɰo
pamahiin	pɐmɐhɪʔin
maghanda	mɐɡhɐndaʔ
implasyon	ʔɪmplɐʃon
lahad	lɐhad
dulugan	duluɰɐn
dulog	dʊloɡ
ambi	ʔɐmbiʔ
biyolon	bɪolon
kaibigan	kxaɪ̯bɪɰan
calalo	kxɐlalo
laway	lɐwaɪ̯
gumimik	ɡʊmimɪk
anor	ʔɐnoɾ
langgas	lɐŋɡas
huyad	hujɐd
basyo	bɐʃo
spg	ʔespid͡ʒɪ
ambisyon	ʔɐmbɪʃon
ikuha	ʔɪxuhɐ
papagtaluhan	papɐɡtɐluhɐn
lalagyan	lalɐɡjan
gahasa	ɡɐhasɐʔ
lagabag	lɐɰɐbaɡ
lakad	lɐxad
caguiat	kxaɡjɐt
igapos	ʔɪɰapos
hilata	hɪlatɐʔ
bataan	bɐtɐʔan
isama	ʔɪsɐmaʔ
ligalig	lɪɰɐliɡ
litang	lɪtaŋ
badayos	bɐdajos
bataw	bɐtaʊ̯
abangan	ʔɐbɐŋan
buhat	buhɐt
gabi	ɡabɪ
galagala	ɡɐlɐɰalɐ
abukay	ʔɐbʊxaɪ̯
buriko	bʊɾixo
limpa	lɪmpaʔ
dyologin	d͡ʒoloɰɪn
asta	ʔɐstaʔ
buntala	bʊntalɐʔ
kilo	kxɪloʔ
pasukan	pɐsuxɐn
kuliglig	kxʊlɪɡliɡ
lutad	lʊtad
alcaide	ʔɐlkaɪ̯de
bulkan	bʊlkan
saksihan	sɐksɪhan
bansi	bɐnsiʔ
tira	tiɾɐ
lugaw	luɰaʊ̯
labasan	labasɐn
bilugin	bɪluɰɪn
guham	ɡʊham
guwatemala	ɡʊɐtemalɐ
bumigay	bʊmɪɰaɪ̯
balingot	bɐlɪŋot
labindalawa	lɐbindɐlɐwa
garalde	ɡɐɾalde
mangilit	mɐŋilɪt
lalagukan	lɐlɐɰʊxan
laro	lɐɾoʔ
ingles	ʔɪŋɡles
kumpiska	kxumpɪska
jamisola	d͡ʒɐmɪsolɐ
initan	ʔɪnɪtan
bituka	bɪtuxɐ
ketsap	kxet͡ʃɐp
opyum	ʔopjʊm
gutay	ɡʊtaɪ̯
makatulog	mɐxɐtuloɡ
yarda	jaɾdɐ
gahak	ɡɐhak
anayad	ʔɐnajɐd
lagom	laɰom
bakulaw	bɐxulaʊ̯
banas	bɐnas
bendisyon	bendɪʃon
ip	ʔɪp
abella	ʔɐbellɐ
lonta	lontɐ
baktaw	bɐktaʊ̯
balayi	bɐlajɪ
diyeta	d͡ʒetɐ
sabon	sɐbon
basa	bɐsa
syota	ʃotɐʔ
ibay	ʔibaɪ̯
kalagitnaan	kxɐlɐɰitnɐʔɐn
lalaban	lɐlabɐn
himas	hɪmas
duhol	dʊhol
paghahabol	pɐɡhɐhabol
apila	ʔɐpɪla
balnibalngawsipatan	bɐlnɪbɐlŋaʊ̯sɪpatɐn
ignacio	ʔɪɡnaʃo
andam	ʔɐndam
denggoy	deŋɡoɪ̯
hinto	hɪntoʔ
busol	bʊsol
bantiti	bɐntitɪʔ
dahil	dahɪl
gala	ɡalɐʔ
disisais	dɪsɪsɐʔis
dampa	dɐmpaʔ
labi	labɪʔ
aywan	ʔewɐn
hango	hɐŋoʔ
peninsula	peninsʊla
macababbad	mɐxɐbabbɐd
biglaan	bɪɡlaʔɐn
benepisyaryo	benepɪʃɐɾjo
diwang	diwɐŋ
tugade	tʊɰade
alambre	ʔɐlambɾe
propesyonal	pɾopeʃonal
dyip	d͡ʒɪp
intindihin	ʔɪntɪndɪhin
bunso	bʊŋsoʔ
konsumido	kxonsʊmido
aprikot	ʔapɾɪxot
bait	bɐʔit
inano	ʔɪnanoʔ
biaya	biɐjɐʔ
magbibigas	mɐɡbɪbɪɰas
bula	bʊlaʔ
malisyoso	mɐlɪʃoso
camiguin	kxɐmɪɰin
atenas	ʔɐtenɐs
gadya	ɡɐd͡ʒa
akba	ʔakbɐ
siping	sipɪŋ
linaw	linaʊ̯
abenida	ʔɐbenidɐ
nganga	ŋɐŋa
tumbalik	tumbalɪk
sabunutan	sɐbʊnutɐn
bunsod	bʊnsod
sisihan	sɪsɪhan
talavera	tɐlɐbeɾɐ
balda	baldɐ
biskuwit	bɪskwit
maalon	maɐlon
anomalya	ʔɐnomɐlja
ketongin	kxetoŋɪn
depresasyon	depɾesɐʃon
banos	bɐnos
abenturero	ʔɐbentʊɾeɾo
limpik	lɪmpik
libtos	lɪbtos
hiroko	hɪɾoxo
lakwatsa	lɐkwat͡ʃɐ
libak	lɪbak
isakay	ʔɪsaxaɪ̯
aksaya	ʔɐksɐja
lalanghutan	lɐlɐŋhutɐn
imahinasyon	ʔɪmɐhɪnɐʃon
maghabla	mɐɡhɐbla
kasuy	kxɐsuɪ
regala	ɾeɰalɐ
laboy	laboɪ̯
bandurya	bɐnduɾjɐ
ihaw	ʔihaʊ̯
galakgak	ɡɐlɐkɡak
biha	bihɐ
kaplastikan	kxɐplɐstɪxan
kasalungat	kxɐsɐlʊŋat
idealismo	ʔɪdejɐlismo
durog	dʊɾoɡ
sampaloc	sɐmpalok
brodkast	bɾodkɐst
malindol	mɐlɪndol
tirada	tɪɾadɐ
eskriba	ʔeskɾibɐ
lakbay	lɐkbaɪ̯
dalag	dɐlaɡ
caparas	kxɐpaɾɐs
guho	ɡʊhoʔ
balangay	bɐlɐŋaɪ̯
kagitingan	kxɐɰɪtiŋɐn
dugong	duɰoŋ
litak	lɪtak
hototay	hototaɪ̯
angaw	ʔaŋaʊ̯
bigwas	bɪɡwas
hiling	hɪliŋ
pintakasi	pɪntɐxasɪ
tumae	tʊmaʔe
binting	bɪntiŋ
villaseñor	bɪllɐseɲoɾ
iso	ʔɪso
pensiyonado	penʃonado
daluyong	dɐlujoŋ
ipagbilin	ʔɪpɐɡbilɪn
lango	lɐŋo
bakod	baxod
hagulgol	hɐɰʊlɡol
halaga	hɐlɐɰa
dekwat	dekwɐt
estapa	ʔestapɐ
hain	haʔɪn
gitata	ɡɪtɐtaʔ
hagak	hɐɰak
malta	maltɐ
atang	ʔatɐŋ
bughaw	bʊɡhaʊ̯
bumitiw	bʊmɪtiʊ̯
gahasa	ɡɐhɐsaʔ
aling	ʔalɪŋ
custodio	kxʊstod͡ʒo
gambala	ɡɐmbalɐʔ
gaffud	ɡaffʊd
bilyon	bɪljon
quisumbing	kxɪsumbɪŋ
yan	jɐn
hunos	hʊnos
ikatlo	ʔɪxɐtlo
mamigay	mɐmiɰaɪ̯
alonto	ʔɐlonto
baliling	bɐlɪliŋ
virata	bɪɾatɐ
babasagin	bɐbɐsaɰɪn
magdede	mɐɡdede
mangobra	mɐŋobɾɐ
adbokasiya	ʔɐdboxɐsiɐ
laba	lɐbaʔ
isnabera	ʔɪsnɐbeɾɐ
imahe	ʔɪmahe
helikoptero	helɪxopteɾo
aras	ʔaɾɐs
hung	hʊŋ
sobrepeña	sobɾepeɲɐ
halaan	hɐlaʔɐn
gatlang	ɡɐtlaŋ
basahin	bɐsahɪn
ebak	ʔebɐk
akit	ʔaxɪt
lungkot	lʊŋkot
ligata	lɪɰatɐʔ
coo	kxʊ
bidbiran	bɪdbiɾɐn
manang	manɐŋ
atendido	ʔɐtendido
barik	baɾɪk
iba	ʔɪba
franco	fɾaŋko
hanako	hɐnaxo
pagtawanan	paɡtɐwanɐn
lipumpon	lɪpumpon
atungal	ʔɐtuŋɐl
agaas	ʔɐɰɐʔas
kiko	kxixo
tabla	tɐbla
asido	ʔasɪdo
hagibis	hɐɰibɪs
magbasa	mɐɡbɐsaʔ
adik	ʔadɪk
hipno	hɪpnoʔ
iting	ʔitɪŋ
agbarugan	ʔɐɡbɐɾuɰɐn
manuntok	mɐnʊntok
dakol	dɐxol
diko	dixo
lambo	lɐmbo
gilid	ɡilɪd
bosnya	bosɲɐ
mamakyaw	mɐmakjaʊ̯
bumagyo	bʊmɐɡjo
alugin	ʔɐlʊɰin
tuba	tʊbaʔ
kasalanan	kxɐsɐlanɐn
gigil	ɡiɰɪl
aguda	ʔɐɰudɐ
guwantes	ɡwɐntes
mabolo	mɐbolo
almuwada	ʔɐlmwɐdɐ
lusok	lʊsok
lanaw	lɐnaʊ̯
lungas	lʊŋas
anak	ʔanɐk
segui	seɰɪ
roxas	ɾohɐs
kanduli	kxɐndulɪʔ
makina	maxɪnɐ
banyos	bɐɲos
himatay	hɪmɐtaɪ̯
agalya	ʔɐɰaljɐ
bigtiin	bɪɡtɪʔin
banyas	bɐɲas
hupiter	hupɪteɾ
litik	litɪk
disenteriya	dɪsenteɾiɐ
hayok	hɐjok
barberya	bɐɾbeɾja
lambitin	lɐmbitɪn
awang	ʔɐwaŋ
magbabalot	mɐɡbɐbɐlot
kikyam	kxɪkjam
atsoy	ʔɐt͡ʃoɪ̯
landit	lɐndit
linga	lɪŋa
bilog	bɪloɡ
barado	bɐɾado
damak	dɐmak
inat	ʔɪnat
hanapbuhay	hɐnɐpbuhaɪ̯
latik	lɐtik
bentilasyon	bentɪlɐʃon
kristiyanismo	kxɾɪstɪɐnismo
manliligaw	mɐnlɪliɰaʊ̯
ganiyan	ɡɐɲan
kalandak	kxɐlɐndak
depensahan	depensɐhan
lukban	lʊkban
punerarya	pʊneɾaɾjɐ
duldol	dʊldol
libay	lɪbaɪ̯
interbiyu	ʔinteɾbju
mindanao	mɪndanaʊ̯
lamba	lɐmba
buklaw	bʊklaʊ̯
amoranto	ʔɐmoɾanto
gabya	ɡabjɐ
doktrina	doktɾinɐ
lawlaw	laʊ̯laʊ̯
manamantala	mɐnɐmɐntɐla
adopsyon	ʔɐdopʃon
gayumahin	ɡɐjʊmahɪn
garil	ɡaɾɪl
akurdiyon	ʔɐxʊɾd͡ʒon
edisyon	ʔedɪʃon
hira	hiɾɐ
bilyaran	bɪljaɾɐn
magbisikleta	mɐɡbɪsɪkletɐ
bumulong	bʊmʊloŋ
awak	ʔɐwak
bikaryo	bɪxaɾjo
dilawan	dɪlawɐn
bersiyon	beɾʃon
ata	ʔatɐʔ
dabarkads	dabɐɾkads
antilope	ʔɐntilope
libingan	lɪbɪŋan
mantika	mɐntixɐʔ
abueg	ʔɐbweɡ
espada	ʔespadɐ
bus	bɐs
gitla	ɡɪtlaʔ
lata	lɐtaʔ
saway	sawaɪ̯
malicsi	mɐliksɪ
usman	ʔusmɐn
bantiti	bɐntɪtiʔ
maagap	mɐʔaɰɐp
dekada	dexadɐ
eskapularyo	ʔeskɐpʊlaɾjo
añonuevo	ʔɐɲonuebo
talunan	tɐlʊnan
dokumento	doxʊmento
antok	ʔɐntok
langitngit	lɐŋɪtŋit
acorda	ʔɐxoɾdɐ
lako	laxoʔ
dalawin	dɐlawɪn
malubak	mɐlʊbak
batas	bɐtas
lapuz	lapʊs
lutas	lutɐs
demolisyon	demolɪʃon
dalahikan	dɐlɐhixɐn
kasingkahulugan	kxɐsɪŋkɐhʊlʊɰan
kahero	kxɐheɾo
breslavia	bɾeslabjɐ
isnabin	ʔɪsnɐbin
adidas	ʔɐdidɐs
gutom	ɡʊtom
alam	ʔalɐm
gaslaw	ɡɐslaʊ̯
niyog	ɲoɡ
dilawan	dɪlɐwan
lula	lʊlaʔ
iritasyon	ʔɪɾɪtɐʃon
kampeonato	kxɐmpeonato
lumayo	lʊmajoʔ
asenso	ʔɐsenso
cacdac	kxakdɐk
angkat	ʔɐŋkat
ilap	ʔɪlap
peninsulares	peninsʊlaɾes
imahen	ʔɪmahen
manigarilyo	mɐnɪɰɐɾiljo
indibidwalismo	ʔɪndɪbɪdwɐlismo
bato	bɐto
lulot	lʊlot
menorca	menoɾkɐ
heswita	heswitɐ
datapwa	dɐtɐpwaʔ
gumapang	ɡʊmapɐŋ
balana	bɐlɐnaʔ
luzuriaga	lʊsʊɾjaɰɐ
gotiko	ɡotɪxo
balakid	bɐlɐxid
koredor	kxoɾedoɾ
kondom	kxondom
diris	diɾɪs
kuba	kxubɐʔ
pagtakpan	pɐɡtɐkpan
aw	ʔaʊ̯
apaw	ʔapaʊ̯
gunaw	ɡʊnaʊ̯
higante	hɪɰante
dilaan	dɪlaʔɐn
kampeon	kxɐmpeon
mananahi	mɐnɐnahɪʔ
kemistri	kxemɪstɾi
iskul	ʔɪskul
imbita	ʔɪmbɪta
inggo	ʔɪŋɡoʔ
likha	lɪkhaʔ
saha	sahɐʔ
arquiza	ʔɐɾkisɐ
crisostomo	kxɾɪsostomo
tigas	tɪɰas
buya	bujɐʔ
gusgusin	ɡʊsɡusɪn
biyolin	bɪolin
katakawan	kxɐtɐxawɐn
bolta	boltɐ
intindi	ʔɪntɪndi
ninang	ninɐŋ
umawit	ʔʊmawɪt
tupa	tupɐ
bituin	bɪtwin
lumanglas	lʊmaŋlɐs
astig	ʔɐstiɡ
baritono	bɐɾɪtono
kupas	kxʊpas
ubasan	ʔʊbɐsan
layno	laɪ̯no
kalusugan	kxɐlʊsʊɰan
hatsuko	hɐt͡ʃuxo
hinlalaki	hɪnlɐlɐxi
impinitibo	ʔɪmpɪnɪtibo
kaklase	kxɐklase
indignasyon	ʔɪndɪɡnɐʃon
desilitro	desɪlitɾo
inuman	ʔɪnʊman
lipas	lipɐs
iwak	ʔiwɐk
gayundin	ɡɐjʊndin
buntonghininga	bʊntoŋhɪnɪŋa
babaero	bɐbɐʔeɾo
gulyasan	ɡʊljasɐn
cagayan	kxɐɰɐjan
bagang	bɐɰaŋ
awtorisado	ʔaʊ̯toɾɪsado
limlim	lɪmlim
giwang	ɡiwɐŋ
halang	halɐŋ
agihap	ʔɐɰihɐp
balikan	balixɐn
bagay	baɰaɪ̯
bumuwelta	bʊmweltɐ
dingding	dɪŋdiŋ
pugo	puɰoʔ
libumbon	lɪbumbon
luha	luhɐʔ
dakip	dɐxip
tas	tɐs
gaong	ɡɐʔoŋ
arya	ʔaɾjɐ
tubuhan	tʊbʊhan
plakard	plaxɐɾd
manghuhula	mɐŋhʊhulɐʔ
diyan	dɪʔan
buli	bulɪ
madyong	mɐd͡ʒoŋ
alala	ʔɐlɐla
ligwak	lɪɡwak
humirap	hʊmiɾɐp
bilabila	bɪlɐbɪla
dijamco	dɪd͡ʒamko
bayani	bɐjanɪ
pagtalunan	pɐɡtɐlunɐn
talampas	tɐlampɐs
manginginom	mɐŋɪŋinom
narvaez	nɐɾbaes
kaaway	kxaɐwaɪ̯
dati	datɪ
tulay	tulaɪ̯
kabinet	kxabɪnet
pagkabuhay	pɐɡkɐbʊhaɪ̯
bakat	bɐxat
anib	ʔanɪb
inom	ʔɪnom
asap	ʔasɐp
dungaw	duŋaʊ̯
labinsiyam	lɐbinʃam
calauang	kxɐlawɐŋ
doktora	doktoɾɐ
lanta	lɐnta
balinguyngoy	bɐlɪŋʊɪŋoɪ̯
bobadilla	bodɐbiljɐ
litratista	lɪtɾɐtistɐ
maghimutok	mɐɡhɪmʊtok
banlian	bɐnlɪʔan
lugaw	lʊɰaʊ̯
bukadkad	bʊxɐdkad
baliko	bɐlɪxoʔ
kata	kxɐtaʔ
ulila	ʔʊlilɐ
agrabyado	ʔɐɡɾɐbjado
patnubay	pɐtnubaɪ̯
piraso	pɪɾaso
daginding	dɐɰɪndiŋ
aligi	ʔɐlɪɰi
andaya	ʔɐndajɐ
sihayan	sɪhajɐn
layak	lɐjak
misyon	mɪʃon
ligamento	lɪɰɐmento
pumula	pʊmʊla
anibersaryo	ʔɐnɪbeɾsaɾjo
lasaw	lasaʊ̯
halea	haleɐ
adelpa	ʔɐdelpɐ
nilabhan	nɪlɐbhan
igib	ʔɪɰib
komplikasyon	kxumplɪxɐʃon
himpilan	hɪmpilɐn
diperensiya	dɪpeɾenʃa
agwardiyente	ʔɐɡwɐɾd͡ʒente
apaw	ʔɐpaʊ̯
sampan	sɐmpan
alapaw	ʔɐlapaʊ̯
antabay	ʔɐntabaɪ̯
dili	dilɪʔ
maganap	mɐɰɐnap
deskripsiyon	deskɾɪpʃon
magsugal	mɐɡsʊɰal
dalmasya	dɐlmaʃɐ
leung	ljʊŋ
lambo	lɐmboʔ
magpanatili	mɐɡpɐnɐtilɪ
paragas	pɐɾaɰɐs
cabasag	kxɐbasɐɡ
malaswa	mɐlɐswaʔ
dominado	domɪnado
alba	ʔalbɐ
hapak	hɐpak
kunat	kxunɐt
dahop	dɐhop
bunggalo	bʊŋɡɐlo
likas	lɪxas
sige	sɪɰe
magnetiko	mɐɡnetɪxo
pugon	pʊɰon
gulaman	ɡʊlamɐn
mabasa	mabɐsaʔ
magbobote	mɐɡbobote
litsiyas	lɪt͡ʃiɐs
banli	bɐnliʔ
dimaranan	dɪmɐɾanɐn
abako	ʔɐbɐxo
balasubas	bɐlɐsubɐs
awayin	ʔɐwajɪn
batingting	bɐtɪŋtiŋ
gusi	ɡusɪʔ
intoksikasyon	ʔɪntoksɪxɐʃon
alamid	ʔɐlɐmid
istante	ʔɪstante
inahin	ʔɪnɐhin
bangkukang	bɐŋkuxɐŋ
bandalismo	bɐndɐlismo
lampin	lɐmpin
apir	ʔɐpiɾ
albarikoke	ʔɐlbɐɾɪxoke
shabu	ʃɐbu
likat	lɪxat
aninag	ʔɐninɐɡ
hintuturo	hɪntʊtuɾoʔ
baclig	baklɪɡ
bilaok	bɪlaʔok
balaho	bɐlɐhoʔ
bilangin	bilɐŋin
layaw	lajaʊ̯
landas	lɐndas
disisiyete	dɪsɪʃete
ibili	ʔɪbɪli
isulat	ʔɪsulɐt
butas	bʊtas
gambang	ɡɐmbaŋ
kaibigan	kxaɪ̯biɰɐn
pagbabasa	pɐɡbɐbɐsaʔ
lusaw	lusaʊ̯
diyabetiko	dɪɐbetɪxo
gulangan	ɡʊlɐŋan
liberal	lɪbeɾal
hukot	huxot
ada	ʔadɐ
buwisan	bʊɪsan
disyembre	dɪʃembɾe
adisyunal	ʔɐdɪʃʊnal
bilangin	bɪlaŋɪn
abok	ʔɐbok
abuso	ʔɐbuso
hopya	hopjɐʔ
suico	suɪxo
tanauan	tɐnawɐn
diyes	d͡ʒɪs
hipag	hipɐɡ
lingkaw	lɪŋkaʊ̯
propesyonalismo	pɾopeʃonɐlismo
limot	lɪmot
husi	husɪ
sulsol	sʊlsol
buan	bʊɐn
analisis	ʔɐnalɪsis
alma	ʔɐlma
hanayan	hɐnɐjan
kabinian	kxɐbɪniʔɐn
abilo	ʔɐbilo
intriga	ʔɪntɾiɰɐ
edipisyo	ʔedɪpiʃo
iliw	ʔilɪʊ̯
alit	ʔalɪt
bisa	bisɐ
iwanan	ʔɪwanɐn
barumbada	bɐɾumbadɐ
palakol	pɐlɐxol
bigti	bɪɡtiʔ
batis	batɪs
kailan	kxelɐn
linisan	lɪnisɐn
luntian	lʊntɪʔan
lohiko	lohɪxo
balaw	balaʊ̯
hortaleza	hoɾtɐlesɐ
tuason	twɐson
punzalan	pʊnsalɐn
salapi	sɐlɐpiʔ
bata	batɐ
pamalo	pɐmaloʔ
gumi	ɡumɪʔ
husto	hʊsto
labak	lɐbak
mangingisda	mɐŋɪŋɪsdaʔ
atayin	ʔɐtɐjin
loa	loʔɐ
lukba	lʊkbaʔ
olayvar	ʔolaɪ̯bɐɾ
sanitaryo	sɐnɪtaɾjo
ipis	ʔipɪs
aspeto	ʔɐspeto
babaylan	bɐbaɪ̯lan
lansina	lɐnsinɐʔ
bag	bɐɡ
disiplinado	dɪsɪplɪnado
tañada	tɐɲɐdɐ
palansak	pɐlɐnsak
salvacion	sɐlbasɪon
halari	hɐlaɾɪʔ
ano	ʔɐno
palacol	pɐlaxol
balabag	bɐlɐbaɡ
komposisyon	kxumposɪʃon
apak	ʔapɐk
gawad	ɡawɐd
balikat	bɐlixɐt
madulas	madʊlas
langkaw	lɐŋkaʊ̯
distinggido	dɪstɪŋɡido
basa	basɐ
selang	selɐŋ
gabay	ɡɐbaɪ̯
ampon	ʔɐmpon
kursonada	kxʊɾsonadɐ
silayan	sɪlajɐn
barkilyos	bɐɾkiljos
kalamba	kxɐlɐmbaʔ
ipamigay	ʔɪpɐmɪɰaɪ̯
ango	ʔɐŋo
guyana	ɡʊjanɐ
bubwit	bʊbwit
sapatos	sɐpatos
mambabae	mɐmbɐbaʔe
gabok	ɡɐbok
italyana	ʔɪtɐljanɐ
tugtugin	tʊɡtʊɰin
magabok	mɐɰɐbok
suka	suxɐ
litwanya	lɪtwaɲɐ
ganid	ɡanɪd
maarte	mɐʔaɾte
lunsod	lʊnsod
magbabakal	mɐɡbɐbaxɐl
abutan	ʔabutɐn
atraso	ʔɐtɾaso
balintataw	bɐlɪntɐtaʊ̯
banat	banɐt
lati	latɪʔ
tibay	tibaɪ̯
calinisan	kxɐlɪnisɐn
apid	ʔɐpid
montealegre	monteɐleɡɾe
martinez	mɐɾtines
kroni	kxɾonɪ
amin	ʔamɪn
buwakaw	bwɐxaʊ̯
hinas	hinɐs
sibuyas	sɪbujɐs
apihin	ʔɐpɪhin
aral	ʔɐɾal
lapulapu	lapʊlapʊ
balngawsipat	bɐlŋaʊ̯sipɐt
hesukristo	hesʊkɾisto
kalantas	kxɐlɐntas
linga	lɪŋaʔ
argolya	ʔɐɾɡoljɐ
ekonomiya	ʔexonomiɐ
buga	buɰɐʔ
coting	kxotiŋ
habubos	hɐbubos
abyasyon	ʔɐbjɐʃon
baon	bɐʔon
bulingbuling	bʊlɪŋbulɪŋ
idyota	ʔɪd͡ʒotɐ
husgahan	hʊsɡɐhan
ari	ʔɐɾi
gamutin	ɡɐmʊtin
adbiyento	ʔɐdbjento
hipan	hipɐn
mabagal	mɐbaɰɐl
lana	lanɐ
darak	dɐɾak
pagkapangulo	pɐɡkapɐŋulo
ganyan	ɡɐɲan
basura	bɐsuɾɐ
deregulasyon	deɾeɰʊlɐʃon
delegado	deleɰado
bastardo	bɐstaɾdo
wari	waɾɪʔ
gupo	ɡʊpoʔ
buhagsigwasan	bʊhɐɡsɪɡwasɐn
alaga	ʔɐlaɰɐʔ
hustisya	hʊstiʃɐ
pirurutong	pɪɾʊɾutoŋ
palitadahan	pɐlɪtɐdahɐn
alpay	ʔɐlpaɪ̯
dispensa	dɪspensɐ
humuthot	hʊmʊthot
burara	bʊɾaɾɐʔ
batutay	bɐtutaɪ̯
rodrigo	ɾodɾiɰo
aba	ʔɐba
higit	hɪɰit
debatista	debɐtistɐ
aroskaldo	ʔɐɾoskaldo
guya	ɡujɐʔ
arogante	ʔɐɾoɰante
sahagun	sɐhaɰʊn
gapi	ɡapɪʔ
harang	haɾɐŋ
ipagmalaki	ʔɪpɐɡmɐlɐxi
pahintulot	pɐhɪntulot
talunan	talʊnan
maghanapbuhay	mɐɡhɐnɐpbuhaɪ̯
kerosin	kxeɾosin
balbal	bɐlbal
korporasyon	kxoɾpoɾɐʃon
inuman	ʔinumɐn
labaw	labaʊ̯
mang	mɐŋ
kulungan	kxʊluŋɐn
litson	lɪt͡ʃon
justiniano	hʊstɪɲɐno
inat	ʔinɐt
salamat	sɐlamɐt
dirihible	dɪɾɪhible
mga	mɐŋa
gahaman	ɡɐhamɐn
karuwagan	kxɐɾʊɐɰan
hapdi	hɐpdiʔ
bunyi	bʊɲiʔ
igkasin	ʔɪɡkasɪn
olaguer	ʔolaɰeɾ
batag	bɐtaɡ
abyugin	ʔɐbjʊɰin
kuto	kxuto
hagilap	hɐɰilɐp
alaga	ʔɐlɐɰaʔ
lastag	lɐstaɡ
maglaso	mɐɡlaso
layo	lɐjoʔ
interyor	ʔɪnteɾjoɾ
ilegal	ʔɪleɰal
pagcaliwagan	pɐɡkɐlɪwaɰɐn
kalookan	kxaloʔoxan
umepal	ʔʊmepɐl
establisimyento	ʔestɐblɪsɪmjento
asilo	ʔɐsilo
boluntaryo	bolʊntaɾjo
ihambing	ʔɪhɐmbiŋ
bilangguan	bɪlɐŋɡuʔɐn
akap	ʔaxɐp
dagli	dɐɡliʔ
husay	husaɪ̯
niknik	nɪknik
hingalo	hɪŋɐloʔ
butangero	bʊtɐŋeɾo
tutuli	tʊtʊli
villafuerte	bɪljɐfweɾte
portuges	poɾtʊɰes
atrebida	ʔɐtɾebidɐ
hikbi	hɪkbi
kalyo	kxaljo
kalamansi	kxɐlɐmɐnsiʔ
pagbabasa	pɐɡbɐbɐsa
gawain	ɡɐwain
mingming	mɪŋmiŋ
asam	ʔɐsam
embahada	ʔembɐhadɐ
tuloy	tuloɪ̯
kabastusan	kxɐbɐstʊsan
biyahe	bjɐhe
comia	kxomɪɐ
bayaran	bɐjaɾɐn
bangka	bɐŋkaʔ
lucena	lʊsenɐ
balagtas	bɐlɐɡtas
iba	ʔibɐ
atat	ʔɐtat
lumutang	lʊmutɐŋ
eslobakya	ʔeslobakjɐ
salba	sɐlba
galagala	ɡɐlɐɰɐla
humagikgik	hʊmɐɰɪkɡik
bigting	bɪɡtiŋ
ikalabimpito	ʔɪxɐlɐbimpɪto
admiral	ʔadmɪɾal
ligtas	lɪɡtas
abukado	ʔɐbʊxado
sipnayan	sɪpnajɐn
lemur	lemʊɾ
bahag	bɐhaɡ
hintay	hɪntaɪ̯
kurap	kxʊɾap
insubordinasyon	ʔɪnsʊboɾdɪnɐʃon
isda	ʔɪsdaʔ
gatid	ɡatɪd
konsiyensiya	kxonʃenʃa
tomiko	tomixo
hihip	hihɪp
pating	pɐtiŋ
galawgaw	ɡɐlaʊ̯ɰaʊ̯
atsi	ʔat͡ʃɪ
burak	buɾɐk
sucgang	sukɡɐŋ
bigkis	bɪɡkis
aral	ʔaɾɐl
kakapitan	kxaxɐpitɐn
limitado	lɪmɪtado
korola	kxoɾolɐ
heolohiya	heolohiɐ
bagot	bɐɰot
balisuso	bɐlɪsʊsoʔ
linggit	lɪŋɡit
impormasyon	ʔɪmpoɾmɐʃon
kailan	kxɐʔɪlan
ingreso	ʔɪŋɡɾeso
lasak	lɐsak
bagtas	bɐɡtas
huy	hʊɪ
llanera	llɐneɾɐ
garapata	ɡɐɾɐpatɐ
pansamantala	pɐnsɐmɐntɐla
lubay	lʊbaɪ̯
mangitlog	mɐŋɪtloɡ
penitensiya	penɪtenʃa
bubo	bʊbo
almohadilya	ʔɐlmohɐdiljɐ
esparago	ʔespaɾɐɰo
malikdim	mɐlikdɪm
praning	pɾanɪŋ
pakulo	pɐxʊloʔ
galapong	ɡɐlɐpoŋ
daungan	daʔuŋɐn
bangus	bɐŋus
inglesa	ʔɪŋɡlesɐ
luwag	lwaɡ
balite	bɐlite
hantong	hɐntoŋ
bigha	bɪɡhaʔ
baguhan	bɐɰuhɐn
komunista	kxomʊnistɐ
man	mɐn
konsensya	kxonsenʃɐ
babasagin	bɐbɐsɐɰin
lumapastangan	lʊmɐpɐstaŋɐn
arminyo	ʔɐɾmiɲo
bangas	baŋɐs
bulatlat	bʊlɐtlat
kesyo	kxeʃo
padrino	pɐdɾino
bakla	bɐklaʔ
magdamag	mɐɡdɐmaɡ
balnidagitab	bɐlnɪdɐɰitɐb
kelan	kxelɐn
isanggalang	ʔɪsɐŋɡɐlaŋ
busay	bʊsaɪ̯
delegasyon	deleɰɐʃon
masyado	mɐʃɐdo
pulbura	pʊlbʊɾa
bestida	bestidɐ
gising	ɡɪsiŋ
hininga	hɪnɪŋa
akwaryum	ʔɐkwaɾjʊm
hamog	hɐmoɡ
maski	mɐski
opasidad	ʔopɐsɪdad
pilapil	pɪlapɪl
basyuhin	bɐʃʊhin
emiko	ʔemixo
malabuyoc	mɐlɐbujok
kanta	kxɐnta
lapit	lɐpit
serna	seɾnɐ
busisi	bʊsisɪʔ
tuwad	tuɐd
kungyari	kxʊŋjaɾɛ
buka	bʊxa
bangcay	bɐŋkaɪ̯
ermita	ʔeɾmitɐ
disiseis	dɪsɪseʔis
ikaanim	ʔɪxɐʔanɪm
collado	kxoljado
racelis	ɾɐselɪs
limay	lɪmaɪ̯
kondimento	kxondɪmento
inis	ʔɪnis
laguyo	lɐɰujoʔ
macuha	mɐxuhɐ
kendi	kxendɪ
abiso	ʔɐbiso
balino	bɐlɪnoʔ
bosyo	boʃoʔ
buwisan	bwisɐn
hakay	hɐxaɪ̯
chiong	t͡ʃɪoŋ
henerala	heneɾalɐ
libing	lɪbiŋ
lesbiyana	lesbjɐnɐ
hangal	haŋɐl
isangkot	ʔɪsɐŋkot
salagubang	sɐlɐɰubɐŋ
matisod	mɐtisod
kabaong	kxɐbaoŋ
gagapang	ɡɐɰapɐŋ
ikadalawampu	ʔɪxɐdɐlɐwɐmpuʔ
budismo	bʊdismo
langgam	lɐŋɡam
hawa	hawɐ
lawit	lɐwit
hirit	hiɾɪt
pulahan	pʊlɐhan
limitasyon	lɪmɪtɐʃon
isil	ʔisɪl
ikit	ʔɪxit
nagbabaon	nɐɡbɐbɐʔon
grapito	ɡɾɐpito
hayku	haɪ̯xʊ
arcilla	ʔɐɾsillɐ
lapnos	lɐpnos
dumaguete	dʊmɐɰete
epistemolohiya	ʔepɪstemolohiɐ
disente	dɪsente
tetano	tetɐno
villapando	bɪllɐpando
imposible	ʔɪmposible
brotsa	bɾot͡ʃɐ
kumabig	kxʊmabɪɡ
hipolito	hɪpolito
mariñas	mɐɾiɲɐs
maggatong	mɐɡɡatoŋ
espanyola	ʔespɐɲolɐ
baraha	bɐɾahɐ
matrapik	mɐtɾapɪk
bilhan	bɪlhan
gitara	ɡɪtaɾɐ
istapador	ʔɪstɐpɐdoɾ
paupahan	paʊ̯pahɐn
kulisap	kxʊlisɐp
kunwari	kxʊnwɐɾeʔ
dagubang	dɐɰʊbaŋ
lapya	lɐpjaʔ
baybay	baɪ̯baɪ̯
babuyan	bɐbʊjan
umakyat	ʔʊmɐkjat
takal	taxɐl
kalooban	kxɐloʔobɐn
katarata	kxɐtɐɾatɐ
galang	ɡɐlaŋ
palitan	pɐlɪtan
hikayat	hɪxajɐt
aspile	ʔɐspɪle
lapig	lapɪɡ
madriaga	mɐdɾiɐɰɐ
esmeril	ʔesmeɾɪl
lomi	lomɪ
pastulan	pɐstulɐn
damuho	dɐmuhoʔ
labintador	lɐbɪntɐdoɾ
larawan	lɐɾawɐn
lalim	lalɪm
tinta	tintɐ
dalubhalmanan	dɐlubhɐlmanɐn
ligis	lɪɰis
maghikaw	mɐɡhixaʊ̯
araw	ʔaɾaʊ̯
lintik	lɪntik
dita	ditɐʔ
sawa	sɐwaʔ
kaakuhan	kxɐʔɐxuhɐn
lakdawkaphay	lɐkdaʊ̯xɐphaɪ̯
labag	lɐbaɡ
rason	ɾɐson
amperyo	ʔɐmpeɾjo
dee	dɪ
luklok	lʊklok
letra	letɾɐ
raket	ɾaxet
delikado	delɪxado
garbansos	ɡɐɾbansos
humina	hʊminɐʔ
bangkoro	bɐŋkoɾo
konsul	kxonsʊl
carillo	kxɐɾiljo
bungbong	bʊŋboŋ
hanip	hanɪp
binata	bɪnatɐʔ
presensiya	pɾesenʃa
giling	ɡɪliŋ
inodoro	ʔɪnodoɾo
ilaw	ʔilaʊ̯
charot	t͡ʃɐɾot
hiyo	hɪoʔ
lumigwak	lʊmɪɡwak
alinman	ʔɐlɪmman
bakokang	bɐxokɐŋ
guwapa	ɡwɐpɐ
infante	ʔɪmpante
lugod	lʊɰod
bulak	bulɐk
marquinez	mɐɾkines
lumibao	lʊmibaʊ̯
diksiyonaryo	dɪkʃonaɾjo
misteryoso	mɪsteɾjoso
gaguhin	ɡɐɰuhɪn
hindot	hɪndot
negosasyon	neɰosɐʃon
abestrus	ʔɐbestɾus
lali	lalɪ
laris	lɐɾis
giwa	ɡiwɐʔ
duhandas	dʊhɐndas
lamog	lɐmoɡ
ebanghelista	ʔebɐŋhelistɐ
datu	datʊ
gumagapang	ɡʊmɐɰapɐŋ
adlawan	ʔɐdlawɐn
gaga	ɡɐɰa
bighani	bɪɡhanɪʔ
nakakabingi	nɐxɐkɐbɪŋi
pangkaraniwan	pɐŋkɐɾɐniwɐn
espadahan	ʔespɐdɐhan
bakasyunista	bɐxɐʃʊnistɐ
bunggo	bʊŋɡoʔ
bacsa	baksɐ
aspalto	ʔɐspalto
lihukan	lihuxɐn
iboykot	ʔɪboɪ̯xot
delata	delatɐ
anito	ʔɐnito
ulianin	ʔʊlianɪn
apyan	ʔɐpjan
taduran	tɐduɾɐn
bayki	baɪ̯xɪ
bawa	bawɐ
luwa	luɐ
almirante	ʔɐlmɪɾante
lentehas	lentehɐs
inangit	ʔɪnɐŋit
castrence	kxɐstɾense
baway	bawaɪ̯
labas	lɐbas
buweltahan	bweltɐhan
gupiling	ɡʊpilɪŋ
gamugamo	ɡɐmuɰɐmo
dalubhasaan	dɐlʊbhɐsaʔɐn
bulalayak	bulɐlɐjak
lahi	lahɪʔ
guyam	ɡujɐm
asawa	ʔɐsawɐ
siya	ʃa
sinelas	sɪnelɐs
distribusyon	dɪstɾɪbʊʃon
ataul	ʔɐtɐʔul
kiamzon	kxiɐmson
gibik	ɡɪbik
ambon	ʔɐmbon
singgapur	sɪŋɡɐpuɾ
lukong	lʊxoŋ
sampay	sɐmpaɪ̯
magpawis	mɐɡpɐwis
tingnan	tɪŋnan
ipabasa	ʔɪpɐbasɐ
ibahin	ʔɪbɐhin
sira	sɪɾaʔ
kabaligtaran	kxɐbɐlɪɡtɐɾan
lutong	lʊtoŋ
laktosa	lɐktosɐ
mangopya	mɐŋopjɐ
samahan	sɐmɐhan
anatomiya	ʔɐnɐtomja
gusilaw	ɡʊsilaʊ̯
lumabas	lʊmɐbas
halalan	hɐlalɐn
absik	ʔɐbsik
harana	hɐɾanɐ
dumukot	dʊmuxot
bisagra	bɪsaɡɾɐ
lunok	lʊnok
malukong	mɐlʊxoŋ
biko	bixo
gamot	ɡɐmot
eva	ʔebɐ
kay	kxaɪ̯
magnipayer	mɐɡnɪpajeɾ
lunaw	lunaʊ̯
humanda	hʊmɐndaʔ
lindayag	lɪndajɐɡ
hingal	hɪŋal
jara	d͡ʒaɾɐ
apostoliko	ʔɐpostolɪxo
asikaso	ʔɐsɪxaso
lanlan	lɐnlan
lumbay	lumbaɪ̯
layon	lɐjon
dakot	dɐxot
indonesya	ʔɪndoneʃɐ
lastay	lɐstaɪ̯
bagunsakupin	bɐɰʊnsaxʊpɪn
pawis	pawɪs
mananquil	mɐnaŋkɪl
bugnit	bʊɡnit
delikadesa	delɪxɐdesɐ
panlipunan	pɐnlipunɐn
angal	ʔaŋɐl
ligpitin	lɪɡpɪtin
kubrekama	kxʊbɾexamɐ
lugar	lʊɰaɾ
bilyar	bɪljaɾ
hanay	hanaɪ̯
reyna	ɾeɪ̯nɐ
manggantso	mɐŋɡant͡ʃo
munggo	mʊŋɡo
ayos	ʔɐjos
bansiw	bɐnsiʊ̯
ambuwang	ʔɐmbwaŋ
batikusin	bɐtɪxusɪn
adhika	ʔɐdhɪxaʔ
pandaigdig	pɐndaɪ̯ɡdiɡ
agahan	ʔɐɰahɐn
langkay	lɐŋkaɪ̯
matunog	mɐtʊnoɡ
ipakita	ʔɪpɐxitɐʔ
lambat	lɐmbat
ani	ʔɐni
usisero	ʔʊsɪseɾo
uwas	ʔʊas
bulalay	bʊlalaɪ̯
mangkukulam	mɐŋkʊxulɐm
dumal	dumɐl
lagpak	lɐɡpak
nguya	ŋujɐʔ
akda	ʔɐkdaʔ
butanding	bʊtɐndiŋ
lomibao	lomibaʊ̯
buwik	bwik
relihiyon	ɾelɪhɪon
lokal	loxal
maapoy	mɐɐpoɪ̯
hambaw	hɐmbaʊ̯
halughog	hɐlʊɡhoɡ
balibago	bɐlɪbaɰo
arawan	ʔɐɾawɐn
gili	ɡɪli
wangis	waŋɪs
kulantro	kxʊlantɾo
iuwi	ʔɪʔʊiʔ
dayrit	daɪ̯ɾɪt
hilahil	hɪlɐhil
macasaet	mɐxasɐet
sinukmani	sɪnʊkmanɪ
arriola	ʔɐɾiolɐ
ragasa	ɾɐɰasɐ
birus	biɾʊs
atay	ʔataɪ̯
konserbatibo	kxonseɾbɐtibo
lehislasyon	lehɪslɐʃon
magbibigas	mɐɡbɪbiɰɐs
ginip	ɡinɪp
sasakyan	sasɐkjan
ihi	ʔihɪʔ
longganisa	loŋɡɐnisɐ
itaas	ʔɪtɐʔas
simenteryo	sɪmenteɾjo
bilot	bɪlot
paraikit	pɐɾɐʔɪxit
kalatsutsi	kxɐlɐt͡ʃut͡ʃɪʔ
hirang	hiɾɐŋ
rin	ɾɪn
bakalaw	bɐxɐlaʊ̯
sayson	saɪ̯son
bundok	bʊndok
dawi	dawɪ
butaka	bʊtaxɐʔ
kupad	kxupɐd
balyan	bɐljan
diyosesis	d͡ʒosesis
gambala	ɡɐmbɐlaʔ
bisitahin	bɪsɪtahɪn
halubilo	hɐlʊbilo
isig	ʔisɪɡ
magtinda	mɐɡtɪnda
magbabasa	mɐɡbɐbɐsa
ibarra	ʔɪbaɾɐ
abang	ʔɐbaŋ
esopago	ʔesopɐɰo
kalamidad	kxɐlɐmɪdad
boac	boʔɐk
humiram	hʊmɪɾam
manilip	mɐnilɪp
alternatibo	ʔɐlteɾnɐtibo
antropolohiya	ʔɐntɾopolohiɐ
atrebido	ʔɐtɾebido
panlikuran	panlɪxʊɾan
limbag	lɪmbaɡ
asosasyon	ʔɐsosɐʃon
burundi	bʊɾundɪ
inakay	ʔɪnaxaɪ̯
lislis	lɪslis
'day	daɪ̯
bawas	bawɐs
mamimili	mɐmɪmilɪ
hatid	hɐtid
bahaw	bɐhaʊ̯
camacho	kxɐmat͡ʃo
turnilyo	tʊɾniljo
atikha	ʔɐtɪkhaʔ
belhika	belhɪxɐ
demostrasyon	demostɾɐʃon
dyaket	d͡ʒaxet
kumpederasyon	kxumpedeɾɐʃon
inglatera	ʔɪŋɡlɐteɾɐ
almoranas	ʔɐlmoɾanɐs
langyot	lɐŋjot
lungad	luŋɐd
kulilipaw	kxʊlɪlipaʊ̯
lingkod	lɪŋkod
anta	ʔantɐ
initsigan	ʔinɪt͡siɰɐn
alkabus	ʔɐlkɐbus
dyumologs	d͡ʒʊmoloɡs
baskagan	bɐskaɰɐn
dila	dilɐʔ
baog	bɐʔoɡ
umaaa	ʔʊmɐʔɐʔaʔ
lagkit	lɐɡkit
isdantuko	ʔɪsdantʊxoʔ
huli	hʊli
mangalay	mɐŋalaɪ̯
calamba	kxɐlɐmbaʔ
magbuhat	mɐɡbuhɐt
kontorsiyonista	kxontoɾsɪonistɐ
dulang	dʊlaŋ
apritada	ʔɐpɾɪtadɐ
pulgas	pʊlɡas
duling	dʊliŋ
lapay	lɐpaɪ̯
albahaka	ʔɐlbɐhaxɐ
himnasyo	hɪmnaʃo
bihasa	bɪhasɐʔ
varona	bɐɾonɐ
hika	hixɐʔ
mansiyon	mɐnʃon
lagod	lɐɰod
malamang	mɐlɐmaŋ
dagibulog	dɐɰɪbʊloɡ
bungaw	bʊŋaʊ̯
kulimlim	kxʊlɪmlim
integral	ʔɪnteɡɾal
identipika	ʔɪdentɪpɪxa
almasiga	ʔɐlmasɪɰa
cornejo	kxoɾneho
galawin	ɡɐlɐwin
barangay	bɐɾɐŋɡaɪ̯
biluslawas	bɪlʊslawɐs
balibat	bɐlibɐt
dagisikan	daɰɪsɪxan
laing	lɐʔiŋ
cabuhat	kxɐbuhɐt
lumakas	lʊmɐxas
halo	hɐloʔ
topacio	topaʃo
tindera	tɪndeɾɐ
baligho	bɐlɪɡhoʔ
lagalag	lɐɰalɐɡ
labastida	lɐbɐstidɐ
konstitusyon	kxonstɪtʊʃon
makipagsuntukan	mɐxɪpɐɡsʊntuxɐn
humilab	hʊmilɐb
pilosopiya	pɪlosopiɐ
kanser	kxanseɾ
karo	kxaɾo
adobe	ʔɐdobe
pasig	pasɪɡ
ayako	ʔɐjaxo
pala	pɐlaʔ
haykap	haɪ̯xap
dimatatac	dɪmɐtatɐk
gawangan	ɡɐwaŋɐn
hampol	hɐmpol
kilitis	kxɪlɪtis
banaba	bɐnɐba
hukuman	hʊxʊman
agbarog	ʔɐɡbaɾoɡ
diplomasya	dɪplomaʃɐ
initsupil	ʔinɪt͡supɪl
balipik	bɐlipɪk
maghikab	mɐɡhɪxab
areglo	ʔɐɾeɡlo
lingon	lɪŋon
dipterya	dɪpteɾjɐ
himuti	hɪmutɪ
lumipad	lʊmɪpad
bami	bamɪʔ
inaantok	ʔɪnɐʔɐntok
bahala	bɐhalɐʔ
aksiyon	ʔɐkʃon
dalublahi	dɐlublahɪʔ
anunsyo	ʔɐnunʃo
akiko	ʔɐxiko
catibog	kxɐtiboɡ
istambay	ʔɪstambaɪ̯
lumo	lʊmo
dagil	daɰɪl
ikaisa	ʔɪxɐʔɪsa
kasintahan	kxɐsɪntahɐn
labadora	lɐbɐdoɾɐ
gumanda	ɡʊmɐnda
lumbao	lumbaʊ̯
gumamit	ɡʊmamɪt
hawig	hɐwiɡ
pacaña	pɐxaɲɐ
ligamgam	lɪɰɐmɡam
dilambuwaya	dɪlambwajɐ
leksiyon	lekʃon
bulbol	bʊlbol
puwas	pwas
dosyentos	doʃentos
panguman	pɐŋʊman
aap	ʔaʔɐp
halika	hɐlixɐ
awa	ʔawɐʔ
barik	bɐɾik
mamagitan	mɐmɐɰitɐn
alibadbad	ʔɐlɪbɐdbad
letsugas	let͡ʃuɰɐs
habulin	hɐbulɪn
pumatay	pʊmɐtaɪ̯
pagsamantalahan	pɐɡsɐmɐntɐlɐhan
macatulad	mɐxɐtulɐd
gayas	ɡɐjas
pagsanjan	pɐɡsɐŋhan
adberbiyo	ʔɐdbeɾbɪo
sentimo	sentɪmo
abilaw	ʔɐbɪlaʊ̯
lilip	lɪlip
dapal	dapɐl
balanse	bɐlanse
direksiyon	dɪɾekʃon
sabunot	sɐbunot
kulangot	kxʊlaŋot
ferriols	feɾɾɪols
indiyano	ʔɪnd͡ʒano
bala	balɐ
arap	ʔaɾɐp
lapit	lapɪt
igsi	ʔɪɡsiʔ
ursua	ʔuɾsʊɐ
balukay	balʊxaɪ̯
kumpisal	kxumpɪsal
itulog	ʔɪtuloɡ
liing	lɪʔiŋ
dumulas	dʊmʊlas
balinghat	bɐlɪŋhat
aurora	ʔaʊ̯ɾoɾɐ
akom	ʔɐxom
villagracia	bɪllɐɡɾaʃɐ
lamira	lɐmiɾɐʔ
loteriya	loteɾiɐ
komedyante	kxomed͡ʒante
bibig	bɪbiɡ
pusyaw	pʊʃau
goma	ɡomɐ
gaban	ɡɐban
iregular	ʔɪɾeɰʊlaɾ
ebolusyon	ʔebolʊʃon
guanzon	ɡuɐnson
kita	kitɐ
maasim	mɐʔasɪm
damdam	dɐmdam
dasal	dɐsal
tamban	tɐmban
tangka	tɐŋkaʔ
dimarim	dɪmaɾɪm
gabiana	ɡɐbiɐnɐ
lisensiya	lɪsenʃa
laygo	laɪ̯ɰo
kampanya	kxɐmpɐɲa
virus	biɾʊs
amilyaramyento	ʔɐmɪljɐɾɐmjento
ginintuan	ɡɪnɪntʊʔan
himanting	hɪmɐntiŋ
mabigat	mɐbɪɰat
magmartsa	mɐɡmaɾt͡ʃɐ
bansot	bɐnsot
sumiko	sʊmixo
anay	ʔanaɪ̯
veneracion	beneɾaʃon
oracion	ʔoɾaʃon
impormal	ʔɪmpoɾmal
teruko	teɾuxo
ilag	ʔilɐɡ
giwang	ɡewɐŋ
ekwador	ʔekwɐdoɾ
dagta	dɐɡtaʔ
bantok	bɐntok
tampal	tɐmpal
bumaha	bʊmɐhaʔ
lumapit	lʊmapɪt
iskrip	ʔɪskɾip
hinog	hɪnoɡ
gugo	ɡuɰoʔ
anhin	ʔɐŋhin
importansiya	ʔɪmpoɾtanʃa
bitin	bɪtin
daras	dɐɾas
hilig	hilɪɡ
rocafort	ɾoxafoɾt
paggiba	pɐɡɡɪbaʔ
brokuli	bɾoxʊli
lagayan	laɰajɐn
oliva	ʔolibɐ
agwat	ʔɐɡwat
pambati	pɐmbɐti
independiyente	ʔɪndepend͡ʒente
albularyo	ʔɐlbʊlaɾjo
dulos	dʊlos
gadgad	ɡɐdɡad
umapaw	ʔʊmapaʊ̯
kabiguan	kxɐbɪɰʊʔan
anayo	ʔɐnajo
kapakanan	kxɐpɐxɐnʔan
magpalaganap	mɐɡpɐlɐɰanɐp
ikalima	ʔɪxɐlɪma
bikas	bixɐs
sawi	sɐwiʔ
ayuyang	ʔɐjʊjaŋ
magpaubaya	mɐɡpɐʔʊbajɐʔ
almirol	ʔɐlmɪɾol
bathala	bɐthalɐʔ
iskwater	ʔɪskwɐteɾ
agamahan	ʔaɰɐmɐhɐn
ihap	ʔihɐp
badya	bɐd͡ʒa
hinaing	hɪnɐʔiŋ
datal	dɐtal
antipolo	ʔɐntɪpolo
probinsiyano	pɾobɪnʃano
encinas	ʔensinɐs
linlang	lɪnlaŋ
mamamana	mɐmɐmanɐʔ
putakti	pʊtɐkti
nabasa	nabɐsaʔ
mapagmatyag	mɐpɐɡmɐt͡ʃaɡ
kabikulan	kxɐbixʊlan
lamuga	lɐmuɰɐʔ
bakod	bɐxod
mahiyain	mɐhɪaʔɪn
atlantiko	ʔɐtlantɪxo
ampang	ʔɐmpaŋ
tukso	tʊkso
libid	lɪbid
kabisayaan	kxɐbɪsɐjaʔɐn
dulay	dulaɪ̯
kumbento	kxumbento
latigo	latɪɰo
bigkas	bɪɡkas
babasa	bɐbasɐ
aquino	ʔɐxino
bangan	bɐŋan
alusitha	ʔɐlʊsɪthaʔ
luwan	lwan
elektrisidad	ʔelektɾɪsɪdad
unano	ʔʊnanoʔ
analitiko	ʔɐnɐlitɪxo
lagalag	lɐɰɐlaɡ
danesa	dɐnesɐ
bilugan	bɪluɰɐn
ikalabintatlo	ʔɪxɐlɐbintɐtlo
alilisan	ʔalɪlɪsan
kasaysayan	kxɐsaɪ̯sajɐn
palda	paldɐ
milagro	mɪlaɡɾo
binti	bɪntiʔ
amain	ʔɐmain
tagos	tɐɰos
suwelas	swelɐs
ayon	ʔɐjon
intermisyon	ʔɪnteɾmɪʃon
catipon	kxɐtipon
benesyana	beneʃɐnɐ
lupalop	lʊpalop
balaglawas	bɐlaɡlawɐs
dabaw	dabaʊ̯
patutsada	pɐtʊt͡ʃadɐ
batasan	batasɐn
mandirigma	mɐndɪɾɪɡmaʔ
amansinaya	ʔɐmɐnsɪnajɐʔ
leynes	leɪ̯nes
ampaw	ʔampaʊ̯
labnaw	lɐbnaʊ̯
abing	ʔabɪŋ
dagdag	dɐɡdaɡ
galusgos	ɡɐlʊsɡos
kutson	kxʊt͡ʃon
magdayao	mɐɡdajaʊ̯
aklan	ʔɐklan
libradilla	lɪbɾɐdillɐ
lukton	lʊkton
barkada	bɐɾkadɐ
traqueña	tɾɐxeɲɐ
indesente	ʔɪndesente
pekas	pexɐs
negosyador	neɰoʃɐdoɾ
babaihin	bɐbɐʔihɪn
langka	lɐŋkaʔ
pukyutan	pʊkjutɐn
baculi	bɐxulɪ
dupil	dupɪl
barera	bɐɾeɾɐ
abogasya	ʔɐboɰɐʃa
alisin	ʔɐlɪsin
baya	bajɐʔ
bahagya	bɐhɐɡjaʔ
mainsekto	mɐʔɪnsekto
balut	bɐlut
dispatser	dɪspat͡ʃeɾ
ilay	ʔilaɪ̯
bayawak	bɐjawɐk
dukal	dʊxal
duhambindahon	dʊhɐmbɪndahon
baluti	bɐlutɪʔ
gat	ɡɐt
sakal	sɐxal
bundol	bʊndol
abnoy	ʔɐbnoɪ̯
pamimilosopo	pɐmɪmɪlosopo
inskripsiyon	ʔɪnskɾɪpʃon
kabute	kxɐbʊte
ehekutibo	ʔehexʊtibo
daglat	dɐɡlat
bisyesto	bɪʃesto
tiyesa	t͡ʃesɐ
maghasik	mɐɡhɐsik
dumating	dʊmɐtiŋ
ihi	ʔɪhiʔ
hangganan	hɐŋɡanɐn
hawak	hawɐk
butete	bʊtete
haligutgot	hɐlɪɰʊtɡot
pasyal	pɐʃal
galalan	ɡɐlɐlan
planetaryum	plɐnetaɾjʊm
gunggong	ɡʊŋɡoŋ
hinga	hɪŋa
c	sɪ
hahagkan	hahɐɡkan
lugay	lʊɰaɪ̯
balas	balɐs
anos	ʔɐnos
alangaang	ʔɐlɐŋaʔɐŋ
kana	kxɐnaʔ
lumihis	lʊmɪhis
koalisyon	kxoɐlɪʃon
bilbil	bɪlbil
gawis	ɡawɪs
ligpit	lɪɡpit
barko	bɐɾko
bagon	bɐɰon
gumising	ɡʊmisɪŋ
baya	bajɐ
lapay	lapaɪ̯
bagsit	baɡsɪt
dumugo	dʊmʊɰoʔ
ocampo	ʔoxampo
alintana	ʔɐlɪntanɐ
liwag	liwɐɡ
inspeksiyon	ʔɪnspekʃon
lantutay	lɐntutaɪ̯
alampay	ʔɐlɐmpaɪ̯
binhi	bɪŋhiʔ
iknat	ʔɪknat
tagabukid	tɐɰɐbuxɪd
bantulot	bɐntulot
indak	ʔɪndak
baga	baɰɐ
lawaan	lɐwɐʔan
sinauna	sɪnaʊ̯nɐ
araro	ʔɐɾaɾo
pisan	pɪsan
dalit	dalɪt
lusaw	lʊsaʊ̯
dilag	dɪlaɡ
ampunan	ʔɐmpunɐn
pribilehiyo	pɾɪbɪlehio
pambansa	pɐmbɐnsaʔ
magdalaga	mɐɡdɐlɐɰa
abrigo	ʔɐbɾiɰo
rekisitos	ɾexɪsitos
pigain	pɪɰɐʔin
payumo	pɐjumo
buwisit	bwɪsɪt
ahedres	ʔɐhedɾes
nancy	nansɪ
kingpin	kxiŋpɪn
desperasyon	despeɾɐʃon
lolipap	lolɪpap
siyempre	ʃempɾe
tatsulok	tɐt͡ʃʊlok
matigas	mɐtɪɰas
guerra	ɡeɾɐ
hektarya	hektaɾjɐ
balai	bɐlaʔɪ
lapok	lɐpok
gahumay	ɡɐhumaɪ̯
quintos	kxintos
apekto	ʔɐpekto
sabunan	sɐbʊnan
tingin	tɪŋin
hagad	haɰɐd
zafra	safɾɐ
lagitik	lɐɰɪtik
lehitimo	lehitɪmo
hudyat	hʊd͡ʒat
casao	kxasaʊ̯
umaa	ʔʊmɐʔaʔ
echevarria	ʔet͡ʃebaɾjɐ
lakhan	lɐkhan
lusay	lusaɪ̯
bulaw	bʊlaʊ̯
mangisda	mɐŋɪsdaʔ
inspirado	ʔɪnspɪɾado
kimono	kxɪmono
babasahin	bɐbɐsɐhin
lansa	lansɐ
manghimasok	mɐŋhɪmasok
busog	bʊsoɡ
escalona	ʔeskɐlonɐ
arabe	ʔɐɾɐbe
balikan	bɐlɪxan
bumisita	bʊmɪsitɐ
alviar	ʔɐlbjaɾ
lu	lʊ
buuin	bʊʔʊʔin
ligid	lɪɰid
adopsiyon	ʔɐdopʃon
linang	lɪnaŋ
lubiano	lʊbjano
iboto	ʔɪboto
anyo	ʔɐɲoʔ
busal	busɐl
sagun	saɰʊn
pestisidyo	pestɪsid͡ʒo
barha	baɾhɐ
lagas	lɐɰas
bingwit	bɪŋwit
demonyo	demoɲo
kaagulo	kxɐʔɐɰuloʔ
pasuguan	pɐsʊɰuʔɐn
batad	bɐtad
marites	maɾɪtes
interesado	ʔɪnteɾesado
baunan	baʔunɐn
atin	ʔatɪn
huminto	hʊmɪntoʔ
libra	libɾɐ
kato	kxɐtoʔ
katawan	kxɐtaʊ̯ʔan
aab	ʔɐʔab
batia	bɐt͡ʃaʔ
diyabetes	dɪɐbetes
gaso	ɡɐso
hagdanan	hɐɡdɐnan
manglicmot	mɐŋlikmot
lingindayat	lɪŋindɐjat
bulubundukin	bʊlʊbʊnduxɪn
daka	daxɐ
artipisyal	ʔɐɾtɪpɪʃal
duhakay	dʊhaxaɪ̯
luhod	lʊhod
lindulin	lɪndʊlin
bacoor	bɐxoʔoɾ
lipit	lipɪt
hugot	huɰot
buwelo	bwelo
dekametro	dexɐmetɾo
irekomenda	ʔɪɾexomenda
eksena	ʔeksenɐ
salinlahi	sɐlɪnlahɪʔ
pumutok	pʊmʊtok
losyon	loʃon
kristo	kxɾisto
hawakan	hɐwaxɐn
sapak	sapɐk
liquigan	lɪxiɰɐn
pinlac	pinlɐk
gasgas	ɡɐsɡas
mabasa	mɐbasɐ
tratado	tɾɐtado
laboratoryo	lɐboɾɐtoɾjo
lala	lɐla
palabas	pɐlɐbas
kristiyano	kxɾɪst͡ʃano
sipon	sɪpʔon
pawisan	pɐwɪsan
dulis	dulɪs
bintog	bɪntoɡ
kampyon	kxɐmpjon
balatkayo	bɐlɐtkɐjoʔ
ispageti	ʔɪspɐɰetɪ
modernisasyon	modeɾnɪsɐʃon
pamintuan	pɐmintʊɐn
ipalinis	ʔɪpɐlinɪs
abnormal	ʔɐbnoɾmal
intrusyon	ʔɪntɾʊʃon
buwang	bwaŋ
luy	lʊɪ
manalikod	mɐnɐlixod
lumabo	lʊmɐbo
trahedya	tɾɐhed͡ʒɐ
lupain	lʊpɐʔin
labahan	lɐbɐhan
limahid	lɪmahɪd
diktadurya	dɪktɐduɾjɐ
propagandista	pɾopɐɰɐndistɐ
isidro	ʔɪsidɾo
gurami	ɡʊɾamɪ
asa	ʔasɐ
beynte	beɪ̯nte
likot	lɪxot
iniba	ʔɪnɪba
villena	bɪljenɐ
kriminal	kxɾɪmɪnal
quiñones	kxɪɲones
buwenamano	bʊenɐmano
aray	ʔɐɾaɪ̯
eugenio	jʊheɲo
hinggil	hɪŋɡil
alipusta	ʔɐlɪpʊstaʔ
iskaparate	ʔɪskɐpɐɾate
dukesa	dʊxesɐ
magbakasakali	mɐɡbɐxɐsɐxalɪʔ
tinik	tɪnik
tumira	tʊmiɾɐ
gawain	ɡɐwɐʔin
balae	bɐlaʔe
legal	leɰal
hungkag	hʊŋkaɡ
naomi	naomɪ
katedral	kxɐtedɾɐl
baterya	bɐteɾja
balibag	bɐlɪbaɡ
buhaghag	bʊhaɡhaɡ
gamit	ɡamɪt
maligaw	mɐlɪɰaʊ̯
galamay	ɡɐlɐmaɪ̯
biyak	bjak
mamad	mɐmad
bitaw	bɪtaʊ̯
ako	ʔaxoʔ
dalublahian	dɐlublahɪʔan
bunso	bʊŋso
sabog	sɐboɡ
pasko	pɐsko
mabasag	mɐbasɐɡ
am	ʔɐm
gago	ɡaɰo
gimbal	ɡɪmbal
aya	ʔajɐ
liberasyon	lɪbeɾɐʃon
humingi	hʊmɪŋiʔ
humigit	hʊmɪɰit
huli	hʊliʔ
bitag	bitɐɡ
pagbubukid	pɐɡbʊbuxɪd
lihiya	lɪhiɐ
bura	buɾɐ
buno	bʊnoʔ
candila	kxɐndilɐ
ikid	ʔixɪd
kotilyon	kxotɪljon
dikya	dɪkja
biguin	bɪɰʊʔin
cato	kxɐto
lakas	lɐxas
gara	ɡaɾɐʔ
gumastos	ɡʊmɐstos
bulo	bʊlo
linuknok	lɪnʊknok
ebidensiya	ʔebɪdenʃa
bangag	bɐŋaɡ
atribusyon	ʔɐtɾɪbʊʃon
buang	bʊʔaŋ
kasinungalingan	kxɐsɪnʊŋɐliŋɐn
batya	bɐt͡ʃaʔ
aswang	ʔɐswaŋ
ingkilino	ʔɪŋkɪlino
quirante	kxɪɾante
obligacion	ʔoblɪɰaʃon
hilabigat	hilɐbɪɰat
agad	ʔɐɰad
bukidnon	bʊxɪdnon
ligid	liɰɪd
agwelo	ʔɐɡwelo
pajares	pɐd͡ʒaɾes
dayang	dajɐŋ
bangaw	baŋaʊ̯
banal	bɐnal
adrias	ʔadɾɪɐs
kahulugan	kxɐhʊlʊɰan
italya	ʔɪtaljɐ
lagumba	lɐɰumba
basa	bɐsaʔ
gawa	ɡɐwaʔ
lugpo	lʊɡpoʔ
gasela	ɡɐselɐ
dilat	dilɐt
instrumento	ʔɪnstɾʊmento
mabasa	mabasɐ
baquiran	bɐxiɾɐn
akay	ʔaxaɪ̯
maghinuha	mɐɡhɪnuhɐʔ
abuwab	ʔɐbwab
iluminasyon	ʔɪlʊmɪnɐʃon
magkanlong	mɐɡkɐnloŋ
luminis	lʊminɪs
ipakita	ʔɪpɐxitɐ
galante	ɡɐlante
valera	bɐleɾɐ
alupag	ʔɐlupɐɡ
bilisan	bɪlɪsan
layas	lɐjas
bayaran	bɐjɐɾan
babaan	babɐʔan
alilis	ʔɐlɪlis
panibughuin	pɐnɪbʊɡhuʔɪn
lantana	lɐntanɐʔ
anila	ʔanɪla
dumighay	dʊmɪɡhaɪ̯
maghirang	mɐɡhiɾɐŋ
gugol	ɡuɰol
engkuwentro	ʔeŋkwentɾo
dumaan	dʊmɐʔan
sangalang	sɐŋɡalɐŋ
pinapasyalan	pɪnapɐʃɐlan
dayag	dajɐɡ
inmigrasyon	ʔɪmmɪɡɾɐʃon
pananabotahe	pɐnɐnɐbotahe
asal	ʔasɐl
umasim	ʔʊmasɪm
mamuti	mɐmʊtiʔ
mambabarang	mɐmbɐbaɾɐŋ
isama	ʔɪsɐma
lanay	lanaɪ̯
palisoc	pɐlisok
hikahos	hɪxɐhos
inmoral	ʔɪmoɾal
idea	ʔɪdeja
atas	ʔatɐs
kata	kxɐta
kolera	kxoleɾɐ
karanasan	kxɐɾɐnɐsan
lamok	lɐmok
baha	bɐhaʔ
kabayo	kxɐbajo
tigyawat	tɪɡjawɐt
lacambra	lɐxambɾɐ
lesbyana	lesbjɐnɐ
lagim	lɐɰim
magmaliw	mɐɡmalɪʊ̯
dilim	dɪlim
hilako	hɪlɐxoʔ
arilyos	ʔɐɾiljos
tagalinis	tɐɰɐlinɪs
dalya	daljɐ
hilig	hɪliɡ
mabayaran	mɐbɐjaɾɐn
gahum	ɡɐhum
dulaan	dulaɐn
manamit	mɐnɐmit
bagalan	bɐɰalɐn
buenafe	bʊenɐpe
dikit	dɪxit
langhapan	lɐŋhapɐn
ninyo	nɪɲɔ
binuya	bɪnujɐ
parilla	pɐɾillɐ
quimpo	kximpo
bitiw	bɪtiʊ̯
amurao	ʔɐmʊɾaʊ̯
hagupit	hɐɰʊpit
kada	kxadɐ
pagdinig	pɐɡdɪniɡ
halik	hɐlik
monica	monɪxɐ
hinala	hɪnalɐʔ
maglandi	mɐɡlɐndiʔ
apayao	ʔɐpɐjaʊ̯
diri	diɾɪ
dapulak	dɐpulɐk
inam	ʔinɐm
dimaandal	dɪmaɐndɐl
hiwaga	hɪwaɰɐʔ
gigil	ɡɪɰil
garay	ɡɐɾaɪ̯
madaga	mɐdɐɰaʔ
ilokana	ʔɪloxanɐ
gabrielle	ɡɐbɾielle
abnormal	ʔɐbnoɾmɐl
manloloko	mɐnloloxo
luwang	lwaŋ
adobo	ʔɐdobo
lunod	lʊnod
giginto	ɡɪɰɪntoʔ
bagal	baɰɐl
maghari	mɐɡhaɾɪʔ
remolatsa	ɾemolat͡ʃɐ
diwa	diwɐʔ
eskina	ʔeskinɐ
madulas	mɐdʊlas
anyayahan	ʔɐɲɐjahɐn
apelyido	ʔɐpeljido
lugit	luɰɪt
beterinaryo	beteɾɪnaɾjo
haway	hɐwaɪ̯
kontador	kxontɐdoɾ
bihasa	bɪhɐsaʔ
lauriat	loɾjɐt
kaanib	kxɐʔanɪb
enerhiya	ʔeneɾhiɐ
ricarte	ɾɪxaɾte
lalad	lɐlad
lumpia	lumpjaʔ
ismid	ʔɪsmid
lungga	lʊŋɡaʔ
linisin	lɪnisɪn
mandocdoc	mɐndokdok
bumalintong	bʊmɐlɪntoŋ
lapas	lɐpas
awtomatiko	ʔaʊ̯tomatɪxo
luklukan	lʊklʊxan
agwardyente	ʔɐɡwɐɾd͡ʒente
amogis	ʔɐmoɰɪs
gales	ɡɐles
liyab	ljab
bahaghari	bɐhɐɡhaɾɪ
dagok	daɰok
dalubbanwahan	dɐlubbɐnwahɐn
kloropila	kxloɾopilɐ
hapunan	hɐpʊnan
dalahik	dɐlahɪk
polintan	polintɐn
galon	ɡɐlon
sakitin	sɐxitɪn
tulak	tulɐk
elehiya	ʔelehiɐ
hawong	hɐwoŋ
kikuko	kxɪxuko
lansones	lɐnsones
hibang	hɪbaŋ
lapida	lapɪda
espinoza	ʔespɪnosɐ
laroy	lɐɾoɪ̯
venus	benʊs
sabunan	sɐbunɐn
rimarim	ɾɪmaɾɪm
sawa	sɐwa
bumasa	bʊmasɐ
galit	ɡɐlit
basahan	bɐsahɐn
dalagita	dɐlɐɰitɐ
burol	bʊɾol
sirena	sɪɾenɐ
baldonado	bɐldonado
lagdameo	lɐɡdameo
datapwat	datɐpwat
asignatura	ʔɐsɪɡnɐtuɾɐ
baclad	bɐklad
jumbag	d͡ʒumbɐɡ
iba	ʔibɐʔ
initan	ʔɪnitɐn
lazatin	lɐsatɪn
panlikod	pɐnlɪxod
takeko	tɐxeko
dagisik	dɐɰisɪk
lubak	lubɐk
alupihan	ʔɐlʊpihɐn
inmoral	ʔɪmmoɾal
bati	batɪʔ
impraestruktura	ʔɪmpɾɐʔestɾʊktuɾɐ
lakambini	lɐxɐmbinɪ
hiya	hɪa
karburador	kxɐɾbʊɾɐdoɾ
babag	bɐbaɡ
saldaña	sɐldaɲɐ
labahan	labahɐn
distrito	dɪstɾito
astronomiya	ʔɐstɾonomiɐ
trillanes	tɾɪllanes
alila	ʔɐlilɐʔ
implamasyon	ʔɪmplɐmɐʃon
himasok	hɪmasok
kulasisi	kxʊlɐsisɪ
diskumpiyado	dɪskumpjɐdo
initdagitban	ʔinɪtdɐɰɪtban
gulunggulungan	ɡʊlʊŋɡʊluŋɐn
umagnas	ʔʊmɐɡnas
ipuipo	ʔɪpʊʔipo
tsampoy	t͡ʃɐmpoɪ̯
girimpula	ɡɪɾɪmpʊla
galalan	ɡɐlalɐn
loobkaphay	loʔobkɐphaɪ̯
biyaya	bjɐjɐʔ
dumungaw	dʊmuŋaʊ̯
danas	danɐs
lagnat	lɐɡnat
gao	ɡɐo
dapat	dapɐt
silindro	sɪlindɾo
hayskul	haɪ̯skʊl
dakutin	dɐxʊtin
iligan	ʔɪliɰɐn
haltak	hɐltak
alipin	ʔɐlipɪn
baligtarin	bɐlɪɡtaɾɪn
talabong	tɐlaboŋ
corro	kxoɾɾo
dalikdik	dɐlikdɪk
kailangan	kxelaŋɐn
animnapu	ʔɐnɪmnɐpuʔ
mabanas	mɐbɐnas
dukha	dʊkhaʔ
manlangit	mɐnlaŋɪt
buswang	bʊswaŋ
lumambitin	lʊmɐmbitɪn
dagihaynayan	dɐɰɪhaɪ̯najɐn
kenji	kxend͡ʒɪ
lunas	lʊnas
lam	lɐm
kobra	kxobɾɐ
demonstrasyon	demonstɾɐʃon
pamahalaan	pɐmɐhɐlaan
botelya	boteljɐ
laguna	lɐɰunɐ
maalamat	mɐɐlɐmat
tirik	tɪɾik
abutan	ʔɐbʊtan
gawi	ɡawɪʔ
lumiwanag	lʊmɪwanɐɡ
tatsuko	tɐt͡ʃuxo
leksikograpiko	leksɪxoɡɾapɪxo
awtoridad	ʔaʊ̯toɾɪdad
anyaya	ʔɐɲɐjɐʔ
bugnitbugnit	bʊɡnitbʊɡnit
instalasyon	ʔɪnstɐlɐʃon
basbas	bɐsbas
laba	lɐba
ate	ʔɐte
bintang	bɪntaŋ
kaluwalhatian	kxɐlʊlʊɐlhɐtiʔɐn
sacdalan	sɐkdalɐn
kalaguyo	kxɐlɐɰujoʔ
iling	ʔɪliŋ
habang	hɐbaŋ
tuwad	twad
banaag	bɐnaʔɐɡ
akom	ʔaxom
nakpil	nakpɪl
lala	lɐlaʔ
kalusugan	kxɐlusuɰɐn
salvador	sɐlbɐdoɾ
direktor	dɪɾektoɾ
silid	sɪlid̪
etiyopiya	ʔetɪopiɐ
atang	ʔɐtaŋ
orkid	ʔoɾkɪd
inumin	ʔinumɪn
gilib	ɡɪlib
daig	dɐʔiɡ
kundena	kxʊndena
zavalla	sɐballɐ
tagal	tɐɰal
aber	ʔɐbeɾ
anas	ʔɐnas
lungsod	lʊŋsod
abad	ʔɐbad
manaloto	mɐnɐloto
malay	malaɪ̯
agpang	ʔɐɡpaŋ
lakandiwa	lɐxɐndiwɐʔ
avanceña	ʔɐbɐnseɲɐ
ingklitik	ʔɪŋklitɪk
libot	lɪbot
midori	mɪdoɾɪ
bigtihin	bɪɡtɪhin
dupa	dʊpaʔ
maglaro	mɐɡlɐɾoʔ
bingit	biŋɪt
api	ʔɐpi
dala	dɐla
sugal	sʊɰal
hinagpis	hɪnɐɡpis
barako	bɐɾaxo
bisikleta	bɪsɪkletɐ
gansa	ɡansɐ
ligo	lɪɰoʔ
haso	hɐsoʔ
bubuwit	bʊbwit
longhitud	loŋhɪtud
dako	daxo
babag	babɐɡ
bukas	buxɐs
laing	laʔɪŋ
ilehitimo	ʔɪlehilɪmo
inla	ʔɪnla
atay	ʔɐtaɪ̯
acosta	ʔɐxostɐ
kalaswaan	kxɐlɐswɐʔan
kutya	kxʊt͡ʃaʔ
agrimensor	ʔɐɡɾɪmensoɾ
magkaaway	mɐɡkɐʔawaɪ̯
kadena	kxɐdenɐ
abyador	ʔɐbjɐdoɾ
ngalan	ŋalɐn
kontento	kxontento
kulasi	kxʊlasɪ
choi	t͡ʃoɪ̯
bungisngis	bʊŋɪsŋis
bumuo	bʊmʊʔoʔ
lascano	lɐskano
linsil	lɪnsil
tsekya	t͡ʃekjɐ
pulmonya	pʊlmoɲa
licup	lixʊp
balakid	bɐlaxɪd
burat	bʊɾat
maristela	mɐɾɪstelɐ
aranya	ʔɐɾaɲɐ
vergara	beɾɡaɾɐ
magbalatkayo	mɐɡbɐlɐtkɐjoʔ
iliko	ʔɪlɪxoʔ
durungawan	duɾʊŋɐwan
makontento	mɐxontento
dehins	dehɪns
dapitan	dɐpitɐn
alagaw	ʔɐlɐɰaʊ̯
ilagan	ʔɪlaɰɐn
balakubak	bɐlɐxubɐk
balota	bɐlotɐ
ikit	ʔixɪt
kasubha	kxɐsubhaʔ
avendaño	ʔɐbendaɲo
ayangaw	ʔɐjɐŋaʊ̯
literal	lɪteɾal
medalya	medaljɐ
ampalaya	ʔɐmpɐlɐja
humimas	hʊmimɐs
aaban	ʔɐʔɐban
calaycay	kxɐlaɪ̯xaɪ̯
ipaintindi	ʔɪpɐʔɪntɪndi
dokumentasyon	doxʊmentɐʃon
lamesita	lɐmesitɐ
ayan	ʔɐjan
manatad	mɐnatɐd
planas	planɐs
isipin	ʔɪsɪpin
garciano	ɡɐɾsiɐno
valmores	bɐlmoɾes
indikasyon	ʔɪndɪxɐʃon
lagok	lɐɰok
labtik	lɐbtik
himala	hɪmɐlaʔ
hakot	haxot
mariseko	mɐɾɪsexo
lingguwista	lɪŋɡwɪstɐ
himpil	hɪmpil
guwapo	ɡwɐpo
dilat	dɪlat
konsumo	kxonsumo
aplaya	ʔɐplajɐ
bokasyon	boxɐʃon
akordeon	ʔɐxoɾd͡ʒon
lapastangan	lɐpɐstaŋɐn
tullao	tuljaʊ̯
abitsuwelas	ʔɐbɪt͡ʃʊelɐs
higanti	hɪɰɐnti
babao	babaʊ̯
atake	ʔɐtaxe
matatakutin	mɐtɐtɐxʊtin
mulkaphay	mʊlkɐphaɪ̯
dayungon	dɐjuŋon
halayhay	hɐlɐjhaɪ̯
tinga	tɪŋa
giyera	ɡjeɾɐ
hangganan	hɐŋɡɐnan
gitlawas	ɡɪtlawɐs
balingkinitan	bɐlɪŋkɪnitɐn
bosniya	bosɲa
balik	bɐlik
kahinaan	kxɐhɪnaʔɐn
alitaptap	ʔɐlɪtɐptap
aghamwika	ʔɐɡhamwixɐʔ
mursiko	mʊɾsixo
engganyo	ʔeŋɡaɲo
pahinga	pɐhɪŋa
aldover	ʔɐldobeɾ
inaaaban	ʔɪnaʔɐʔɐban
budbod	bʊdbod
maingay	mɐʔiŋaɪ̯
paminta	pɐmɪnta
likom	lixom
langoy	lɐŋoɪ̯
mahilig	mɐhilɪɡ
bilin	bilɪn
tagubilin	tɐɰʊbilɪn
lubos	lʊbos
tagiktik	tɐɰɪktik
sikreto	sɪkɾeto
diyos	d͡ʒos
etika	ʔetɪxa
lasenggero	lɐseŋɡeɾo
digma	dɪɡmaʔ
cantiveros	kxɐntɪbeɾos
wari	waɾɪ
liso	lɪso
gatos	ɡɐtos
desperada	despeɾadɐ
kanlong	kxɐnloŋ
rali	ɾalɪ
baliktad	bɐlɪktad
kariton	kxɐɾɪton
abahin	ʔɐbɐhin
lihim	lihɪm
bakasyonista	bɐxɐʃonistɐ
kongregasyon	kxoŋɡɾeɰɐʃon
aborsiyon	ʔɐboɾʃon
biyuda	bjʊdɐ
bidbid	bɪdbid
gutoy	ɡʊtoɪ̯
asindero	ʔɐsɪndeɾo
ezra	ʔesɾɐ
kinalabasan	kxɪnalɐbɐsan
tapunan	tɐpʊnan
mamaril	mɐmɐɾil
cardiño	kxɐɾdiɲo
albanya	ʔɐlbaɲɐ
malikhain	mɐlɪkhaʔɪn
mamihasa	mɐmɪhasɐʔ
away	ʔawaɪ̯
larangan	lɐɾaŋɐn
villaruz	bɪllaɾʊs
diyalekto	dɪɐlekto
aralin	ʔɐɾɐlin
eskosya	ʔeskoʃɐ
dusdos	dʊsdos
lambanog	lɐmbɐnoɡ
bakwit	bɐkwit
manabunot	mɐnɐbunot
bilad	bɪlad
istrikto	ʔɪstɾikto
sanki	sɐŋki
bili	bɪli
bangan	baŋɐn
nietes	ɲetes
gawan	ɡɐwan
bintag	bɪntaɡ
korea	kxoɾeɐ
españa	ʔespaɲɐ
instigador	ʔɪnstɪɰɐdoɾ
alak	ʔalɐk
angkas	ʔɐŋkas
bruha	bɾuhɐ
ako	ʔɐxo
buko	buxo
pipi	pipɪʔ
hilahid	hɪlahɪd
maniego	mɐɲeɰo
urano	ʔʊɾano
bantayan	bɐntɐjan
luwal	lwal
athanasia	ʔɐthɐnasɪɐ
ugat	ʔʊɰat
mamasada	mɐmɐsadɐ
luko	lʊxoʔ
agrikultura	ʔɐɡɾɪxʊltuɾɐ
espiya	ʔespiɐ
villamor	bɪllamoɾ
lantaka	lɐntaxɐʔ
subsidiya	sʊbsɪdiɐ
asungot	ʔɐsuŋot
luyok	lʊjok
mabagyo	mɐbɐɡjo
kabuwanan	kxɐbwɐnɐn
lambanog	lɐmbanoɡ
aplikante	ʔɐplɪxante
kobrador	kxobɾɐdoɾ
damahan	dɐmɐhan
layag	lajɐɡ
bakas	bɐxas
yumi	jumɪʔ
teoriya	teoɾiɐ
bañaga	bɐɲɐɰɐ
habang	habɐŋ
larot	lɐɾot
katarungan	kxɐtɐɾuŋɐn
awanggan	ʔɐwɐŋɡan
laxamana	lɐksɐmanɐ
alimasag	ʔɐlɪmasɐɡ
tseko	t͡ʃexo
olats	ʔolat͡s
bitay	bitaɪ̯
abra	ʔabɾɐ
magbentilador	mɐɡbentɪlɐdoɾ
upa	ʔupɐ
nangka	nɐŋkaʔ
lumalaban	lʊmɐlabɐn
akordeon	ʔɐxoɾdeon
datinguinoo	datɪŋɡɪnoʔo
dueñas	dueɲɐs
sakdal	sɐkdal
lukemya	lʊxemjɐ
sangla	sɐŋlaʔ
humalik	hʊmɐlik
pamahiin	pamɐhiʔɪn
balaong	bɐlaʔoŋ
bumoto	bʊmoto
kulambo	kxʊlɐmboʔ
balakang	bɐlɐxaŋ
bulakan	bʊlaxɐn
administrasyon	ʔɐdmɪnɪstɾɐʃon
baboy	baboɪ̯
dumihan	dʊmɪhan
kapalaran	kxɐpɐlaɾɐn
aksayado	ʔɐksɐjado
inisyatibo	ʔɪnɪʃɐtibo
lugso	lʊɡsoʔ
bitig	bɪtiɡ
musika	musɪxɐ
guro	ɡʊɾoʔ
dalangat	dɐlaŋɐt
lira	liɾɐ
solidum	solidʊm
lantong	lɐntoŋ
baunan	baʔʊnan
pasista	pɐsistɐ
isantabi	ʔɪsɐntɐbi
abolisyon	ʔɐbolɪʃon
kolombiya	kxolumbɪɐ
manrique	mɐnɾixe
bithay	bɪthaɪ̯
mangubra	mɐŋʊbɾa
himuti	hɪmʊtiʔ
portugal	poɾtʊɰal
kamunduhan	kxɐmʊndʊhan
day	daɪ̯
aserbayan	ʔɐseɾbɐjan
gumagad	ɡʊmɐɰad
baliw	bɐliʊ̯
bahaw	bahaʊ̯
taguinod	tɐɰinod
dolar	dolɐɾ
rodriguez	ɾodɾiɰes
tuwang	twaŋ
higsipnayan	hɪɡsɪpnajɐn
taguba	tɐɰubɐ
bungangkahoy	bʊŋɐŋkahoɪ̯
binasa	bɪnasɐ
edukasyon	ʔedʊxɐʃon
ambag	ʔɐmbaɡ
catapang	kxɐtapɐŋ
isnab	ʔɪsnab
laryo	lɐɾjo
baitang	bɐʔɪtaŋ
akala	ʔɐxalɐ
tsokolate	t͡ʃoxolate
aminado	ʔɐmɪnado
lakwatsero	lɐkwɐt͡ʃeɾo
diskriminasyon	dɪskɾɪmɪnɐʃon
alahero	ʔɐlɐheɾo
hamayka	hɐmaɪ̯xɐ
kakayahan	kxɐxɐjɐhan
habid	hɐbid
pari	paɾɪʔ
laruan	laɾʊʔan
nobela	nobelɐ
dalubhalman	dɐlubhɐlman
amilyar	ʔɐmɪljaɾ
karibal	kxɐɾɪbal
indulhensiya	ʔɪndʊlhenʃa
aglahi	ʔɐɡlahɪʔ
megumi	meɰumɪ
bagang	bɐɡʔaŋ
biray	bɪɾaɪ̯
atubili	ʔɐtʊbɪliʔ
hawakan	hɐwɐxan
bulwang	bʊlwaŋ
damahan	dɐmahɐn
dahilig	dɐlɪhiɡ
ayuda	ʔɐjudɐ
balaye	bɐlaje
abakus	ʔabɐxus
instruktor	ʔɪnstɾʊktoɾ
linatoc	lɪnatok
cagao	kxaɰaʊ̯
espina	ʔespinɐ
aduwana	ʔɐdwɐnɐ
lamang	lɐmaŋ
balingot	bɐliŋot
gakgak	ɡɐkɡak
lagaklak	lɐɰɐklak
lugami	lʊɰamɪʔ
pandiwa	pɐndiwɐʔ
indiyana	ʔɪnd͡ʒanɐ
lasunin	lɐsunɪn
king	kxɪŋ
kuha	kxuhɐ
magbubukid	mɐɡbʊbuxɪd
lubog	lʊboɡ
kolado	kxolado
intimidasyon	ʔɪntɪmɪdɐʃon
mangupit	mɐŋupɪt
ipasok	ʔɪpasok
langkas	lɐŋkas
bangungot	bɐŋuŋot
inggit	ʔɪŋɡit
dedikado	dedɪxado
angkin	ʔɐŋkin
tuba	tʊba
kikyam	kxikjɐm
bulati	bʊlate
kuwadra	kwadɾɐ
lumay	lʊmaɪ̯
pusa	pusɐʔ
danumbiling	danumbɪliŋ
apresyasyon	ʔɐpɾeʃɐʃon
himagsik	hɪmɐɡsik
ahunin	ʔɐhunɪn
hagdan	hɐɡdan
magbigay	mɐɡbɪɰaɪ̯
inso	ʔɪnso
lagda	lɐɡdaʔ
kunwari	kxʊnwaɾɪʔ
gumapac	ɡʊmapɐk
karayom	kxɐɾajom
panalangin	pɐnɐlaŋɪn
balat	bɐlat
kilikiti	kxɪlɪxɪtiʔ
anyo	ʔaɲo
iprint	ʔɪpɾint
kyoko	kjoxo
agahas	ʔɐɰahɐs
masangkay	mɐsaŋkaɪ̯
kaibuturan	kxɐʔɪbʊtuɾɐn
dimig	dɪmiɡ
akba	ʔɐkba
anot	ʔɐnot
bitig	bitɪɡ
langaray	lɐŋaɾaɪ̯
indayog	ʔɪndajoɡ
istatwa	ʔɪstatwɐ
laruan	lɐɾʊʔan
hangin	haŋɪn
botohan	botohɐn
ingkorporasyon	ʔɪŋkoɾpoɾɐʃon
natural	nɐtʊɾal
batay	bataɪ̯
amuyong	ʔɐmujoŋ
dangal	dɐŋal
torrecampo	toɾɾexampo
akompanya	ʔɐxumpɐɲa
bungo	bʊŋoʔ
polonya	poloɲɐ
gascon	ɡɐskon
dagipik	dɐɰipɪk
ganoon	ɡɐnon
libre	lɪbɾe
lira	liɾɐʔ
banyaga	bɐɲɐɰɐʔ
binhay	bɪŋhaɪ̯
buson	bʊson
banoglawin	bɐnoɡlawɪn
kaphay	kxɐphaɪ̯
kahalagahan	kxɐhɐlɐɰɐhan
maglabas	mɐɡlɐbas
baba	bɐba
tungaw	tʊŋaʊ̯
basurero	bɐsʊɾeɾo
mabato	mɐbɐto
biniboy	bɪniboɪ̯
uwi	ʔʊiʔ
maglapastangan	mɐɡlɐpɐstaŋɐn
aratiles	ʔɐɾatɪles
lagundi	lɐɰʊndiʔ
segunda	seɰundɐ
tigang	tiɰɐŋ
tumingala	tʊmɪŋɐlaʔ
estola	ʔestolɐ
ekisan	ʔexisɐn
limonada	lɪmonadɐ
simpatiko	sɪmpatɪxo
litigante	lɪtɪɰante
liga	liɰɐ
gayot	ɡɐjot
hikab	hɪxab
kaibuturan	kxaʔɪbʊtuɾɐn
boongaling	booŋɡalɪŋ
bitas	bitɐs
umpisa	ʔumpɪsa
islam	ʔislɐm
mamamangka	mɐmɐmɐŋkaʔ
selular	selulɐɾ
bula	bʊla
hira	hɪɾa
palasihayan	pɐlɐsɪhajɐn
gusot	ɡʊsot
kasiguraduhan	kxɐsɪɰʊɾɐduhɐn
tio	t͡ʃo
itik	ʔitɪk
adiksiyon	ʔɐdɪkʃon
dalok	dɐlok
gilong	ɡɪloŋ
bilyonarya	bɪljonaɾjɐ
hiwa	hiwɐʔ
maghapon	mɐɡhapon
laskuta	lɐskutɐʔ
bulsa	bʊlsa
islandiya	ʔɪsland͡ʒa
onomastika	ʔonomastɪxa
administrador	ʔɐdmɪnɪstɾɐdoɾ
dilihensiya	dɪlɪhenʃa
karerahan	kxaɾeɾɐhan
orendain	ʔoɾendaɪ̯n
daspanin	daspɐnin
supil	supɪl
bantuan	bɐntʊʔan
bayaw	bajaʊ̯
arkeologo	ʔɐɾkeoloɰo
ganta	ɡantɐ
abain	ʔɐbɐʔin
lambak	lɐmbak
ilan	ʔɪlan
hakot	hɐxot
ipatanggal	ʔɪpɐtɐŋɡal
iwi	ʔɪwi
dais	dɐʔis
arsobispado	ʔɐɾsobɪspado
huwepe	hʊepe
alisto	ʔɐlisto
balato	bɐlato
cabral	kxabɾɐl
kuneho	kxʊneho
aplikasyon	ʔɐplɪxɐʃon
linggatong	lɪŋɡatoŋ
dumihan	dumihɐn
kagalingan	kxɐɰɐliŋɐn
gamit	ɡɐmit
balisuplingan	bɐlɪsʊpliŋɐn
koneksiyon	kxonekʃon
lowat	lowɐt
bigamiya	bɪɰɐmiɐ
hukay	huxaɪ̯
luwad	lwad
bulalo	bʊlɐloʔ
anahaw	ʔɐnahaʊ̯
pinaghihinalaan	pɪnɐɡhɪhɪnɐlaɐn
anda	ʔandɐ
dalubhayop	dɐlubhajop
balyena	bɐljenɐ
apalya	ʔɐpɐlja
ligaw	liɰaʊ̯
lumanay	lʊmanaɪ̯
panghimpapawid	pɐŋhɪmpɐpɐwid
luhuran	luhuɾɐn
makati	mɐxatɪ
lumpiya	lumpjaʔ
liwaliw	lɪwɐliʊ̯
diigkasin	dɪʔɪɡkasɪn
sagana	sɐɰanɐ
dita	dɪtaʔ
lanip	lanɪp
kabayanihan	kxɐbɐjɐnihɐn
dakila	dɐxilɐʔ
abakada	ʔɐbɐxadɐ
inana	ʔɪnanɐ
taboy	tɐboɪ̯
mandukot	mɐnduxot
singil	sɪŋil
agingay	ʔɐɰiŋaɪ̯
kuwapaw	kwapaʊ̯
epilepsiya	ʔepɪlepʃa
lukto	lʊktoʔ
limampu	lɪmɐmpuʔ
patiño	pɐtiɲo
bulag	bulɐɡ
baluga	bɐluɰɐʔ
labi	lɐbiʔ
lunsad	lʊnsad
balot	bɐlot
sabunin	sɐbʊnin
isumbong	ʔɪsumboŋ
kaliskis	kxɐlɪskis
gawgaw	ɡaʊ̯ɰaʊ̯
mamimili	mɐmɪmɪli
daniw	dɐniʊ̯
mamasa	mɐmɐsaʔ
bukas	bʊxas
tawanan	tɐwɐnan
inglesera	ʔɪŋɡleseɾɐ
lingming	lɪŋmiŋ
mambola	mɐmbolɐ
bangkuro	bɐŋkuɾo
cinco	siŋko
bodega	bodeɰɐ
mapahiya	mɐpɐhɪaʔ
daldal	dɐldal
abukay	ʔɐbuxaɪ̯
imperyo	ʔɪmpeɾjo
diyan	d͡ʒɐʔan
kumbulsiyon	kxumbʊlʃon
magnanakaw	mɐɡnɐnɐxaʊ̯
busabos	bʊsabos
balakbak	bɐlɐkbak
butod	bʊtod
lista	lɪsta
magarbo	mɐɰaɾbo
gala	ɡalɐ
maburyong	mɐbʊɾjoŋ
ilagay	ʔɪlɐɰaɪ̯
baywang	bewɐŋ
talang	talɐŋ
hagak	haɰɐk
bataw	bataʊ̯
ama	ʔamɐ
disgrasya	dɪsɡɾaʃɐ
halak	hɐlak
ingil	ʔiŋɪl
tupi	tʊpiʔ
gilit	ɡilɪt
bungi	buŋɪʔ
dyipni	d͡ʒipnɪ
simbulan	sɪmbulɐn
ganyak	ɡɐɲak
hirang	hɪɾaŋ
akrostik	ʔɐkɾostɪk
biya	biɐ
paggatas	pɐɡɡatɐs
holdap	holdɐp
maravilla	mɐɾɐbiljɐ
deklarasyon	deklɐɾɐʃon
pagkabuhay	pɐɡkabuhaɪ̯
bati	bɐtiʔ
hiwa	hɪwaʔ
ibaloy	ʔɪbɐloɪ̯
agta	ʔɐɡta
banaag	banɐɐɡ
maghumpay	mɐɡhumpaɪ̯
himpilan	hɪmpɪlan
balnikapnayan	bɐlnɪxɐpnajɐn
dinding	dɪndiŋ
gawi	ɡɐwi
dalubituinan	dɐlubɪtʊʔɪnan
adwana	ʔɐdwanɐ
tunton	tʊnton
embalsamador	ʔembɐlsɐmɐdoɾ
mahiwaga	mɐhɪwaɰɐʔ
bantot	bɐntot
detalyado	detɐljado
alwagi	ʔɐlwaɰɪ
decena	desenɐ
linta	lɪntaʔ
bukayo	bʊxajoʔ
halay	halaɪ̯
kinabukasan	kxɪnabʊxasɐn
pahiyain	pɐhɪɐʔin
linggi	lɪŋɡiʔ
mangoba	mɐŋobɐ
dapithapon	dɐpɪthapon
bakterya	bɐkteɾjɐ
bambang	bɐmbaŋ
magnanay	mɐɡnanaɪ̯
itawit	ʔɪtawɪt
katawan	kxɐtɐwan
abyog	ʔɐbjoɡ
ilong	ʔɪloŋ
sukgisan	sʊkɡisɐn
mandurukot	mɐndʊɾuxot
dausdos	dɐʔʊsdos
himay	himaɪ̯
dampot	dɐmpot
lagpas	lɐɡpas
insesto	ʔɪnsesto
aga	ʔaɰɐ
espantaho	ʔespɐntaho
gambol	ɡɐmbol
pinagtawanan	pɪnaɡtɐwanɐn
drakula	dɾaxʊlɐ
apektado	ʔɐpektado
dagupan	dɐɰupɐn
biyanan	bɪenan
dantay	dɐntaɪ̯
habonero	hɐboneɾo
puntahan	pʊntɐhan
maceda	mɐsedɐ
amatista	ʔɐmɐtistɐ
diplomata	dɪplomɐta
caluya	kxɐlujɐ
topak	topɐk
hagulhol	hɐɰʊlhol
mañago	mɐɲɐɰo
awtoridad	ʔotoɾɪdad
digtalain	dɪɡtalɐʔin
ayungin	ʔɐjuŋɪn
singkit	sɪŋkit
lasa	lasɐʔ
bilyonaryo	bɪljonaɾjo
amoy	ʔɐmoɪ̯
epidemia	ʔepɪdemjɐ
awtismo	ʔaʊ̯tismo
rusya	ɾuʃɐ
gaspang	ɡɐspaŋ
latay	lataɪ̯
gumi	ɡʊmi
lawa	lawɐʔ
ipasagot	ʔɪpɐsɐɰot
basi	basɪʔ
kalinisan	kxɐlɪnisɐn
gapi	ɡɐpiʔ
dagitigilan	dɐɰɪtiɰɪlan
burado	bʊɾado
adorno	ʔɐdoɾno
macadangdang	mɐxɐdaŋdɐŋ
komunyon	kxomʊɲon
pain	paʔɪn
anatomista	ʔɐnɐtomistɐ
abrenica	ʔɐbɾenixɐ
gibay	ɡibaɪ̯
lanab	lanɐb
sentigrado	sentɪɡɾado
nakakaintriga	nɐxɐkɐʔɪntɾiɰɐ
figueroa	fɪɰeɾoɐ
duhat	duhɐt
butudkaphay	bʊtudkɐphaɪ̯
teknolohiya	teknolohiɐ
kalusugan	kxɐlʊsuɰɐn
halukipkip	hɐlʊxɪpkip
edukada	ʔedʊxadɐ
alitangya	ʔɐlɪtɐŋja
kondisyon	kxondɪʃon
litaw	lɪtaʊ̯
ulam	ʔulɐm
labimpito	lɐbimpɪto
taruc	taɾʊk
dampalit	dɐmpɐlit
labandera	lɐbɐndeɾɐ
balintuna	bɐlɪntunɐʔ
kinatawan	kxɪnɐtɐwan
pawisan	pɐwisɐn
interprete	ʔɪnteɾpɾete
osamu	ʔosamʊ
ebidensya	ʔebɪdenʃɐ
imperyalismo	ʔɪmpeɾjɐlismo
balahak	bɐlahɐk
maglantod	mɐɡlɐntod
burloloy	bʊɾloloɪ̯
balisungsong	bɐlɪsʊŋsoŋ
maralit	mɐɾalɪt
irebisa	ʔɪɾebɪsa
dalhin	dɐlhin
hagahas	hɐɰɐhas
puke	puxe
hapag	hɐpaɡ
lupi	lʊpiʔ
aghimuin	ʔɐɡhimʊɪn
lumaban	lʊmabɐn
lukulok	lʊxʊlok
bantulot	bɐntʊlot
giit	ɡiɪt
despertador	despeɾtɐdoɾ
catimbang	kxɐtimbɐŋ
kapakanan	kxɐpɐxɐnan
bantas	bɐntas
lungib	lʊŋib
kalat	kxalɐt
aspekto	ʔɐspekto
agwas	ʔɐɡwas
dilubyo	dɪlubjo
babero	bɐbeɾo
komunismo	kxomʊnismo
setyembre	set͡ʃembɾe
ketong	kxetoŋ
pader	pɐdeɾ
musoleyo	mʊsolejo
asinta	ʔɐsɪnta
badyet	bad͡ʒet
kapag	kxɐpaɡ
arsobispo	ʔɐɾsobispo
amnestiya	ʔɐmnestiɐ
talento	tɐlento
lanuza	lɐnusɐ
gumayak	ɡʊmɐjak
ibagsak	ʔɪbɐɡsak
golondrina	ɡolondɾinɐ
villafranca	bɪllɐfɾaŋkɐ
tatlumpu	tɐtlumpuʔ
dalandan	dɐlɐndan
kimona	kxɪmonɐ
konsultant	kxonsultɐnt
peluka	peɾuxɐ
alinlangan	ʔɐlɪnlaŋɐn
frias	fɾɪɐs
baging	baɰɪŋ
gining	ɡinɪŋ
biki	bixɪʔ
kapok	kxapok
astinggal	ʔɐstɪŋɡal
eskandalosa	ʔeskɐndɐlosɐ
mabitamina	mɐbɪtɐminɐ
pasay	pasaɪ̯
kaniyugan	kxɐɲʊɰɐn
chang	t͡ʃɐŋ
lakip	lɐxip
identipikasyon	ʔɪdentɪpɪxɐʃon
dangkal	dɐŋkal
haplos	hɐplos
makatotohanan	mɐxɐtotohanɐn
kusa	kxusɐʔ
ilocos	ʔɪloxos
amoritis	ʔɐmoɾitɪs
maghati	mɐɡhatɪʔ
manlutac	mɐnlutɐk
balsahan	bɐlsɐhan
samonte	sɐmonte
hakhak	hɐkhak
villamater	bɪllɐmateɾ
bugtong	bʊɡtoŋ
luganggang	lʊŋɡɐɰaŋ
mangamote	mɐŋɐmote
henetika	henetɪxa
bakal	bɐxal
palaka	pɐlɐxaʔ
jalandoni	d͡ʒɐlɐndonɪ
bigamya	bɪɰɐmja
asta	ʔastɐ
magsiwalat	mɐɡsɪwalɐt
ekonomista	ʔexonomistɐ
hampaslupa	hɐmpaslupɐʔ
bungi	bʊŋiʔ
anino	ʔɐnino
kalidad	kxɐlɪdad
lagari	lɐɰɐɾiʔ
abalos	ʔabɐlos
lacap	laxɐp
halihaw	hɐlihaʊ̯
basilan	bɐsilɐn
bathalaan	bɐthɐlaʔɐn
harimanawari	haɾɪmɐnɐwaɾɪʔ
industriyal	ʔɪndʊstɾjal
oliba	ʔolibɐ
gahi	ɡɐhiʔ
piyo	pjoʔ
ayaw	ʔɐjaʊ̯
bisor	bɪsoɾ
maamag	mɐʔamɐɡ
keso	kxeso
entrada	ʔentɾadɐ
amis	ʔɐmis
kilay	kxilaɪ̯
bota	botɐ
bastos	bɐstos
haha	hɐha
aa	ʔɐʔaʔ
lukot	lʊxot
mabuwisit	mɐbwisɪt
lako	lɐxo
mamuhunan	mɐmʊhunɐn
bagkos	bɐɡkos
karton	kxɐɾton
ingat	ʔiŋɐt
bakam	bɐxam
megan	meɰɐn
anwang	ʔɐnwaŋ
eskaparate	ʔeskɐpɐɾate
gatilyo	ɡɐtiljo
liling	lilɪŋ
gumawa	ɡʊmɐwaʔ
pinas	pɪnas
linisan	lɪnɪsan
asim	ʔasɪm
magaling	mɐɰalɪŋ
kailangan	kxɐʔɪlaŋɐn
argente	ʔɐɾhente
kambal	kxambɐl
eskabetse	ʔeskɐbet͡ʃe
liso	lɪsoʔ
tung	tʊŋ
gitlapi	ɡɪtlapɪʔ
latitud	lɐtɪtud
lansangan	lɐnsaŋɐn
apokripos	ʔɐpokɾɪpos
dosis	dosɪs
diskita	dɪskɪta
misteryo	mɪsteɾjo
pacana	pɐxanɐ
aleman	ʔɐleman
barat	bɐɾat
magbaon	mɐɡbaʔon
yalung	jalʊŋ
baliin	bɐliʔɪn
umiskor	ʔʊmɪskoɾ
ignoransiya	ʔɪɡnoɾanʃɐ
daw	daʊ̯
aghimo	ʔɐɡhimoʔ
caguioa	kxɐɰiwɐ
pagtutulungan	pɐɡtʊtʊlʊŋan
ragas	ɾaɰɐs
mababa	mɐbabɐʔ
bomba	bumbɐ
kalapati	kxɐlɐpatɪ
abdurahman	ʔɐbdʊɾahmɐn
gilagiran	ɡɪlɐɰiɾɐn
tang	tɐŋ
amorseko	ʔɐmoɾsexo
mansanitas	mɐnsɐnitɐs
bukal	bʊxal
mamumundok	mamʊmʊndok
lagas	laɰɐs
bernabe	beɾnɐbe
kalat	kxɐlat
tino	tɪnoʔ
palayasin	pɐlɐjasɪn
lagap	lɐɰap
linab	lɪnab
iyak	ʔɪak
fulgencio	fʊlhenʃo
maglingid	mɐɡlɪŋid
akyatan	ʔɐkjatɐn
tanga	tɐŋa
banyo	baɲo
limusina	lɪmʊsinɐ
marungis	mɐɾuŋɪs
halina	hɐlinɐ
amyenda	ʔɐmjendɐ
aktibidad	ʔɐktɪbɪdad
makaako	mɐxɐʔɐxo
dampi	dɐmpiʔ
demanda	demandɐ
lipol	lɪpol
mekanismo	mexɐnismo
bago	baɰo
mamanhikan	mɐmɐŋhixɐn
basta	bɐstaʔ
dalmatika	dɐlmatɪxa
alisagsag	ʔɐlɪsɐɡsaɡ
garchitorena	ɡɐɾt͡ʃɪtoɾenɐ
bitad	bɪtad
bakas	baxɐs
hataw	hataʊ̯
aminin	ʔɐminɪn
makinis	mɐxinɪs
dalaga	dɐlaɰɐ
abusuhin	ʔɐbʊsuhɪn
halili	hɐlilɪ
itali	ʔɪtalɪʔ
pinagtaluhan	pɪnaɡtɐluhɐn
simbahan	sɪmbahɐn
bulanhagui	bʊlɐŋhaɰɪ
gawin	ɡɐwin
akala	ʔɐxalɐʔ
batsoy	bɐt͡ʃoɪ̯
mallorca	mɐlloɾkɐ
bondying	bond͡ʒiŋ
buot	bʊʔot
lalagukan	lɐlɐɰuxɐn
diskarte	dɪskaɾte
bwisit	bwisɪt
linga	liŋɐʔ
liyamado	lɪɐmado
dimig	dimɪɡ
makulit	mɐxʊlit
dalo	dɐlo
basta	bɐsta
kanada	kxɐnɐda
kondensada	kxondensadɐ
dahilan	dɐhɪlan
bayong	bɐjoŋ
puntirya	pʊntɪɾja
takako	tɐxako
iswad	ʔɪswad
bamban	bɐmban
magbabasa	mɐɡbɐbɐsaʔ
payapa	pɐjapɐʔ
batak	batɐk
agimat	ʔɐɰimɐt
imparsiyal	ʔɪmpɐɾʃal
plapla	plaplɐ
hidwaan	hɪdwaʔɐn
abay	ʔabaɪ̯
grumadweyt	ɡɾʊmadweɪ̯t
lubang	lubɐŋ
sanggumay	sɐŋɡumaɪ̯
adlaw	ʔɐdlaʊ̯
gacutan	ɡɐxutɐn
palaboy	pɐlaboɪ̯
depensa	depensɐ
mangalandakan	mɐŋɐlɐndaxɐn
arkila	ʔaɾkɪla
lungkag	lʊŋkaɡ
banoy	banoɪ̯
integrasyon	ʔɪnteɡɾɐʃon
lilik	lilɪk
listahan	lɪstahɐn
balam	balɐm
bungkugan	bʊŋkuɰɐn
gawain	ɡawaʔɪn
mahulog	mɐhuloɡ
kapangyarihan	kxɐpɐŋjɐɾihɐn
inmoralidad	ʔɪmmoɾɐlɪdad
asar	ʔɐsaɾ
halukay	hɐlʊxaɪ̯
dungis	duŋɪs
kimika	kximɪxa
kapanahunan	kxɐpɐnɐhunɐn
daulat	dɐʔʊlat
balbon	bɐlbon
mañalac	mɐɲɐlɐk
rebentador	ɾebentɐdoɾ
halibhib	hɐlɪbhib
lampas	lɐmpas
isabela	ʔɪsɐbelɐ
makibahagi	mɐxɪbɐhaɰɪʔ
iran	ʔɪɾan
interpretasyon	ʔɪnteɾpɾetɐʃon
gastusin	ɡastʊsin
kaberdehan	kxɐbeɾdehan
laslas	lɐslas
lasinggera	lɐsɪŋɡeɾɐ
puson	pʊson
alis	ʔɐlis
gasta	ɡɐsta
yuichiro	jʊɪt͡ʃiɾo
lalan	lɐlan
tanghali	tɐŋhalɪʔ
resistensya	ɾesɪstenʃɐ
bakit	baxet
lintos	lɪntos
malanta	mɐlɐnta
maghilik	mɐɡhɪlik
drama	dɾamɐ
aratilis	ʔɐɾatɪlis
bariles	bɐɾiles
atsi	ʔɐt͡ʃi
batugan	bɐtuɰɐn
baga	bɐɰa
laylo	laɪ̯lo
magaso	mɐɰɐso
hula	hulɐʔ
pipi	pipɪ
bokya	bokjɐʔ
manantan	mɐnantɐn
balwarte	bɐlwaɾte
kasoy	kxɐsoɪ̯
dutaan	dutɐʔɐn
husga	hʊsɡa
mais	mɐʔis
disipulo	dɪsipʊlo
daan	daʔɐn
alikabok	ʔɐlɪxɐbok
gulay	ɡulaɪ̯
liha	lihɐʔ
ahente	ʔɐhente
halea	hɐleja
magbayad	mɐɡbajɐd
tiis	tɪʔis
calingasan	kxɐlɪŋasɐn
lebadura	lebɐduɾɐ
asada	ʔɐsadɐ
edukado	ʔedʊxado
uhaw	ʔʊhaʊ̯
imus	ʔimʊs
hawig	hawɪɡ
hunta	huntɐ
dimailig	dɪmaɪ̯lɪɡ
lawaan	lɐwaʔɐn
idroheno	ʔɪdɾoheno
deposito	deposɪto
pakupya	pɐxʊpjaʔ
audrey	ʔaʊ̯dɾeɪ̯
ikalat	ʔɪxalɐt
editoryal	ʔedɪtoɾjal
daisuke	daɪ̯suxe
nakakaalarma	nɐxɐkɐɐlaɾmɐ
desesperada	desespeɾadɐ
dayalekto	dɐjɐlekto
tuwa	twaʔ
halip	hɐlip
agos	ʔaɰos
pantig	pantɪɡ
bugnot	bʊɡnot
wiski	wiskɪ
dalwa	dɐlwa
bitaog	bɪtaʔoɡ
luoy	lʊʔoɪ̯
himasmas	hɪmɐsmas
dulit	dulɪt
likido	lixɪdo
pagka	pɐɡka
pagsasabansa	pɐɡsɐsɐbɐnsaʔ
makulimlim	mɐxʊlɪmlim
kaban	kxɐban
inunan	ʔɪnunɐn
biray	biɾaɪ̯
liwayway	lɪwaɪ̯waɪ̯
biloy	biloɪ̯
uling	ʔulɪŋ
tapay	tapaɪ̯
agaw	ʔɐɰaʊ̯
buwanan	bwanɐn
biyetnam	bɪetnam
salarin	sɐlɐɾin
apak	ʔɐpak
bunton	bʊnton
magnakaw	mɐɡnaxaʊ̯
ensaymada	ʔensaɪ̯madɐ
lagapak	lɐɰɐpak
timbang	tɪmbaŋ
tonelada	toneladɐ
himutok	hɪmʊtok
batidor	bɐtɪdoɾ
sultana	sʊltanɐ
alay	ʔalaɪ̯
maghabilin	mɐɡhɐbilɪn
beripikahin	beɾɪpɪxɐhin
balasabas	bɐlɐsabɐs
guimaras	ɡɪmɐɾas
dikyam	dɪkjam
suntok	sʊntok
atsuwete	ʔɐt͡ʃʊete
intelihensiya	ʔɪntelɪhenʃa
pinapagtalunan	pɪnapɐɡtɐlʊnan
mariko	mɐɾixo
camarines	kxɐmɐɾines
traydor	tɾaɪ̯doɾ
hupa	hʊpaʔ
kuto	kxʊtoʔ
anakronismo	ʔɐnɐkɾonismo
balaguer	bɐlɐɰeɾ
bikas	bɪxas
mangulabnan	mɐŋʊlabnɐn
usisera	ʔʊsɪseɾɐ
lasenggo	lɐseŋɡo
labawsugnayan	lɐbaʊ̯sʊɡnajɐn
balisa	bɐlisɐ
bayabasan	bɐjɐbasɐn
lain	laɪ̯n
hatimbutod	hatɪmbʊtod
atis	ʔatɪs
impiyerno	ʔɪmpjeɾno
gulyabaw	ɡʊljabaʊ̯
banghay	bɐŋhaɪ̯
inosente	ʔɪnosente
interes	ʔɪnteɾes
villarino	bɪllɐɾino
macasieb	mɐxasɪeb
bali	balɪʔ
magbabaon	nɐɡbɐʔon
kikil	kxixɪl
klima	kxlimɐ
ayta	ʔaɪ̯ta
daong	dɐʔoŋ
dusa	dusɐ
interbensiyon	ʔɪnteɾbenʃon
mukha	mʊkhaʔ
angi	ʔɐŋi
imigrasyon	ʔɪmɪɡɾɐʃon
dalublumutan	dɐlublumʊtan
kita	kɪta
rumupok	ɾʊmʊpok
umalog	ʔʊmɐloɡ
dapdap	dɐpdap
kaibigan	kxaɪ̯bɪɰɐn
burgis	bʊɾɡis
prudente	pɾʊdente
burda	bʊɾda
limpak	lɪmpak
kuting	kxʊtiŋ
balasa	bɐlasɐ
mikiko	mɪxiko
anlaw	ʔɐnlaʊ̯
elastiko	ʔelastɪxo
alyas	ʔɐljas
tansiya	tɐnʃa
alsa	ʔɐlsa
cuasay	kwɐsaɪ̯
arsilya	ʔɐɾsiljɐ
huli	hulɪʔ
buwitre	bwɪtɾe
lukso	lʊkso
aktibista	ʔɐktɪbistɐ
materyalismo	mɐteɾjɐlismo
haba	habɐʔ
utot	ʔʊtot
posas	posɐs
bansag	bɐnsaɡ
hapis	hapɪs
habhab	habhɐb
dilig	dɪliɡ
dalubtalaan	dɐlubtalɐʔan
banig	bɐniɡ
alitan	ʔɐlitɐn
dalubtauhan	dɐlubtaʔʊhan
pagkabilanggo	pɐɡkɐbɪlɐŋɡoʔ
dalubkabibihan	dɐlubkabɪbɪhan
halo	hɐlo
latag	lɐtaɡ
lechias	let͡ʃiɐs
tipaklong	tipɐkloŋ
itak	ʔɪtak
apa	ʔɐpaʔ
hadlang	hɐdlaŋ
bumaba	bʊmɐba
inmoralidad	ʔɪmoɾɐlɪdad
pasulo	pɐsulo
bunyag	bʊɲaɡ
ika	ʔɪxaʔ
hamak	hamɐk
alpa	ʔɐlpa
magbakal	mɐɡbɐxal
lukob	luxob
hirasol	hɪɾɐsol
macaranas	mɐxɐɾanɐs
jimenez	hɪmenes
kalibugan	kxɐlɪbuɰɐn
manindigan	mɐnɪndiɰɐn
lungad	lʊŋad
bansa	bɐnsaʔ
haynayan	haɪ̯najɐn
adwa	ʔɐdwaʔ
dentista	dentistɐ
bulihala	bʊlɪhalɐʔ
pagtripan	pɐɡtɾɪpan
buturan	butʊɾan
liyama	ljɐmɐ
nabasa	nɐbasɐ
israel	ʔɪsɾɐʔel
banyera	bɐɲeɾɐ
fronda	fɾondɐ
lingid	lɪŋid
encarnado	ʔeŋkɐɾnado
kabanata	kxɐbɐnatɐʔ
tiozon	t͡ʃoson
propesyon	pɾopeʃon
tugtugin	tʊɡtuɰɪn
agapay	ʔɐɰapaɪ̯
mustasa	mʊstasɐ
politikal	polɪtɪxal
aspin	ʔaspɪn
bitsin	bɪt͡ʃin
amil	ʔamɪl
dinagipik	dɪnɐɰipɪk
paz	pɐs
cainta	kxɐʔɪntaʔ
hulma	hʊlma
gan	ɡɐn
lola	lolɐ
epal	ʔepɐl
halika	hɐlɪxa
antique	ʔɐntixe
eskrima	ʔeskɾimɐ
aso	ʔɐso
galawan	ɡɐlawɐn
ika	ʔixɐʔ
masabon	mɐsɐbon
lantod	lɐntod
tinapa	tɪnɐpa
laksante	lɐksante
batar	bɐtaɾ
aa	ʔɐɐ
tren	trɛn
asarol	ʔɐsɐɾol
dyas	d͡ʒɐs
halakhak	hɐlɐkhak
catanduanes	kxɐtɐndwɐnes
konserbatoryo	kxonseɾbɐtoɾjo
iglesya	ʔɪɡleʃɐ
ligta	lɪɡtaʔ
paskuwa	pɐskuɐ
maghingalo	mɐɡhɪŋɐlo
batik	bɐtik
liig	lɪʔiɡ
felicidad	felɪsɪdad
bakin	baxɪn
atensiyon	ʔɐtenʃon
agoy	ʔaɰoɪ̯
balnibulog	bɐlnɪbʊloɡ
tira	tiɾɐʔ
agap	ʔaɰɐp
konsentihin	kxonsentɪhin
mabini	mɐbinɪ
grasya	ɡɾaʃɐ
lupit	lʊpit
lamas	lɐmas
maghiganti	mɐɡhɪɰɐnti
legwas	leɡwɐs
cavan	kxɐban
ahang	ʔahɐŋ
daga	daɰɐ
larga	lɐɾɡa
hatiin	hɐtɪʔin
wahoy	wahoɪ̯
calaunan	kxɐlɐʔunɐn
matalo	mɐtalo
aktibidades	ʔɐktɪbɪdades
buhay	buhaɪ̯
duag	dwaɡ
aprikano	ʔɐpɾɪxano
layaw	lɐjaʊ̯
bunganga	bʊŋaŋɐʔ
lawit	lawɪt
welga	welɡɐ
baklain	bɐklɐʔin
banta	bɐntaʔ
baron	bɐɾon
duwag	dwaɡ
kahalayan	kxɐhɐlajɐn
sabater	sɐbateɾ
aktuwal	ʔɐktwal
balagat	bɐlaɰɐt
garapon	ɡɐɾɐpon
bayabasan	bajɐbɐsan
poon	pʊn
dama	dɐma
iskolar	ʔɪskolɐɾ
kompleto	kxumpleto
inain	ʔɪnɐʔin
limatik	lɪmɐtik
giling	ɡilɪŋ
alam	ʔɐlam
protekta	pɾotektɐ
hagikgik	hɐɰɪkɡik
pagbasehan	pɐɡbɐsehɐn
mabuti	mɐbutɪ
laog	lɐʔoɡ
ikog	ʔixoɡ
hesusmaryosep	hesusmɐɾjosep
hangos	hɐŋos
hiyaw	hɪaʊ̯
bignay	bɪɡnaɪ̯
amis	ʔamɪs
lipi	lipɪʔ
hangarin	hɐŋaɾɪn
lao	laʊ̯
buhag	buhɐɡ
almasiga	ʔɐlmɐsiɰɐ
tsinelas	t͡ʃɪnelɐs
krisma	kxɾismɐ
pasakalye	pɐsɐxalje
gayunman	ɡɐjʊmman
maabilidad	mɐʔɐbɪlɪdad
trapik	tɾapɪk
balintataw	bɐlɪntɐtɐʔo
humpay	humpaɪ̯
lukob	lʊxob
lohika	lohɪxa
bihis	bɪhis
alog	ʔɐloɡ
haka	haxɐʔ
villareal	bɪllaɾeɐl
alkansya	ʔɐlkanʃɐ
mondragon	mondɾaɰon
gunaw	ɡunaʊ̯
istorya	ʔɪstoɾjɐ
dalubwikaan	dɐlubwixɐʔan
tumingin	tʊmɪŋin
libis	lɪbis
hangad	hɐŋad
samid	sɐmid
amihan	ʔɐmihɐn
korap	kxoɾap
k	kx
pekulyaridad	pexʊljɐɾɪdad
gaga	ɡaɰɐ
hispanismo	hɪspɐnismo
larang	laɾɐŋ
kalendaryo	kxɐlendaɾjo
awtopsiya	ʔaʊ̯topʃa
magwala	mɐɡwɐlaʔ
kumunoy	kxʊmʊnoɪ̯
butaw	bʊtaʊ̯
pekulyar	pexʊljaɾ
van	bɐn
opeña	ʔopeɲɐ
garing	ɡaɾɪŋ
solis	solɪs
hidwa	hɪdwaʔ
indones	ʔɪndones
iwas	ʔiwɐs
tigang	tɪɰaŋ
amen	ʔɐmen
laab	lɐba
ubas	ʔubɐs
pamamahagi	pɐmɐmɐhaɰɪʔ
hitad	hitɐd
budista	bʊdistɐ
bawi	bawɪʔ
disenyo	dɪseɲo
kulangi	kxʊlaŋɪʔ
danay	danaɪ̯
mahistrado	mɐhɪstɾado
maglalang	mɐɡlalɐŋ
basbasan	bɐsbɐsan
bruselas	bɾʊselɐs
atupag	ʔɐtupɐɡ
umawat	ʔʊmawɐt
masahiro	mɐsɐhiɾo
hapon	hɐpon
tanikala	tɐnɪxɐlaʔ
biscocho	bɪskot͡ʃo
bilis	bɪlis
kaloob	kxɐloʔob
anghang	ʔɐŋhaŋ
kahandaan	kxɐhɐndɐʔan
bangkal	bɐŋkal
kontakin	kxontaxɪn
imbes	ʔɪmbes
labakara	lɐbɐxaɾɐ
lugi	luɰɪ
kinalaman	kxɪnalɐman
empake	ʔempaxe
dawis	dawɪs
abante	ʔɐbante
luway	lwaɪ̯
albay	ʔɐlbaɪ̯
danumbulog	danumbʊloɡ
balitado	bɐlɪtado
lupasay	lʊpasaɪ̯
lilim	lilɪm
abuluyan	ʔɐbʊlujɐn
bayo	bɐjo
hapones	hɐpones
batingaw	bɐtɪŋaʊ̯
lakad	laxɐd
pasyente	pɐʃente
hagkan	hɐɡkan
leksiyon	lɪkʃon
bangkete	bɐŋkete
luwalhati	lʊɐlhatɪʔ
bulol	bʊlol
suazo	swɐso
nobuhisa	nobʊhisɐ
ahiya	ʔɐhiɐ
lulon	lʊlon
banat	bɐnat
bitsuwelas	bɪt͡ʃʊelɐs
iriga	ʔɪɾɪɰa
lasap	lɐsap
betsin	bet͡ʃɪn
destinasyon	destɪnɐʃon
tiris	tɪɾis
kakahuyan	kxɐxɐhʊjan
kliyente	kljente
daliri	dɐliɾɪʔ
marapao	mɐɾapɐo
sais	sɐʔis
dara	dɐɾa
balangay	bɐlaŋaɪ̯
nganga	ŋaŋɐʔ
suan	swɐn
yari	jɐɾɪ
hudas	hudɐs
paasa	pɐʔasɐ
maliwanag	mɐlɪwanɐɡ
biyenan	bɪenan
ginhawa	ɡɪŋhawɐ
awstralya	ʔaʊ̯stɾɐljɐ
kidlat	kxɪdlat
lengguwahe	leŋɡwɐhe
isauli	ʔɪsolɪʔ
libag	lɪbaɡ
bahay	bahaɪ̯
lipot	lɪpot
binabae	bɪnɐbaʔe
ebaporada	ʔebɐpoɾadɐ
buntutan	bʊntʊtan
alimango	ʔɐlɪmaŋo
griyego	ɡɾjeɰo
dalubkulisapan	dɐlubkulɪsapɐn
bagabag	bɐɰɐbaɡ
pipi	pɪpiʔ
diyalogo	d͡ʒaloɰo
kulugo	kxʊlʊɰo
cenizal	senisɐl
baley	bɐleɪ̯
diskusyon	dɪskʊʃon
ingklusyon	ʔɪŋklʊʃon
alimuom	ʔɐlɪmuʔom
hiyo	hɪo
balisawsaw	bɐlɪsaʊ̯saʊ̯
bapor	bɐpoɾ
kabo	kxabo
dumausdos	dʊmɐʔʊsdos
dalurok	dɐluɾok
kaalit	kxaɐlɪt
dugyot	dʊɡjot
cadayona	kxɐdɐjonɐ
malas	malɐs
lago	laɰo
montejo	ʔɐlkaɪ̯de
banga	baŋɐʔ
kababaan	kxɐbɐbaʔɐn
inapo	ʔɪnɐpo
desidido	desɪdido
cagalingan	kxɐɰɐliŋɐn
gladyador	ɡlɐd͡ʒɐdoɾ
atigin	ʔɐtɪɰin
ikabilanggo	ʔɪxɐbɪlɐŋɡoʔ
bugarin	bʊɰaɾɪn
lagusan	laɰusɐn
bataraza	bɐtɐɾasɐ
mangagat	mɐŋɐɰat
parke	pɐɾke
hasa	hɐsaʔ
aninaw	ʔɐninaʊ̯
alpapa	ʔɐlpapɐ
hiya	hɪaʔ
yari	jaɾɪʔ
gawi	ɡɐwiʔ
angot	ʔɐŋot
akit	ʔɐxit
dakdak	dɐkdak
balatong	bɐlatoŋ
biyay	bjaɪ̯
utang	ʔutɐŋ
bungangero	bʊŋɐŋeɾo
marani	mɐɾɐniʔ
alberto	ʔɐlbeɾto
mabulaklak	mɐbʊlɐklak
virrey	biɾɾeɪ̯
dagindas	dɐɰɪndas
laberinto	lɐbeɾinto
sangkot	sɐŋkot
berdugo	beɾduɰo
ipodromo	ʔɪpodɾomo
kabiguan	kxɐbiɰuʔɐn
husgado	hʊsɡado
disiplinahin	dɪsɪplɪnahɪn
humaling	hʊmalɪŋ
hita	hɪtaʔ
bangas	bɐŋas
igi	ʔiɰɪ
lisok	lɪsok
labo	lɐboʔ
simento	sɪmento
belarusya	belɐɾuʃɐ
daluhong	dɐluhoŋ
hinlog	hɪnloɡ
papansin	pɐpansɪn
magbulakbol	mɐɡbʊlɐkbol
kotse	kxot͡ʃe
gancayco	ɡɐŋkaɪ̯xo
pahamak	pɐhamɐk
dalit	dɐlit
bola	bolɐ
kababaihan	kxɐbɐbɐʔihɐn
tsismis	t͡ʃismɪs
daga	dɐɰaʔ
huwisyo	hʊɪʃo
karakter	kxɐɾakteɾ
arnibal	ʔɐɾnibɐl
atsara	ʔɐt͡ʃaɾɐ
esmeralda	ʔesmeɾaldɐ
calamba	kxɐlɐmba
angis	ʔɐŋis
bumbunan	bumbunɐn
abono	ʔɐbono
hayag	hɐjaɡ
jaramillo	hɐɾɐmiljo
ata	ʔatɐ
sidras	sidɾɐs
rajah	ɾahɐ
katuwang	kxɐtwaŋ
lulod	lʊlod
fuentebella	pʊentebeljɐ
ikawalo	ʔɪxɐwɐlo
sabsab	sabsɐb
buumbilang	bʊʔumbilɐŋ
ikuko	ʔɪxuko
ining	ʔɪniŋ
tapos	tɐpos
mambuwisit	mɐmbwisɪt
sabangan	sɐbaŋɐn
garay	ɡaɾaɪ̯
tiyahin	t͡ʃahɪn
guniguni	ɡʊniɰʊni
gobernador	ɡobeɾnɐdoɾ
buwan	bwan
malakanyang	mɐlɐxaɲɐŋ
bonilla	boniljɐ
layter	laɪ̯teɾ
bunag	bunɐɡ
maya	majɐ
lokalidad	loxɐlɪdad
olivares	ʔolɪbaɾes
kaliwete	kxɐlɪwete
marinduque	mɐɾɪnduxe
babasahin	bɐbɐsahɪn
nakakahawa	nɐxɐkɐhawɐ
adres	ʔɐdɾes
baliw	balɪʊ̯
fontelera	fonteleɾɐ
tabas	tɐbas
dumilim	dʊmɪlim
brasil	bɾɐsil
hila	hilɐ
diit	dɪʔit
nagbaon	nɐɡbaʔon
dayuhan	dɐjʊhan
industriya	ʔɪndustɾja
alupag	ʔɐlʊpaɡ
apitong	ʔɐpitoŋ
baiki	bɐʔixɪʔ
donat	donɐt
balat	balɐt
iskultor	ʔɪskʊltoɾ
isakay	ʔɪsɐxaɪ̯
mamamahayag	mɐmɐmɐhɐjaɡ
balinsasayaw	bɐlinsɐsɐjaʊ̯
arwa	ʔɐɾwaʔ
desyerto	deʃeɾto
sioson	ʃoson
olivera	ʔolɪbeɾɐ
ampiteatro	ʔɐmpɪteɐtɾo
sundang	sʊndaŋ
lamyerda	lɐmjeɾdɐ
pilantropo	pɪlantɾopo
kaopisina	kxɐopɪsinɐ
abril	ʔɐbɾil
balakat	bɐlaxɐt
tubo	tʊbo
latin	lɐtin
kungyari	kxʊŋjaɾɪ
tirahan	tɪɾɐhan
papagtalunan	papɐɡtɐlunɐn
gapok	ɡɐpok
aysing	ʔaɪ̯sɪŋ
idea	ʔɪdejɐ
abokado	ʔɐboxado
luzano	lʊsano
pinapagtawanan	pɪnapɐɡtɐwanɐn
lakwatsera	lɐkwɐt͡ʃeɾɐ
vinoya	bɪnojɐ
lakansugo	lɐxɐnsuɰoʔ
bulahaw	bʊlahaʊ̯
inumin	ʔɪnʊmin
langhap	lɐŋhap
lagong	laɰoŋ
bugbog	bʊɡboɡ
lasaw	lɐsaʊ̯
gitata	ɡɪtatɐʔ
astaka	ʔɐstɐxaʔ
patayin	pɐtɐjin
busangot	bʊsaŋot
tapales	tɐpales
bangkuta	bɐŋkutɐʔ
introduksiyon	ʔɪntɾodʊkʃon
lagayan	lɐɰɐjan
tungkos	tʊŋkos
bukot	bʊxot
agaw	ʔaɰaʊ̯
habilog	hɐbɪloɡ
karambola	kxɐɾɐmbolɐ
lumaki	lʊmɐxi
umasinta	ʔʊmɐsɪnta
buga	bʊɰa
harang	hɐɾaŋ
magboo	mɐɡboo
palaspas	pɐlɐspas
balbas	bɐlbas
bugso	bʊɡsoʔ
sadya	sɐd͡ʒaʔ
tagapangasiwa	tɐɰɐpɐŋɐsiwɐʔ
lugot	lʊɰot
humalili	hʊmɐlilɪ
uwak	ʔʊak
hilaga	hɪlaɰɐʔ
alamang	ʔɐlɐmaŋ
carrillo	kxɐɾɾillo
liturhiya	lɪtuɾhɪa
sumagot	sʊmɐɰot
lang	lɐŋ
buyon	bʊjon
talag	talɐɡ
dimaapi	dɪmaɐpɪ
arabya	ʔɐɾabjɐ
siyampu	ʃɐmpʊ
gaan	ɡɐʔan
mahumaling	mɐhʊmɐliŋ
lutay	lʊtaɪ̯
tirona	tɪɾonɐ
gangsal	ɡɐŋsal
banto	bɐntoʔ
canina	kxɐninɐ
arkanghel	ʔɐɾkaŋhel
bayugo	bɐjuɰo
manghawa	mɐŋhawɐ
iparusa	ʔɪpɐɾusɐ
hayon	hɐjon
hiwatig	hɪwatɪɡ
lihi	lɪhi
pastora	pɐstoɾɐ
biyudo	bjʊdo
langil	laŋɪl
dalang	dalɐŋ
suka	suxɐʔ
dutdot	dʊtdot
rizal	ɾɪsal
angkop	ʔɐŋkop
abatan	ʔabatɐn
mahirap	mɐhiɾɐp
pumarada	pʊmɐɾadɐ
lingil	liŋɪl
humagulhol	hʊmɐɰʊlhol
zamboanga	sɐmbwɐŋɡɐ
almusal	ʔɐlmʊsal
imbestigasyon	ʔɪmbestɪɰɐʃon
kotse	kxot͡se
haba	habɐ
pangatnig	pɐŋɐtniɡ
lityo	lit͡ʃo
diktadora	dɪktɐdoɾɐ
bulgar	bʊlɡaɾ
maglaway	mɐɡlɐwaɪ̯
lumangoy	lʊmɐŋoɪ̯
irak	ʔɪɾak
hambog	hɐmboɡ
lingindayat	lɪŋɪndajɐt
tseke	t͡ʃexe
huwag	hʊaɡ
eba	ʔebɐ
ikapito	ʔɪxɐpɪto
lamukos	lɐmʊxos
bali	balɪ
mamamakyaw	mɐmɐmɐkjaʊ̯
lumiit	lʊmɪʔit
kampana	kxɐmpanɐʔ
israelita	ʔɪsɾɐʔelitɐ
kainan	kxɐʔɪnan
ani	ʔanɪ
mata	mɐta
corcuera	kxoɾkweɾɐ
lunukin	lʊnʊxin
benipayo	benɪpajo
pagtalunan	pɐɡtɐlʊnan
gumulo	ɡʊmʊlo
tiya	tiɐ
piskalya	pɪskɐlja
ayaw	ʔajaʊ̯
hantik	hɐntik
sampalok	sɐmpalok
lupog	lʊpoɡ
liknayan	lɪknajɐn
andar	ʔɐndaɾ
diktador	dɪktɐdoɾ
bangkas	bɐŋkas
hasa	hasɐʔ
lumabo	lʊmaboʔ
rebisa	ɾebɪsa
tanlap	tɐnlap
sustento	sʊstento
aksyon	ʔɐkʃon
bigo	bɪɰoʔ
ihagis	ʔɪhaɰɪs
armado	ʔɐɾmado
ahensiya	ʔɐhenʃa
lubo	lʊbo
labimpito	lɐbɪmpɪto
gaano	ɡɐʔɐno
korona	kxoɾonɐ
dominikano	domɪnɪxano
mahangin	mɐhaŋɪn
bista	bistɐ
alyas	ʔaljɐs
lagislis	lɐɰɪslis
bulandal	bʊlɐndal
hanapin	hɐnapɪn
awtorisado	ʔotoɾɪsado
lunday	lʊndaɪ̯
atras	ʔɐtɾas
hagonoy	hɐɰonoɪ̯
lundag	lʊndaɡ
akwarela	ʔɐkwɐɾelɐ
akasya	ʔɐxaʃɐ
balani	bɐlanɪʔ
institusyon	ʔɪnstɪtʊʃon
alulod	ʔɐlʊlod
logarta	loɰaɾtɐ
hasmin	hɐsmin
kinina	kxɪninɐ
ewan	ʔewɐn
balaghan	bɐlɐɡhan
gastadora	ɡɐstɐdoɾɐ
abog	ʔɐboɡ
iksi	ʔɪksiʔ
coquia	kxoxɪɐ
limanlaksa	lɪmɐnlɐksaʔ
itey	ʔɪteɪ̯
cauilan	kxɐwilɐn
diskuwalipikado	dɪskʊɐlɪpɪxado
bisig	bisɪɡ
estrella	ʔestɾellɐ
diplomatiko	dɪplomɐtɪxo
deportasyon	depoɾtɐʃon
amama	ʔɐmamɐ
kastiguhin	kxɐstɪɰuhɪn
apurado	ʔɐpʊɾado
langis	lɐŋis
amugis	ʔɐmuɰɪs
abobot	ʔɐbobot
ladya	lɐd͡ʒaʔ
hudikatura	hʊdɪxɐtuɾɐ
komunidad	kxomʊnɪdad
administratibo	ʔɐdmɪnɪstɾɐtibo
sugok	sʊɰok
aninaw	ʔɐnɪnaʊ̯
buquid	buxɪd
atribida	ʔɐtɾɪbidɐ
asunto	ʔɐsunto
daktao	dɐktaʔo
aberya	ʔɐbeɾja
haya	hajɐʔ
mangutang	mɐŋutɐŋ
suntukin	sʊntʊxin
kutis	kxutɪs
bulyaw	bʊljaʊ̯
baliskad	bɐlɪskad
daks	dɐks
chan	t͡ʃɐn
manlalaro	mɐnlɐlaɾoʔ
peñaflor	peɲɐfloɾ
alimuran	ʔɐlɪmʊɾan
labintatlo	lɐbintɐtlo
bubuyog	bʊbujoɡ
prayoridad	pɾɐjoɾidɐd
manlalakbay	mɐnlɐlɐkbaɪ̯
desbentaha	desbentahɐ
isnabero	ʔɪsnɐbeɾo
halimunmon	hɐlɪmʊmmon
luya	lujɐ
bati	bɐti
yolanda	jolandɐ
alaala	ʔɐlɐʔɐla
bottomesa	botomesɐ
mapangutya	mɐpaŋʊt͡ʃaʔ
galabok	ɡɐlɐbok
antukin	ʔɐntʊxin
batayan	bɐtajɐn
mambugaw	mɐmbuɰaʊ̯
ganoon	ɡɐnoʔon
bukad	bʊxad
labong	lɐboŋ
moises	moɪ̯ses
establisimiyento	ʔestɐblɪsɪmjento
manunugal	mɐnʊnuɰɐl
destiyero	dest͡ʃeɾo
lahat	lɐhat
maniobra	mɐniobɾɐ
urong	ʔʊɾoŋ
gapang	ɡapɐŋ
puyat	pujɐt
hipig	hɪpiɡ
amyendahan	ʔɐmjendɐhan
kinakapatid	kxɪnaxɐpɐtid
awtorisasyon	ʔaʊ̯toɾɪsɐʃon
bacas	bɐxas
binaysok	bɪnaɪ̯sok
awayan	ʔɐwɐjan
tirahan	tɪɾahɐn
depresyon	depɾeʃon
kilabot	kxɪlabot
bangis	bɐŋis
acuzar	ʔɐxusɐɾ
imoral	ʔɪmoɾal
punso	pʊnsoʔ
balindas	bɐlɪndas
aparador	ʔɐpɐɾɐdoɾ
lapisa	lɐpɪsaʔ
bagets	bɐɰet͡s
figueras	pɪɰeɾɐs
tantiya	tɐnt͡ʃa
abutab	ʔɐbʊtab
zapanta	sɐpantɐ
itay	ʔɪtaɪ̯
pinsan	pinsɐn
gambi	ɡɐmbi
pugad	puɰɐd
gata	ɡɐtaʔ
nakakatakot	nɐxɐkɐtaxot
pagbati	pɐɡbatɪʔ
payatot	pɐjatot
bimbin	bɪmbin
magdaspan	mɐɡdaspɐn
gramatika	ɡɾɐmatɪxa
lagasaw	lɐɰɐsaʊ̯
malutong	mɐlʊtoŋ
bukana	bʊxanɐ
pugutan	pʊɰutɐn
abubot	ʔɐbubot
ligawgaw	lɪɰaʊ̯ɰaʊ̯
luglog	lʊɡloɡ
amorsiko	ʔɐmoɾsixo
pangulo	pɐŋulo
dagan	dɐɰan
banga	bɐŋaʔ
imbitado	ʔɪmbɪtado
calan	kxɐlan
bana	banɐ
villamin	bɪllamɪn
tauhan	tɐʔuhɐn
mallare	mɐllaɾe
bagito	bɐɰito
yasay	jasaɪ̯
magbabakal	mɐɡbɐbɐxal
sipon	sɪpon
dahilig	dɐhilɪɡ
gawak	ɡɐwak
ayson	ʔaɪ̯son
isuot	ʔɪsʊʔot
nakakabwisit	nɐxɐkɐbwisɪt
asanorya	ʔɐsɐnoɾjɐ
lumagui	lʊmaɰɪ
limahid	lɪmɐhid
gilas	ɡilɐs
bolera	boleɾɐ
inmigrasyon	ʔɪmɪɡɾɐʃon
liban	libɐn
bakaw	bɐxaʊ̯
hinguto	hɪŋuto
agahas	ʔɐɰɐhas
maako	mɐʔɐxo
panirahanan	pɐnɪɾɐhanɐn
dinsol	dɪnsol
lahad	lahɐd
anila	ʔɐnilɐ
kulasi	kxʊlase
alingasaw	ʔɐlɪŋasaʊ̯
disiplina	dɪsɪplinɐ
pantablay	pɐntɐblaɪ̯
pala	palɐʔ
danumtigilan	dɐnʊmtiɰɪlan
laya	lajɐʔ
kurikong	kxʊɾɪxoŋ
pinlandya	pɪnland͡ʒɐ
dumagit	dʊmaɰɪt
sapak	sɐpak
antanda	ʔɐntɐndaʔ
lumi	lʊmiʔ
dekametro	dexametɾo
mapagsamantala	mɐpɐɡsɐmɐntɐla
sya	ʃa
dinamarka	dɪnɐmaɾkɐ
galing	ɡalɪŋ
bulagta	bʊlɐɡtaʔ
bangga	bɐŋɡaʔ
adyenda	ʔɐd͡ʒendɐ
dinastiya	dɪnɐstiɐ
vigilante	bɪd͡ʒɪlante
hinuha	hɪnuhɐʔ
antas	ʔɐntas
militar	mɪlɪtaɾ
bulig	bʊliɡ
pantoja	pɐntohɐ
anis	ʔɐnis
alimpungat	ʔɐlɪmpʊŋat
bartolina	bɐɾtolinɐ
laya	lajɐ
lagay	lɐɰaɪ̯
bernakulo	beɾnaxʊlo
hatinig	hɐtinɪɡ
altapresyon	ʔɐltɐpɾeʃon
domantay	domantaɪ̯
agata	ʔaɰɐta
balandra	bɐlandɾɐ
batuktok	batʊktok
itlog	ʔɪtloɡ
biik	bɪʔik
lubig	lʊbiɡ
imposibilidad	ʔɪmposɪbɪlɪdad
usap	ʔusɐp
aniya	ʔɐɲa
asyano	ʔɐʃɐno
labhan	lɐbhan
buhangin	bʊhaŋɪn
maghitso	mɐɡhɪt͡ʃo
ensemada	ʔensemadɐ
indiyo	ʔɪnd͡ʒo
lamad	lamɐd
panukala	pɐnʊxalɐʔ
lalik	lalɪk
asukal	ʔɐsuxɐl
pahina	pahɪnɐ
kandila	kxɐndilɐʔ
gunting	ɡʊntiŋ
tupada	tʊpadɐ
analisador	ʔɐnɐlɪsɐdoɾ
danumhaynayan	dɐnʊmhaɪ̯najɐn
lanap	lanɐp
hugpong	hʊɡpoŋ
anayin	ʔɐnajɪn
dramatiko	dɾɐmatɪxo
dekwatin	dekwɐtin
pudpod	pʊdpod
bus	bʊs
cruzat	kxɾʊsɐt
desmaya	desmɐja
emosyonal	ʔemoʃonal
nacpil	nakpɪl
kaldero	kxɐldeɾo
yari	jaɾɪ
anggulo	ʔaŋɡʊlo
nicdao	nikdɐo
baraka	bɐɾaxɐ
ipit	ʔipɪt
kilusan	kxɪlʊsan
bantayan	bɐntajɐn
amo	ʔɐmoʔ
dagas	dɐɰas
ingit	ʔɪŋit
lumbang	lumbɐŋ
intuwisyon	ʔɪntʊɪʃon
literasiya	lɪteɾɐsiɐ
lagnatin	lɐɡnɐtin
bumasa	bʊmɐsaʔ
dibdib	dɪbdib
langasngas	lɐŋɐsŋas
bigla	bɪɡlaʔ
biyola	bjolɐ
abrazado	ʔɐbɾɐsado
hatak	hatɐk
himnasta	hɪmnastɐ
banawa	bɐnawɐ
saboy	saboɪ̯
lutang	lʊtaŋ
maghinala	mɐɡhɪnalɐʔ
naman	nɐman
litograpiya	lɪtoɡɾɐpiɐ
danum	dɐnum
atangya	ʔɐtɐŋja
tambalan	tɐmbalɐn
garil	ɡɐɾil
hantungan	hɐntuŋɐn
tiwali	tɪwɐliʔ
at	ʔɐt
inyo	ʔɪɲo
agwahe	ʔɐɡwahe
batsilyer	bɐt͡ʃɪljeɾ
ganti	ɡɐnti
laba	labɐʔ
limonsito	lɪmonsito
cañete	kxɐɲete
litrato	lɪtɾato
manggulo	mɐŋɡʊlo
palitada	pɐlɪtadɐ
ikalabingwalo	ʔɪxɐlɐbiŋwɐlo
bungal	bʊŋal
alvarez	ʔalbɐɾes
ruta	ɾutɐ
kontak	kxontɐk
isputing	ʔɪsputɪŋ
estrada	ʔestɾadɐ
abrasete	ʔɐbɾɐsete
dinsulan	dɪnsulɐn
dilawdinsol	dɪlaʊ̯dɪnsol
diwa	diwɐ
hirap	hɪɾap
ikagalit	ʔɪxɐɰalɪt
gipos	ɡɪpos
habonete	hɐbonete
harapan	hɐɾɐpan
industriyalisasyon	ʔɪndustɾɪɐlɪsɐʃon
ahas	ʔahɐs
tren	tɾɛn
casanova	kxɐsɐnobɐ
peras	peɾɐs
itapon	ʔɪtapon
bigat	bɪɰat
heograpiya	heoɡɾɐpiɐ
lapnit	lɐpnit
danumkapnayan	dɐnʊmkɐpnajɐn
lamas	lamɐs
ihalintulad	ʔɪhɐlɪntulɐd
dukwangin	dʊkwɐŋin
gantihan	ɡantihɐn
duhansipat	dʊhɐnsipɐt
karpintero	kxɐɾpɪnteɾo
muñoz	mʊɲos
maghawak	mɐɡhawɐk
diyan	d͡ʒan
aya	ʔajɐʔ
apat	ʔapɐt
asbok	ʔɐsbok
dagitban	dɐɰɪtban
negosyante	neɰoʃɐnte
abdikasyon	ʔɐbdɪxɐʃon
dagilusaw	dɐɰɪlʊsaʊ̯
manakit	mɐnɐxit
baklad	bɐklad
adan	ʔɐdan
liya	liɐʔ
cancio	kxansɪo
gantimpala	ɡɐntɪmpalɐʔ
luklukan	lʊkluxɐn
hubo	hʊboʔ
elegante	ʔeleɰante
inakay	ʔɪnɐxaɪ̯
bugaw	buɰaʊ̯
lagsang	lɐɡsaŋ
kalatas	kxɐlɐtas
tancinco	tɐnsiŋko
bagansiya	bɐɰanʃa
opisyales	ʔopɪʃɐles
tikbalang	tɪkbalɐŋ
lasinggero	lɐsɪŋɡeɾo
bumaba	bʊmabɐʔ
mapera	mɐpeɾɐ
ignorante	ʔɪɡnoɾante
embahador	ʔembɐhɐdoɾ
aba	ʔɐbaʔ
dagabdab	dɐɰɐbdab
linay	linaɪ̯
gatchalian	ɡɐtt͡ʃaljɐn
amarilyo	ʔɐmɐɾiljo
eksaherasyon	ʔeksɐheɾɐʃon
tsaa	t͡ʃɐʔa
islam	ʔɪslam
labahin	labahɪn
estronsiyo	ʔestɾonʃo
kaluntian	kxɐlʊntɪʔan
gilgil	ɡɪlɡil
naoko	naoxo
abrasador	ʔɐbɾɐsɐdoɾ
kalso	kxɐlso
abisuhan	ʔɐbɪsuhɐn
basagin	bɐsaɰɪn
nagbabaon	nɐɡbɐbaʔon
akbay	ʔɐkbaɪ̯
cabrera	kxɐbɾeɾɐ
labon	lɐbon
bading	bɐdiŋ
angpao	ʔaŋpaʊ̯
labingwalo	lɐbiŋwɐlo
alperes	ʔɐlpeɾes
selda	seldɐ
bulaga	bʊlɐɰaʔ
azucena	ʔɐsʊsenɐ
burahin	bʊɾɐhin
ipakausap	ʔɪpɐxɐʔusɐp
luksemburgo	lʊksembuɾɡo
antig	ʔɐntiɡ
buwagin	bʊɐɰin
komunikasyon	kxomʊnɪxɐʃon
lehislatura	lehɪslɐtuɾɐ
maramot	mɐɾamot
siga	siɰɐʔ
platito	plɐtito
dalangin	dɐlaŋɪn
dokumentado	doxʊmentado
kailangan	kxaɪ̯laŋɐn
lipa	lipɐʔ
michiko	mɪt͡ʃixo
nakibahagi	mɐxɪbɐhaɰɪʔ
ikasiyam	ʔɪxɐʃam
kakarampot	kxɐxɐɾɐmpot
panggupit	pɐŋɡʊpit
alingasngas	ʔɐlɪŋɐsŋas
balkon	bɐlkon
amak	ʔɐmak
hablot	hɐblot
abay	ʔɐbaɪ̯
awtonomiya	ʔaʊ̯tonomiɐ
raha	ɾahɐ
bombay	bumbaɪ̯
heringgilya	heɾɪŋɡiljɐ
pagsasaka	pɐɡsɐsaxɐ
bumahin	bʊmɐhin
kubo	kxubo
bagabag	bɐɰabɐɡ
prangka	pɾaŋkɐ
hagunoy	hɐɰunoɪ̯
meryenda	meɾjendɐ
logo	loɰo
dagisdis	dɐɰɪsdis
labingwalo	lɐbɪŋwɐlo
dikya	dɪkjaʔ
dimapilis	dɪmɐpilɪs
apura	ʔɐpʊɾa
daldalero	dɐldɐleɾo
pihikan	pɪhixɐn
beatipikasyon	beɐtɪpɪxɐʃon
dambuhala	dɐmbʊhalɐʔ
apatnaraan	ʔɐpɐtnɐɾɐʔan
kiko	kxixoʔ
ilot	ʔɪlot
itago	ʔɪtaɰoʔ
komento	kxomento
kalambre	kxɐlambɾe
balde	bɐlde
pamilyaridad	pɐmɪljɐɾɪdad
isagani	ʔɪsɐɰanɪ
estampita	ʔestɐmpitɐ
pananagutan	pɐnɐnɐɰutɐn
maselan	mɐselɐn
dalamhati	dɐlɐmhatɪʔ
kapitan	kxɐpɪtan
ricafort	ɾɪxafoɾt
kandidatura	kxɐndɪdɐtuɾɐ
magbrotsa	mɐɡbɾot͡ʃɐ
abala	ʔɐbalɐ
dinosawro	dɪnosaʊ̯ɾo
palikuran	palɪxuɾɐn
iyakin	ʔiaxɪn
magpraktis	mɐɡpɾaktɪs
habi	hɐbi
agnos	ʔɐɡnos
mangisay	mɐŋisaɪ̯
kodipikasyon	kxodɪpɪxɐʃon
ingkong	ʔɪŋkoŋ
alkansiya	ʔɐlkɐnsiɐ
ipokrita	ʔɪpokɾɪta
hukbalahap	hʊkbɐlahɐp
haliparot	hɐlɪpaɾot
babae	bɐbaʔe
amba	ʔɐmbaʔ
maabo	mɐʔɐbo
yñiguez	jɲɪɰes
tungkab	tʊŋkab
hiraya	hɪɾajɐʔ
pamilyar	pɐmɪljaɾ
lespu	lespʊ
kumulang	kxʊmulɐŋ
apolo	ʔɐpolo
lukbot	lʊkbot
insulares	ʔɪnsʊlaɾes
ginawin	ɡɪnɐwin
magkataon	mɐɡkɐtɐʔon
buli	bʊli
kanlungan	kxɐnluŋɐn
humalakhak	hʊmɐlɐkhak
bistado	bɪstado
herradura	ʔeɾɐduɾɐ
bulati	bʊlatɪ
ideolohiya	ʔɪdeolohiɐ
bukbok	bʊkbok
iregularidad	ʔɪɾeɰʊlɐɾɪdad
bayong	baɪ̯ʔoŋ
miyembro	mjembɾo
abalahin	ʔɐbɐlahɪn
lanaw	lanaʊ̯
lagos	lɐɰos
lagmay	laɡmaɪ̯
dalas	dɐlas
patahian	pɐtɐhiʔɐn
tampisaw	tɐmpɪsaʊ̯
mamasura	mɐmɐsuɾɐ
mandadangkal	mɐndɐdɐŋkal
bayar	bajɐɾ
parreño	pɐɾeɲo
magtimpla	mɐɡtɪmpla
halukay	hɐluxaɪ̯
gapo	ɡɐpo
hilata	hɪlɐtaʔ
alonte	ʔɐlonte
bongga	boŋɡɐ
kanselasyon	kxɐnselɐʃon
insureksiyon	ʔɪnsʊɾekʃon
mamahagi	mɐmɐhaɰɪʔ
bumahing	bʊmɐhiŋ
magbasa	mɐɡbɐsa
gaano	ɡɐʔano
linis	lɪnis
asul	ʔɐsul
balangkas	bɐlɐŋkas
asap	ʔɐsap
maglolo	mɐɡlolo
pagtae	pɐɡtaʔe
ibutod	ʔɪbʊtod
unan	ʔunɐn
hitso	hɪt͡ʃo
ilalim	ʔɪlalɪm
balewalain	bɐlewɐlɐʔin
bakawan	bɐxawɐn
damuhan	dɐmʊhan
ibalik	ʔɪbɐlik
episyente	ʔepɪʃente
tsunami	t͡ʃʊnamɪ
tiyuhin	t͡ʃuhɪn
bisaya	bɪsajɐʔ
peñaflorida	peɲɐfloɾidɐ
bulwak	bʊlwak
nagbaon	nɐɡbɐʔon
bitak	bɪtak
furagganan	fʊɾɐɡɡanɐn
landi	lɐndiʔ
gupit	ɡʊpit
mendoza	mendosɐ
bampira	bɐmpiɾɐ
diyaryo	d͡ʒaɾjo
balanga	bɐlɐŋaʔ
bulakan	bʊlɐxan
durante	dʊɾante
kapatawaran	kxɐpɐtɐwɐɾan
dagusdos	dɐɰʊsdos
ekspresyon	ʔekspɾeʃon
kaagaw	kxaɐɰaʊ̯
disiseis	dɪsɪsɐʔis
bulakenyo	bʊlɐxeɲo
isla	ʔislɐ
yang	jɐŋ
antibiyotiko	ʔɐntɪbjotɪxo
gisahin	ɡɪsɐhin
hulagpos	hʊlɐɡpos
sinco	siŋko
natsuko	nɐt͡ʃuxo
hayto	haɪ̯to
karunungan	kxɐɾʊnuŋɐn
lista	listɐ
rimas	ɾimɐs
lambing	lɐmbiŋ
reodica	ɾeodixɐ
impatso	ʔɪmpat͡ʃo
inda	ʔɪnda
almon	ʔɐlmon
villasis	bɪllasɪs
lagaslas	lɐɰɐslas
lansang	lɐnsaŋ
papagayo	pɐpɐɰajo
libid	libɪd
cabiling	kxɐbilɪŋ
baniaga	bɐɲɐɰɐ
gulo	ɡʊloʔ
tabas	tabɐs
luksa	lʊksaʔ
maybahay	maɪ̯bahaɪ̯
hayan	hɐjan
laoag	lɐwaɡ
bagsik	bɐɡsik
keyk	kxeɪ̯k
balikbayan	bɐlɪkbajɐn
lipana	lɪpanɐʔ
konsulado	kxonsʊlado
lala	lalɐʔ
ipantakip	ʔɪpɐntɐxip
saksak	sɐksak
torralba	toɾɾalbɐ
atubili	ʔɐtʊbilɪʔ
anim	ʔanɪm
itaboy	ʔɪtɐboɪ̯
atas	ʔɐtas
bula	bulɐ
hilab	hilɐb
tokayo	toxajo
lasuna	lɐsʊnaʔ
maghimagsik	mɐɡhɪmɐɡsik
magustuhan	mɐɰʊstʊhan
faltado	fɐltado
halintulad	hɐlɪntulɐd
aaaban	ʔaʔɐʔɐban
biyas	bjas
baliling	bɐlilɪŋ
pambilo	pɐmbɪlo
binutil	bɪnutɪl
ginatan	ɡɪnɐtan
supling	sʊpliŋ
kitikiti	kxɪtɪxɪti
dinig	dɪniɡ
iskandalo	ʔɪskandɐlo
butudkilos	bʊtudkilos
cuizon	kxuɪson
bulilit	bʊlɪlit
labis	labɪs
gahi	ɡahɪʔ
oligarka	ʔolɪɰaɾkɐ
kumanta	kxʊmɐnta
eskalador	ʔeskɐlɐdoɾ
ipil	ʔipɪl
heroglipiko	heɾoɡlipɪxo
madamot	mɐdamot
gisa	ɡɪsa
biyolohiya	bɪolohiɐ
kumuha	kxʊmuhɐ
guno	ɡʊno
bumilis	bʊmɪlis
magbenta	mɐɡbentɐ
angas	ʔaŋɐs
fojas	pohɐs
babaan	babaʔɐn
butaw	butaʊ̯
dalubsugaan	dɐlubsuɰaan
pundido	pʊndido
balakilan	bɐlɐxilɐn
abaka	ʔɐbɐxa
buurin	bʊʔʊɾin
garote	ɡɐɾote
dambana	dɐmbanɐʔ
ginataan	ɡɪnɐtɐʔan
industriyalista	ʔɪndʊstɾɪɐlistɐ
wawa	wawɐʔ
gabon	ɡɐbon
baril	bɐɾil
cabanayan	kxɐbɐnajɐn
dentisteriya	dentɪsteɾiɐ
negra	neɡɾɐ
gana	ɡɐna
katuray	kxɐtuɾaɪ̯
telebisyon	telebɪʃon
biyolento	bɪolento
kontrobersiya	kxontɾobeɾʃɐ
handalapak	hɐndɐlɐpak
cabuti	kxɐbʊti
boba	bobɐ
drowing	dɾowɪŋ
dipa	dɪpa
bako	bɐxoʔ
biyatiko	bjatɪxo
banggit	bɐŋɡit
magbinata	mɐɡbɪnɐtaʔ
balikutsa	bɐlɪxʊt͡ʃa
gipo	ɡɪpoʔ
abentura	ʔɐbentuɾɐ
langkal	lɐŋkal
handa	hɐndaʔ
caballero	kxɐbɐljeɾo
tungkol	tʊŋkol
hubad	hʊbad
filipina	fɪlɪpinɐ
arevalo	ʔɐɾebɐlo
bayaw	bɐjaʊ̯
veloria	beloɾjɐ
hurisdiksiyon	hʊɾɪsdɪkʃon
babaw	babaʊ̯
ba't	bɐt
hanap	hanɐp
laglag	lɐɡlaɡ
ditse	dɪt͡ʃe
arhentina	ʔɐɾhentinɐ
esena	ʔesenɐ
alimpuyo	ʔɐlɪmpʊjo
calayan	kxɐlajɐn
agresibo	ʔɐɡɾesibo
laos	lɐʔos
dalampasigan	dɐlɐmpɐsiɰɐn
punongkahoy	pʊnoŋkahoɪ̯
haraya	hɐɾajɐʔ
igera	ʔɪɰeɾɐ
garcia	ɡɐɾsiɐ
daluro	dɐluɾoʔ
kabag	kxabɐɡ
mabangis	mɐbɐŋis
islang	ʔɪslaŋ
hapit	hapɪt
banting	bɐntiŋ
siyokoy	ʃoxoɪ̯
diklap	dɪklap
diin	dɪin
dalangat	dɐlɐŋat
kaligayahan	kxɐlɪɰɐjahɐn
bilasa	bɪlɐsaʔ
kalungsuran	kxɐlʊŋsʊɾan
haban	hɐban
kompanya	kxumpɐɲa
azaña	ʔɐsaɲɐ
balintong	bɐlɪntoŋ
dagim	dɐɰim
magparaya	mɐɡpɐɾajɐʔ
humandusay	hʊmɐndusaɪ̯
zaide	saɪ̯de
brilyante	bɾɪljante
saguinsin	sɐɰinsɪn
ikalabindalawa	ʔɪxɐlɐbindɐlɐwa
basehan	bɐsehan
manlait	mɐnlaʔɪt
gibang	ɡibɐŋ
mapusyaw	mɐpʊʃɐu
lingaw	liŋaʊ̯
inang	ʔɪnaŋ
ligo	liɰoʔ
alala	ʔɐlalɐ
bitayan	bɪtɐjan
imprastraktura	ʔɪmpɾɐstɾɐktuɾɐ
laksatiba	lɐksɐtibɐ
lumuklok	lʊmʊklok
mura	muɾɐ
lupasay	lʊpɐsaɪ̯
armas	ʔɐɾmas
legalidad	leɰɐlɪdad
dimalaluan	dɪmɐlalʊɐn
labasan	lɐbɐsan
liyempo	ljempo
umagahas	ʔʊmɐɰɐhas
tsiko	t͡ʃixo
dala	dɐlaʔ
dy	dɪ
bagyo	bɐɡjo
inugsukat	ʔɪnʊɡsuxɐt
lasak	lasɐk
lisa	lɪsaʔ
bimol	bɪmol
ligo	lɪɰo
bulacan	bʊlɐxan
hapunan	hɐpunɐn
wang	wɐŋ
halaan	hɐlɐʔan
aabisuhan	ʔɐɐbɪsuhɐn
estatwa	ʔestatwɐ
pawatas	pɐwɐtas
panghalip	pɐŋhɐlip
tindero	tɪndeɾo
desgrasya	desɡɾaʃɐ
imoralidad	ʔɪmoɾɐlɪdad
aktibo	ʔɐktibo
oliveros	ʔolɪbeɾos
lagwerta	lɐɡweɾtɐ
bunot	bʊnot
dahas	dɐhas
bangketa	bɐŋketɐ
fabregas	fabɾeɰɐs
iskor	ʔɪskoɾ
limpal	lɪmpal
babay	babaɪ̯
ensiklopedya	ʔensɪkloped͡ʒɐ
aksidente	ʔɐksɪdente
babayaran	bɐbɐjaɾɐn
dinagat	dɪnaɰɐt
castañeda	kxɐstɐɲedɐ
alibugha	ʔɐlɪbʊɡhaʔ
bigyan	bɪɡjan
nakawin	nɐxawɪn
bulgarya	bʊlɡaɾjɐ
balngawsukat	bɐlŋaʊ̯suxɐt
magbiro	mɐɡbɪɾoʔ
bumalikwas	bʊmɐlɪkwas
luntidinsol	lʊntɪdɪnsol
tungkod	tʊŋkod
hilera	hɪleɾɐ
kontestant	kxontestɐnt
bilhin	bɪlhin
bibilis	bɪbɪlis
dominante	domɪnante
dusing	dusɪŋ
kolateral	kxolɐteɾal
pulgada	pʊlɡadɐ
ipatapon	ʔɪpɐtapon
bulate	bʊlate
hunghang	hʊŋhaŋ
inggitera	ʔɪŋɡɪteɾɐ
bayarin	bajɐɾɪn
gapong	ɡɐpoŋ
dadaanin	dɐdɐʔanɪn
baniaga	bɐɲɐɰɐʔ
impormante	ʔɪmpoɾmante
abatan	ʔɐbɐtan
alkitran	ʔɐlkɪtɾan
inundasyon	ʔɪnʊndɐʃon
luga	luɰɐʔ
abala	ʔɐbɐla
macalalad	mɐxɐlalɐd
akyatan	ʔɐkjɐtan
gerodias	d͡ʒeɾod͡ʒɐs
benta	bentɐ
bangkito	bɐŋkitoʔ
bagamat	bɐɰɐmat
butse	bʊt͡ʃi
kastila	kxɐstilɐʔ
mangmang	mɐŋmaŋ
bikolana	bɪxolanɐ
inano	ʔɪnɐno
buklod	bʊklod
baket	baxet
bunso	bʊnsoʔ
lubigan	lʊbɪɰan
bakuran	bɐxuɾɐn
apendisitis	ʔɐpendɪsitɪs
limi	limɪ
balaraw	bɐlɐɾaʊ̯
lukutan	lʊxutɐn
pinapagtaluhan	pɪnapɐɡtɐluhɐn
apolonio	ʔɐpolonɪo
aspirina	ʔɐspɪɾinɐ
alilis	ʔɐlilɪs
liwat	liwɐt
liko	lɪxoʔ
gas	ɡɐs
sabila	sabɪla
cadano	kxɐdano
mamamakyaw	mɐmamɐkjaʊ̯
paborito	pɐboɾable
inampalan	ʔɪnampɐlan
rusoblanka	ɾʊsoblaŋkɐ
brutal	bɾʊtal
basisig	bɐsisɪɡ
bayolente	bɐjolente
lagi	laɰɪʔ
bayoneta	bɐjonetɐ
labinsiyam	lɐbɪnʃam
ina	ʔɪna
bugok	bʊɰok
semaña	semaɲɐ
estonya	ʔestoɲɐ
antena	ʔɐntenɐ
magandahan	mɐɰɐndɐhan
amil	ʔɐmil
lihim	lɪhim
barakilan	bɐɾɐxilɐn
ingrato	ʔɪŋɡɾato
halas	halɐs
bayad	bɐjad
bula	bulɐʔ
guwardiya	ɡwaɾd͡ʒa
gayang	ɡajɐŋ
agsikapan	ʔɐɡsɪxapɐn
inagurasyon	ʔɪnɐɰʊɾɐʃon
kabaktan	kxɐbɐktan
batchoy	bɐt͡ʃoɪ̯
ipokrisiya	ʔɪpokɾɪsiɐ
hinagkan	hɪnɐɡkan
iniina	ʔɪniʔɪna
liwas	liwɐs
heranyo	heɾaɲo
papaya	pɐpajɐ
espesyal	ʔespeʃal
ayumi	ʔɐjumɪ
iyag	ʔɪaɡ
maghinto	mɐɡhɪntoʔ
balang	balɐŋ
susmaryosep	sʊsmɐɾjosep
quezon	kxeson
dalubbanwa	dɐlubbɐnwa
giliw	ɡilɪʊ̯
monopolisasyon	monopolɪsɐʃon
lubha	lʊbhaʔ
labso	lɐbsoʔ
kondenahin	kxondenɐhin
cubacub	kxʊbaxʊb
seminaryo	semɪnaɾjo
lupagi	lʊpaɰɪʔ
ektarya	ʔektaɾjɐ
closa	kxlosɐ
albakora	ʔɐlbɐxoɾɐ
hilam	hɪlam
lipstik	lipstɪk
kanisid	kxɐnisɪd
daldalera	dɐldɐleɾɐ
hawla	haʊ̯lɐ
anunsiyo	ʔɐnunʃo
butal	bʊtal
gabriel	ɡɐbɾjel
burges	bʊɾɡis
bawaw	bawaʊ̯
masangcay	mɐsaŋkaɪ̯
hingalin	hɪŋalɪn
tawanan	tɐwanɐn
lugas	lʊɰas
ibenta	ʔɪbentɐ
corazon	kxoɾɐson
manggas	mɐŋɡas
armas	ʔaɾmɐs
higtao	hɪɡtaʔo
babuyin	bɐbujɪn
lihi	lɪhiʔ
bamus	bamʊs
gumulang	ɡʊmulɐŋ
basig	basɪɡ
arkitektura	ʔɐɾkɪtektuɾɐ
adyo	ʔɐd͡ʒoʔ
adiksyon	ʔɐdɪkʃon
post	poʊst
sanidad	sɐnɪdad
haliparot	hɐlɪpɐɾot
bagaoisan	bɐɰɐwisɐn
hagod	hɐɰod
bingguhan	bɪŋɡuhɐn
aling	ʔɐliŋ
liban	lɪban
sulyasid	sʊljasɪd
lipat	lipɐt
kasabihan	kxɐsɐbɪhan
buslo	bʊsloʔ
dambong	dɐmboŋ
lumindol	lʊmɪndol
talukbong	tɐlʊkboŋ
bituin	bɪtʊʔin
jurado	hʊɾado
gising	ɡisɪŋ
konsumisyon	kxonsʊmɪʃon
minviluz	mɪnbilʊs
dyahe	d͡ʒahe
kenzo	kxenso
balaksila	bɐlɐksilɐʔ
hinahon	hɪnahon
babad	bɐbad
pugok	pʊɰok
remulla	ɾemullɐ
limi	limɪʔ
layag	lɐjaɡ
isara	ʔɪsɐɾa
ineng	ʔɪneŋ
buto	bʊto
aaa	ʔɐʔɐʔaʔ
hiwalay	hɪwɐlaɪ̯
idealista	ʔɪdejɐlistɐ
demonio	demoɲo
sabihin	sɐbihɪn
politika	politɪxa
lagnatin	laɡnatɪn
baiya	bɐʔiɐ
retratista	ɾetɾɐtistɐ
ito	ʔɪto
tagas	taɰɐs
bana	bɐnaʔ
bakunado	bɐxʊnado
lugmok	lʊɡmok
arrogante	ʔɐɾoɰante
kampante	kxɐmpante
danaw	danaʊ̯
intelihente	ʔɪntelɪhente
nikotina	nɪxotinɐ
damdamin	dɐmdamɪn
dagadagaan	dɐɰɐdɐɰaʔɐn
libingan	libiŋɐn
uriarte	ʔʊɾjaɾte
hambo	hɐmbo
pigsa	pɪɡsa
kerida	kxeɾidɐ
gilagid	ɡɪlaɰɪd
damit	dɐmit
diyametro	dɪɐmetɾo
paliwanag	pɐlɪwanɐɡ
laylayan	laɪ̯lajɐn
fontillas	pontiljɐs
hatinggabi	hatɪŋɡɐbi
lubid	lubɪd
basilika	bɐsilɪxa
bacani	bɐxanɪ
harina	hɐɾinɐ
dehins	deɪ̯ns
bahin	bɐhin
papagtalunan	papɐɡtɐlʊnan
galis	ɡɐlis
basurahan	bɐsʊɾahɐn
hukbo	hʊkbo
hibla	hɪbla
benus	benʊs
mapanghusga	mɐpaŋhʊsɡa
emperador	ʔempeɾɐdoɾ
agwamarina	ʔɐɡwɐmɐɾinɐ
anta	ʔɐnta
patatas	pɐtatɐs
haponesa	hɐponesɐ
dalubtao	dɐlubtaʔo
sentensiya	sentenʃɐ
burias	buɾjɐs
disinuwebe	dɪsɪnwebe
buhagtigilan	bʊhɐɡtɪɰilɐn
agustin	ʔɐɰʊstin
siko	sixo
bigasan	biɰasɐn
espesyalista	ʔespeʃɐlistɐ
babayaran	bɐbɐjɐɾan
burara	bʊɾɐɾaʔ
espanyol	ʔespɐɲol
abuloy	ʔɐbuloɪ̯
macapugay	mɐxɐpuɰaɪ̯
aburido	ʔɐbʊɾɪdo
hilik	hɪlik
hampas	hɐmpas
luntian	lʊntiʔɐn
agusan	ʔɐɰusɐn
biliran	bɪliɾɐn
mandarambong	mɐndɐɾɐmboŋ
abuhan	ʔabuhɐn
arawan	ʔɐɾɐwan
jusi	d͡ʒusɪ
destruksiyon	destɾʊkʃon
gatbonton	ɡɐtbonton
rambulan	ɾɐmbulɐn
aprobado	ʔɐpɾobado
binago	bɪnaɰo
lipad	lɪpad
dumali	dʊmɐliʔ
semantika	semantɪxɐ
anak	ʔɐnak
pulot	pʊlot
agusil	ʔɐɰʊsil
mukha	mʊxaʔ
habi	habɪʔ
abogada	ʔɐboɰadɐ
maatik	mɐʔɐtik
plaslayt	plaslaɪ̯t
basag	basɐɡ
aranda	ʔɐɾandɐ
paypay	paɪ̯paɪ̯
buslot	bʊslot
puke	puxeʔ
bilulo	bɪlulo
lasenggera	lɐseŋɡeɾɐ
kondominyum	kxondomiɲʊm
hagis	haɰɪs
cadapan	kxɐdapɐn
inaama	ʔɪnaʔɐma
loo	lʊ
pawikan	pɐwixɐn
gasino	ɡɐsino
bumalik	bʊmɐlik
gurlis	ɡʊɾlis
panhik	pɐŋhik
latag	latɐɡ
akusa	ʔɐxʊsa
filipino	fɪlɪpino
gamay	ɡamaɪ̯
banlaw	bɐnlaʊ̯
isama	ʔɪsamɐ
manghula	mɐŋhulɐʔ
laitin	lɐʔitɪn
laplap	lɐplap
pako	pɐxoʔ
bergonia	beɾɡoɲɐ
hangintigilan	hɐŋɪntiɰilɐn
dugso	dʊɡsoʔ
sapa	sapɐʔ
boling	bolɪŋ
arkeolohiya	ʔɐɾkeolohiɐ
istoryador	ʔɪstoɾjɐdoɾ
lumabag	lʊmɐbaɡ
magma	maɡmɐ
butac	butɐk
dagitsigan	dɐɰɪt͡ʃiɰɐn
dilaan	dɪlɐʔan
norwega	noɾweɰɐ
lambi	lɐmbiʔ
mambabatas	mɐmbɐbatɐs
bukaka	bʊxakɐʔ
tiangco	t͡ʃaŋko
bulon	bʊlon
lalamunan	lɐlɐmunɐn
ching	t͡ʃɪŋ
dumlao	dumlɐo
dumalaw	dʊmalaʊ̯
abnormalidad	ʔɐbnoɾmɐlɪdad
impluwensiya	ʔɪmplʊensiɐ
kiyoko	kjoxo
aa	ʔaʔɐʔ
bahagsubay	bɐhɐɡsubaɪ̯
gubat	ɡubɐt
ichiro	ʔɪt͡ʃiɾo
maglola	mɐɡlolɐ
makapuno	mɐxɐpʊnoʔ
gorilya	ɡoɾiljɐ
lasog	lɐsoɡ
inutil	ʔɪnutɪl
bumali	bʊmalɪʔ
paghuhukom	pɐɡhʊhʊxom
lago	lɐɰoʔ
akibat	ʔɐxibɐt
apa	ʔapɐ
mabuhok	mɐbʊhok
kung	kxʊŋ
lutay	lutaɪ̯
impo	ʔɪmpo
lugami	lʊɰɐmiʔ
agwas	ʔaɡwɐs
bilangan	bɪlaŋɐn
astropisika	ʔɐstɾopisɪxɐ
lagumlalangin	lɐɰʊmlɐlɐŋin
awstriya	ʔaʊ̯stɾɪɐ
guluhin	ɡʊlʊhin
latundan	lɐtʊndan
ipunin	ʔɪpunɪn
ilang	ʔɪlaŋ
kodigo	kxodɪɰo
apahap	ʔɐpahɐp
laas	laʔɐs
kahabagan	kxɐhɐbɐɰan
magsalang	mɐɡsalɐŋ
limi	lɪmiʔ
dura	dʊɾaʔ
lapirot	lɐpɪɾot
kalawangin	kxɐlɐwɐŋin
bitbit	bɪtbit
arcinas	ʔɐɾsinɐs
kolonya	kxoloɲɐ
