سىستېمىسى	sˌɪstemˈɪsɪ
سېتىۋېلىش	sˌetɪwˈelɪʃ
ئوتتۇرىسىدىكى	ˌottuɾˌɪsɪdˈɪkɪ
تارىخچى	tɑɾˈɪχt͡ʃɪ
كېسەللىك	kesˈællɪk
ئىككى	ˈɪkkɪ
كۆرەتتى	kœɾˈættɪ
ھايۋانلارنى	hˌɑjwɑnlˈɑrnɪ
نى	nˈɪ
مۈلۈك	mˈylyk
تىلىنى	tɪlˈɪnɪ
جايلاخكان	d͡ʒɑjlˈɑχkɑn
بىلگەن	bˈɪlɡæn
سىياسەت	sɪjˈɑsæt
پاتقاق	pˈɑtqɑq
ۋەزىپىگە	wˌæzɪpˈɪɡæ
سەھنە	sˈæhnæ
مەقسەت	mˈæqsæt
تۇغقانلىرى	tˌuʁqɑnlˈɪɾɪ
كاتتا	kˈɑttɑ
خاراكتېر	χɑɾˈɑkter
ھەقسىز	hˈæqsɪz
ئىنجىل	ˈɪnd͡ʒɪl
سۈرگۈن	sˈyrɡyn
قايتىدىن	qɑjtˈɪdɪn
ئىسمائىل	ɪsmˈɑɪl
كېتىشى	ketˈɪʃɪ
پەقەتلا	pæqˈætlɑ
شەرتى	ʃˈærtɪ
دەسلەپ	dˈæslæp
جۇمھۇرىيىتىنىڭ	d͡ʒˌumhuɾˌɪjɪtˈɪnɪŋ
مۇناسىۋەتلىك	mˌunɑsɪwˈætlɪk
بولدى	bˈoldɪ
ياغاچتىن	jɑʁˈɑt͡ʃtɪn
يېيىش	jˈejɪʃ
ئىپادىلەيدىغان	ˌɪpɑdˌɪlæjdˈɪʁɑn
مەھكىمىسى	mˌæhkɪmˈɪsɪ
داۋامىدا	dˌɑwɑmˈɪdɑ
ئۇنىۋېرسىتېتىدا	ˌunɪwˌersɪtetˈɪdɑ
ئېيتقاندا	ejtqˈɑndɑ
تاشكەنت	tˈɑʃkænt
خەلقلەرنىڭ	χælqlˈærnɪŋ
زىيالىلار	zˌɪjɑlˈɪlɑr
تىنچلىق	tˈɪnt͡ʃlɪq
مىنىڭ	mˈɪnɪŋ
قۇرۇشقا	quɾˈuʃqɑ
مايدانى	mɑjdˈɑnɪ
تەڭگە	tˈæŋɡæ
قىلىندۇ	qɪlˈɪndu
شى	ʃˈɪ
ئوخشىمايدۇ	ˌoχʃɪmˈɑjdu
ئېتىپ	ˈetɪp
بايرىقى	bɑjrˈɪqɪ
خانىم	χˈɑnɪm
يوقىتىش	joqˈɪtɪʃ
ئۇلار	ˈulɑr
قاتناشقان	qɑtnˈɑʃqɑn
ئۇنىۋېرستېتى	ˌunɪwerstˈetɪ
قارىغان	qɑɾˈɪʁɑn
ھېكىم	hˈekɪm
تەلىم	tˈælɪm
ئۇندىن	ˈundɪn
شىمالىدىكى	ʃˌɪmɑlɪdˈɪkɪ
نەقەدەر	næqˈædær
بەگ	bˈæɡ
يېزىلغان	jezˈɪlʁɑn
تونۇرغا	tonˈurʁɑ
ئاسمان	ˈɑsmɑn
سىياسىي	sɪjˈɑsɪj
ئارزۇسىنى	ˌɑrzusˈɪnɪ
ھەققى	hˈæqqɪ
كەلتۈرۈلگەن	kˌæltyɾˈylɡæn
ئۇيغۇرنىڭ	ujʁˈurnɪŋ
دائىم	dˈɑɪm
ھاياتىدا	hˌɑjɑtˈɪdɑ
ئېگىزلىكى	ˌeɡɪzlˈɪkɪ
ئوت	ˈot
ۋاقىتتىن	wɑqˈɪttɪn
ئىنكار	ˈɪnkɑr
يېڭىسار	jeŋˈɪsɑr
بەلگىلەيدۇ	bˌælɡɪlˈæjdu
دۇنيانى	dunjˈɑnɪ
روزى	rˈozɪ
بۇنىڭدىن	bunˈɪŋdɪn
كېتىش	kˈetɪʃ
بولغاندا	bolʁˈɑndɑ
ئاۋال	ˈɑwɑl
ساغلام	sˈɑʁlɑm
تەشكىلاتىنىڭ	tˌæʃkɪlɑtˈɪnɪŋ
خۇسۇسى	χusˈusɪ
كەشىپ	kˈæʃɪp
ۋاقتىنى	wɑqtˈɪnɪ
ئاتالغان	ɑtˈɑlʁɑn
مۇشۇنداق	muʃˈundɑq
تۇرىدۇ	tuɾˈɪdu
تەمىنلەيدىغان	tˌæmɪnlæjdˈɪʁɑn
قاراپ	qˈɑɾɑp
تە	tˈæ
يەردىكى	jærdˈɪkɪ
رازى	rˈɑzɪ
دۆلەت	dˈœlæt
ئۆمەر	ˈœmær
قارلىق	qˈɑrlɪq
ئۆزگىرىپ	œzɡˈɪɾɪp
بۇلارغا	bulˈɑrʁɑ
ئۆستەڭ	ˈœstæŋ
كوممۇنىستىك	kˌommunˈɪstɪk
ياراتتى	jɑɾˈɑttɪ
تۇرىمەن	tuɾˈɪmæn
سوغۇق	sˈoʁuq
كىتابلارنى	kˌɪtɑblˈɑrnɪ
خارابىسى	χˌɑɾɑbˈɪsɪ
كىم	kˈɪm
بولدۇق	bˈolduq
تۆرت	tˈœrt
ئەسىر	ˈæsɪr
ئاساسىي	ɑsˈɑsɪj
ئىمكانىيىتىگە	ˌɪmkɑnˌɪjɪtˈɪɡæ
چەتئەللىك	t͡ʃætˈællɪk
خارىكى	χɑɾˈɪkɪ
خاسىيەتلىك	χˌɑsɪjˈætlɪk
نوبېل	nˈobel
يەتكەن	jˈætkæn
خەلقىمىزنىڭ	χˌælqɪmˈɪznɪŋ
ئورگان	ˈorɡɑn
بارغاندىن	bɑrʁˈɑndɪn
ياغلىق	jˈɑʁlɪq
مەنىدىكى	mˌænɪdˈɪkɪ
ئەلىشىر	ælˈɪʃɪr
ئاجراتقان	ɑd͡ʒrˈɑtqɑn
بولىدىغان	bˌolɪdˈɪʁɑn
چۈشەندۈرۈش	t͡ʃˌyʃændˈyɾyʃ
دەپ	dˈæp
تاۋار	tˈɑwɑr
مەسىلىسى	mˌæsɪlˈɪsɪ
ياشلار	jˈɑʃlɑr
تاللىغان	tɑllˈɪʁɑn
بۇغداي	bˈuʁdɑj
ئاپپاراتلىرى	ˌɑppɑɾɑtlˈɪɾɪ
بەختلىك	bˈæχtlɪk
نامىزى	nɑmˈɪzɪ
تونۇلغان	tonˈulʁɑn
مەھكىمە	mæhkˈɪmæ
ئازسانلىق	ɑzsˈɑnlɪq
ۋەكىل	wˈækɪl
سەئىد	sˈæɪd
دېمەكتۇر	demˈæktur
ئەسكەرتىپ	æskˈærtɪp
بۆلۈم	bˈœlym
ياساپ	jˈɑsɑp
مەھمۇت	mˈæhmut
ئېلان	ˈelɑn
باشلايدۇ	bɑʃlˈɑjdu
ئىلگىرىكى	ˌɪlɡɪɾˈɪkɪ
توم	tˈom
نەتىجىسىدە	nˌætɪd͡ʒɪsˈɪdæ
ھەنەفىي	hænˈæfɪj
گېپى	ɡˈepɪ
دەۋردىكى	dæwrdˈɪkɪ
ماھارىتى	mˌɑhɑɾˈɪtɪ
بوۋاي	bˈowɑj
تېمپېراتۇرىسى	tˌempeɾˌɑtuɾˈɪsɪ
ئاللىبۇرۇن	ˌɑllɪbˈuɾun
نادان	nˈɑdɑn
باھانە	bɑhˈɑnæ
ھىجرى	hˈɪd͡ʒrɪ
تېپىپ	tˈepɪp
كالا	kˈɑlɑ
سائەتتىن	sɑˈættɪn
مۇيەسسەر	mujˈæssær
بىرەر	bˈɪɾær
مەنبەسىنى	mˌænbæsˈɪnɪ
شۆبە	ʃˈœbæ
تىلغا	tˈɪlʁɑ
قىسمىدىكى	qˌɪsmɪdˈɪkɪ
ئائىت	ˈɑɪt
مۇسۇلمان	musˈulmɑn
سېستىمىسى	sˌestɪmˈɪsɪ
تارقىتىش	tɑrqˈɪtɪʃ
تارىخىنىڭ	tˌɑɾɪχˈɪnɪŋ
تەۋەسىدە	tˌæwæsˈɪdæ
خاتىرىسى	χˌɑtɪɾˈɪsɪ
قوياتتى	qojˈɑttɪ
ئەسكەرتىش	æskˈærtɪʃ
يۈزىدىكى	jˌyzɪdˈɪkɪ
سۆزلەيدىغان	sˌœzlæjdˈɪʁɑn
باشلاندى	bɑʃlˈɑndɪ
چىقتى	t͡ʃˈɪqtɪ
مەشغۇل	mˈæʃʁul
بىرىگە	bɪɾˈɪɡæ
ھەيران	hˈæjrɑn
قانچىلىك	qɑnt͡ʃˈɪlɪk
ئۇرۇشتا	uɾˈuʃtɑ
نەرسىلەر	nærsˈɪlær
كېيىنلا	kejˈɪnlɑ
بىلىملىرىنى	bˌɪlɪmlɪɾˈɪnɪ
سانى	sˈɑnɪ
دوختۇر	dˈoχtur
جەمئىيەت	d͡ʒæmˈɪjæt
بىرقەدەر	bɪrqˈædær
كىرىم	kˈɪɾɪm
ۋەزىپىسىنى	wˌæzɪpɪsˈɪnɪ
ھەقىقەتەن	hˌæqɪqˈætæn
دادىسىدىن	dˌɑdɪsˈɪdɪn
كۆرسەتكەن	kœrsˈætkæn
قۇرغۇچىسى	qˌurʁut͡ʃˈɪsɪ
دا	dˈɑ
بولغانىكەن	bˌolʁɑnˈɪkæn
ئىرادە	ɪɾˈɑdæ
ئويناپ	ˈojnɑp
يىل	jˈɪl
ئامىللار	ɑmˈɪllɑr
دوستلۇق	dˈostluq
مۇستەقىللىقىنى	mˌustæqˌɪllɪqˈɪnɪ
قويۇلمايدۇ	qˌojulmˈɑjdu
خۇلاسە	χulˈɑsæ
كىشىنىڭ	kɪʃˈɪnɪŋ
ئۇنىڭ	ˈunɪŋ
سۆزى	sˈœzɪ
يېقىنقى	jeqˈɪnqɪ
ئەدەبىيات	ˌædæbˈɪjɑt
ياتلىق	jˈɑtlɪq
تامامەن	tɑmˈɑmæn
كوللېكتىپ	kollˈektɪp
DNA	dnˈɑ
جازاسى	d͡ʒɑzˈɑsɪ
تارتىش	tˈɑrtɪʃ
ئاللىقاچان	ˌɑllɪqˈɑt͡ʃɑn
ھۇجۇمغا	hud͡ʒˈumʁɑ
يەتتى	jˈættɪ
ئاپتوماتىك	ˌɑptomˈɑtɪk
ئىنسانىيەتكە	ˌɪnsɑnɪjˈætkæ
قىسمىنىڭ	qɪsmˈɪnɪŋ
ئىگەللەيدۇ	ˌɪɡællˈæjdu
مەزگىلدە	mæzɡˈɪldæ
چىققانلىقىنى	t͡ʃˌɪqqɑnlɪqˈɪnɪ
قارايدۇ	qɑɾˈɑjdu
كۆرگىلى	kœrɡˈɪlɪ
يۇڭ	jˈuŋ
تەرىپىدىكى	tˌæɾɪpɪdˈɪkɪ
رايونلۇق	rɑjˈonluq
تام	tˈɑm
تۈرلىرىنىڭ	tˌyrlɪɾˈɪnɪŋ
مۇئەييەن	muˈæjjæn
بېكىتكەن	bekˈɪtkæn
يېتىش	jˈetɪʃ
دۇلات	dˈulɑt
چۈشەنچە	t͡ʃyʃˈænt͡ʃæ
يۈز	jˈyz
مۇنچە	mˈunt͡ʃæ
شىمالى	ʃɪmˈɑlɪ
توختام	tˈoχtɑm
بايلىق	bˈɑjlɪq
ئۇقتۇرۇش	uqtˈuɾuʃ
ھەممىسىنى	hˌæmmɪsˈɪnɪ
تۈركچە	tˈyrkt͡ʃæ
قوغداپ	qˈoʁdɑp
سۆڭەك	sˈœŋæk
ۋاقىتلىرىدا	wˌɑqɪtlɪɾˈɪdɑ
تەييارلاپ	tæjjˈɑrlɑp
جايلار	d͡ʒˈɑjlɑr
مەرىپەت	mæɾˈɪpæt
يولباشلاش	jolbˈɑʃlɑʃ
بېيجىڭ	bˈejd͡ʒɪŋ
ۋاپات	wˈɑpɑt
قايتۇرۇش	qɑjtˈuɾuʃ
بولىدىغانلىقىنى	bˌolɪdˌɪʁɑnlɪqˈɪnɪ
ئاتلىق	ˈɑtlɪq
ئاجايىپ	ɑd͡ʒˈɑjɪp
خانلىقى	χɑnlˈɪqɪ
مېنىڭچە	menˈɪŋt͡ʃæ
ئەزاسى	æzˈɑsɪ
ھالقىلىق	hɑlqˈɪlɪq
ساقلايدۇ	sɑqlˈɑjdu
قوشۇلغان	qoʃˈulʁɑn
ئۆيىدە	œjˈɪdæ
ئۆزىمىزنى	ˌœzɪmˈɪznɪ
بىلمەي	bˈɪlmæj
سەۋەپتىن	sæwˈæptɪn
بالىڭىزغا	bˌɑlɪŋˈɪzʁɑ
چىرايلىق	t͡ʃɪɾˈɑjlɪq
نەزەرىيىسى	nˌæzæɾɪjˈɪsɪ
بىرمۇ	bˈɪrmu
سودا	sˈodɑ
يوقاپ	jˈoqɑp
سۇپىسى	supˈɪsɪ
يېزىقتا	jezˈɪqtɑ
ئەتراپلىق	ætrˈɑplɪq
پۇلنىڭ	pˈulnɪŋ
كۈرەش	kˈyɾæʃ
مەيلى	mˈæjlɪ
دۇنياسىغا	dˌunjɑsˈɪʁɑ
قوماندانلىق	qˌomɑndˈɑnlɪq
ئاچتى	ˈɑt͡ʃtɪ
سەۋەبى	sæwˈæbɪ
شۇغۇللىنىدىغان	ʃˌuʁullˌɪnɪdˈɪʁɑn
چۈشكەندىن	t͡ʃyʃkˈændɪn
ھەمدە	hˈæmdæ
دېگەندىن	deɡˈændɪn
دۇنياسىدىكى	dˌunjɑsɪdˈɪkɪ
ياڭاق	jˈɑŋɑq
قالدۇرۇپ	qɑldˈuɾup
ئۆيى	ˈœjɪ
تاشيولىنىڭ	tˌɑʃjolˈɪnɪŋ
مەجبۇر	mˈæd͡ʒbur
تەبئىي	tˈæbɪj
ئىران	ˈɪɾɑn
قىلمايدۇ	qɪlmˈɑjdu
روھىنى	rohˈɪnɪ
يۇسۇف	jˈusuf
چاغلاردا	t͡ʃɑʁlˈɑrdɑ
يىغىنى	jɪʁˈɪnɪ
رىئايە	rɪˈɑjæ
قەبىلىسىنىڭ	qˌæbɪlɪsˈɪnɪŋ
بەلگىلىگەن	bˌælɡɪlˈɪɡæn
ئادالەت	ɑdˈɑlæt
كۆزلىگەن	kœzlˈɪɡæn
خەۋىرىنى	χˌæwɪɾˈɪnɪ
مەنبەلەردە	mˌænbælˈærdæ
بەلگىلىك	bælɡˈɪlɪk
بۆلۈمى	bœlˈymɪ
بارماق	bˈɑrmɑq
قول	qˈol
سېلىش	sˈelɪʃ
ئۈستۈنكى	ystˈynkɪ
ئەنھۇ	ˈænhu
رەسۇلۇللاھنىڭ	rˌæsulullˈɑhnɪŋ
پارلامېنت	pɑrlˈɑment
نۇر	nˈur
كۆز	kˈœz
بولغىنى	bolʁˈɪnɪ
ئىچكى	ˈɪt͡ʃkɪ
اللە	ˈɑllæ
ئالەم	ˈɑlæm
ساقلانماقتا	sˌɑqlɑnmˈɑqtɑ
تىللىرى	tɪllˈɪɾɪ
مەلۇم	mˈælum
ماددا	mˈɑddɑ
ھېچقانداق	het͡ʃqˈɑndɑq
ئاپتور	ˈɑptor
چىش	t͡ʃˈɪʃ
مۇسۇلمانلار	mˌusulmˈɑnlɑr
غەلبە	ʁˈælbæ
قەيسەر	qˈæjsær
كىشىدۇر	kɪʃˈɪdur
ئالاقىسى	ˌɑlɑqˈɪsɪ
گۇمان	ɡˈumɑn
ئىپادىلەش	ˌɪpɑdˈɪlæʃ
تۈركىيەدىكى	tˌyrkɪjædˈɪkɪ
رەسىم	rˈæsɪm
يېقىندا	jeqˈɪndɑ
قىيىن	qˈɪjɪn
ئۆرپ	ˈœrp
سۇغۇرتا	suʁˈurtɑ
تىپىك	tˈɪpɪk
رايونلىرىدا	rˌɑjonlɪɾˈɪdɑ
رايونغا	rɑjˈonʁɑ
تېمپېراتۇرا	tˌempeɾɑtˈuɾɑ
مەكتەپتىكى	mˌæktæptˈɪkɪ
بىرلىكى	bɪrlˈɪkɪ
ئوقۇتۇش	oqˈutuʃ
ئۆزبېك	ˈœzbek
بولغاچ	bˈolʁɑt͡ʃ
دەۋالاشقۇچى	dˌæwɑlɑʃqˈut͡ʃɪ
ئۆلتۈرۈلگەن	ˌœltyɾˈylɡæn
مۇئەسسەسەلىرى	mˌuæssˌæsælˈɪɾɪ
ئاپتونومىيىلىك	ˌɑptonˌomɪjˈɪlɪk
ئارزۇ	ˈɑrzu
دىگەندەك	dɪɡˈændæk
قالماسلىقى	qˌɑlmɑslˈɪqɪ
نەشىر	nˈæʃɪr
ئوقۇغۇچىسى	ˌoquʁut͡ʃˈɪsɪ
كەتكەن	kˈætkæn
قوش	qˈoʃ
ماقالىنىڭ	mˌɑqɑlˈɪnɪŋ
يىلغىچە	jɪlʁˈɪt͡ʃæ
تاۋۇز	tˈɑwuz
ئاكا	ˈɑkɑ
شەرقى	ʃˈærqɪ
م	m
كۆكتات	kˈœktɑt
جالالىدىن	d͡ʒˌɑlɑlˈɪdɪn
قومۇل	qˈomul
يوشۇرۇن	joʃˈuɾun
ئۇزاق	ˈuzɑq
بەلگە	bˈælɡæ
قالدىم	qˈɑldɪm
ھېسابلاپ	hesˈɑblɑp
بۇيانقى	bujˈɑnqɪ
ئىدىم	ˈɪdɪm
مەزگىلىدە	mˌæzɡɪlˈɪdæ
كىشىلەرنى	kˌɪʃɪlˈærnɪ
يۇقىرى	juqˈɪɾɪ
تاللاش	tˈɑllɑʃ
پايدىسى	pɑjdˈɪsɪ
ياخشىلانماقتا	jˌɑχʃɪlɑnmˈɑqtɑ
باشلاپ	bˈɑʃlɑp
بىرىدۇر	bɪɾˈɪdur
ۋەكىلى	wækˈɪlɪ
كۆزىگە	kœzˈɪɡæ
بۆرە	bˈœɾæ
ئۆيىنى	œjˈɪnɪ
كۈز	kˈyz
پىششىقلاپ	pɪʃʃˈɪqlɑp
ئاسىيادا	ˌɑsɪjˈɑdɑ
نىشاننى	nɪʃˈɑnnɪ
قاتناش	qˈɑtnɑʃ
جەھەتلەردە	d͡ʒˌæhætlˈærdæ
چەرچەن	t͡ʃˈært͡ʃæn
ئۇچرىغان	ut͡ʃrˈɪʁɑn
خەلقلىرى	χælqlˈɪɾɪ
ۋىرۇس	wˈɪɾus
ھەربىي	hˈærbɪj
يەپ	jˈæp
ئادەملەرگە	ˌɑdæmlˈærɡæ
نورمال	nˈormɑl
مەسچىت	mˈæst͡ʃɪt
قالماي	qˈɑlmɑj
ھ	h
قىلغىلى	qɪlʁˈɪlɪ
تاللاپ	tˈɑllɑp
يېتىدۇ	jetˈɪdu
قاتارىدا	qˌɑtɑɾˈɪdɑ
يارىتىلغان	jˌɑɾɪtˈɪlʁɑn
مەرھۇم	mˈærhum
تېخنىكا	teχnˈɪkɑ
زىيارەت	zɪjˈɑɾæt
سائەت	sˈɑæt
جانلىق	d͡ʒˈɑnlɪq
چۈش	t͡ʃˈyʃ
دان	dˈɑn
خىتايچە	χɪtˈɑjt͡ʃæ
ئوخشاشلا	oχʃˈɑʃlɑ
قارارىغا	qˌɑɾɑɾˈɪʁɑ
تەلەپپۇز	tælˈæppuz
ئايرىلىدۇ	ˌɑjrɪlˈɪdu
قۇيىدۇ	qujˈɪdu
ئەقلىي	ˈæqlɪj
ئوتتۇرىدىن	ˌottuɾˈɪdɪn
بېلىق	bˈelɪq
سامساق	sˈɑmsɑq
قىلغان	qˈɪlʁɑn
ئوردىسى	ordˈɪsɪ
تېپىلغان	tepˈɪlʁɑn
تۇرماقتا	turmˈɑqtɑ
پروگراممىلىق	prˌoɡrɑmmˈɪlɪq
كۆردۈم	kˈœrdym
ئاللاھتىن	ɑllˈɑhtɪn
جەمئىيىتى	d͡ʒˌæmɪjˈɪtɪ
يېمەكلىكلەرنى	jˌemæklɪklˈærnɪ
مىللەتلەرنىڭ	mˌɪllætlˈærnɪŋ
يوپۇرمىقى	jˌopurmˈɪqɪ
نەسىھەت	næsˈɪhæt
ئاراللىرى	ˌɑɾɑllˈɪɾɪ
دوستۇمنىڭ	dostˈumnɪŋ
مەزھىپى	mæzhˈɪpɪ
بېرىلىدۇ	bˌeɾɪlˈɪdu
يازغان	jˈɑzʁɑn
ئېسىپ	ˈesɪp
توپىغا	topˈɪʁɑ
ئىچىدە	ɪt͡ʃˈɪdæ
بېرىلگەن	beɾˈɪlɡæn
بەش	bˈæʃ
فوندى	fˈondɪ
سان	sˈɑn
مىليوندىن	mɪljˈondɪn
گوۋۇيۈەن	ɡˌowujˈyæn
تىزىلغان	tɪzˈɪlʁɑn
قويىدىغان	qˌojɪdˈɪʁɑn
مەزكۇر	mˈæzkur
قىز	qˈɪz
ئۇلاردىكى	ˌulɑrdˈɪkɪ
دېسەم	dˈesæm
بەنى	bˈænɪ
جاۋابكار	d͡ʒɑwˈɑbkɑr
ئاخىر	ˈɑχɪr
دەۋرلەردە	dæwrlˈærdæ
يېڭىدىن	jeŋˈɪdɪn
ئالاقىدارلار	ˌɑlɑqɪdˈɑrlɑr
باھار	bˈɑhɑr
تۇتۇشقا	tutˈuʃqɑ
نامىدا	nɑmˈɪdɑ
رايونىدا	rˌɑjonˈɪdɑ
رەت	rˈæt
كېچىدە	ket͡ʃˈɪdæ
خەلقئارادىكى	χˌælqɑɾɑdˈɪkɪ
ئىشلەشكە	ɪʃlˈæʃkæ
مىسىرلىق	mɪsˈɪrlɪq
نامايەن	nɑmˈɑjæn
سانائىتىدىن	sˌɑnɑɪtˈɪdɪn
سىزىلغان	sɪzˈɪlʁɑn
خالىغانچە	χˌɑlɪʁˈɑnt͡ʃæ
مەدەنىيىتىگە	mˌædænˌɪjɪtˈɪɡæ
ھەرپ	hˈærp
خىزمىتىنى	χˌɪzmɪtˈɪnɪ
شانلىق	ʃˈɑnlɪq
ئۆزلىرىگە	ˌœzlɪɾˈɪɡæ
خانى	χˈɑnɪ
يايلاق	jˈɑjlɑq
قۇرۇلۇش	quɾˈuluʃ
ئابدۇسالام	ˌɑbdusˈɑlɑm
بولماي	bˈolmɑj
يېتىلگەن	jetˈɪlɡæn
قارالغان	qɑɾˈɑlʁɑn
ئەھلى	ˈæhlɪ
چاغاتاي	t͡ʃɑʁˈɑtɑj
ھەرىكەتلىرى	hˌæɾɪkætlˈɪɾɪ
ئەمگەك	ˈæmɡæk
بولۇشنىڭ	bolˈuʃnɪŋ
قىسمىغا	qɪsmˈɪʁɑ
بۇقا	bˈuqɑ
ھەممە	hˈæmmæ
تۇڭگان	tˈuŋɡɑn
شەكىللەنگەن	ʃˌækɪllˈænɡæn
ساھەسىدە	sˌɑhæsˈɪdæ
ئۇرۇقى	uɾˈuqɪ
ئۇسۇللىرى	ˌusullˈɪɾɪ
ھەقتە	hˈæqtæ
رېئاللىققا	rˌeɑllˈɪqqɑ
ئالتۇن	ˈɑltun
مول	mˈol
تۈزۈلگەن	tyzˈylɡæn
قويغان	qˈojʁɑn
ئالغىلى	ɑlʁˈɪlɪ
ناۋادا	nɑwˈɑdɑ
بولغانلىقى	bˌolʁɑnlˈɪqɪ
تولغان	tˈolʁɑn
ئوقۇتقۇچىلار	ˌoqutqut͡ʃˈɪlɑr
قىلسىمۇ	qɪlsˈɪmu
ئامانەت	ɑmˈɑnæt
تەبىئى	tæbˈɪɪ
ئۇچى	ˈut͡ʃɪ
تەڭرى	tˈæŋrɪ
ئاشىق	ˈɑʃɪq
بىردىنبىر	bɪrdˈɪnbɪr
يىگىت	jˈɪɡɪt
كۆرسىتىدۇ	kˌœrsɪtˈɪdu
ئورۇنلار	oɾˈunlɑr
كۈنىگە	kynˈɪɡæ
ئورتا	ˈortɑ
ئەتىسى	ætˈɪsɪ
تاماكا	tɑmˈɑkɑ
خالىي	χˈɑlɪj
چىقىدىغان	t͡ʃˌɪqɪdˈɪʁɑn
توختالغان	toχtˈɑlʁɑn
ئىنسانىي	ɪnsˈɑnɪj
مۇكاپاتى	mˌukɑpˈɑtɪ
مىسال	mˈɪsɑl
ئۆيلەرنىڭ	œjlˈærnɪŋ
قىلدىم	qˈɪldɪm
بەردى	bˈærdɪ
نىياز	nˈɪjɑz
قايىل	qˈɑjɪl
ھۆكۈمەت	hœkˈymæt
تىللارغا	tɪllˈɑrʁɑ
ئۇيغۇرلىرىنىڭ	ˌujʁurlɪɾˈɪnɪŋ
رايونى	rɑjˈonɪ
ئىتتىپاقىنىڭ	ˌɪttɪpɑqˈɪnɪŋ
ھەربى	hˈærbɪ
سۇمېر	sˈumer
نەپىس	nˈæpɪs
زىيانلىق	zɪjˈɑnlɪq
سودىگەر	sodˈɪɡær
دېتال	dˈetɑl
ئالدىراش	ɑldˈɪɾɑʃ
دىنىنىڭ	dɪnˈɪnɪŋ
قىلىمەن	qɪlˈɪmæn
سىنا	sˈɪnɑ
ئىگىلىكى	ˌɪɡɪlˈɪkɪ
كېرەكلىكىنى	kˌeɾæklɪkˈɪnɪ
سوممىسى	sommˈɪsɪ
چىقارغان	t͡ʃɪqˈɑrʁɑn
تۇرمۇشتىكى	tˌurmuʃtˈɪkɪ
باراۋەرلىك	bˌɑɾɑwˈærlɪk
سەۋەبلەر	sæwˈæblær
ئالماشتۇرۇش	ˌɑlmɑʃtˈuɾuʃ
بېسىش	bˈesɪʃ
يەھۇدىيلار	jˌæhudˈɪjlɑr
تىن	tˈɪn
ماھارەت	mɑhˈɑɾæt
بەدىئىي	bædˈɪɪj
ۋارىسلىق	wɑɾˈɪslɪq
يولى	jˈolɪ
رومان	rˈomɑn
چۈشتىن	t͡ʃˈyʃtɪn
تاقىم	tˈɑqɪm
ئۆزلىرى	œzlˈɪɾɪ
دائىرىسى	dˌɑɪɾˈɪsɪ
ئورنىدىن	ornˈɪdɪn
كامال	kˈɑmɑl
ئوينىدى	ojnˈɪdɪ
ئاۋۋال	ˈɑwwɑl
بەلباغ	bˈælbɑʁ
پاسپورت	pˈɑsport
بۇمۇ	bˈumu
چېگرا	t͡ʃˈeɡrɑ
يەتكۈزىدىغان	jˌætkyzɪdˈɪʁɑn
تونۇپ	tˈonup
تاراتقۇ	tɑɾˈɑtqu
تۈزۈلۈشى	tˌyzylˈyʃɪ
ۋىلايەت	wɪlˈɑjæt
ھايۋانات	hɑjwˈɑnɑt
يەھۇدىلارنى	jˌæhudɪlˈɑrnɪ
ئاخىرلاشتى	ˌɑχɪrlˈɑʃtɪ
قۇرۇق	qˈuɾuq
ھۆكۈمەتلىرى	hˌœkymætlˈɪɾɪ
مەجبۇرى	mæd͡ʒbˈuɾɪ
بولغىنىغا	bˌolʁɪnˈɪʁɑ
چاي	t͡ʃˈɑj
ئاۋات	ˈɑwɑt
ئۇنتۇپ	ˈuntup
رىياسەتچىلىك	rˌɪjɑsætt͡ʃˈɪlɪk
خاقانى	χɑqˈɑnɪ
ئەزالىرىنىڭ	ˌæzɑlɪɾˈɪnɪŋ
تەرجىمان	tærd͡ʒˈɪmɑn
جىنايەتنى	d͡ʒˌɪnɑjˈætnɪ
قا	qˈɑ
ھېيت	hˈejt
تۆۋەن	tˈœwæn
بېرىلىپ	beɾˈɪlɪp
ھال	hˈɑl
دورىلارنى	dˌoɾɪlˈɑrnɪ
ئىنسانىيەت	ˌɪnsɑnˈɪjæt
of	ˈof
بېشىغا	beʃˈɪʁɑ
ئاتالغۇ	ɑtˈɑlʁu
پىكرىگە	pɪkrˈɪɡæ
ئەدەبىياتى	ˌædæbɪjˈɑtɪ
كەلمەكتە	kælmˈæktæ
قۇل	qˈul
تاق	tˈɑq
قىلدۇردى	qɪldˈurdɪ
ياراتقان	jɑɾˈɑtqɑn
ئەنگلىيە	ænɡlˈɪjæ
ئىشلاردا	ɪʃlˈɑrdɑ
ئىنىمىز	ɪnˈɪmɪz
دەۋرىدە	dæwrˈɪdæ
ئىشچى	ˈɪʃt͡ʃɪ
ياردەمچى	jɑrdˈæmt͡ʃɪ
شەرقتىن	ʃˈærqtɪn
ۋەزىيەت	wæzˈɪjæt
يەسەۋىي	jæsˈæwɪj
بېرىش	bˈeɾɪʃ
قازان	qˈɑzɑn
ئېتىبارەن	ˌetɪbˈɑɾæn
تاپالماي	tɑpˈɑlmɑj
ئىنساننىڭ	ɪnsˈɑnnɪŋ
روسىيە	rosˈɪjæ
خىتاينىڭ	χɪtˈɑjnɪŋ
سېنىڭ	sˈenɪŋ
خۇيزۇ	χˈujzu
پۇرسىتىگە	pˌursɪtˈɪɡæ
ئىشلىرىنى	ˌɪʃlɪɾˈɪnɪ
ساھە	sˈɑhæ
ئىشتا	ˈɪʃtɑ
زادى	zˈɑdɪ
مەنبە	mˈænbæ
زىيان	zˈɪjɑn
ئىمزا	ˈɪmzɑ
قۇياشنىڭ	qujˈɑʃnɪŋ
نۆۋىتى	nœwˈɪtɪ
يېرى	jˈeɾɪ
ھۈسەيىن	hysˈæjɪn
چالغۇ	t͡ʃˈɑlʁu
تۈركىستاندىكى	tˌyrkɪstɑndˈɪkɪ
تەكشۈرۈپ	tækʃˈyɾyp
ئارىسىدىكى	ˌɑɾɪsɪdˈɪkɪ
شۇنچىلىك	ʃunt͡ʃˈɪlɪk
نەتىجىگە	nˌætɪd͡ʒˈɪɡæ
ئومۇمى	omˈumɪ
بېكىتىلگەن	bˌekɪtˈɪlɡæn
ئىقتىدارى	ˌɪqtɪdˈɑɾɪ
ئاياللىرىنىڭ	ˌɑjɑllɪɾˈɪnɪŋ
كەلمەيدۇ	kælmˈæjdu
يوق	jˈoq
تەرىپىدە	tˌæɾɪpˈɪdæ
كونا	kˈonɑ
پۇرسەت	pˈursæt
يىغلاپ	jˈɪʁlɑp
كىرەك	kˈɪɾæk
ۋاقتىدا	wɑqtˈɪdɑ
تەرتىپى	tærtˈɪpɪ
دەيدۇ	dˈæjdu
ئېتنىك	ˈetnɪk
لى	lˈɪ
بىكار	bˈɪkɑr
كومپىيوتىر	kˌompɪjˈotɪr
بازىرى	bɑzˈɪɾɪ
ئىسرائىل	ɪsrˈɑɪl
سەرپ	sˈærp
تەھرىرلەش	tæhrˈɪrlæʃ
ئارىلاشتۇرۇپ	ˌɑɾɪlɑʃtˈuɾup
قايرىپ	qˈɑjrɪp
كۈن	kˈyn
يازغۇچىسى	jˌɑzʁut͡ʃˈɪsɪ
كىچىك	kˈɪt͡ʃɪk
ئۇشبۇ	ˈuʃbu
تارمىقى	tɑrmˈɪqɪ
يولىدا	jolˈɪdɑ
باھاسى	bɑhˈɑsɪ
كېتىشكە	ketˈɪʃkæ
مەنىدە	mænˈɪdæ
مالىكنىڭ	mɑlˈɪknɪŋ
بازىرىدا	bˌɑzɪɾˈɪdɑ
تەركىب	tˈærkɪb
ئۈنۈمى	ynˈymɪ
كۆتۈرۈپ	kœtˈyɾyp
جەمئىيەتكە	d͡ʒˌæmɪjˈætkæ
قەتئىي	qˈætɪj
شېڭ	ʃˈeŋ
كىتابىدا	kˌɪtɑbˈɪdɑ
قىلغۇچى	qɪlʁˈut͡ʃɪ
ئايروپىلانى	ˌɑjropɪlˈɑnɪ
باشقۇرغۇچى	bˌɑʃqurʁˈut͡ʃɪ
كىتابنى	kɪtˈɑbnɪ
قەدىمىي	qædˈɪmɪj
تېلىفون	telˈɪfon
كومىتېتىنىڭ	kˌomɪtetˈɪnɪŋ
نىكاھ	nˈɪkɑh
ئۆمەرنىڭ	œmˈærnɪŋ
ماقالىدە	mˌɑqɑlˈɪdæ
ئۆتمەيلا	œtmˈæjlɑ
بەدەن	bˈædæn
ئۆتكۈزۈلگەن	ˌœtkyzˈylɡæn
سىڭدۈرمە	sɪŋdˈyrmæ
قېرىنداشلار	qˌeɾɪndˈɑʃlɑr
غەرپكە	ʁˈærpkæ
يەرلەرنى	jærlˈærnɪ
ئاۋاز	ˈɑwɑz
پولو	pˈolo
رۇس	rˈus
نەق	nˈæq
مەسىلىلەرنى	mˌæsɪlɪlˈærnɪ
خەلقئارالىق	χˌælqɑɾˈɑlɪq
خالاس	χˈɑlɑs
دەۋرىنىڭ	dæwrˈɪnɪŋ
ھەققىنى	hæqqˈɪnɪ
ئەمگەكچىلەر	ˌæmɡækt͡ʃˈɪlær
تايىنىپ	tɑjˈɪnɪp
كۈتۈپ	kˈytyp
زامانلاردا	zˌɑmɑnlˈɑrdɑ
ۋاكالەت	wɑkˈɑlæt
ۋاڭنىڭ	wˈɑŋnɪŋ
سانتىمېتىر	sˌɑntɪmˈetɪr
مېتىر	mˈetɪr
قۇتادغۇبىلىك	qˌutɑdʁubˈɪlɪk
ئوبلاستى	oblˈɑstɪ
مەندەك	mˈændæk
قۇرامىغا	qˌuɾɑmˈɪʁɑ
مۇستەملىكىسى	mˌustæmlɪkˈɪsɪ
مىللەت	mˈɪllæt
تەرتىپكە	tærtˈɪpkæ
قىرىم	qˈɪɾɪm
چۈشەندۈرىدۇ	t͡ʃˌyʃændyɾˈɪdu
يەرلەرگە	jærlˈærɡæ
مەدەنىيىتى	mˌædænɪjˈɪtɪ
نوپۇسى	nopˈusɪ
بوۋاق	bˈowɑq
ئازىركى	ɑzˈɪrkɪ
ئورگانىك	orɡˈɑnɪk
ئامبال	ˈɑmbɑl
يەردىن	jˈærdɪn
جەريانى	d͡ʒærjˈɑnɪ
تۈپ	tˈyp
ئىستېمال	ɪstˈemɑl
ساقلاش	sˈɑqlɑʃ
يەتتە	jˈættæ
ئاخىرىغا	ˌɑχɪɾˈɪʁɑ
خوش	χˈoʃ
بىلدۈرگەن	bɪldˈyrɡæn
تەك	tˈæk
ئارغامچا	ɑrʁˈɑmt͡ʃɑ
خىلدىن	χˈɪldɪn
تۈركىستاننىڭ	tˌyrkɪstˈɑnnɪŋ
ئەتراپىدا	ˌætrɑpˈɪdɑ
ئاياللار	ɑjˈɑllɑr
توختىتىپ	toχtˈɪtɪp
بىردەم	bˈɪrdæm
مىللەتچىلىك	mˌɪllætt͡ʃˈɪlɪk
نۇپۇسى	nupˈusɪ
ئۆلگەن	ˈœlɡæn
ئۆزئارا	œzˈɑɾɑ
دىۋان	dˈɪwɑn
مەزمۇنى	mæzmˈunɪ
بىرنەچچە	bɪrnˈæt͡ʃt͡ʃæ
ئۇلۇغ	ˈuluʁ
ئېيتتى	ˈejttɪ
ئەنئەنىۋىي	ˌænænˈɪwɪj
ئۈزۈپ	ˈyzyp
قىسمى	qˈɪsmɪ
كۈلتۈر	kˈyltyr
ئېرى	ˈeɾɪ
تەشكىل	tˈæʃkɪl
ئىسھاق	ˈɪshɑq
قوزغىلاڭ	qozʁˈɪlɑŋ
نەۋائىي	næwˈɑɪj
ئايەتلەر	ɑjˈætlær
غىچە	ʁˈɪt͡ʃæ
پوچتا	pˈot͡ʃtɑ
كېيىنمۇ	kejˈɪnmu
ئۇلۇس	ˈulus
ئۆزىمىزگە	ˌœzɪmˈɪzɡæ
پەرز	pˈærz
كېيىنچە	kejˈɪnt͡ʃæ
كىتابى	kɪtˈɑbɪ
ئوقۇغۇچىلارنىڭ	ˌoquʁˌut͡ʃɪlˈɑrnɪŋ
مىللەتلەرنى	mˌɪllætlˈærnɪ
ساقىت	sˈɑqɪt
جىنايى	d͡ʒɪnˈɑjɪ
كۆمەچ	kˈœmæt͡ʃ
شىمالدىكى	ʃˌɪmɑldˈɪkɪ
ئىجاد	ˈɪd͡ʒɑd
سوڭرە	sˈoŋræ
ياۋرۇپا	jɑwrˈupɑ
ئەكس	ˈæks
بايلىقىدىن	bˌɑjlɪqˈɪdɪn
ئوغلى	ˈoʁlɪ
ۋاستە	wˈɑstæ
قوللانغان	qollˈɑnʁɑn
ھاراق	hˈɑɾɑq
تۈر	tˈyr
مەركىزىدە	mˌærkɪzˈɪdæ
مەكتىپى	mæktˈɪpɪ
خاتا	χˈɑtɑ
تېگىشلىك	teɡˈɪʃlɪk
تۇنجى	tˈund͡ʒɪ
ئالەمنىڭ	ɑlˈæmnɪŋ
ئەسەرلىرى	ˌæsærlˈɪɾɪ
ئىچىنى	ɪt͡ʃˈɪnɪ
دۇنيادىكى	dˌunjɑdˈɪkɪ
رايۇننومۇرى	rˌɑjunnomˈuɾɪ
بىرىنى	bɪɾˈɪnɪ
تېخىچە	teχˈɪt͡ʃæ
ئازات	ˈɑzɑt
توغۇلغان	toʁˈulʁɑn
ئەدەبىياتىغا	ˌædæbˌɪjɑtˈɪʁɑ
رەڭدە	rˈæŋdæ
قىلىشىغا	qˌɪlɪʃˈɪʁɑ
زور	zˈor
قىلغۇچىلارنىڭ	qˌɪlʁut͡ʃɪlˈɑrnɪŋ
قامۇسى	qɑmˈusɪ
ھالقا	hˈɑlqɑ
شەكىللىرى	ʃˌækɪllˈɪɾɪ
شۇنىڭغا	ʃunˈɪŋʁɑ
سىياسىتىنى	sˌɪjɑsɪtˈɪnɪ
مەسىلىگە	mˌæsɪlˈɪɡæ
بەزىلىرى	bˌæzɪlˈɪɾɪ
تاشلاپ	tˈɑʃlɑp
ئۆسىدۇ	œsˈɪdu
كېيىنكى	kejˈɪnkɪ
شەخسى	ʃˈæχsɪ
ۋەزىپىسى	wˌæzɪpˈɪsɪ
جەنۇبتىن	d͡ʒænˈubtɪn
ياسىلىدۇ	jˌɑsɪlˈɪdu
ھەددىدىن	hæddˈɪdɪn
قىسمەن	qˈɪsmæn
تاۋۇشى	tɑwˈuʃɪ
ئېيىق	ˈejɪq
نۇقتىسىدىن	nˌuqtɪsˈɪdɪn
رەئىسى	ræˈɪsɪ
جەڭدە	d͡ʒˈæŋdæ
سەپ	sˈæp
تەربىيىسى	tˌærbɪjˈɪsɪ
بەدىلىگە	bˌædɪlˈɪɡæ
قوينىڭ	qˈojnɪŋ
بەك	bˈæk
نومۇرى	nomˈuɾɪ
تۈنۈگۈن	tynˈyɡyn
بېسىمى	besˈɪmɪ
بولۇۋاتقان	bˌoluwˈɑtqɑn
ياسىغان	jɑsˈɪʁɑn
ئىزدەڭ	ˈɪzdæŋ
ئەنئەنە	ænˈænæ
پارتىيىسى	pˌɑrtɪjˈɪsɪ
بىرىش	bˈɪɾɪʃ
ھاجى	hˈɑd͡ʒɪ
لېكىن	lˈekɪn
ئىدۇق	ˈɪduq
بىلىدۇ	bɪlˈɪdu
بېشىدىن	beʃˈɪdɪn
قىلغانلىقىنى	qˌɪlʁɑnlɪqˈɪnɪ
كۈنلەردە	kynlˈærdæ
ئىلىم	ˈɪlɪm
ئىشخانىسى	ˌɪʃχɑnˈɪsɪ
قولدىن	qˈoldɪn
ئېغىرلىق	eʁˈɪrlɪq
ئىمپېرىيە	ˌɪmpeɾˈɪjæ
تاش	tˈɑʃ
قاتاردا	qɑtˈɑrdɑ
ئالاھىدىلىكى	ˌɑlɑhˌɪdɪlˈɪkɪ
ئوقۇغانلىقى	ˌoquʁɑnlˈɪqɪ
ئادەملىرى	ˌɑdæmlˈɪɾɪ
ھېلىمۇ	helˈɪmu
ۋاپاتى	wɑpˈɑtɪ
كەلتۈرۈش	kæltˈyɾyʃ
تۈردە	tˈyrdæ
كىيىنكى	kɪjˈɪnkɪ
مىللىتىنىڭ	mˌɪllɪtˈɪnɪŋ
قولدا	qˈoldɑ
ئۇنۋان	ˈunwɑn
بىرۇنىنىڭ	bˌɪɾunˈɪnɪŋ
جەرياندا	d͡ʒærjˈɑndɑ
شەكلى	ʃˈæklɪ
ئىشىكى	ɪʃˈɪkɪ
بېكىتىپ	bekˈɪtɪp
شىركەتتىن	ʃɪrkˈættɪn
يوقىرى	joqˈɪɾɪ
سۇغا	sˈuʁɑ
قالدى	qˈɑldɪ
مۇددەت	mˈuddæt
بايلىقى	bɑjlˈɪqɪ
يېزىلىشى	jˌezɪlˈɪʃɪ
قىپتۇ	qˈɪptu
ئۇ	ˈu
فىلىم	fˈɪlɪm
ئۆزى	ˈœzɪ
زىيالىي	zɪjˈɑlɪj
تاشيوللىرى	tˌɑʃjollˈɪɾɪ
ماڭغاندا	mɑŋʁˈɑndɑ
مۇكاپاتىغا	mˌukɑpɑtˈɪʁɑ
باغ	bˈɑʁ
پەش	pˈæʃ
ئۆزگەرتىلگەن	ˌœzɡærtˈɪlɡæn
داۋا	dˈɑwɑ
كىچىككىنە	kˌɪt͡ʃɪkkˈɪnæ
ھېسابلىنىدۇ	hˌesɑblɪnˈɪdu
دەرھال	dˈærhɑl
تونۇش	tˈonuʃ
غەلىتە	ʁælˈɪtæ
مىلادىدىن	mˌɪlɑdˈɪdɪn
كۆپىنچىسى	kˌœpɪnt͡ʃˈɪsɪ
چىقىپ	t͡ʃˈɪqɪp
تەبىئىي	tæbˈɪɪj
گېكتار	ɡˈektɑr
بارلىققا	bɑrlˈɪqqɑ
ئالەمدىن	ɑlˈæmdɪn
ئۇنىۋېرسال	ˌunɪwˈersɑl
ئەمەسلىكىنى	ˌæmæslɪkˈɪnɪ
يېتىشىپ	jetˈɪʃɪp
ھەر	hˈær
ھىندى	hˈɪndɪ
ئالدىدا	ɑldˈɪdɑ
ئەسىردىن	æsˈɪrdɪn
ھەركەت	hˈærkæt
پات	pˈɑt
كۆچمە	kˈœt͡ʃmæ
جەنۇبىي	d͡ʒænˈubɪj
تۈسىنى	tysˈɪnɪ
قۇرۇلدى	quɾˈuldɪ
نەچچە	nˈæt͡ʃt͡ʃæ
ى	ˈɪ
بۇخارا	buχˈɑɾɑ
ئۇرۇق	ˈuɾuq
ناھايىتىمۇ	nˌɑhɑjɪtˈɪmu
چۈشەنچىسىنى	t͡ʃˌyʃænt͡ʃɪsˈɪnɪ
ھەمىشە	hæmˈɪʃæ
ھۇجۇم	hˈud͡ʒum
ھەسسىلەپ	hæssˈɪlæp
تېزلا	tˈezlɑ
جۈملىدىن	d͡ʒymlˈɪdɪn
ياكى	jˈɑkɪ
كىچىكىدىن	kˌɪt͡ʃɪkˈɪdɪn
ئازادلىقتىن	ˌɑzɑdlˈɪqtɪn
يەرنىڭ	jˈærnɪŋ
ئىتالىيە	ˌɪtɑlˈɪjæ
قىزىل	qˈɪzɪl
يەرنى	jˈærnɪ
قاتارىدىن	qˌɑtɑɾˈɪdɪn
تىرىشىپ	tɪɾˈɪʃɪp
ئوقۇشقا	oqˈuʃqɑ
قالمىدى	qɑlmˈɪdɪ
قاراخانىيلار	qˌɑɾɑχɑnˈɪjlɑr
مەنىسىدىكى	mˌænɪsɪdˈɪkɪ
كېلىۋاتقان	kˌelɪwˈɑtqɑn
يىلىغا	jɪlˈɪʁɑ
ھالاك	hˈɑlɑk
قىلىشىمىز	qˌɪlɪʃˈɪmɪz
قاپتۇ	qˈɑptu
ياۋروپادا	jˌɑwropˈɑdɑ
مەقسىدى	mæqsˈɪdɪ
ئاستى	ˈɑstɪ
بىرىپ	bˈɪɾɪp
سوڭىغا	soŋˈɪʁɑ
ئوزۇقلۇق	ozˈuqluq
نەزىرىدە	nˌæzɪɾˈɪdæ
سارىيى	sɑɾˈɪjɪ
كۈچلۈك	kˈyt͡ʃlyk
ئېچىلغان	et͡ʃˈɪlʁɑn
شېئىرلار	ʃeˈɪrlɑr
باغۋەنچىلىك	bˌɑʁwænt͡ʃˈɪlɪk
قەشقەر	qˈæʃqær
ياشاپ	jˈɑʃɑp
دە	dˈæ
ترامپ	trˈɑmp
ئاللاھ	ˈɑllɑh
تارقىتىلغان	tˌɑrqɪtˈɪlʁɑn
ھاكىمىيەتنى	hˌɑkɪmɪjˈætnɪ
خەنزۇ	χˈænzu
يەتكۈزۈپ	jætkˈyzyp
سەنئەت	sˈænæt
ماددى	mˈɑddɪ
ئاتا	ˈɑtɑ
تۇرۇشلۇق	tuɾˈuʃluq
ئاپتونۇم	ɑptˈonum
دەرىجىسىنى	dˌæɾɪd͡ʒɪsˈɪnɪ
بىلىمگە	bɪlˈɪmɡæ
ماددىي	mˈɑddɪj
رەھىمەھۇللاھ	rˌæhɪmæhˈullɑh
تۈرى	tˈyɾɪ
ھىندىستاننىڭ	hˌɪndɪstˈɑnnɪŋ
پايتەختى	pɑjtˈæχtɪ
گۇرۇپپا	ɡuɾˈuppɑ
خەت	χˈæt
ئىنسانىيەتنىڭ	ˌɪnsɑnɪjˈætnɪŋ
ق	q
قۇرۇلمىسى	qˌuɾulmˈɪsɪ
ئىكەن	ˈɪkæn
ناننىڭ	nˈɑnnɪŋ
ئۇنۋانىغا	ˌunwɑnˈɪʁɑ
ئىتتىپاقداش	ˌɪttɪpˈɑqdɑʃ
ئىچكىرى	ɪt͡ʃkˈɪɾɪ
ياخشىراق	jɑχʃˈɪɾɑq
تۆھپە	tˈœhpæ
نەشر	nˈæʃr
پەقەت	pˈæqæt
سالىھ	sˈɑlɪh
بىرگە	bˈɪrɡæ
ئۇچۇرلار	ut͡ʃˈurlɑr
چاچ	t͡ʃˈɑt͡ʃ
سۈرئەتتە	syɾˈættæ
ئىمكانىيەت	ˌɪmkɑnˈɪjæt
بىلىپ	bˈɪlɪp
ھاياتلىق	hɑjˈɑtlɪq
گىلەم	ɡˈɪlæm
شۇنچە	ʃˈunt͡ʃæ
كۆڭلىنى	kœŋlˈɪnɪ
ئىشلەپچىقىرىش	ˌɪʃlæpt͡ʃɪqˈɪɾɪʃ
دىمەك	dˈɪmæk
توپلاش	tˈoplɑʃ
ئەسىرىنى	ˌæsɪɾˈɪnɪ
جازاسىغا	d͡ʒˌɑzɑsˈɪʁɑ
ھەزرىتى	hæzrˈɪtɪ
مۇۋەپپەقىيەتلىك	mˌuwæppˌæqɪjˈætlɪk
تەڭرىتاغ	tæŋrˈɪtɑʁ
دۆلەتلىرى	dˌœlætlˈɪɾɪ
جەمئىي	d͡ʒˈæmɪj
قىلالايدىغان	qˌɪlɑlɑjdˈɪʁɑn
قار	qˈɑr
تۆلەپ	tˈœlæp
بىلەتتى	bɪlˈættɪ
خەۋپسىزلىكى	χˌæwpsɪzlˈɪkɪ
ئىسىم	ˈɪsɪm
ئۇچرايدىغان	ˌut͡ʃrɑjdˈɪʁɑn
مەندىن	mˈændɪn
بەرداشلىق	bærdˈɑʃlɪq
تۇرمۇشنى	turmˈuʃnɪ
دەۋرىدىن	dæwrˈɪdɪn
ياسىر	jˈɑsɪr
يوپۇرماق	jopˈurmɑq
مۇۋەپپەقىيەتكە	mˌuwæppˌæqɪjˈætkæ
ئىگىلەيدۇ	ˌɪɡɪlˈæjdu
كىشىلەرگە	kˌɪʃɪlˈærɡæ
سەلبى	sˈælbɪ
ئىشلەش	ˈɪʃlæʃ
تەۋە	tˈæwæ
گۇاڭشۈ	ɡuˈɑŋʃy
باغلىنىپ	bɑʁlˈɪnɪp
شەنبە	ʃˈænbæ
خوتەن	χˈotæn
شىسىنىڭ	ʃɪsˈɪnɪŋ
نۇزۇكۇمنىڭ	nˌuzukˈumnɪŋ
تىخى	tˈɪχɪ
باغلاپ	bˈɑʁlɑp
يېتىدىغان	jˌetɪdˈɪʁɑn
ھىچكىم	hˈɪt͡ʃkɪm
كىتابلار	kɪtˈɑblɑr
ئۇسۇلىنى	ˌusulˈɪnɪ
چىقىم	t͡ʃˈɪqɪm
تۇل	tˈul
دورىغا	doɾˈɪʁɑ
ئاددىي	ˈɑddɪj
كىتاب	kˈɪtɑb
تېپىش	tˈepɪʃ
قىلماق	qˈɪlmɑq
ئىلىش	ˈɪlɪʃ
قوزغىغان	qozʁˈɪʁɑn
يېرىنى	jeɾˈɪnɪ
مەھسۇلاتلىرىنى	mˌæhsulˌɑtlɪɾˈɪnɪ
بولغانلار	bolʁˈɑnlɑr
سىتاتىسكىگا	sˌɪtɑtɪskˈɪɡɑ
ياشاۋاتقان	jˌɑʃɑwˈɑtqɑn
دوكتۇر	dˈoktur
رامىزان	rɑmˈɪzɑn
مەخسۇت	mˈæχsut
بولۇۋاتىدۇ	bˌoluwɑtˈɪdu
قوناق	qˈonɑq
ماگىستىرلىق	mˌɑɡɪstˈɪrlɪq
ھەدىسنى	hædˈɪsnɪ
ئالدىغا	ɑldˈɪʁɑ
پەيغەمبەرنىڭ	pˌæjʁæmbˈærnɪŋ
خەلقىمىز	χælqˈɪmɪz
كىرىدۇ	kɪɾˈɪdu
ئىتىراپ	ɪtˈɪɾɑp
يۇلتۇز	jˈultuz
كەتسە	kˈætsæ
قاتارلىقلار	qˌɑtɑrlˈɪqlɑr
ھازىرچە	hɑzˈɪrt͡ʃæ
ھېسابلاش	hesˈɑblɑʃ
مىللىمېتىر	mˌɪllɪmˈetɪr
تەرجىمىسى	tˌærd͡ʒɪmˈɪsɪ
مەۋجۇتلۇقىنى	mˌæwd͡ʒutluqˈɪnɪ
باجنى	bˈɑd͡ʒnɪ
پۇلغا	pˈulʁɑ
ئوتتا	ˈottɑ
بېرىپتۇ	beɾˈɪptu
مەھمۇد	mˈæhmud
ئەقىللىق	æqˈɪllɪq
كىرىمى	kɪɾˈɪmɪ
يېنىپ	jˈenɪp
ئېلىنىپ	elˈɪnɪp
تۆت	tˈœt
تەقدىر	tˈæqdɪr
تاشقى	tˈɑʃqɪ
قۇرۇلما	quɾˈulmɑ
ئاخىرىدا	ˌɑχɪɾˈɪdɑ
بىلىش	bˈɪlɪʃ
مەسخىرە	mæsχˈɪɾæ
يۇرتى	jˈurtɪ
بولۇشتىن	bolˈuʃtɪn
ئەل	ˈæl
مىللەتلەرگە	mˌɪllætlˈærɡæ
شىمالدا	ʃɪmˈɑldɑ
ۋۇجۇدقا	wud͡ʒˈudqɑ
ئاددى	ˈɑddɪ
بولمايدۇ	bolmˈɑjdu
ئۆزىدە	œzˈɪdæ
ياشىغان	jɑʃˈɪʁɑn
غوللۇق	ʁˈolluq
سورايدۇ	soɾˈɑjdu
تەرەپتە	tæɾˈæptæ
بۈگۈنگىچە	bˌyɡynɡˈɪt͡ʃæ
قاتارلىقلارنىڭ	qˌɑtɑrlɪqlˈɑrnɪŋ
جۇمھۇرىيەت	d͡ʒˌumhuɾˈɪjæt
بەزىلەر	bæzˈɪlær
چۆللۈك	t͡ʃˈœllyk
ئارىدا	ɑɾˈɪdɑ
كەلدى	kˈældɪ
دۆلىتىگە	dˌœlɪtˈɪɡæ
تەقلىد	tˈæqlɪd
قالسا	qˈɑlsɑ
قىلىپتۇ	qɪlˈɪptu
يۈك	jˈyk
خاتىرجەم	χɑtˈɪrd͡ʒæm
قۇربان	qˈurbɑn
گەۋدىلىك	ɡæwdˈɪlɪk
يەھۇدى	jæhˈudɪ
ئايالى	ɑjˈɑlɪ
قەشقەرنىڭ	qæʃqˈærnɪŋ
تۈركىيە	tyrkˈɪjæ
ئېسىمگە	esˈɪmɡæ
خەلقئارادا	χˌælqɑɾˈɑdɑ
بەلۋاغ	bˈælwɑʁ
ياپونىيىدە	jˌɑponɪjˈɪdæ
مايسا	mˈɑjsɑ
ئىلگىرى	ɪlɡˈɪɾɪ
تۈزلەڭلىك	tyzlˈæŋlɪk
يەرگە	jˈærɡæ
جۇڭگوغا	d͡ʒuŋɡˈoʁɑ
زىمىنى	zɪmˈɪnɪ
ھۆكۈمرانلىق	hˌœkymrˈɑnlɪq
سىياسىتىنىڭ	sˌɪjɑsɪtˈɪnɪŋ
كۆرسىتىلگەن	kˌœrsɪtˈɪlɡæn
يارىتىپ	jɑɾˈɪtɪp
تەشۋىقات	tæʃwˈɪqɑt
ئانام	ˈɑnɑm
بۇيىچە	bujˈɪt͡ʃæ
ئورگىنىنىڭ	ˌorɡɪnˈɪnɪŋ
ئورۇندا	oɾˈundɑ
شارائىتتا	ʃˌɑɾɑˈɪttɑ
كىلىدۇ	kɪlˈɪdu
ئوغلىنى	oʁlˈɪnɪ
پاختا	pˈɑχtɑ
قەدىمدىن	qædˈɪmdɪn
قىلىندى	qɪlˈɪndɪ
ئەشمە	ˈæʃmæ
دائىرىدە	dˌɑɪɾˈɪdæ
ئاستىدا	ɑstˈɪdɑ
رايوندا	rɑjˈondɑ
نەرسىنىڭ	nærsˈɪnɪŋ
خاتىرە	χɑtˈɪɾæ
تىلەيمىز	tɪlˈæjmɪz
قىلىنىشقا	qˌɪlɪnˈɪʃqɑ
نېمىگە	nemˈɪɡæ
قىلاتتى	qɪlˈɑttɪ
ئۇنىڭدىكى	ˌunɪŋdˈɪkɪ
جايدىكى	d͡ʒɑjdˈɪkɪ
قىلغۇچ	qˈɪlʁut͡ʃ
سازاۋەر	sɑzˈɑwær
كۈنگە	kˈynɡæ
شىمالدىن	ʃɪmˈɑldɪn
بىلىدىغان	bˌɪlɪdˈɪʁɑn
تۈركىيەنىڭ	tˌyrkɪjˈænɪŋ
ئىجادىيەت	ˌɪd͡ʒɑdˈɪjæt
فرانسۇز	frˈɑnsuz
بىرى	bˈɪɾɪ
قىممىتىنى	qˌɪmmɪtˈɪnɪ
ئاسانلا	ɑsˈɑnlɑ
گېزىت	ɡˈezɪt
دەۋرنىڭ	dˈæwrnɪŋ
مەزگىل	mˈæzɡɪl
ساقلانغان	sɑqlˈɑnʁɑn
تىرىشچانلىق	tˌɪɾɪʃt͡ʃˈɑnlɪq
سەمىمىي	sæmˈɪmɪj
مەقسىتىدە	mˌæqsɪtˈɪdæ
تارقىلىش	tɑrqˈɪlɪʃ
فوند	fˈond
ئالدى	ˈɑldɪ
كەڭ	kˈæŋ
مەقسىتى	mæqsˈɪtɪ
بىزدىكى	bɪzdˈɪkɪ
چىراغ	t͡ʃˈɪɾɑʁ
بىن	bˈɪn
يېغىن	jˈeʁɪn
ھېس	hˈes
ئۈستىدە	ystˈɪdæ
مەركىزىي	mærkˈɪzɪj
قالغان	qˈɑlʁɑn
پادىشاھى	pˌɑdɪʃˈɑhɪ
سىناپ	sˈɪnɑp
ئېرىشكەن	eɾˈɪʃkæn
بېسىپ	bˈesɪp
سۆزلەرگە	sœzlˈærɡæ
ماتېماتىكا	mˌɑtemɑtˈɪkɑ
بارىدىغان	bˌɑɾɪdˈɪʁɑn
ھىجرىيە	hɪd͡ʒrˈɪjæ
كىرىشكە	kɪɾˈɪʃkæ
قالغانلىرى	qˌɑlʁɑnlˈɪɾɪ
ئارقا	ˈɑrqɑ
تەشكىلىي	tæʃkˈɪlɪj
بەكمۇ	bˈækmu
كەچۈرگەن	kæt͡ʃˈyrɡæn
سالىدۇ	sɑlˈɪdu
ئىكەنلىكى	ˌɪkænlˈɪkɪ
شەكلىدىكى	ʃˌæklɪdˈɪkɪ
ئانىسىغا	ˌɑnɪsˈɪʁɑ
ھاجىم	hˈɑd͡ʒɪm
نەتىجىدە	nˌætɪd͡ʒˈɪdæ
يۇيۇش	jˈujuʃ
ناماز	nˈɑmɑz
توسقۇنلۇق	tosqˈunluq
قاتارلىق	qɑtˈɑrlɪq
مەكتىپىگە	mˌæktɪpˈɪɡæ
زىكىر	zˈɪkɪr
پۇت	pˈut
تەشكىلاتلارنىڭ	tˌæʃkɪlɑtlˈɑrnɪŋ
مۇناسىۋىتى	mˌunɑsɪwˈɪtɪ
يېزىنىڭ	jezˈɪnɪŋ
كىشىلەر	kɪʃˈɪlær
تاتار	tˈɑtɑr
چاغدا	t͡ʃˈɑʁdɑ
ئاپتونومىيە	ˌɑptonomˈɪjæ
ئۈرۈمچىدە	ˌyɾymt͡ʃˈɪdæ
پىشقان	pˈɪʃqɑn
تۈركۈم	tˈyrkym
ياۋروپانىڭ	jˌɑwropˈɑnɪŋ
ھۆل	hˈœl
كارخانا	kɑrχˈɑnɑ
بىرلا	bˈɪrlɑ
سوزۇلغان	sozˈulʁɑn
بۆلۈنۈپ	bœlˈynyp
بارا	bˈɑɾɑ
يېشىل	jˈeʃɪl
ياشلارنىڭ	jɑʃlˈɑrnɪŋ
قازانغان	qɑzˈɑnʁɑn
ئىتتىپاق	ɪttˈɪpɑq
چاقىردى	t͡ʃɑqˈɪrdɪ
مەندە	mˈændæ
تۇغما	tˈuʁmɑ
ماشىنا	mɑʃˈɪnɑ
داۋالاش	dɑwˈɑlɑʃ
ئوتاق	ˈotɑq
قاماق	qˈɑmɑq
ئالىملىرى	ˌɑlɪmlˈɪɾɪ
تەنلىك	tˈænlɪk
كەينىدىن	kæjnˈɪdɪn
دېگەن	dˈeɡæn
شەرەپ	ʃˈæɾæp
كىرىش	kˈɪɾɪʃ
دېڭىز	dˈeŋɪz
ئانا	ˈɑnɑ
قىلىشنى	qɪlˈɪʃnɪ
يەرشارى	jærʃˈɑɾɪ
جەھەتتىمۇ	d͡ʒˌæhættˈɪmu
يالىڭاچ	jɑlˈɪŋɑt͡ʃ
ئۇيغۇرچە	ujʁˈurt͡ʃæ
ئۆتىدۇ	œtˈɪdu
يىراق	jˈɪɾɑq
قىلىۋاتىدۇ	qˌɪlɪwɑtˈɪdu
كەسپىي	kˈæspɪj
پۇل	pˈul
رەھبەرلىكىدىكى	rˌæhbærlˌɪkɪdˈɪkɪ
شېئىرى	ʃeˈɪɾɪ
قورۇقچىبەگ	qˌoɾuqt͡ʃˈɪbæɡ
يەڭگەن	jˈæŋɡæn
قىزىق	qˈɪzɪq
ساقلىنىپ	sɑqlˈɪnɪp
تەمى	tˈæmɪ
ئىشلىتىلگەن	ˌɪʃlɪtˈɪlɡæn
بارلىقىنى	bˌɑrlɪqˈɪnɪ
ئالىي	ˈɑlɪj
مۇمكىن	mˈumkɪn
كەلگەنلىكى	kˌælɡænlˈɪkɪ
سۇرە	sˈuɾæ
ئۆزىدىن	œzˈɪdɪn
سۆيۈملۈك	sœjˈymlyk
ئىستەك	ˈɪstæk
سەپەرگە	sæpˈærɡæ
كەسپىدە	kæspˈɪdæ
يېزىدا	jezˈɪdɑ
گېرمانىيە	ɡˌermɑnˈɪjæ
غەربكە	ʁˈærbkæ
سىياسىتى	sˌɪjɑsˈɪtɪ
ئېلىندى	elˈɪndɪ
ئەلئەنسارىي	ˌælænsˈɑɾɪj
دۇر	dˈur
كۆرىسىز	kœɾˈɪsɪz
توغرىلىق	toʁrˈɪlɪq
كەسپ	kˈæsp
دۆلەتنىڭ	dœlˈætnɪŋ
بۇلىدۇ	bulˈɪdu
مەسئۇلىيەت	mˌæsulˈɪjæt
تەرەپنى	tæɾˈæpnɪ
يەنە	jˈænæ
مەپتۇن	mˈæptun
ئەسەرلىرىنى	ˌæsærlɪɾˈɪnɪ
كەنت	kˈænt
ھازىرغىچە	hˌɑzɪrʁˈɪt͡ʃæ
ناھىيىسىدە	nˌɑhɪjɪsˈɪdæ
ياۋايى	jɑwˈɑjɪ
قەشقەردىكى	qˌæʃqærdˈɪkɪ
يۆنىلىشى	jˌœnɪlˈɪʃɪ
ئۇيغۇرلارنى	ˌujʁurlˈɑrnɪ
ئۆگەنگەن	œɡˈænɡæn
ئۇيغۇرلاردا	ˌujʁurlˈɑrdɑ
چىقىرىدۇ	t͡ʃˌɪqɪɾˈɪdu
ئايەت	ˈɑjæt
تۆھپىسى	tœhpˈɪsɪ
دادىسى	dɑdˈɪsɪ
سۇلتان	sˈultɑn
مو	mˈo
جاۋاب	d͡ʒˈɑwɑb
ۋەقەلەرنى	wˌæqælˈærnɪ
ر	r
بولغۇچى	bolʁˈut͡ʃɪ
تارقىلىپ	tɑrqˈɪlɪp
بىلگە	bˈɪlɡæ
شىنجاڭ	ʃˈɪnd͡ʒɑŋ
ئۇقۇم	ˈuqum
خىزمەتلەرنى	χˌɪzmætlˈærnɪ
تۆۋەندە	tœwˈændæ
د	d
ئارىسىدىن	ˌɑɾɪsˈɪdɪn
ماھىيەتتە	mˌɑhɪjˈættæ
ئوراپ	ˈoɾɑp
ئىنسانغا	ɪnsˈɑnʁɑ
دەل	dˈæl
ھاۋالە	hɑwˈɑlæ
ئومۇمەن	omˈumæn
ياشلارغا	jɑʃlˈɑrʁɑ
روھنى	rˈohnɪ
بىلىملىك	bɪlˈɪmlɪk
سۇتۇق	sˈutuq
مال	mˈɑl
سىياسى	sɪjˈɑsɪ
شېئىر	ʃˈeɪr
تەكرار	tˈækrɑr
بويۇن	bˈojun
ئوخشاپ	ˈoχʃɑp
زامانىدا	zˌɑmɑnˈɪdɑ
شۇنداقلا	ʃundˈɑqlɑ
ئىشەنچلىك	ɪʃˈænt͡ʃlɪk
كاپالەتكە	kˌɑpɑlˈætkæ
ئاڭلىغان	ɑŋlˈɪʁɑn
نۇقتىغا	nuqtˈɪʁɑ
يوغان	jˈoʁɑn
كىشىدىن	kɪʃˈɪdɪn
قوغداش	qˈoʁdɑʃ
ياد	jˈɑd
خرىستىئان	χrɪstˈɪɑn
ئاياغ	ˈɑjɑʁ
مىنىستىرى	mˌɪnɪstˈɪɾɪ
سانائىتى	sˌɑnɑˈɪtɪ
تىلدا	tˈɪldɑ
قازى	qˈɑzɪ
ۋەكىللىك	wækˈɪllɪk
تېما	tˈemɑ
ۋىلايىتىنىڭ	wˌɪlɑjɪtˈɪnɪŋ
بىلمەيدۇ	bɪlmˈæjdu
ناھايتى	nɑhˈɑjtɪ
ۋاقتى	wˈɑqtɪ
جاھان	d͡ʒˈɑhɑn
تەۋەلىكىدە	tˌæwælɪkˈɪdæ
تاۋۇش	tˈɑwuʃ
نۇرغۇن	nˈurʁun
ئىرادىسى	ˌɪɾɑdˈɪsɪ
يەل	jˈæl
ئىمىن	ˈɪmɪn
ئاساسىغا	ˌɑsɑsˈɪʁɑ
پايتەخت	pˈɑjtæχt
تارقىلىشى	tˌɑrqɪlˈɪʃɪ
ئەلچىسى	ælt͡ʃˈɪsɪ
دىنىغا	dɪnˈɪʁɑ
ئىشلىتىلىدۇ	ˌɪʃlɪtɪlˈɪdu
چۈشۈش	t͡ʃˈyʃyʃ
قىزىمنىڭ	qɪzˈɪmnɪŋ
دەرىجىگە	dˌæɾɪd͡ʒˈɪɡæ
ئەھمىيەتلىك	ˌæhmɪjˈætlɪk
ئەسىرىدە	ˌæsɪɾˈɪdæ
مۇبارەك	mubˈɑɾæk
ئېيى	ˈejɪ
قىزنىڭ	qˈɪznɪŋ
چالا	t͡ʃˈɑlɑ
ئوبيېكتىپ	objˈektɪp
چەتئەلگە	t͡ʃætˈælɡæ
بولۇشىغا	bˌoluʃˈɪʁɑ
توننا	tˈonnɑ
تاشيول	tˈɑʃjol
ئۇمۇ	ˈumu
يۈرگەن	jˈyrɡæn
دىئامېتىرى	dˌɪɑmetˈɪɾɪ
يۇنان	jˈunɑn
ئۇلارغا	ulˈɑrʁɑ
ۋاقىتتا	wɑqˈɪttɑ
ئىبارەتتۇر	ˌɪbɑɾˈættur
تەپسىلىي	tæpsˈɪlɪj
ئالغا	ˈɑlʁɑ
بىزنى	bˈɪznɪ
بالدۇر	bˈɑldur
دەرىجىلىك	dˌæɾɪd͡ʒˈɪlɪk
دۆلەتلەرنىڭ	dˌœlætlˈærnɪŋ
داۋاملىشىپ	dˌɑwɑmlˈɪʃɪp
پايتاھتى	pɑjtˈɑhtɪ
بارلىق	bˈɑrlɪq
قىلماقتا	qɪlmˈɑqtɑ
تىنچ	tˈɪnt͡ʃ
تاپتى	tˈɑptɪ
ئوقۇتقۇچىسى	ˌoqutqut͡ʃˈɪsɪ
سۇڭپىياز	suŋpˈɪjɑz
دەرس	dˈærs
يۈزىنىڭ	jyzˈɪnɪŋ
نىسبەتەن	nɪsbˈætæn
شەكىلدىكى	ʃˌækɪldˈɪkɪ
قوشنا	qˈoʃnɑ
ئەزەلدىن	æzˈældɪn
بۇزۇلۇپ	buzˈulup
قاراقاش	qɑɾˈɑqɑʃ
خىش	χˈɪʃ
كەسىپنى	kæsˈɪpnɪ
پادىشاھلىقى	pˌɑdɪʃɑhlˈɪqɪ
ماددىسىدىكى	mˌɑddɪsɪdˈɪkɪ
يىرىك	jˈɪɾɪk
قۇرۇلتىيى	qˌuɾultˈɪjɪ
نەرسىلەرنى	nˌærsɪlˈærnɪ
ساما	sˈɑmɑ
قويۇلىدۇ	qˌojulˈɪdu
ساھەدە	sɑhˈædæ
راھەت	rˈɑhæt
شەرىئەت	ʃæɾˈɪæt
يۈزىنى	jyzˈɪnɪ
كۆڭلىگە	kœŋlˈɪɡæ
ئابباس	ˈɑbbɑs
ئېلېكتر	ˈelektr
قىلىشتا	qɪlˈɪʃtɑ
ماڭدى	mˈɑŋdɪ
ماتېماتىكىلىق	mˌɑtemˌɑtɪkˈɪlɪq
مىللەتلەردىن	mˌɪllætlˈærdɪn
تۈزۈمى	tyzˈymɪ
قالمايدۇ	qɑlmˈɑjdu
چىقىش	t͡ʃˈɪqɪʃ
ھىس	hˈɪs
نىمىشقا	nɪmˈɪʃqɑ
ئىنىق	ˈɪnɪq
ئوقۇشى	oqˈuʃɪ
سېلىشتۇرما	sˌelɪʃtˈurmɑ
ئابدۇراخمان	ˌɑbduɾˈɑχmɑn
خەۋەرلىشىش	χˌæwærlˈɪʃɪʃ
چىشى	t͡ʃˈɪʃɪ
ئۇسۇللار	usˈullɑr
ھالىتى	hɑlˈɪtɪ
جۇغراپىيىلىك	d͡ʒˌuʁrɑpɪjˈɪlɪk
قىسمىنى	qɪsmˈɪnɪ
ئۇيغۇردىن	ujʁˈurdɪn
ئاخبارات	ɑχbˈɑɾɑt
ئىزھار	ˈɪzhɑr
ئويۇننى	ojˈunnɪ
ئېرىشىش	eɾˈɪʃɪʃ
ئەسلىي	ˈæslɪj
بىرلىشىپ	bɪrlˈɪʃɪp
خۇشال	χˈuʃɑl
ئافرىقا	ɑfrˈɪqɑ
قىرغىنچىلىق	qˌɪrʁɪnt͡ʃˈɪlɪq
مۇھەببىتى	mˌuhæbbˈɪtɪ
تەھسىل	tˈæhsɪl
باشلىنىدۇ	bˌɑʃlɪnˈɪdu
ئىلغار	ˈɪlʁɑr
ماھىر	mˈɑhɪr
ئۈستىدىكى	ˌystɪdˈɪkɪ
قەلەم	qˈælæm
بەدەندىكى	bˌædændˈɪkɪ
يازغۇچى	jɑzʁˈut͡ʃɪ
سامسۇڭ	sˈɑmsuŋ
ئەستايىدىل	ˌæstɑjˈɪdɪl
بولمىسۇن	bolmˈɪsun
بولمىغان	bolmˈɪʁɑn
ئىپادە	ɪpˈɑdæ
شەكىل	ʃˈækɪl
بەيئەت	bˈæjæt
يەنىلا	jænˈɪlɑ
بىخەتەر	bɪχˈætær
ئەللىرى	ællˈɪɾɪ
تېرىسى	teɾˈɪsɪ
بىرىنجى	bɪɾˈɪnd͡ʒɪ
ئۈندەيدۇ	yndˈæjdu
نوپۇس	nˈopus
كۆزىنى	kœzˈɪnɪ
تارىخىنى	tˌɑɾɪχˈɪnɪ
ۋاقىتلاردا	wˌɑqɪtlˈɑrdɑ
مەقسەتلىك	mæqsˈætlɪk
ئۆمۈر	ˈœmyr
دائىرىسىدە	dˌɑɪɾɪsˈɪdæ
سادىق	sˈɑdɪq
دۆلەتكە	dœlˈætkæ
ئىشلىتىپ	ɪʃlˈɪtɪp
ئوقۇغان	oqˈuʁɑn
تۇرسا	tˈursɑ
قانات	qˈɑnɑt
تۇتۇش	tˈutuʃ
كەينى	kˈæjnɪ
تۆۋەندىكىچە	tˌœwændɪkˈɪt͡ʃæ
سىستېما	sɪstˈemɑ
كاۋاۋىچىن	kˌɑwɑwˈɪt͡ʃɪn
شەھىرىگە	ʃˌæhɪɾˈɪɡæ
ئورمان	ˈormɑn
ئىنساننى	ɪnsˈɑnnɪ
تۇز	tˈuz
چىقىرىش	t͡ʃɪqˈɪɾɪʃ
كاربون	kˈɑrbon
بەرگەن	bˈærɡæn
ۋاز	wˈɑz
ئەنئەنىۋى	ˌænænˈɪwɪ
كىشىلەردىن	kˌɪʃɪlˈærdɪn
بىرىنچىسى	bˌɪɾɪnt͡ʃˈɪsɪ
جەريان	d͡ʒˈærjɑn
خوتۇنى	χotˈunɪ
ئەكىس	ˈækɪs
سانلىق	sˈɑnlɪq
سېلىشتۇرۇپ	sˌelɪʃtˈuɾup
ئۆزبېكىستان	ˌœzbekˈɪstɑn
ئورنىدا	ornˈɪdɑ
پەيدا	pˈæjdɑ
قېتىم	qˈetɪm
ئوتتۇرىغا	ˌottuɾˈɪʁɑ
پالۋان	pˈɑlwɑn
سىزدىن	sˈɪzdɪn
زامانىۋىي	zˌɑmɑnˈɪwɪj
بالىلىق	bɑlˈɪlɪq
كەلگەندە	kælɡˈændæ
ئويلىنىپ	ojlˈɪnɪp
ئوينايدىغان	ˌojnɑjdˈɪʁɑn
بەدىنىدە	bˌædɪnˈɪdæ
دەپتۇ	dˈæptu
قويۇپ	qˈojup
يەنى	jˈænɪ
ئۇلاردا	ulˈɑrdɑ
بانان	bˈɑnɑn
تەسىس	tˈæsɪs
بۇغراخان	buʁrˈɑχɑn
تەخسە	tˈæχsæ
ياشاش	jˈɑʃɑʃ
جەنۇبقا	d͡ʒænˈubqɑ
ئاچقان	ˈɑt͡ʃqɑn
تۇغۇلۇپ	tuʁˈulup
كەسىپكە	kæsˈɪpkæ
ھۆكۈم	hˈœkym
ئەكسىچە	æksˈɪt͡ʃæ
ئىسلاھات	ɪslˈɑhɑt
ئىپتىدائىي	ˌɪptɪdˈɑɪj
مەسىلىنىڭ	mˌæsɪlˈɪnɪŋ
بالىلار	bɑlˈɪlɑr
ماقالىنى	mˌɑqɑlˈɪnɪ
ئىشلارنى	ɪʃlˈɑrnɪ
ئالاقە	ɑlˈɑqæ
تۇرسۇن	tˈursun
دېيىلىدۇ	dˌejɪlˈɪdu
يېزىقى	jezˈɪqɪ
ئۆتىگەن	œtˈɪɡæn
خىتايلار	χɪtˈɑjlɑr
زامانىۋى	zˌɑmɑnˈɪwɪ
ھەقىقەتەنمۇ	hˌæqɪqætˈænmu
جىسىمنىڭ	d͡ʒɪsˈɪmnɪŋ
زاۋۇت	zˈɑwut
كىلاسسىك	kɪlˈɑssɪk
مالىيە	mɑlˈɪjæ
تىلنى	tˈɪlnɪ
چۈشەنگەن	t͡ʃyʃˈænɡæn
قىلىشنىڭ	qɪlˈɪʃnɪŋ
قارشى	qˈɑrʃɪ
ئۆزگەرتىش	œzɡˈærtɪʃ
ھەدىسلەرنىڭ	hˌædɪslˈærnɪŋ
يامان	jˈɑmɑn
ئائىلىسى	ˌɑɪlˈɪsɪ
گۇناھ	ɡˈunɑh
بايراق	bˈɑjrɑq
سەئۇدى	sæˈudɪ
قىلدى	qˈɪldɪ
ھەپتىدە	hæptˈɪdæ
ئورۇن	ˈoɾun
ھەممىمىزگە	hˌæmmɪmˈɪzɡæ
بولۇشتەك	bolˈuʃtæk
ياشلىق	jˈɑʃlɪq
ۋۇجۇتقا	wud͡ʒˈutqɑ
ئۈنۈملۈك	ynˈymlyk
تىلىدىن	tɪlˈɪdɪn
قىزىم	qˈɪzɪm
رادىئو	rɑdˈɪo
خەلقئارا	χælqˈɑɾɑ
ئاشىدۇ	ɑʃˈɪdu
مەنىسىدە	mˌænɪsˈɪdæ
كۆرسەتتى	kœrsˈættɪ
دىنىي	dˈɪnɪj
ھەم	hˈæm
مۇناسىۋەتنى	mˌunɑsɪwˈætnɪ
تەھرىر	tˈæhrɪr
سەۋەپلىك	sæwˈæplɪk
ھەرخىل	hˈærχɪl
غەربى	ʁˈærbɪ
كەچۈرۈم	kæt͡ʃˈyɾym
ئىشلىگەن	ɪʃlˈɪɡæn
سوزۇق	sˈozuq
قەدەر	qˈædær
پائالىيەتلىرىنى	pˌɑɑlˌɪjætlɪɾˈɪnɪ
چىقىرىدىغان	t͡ʃˌɪqɪɾɪdˈɪʁɑn
ھەرگىز	hˈærɡɪz
سەككىز	sˈækkɪz
مۇددىتى	muddˈɪtɪ
ئىچكىرىدىكى	ˌɪt͡ʃkɪɾɪdˈɪkɪ
غۇلجىدا	ʁuld͡ʒˈɪdɑ
رەڭگى	rˈæŋɡɪ
پەيلاسوپ	pæjlˈɑsop
باشقىچە	bɑʃqˈɪt͡ʃæ
كەپتۇ	kˈæptu
يېرىدىن	jeɾˈɪdɪn
دىلمۇرات	dɪlmˈuɾɑt
مارشى	mˈɑrʃɪ
ئالىدىغان	ˌɑlɪdˈɪʁɑn
ئۆلگەندىن	œlɡˈændɪn
خالىغان	χɑlˈɪʁɑn
تەخمىنەن	tæχmˈɪnæn
يازغۇچىلىرى	jˌɑzʁut͡ʃɪlˈɪɾɪ
قۇرئاننى	quɾˈɑnnɪ
تۇرمۇشىنى	tˌurmuʃˈɪnɪ
دېھقانلار	dehqˈɑnlɑr
ئوخشاشمىغان	ˌoχʃɑʃmˈɪʁɑn
نەتىجىسىنى	nˌætɪd͡ʒɪsˈɪnɪ
پۈتۈن	pˈytyn
ئەسىرگە	æsˈɪrɡæ
سەۋەپ	sˈæwæp
ئېنېرگىيە	ˌenerɡˈɪjæ
خىمىيىلىك	χˌɪmɪjˈɪlɪk
تەكلىپى	tæklˈɪpɪ
روياپقا	rojˈɑpqɑ
دانە	dˈɑnæ
لىكىن	lˈɪkɪn
ئەسەرنى	æsˈærnɪ
مەدەت	mˈædæt
غەيرىي	ʁˈæjrɪj
ئىگە	ˈɪɡæ
سوۋېت	sˈowet
مەھكۇم	mˈæhkum
سايلام	sˈɑjlɑm
ئىشنى	ˈɪʃnɪ
ئۆلتۈرىۋېلىش	ˌœltyɾɪwˈelɪʃ
كۇۋادىرات	kˌuwɑdˈɪɾɑt
ئون	ˈon
ماۋ	mˈɑw
بىۋاسىتە	bˌɪwɑsˈɪtæ
تەتقىقاتىغا	tˌætqɪqɑtˈɪʁɑ
باھا	bˈɑhɑ
پەسلىدە	pæslˈɪdæ
قىلىنىشى	qˌɪlɪnˈɪʃɪ
رەڭلىك	rˈæŋlɪk
شەيخ	ʃˈæjχ
قالىدىغان	qˌɑlɪdˈɪʁɑn
ئىنسانلارغا	ˌɪnsɑnlˈɑrʁɑ
تەربىيە	tærbˈɪjæ
بۇنىڭغا	bunˈɪŋʁɑ
تارىخىدىكى	tˌɑɾɪχɪdˈɪkɪ
خۇسۇسىيىتىگە	χˌususˌɪjɪtˈɪɡæ
زۆرۈر	zˈœɾyr
ئەھۋالنى	æhwˈɑlnɪ
بۈيۈك	bˈyjyk
ئۆگىنىش	œɡˈɪnɪʃ
تەۋەلىك	tæwˈælɪk
تەربىيىلەش	tˌærbɪjˈɪlæʃ
شام	ʃˈɑm
ھىساپلىنىدۇ	hˌɪsɑplɪnˈɪdu
ۋالىي	wˈɑlɪj
بەرمىگەن	bærmˈɪɡæn
ئىبراھىم	ɪbrˈɑhɪm
ئوقۇغۇچىلار	ˌoquʁut͡ʃˈɪlɑr
ئەھۋاللار	æhwˈɑllɑr
قۇللۇق	qˈulluq
قىسىم	qˈɪsɪm
ھازىرقى	hɑzˈɪrqɪ
دۇنيادا	dunjˈɑdɑ
سەھىھ	sˈæhɪh
باشقىلارنى	bˌɑʃqɪlˈɑrnɪ
توختاپ	tˈoχtɑp
ئۆلۈپ	ˈœlyp
بالىنى	bɑlˈɪnɪ
ئېتىقاد	etˈɪqɑd
توختىلىپ	toχtˈɪlɪp
مەلۇماتقا	mˌælumˈɑtqɑ
تاماملىغان	tˌɑmɑmlˈɪʁɑn
شەرت	ʃˈært
ئىجادىيىتى	ˌɪd͡ʒɑdɪjˈɪtɪ
خېلى	χˈelɪ
بىلدۈرىدۇ	bˌɪldyɾˈɪdu
ئاتىلىدىغان	ˌɑtɪlɪdˈɪʁɑn
يولنى	jˈolnɪ
قىلىنىدۇ	qˌɪlɪnˈɪdu
ئۇرۇشى	uɾˈuʃɪ
بۇلۇت	bˈulut
شىركىتى	ʃɪrkˈɪtɪ
فىرانسىيە	fˌɪɾɑnsˈɪjæ
ماددىلارنى	mˌɑddɪlˈɑrnɪ
يەھۇدىلار	jˌæhudˈɪlɑr
بېقىش	bˈeqɪʃ
بوستانلىق	bostˈɑnlɪq
خىلى	χˈɪlɪ
ئانىسىنىڭ	ˌɑnɪsˈɪnɪŋ
سىزگە	sˈɪzɡæ
ئولتۇراقلاشقان	ˌoltuɾɑqlˈɑʃqɑn
ئوقۇيدىغان	ˌoqujdˈɪʁɑn
جىنسىي	d͡ʒˈɪnsɪj
ئېقىپ	ˈeqɪp
خاننىڭ	χˈɑnnɪŋ
مەنئى	mˈænɪ
مۇرەسسە	muɾˈæssæ
قۇر	qˈur
قاتارلىقلارنى	qˌɑtɑrlɪqlˈɑrnɪ
ھوقۇقلۇق	hoqˈuqluq
يىلىغىچە	jˌɪlɪʁˈɪt͡ʃæ
قىلىدىغان	qˌɪlɪdˈɪʁɑn
ئۆزىنى	œzˈɪnɪ
روھ	rˈoh
مەھسۇلاتى	mˌæhsulˈɑtɪ
ھاسىل	hˈɑsɪl
بايان	bˈɑjɑn
بولۇشنى	bolˈuʃnɪ
بولدۇم	bˈoldum
خىتاب	χˈɪtɑb
مۇستاككىل	mustˈɑkkɪl
بوغۇم	bˈoʁum
ھېسابات	hesˈɑbɑt
ئوڭ	ˈoŋ
ئاسسىمىلياتسىيە	ˌɑssɪmˌɪljɑtsˈɪjæ
كېڭەش	kˈeŋæʃ
تۈركىي	tˈyrkɪj
سۆزلەنگەن	sœzlˈænɡæn
ھۈنەر	hˈynær
ياغ	jˈɑʁ
خاتىمە	χɑtˈɪmæ
پادىشاھ	pɑdˈɪʃɑh
قېرى	qˈeɾɪ
قارايمەن	qɑɾˈɑjmæn
تالانتى	tɑlˈɑntɪ
ئانىلار	ɑnˈɪlɑr
ئۆلچەم	ˈœlt͡ʃæm
ۋاقىتتىكى	wˌɑqɪttˈɪkɪ
چىقىرىشى	t͡ʃˌɪqɪɾˈɪʃɪ
ھادىسە	hɑdˈɪsæ
جىسمانىي	d͡ʒɪsmˈɑnɪj
ئۇيغۇن	ˈujʁun
گىرىپتار	ɡɪɾˈɪptɑr
ئارقىسىدا	ˌɑrqɪsˈɪdɑ
مەنىگە	mænˈɪɡæ
دەرىجىسى	dˌæɾɪd͡ʒˈɪsɪ
ئوقۇغۇچىنىڭ	ˌoquʁut͡ʃˈɪnɪŋ
ئۇچرايدۇ	ut͡ʃrˈɑjdu
بېگى	bˈeɡɪ
ئاندىن	ˈɑndɪn
جىن	d͡ʒˈɪn
بېيجىڭغا	bejd͡ʒˈɪŋʁɑ
ئىشغال	ˈɪʃʁɑl
تەركىبى	tærkˈɪbɪ
مۇقەددەس	muqˈæddæs
پىشۇرۇلىدۇ	pˌɪʃuɾulˈɪdu
تومۇر	tˈomur
ئاتالدى	ɑtˈɑldɪ
ئاتاقلىق	ɑtˈɑqlɪq
يارقىن	jˈɑrqɪn
تەلىپى	tælˈɪpɪ
شەكىللەندۈرگەن	ʃˌækɪllændˈyrɡæn
ئىدارىسى	ˌɪdɑɾˈɪsɪ
ماقالىدا	mˌɑqɑlˈɪdɑ
مەيداندا	mæjdˈɑndɑ
تەڭ	tˈæŋ
ئېغىرلىقى	ˌeʁɪrlˈɪqɪ
ئۆچ	ˈœt͡ʃ
تەمىنلىگەن	tˌæmɪnlˈɪɡæn
كېسىپ	kˈesɪp
ئۇچار	ˈut͡ʃɑr
رەھبەرلىك	ræhbˈærlɪk
پۇلى	pˈulɪ
رەھبىرى	ræhbˈɪɾɪ
قىلىمىز	qɪlˈɪmɪz
سەن	sˈæn
ئاممىۋىي	ɑmmˈɪwɪj
قاراشلىرى	qˌɑɾɑʃlˈɪɾɪ
رەزىيەللاھۇ	rˌæzɪjællˈɑhu
رېمونت	rˈemont
قىممەتكە	qɪmmˈætkæ
چارىسىنى	t͡ʃˌɑɾɪsˈɪnɪ
جايلارنىڭ	d͡ʒɑjlˈɑrnɪŋ
خان	χˈɑn
شەخسلەردىن	ʃæχslˈærdɪn
قاراش	qˈɑɾɑʃ
ئارىق	ˈɑɾɪq
ئىجتىمائى	ˌɪd͡ʒtɪmˈɑɪ
ئات	ˈɑt
ئىسلام	ˈɪslɑm
تىپلىق	tˈɪplɪq
قىلىشتىن	qɪlˈɪʃtɪn
خەلقنىڭ	χˈælqnɪŋ
ھەرگىزمۇ	hærɡˈɪzmu
يوللۇق	jˈolluq
قىلالمايدۇ	qˌɪlɑlmˈɑjdu
ئاستا	ˈɑstɑ
بىلىشى	bɪlˈɪʃɪ
دەسلەپتە	dæslˈæptæ
ياپونلۇق	jɑpˈonluq
ئەسلىگە	æslˈɪɡæ
دالا	dˈɑlɑ
ئۇرۇشىدىن	ˌuɾuʃˈɪdɪn
بېرەي	bˈeɾæj
بىنا	bˈɪnɑ
پۈتتۈرگەندىن	pˌyttyrɡˈændɪn
قىلسا	qˈɪlsɑ
مەدەنىي	mædˈænɪj
سۆيگۈ	sˈœjɡy
مۇئاۋىن	muˈɑwɪn
ئەھمەد	ˈæhmæd
سوئالغا	soˈɑlʁɑ
تۇرۇپ	tˈuɾup
ھاياتقا	hɑjˈɑtqɑ
گۈزەل	ɡˈyzæl
خەتنى	χˈætnɪ
لىق	lˈɪq
ئەخلەت	ˈæχlæt
پۇرسىتى	pursˈɪtɪ
ئېلېكترونلۇق	ˌelektrˈonluq
پوزىتسىيە	pˌozɪtsˈɪjæ
ئىشى	ˈɪʃɪ
سورۇندا	soɾˈundɑ
ئويناش	ˈojnɑʃ
قېرىندىشى	qˌeɾɪndˈɪʃɪ
چىقىشىغا	t͡ʃˌɪqɪʃˈɪʁɑ
ئۆلچەش	ˈœlt͡ʃæʃ
بولالايدۇ	bˌolɑlˈɑjdu
ۋاقىت	wˈɑqɪt
ئىلى	ˈɪlɪ
مەدەنىيىتىنىڭ	mˌædænˌɪjɪtˈɪnɪŋ
ۋاستىسى	wɑstˈɪsɪ
ساھابىلەر	sˌɑhɑbˈɪlær
مەسئۇل	mˈæsul
زامانىسىدا	zˌɑmɑnɪsˈɪdɑ
توپا	tˈopɑ
دورا	dˈoɾɑ
ئوقۇۋاتقان	ˌoquwˈɑtqɑn
جەھەتتىكى	d͡ʒˌæhættˈɪkɪ
جانلىقلار	d͡ʒɑnlˈɪqlɑr
ئۆينى	ˈœjnɪ
تۈرلىرى	tyrlˈɪɾɪ
ئەسلىدە	æslˈɪdæ
ھەققىدە	hæqqˈɪdæ
بەكرى	bˈækrɪ
چوڭقۇر	t͡ʃˈoŋqur
قاراشلىق	qɑɾˈɑʃlɪq
قانۇنىي	qɑnˈunɪj
ھەممىسىنىڭ	hˌæmmɪsˈɪnɪŋ
تەرەپنىڭ	tæɾˈæpnɪŋ
ئۇل	ˈul
ئۈرۈمچىگە	ˌyɾymt͡ʃˈɪɡæ
سۇلالىسىنىڭ	sˌulɑlɪsˈɪnɪŋ
كۈچەپ	kˈyt͡ʃæp
روزا	rˈozɑ
ھازىرمۇ	hɑzˈɪrmu
خىمىيە	χɪmˈɪjæ
قاتارىغا	qˌɑtɑɾˈɪʁɑ
توملۇق	tˈomluq
مۇداپىئە	mˌudɑpˈɪæ
يەكشەنبە	jækʃˈænbæ
تەسىرىدىن	tˌæsɪɾˈɪdɪn
قۇياش	qˈujɑʃ
قالتىس	qˈɑltɪs
قانۇندا	qɑnˈundɑ
سىنىپ	sˈɪnɪp
ئەۋج	ˈæwd͡ʒ
قەدەم	qˈædæm
ئايرىلغان	ɑjrˈɪlʁɑn
ۋەيران	wˈæjrɑn
ھازىرغا	hɑzˈɪrʁɑ
قىلىنىش	qɪlˈɪnɪʃ
مەنىسىنى	mˌænɪsˈɪnɪ
قالماستىن	qɑlmˈɑstɪn
ئاۋازىنى	ˌɑwɑzˈɪnɪ
خىزمىتىگە	χˌɪzmɪtˈɪɡæ
خىلاپ	χˈɪlɑp
مەڭگۈلۈك	mæŋɡˈylyk
لوپ	lˈop
جاي	d͡ʒˈɑj
ئىسىملىرى	ˌɪsɪmlˈɪɾɪ
ئۆزگەرتىشكە	ˌœzɡærtˈɪʃkæ
ئىشلەيدىغان	ˌɪʃlæjdˈɪʁɑn
ئۆزىدىكى	ˌœzɪdˈɪkɪ
پايدا	pˈɑjdɑ
مەھكىمىسىنىڭ	mˌæhkɪmɪsˈɪnɪŋ
بىر	bˈɪr
ئالتە	ˈɑltæ
ئۆيىگە	œjˈɪɡæ
كىتابلىرى	kˌɪtɑblˈɪɾɪ
قۇتلۇق	qˈutluq
كېسەلگە	kesˈælɡæ
جون	d͡ʒˈon
ياۋروپا	jɑwrˈopɑ
چىنە	t͡ʃˈɪnæ
مەكتەپنىڭ	mæktˈæpnɪŋ
ئىنگلىز	ˈɪnɡlɪz
خۇدا	χˈudɑ
ساقلاپ	sˈɑqlɑp
تاتارلار	tɑtˈɑrlɑr
باقمىغان	bɑqmˈɪʁɑn
قىلغىنى	qɪlʁˈɪnɪ
ئافرىقىدىكى	ˌɑfrɪqɪdˈɪkɪ
ئىراق	ˈɪɾɑq
يىپەك	jˈɪpæk
ماي	mˈɑj
پائالىيەتلىرى	pˌɑɑlˌɪjætlˈɪɾɪ
زوراۋانلىق	zˌoɾɑwˈɑnlɪq
مىسىر	mˈɪsɪr
خانلىقىنىڭ	χˌɑnlɪqˈɪnɪŋ
كېلىشىم	kelˈɪʃɪm
پارچىدىن	pɑrt͡ʃˈɪdɪn
ئاپتورنىڭ	ɑptˈornɪŋ
ئايرىلىپ	ɑjrˈɪlɪp
خېنىم	χˈenɪm
نامدا	nˈɑmdɑ
ئۆردەك	ˈœrdæk
بولمىدى	bolmˈɪdɪ
مىسلى	mˈɪslɪ
ئۈلگە	ˈylɡæ
قىروسىز	qɪɾˈosɪz
ئىلىپ	ˈɪlɪp
يىلتىز	jˈɪltɪz
شىمالىي	ʃɪmˈɑlɪj
كەسپىگە	kæspˈɪɡæ
قىسقىچە	qɪsqˈɪt͡ʃæ
بوۋاقنىڭ	bowˈɑqnɪŋ
ئۈزى	ˈyzɪ
كۈنىمىزدە	kˌynɪmˈɪzdæ
غەرب	ʁˈærb
ئىسلامنىڭ	ɪslˈɑmnɪŋ
ئەينەن	ˈæjnæn
يۇقىرىدىكى	jˌuqɪɾɪdˈɪkɪ
سىنانىڭ	sɪnˈɑnɪŋ
بارغاندا	bɑrʁˈɑndɑ
مەسچىتنىڭ	mæst͡ʃˈɪtnɪŋ
زەھەر	zˈæhær
قەھۋە	qˈæhwæ
يىللاردىن	jɪllˈɑrdɪn
شۇنىڭ	ʃˈunɪŋ
تاشنى	tˈɑʃnɪ
سىلەر	sˈɪlær
خادىم	χˈɑdɪm
مۇناسىپ	munˈɑsɪp
قىلىشتىكى	qˌɪlɪʃtˈɪkɪ
ۋەدە	wˈædæ
دۇنياسى	dunjˈɑsɪ
ئوقۇغۇچىلاردىن	ˌoquʁˌut͡ʃɪlˈɑrdɪn
ئوقۇشنى	oqˈuʃnɪ
تولۇق	tˈoluq
مەسئۇلىيىتىنى	mˌæsulˌɪjɪtˈɪnɪ
شىركىتىنىڭ	ʃˌɪrkɪtˈɪnɪŋ
مەزمۇنلار	mæzmˈunlɑr
دەرياسى	dærjˈɑsɪ
دوللار	dˈollɑr
كەنتى	kˈæntɪ
شەرقتە	ʃˈærqtæ
دەرىخى	dæɾˈɪχɪ
ناھىيىنىڭ	nˌɑhɪjˈɪnɪŋ
ئىنگلىزچە	ɪnɡlˈɪzt͡ʃæ
جايلاردا	d͡ʒɑjlˈɑrdɑ
ئىشلىتىش	ɪʃlˈɪtɪʃ
مەكتەپكە	mæktˈæpkæ
كەلگەنلىكىنى	kˌælɡænlɪkˈɪnɪ
دەرىجىدە	dˌæɾɪd͡ʒˈɪdæ
قىش	qˈɪʃ
كۆتۈرگەن	kœtˈyrɡæn
نېمىنى	nemˈɪnɪ
كۆڭلى	kˈœŋlɪ
ئوغۇل	ˈoʁul
مۇسۇلمانلارنىڭ	mˌusulmɑnlˈɑrnɪŋ
ئۇنىڭغا	unˈɪŋʁɑ
قەرز	qˈærz
ئەلى	ˈælɪ
ئېلىپ	ˈelɪp
سىناش	sˈɪnɑʃ
تەبىئەت	tæbˈɪæt
ئەرتۇغرۇل	ærtˈuʁrul
قىلىنىپ	qɪlˈɪnɪp
مىلادىيىدىن	mˌɪlɑdɪjˈɪdɪn
يولۇچىلار	jˌolut͡ʃˈɪlɑr
مۇنەۋۋەر	munˈæwwær
ئەتراپىغا	ˌætrɑpˈɪʁɑ
تىلىدا	tɪlˈɪdɑ
ئاجرىتىپ	ɑd͡ʒrˈɪtɪp
ھەرىكىتى	hˌæɾɪkˈɪtɪ
ئوقۇپ	ˈoqup
قانۇننىڭ	qɑnˈunnɪŋ
ئىسلامغا	ɪslˈɑmʁɑ
پائالىيەتلەر	pˌɑɑlɪjˈætlær
تامغا	tˈɑmʁɑ
ئەقىدىسى	ˌæqɪdˈɪsɪ
ئاد	ˈɑd
بولىمىز	bolˈɪmɪz
بالىلارنىڭ	bˌɑlɪlˈɑrnɪŋ
شافىئىي	ʃɑfˈɪɪj
مىللى	mˈɪllɪ
خەۋەرلەر	χæwˈærlær
قوشۇنلىرى	qˌoʃunlˈɪɾɪ
مىللىتى	mɪllˈɪtɪ
يېتىم	jˈetɪm
قىلىنماقتا	qˌɪlɪnmˈɑqtɑ
كېلىش	kˈelɪʃ
ئەڭ	ˈæŋ
ئاڭلاپ	ˈɑŋlɑp
نۇقتىدىن	nuqtˈɪdɪn
تېمىنى	temˈɪnɪ
ئۆزلىرىنى	ˌœzlɪɾˈɪnɪ
ئورگانلىرى	ˌorɡɑnlˈɪɾɪ
كۆرۈنۈش	kœɾˈynyʃ
تەييار	tˈæjjɑr
ئاڭلىشىمچە	ˌɑŋlɪʃˈɪmt͡ʃæ
دېگەنلىك	deɡˈænlɪk
زىيادە	zɪjˈɑdæ
تارىم	tˈɑɾɪm
غازى	ʁˈɑzɪ
قوشتى	qˈoʃtɪ
ئايلانغان	ɑjlˈɑnʁɑn
كەتتى	kˈættɪ
خىراجىتى	χˌɪɾɑd͡ʒˈɪtɪ
دېڭىزنىڭ	deŋˈɪznɪŋ
فىقھىي	fˈɪqhɪj
ئىستانبۇل	ɪstˈɑnbul
ئوقۇغۇچىلىرى	ˌoquʁˌut͡ʃɪlˈɪɾɪ
ئىدارىسىنىڭ	ˌɪdɑɾɪsˈɪnɪŋ
دولقۇن	dˈolqun
بولۇشىنى	bˌoluʃˈɪnɪ
يېپىق	jˈepɪq
دېيىش	dˈejɪʃ
ئېتىش	ˈetɪʃ
مىقدارى	mɪqdˈɑɾɪ
مىلىيون	mɪlˈɪjon
ئويلاپ	ˈojlɑp
سوققان	sˈoqqɑn
خەلىقنىڭ	χælˈɪqnɪŋ
ش	ʃ
جاپالىق	d͡ʒɑpˈɑlɪq
ئارىسىدا	ˌɑɾɪsˈɪdɑ
پەۋقۇلئاددە	pˌæwqulˈɑddæ
قورال	qˈoɾɑl
پەنلەر	pˈænlær
موڭغۇل	mˈoŋʁul
بېجىرىش	bed͡ʒˈɪɾɪʃ
تاغ	tˈɑʁ
قىلىشى	qɪlˈɪʃɪ
مىڭغا	mˈɪŋʁɑ
ئېشىپ	ˈeʃɪp
ئۇرخۇن	ˈurχun
كالىفورنىيە	kˌɑlɪfornˈɪjæ
پاكىت	pˈɑkɪt
توختى	tˈoχtɪ
ئىجتىمائىي	ˌɪd͡ʒtɪmˈɑɪj
ئەۋەتىپ	æwˈætɪp
زىيالىيلار	zˌɪjɑlˈɪjlɑr
ئەمەل	ˈæmæl
ئىللەت	ˈɪllæt
نۇقتىسى	nuqtˈɪsɪ
قېيىن	qˈejɪn
تەۋەسىدىن	tˌæwæsˈɪdɪn
ئافغانىستان	ˌɑfʁɑnˈɪstɑn
خىرىستىيان	χˌɪɾɪstˈɪjɑn
تەرەپكە	tæɾˈæpkæ
قىلىدىكەن	qˌɪlɪdˈɪkæn
نامى	nˈɑmɪ
تەسىرىگە	tˌæsɪɾˈɪɡæ
مەزگىلدىن	mæzɡˈɪldɪn
ئۈزىنىڭ	yzˈɪnɪŋ
جوڭگۇ	d͡ʒˈoŋɡu
تېببىي	tˈebbɪj
ب	b
ئاتقا	ˈɑtqɑ
پۈتۈشكىنى	pˌytyʃkˈɪnɪ
زامانغا	zɑmˈɑnʁɑ
ناھىيىسى	nˌɑhɪjˈɪsɪ
بولمىش	bˈolmɪʃ
ياردىمى	jɑrdˈɪmɪ
بولۇش	bˈoluʃ
ئىككىدىن	ɪkkˈɪdɪn
پاي	pˈɑj
قابىلىيىتى	qˌɑbɪlɪjˈɪtɪ
بېرەتتى	beɾˈættɪ
ئارىلىق	ɑɾˈɪlɪq
تۇتاش	tˈutɑʃ
ئىنكاس	ˈɪnkɑs
ھاللاردا	hɑllˈɑrdɑ
يوللاپ	jˈollɑp
مەۋھۇم	mˈæwhum
تەرەققىيات	tˌæɾæqqˈɪjɑt
جەمئىيەتنىڭ	d͡ʒˌæmɪjˈætnɪŋ
ئېھتىياجى	ˌehtɪjˈɑd͡ʒɪ
سۆزنى	sˈœznɪ
دىنىنى	dɪnˈɪnɪ
ئىشلىتىشكە	ˌɪʃlɪtˈɪʃkæ
دولان	dˈolɑn
ئارىلىقىدىكى	ˌɑɾɪlˌɪqɪdˈɪkɪ
قاتناشقۇچىلار	qˌɑtnɑʃqut͡ʃˈɪlɑr
كەڭلىك	kˈæŋlɪk
غا	ʁˈɑ
كۆچمەن	kˈœt͡ʃmæn
مەسىلىنى	mˌæsɪlˈɪnɪ
ھەقىقەتنى	hˌæqɪqˈætnɪ
تارمار	tˈɑrmɑr
ئوخشايدۇ	oχʃˈɑjdu
پەرقلىنىدۇ	pˌærqlɪnˈɪdu
ئالما	ˈɑlmɑ
قوشۇپ	qˈoʃup
كەچ	kˈæt͡ʃ
تۆتىنچى	tœtˈɪnt͡ʃɪ
زات	zˈɑt
ئارمىيەسى	ˌɑrmɪjˈæsɪ
دوستلار	dˈostlɑr
توغرىسىغا	tˌoʁrɪsˈɪʁɑ
ئىمكانىيىتى	ˌɪmkɑnɪjˈɪtɪ
ئېنىق	ˈenɪq
ئېغىزى	eʁˈɪzɪ
ئىشىنى	ɪʃˈɪnɪ
چەتكە	t͡ʃˈætkæ
كىگىز	kˈɪɡɪz
بولۇپتۇ	bolˈuptu
فىزىكا	fɪzˈɪkɑ
شەھرىنىڭ	ʃæhrˈɪnɪŋ
ئەمەلدىن	æmˈældɪn
ئادەملەرنىڭ	ˌɑdæmlˈærnɪŋ
قانداقلا	qɑndˈɑqlɑ
كۆپ	kˈœp
ئىز	ˈɪz
جايلارنى	d͡ʒɑjlˈɑrnɪ
شارائىت	ʃɑɾˈɑɪt
تاشلاش	tˈɑʃlɑʃ
يېزىق	jˈezɪq
ئومۇملاشقان	ˌomumlˈɑʃqɑn
كېسەك	kˈesæk
كېلىپ	kˈelɪp
سۆھبەت	sˈœhbæt
دادا	dˈɑdɑ
جەرىمانە	d͡ʒˌæɾɪmˈɑnæ
ۋاسىتىسىنى	wˌɑsɪtɪsˈɪnɪ
ئىدارە	ɪdˈɑɾæ
ھەجىملىك	hæd͡ʒˈɪmlɪk
قارارغا	qɑɾˈɑrʁɑ
رولى	rˈolɪ
تاشيولى	tɑʃjˈolɪ
دۆلەتلەر	dœlˈætlær
ئىبارەت	ɪbˈɑɾæt
ھەممىدىن	hæmmˈɪdɪn
ياخشى	jˈɑχʃɪ
رەسمىي	rˈæsmɪj
مۇتەللىپ	mutˈællɪp
ئايغىچە	ɑjʁˈɪt͡ʃæ
جۇڭخۇا	d͡ʒuŋχˈuɑ
ھاكىمىيەت	hˌɑkɪmˈɪjæt
ئۆلۈمى	œlˈymɪ
كوممۇنىست	kommˈunɪst
ژۇرنىلى	ʒurnˈɪlɪ
ئوغۇز	ˈoʁuz
قىلماسلىق	qɪlmˈɑslɪq
بويى	bˈojɪ
جەمئىيەتنى	d͡ʒˌæmɪjˈætnɪ
تازىلاش	tɑzˈɪlɑʃ
راست	rˈɑst
ئىككىسى	ɪkkˈɪsɪ
ناھىيە	nɑhˈɪjæ
تىپتىكى	tɪptˈɪkɪ
چىقىرىپ	t͡ʃɪqˈɪɾɪp
قىشلىق	qˈɪʃlɪq
مۇنداق	mˈundɑq
كېتىپتۇ	ketˈɪptu
ياشتىن	jˈɑʃtɪn
كۆل	kˈœl
بۇلارنىڭ	bulˈɑrnɪŋ
شەھىرىدىكى	ʃˌæhɪɾɪdˈɪkɪ
توماس	tˈomɑs
مەلۇمات	mælˈumɑt
يازما	jˈɑzmɑ
قاسىم	qˈɑsɪm
شاھى	ʃˈɑhɪ
ۋايىغا	wɑjˈɪʁɑ
قىزغىن	qˈɪzʁɪn
ئاشۇ	ˈɑʃu
شۇغۇللانغان	ʃˌuʁullˈɑnʁɑn
ئەدەبىي	ædˈæbɪj
قىسقا	qˈɪsqɑ
بىرلىكىنى	bˌɪrlɪkˈɪnɪ
ھاشىم	hˈɑʃɪm
مەشرىپى	mæʃrˈɪpɪ
بۆلۈنىدۇ	bˌœlynˈɪdu
ئىنسان	ˈɪnsɑn
قېتىمدىن	qetˈɪmdɪn
ساز	sˈɑz
داڭلىق	dˈɑŋlɪq
ھەرقانداق	hærqˈɑndɑq
ناھىيىسىگە	nˌɑhɪjɪsˈɪɡæ
گۆشى	ɡˈœʃɪ
ئىشلىتىدۇ	ˌɪʃlɪtˈɪdu
قەد	qˈæd
كۆپچىلىك	kœpt͡ʃˈɪlɪk
دوكلات	dˈoklɑt
رولىنى	rolˈɪnɪ
قوڭ	qˈoŋ
ئەنگە	ˈænɡæ
سېسىق	sˈesɪq
مەنىلىك	mænˈɪlɪk
بىزدە	bˈɪzdæ
بولغاندەك	bolʁˈɑndæk
ئىزچىل	ˈɪzt͡ʃɪl
ئېنگىلىزچە	ˌenɡɪlˈɪzt͡ʃæ
يېزىقىنى	jˌezɪqˈɪnɪ
بولمايدىغانلىقىنى	bˌolmɑjdˌɪʁɑnlɪqˈɪnɪ
كوپ	kˈop
دولقۇنى	dolqˈunɪ
ئۆزىگە	œzˈɪɡæ
خۇسۇسەن	χusˈusæn
ئىلاۋە	ɪlˈɑwæ
مېڭىنىڭ	meŋˈɪnɪŋ
ئاھالىسىنىڭ	ˌɑhɑlɪsˈɪnɪŋ
قۇبۇل	qˈubul
ئەرەپ	ˈæɾæp
توغرىسىدا	tˌoʁrɪsˈɪdɑ
بىرىدىن	bɪɾˈɪdɪn
شەكىللىك	ʃækˈɪllɪk
ئايلىق	ˈɑjlɪq
يولىنى	jolˈɪnɪ
پەرەز	pˈæɾæz
يېزىسى	jezˈɪsɪ
ھەرقايسى	hærqˈɑjsɪ
ئوڭدىن	ˈoŋdɪn
بىرقانچە	bɪrqˈɑnt͡ʃæ
ئەھمىيەت	æhmˈɪjæt
قۇرغاق	qˈurʁɑq
مۇنتىزىم	muntˈɪzɪm
ئۇرۇشتىن	uɾˈuʃtɪn
كۈچلەر	kˈyt͡ʃlær
ئۆتكۈزىدۇ	ˌœtkyzˈɪdu
تاپىدۇ	tɑpˈɪdu
چۈشكەن	t͡ʃˈyʃkæn
كېيىن	kˈejɪn
مۇرەككەپ	muɾˈækkæp
مەيدانغا	mæjdˈɑnʁɑ
ئېيتىپ	ˈejtɪp
كۈندىلىك	kyndˈɪlɪk
يېزا	jˈezɑ
نەقىش	nˈæqɪʃ
پىرسەنتىنى	pˌɪrsæntˈɪnɪ
قاتنىشى	qɑtnˈɪʃɪ
سۇدا	sˈudɑ
سۇلالىسى	sˌulɑlˈɪsɪ
ھەدىس	hˈædɪs
تاماق	tˈɑmɑq
بەلگىلىمىگە	bˌælɡɪlɪmˈɪɡæ
توپى	tˈopɪ
نورۇز	nˈoɾuz
قىلىپلا	qɪlˈɪplɑ
ئۆسۈپ	ˈœsyp
غالىپ	ʁˈɑlɪp
ئىنسانلار	ɪnsˈɑnlɑr
بوپتۇ	bˈoptu
ناچار	nˈɑt͡ʃɑr
تېمىسى	temˈɪsɪ
قىممىتى	qɪmmˈɪtɪ
ئۇچراپ	ˈut͡ʃrɑp
ئىشلىرىغا	ˌɪʃlɪɾˈɪʁɑ
ئۆگىتىش	œɡˈɪtɪʃ
قۇرۇلۇشى	qˌuɾulˈuʃɪ
ژۇرنىلىنىڭ	ʒˌurnɪlˈɪnɪŋ
باتۇر	bˈɑtur
ئۇن	ˈun
بەدەننى	bædˈænnɪ
ئومۇمىي	omˈumɪj
كېلىۋاتىدۇ	kˌelɪwɑtˈɪdu
ۋىتامىن	wɪtˈɑmɪn
تېرە	tˈeɾæ
شىتابى	ʃɪtˈɑbɪ
غايىسى	ʁɑjˈɪsɪ
لازىم	lˈɑzɪm
رايون	rˈɑjon
ئۆي	ˈœj
بېرىۋاتقان	bˌeɾɪwˈɑtqɑn
ئۈزۈك	ˈyzyk
ئۈرۈمچى	yɾˈymt͡ʃɪ
تەنقىد	tˈænqɪd
باشلىق	bˈɑʃlɪq
ئالدىنقى	ɑldˈɪnqɪ
ئېقىم	ˈeqɪm
دەۋرىنى	dæwrˈɪnɪ
دائىمىي	dɑˈɪmɪj
ئىشچىلار	ɪʃt͡ʃˈɪlɑr
بىخەتەرلىك	bˌɪχætˈærlɪk
تەرىپىدىن	tˌæɾɪpˈɪdɪn
ئاياق	ˈɑjɑq
كىتابتا	kɪtˈɑbtɑ
ھەركۈنى	hærkˈynɪ
چاغدىكى	t͡ʃɑʁdˈɪkɪ
دۆلەتلىرىنىڭ	dˌœlætlɪɾˈɪnɪŋ
سىدىق	sˈɪdɪq
سانائەت	sɑnˈɑæt
ئاقسۇ	ˈɑqsu
ئۇچۇر	ˈut͡ʃur
ئۆلدى	ˈœldɪ
بەلكى	bˈælkɪ
موللا	mˈollɑ
ھەپتە	hˈæptæ
تارقالغان	tɑrqˈɑlʁɑn
ھايۋانلارنىڭ	hˌɑjwɑnlˈɑrnɪŋ
تىللار	tˈɪllɑr
پۇختا	pˈuχtɑ
ئۇستاز	ˈustɑz
بەل	bˈæl
كۈچىنى	kyt͡ʃˈɪnɪ
نەسلىدىن	næslˈɪdɪn
ئۇرۇشقا	uɾˈuʃqɑ
مەسىلىلەر	mˌæsɪlˈɪlær
سولغا	sˈolʁɑ
بېشىنى	beʃˈɪnɪ
بەت	bˈæt
ئېيتقان	ˈejtqɑn
باشلاش	bˈɑʃlɑʃ
ساتقۇچى	sɑtqˈut͡ʃɪ
قۇتۇپ	qˈutup
كېتىدۇ	ketˈɪdu
ئىنقىلابىنىڭ	ˌɪnqɪlɑbˈɪnɪŋ
كېلەر	kˈelær
ئومۇميۈزلۈك	ˌomumjˈyzlyk
جاپا	d͡ʒˈɑpɑ
تېنچلىق	tˈent͡ʃlɪq
گەپلەر	ɡˈæplær
سەھىيە	sæhˈɪjæ
خىلاپلىق	χɪlˈɑplɪq
ئادەت	ˈɑdæt
ئاستىدىكى	ˌɑstɪdˈɪkɪ
خىلدىكى	χɪldˈɪkɪ
قارىمۇ	qɑɾˈɪmu
قەبىلىسى	qˌæbɪlˈɪsɪ
مەككىدە	mækkˈɪdæ
ئانالىز	ɑnˈɑlɪz
ئىقبال	ˈɪqbɑl
يېتىشتۈرۈش	jˌetɪʃtˈyɾyʃ
قېشىغا	qeʃˈɪʁɑ
كۆكتۈرك	kˈœktyrk
ئىسىملار	ɪsˈɪmlɑr
ئەبى	ˈæbɪ
خەقنىڭ	χˈæqnɪŋ
پۇتىن	pˈutɪn
كۈنلەرنىڭ	kynlˈærnɪŋ
كەينىگە	kæjnˈɪɡæ
تېلېۋىزور	tˌelewˈɪzor
مەكتەپلەرنى	mˌæktæplˈærnɪ
قىلمايدىغان	qˌɪlmɑjdˈɪʁɑn
قېچىپ	qˈet͡ʃɪp
نامرات	nˈɑmrɑt
يەككە	jˈækkæ
ھەممىسىگە	hˌæmmɪsˈɪɡæ
تىجارەت	tɪd͡ʒˈɑɾæt
رەسمى	rˈæsmɪ
تەكشى	tˈækʃɪ
قولايلىق	qolˈɑjlɪq
ياپون	jˈɑpon
كەلتۈرىدۇ	kˌæltyɾˈɪdu
تىكلەپ	tˈɪklæp
مۇنازىرە	mˌunɑzˈɪɾæ
كېتىۋاتقان	kˌetɪwˈɑtqɑn
خاھرى	χˈɑhrɪ
سىلەرنىڭ	sɪlˈærnɪŋ
رادىئاكتىپلىق	rˌɑdɪɑktˈɪplɪq
قوشۇن	qˈoʃun
بارغانسېرى	bˌɑrʁɑnsˈeɾɪ
كۆرۈۋالغىلى	kˌœɾywɑlʁˈɪlɪ
ئوق	ˈoq
ئۇزۇنلۇق	uzˈunluq
تەختكە	tˈæχtkæ
تەرەققىياتىنى	tˌæɾæqqˌɪjɑtˈɪnɪ
دەپمۇ	dˈæpmu
ياۋروپادىكى	jˌɑwropɑdˈɪkɪ
ئىشلەنگەن	ɪʃlˈænɡæn
قولىغا	qolˈɪʁɑ
ھەرىكىتىنىڭ	hˌæɾɪkɪtˈɪnɪŋ
ئىدىيە	ɪdˈɪjæ
دەپنە	dˈæpnæ
قاتنىشىپ	qɑtnˈɪʃɪp
تىك	tˈɪk
قۇرغان	qˈurʁɑn
تەھدىت	tˈæhdɪt
ئامېرىكا	ˌɑmeɾˈɪkɑ
دائىرىسىدىكى	dˌɑɪɾˌɪsɪdˈɪkɪ
تەۋەسىدىكى	tˌæwæsɪdˈɪkɪ
ئۆزىمىزنىڭ	ˌœzɪmˈɪznɪŋ
بايلىقلىرىدىن	bˌɑjlɪqlɪɾˈɪdɪn
قويۇق	qˈojuq
ئەدەبىياتىنىڭ	ˌædæbˌɪjɑtˈɪnɪŋ
ئاللاھقا	ɑllˈɑhqɑ
تۇرۇپلا	tuɾˈuplɑ
مۇتەخەسسىس	mˌutæχˈæssɪs
بولسۇن	bˈolsun
سۆزىنىڭ	sœzˈɪnɪŋ
بىزگە	bˈɪzɡæ
قوشقان	qˈoʃqɑn
فرانسىيە	frɑnsˈɪjæ
تاپشۇرغان	tɑpʃˈurʁɑn
پەس	pˈæs
جەمئىيىتىنىڭ	d͡ʒˌæmɪjɪtˈɪnɪŋ
مۇكاپاتقا	mˌukɑpˈɑtqɑ
ئىجرا	ˈɪd͡ʒrɑ
قۇم	qˈum
قىلدۇرۇش	qɪldˈuɾuʃ
تەمىنلەيدۇ	tˌæmɪnlˈæjdu
مەجبۇرىيىتى	mˌæd͡ʒbuɾɪjˈɪtɪ
ئىبن	ˈɪbn
ھاياتنى	hɑjˈɑtnɪ
ئۆگىنىپ	œɡˈɪnɪp
ھاكىمىيىتى	hˌɑkɪmɪjˈɪtɪ
لېكسىيە	leksˈɪjæ
بالا	bˈɑlɑ
دۈشمەنگە	dyʃmˈænɡæ
ئۇزۇنلۇقى	ˌuzunlˈuqɪ
نۆۋەتتىكى	nˌœwættˈɪkɪ
ھەدىسلەرنى	hˌædɪslˈærnɪ
چاناق	t͡ʃˈɑnɑq
بولسا	bˈolsɑ
گەرچە	ɡˈært͡ʃæ
سورىغان	soɾˈɪʁɑn
جايلىرىغا	d͡ʒˌɑjlɪɾˈɪʁɑ
بېرىشى	beɾˈɪʃɪ
تۇيغۇسى	tujʁˈusɪ
ياخشىلىق	jɑχʃˈɪlɪq
توپنى	tˈopnɪ
ئۇزۇنلۇك	uzˈunluk
تونۇشتۇرۇلغان	tˌonuʃtuɾˈulʁɑn
مۈلكى	mˈylkɪ
ئويلايمەن	ojlˈɑjmæn
يەكۈن	jˈækyn
ئۆيدىن	ˈœjdɪn
كۇچا	kˈut͡ʃɑ
تۇرمۇشى	turmˈuʃɪ
قېتىمقى	qetˈɪmqɪ
تارمىقىغا	tˌɑrmɪqˈɪʁɑ
بۇنى	bˈunɪ
توغرۇلۇق	toʁrˈuluq
نىسپىيلىك	nɪspˈɪjlɪk
بولمىسا	bolmˈɪsɑ
ساھەلەردە	sˌɑhælˈærdæ
رېئاللىق	reˈɑllɪq
تۇخۇم	tˈuχum
سەر	sˈær
بارىدۇ	bɑɾˈɪdu
دەرىجىدىكى	dˌæɾɪd͡ʒɪdˈɪkɪ
پايدىلىنىپ	pˌɑjdɪlˈɪnɪp
سۈنئىي	sˈynɪj
ئۆتتى	ˈœttɪ
ھايۋان	hˈɑjwɑn
قېلىش	qˈelɪʃ
ئىشلەۋاتقان	ˌɪʃlæwˈɑtqɑn
ئارقىلىق	ɑrqˈɪlɪq
ھالدا	hˈɑldɑ
لار	lˈɑr
ئاتالمىش	ɑtˈɑlmɪʃ
ئوقۇشىنى	ˌoquʃˈɪnɪ
ئارمىيىسى	ˌɑrmɪjˈɪsɪ
ئۇسسۇلى	ussˈulɪ
قەشقەردە	qæʃqˈærdæ
مەھرۇم	mˈæhrum
كۇنى	kˈunɪ
شەھەرنى	ʃæhˈærnɪ
ئىككىنچى	ɪkkˈɪnt͡ʃɪ
تەسلىم	tˈæslɪm
ئەنە	ˈænæ
كۆرسىتىش	kœrsˈɪtɪʃ
ئىماننىڭ	ɪmˈɑnnɪŋ
ئىپادىسى	ˌɪpɑdˈɪsɪ
قانۇنى	qɑnˈunɪ
چىقىرىلغان	t͡ʃˌɪqɪɾˈɪlʁɑn
كېتىدىغان	kˌetɪdˈɪʁɑn
ھەقىقى	hæqˈɪqɪ
تارىخى	tɑɾˈɪχɪ
تەتقىق	tˈætqɪq
ئىقتىساد	ɪqtˈɪsɑd
دېگەننى	deɡˈænnɪ
ئىگىسى	ɪɡˈɪsɪ
ئازراق	ˈɑzrɑq
قاتناشتى	qɑtnˈɑʃtɪ
ھاۋا	hˈɑwɑ
قىلمىشى	qɪlmˈɪʃɪ
رېئال	rˈeɑl
مۇتەللىپنىڭ	mˌutællˈɪpnɪŋ
سەۋەب	sˈæwæb
ئالاھىدىلىككە	ˌɑlɑhˌɪdɪlˈɪkkæ
مۇسۇلمانلارنى	mˌusulmɑnlˈɑrnɪ
تەكلىماكان	tˌæklɪmˈɑkɑn
بازىرىنىڭ	bˌɑzɪɾˈɪnɪŋ
مۇسابىقىسى	mˌusɑbɪqˈɪsɪ
بۇيان	bˈujɑn
تۈپەيلى	typˈæjlɪ
قۇرۇش	qˈuɾuʃ
شەخس	ʃˈæχs
ئۆتىمەن	œtˈɪmæn
مەيدانى	mæjdˈɑnɪ
ھەدىيە	hædˈɪjæ
ئۇيغۇرچىغا	ˌujʁurt͡ʃˈɪʁɑ
مىليون	mˈɪljon
يۇرتىغا	jurtˈɪʁɑ
يۈرۈپ	jˈyɾyp
كەلتۈرگەن	kæltˈyrɡæn
پەرزەنتى	pærzˈæntɪ
تەرىقىسىدە	tˌæɾɪqɪsˈɪdæ
بويلاپ	bˈojlɑp
ئىشلار	ˈɪʃlɑr
بەلگىلىنىدۇ	bˌælɡɪlɪnˈɪdu
رىقابەت	rɪqˈɑbæt
دەسلەپكى	dæslˈæpkɪ
ئاسمانغا	ɑsmˈɑnʁɑ
تىلدىكى	tɪldˈɪkɪ
قات	qˈɑt
ئىچكىرىدە	ˌɪt͡ʃkɪɾˈɪdæ
ئېرۇر	ˈeɾur
ئالى	ˈɑlɪ
كۆپىيىپ	kœpˈɪjɪp
دىكى	dˈɪkɪ
ياردەمچىسى	jˌɑrdæmt͡ʃˈɪsɪ
يىغىنغا	jɪʁˈɪnʁɑ
ھالقىغان	hɑlqˈɪʁɑn
مىللىي	mˈɪllɪj
بەلگىلەپ	bælɡˈɪlæp
ئاتىسى	ɑtˈɪsɪ
بۇرۇن	bˈuɾun
ئەقىل	ˈæqɪl
ئىشلەپ	ˈɪʃlæp
كېرەكلىكى	kˌeɾæklˈɪkɪ
گۈلى	ɡˈylɪ
ئۆردەكنىڭ	œrdˈæknɪŋ
بەلكىم	bˈælkɪm
تارماقلىرى	tˌɑrmɑqlˈɪɾɪ
كەلتۈرۈلىدۇ	kˌæltyɾylˈɪdu
بۇيرۇق	bˈujruq
تۇردى	tˈurdɪ
سىياسەتنىڭ	sˌɪjɑsˈætnɪŋ
سۆزلەپ	sˈœzlæp
ئۇنۋانى	unwˈɑnɪ
تەشەببۇس	tæʃˈæbbus
ۋەتەندىكى	wˌætændˈɪkɪ
ئۆتكەندە	œtkˈændæ
تىرازىي	tɪɾˈɑzɪj
يولغا	jˈolʁɑ
ھۆكۈمىتى	hˌœkymˈɪtɪ
قولى	qˈolɪ
ئارقىغا	ɑrqˈɪʁɑ
ئاشۇرۇپ	ɑʃˈuɾup
ماتورلۇق	mɑtˈorluq
مىنىستىرلىكى	mˌɪnɪstɪrlˈɪkɪ
تا	tˈɑ
كۆرسىتىپ	kœrsˈɪtɪp
نوپۇسنىڭ	nopˈusnɪŋ
كۈنى	kˈynɪ
دۆلىتىنىڭ	dˌœlɪtˈɪnɪŋ
نۇقتا	nˈuqtɑ
مۇخبىر	mˈuχbɪr
مەمۇرى	mæmˈuɾɪ
ۋەقەنى	wæqˈænɪ
ئېسىل	ˈesɪl
بولغاچقا	bolʁˈɑt͡ʃqɑ
نۇسخىلىرى	nˌusχɪlˈɪɾɪ
لىپەك	lˈɪpæk
شۇ	ʃˈu
ئاشلىق	ˈɑʃlɪq
دىيارىدا	dˌɪjɑɾˈɪdɑ
ئەمەلىيەتكە	ˌæmælɪjˈætkæ
جايلىرىدىكى	d͡ʒˌɑjlɪɾɪdˈɪkɪ
مۇدىر	mˈudɪr
ئەخلاقىي	æχlˈɑqɪj
ئابلاجان	ɑblˈɑd͡ʒɑn
دوستى	dˈostɪ
جەڭ	d͡ʒˈæŋ
ئايلىنىپ	ɑjlˈɪnɪp
خاتالىق	χɑtˈɑlɪq
يېقىندىن	jeqˈɪndɪn
يېقىن	jˈeqɪn
ئەزالىرىنى	ˌæzɑlɪɾˈɪnɪ
دەرسى	dˈærsɪ
سىلەرگە	sɪlˈærɡæ
ئۇيغۇرنى	ujʁˈurnɪ
يېغى	jˈeʁɪ
مەنچە	mˈænt͡ʃæ
سېپىل	sˈepɪl
يىغىن	jˈɪʁɪn
نوقۇل	nˈoqul
ئاران	ˈɑɾɑn
بالىسى	bɑlˈɪsɪ
بىلەنمۇ	bɪlˈænmu
دۇنيا	dˈunjɑ
كىرگەندىن	kɪrɡˈændɪn
ئابدۇرېھىم	ˌɑbduɾˈehɪm
قىيامەت	qɪjˈɑmæt
ئۇزۇنراق	uzˈunrɑq
تاپقان	tˈɑpqɑn
تارتىدۇ	tɑrtˈɪdu
مۇھىتتا	muhˈɪttɑ
توختامنى	toχtˈɑmnɪ
ماقالىلەرنى	mˌɑqɑlɪlˈærnɪ
خىمالىكاڭ	χˌɪmɑlˈɪkɑŋ
خېلىلا	χelˈɪlɑ
ئىتتىپاقىغا	ˌɪttɪpɑqˈɪʁɑ
ئالدىنى	ɑldˈɪnɪ
يۇقىرىقى	jˌuqɪɾˈɪqɪ
بۇخىل	bˈuχɪl
ھەرىكىتىگە	hˌæɾɪkɪtˈɪɡæ
ئۆتكۈر	ˈœtkyr
خىل	χˈɪl
ئابدۇخالىق	ˌɑbduχˈɑlɪq
چارۋا	t͡ʃˈɑrwɑ
ئۇلۇغۋار	ulˈuʁwɑr
مەيدانىدا	mˌæjdɑnˈɪdɑ
ماكانى	mɑkˈɑnɪ
قېلىپ	qˈelɪp
ئائىلىدە	ˌɑɪlˈɪdæ
باش	bˈɑʃ
ئوينايدۇ	ojnˈɑjdu
مەسىلەن	mæsˈɪlæn
يېتەرلىك	jetˈærlɪk
ماڭا	mˈɑŋɑ
ئۇيغۇرلار	ujʁˈurlɑr
جەنۇبتا	d͡ʒænˈubtɑ
دەۋرى	dˈæwrɪ
بەزى	bˈæzɪ
زاماندىكى	zˌɑmɑndˈɪkɪ
بوسنىيە	bosnˈɪjæ
زىت	zˈɪt
ئابدۇقادىر	ˌɑbduqˈɑdɪr
يىلىنىڭ	jɪlˈɪnɪŋ
شەھىرىنىڭ	ʃˌæhɪɾˈɪnɪŋ
مەھسۇلى	mæhsˈulɪ
غەم	ʁˈæm
بەزىلەرنىڭ	bˌæzɪlˈærnɪŋ
ئۆزەم	ˈœzæm
رۇخسەت	rˈuχsæt
بولغىلى	bolʁˈɪlɪ
بۆلىكى	bœlˈɪkɪ
كېلىشى	kelˈɪʃɪ
ئىشلاردىن	ɪʃlˈɑrdɪn
خەلقىنى	χælqˈɪnɪ
قىلالايدۇ	qˌɪlɑlˈɑjdu
ياشقا	jˈɑʃqɑ
كۈنلىرى	kynlˈɪɾɪ
قورقۇش	qˈorquʃ
يېزىسىنىڭ	jˌezɪsˈɪnɪŋ
قىلىشتۇر	qɪlˈɪʃtur
نېفىت	nˈefɪt
يولدىن	jˈoldɪn
سېلىشتۇرغاندا	sˌelɪʃturʁˈɑndɑ
ئەمەلگە	æmˈælɡæ
پېتى	pˈetɪ
يېرىدە	jeɾˈɪdæ
ھوقۇقىنىڭ	hˌoquqˈɪnɪŋ
ئەنقەرە	ænqˈæɾæ
ئوتتۇرىچە	ˌottuɾˈɪt͡ʃæ
دىنى	dˈɪnɪ
تىللارنىڭ	tɪllˈɑrnɪŋ
ساھەگە	sɑhˈæɡæ
تەقدىرىنى	tˌæqdɪɾˈɪnɪ
چىقاتتى	t͡ʃɪqˈɑttɪ
تۈركىستاندا	tˌyrkɪstˈɑndɑ
لىنىيىسىنىڭ	lˌɪnɪjɪsˈɪnɪŋ
تۈرتكە	tˈyrtkæ
قارمىقىدىكى	qˌɑrmɪqɪdˈɪkɪ
ئىت	ˈɪt
ئىگىلەپ	ɪɡˈɪlæp
كۈچىنىڭ	kyt͡ʃˈɪnɪŋ
بالىلىرىغا	bˌɑlɪlɪɾˈɪʁɑ
باب	bˈɑb
يېشى	jˈeʃɪ
مەن	mˈæn
نەرسىگە	nærsˈɪɡæ
چوڭلار	t͡ʃˈoŋlɑr
تۇرغان	tˈurʁɑn
يەتكۈزگەن	jætkˈyzɡæn
نۇسخا	nˈusχɑ
مەيداننىڭ	mæjdˈɑnnɪŋ
قىلغاندا	qɪlʁˈɑndɑ
بازارغا	bɑzˈɑrʁɑ
نۆۋىتىدە	nˌœwɪtˈɪdæ
كەنجى	kˈænd͡ʒɪ
ئەمەس	ˈæmæs
تارىختا	tɑɾˈɪχtɑ
ۋاپاتىدىن	wˌɑpɑtˈɪdɪn
قالىسىز	qɑlˈɪsɪz
يىڭى	jˈɪŋɪ
ئىنچىكە	ɪnt͡ʃˈɪkæ
پاش	pˈɑʃ
ئۆلكىلىك	œlkˈɪlɪk
ئۇدۇن	ˈudun
دىققەت	dˈɪqqæt
ئوينىلىدۇ	ˌojnɪlˈɪdu
گوۋۇيۈەننىڭ	ɡˌowujyˈænnɪŋ
چارە	t͡ʃˈɑɾæ
ئەللىك	ˈællɪk
قىلىنغاندىن	qˌɪlɪnʁˈɑndɪn
بەرگەندە	bærɡˈændæ
قارا	qˈɑɾɑ
چوڭراق	t͡ʃˈoŋrɑq
مەنپەئەتىنى	mˌænpæætˈɪnɪ
دېگۈدەك	deɡˈydæk
قۇرۇلغاندىن	qˌuɾulʁˈɑndɪn
تونۇشتۇرۇپ	tˌonuʃtˈuɾup
خەلقنى	χˈælqnɪ
باھالاش	bɑhˈɑlɑʃ
ئوقۇرمەنلەرنىڭ	ˌoqurmænlˈærnɪŋ
مەركەز	mˈærkæz
رەڭ	rˈæŋ
رەتلىك	rˈætlɪk
بولسام	bˈolsɑm
بىراقلا	bɪɾˈɑqlɑ
نەشرىيات	næʃrˈɪjɑt
يىگانە	jɪɡˈɑnæ
ساياھەت	sɑjˈɑhæt
بىرلەشمە	bɪrlˈæʃmæ
تەبلىغ	tˈæblɪʁ
فونېتىكىلىق	fˌonetɪkˈɪlɪq
ئاپىرىپ	ɑpˈɪɾɪp
شەھەر	ʃˈæhær
سىڭىپ	sˈɪŋɪp
ئوردىسىدا	ˌordɪsˈɪdɑ
قېرىنداشلارنىڭ	qˌeɾɪndɑʃlˈɑrnɪŋ
زادىلا	zɑdˈɪlɑ
ئۆتكەندىن	œtkˈændɪn
ئەلىنىڭ	ælˈɪnɪŋ
قېتىملىق	qetˈɪmlɪq
پەيغەمبەر	pæjʁˈæmbær
ھاياتىغا	hˌɑjɑtˈɪʁɑ
پارتىيە	pɑrtˈɪjæ
باردۇر	bˈɑrdur
كۆرسىتىشى	kˌœrsɪtˈɪʃɪ
ئىقتىدارىغا	ˌɪqtɪdɑɾˈɪʁɑ
سۇ	sˈu
قىزى	qˈɪzɪ
خاتىرىلەش	χˌɑtɪɾˈɪlæʃ
تەجرىبە	tæd͡ʒrˈɪbæ
نىشان	nˈɪʃɑn
ئاستىغا	ɑstˈɪʁɑ
كەلتۈردى	kæltˈyrdɪ
ئەھۋال	ˈæhwɑl
گەپنى	ɡˈæpnɪ
تىللىق	tˈɪllɪq
كۆپرەك	kˈœpræk
مەشرەپ	mˈæʃræp
ھويلا	hˈojlɑ
ئۇيغۇرغا	ujʁˈurʁɑ
ساپ	sˈɑp
ھاياتى	hɑjˈɑtɪ
جارى	d͡ʒˈɑɾɪ
ئاڭلىدىم	ɑŋlˈɪdɪm
بىرىدە	bɪɾˈɪdæ
نوچى	nˈot͡ʃɪ
ئۇزۇقلۇق	uzˈuqluq
بىرلەشمىسى	bˌɪrlæʃmˈɪsɪ
گۇرۇپپىسى	ɡˌuɾuppˈɪsɪ
تېخى	tˈeχɪ
ۋىلايىتى	wˌɪlɑjˈɪtɪ
ئىسمى	ˈɪsmɪ
ئۇتۇق	ˈutuq
بارلىقى	bɑrlˈɪqɪ
قارىغۇلارچە	qˌɑɾɪʁulˈɑrt͡ʃæ
ئاساسلانغاندا	ˌɑsɑslɑnʁˈɑndɑ
سەندىن	sˈændɪn
باي	bˈɑj
پەرقى	pˈærqɪ
چاقچاق	t͡ʃˈɑqt͡ʃɑq
ئوۋ	ˈow
ئېرىق	ˈeɾɪq
پۈتكۈل	pˈytkyl
مائارىپى	mˌɑɑɾˈɪpɪ
باشلانغان	bɑʃlˈɑnʁɑn
ماقۇل	mˈɑqul
تۆرە	tˈœɾæ
ياسايدۇ	jɑsˈɑjdu
جاراڭلىق	d͡ʒɑɾˈɑŋlɪq
مەزگىلى	mæzɡˈɪlɪ
سىزنىڭ	sˈɪznɪŋ
ئۇسۇلدا	usˈuldɑ
ئۆتۈش	ˈœtyʃ
ياشانغان	jɑʃˈɑnʁɑn
دەرياسىنىڭ	dˌærjɑsˈɪnɪŋ
دېيىلگەن	dejˈɪlɡæn
تۆۋەندىكى	tˌœwændˈɪkɪ
يۇمىلاق	jumˈɪlɑq
تارماقتىكى	tˌɑrmɑqtˈɪkɪ
ئېلىنغان	elˈɪnʁɑn
ھامان	hˈɑmɑn
جەلىپ	d͡ʒˈælɪp
قوڭۇر	qˈoŋur
يىللىق	jˈɪllɪq
بولۇپ	bˈolup
قالايمىقان	qˌɑlɑjmˈɪqɑn
مۇستەملىكە	mˌustæmlˈɪkæ
مىللەتتە	mɪllˈættæ
ۋىرۇسى	wɪɾˈusɪ
قوللىنىپ	qollˈɪnɪp
دادىسىغا	dˌɑdɪsˈɪʁɑ
دەۋرىدىكى	dˌæwrɪdˈɪkɪ
مەنمۇ	mˈænmu
ئۆزىڭىزنى	ˌœzɪŋˈɪznɪ
ئىسىملىك	ɪsˈɪmlɪk
نەزەر	nˈæzær
كەسپىنى	kæspˈɪnɪ
خەلققە	χˈælqqæ
ئېلىشى	elˈɪʃɪ
ئاكام	ˈɑkɑm
دوست	dˈost
تەرەققىياتىغا	tˌæɾæqqˌɪjɑtˈɪʁɑ
شەخسنىڭ	ʃˈæχsnɪŋ
پىشۇرۇش	pɪʃˈuɾuʃ
ھازىر	hˈɑzɪr
ئۇيغۇرلارغا	ˌujʁurlˈɑrʁɑ
تېخنىكىلىق	tˌeχnɪkˈɪlɪq
ياشنىڭ	jˈɑʃnɪŋ
بىرۇنى	bɪɾˈunɪ
ئىشلىتىۋاتقان	ˌɪʃlɪtɪwˈɑtqɑn
مۇھىتى	muhˈɪtɪ
تەلەپنى	tælˈæpnɪ
ئاساسەن	ɑsˈɑsæn
شەكلىنى	ʃæklˈɪnɪ
كاپالەتلىك	kˌɑpɑlˈætlɪk
پارىژ	pˈɑɾɪʒ
يىلتىزى	jɪltˈɪzɪ
شەخسلەر	ʃˈæχslær
ئۆستۈرۈش	œstˈyɾyʃ
گە	ɡˈæ
ھىندىستانغا	hˌɪndɪstˈɑnʁɑ
ئاساسلىق	ɑsˈɑslɪq
ئاستىدىن	ɑstˈɪdɪn
ۋاسىتىسى	wˌɑsɪtˈɪsɪ
تەركىبىدە	tˌærkɪbˈɪdæ
بۇرۇنلا	buɾˈunlɑ
مەزمۇنىنى	mˌæzmunˈɪnɪ
باشلىرىدا	bˌɑʃlɪɾˈɪdɑ
ئوقيا	ˈoqjɑ
ئوتتۇرغا	ottˈurʁɑ
بوز	bˈoz
پۈتۈنلەي	pytˈynlæj
ھۈسەين	hˈysæjn
قىلىشقا	qɪlˈɪʃqɑ
چاقىرىق	t͡ʃɑqˈɪɾɪq
يىلدا	jˈɪldɑ
ئېسىمدە	esˈɪmdæ
كىيىن	kˈɪjɪn
ناتايىن	nɑtˈɑjɪn
ساقچى	sˈɑqt͡ʃɪ
ھەممىگە	hæmmˈɪɡæ
شېئىرلىرى	ʃˌeɪrlˈɪɾɪ
بارلار	bˈɑrlɑr
ئېچىش	ˈet͡ʃɪʃ
كېرىيە	keɾˈɪjæ
ساھابىلەردىن	sˌɑhɑbɪlˈærdɪn
بىرلە	bˈɪrlæ
دۆلەتتىكى	dˌœlættˈɪkɪ
قىسىمى	qɪsˈɪmɪ
سېتىپ	sˈetɪp
پائالىيەت	pˌɑɑlˈɪjæt
تەرەپتىكى	tˌæɾæptˈɪkɪ
تەن	tˈæn
كومىتېتى	kˌomɪtˈetɪ
خىتاي	χˈɪtɑj
قەبۇل	qˈæbul
بالام	bˈɑlɑm
كەلگەندىن	kælɡˈændɪn
ئارمىيە	ɑrmˈɪjæ
غەيرى	ʁˈæjrɪ
كەلسە	kˈælsæ
رايونلىرىنى	rˌɑjonlɪɾˈɪnɪ
ئورگىنى	orɡˈɪnɪ
سەلبىي	sˈælbɪj
ھەرىكەتچان	hˌæɾɪkˈætt͡ʃɑn
ماتېرىيال	mˌɑteɾˈɪjɑl
دېيىلىدىغان	dˌejɪlɪdˈɪʁɑn
چەكسىز	t͡ʃˈæksɪz
مەنە	mˈænæ
خىيال	χˈɪjɑl
سانىنى	sɑnˈɪnɪ
ئاسىيادىكى	ˌɑsɪjɑdˈɪkɪ
قىلغاندىن	qɪlʁˈɑndɪn
چىقىشقا	t͡ʃɪqˈɪʃqɑ
ئۇيغۇرلاردىكى	ˌujʁurlɑrdˈɪkɪ
سادىر	sˈɑdɪr
مەدىنە	mædˈɪnæ
ئورگىنىغا	ˌorɡɪnˈɪʁɑ
ئەسەرنىڭ	æsˈærnɪŋ
ئايلاندى	ɑjlˈɑndɪ
ئىنىسى	ɪnˈɪsɪ
غول	ʁˈol
نەتىجىلىرى	nˌætɪd͡ʒɪlˈɪɾɪ
تەڭلا	tˈæŋlɑ
بۆلەك	bˈœlæk
ئەركىن	ˈærkɪn
ئوتتۇز	ˈottuz
مارت	mˈɑrt
بەس	bˈæs
كېسىلىگە	kˌesɪlˈɪɡæ
كەمچىل	kˈæmt͡ʃɪl
بىرخىل	bˈɪrχɪl
بولىۋېرىدۇ	bˌolɪweɾˈɪdu
گۈزەللىك	ɡyzˈællɪk
مىللەتتىن	mɪllˈættɪn
ھالىتىگە	hˌɑlɪtˈɪɡæ
گويا	ɡˈojɑ
قىزىقارلىق	qˌɪzɪqˈɑrlɪq
كېچىسى	ket͡ʃˈɪsɪ
ئو	ˈo
شارائىتى	ʃˌɑɾɑˈɪtɪ
مېۋە	mˈewæ
شىنجاڭدىكى	ʃˌɪnd͡ʒɑŋdˈɪkɪ
مەكتەپ	mˈæktæp
ۋەزىپە	wæzˈɪpæ
باغلىنىشلىق	bˌɑʁlɪnˈɪʃlɪq
دىئابېت	dɪˈɑbet
تەييارلاش	tæjjˈɑrlɑʃ
كۆزى	kˈœzɪ
تۈزۈم	tˈyzym
قاتارلىقلارغا	qˌɑtɑrlɪqlˈɑrʁɑ
تېرىلغۇ	teɾˈɪlʁu
سۇلالىسىنى	sˌulɑlɪsˈɪnɪ
قۇرۇقلۇق	quɾˈuqluq
ئىبادەت	ɪbˈɑdæt
كەرىم	kˈæɾɪm
يەرلىك	jˈærlɪk
ناھىيىگە	nˌɑhɪjˈɪɡæ
نۆۋەتتە	nœwˈættæ
سۆزلىگەن	sœzlˈɪɡæn
ئەپەندى	æpˈændɪ
ھەقىقەتكە	hˌæqɪqˈætkæ
تۆۋەندىكىدەك	tˌœwændɪkˈɪdæk
تەقۋىم	tˈæqwɪm
خىتايغا	χɪtˈɑjʁɑ
دۇنيادىن	dunjˈɑdɪn
سابىق	sˈɑbɪq
ھۆكۈمىتىگە	hˌœkymɪtˈɪɡæ
سۆزنىڭ	sˈœznɪŋ
شىركەتنىڭ	ʃɪrkˈætnɪŋ
ئۇنىۋېرسىتېتىنىڭ	ˌunɪwˌersɪtetˈɪnɪŋ
كىشىلىرى	kˌɪʃɪlˈɪɾɪ
قويدۇم	qˈojdum
دۇنياسىنىڭ	dˌunjɑsˈɪnɪŋ
بولۇپلا	bolˈuplɑ
كومپيۇتېر	kompjˈuter
قولىنى	qolˈɪnɪ
خېرىدار	χeɾˈɪdɑr
فىزىكىسى	fˌɪzɪkˈɪsɪ
كەسىپ	kˈæsɪp
غۇلجا	ʁˈuld͡ʒɑ
پەرق	pˈærq
تۈركىيەگە	tˌyrkɪjˈæɡæ
مەشغۇلات	mæʃʁˈulɑt
ئالىدۇ	ɑlˈɪdu
ئېلخەت	ˈelχæt
سىمسىز	sˈɪmsɪz
بىرلىككە	bɪrlˈɪkkæ
ئارىلىشىپ	ˌɑɾɪlˈɪʃɪp
مەركىزى	mærkˈɪzɪ
سېپىپ	sˈepɪp
پاراڭلىشىپ	pˌɑɾɑŋlˈɪʃɪp
ئوغۇللار	oʁˈullɑr
ئايدىن	ˈɑjdɪn
ئوخشىمايدىغان	ˌoχʃɪmɑjdˈɪʁɑn
بەرگۈچى	bærɡˈyt͡ʃɪ
ئۆلچەملىك	œlt͡ʃˈæmlɪk
زاپاس	zˈɑpɑs
باشقىلار	bɑʃqˈɪlɑr
ئەرەبچە	æɾˈæbt͡ʃæ
دېگەنگە	deɡˈænɡæ
ھالەتكە	hɑlˈætkæ
كېلىشىمى	kˌelɪʃˈɪmɪ
ئىلمىي	ˈɪlmɪj
باياشات	bɑjˈɑʃɑt
قارىتىلغان	qˌɑɾɪtˈɪlʁɑn
ئۇيغۇرلارمۇ	ˌujʁurlˈɑrmu
كۈمۈش	kˈymyʃ
مىللەتنى	mɪllˈætnɪ
مۇئەللىم	muˈællɪm
ئاي	ˈɑj
كۆڭۈل	kˈœŋyl
بەلگىلەنگەن	bˌælɡɪlˈænɡæn
ئابدۇرراھمان	ˌɑbdurrˈɑhmɑn
مەھكىمىسىگە	mˌæhkɪmɪsˈɪɡæ
گېنېرال	ɡenˈeɾɑl
كۈچى	kˈyt͡ʃɪ
مۇنارى	munˈɑɾɪ
مۇناسىۋەت	mˌunɑsˈɪwæt
مەڭگۈ	mˈæŋɡy
قازاقىستان	qˌɑzɑqˈɪstɑn
بار	bˈɑr
نۇسخىسىنى	nˌusχɪsˈɪnɪ
ئىگىسىنىڭ	ˌɪɡɪsˈɪnɪŋ
ئامېرىكىلىقلار	ˌɑmeɾˌɪkɪlˈɪqlɑr
ھېسسىيات	hessˈɪjɑt
تۇرغۇن	tˈurʁun
بېرىلغان	beɾˈɪlʁɑn
ئېغىز	ˈeʁɪz
ئۈستىگە	ystˈɪɡæ
بىرسى	bˈɪrsɪ
تاشلايدۇ	tɑʃlˈɑjdu
ھەلىق	hˈælɪq
پېئىل	pˈeɪl
مىراس	mˈɪɾɑs
تالانت	tˈɑlɑnt
ھىچ	hˈɪt͡ʃ
توختامى	toχtˈɑmɪ
مۇددەتلىك	muddˈætlɪk
ياغاچ	jˈɑʁɑt͡ʃ
كىرىپ	kˈɪɾɪp
ئەسلىدىكى	ˌæslɪdˈɪkɪ
ئۇنداق	ˈundɑq
دېگەندە	deɡˈændæ
شەھەردە	ʃæhˈærdæ
بۇنداق	bˈundɑq
يېزىلىق	jezˈɪlɪq
بويىچە	bojˈɪt͡ʃæ
شەھەرگە	ʃæhˈærɡæ
مېڭە	mˈeŋæ
ئارىلىنىڭ	ˌɑɾɪlˈɪnɪŋ
مۇدىرى	mudˈɪɾɪ
توپ	tˈop
ئورنىغا	ornˈɪʁɑ
جايى	d͡ʒˈɑjɪ
دىگەن	dˈɪɡæn
ئۇرۇشنى	uɾˈuʃnɪ
ئوقۇيدۇ	oqˈujdu
ئىنگىلىزچە	ˌɪnɡɪlˈɪzt͡ʃæ
شېئىرىي	ʃeˈɪɾɪj
تەتقىقاتلار	tˌætqɪqˈɑtlɑr
سۇنىڭ	sˈunɪŋ
قۇرۇلمىسىنى	qˌuɾulmɪsˈɪnɪ
باشلىقى	bɑʃlˈɪqɪ
قاتكۆك	qˈɑtkœk
قوراللىق	qoɾˈɑllɪq
ئەنگىلىيە	ˌænɡɪlˈɪjæ
شىركەتلەر	ʃɪrkˈætlær
قانۇنغا	qɑnˈunʁɑ
ئورۇنلاردىن	ˌoɾunlˈɑrdɪn
روھىي	rˈohɪj
نۇرغۇنلىغان	nˌurʁunlˈɪʁɑn
خەلقى	χˈælqɪ
تۈرتكىلىك	tyrtkˈɪlɪk
چىقىشنى	t͡ʃɪqˈɪʃnɪ
ئىشلىدى	ɪʃlˈɪdɪ
ئاچچىق	ˈɑt͡ʃt͡ʃɪq
خوتەنىينىڭ	χˌotænˈɪjnɪŋ
بارغان	bˈɑrʁɑn
ئالىملار	ɑlˈɪmlɑr
دېسە	dˈesæ
بەرمەيدۇ	bærmˈæjdu
ئۇيغۇرلاردىن	ˌujʁurlˈɑrdɪn
غەربكىچە	ʁærbkˈɪt͡ʃæ
داستىخان	dɑstˈɪχɑn
پۇرسەتتىن	pursˈættɪn
داۋام	dˈɑwɑm
خاتىرىلەنگەن	χˌɑtɪɾɪlˈænɡæn
پۈتتۈرگەن	pyttˈyrɡæn
پارسچە	pˈɑrst͡ʃæ
رەھمەتۇللا	rˌæhmætˈullɑ
ئارىلىقىدا	ˌɑɾɪlɪqˈɪdɑ
قوللىشىغا	qˌollɪʃˈɪʁɑ
تاقابىل	tɑqˈɑbɪl
پارلاق	pˈɑrlɑq
زاپىسى	zɑpˈɪsɪ
كاتولىك	kɑtˈolɪk
ئوتلاق	ˈotlɑq
قۇمۇل	qˈumul
ئەركەك	ˈærkæk
ئويۇن	ˈojun
كەچلىك	kˈæt͡ʃlɪk
موڭغۇللارنىڭ	mˌoŋʁullˈɑrnɪŋ
مەسىلە	mæsˈɪlæ
كېڭىشى	keŋˈɪʃɪ
ئىشىك	ˈɪʃɪk
پەرھات	pˈærhɑt
تېكىن	tˈekɪn
ئىچىدىلا	ˌɪt͡ʃɪdˈɪlɑ
قەيەردە	qæjˈærdæ
شەھىرىنى	ʃˌæhɪɾˈɪnɪ
ھاجىتى	hɑd͡ʒˈɪtɪ
ھەمكارلىشىپ	hˌæmkɑrlˈɪʃɪp
چىققاندىن	t͡ʃɪqqˈɑndɪn
قۇملۇق	qˈumluq
گەپلەرنى	ɡæplˈærnɪ
تۈركلەرنىڭ	tyrklˈærnɪŋ
پىسخىك	pˈɪsχɪk
كۈلكىلىك	kylkˈɪlɪk
قايتۇرۇپ	qɑjtˈuɾup
يەھۇدىي	jæhˈudɪj
نۇسخىسى	nusχˈɪsɪ
تەتقىقاتچى	tˌætqɪqˈɑtt͡ʃɪ
داۋاملاشتۇرۇش	dˌɑwɑmlɑʃtˈuɾuʃ
تەسىر	tˈæsɪr
يولىنىڭ	jolˈɪnɪŋ
تىزىمغا	tɪzˈɪmʁɑ
بۆلۈپ	bˈœlyp
ئالدىن	ˈɑldɪn
تۇپراققا	tuprˈɑqqɑ
روشەن	rˈoʃæn
تەرەپ	tˈæɾæp
خەنسۇچە	χænsˈut͡ʃæ
يېمەكلىك	jemˈæklɪk
مىكرو	mˈɪkro
پۇلىنى	pulˈɪnɪ
غەربىي	ʁˈærbɪj
پايدىلىنىش	pˌɑjdɪlˈɪnɪʃ
پەتىۋا	pætˈɪwɑ
قويۇلغان	qojˈulʁɑn
قوغلاپ	qˈoʁlɑp
توغرىسىدىكى	tˌoʁrɪsɪdˈɪkɪ
سالدى	sˈɑldɪ
مەھسۇلاتلىرى	mˌæhsulɑtlˈɪɾɪ
ئوتنى	ˈotnɪ
بۇنىڭدا	bunˈɪŋdɑ
يەنىمۇ	jænˈɪmu
جەنۇبىدىكى	d͡ʒˌænubɪdˈɪkɪ
ھالغا	hˈɑlʁɑ
نىمە	nˈɪmæ
ئەلا	ˈælɑ
تاۋۇشلار	tɑwˈuʃlɑr
ئېيتىلغان	ejtˈɪlʁɑn
قىلىشىدۇ	qˌɪlɪʃˈɪdu
بىلەنلا	bɪlˈænlɑ
قۇرۇلۇشلىرى	qˌuɾuluʃlˈɪɾɪ
بايرىمى	bɑjrˈɪmɪ
تارىخقا	tɑɾˈɪχqɑ
مۇھاكىمە	mˌuhɑkˈɪmæ
مۇسۇلمانلارغا	mˌusulmɑnlˈɑrʁɑ
قىرغىز	qˈɪrʁɪz
تۇتقۇن	tˈutqun
ئادەتتىكى	ˌɑdættˈɪkɪ
بىز	bˈɪz
دۇنياسىدا	dˌunjɑsˈɪdɑ
بولغانلىقتىن	bˌolʁɑnlˈɪqtɪn
يېڭى	jˈeŋɪ
ئىمتىھان	ɪmtˈɪhɑn
بۇلۇش	bˈuluʃ
قاراشلىرىنى	qˌɑɾɑʃlɪɾˈɪnɪ
ئۆتىشى	œtˈɪʃɪ
داموللام	dɑmˈollɑm
نەرسىنى	nærsˈɪnɪ
ئايرىپ	ˈɑjrɪp
دوتەي	dˈotæj
بىلىم	bˈɪlɪm
ئىتتىپاقى	ˌɪttɪpˈɑqɪ
شامال	ʃˈɑmɑl
زەھەرلىك	zæhˈærlɪk
قەدىمكى	qædˈɪmkɪ
يېتىپ	jˈetɪp
خەلقىگە	χælqˈɪɡæ
كېتىپ	kˈetɪp
بانكا	bˈɑnkɑ
توغرالغان	toʁrˈɑlʁɑn
بەدىنى	bædˈɪnɪ
خاقان	χˈɑqɑn
كەم	kˈæm
ئاساسىنى	ˌɑsɑsˈɪnɪ
يا	jˈɑ
ئوكيان	ˈokjɑn
تەڭكەش	tˈæŋkæʃ
يوقتۇر	jˈoqtur
ئوبرازىنى	ˌobrɑzˈɪnɪ
ھەقىقىي	hæqˈɪqɪj
موڭغۇلچە	moŋʁˈult͡ʃæ
تىللىرىنى	tˌɪllɪɾˈɪnɪ
ھېكايە	hekˈɑjæ
ھەتتا	hˈættɑ
جەنۇب	d͡ʒˈænub
سۈپەت	sˈypæt
ئالاقىلىشىش	ˌɑlɑqɪlˈɪʃɪʃ
كومپيوتېر	kompjˈoter
ئۇرۇشىدا	ˌuɾuʃˈɪdɑ
يۇقىرىدا	jˌuqɪɾˈɪdɑ
مىنگونىڭ	mɪnɡˈonɪŋ
ئورۇنغا	oɾˈunʁɑ
ئەمەلىي	æmˈælɪj
ئەپۇ	ˈæpu
بولىسىز	bolˈɪsɪz
چەك	t͡ʃˈæk
كېرەكلىك	keɾˈæklɪk
جۇ	d͡ʒˈu
نىشانى	nɪʃˈɑnɪ
سىرتقى	sˈɪrtqɪ
تىبەت	tˈɪbæt
بۈگۈنكى	byɡˈynkɪ
تۈمەن	tˈymæn
ساقلاشقا	sɑqlˈɑʃqɑ
ئوغلىنىڭ	oʁlˈɪnɪŋ
خەۋەر	χˈæwær
يېزىپ	jˈezɪp
بىزنىڭ	bˈɪznɪŋ
دۆلەتتە	dœlˈættæ
ئائىلىسىگە	ˌɑɪlɪsˈɪɡæ
تۇغۇت	tˈuʁut
ھەممىمىز	hæmmˈɪmɪz
دېمەك	dˈemæk
ئەسەرلەرنى	ˌæsærlˈærnɪ
ئىلاھى	ɪlˈɑhɪ
چۈشەندۈرۈپ	t͡ʃˌyʃændˈyɾyp
تۈرمىگە	tyrmˈɪɡæ
ئۇنىڭدا	unˈɪŋdɑ
ئاياللارغا	ˌɑjɑllˈɑrʁɑ
ئەيسا	ˈæjsɑ
ئارتۇق	ˈɑrtuq
ئۆستۈرۈلىدۇ	ˌœstyɾylˈɪdu
ئەگەر	ˈæɡær
ئۆتۈشكە	œtˈyʃkæ
بولىدۇ	bolˈɪdu
شېھىت	ʃˈehɪt
مەنزىرىسى	mˌænzɪɾˈɪsɪ
مالىك	mˈɑlɪk
چۈشۈپ	t͡ʃˈyʃyp
ئىجارىگە	ˌɪd͡ʒɑɾˈɪɡæ
رەھمەت	rˈæhmæt
مەسىلىلەرگە	mˌæsɪlɪlˈærɡæ
كەچتە	kˈæt͡ʃtæ
ئولتۇرۇپ	oltˈuɾup
پەسىل	pˈæsɪl
ئاتىلىدۇ	ˌɑtɪlˈɪdu
مەكتەپلەر	mæktˈæplær
خەنسۇ	χˈænsu
زىياننى	zɪjˈɑnnɪ
دىيارىدىكى	dˌɪjɑɾɪdˈɪkɪ
يامغۇر	jˈɑmʁur
يىللارغا	jɪllˈɑrʁɑ
ئۆزىنىڭ	œzˈɪnɪŋ
يېزىلىدۇ	jˌezɪlˈɪdu
دۆلىتىنى	dˌœlɪtˈɪnɪ
ئالغۇچى	ɑlʁˈut͡ʃɪ
قىزغا	qˈɪzʁɑ
جۈمە	d͡ʒˈymæ
ھادىسىسى	hˌɑdɪsˈɪsɪ
ۋەتەنگە	wætˈænɡæ
بەلگىلەش	bælɡˈɪlæʃ
نەزىر	nˈæzɪr
خەنسۇلار	χænsˈulɑr
ياشلىرى	jɑʃlˈɪɾɪ
چېچىنى	t͡ʃet͡ʃˈɪnɪ
شەرقىي	ʃˈærqɪj
شەخىس	ʃˈæχɪs
چىقىدۇ	t͡ʃɪqˈɪdu
قايناق	qˈɑjnɑq
خەلق	χˈælq
قوللىنىش	qollˈɪnɪʃ
ئالماشتۇرۇپ	ˌɑlmɑʃtˈuɾup
ئۆتكەن	ˈœtkæn
زىرە	zˈɪɾæ
تاكى	tˈɑkɪ
قېلىشتىن	qelˈɪʃtɪn
مەخپىي	mˈæχpɪj
قالىمىز	qɑlˈɪmɪz
دېگەندەك	deɡˈændæk
تۇرۇۋاتقان	tˌuɾuwˈɑtqɑn
نۆۋەت	nˈœwæt
تەرتىپ	tˈærtɪp
ئاساسلىقى	ˌɑsɑslˈɪqɪ
بۈگۈن	bˈyɡyn
پىششىق	pˈɪʃʃɪq
سالماقنى	sɑlmˈɑqnɪ
خانلىق	χˈɑnlɪq
بىئولوگىيە	bˌɪoloɡˈɪjæ
مەملىكەت	mæmlˈɪkæt
ئائىلىگە	ˌɑɪlˈɪɡæ
زېمىنى	zemˈɪnɪ
بىراق	bˈɪɾɑq
سىرتقا	sˈɪrtqɑ
يان	jˈɑn
يالغۇز	jˈɑlʁuz
توپلىغان	toplˈɪʁɑn
بايقالغان	bɑjqˈɑlʁɑn
توغرا	tˈoʁrɑ
قارىشىنى	qˌɑɾɪʃˈɪnɪ
جايلاردىكى	d͡ʒˌɑjlɑrdˈɪkɪ
ھورمۇن	hˈormun
ئۆسۈملۈكنىڭ	ˌœsymlˈyknɪŋ
باقايلى	bɑqˈɑjlɪ
بىرىدۇ	bɪɾˈɪdu
ئويلىغان	ojlˈɪʁɑn
كىرگەندە	kɪrɡˈændæ
خاڭگۇڭ	χˈɑŋɡuŋ
ئۇچ	ˈut͡ʃ
قىسمىدا	qɪsmˈɪdɑ
قالمىغان	qɑlmˈɪʁɑn
يار	jˈɑr
كۈچكە	kˈyt͡ʃkæ
تۈرگە	tˈyrɡæ
ئادا	ˈɑdɑ
مەزمۇن	mˈæzmun
كۆرۈنەرلىك	kˌœɾynˈærlɪk
نارازى	nɑɾˈɑzɪ
ئەجدادلىرىمىز	ˌæd͡ʒdɑdlɪɾˈɪmɪz
باشتا	bˈɑʃtɑ
ئىجابىي	ɪd͡ʒˈɑbɪj
قەھرىمان	qæhrˈɪmɑn
ئۈچ	ˈyt͡ʃ
قارى	qˈɑɾɪ
بېرىدىغان	bˌeɾɪdˈɪʁɑn
پىشىپ	pˈɪʃɪp
ئىشتىن	ˈɪʃtɪn
ھىجرەت	hˈɪd͡ʒræt
قالدۇرغان	qɑldˈurʁɑn
ئۇسۇل	ˈusul
ئەتراپتىكى	ˌætrɑptˈɪkɪ
دېگەنلىكتۇر	dˌeɡænlˈɪktur
مەزگىللەردە	mˌæzɡɪllˈærdæ
خەتەرلىك	χætˈærlɪk
ئى	ˈɪ
شىنجاڭدا	ʃɪnd͡ʒˈɑŋdɑ
ھەرىكەتكە	hˌæɾɪkˈætkæ
شائىر	ʃˈɑɪr
مەخسۇس	mˈæχsus
شىمال	ʃˈɪmɑl
زۇلۇم	zˈulum
چامغۇر	t͡ʃˈɑmʁur
ئامېرىكىدىكى	ˌɑmeɾˌɪkɪdˈɪkɪ
قايتىپ	qˈɑjtɪp
يېقىملىق	jeqˈɪmlɪq
باغلىق	bˈɑʁlɪq
نازارەت	nɑzˈɑɾæt
قورالى	qoɾˈɑlɪ
مۇۋاپىق	muwˈɑpɪq
مىڭدىن	mˈɪŋdɪn
كېسىم	kˈesɪm
ئۆلكىسى	œlkˈɪsɪ
سۈرىدۇ	syɾˈɪdu
قولىدا	qolˈɪdɑ
يېزىقنى	jezˈɪqnɪ
ئېينىشتىيىن	ˌejnɪʃtˈɪjɪn
دۆلىتى	dœlˈɪtɪ
قارىتىپ	qɑɾˈɪtɪp
ئاق	ˈɑq
ئۇلارنى	ulˈɑrnɪ
قۇرئاندا	quɾˈɑndɑ
مۇكاپات	mukˈɑpɑt
تاغقا	tˈɑʁqɑ
زىيىنى	zɪjˈɪnɪ
بىرىنچى	bɪɾˈɪnt͡ʃɪ
بىرىنىڭ	bɪɾˈɪnɪŋ
دېمەكچى	demˈækt͡ʃɪ
خەۋپ	χˈæwp
سۈپەتلىك	sypˈætlɪk
سىر	sˈɪr
ۋاقىتلىق	wɑqˈɪtlɪq
چېپىپ	t͡ʃˈepɪp
كوماندا	komˈɑndɑ
چىقىشى	t͡ʃɪqˈɪʃɪ
زاماندا	zɑmˈɑndɑ
مۇسابىقە	mˌusɑbˈɪqæ
قانداقمۇ	qɑndˈɑqmu
مۇھەممەد	muhˈæmmæd
تەتقىقات	tætqˈɪqɑt
ھەدىسنىڭ	hædˈɪsnɪŋ
ماقالە	mɑqˈɑlæ
شۇغۇللىنىدۇ	ʃˌuʁullɪnˈɪdu
پائالىيىتى	pˌɑɑlɪjˈɪtɪ
يۈزلەنگەن	jyzlˈænɡæn
ئەجدادلىرىمىزنىڭ	ˌæd͡ʒdɑdlˌɪɾɪmˈɪznɪŋ
ئىسلامىي	ɪslˈɑmɪj
ئىقلىم	ˈɪqlɪm
ئارام	ˈɑɾɑm
ئاساسىدىكى	ˌɑsɑsɪdˈɪkɪ
ئالدىم	ˈɑldɪm
سورۇن	sˈoɾun
بۇندىن	bˈundɪn
سىرت	sˈɪrt
قانۇندىكى	qˌɑnundˈɪkɪ
كۆڭلىڭىزدە	kˌœŋlɪŋˈɪzdæ
قىزلارنىڭ	qɪzlˈɑrnɪŋ
مەنىسى	mænˈɪsɪ
بەردىم	bˈærdɪm
ئەۋلادلىرى	ˌæwlɑdlˈɪɾɪ
خەنزۇلار	χænzˈulɑr
تۇتىشىدۇ	tˌutɪʃˈɪdu
كاڭشىنىڭ	kɑŋʃˈɪnɪŋ
ئىمپېرىيىسىنىڭ	ˌɪmpeɾˌɪjɪsˈɪnɪŋ
ياشاشقا	jɑʃˈɑʃqɑ
مەلۇماتلار	mˌælumˈɑtlɑr
ئۆزلۈكىدىن	ˌœzlykˈɪdɪn
تۈركىستان	tyrkˈɪstɑn
بىرلەشكەن	bɪrlˈæʃkæn
يىلنى	jˈɪlnɪ
ئىراننىڭ	ɪɾˈɑnnɪŋ
ئاۋام	ˈɑwɑm
زىيانغا	zɪjˈɑnʁɑ
دىنغا	dˈɪnʁɑ
ئالىم	ˈɑlɪm
پەرقلىنىپ	pærqlˈɪnɪp
ھۆر	hˈœr
قانۇننى	qɑnˈunnɪ
كۈلۈپ	kˈylyp
توسالغۇ	tosˈɑlʁu
بۇلارنى	bulˈɑrnɪ
بولالمايدۇ	bˌolɑlmˈɑjdu
بولىدىكەن	bˌolɪdˈɪkæn
قائىدە	qɑˈɪdæ
ئۇستا	ˈustɑ
ئەزالىرى	ˌæzɑlˈɪɾɪ
شۇنىڭدىن	ʃunˈɪŋdɪn
توپلانغان	toplˈɑnʁɑn
مىقياسىدا	mˌɪqjɑsˈɪdɑ
تىللاردا	tɪllˈɑrdɑ
ئىجارە	ɪd͡ʒˈɑɾæ
بالىلارغا	bˌɑlɪlˈɑrʁɑ
قۇش	qˈuʃ
نۇتۇق	nˈutuq
مەدىنىدە	mˌædɪnˈɪdæ
قەبرە	qˈæbræ
مۇنار	mˈunɑr
جىنايەت	d͡ʒɪnˈɑjæt
تېرىقچىلىق	tˌeɾɪqt͡ʃˈɪlɪq
يالغان	jˈɑlʁɑn
ئېھتىماللىقى	ˌehtɪmɑllˈɪqɪ
توختىتىش	toχtˈɪtɪʃ
ئېلېكتىر	elˈektɪr
تەكشۈرۈش	tækʃˈyɾyʃ
قانلىق	qˈɑnlɪq
گۈرۈچ	ɡˈyɾyt͡ʃ
تەشكىلاتنىڭ	tˌæʃkɪlˈɑtnɪŋ
تارتىشش	tˈɑrtɪʃʃ
مېيىپلەر	mejˈɪplær
چەتئەل	t͡ʃˈætæl
مەغلۇبىيەتكە	mˌæʁlubɪjˈætkæ
ھەيدەش	hˈæjdæʃ
كىرگۈزۈپ	kɪrɡˈyzyp
ئۇسۇلى	usˈulɪ
غايە	ʁˈɑjæ
ئېھتىمال	ehtˈɪmɑl
دەيمەن	dˈæjmæn
ئەسلى	ˈæslɪ
ئوقۇرمەنلەر	ˌoqurmˈænlær
ناملىرى	nɑmlˈɪɾɪ
يېشىدا	jeʃˈɪdɑ
بېشىدا	beʃˈɪdɑ
ئايلاندۇرۇپ	ˌɑjlɑndˈuɾup
ئۇچىغا	ut͡ʃˈɪʁɑ
مودا	mˈodɑ
بىلەن	bˈɪlæn
ئاخىرى	ɑχˈɪɾɪ
قايسى	qˈɑjsɪ
ئەمەلدار	æmˈældɑr
مۇھاپىزەت	mˌuhɑpˈɪzæt
جۇڭغار	d͡ʒˈuŋʁɑr
ئىشلەتكەن	ɪʃlˈætkæn
باسقۇچقا	bɑsqˈut͡ʃqɑ
دۆلەتلىرىدە	dˌœlætlɪɾˈɪdæ
ھەمراھ	hˈæmrɑh
شىسى	ʃˈɪsɪ
ساھەسى	sɑhˈæsɪ
كۈچ	kˈyt͡ʃ
ئا	ˈɑ
ئاۋارە	ɑwˈɑɾæ
كۆچۈرۈپ	kœt͡ʃˈyɾyp
ھەق	hˈæq
خانىمنىڭ	χɑnˈɪmnɪŋ
ئوقۇغۇچىلارغا	ˌoquʁˌut͡ʃɪlˈɑrʁɑ
بېكىتىش	bekˈɪtɪʃ
جەننەت	d͡ʒˈænnæt
تۈزۈمنىڭ	tyzˈymnɪŋ
باقتىم	bˈɑqtɪm
مەنبەسى	mænbˈæsɪ
ئوتتۇرىسىغا	ˌottuɾɪsˈɪʁɑ
قاراڭغۇ	qɑɾˈɑŋʁu
پروفېسسور	profˈessor
ئىچىدىن	ɪt͡ʃˈɪdɪn
قىلىنغان	qɪlˈɪnʁɑn
تۈردىكى	tyrdˈɪkɪ
ئىنتېرنېت	ɪntˈernet
قارىماي	qɑɾˈɪmɑj
ماخمۇت	mˈɑχmut
دېھقانچىلىق	dˌehqɑnt͡ʃˈɪlɪq
بېرىلىشى	bˌeɾɪlˈɪʃɪ
ھېكايىسى	hˌekɑjˈɪsɪ
ئىككىگە	ɪkkˈɪɡæ
يۈزىسىدىن	jˌyzɪsˈɪdɪn
ئىشەنچ	ˈɪʃænt͡ʃ
مىس	mˈɪs
كىلىماتى	kˌɪlɪmˈɑtɪ
ئۈزىنى	yzˈɪnɪ
ھۆرمەت	hˈœrmæt
جايلاشقان	d͡ʒɑjlˈɑʃqɑn
پاتېنت	pˈɑtent
باققان	bˈɑqqɑn
تەۋسىيە	tæwsˈɪjæ
ئىمان	ˈɪmɑn
گۈللىنىش	ɡyllˈɪnɪʃ
دەيدىغان	dæjdˈɪʁɑn
مەمتېلى	mæmtˈelɪ
مەسىلىسىنى	mˌæsɪlɪsˈɪnɪ
قوشۇلۇپ	qoʃˈulup
ھۆكۈمەتكە	hˌœkymˈætkæ
تۇرمۇشتا	turmˈuʃtɑ
يازغۇچىلار	jˌɑzʁut͡ʃˈɪlɑr
سوقۇپ	sˈoqup
جەمئىيەتتىكى	d͡ʒˌæmɪjættˈɪkɪ
چۈشتى	t͡ʃˈyʃtɪ
ئۇنداقتا	undˈɑqtɑ
شېكەر	ʃˈekær
مەپكۇرە	mæpkˈuɾæ
مىسىرنىڭ	mɪsˈɪrnɪŋ
مىڭ	mˈɪŋ
كونكرېت	kˈonkret
پۇرچاق	pˈurt͡ʃɑq
غولى	ʁˈolɪ
ئوقۇدى	oqˈudɪ
تىز	tˈɪz
ئىككىنجى	ɪkkˈɪnd͡ʒɪ
كۆرۈشكە	kœɾˈyʃkæ
ھالال	hˈɑlɑl
ئاتاپ	ˈɑtɑp
ياردەم	jˈɑrdæm
يېنىغا	jenˈɪʁɑ
شۇڭا	ʃˈuŋɑ
ھەيئىتى	hæjˈɪtɪ
قان	qˈɑn
لۇت	lˈut
رەڭگارەڭ	ræŋɡˈɑɾæŋ
ئەينەك	ˈæjnæk
دىننى	dˈɪnnɪ
پارىسچە	pɑɾˈɪst͡ʃæ
جۇڭگودا	d͡ʒuŋɡˈodɑ
دەپلا	dˈæplɑ
ئەزىز	ˈæzɪz
بەلگىلىمىلەر	bˌælɡɪlɪmˈɪlær
بېرىشنى	beɾˈɪʃnɪ
رۇمى	rˈumɪ
كۆك	kˈœk
ئەلچى	ˈælt͡ʃɪ
ئۆزگىرىشلەر	ˌœzɡɪɾˈɪʃlær
تۈركىستاننى	tˌyrkɪstˈɑnnɪ
قوماندانى	qˌomɑndˈɑnɪ
سوراپ	sˈoɾɑp
كەمسىتىش	kæmsˈɪtɪʃ
ئۆزۈمنى	œzˈymnɪ
مىلادىنىڭ	mˌɪlɑdˈɪnɪŋ
ئەسەرلىرىنىڭ	ˌæsærlɪɾˈɪnɪŋ
ئەھۋاللارنى	ˌæhwɑllˈɑrnɪ
دۇچ	dˈut͡ʃ
ئەھۋالىنى	ˌæhwɑlˈɪnɪ
قۇلاق	qˈulɑq
قازاق	qˈɑzɑq
جاۋاپ	d͡ʒˈɑwɑp
تارماق	tˈɑrmɑq
ساندىكى	sɑndˈɪkɪ
ئەلۋەتتە	ælwˈættæ
تالىشىش	tɑlˈɪʃɪʃ
تەرەپتىن	tæɾˈæptɪn
ئارسلان	ˈɑrslɑn
تەركىپ	tˈærkɪp
لايىق	lˈɑjɪq
ئىجازەت	ɪd͡ʒˈɑzæt
ھاۋاسى	hɑwˈɑsɪ
سىرتىدىكى	sˌɪrtɪdˈɪkɪ
ئېلىمىزنىڭ	ˌelɪmˈɪznɪŋ
ئىجادىي	ɪd͡ʒˈɑdɪj
دېرەك	dˈeɾæk
ساۋاتسىز	sɑwˈɑtsɪz
ئۆزۈمنىڭ	œzˈymnɪŋ
ھاياتىنىڭ	hˌɑjɑtˈɪnɪŋ
قىلىنىدىغان	qˌɪlɪnɪdˈɪʁɑn
ئۇچۇرلارنى	ˌut͡ʃurlˈɑrnɪ
كۈنجۈت	kˈynd͡ʒyt
ئوقۇرمەنلەرگە	ˌoqurmænlˈærɡæ
يىللاردا	jɪllˈɑrdɑ
يېرىم	jˈeɾɪm
تەنلىكلەر	tænlˈɪklær
ئارالنىڭ	ɑɾˈɑlnɪŋ
تارىخنىڭ	tɑɾˈɪχnɪŋ
مەغلۇپ	mˈæʁlup
سۈرئىتى	syɾˈɪtɪ
سىز	sˈɪz
ئېيتىدۇ	ejtˈɪdu
غەلىبە	ʁælˈɪbæ
كىرگۈزگەن	kɪrɡˈyzɡæn
ناملىق	nˈɑmlɪq
ئىسلامنى	ɪslˈɑmnɪ
قادىر	qˈɑdɪr
جۇڭگودىكى	d͡ʒˌuŋɡodˈɪkɪ
تەكلىپ	tˈæklɪp
رايوننىڭ	rɑjˈonnɪŋ
خاراكتېرلىك	χˌɑɾɑktˈerlɪk
ئەسىردە	æsˈɪrdæ
دۇنياۋى	dunjˈɑwɪ
ئاتىلىپ	ɑtˈɪlɪp
دۆلەتتىن	dœlˈættɪn
زېمىن	zˈemɪn
ماتېرىياللارنى	mˌɑteɾˌɪjɑllˈɑrnɪ
مۇشۇ	mˈuʃu
قارىشى	qɑɾˈɪʃɪ
رول	rˈol
ئاز	ˈɑz
بىردەك	bˈɪrdæk
باغلانغان	bɑʁlˈɑnʁɑn
نامەلۇم	nɑmˈælum
تالاش	tˈɑlɑʃ
سۇڭ	sˈuŋ
كېچە	kˈet͡ʃæ
مېڭىش	mˈeŋɪʃ
باشلىغان	bɑʃlˈɪʁɑn
دەۋىردە	dæwˈɪrdæ
دۈشمەن	dˈyʃmæn
سۆزدىن	sˈœzdɪn
تاڭ	tˈɑŋ
قارايدىغان	qˌɑɾɑjdˈɪʁɑn
دەخلى	dˈæχlɪ
كوچا	kˈot͡ʃɑ
يۈسۈپ	jˈysyp
لىنىيىسى	lˌɪnɪjˈɪsɪ
قىلسىڭىز	qɪlsˈɪŋɪz
نوقتىسىدىن	nˌoqtɪsˈɪdɪn
لىك	lˈɪk
ئىسا	ˈɪsɑ
ئۇلاردىن	ulˈɑrdɪn
جۈپ	d͡ʒˈyp
ئەھمىيەتكە	ˌæhmɪjˈætkæ
ئامالسىز	ɑmˈɑlsɪz
كىلومېتىر	kˌɪlomˈetɪr
يىگىرمە	jɪɡˈɪrmæ
قىلىدۇ	qɪlˈɪdu
خىزمىتى	χɪzmˈɪtɪ
ماقالىسى	mˌɑqɑlˈɪsɪ
سۆزلىرى	sœzlˈɪɾɪ
ئاياللارنىڭ	ˌɑjɑllˈɑrnɪŋ
ئىشىغا	ɪʃˈɪʁɑ
يۈزىدىن	jyzˈɪdɪn
ئوۋچىلىق	owt͡ʃˈɪlɪq
ياشايدىغان	jˌɑʃɑjdˈɪʁɑn
جەھەتتە	d͡ʒæhˈættæ
بولماقتا	bolmˈɑqtɑ
يىلىدىن	jɪlˈɪdɪn
ئارىدىن	ɑɾˈɪdɪn
سەپەر	sˈæpær
كومىتېت	komˈɪtet
باينىڭ	bˈɑjnɪŋ
ئەلگە	ˈælɡæ
سول	sˈol
ھىكايە	hɪkˈɑjæ
ئادەم	ˈɑdæm
تەرىپى	tæɾˈɪpɪ
كۆرۈش	kˈœɾyʃ
رايونىنىڭ	rˌɑjonˈɪnɪŋ
قاتار	qˈɑtɑr
ئىنقىلابىي	ˌɪnqɪlˈɑbɪj
ئاڭلايدىغان	ˌɑŋlɑjdˈɪʁɑn
سەل	sˈæl
ئايروپىلان	ˌɑjropˈɪlɑn
ئىپادىلىنىدۇ	ˌɪpɑdˌɪlɪnˈɪdu
ئاتىلىشى	ˌɑtɪlˈɪʃɪ
ئاپتونوم	ɑptˈonom
ئائىلىنىڭ	ˌɑɪlˈɪnɪŋ
ئىزدەش	ˈɪzdæʃ
مېنىڭ	mˈenɪŋ
بالىلىرى	bˌɑlɪlˈɪɾɪ
كۆزدە	kˈœzdæ
دۇنياغا	dunjˈɑʁɑ
ئەھۋالدا	æhwˈɑldɑ
ئورنىنى	ornˈɪnɪ
تەشۋىق	tˈæʃwɪq
شۆھرەت	ʃˈœhræt
ساق	sˈɑq
قىلىسىز	qɪlˈɪsɪz
قارىمۇچ	qɑɾˈɪmut͡ʃ
ياۋا	jˈɑwɑ
تارىخنى	tɑɾˈɪχnɪ
ھەممىنى	hæmmˈɪnɪ
ئادەمگە	ɑdˈæmɡæ
خوتۇن	χˈotun
ئەلدىكى	ældˈɪkɪ
جايدا	d͡ʒˈɑjdɑ
خۇسۇسىي	χusˈusɪj
قىتئەسى	qɪtˈæsɪ
باشلاپلا	bɑʃlˈɑplɑ
مېھرى	mˈehrɪ
بىردىن	bˈɪrdɪn
جىددىي	d͡ʒˈɪddɪj
دۇئا	dˈuɑ
كۆتۈرىدۇ	kˌœtyɾˈɪdu
مىللەتنىڭ	mɪllˈætnɪŋ
ئىقتىدارىنى	ˌɪqtɪdɑɾˈɪnɪ
جۇڭگو	d͡ʒˈuŋɡo
خېمىر	χˈemɪr
كۈنىنى	kynˈɪnɪ
قاش	qˈɑʃ
بەرسە	bˈærsæ
ئىچىدىكى	ˌɪt͡ʃɪdˈɪkɪ
ئامېرىكىدا	ˌɑmeɾɪkˈɪdɑ
ھۆكۈمىتىنىڭ	hˌœkymɪtˈɪnɪŋ
بۇزۇپ	bˈuzup
ئوسمان	ˈosmɑn
نازىل	nˈɑzɪl
ئادەمنى	ɑdˈæmnɪ
مۇنبەت	mˈunbæt
چۈنكى	t͡ʃˈynkɪ
كەلگەنىدى	kˌælɡænˈɪdɪ
تۈزۈپ	tˈyzyp
ئىشقا	ˈɪʃqɑ
توشقان	tˈoʃqɑn
مۈشۈك	mˈyʃyk
يۇقۇرى	juqˈuɾɪ
كىملىكىنى	kˌɪmlɪkˈɪnɪ
ماس	mˈɑs
ئەۋلىيا	æwlˈɪjɑ
ئۆلچىمى	œlt͡ʃˈɪmɪ
ئالامەتلەر	ˌɑlɑmˈætlær
ئاشتى	ˈɑʃtɪ
قىرىق	qˈɪɾɪq
قانچە	qˈɑnt͡ʃæ
كۆرە	kˈœɾæ
ئالقىشىغا	ˌɑlqɪʃˈɪʁɑ
چىقىۋاتقان	t͡ʃˌɪqɪwˈɑtqɑn
ئادەتكە	ɑdˈætkæ
ئاسىيا	ɑsˈɪjɑ
سورىدى	soɾˈɪdɪ
قېرىنداش	qeɾˈɪndɑʃ
قايتقاندىن	qɑjtqˈɑndɪn
تۈركلىرى	tyrklˈɪɾɪ
كۆرگەن	kˈœrɡæn
قورقۇپ	qˈorqup
بېشىدىكى	bˌeʃɪdˈɪkɪ
پاكىز	pˈɑkɪz
نۇرى	nˈuɾɪ
بىزمۇ	bˈɪzmu
ئەمما	ˈæmmɑ
قوللىنىلغان	qˌollɪnˈɪlʁɑn
ئۈستىدىن	ystˈɪdɪn
تېلېۋىزىيە	tˌelewɪzˈɪjæ
كۆتۈرۈلگەن	kˌœtyɾˈylɡæn
مەسئۇلىيىتى	mˌæsulɪjˈɪtɪ
ئېنىقلاش	enˈɪqlɑʃ
ھەممەيلەن	hæmmˈæjlæn
ئىلمى	ˈɪlmɪ
ھارام	hˈɑɾɑm
ئەرەبلەر	æɾˈæblær
سۈپىتىدە	sˌypɪtˈɪdæ
مەھكەم	mˈæhkæm
ھوقۇقىدىن	hˌoquqˈɪdɪn
ئىزدىنىش	ɪzdˈɪnɪʃ
ئۇنىۋېرسىتېتى	ˌunɪwˌersɪtˈetɪ
ئىنتايىن	ɪntˈɑjɪn
ئوقۇتقۇچىلىق	ˌoqutqut͡ʃˈɪlɪq
ئايرىش	ˈɑjrɪʃ
كىتابىنى	kˌɪtɑbˈɪnɪ
س	s
لىبېرالىزم	lˌɪbeɾˈɑlɪzm
ھالبۇكى	hɑlbˈukɪ
رايونىدىكى	rˌɑjonɪdˈɪkɪ
ئۆتىدىغان	ˌœtɪdˈɪʁɑn
شەكىللىنىدۇ	ʃˌækɪllɪnˈɪdu
دادىسىنىڭ	dˌɑdɪsˈɪnɪŋ
يات	jˈɑt
ئەركىنلىك	ærkˈɪnlɪk
زۇڭتۇڭ	zˈuŋtuŋ
نىشانغا	nɪʃˈɑnʁɑ
كادىر	kˈɑdɪr
سۈننەت	sˈynnæt
قويدى	qˈojdɪ
مېھمان	mˈehmɑn
ئورۇننىڭ	oɾˈunnɪŋ
نان	nˈɑn
لوپنۇر	lˈopnur
پادىشاھلىق	pˌɑdɪʃˈɑhlɪq
بىلمەيدىغان	bˌɪlmæjdˈɪʁɑn
شەكلىگە	ʃæklˈɪɡæ
تۇتىدۇ	tutˈɪdu
تايانغان	tɑjˈɑnʁɑn
ئاخىرلىشىدۇ	ˌɑχɪrlɪʃˈɪdu
تۇرۇپتۇ	tuɾˈuptu
ئىپادىلەنگەن	ˌɪpɑdɪlˈænɡæn
تېخنىكىسى	tˌeχnɪkˈɪsɪ
پىلانى	pɪlˈɑnɪ
ئەھۋالىغا	ˌæhwɑlˈɪʁɑ
خىزمەت	χˈɪzmæt
سۈرگەن	sˈyrɡæn
ھەققىدىكى	hˌæqqɪdˈɪkɪ
مۇھىت	mˈuhɪt
ئىستىكى	ɪstˈɪkɪ
ئەلەيھىسسالام	ˌælæjhɪssˈɑlɑm
دەرسلىك	dˈærslɪk
قالدۇرىدۇ	qˌɑlduɾˈɪdu
رادىيو	rɑdˈɪjo
بۇددا	bˈuddɑ
شەرقتىكى	ʃærqtˈɪkɪ
ئادەملەر	ɑdˈæmlær
ئوتتۇرىسىدا	ˌottuɾɪsˈɪdɑ
دائىرائىقىدا	dˌɑɪɾˌɑɪqˈɪdɑ
مەكتەپلەرنىڭ	mˌæktæplˈærnɪŋ
مىنۇت	mˈɪnut
بىللە	bˈɪllæ
ھەسرەت	hˈæsræt
پىچاق	pˈɪt͡ʃɑq
ئېشەك	ˈeʃæk
رايوندىكى	rˌɑjondˈɪkɪ
قويىدۇ	qojˈɪdu
مۇز	mˈuz
تۇرۇشى	tuɾˈuʃɪ
ئاساس	ˈɑsɑs
قويۇپتۇ	qojˈuptu
جىق	d͡ʒˈɪq
تۈز	tˈyz
ھەسسە	hˈæssæ
رەسۇلۇللاھ	rˌæsulˈullɑh
ھېساب	hˈesɑb
ھىندىستاندا	hˌɪndɪstˈɑndɑ
كۆپۈنچە	kœpˈynt͡ʃæ
GPS	ɡps
تەييارلىغان	tˌæjjɑrlˈɪʁɑn
دىن	dˈɪn
كېلىدۇ	kelˈɪdu
مۇراسىمى	mˌuɾɑsˈɪmɪ
كۆلى	kˈœlɪ
ئادەمنىڭ	ɑdˈæmnɪŋ
ئارقىلىقلا	ˌɑrqɪlˈɪqlɑ
ئانىنىڭ	ɑnˈɪnɪŋ
بوۋىسى	bowˈɪsɪ
ھەمكارلىق	hæmkˈɑrlɪq
ياڭ	jˈɑŋ
قىلماقچى	qɪlmˈɑqt͡ʃɪ
تېغى	tˈeʁɪ
كېسەللىكلەر	kˌesællˈɪklær
قاقاس	qˈɑqɑs
كىشىلىك	kɪʃˈɪlɪk
ئوتتۇرا	ottˈuɾɑ
ئاشۇنداق	ɑʃˈundɑq
ئىقتىدار	ɪqtˈɪdɑr
كلاسسىك	klˈɑssɪk
پۇلنى	pˈulnɪ
يەتكۈزۈش	jætkˈyzyʃ
ئوقۇتقۇچى	ˌoqutqˈut͡ʃɪ
نام	nˈɑm
دۆلەتلەردىكى	dˌœlætlærdˈɪkɪ
بېشى	bˈeʃɪ
گۆش	ɡˈœʃ
يىلدىن	jˈɪldɪn
بولسىلا	bolsˈɪlɑ
سەۋەبىنى	sˌæwæbˈɪnɪ
ئۇچۇش	ˈut͡ʃuʃ
ھەممىسى	hæmmˈɪsɪ
ئۈزۈم	ˈyzym
ئەقىلگە	æqˈɪlɡæ
داڭق	dˈɑŋq
ئۆسكەن	ˈœskæn
يېرىگە	jeɾˈɪɡæ
يىللىرى	jɪllˈɪɾɪ
يۇرت	jˈurt
بېرىشكە	beɾˈɪʃkæ
ئەبۇبەكرى	ˌæbubˈækrɪ
فارابى	fɑɾˈɑbɪ
ئاھالىلەر	ˌɑhɑlˈɪlær
ئۇستازى	ustˈɑzɪ
ئالاھىدىلىك	ˌɑlɑhɪdˈɪlɪk
پروگرامما	proɡrˈɑmmɑ
دوكتۇرلۇق	doktˈurluq
قۇدرەتلىك	qudrˈætlɪk
كۆرۈنىدۇ	kˌœɾynˈɪdu
بولغانلىقىنى	bˌolʁɑnlɪqˈɪnɪ
ئاشۇرۇش	ɑʃˈuɾuʃ
ۋاڭ	wˈɑŋ
ئىشلىتىلىدىغان	ˌɪʃlɪtˌɪlɪdˈɪʁɑn
پىلان	pˈɪlɑn
ھامىلدار	hɑmˈɪldɑr
كېسىلىنى	kˌesɪlˈɪnɪ
ئەتراپى	ætrˈɑpɪ
كىتابنىڭ	kɪtˈɑbnɪŋ
قويۇشقا	qojˈuʃqɑ
ئېرىشىپ	eɾˈɪʃɪp
كۋادرات	kwˈɑdrɑt
كۆزگە	kˈœzɡæ
ئايرىم	ˈɑjrɪm
قوشۇلىدۇ	qˌoʃulˈɪdu
يوللىرىنى	jˌollɪɾˈɪnɪ
ئۇششاق	ˈuʃʃɑq
ئىلتىماس	ɪltˈɪmɑs
ماڭغان	mˈɑŋʁɑn
ئۇيغۇرچىدا	ˌujʁurt͡ʃˈɪdɑ
ھەممىسىدە	hˌæmmɪsˈɪdæ
يىلى	jˈɪlɪ
دىققىتىنى	dˌɪqqɪtˈɪnɪ
خەق	χˈæq
بولماسلىقى	bˌolmɑslˈɪqɪ
ئويۇنغا	ojˈunʁɑ
ئاخىرقى	ɑχˈɪrqɪ
دېيىشكە	dejˈɪʃkæ
ۋىلايەتلىك	wˌɪlɑjˈætlɪk
كىلوگرام	kɪlˈoɡrɑm
خەۋىرى	χæwˈɪɾɪ
مۇزىكا	muzˈɪkɑ
قايتىش	qˈɑjtɪʃ
شىمالغا	ʃɪmˈɑlʁɑ
كۆپىنچە	kœpˈɪnt͡ʃæ
كەبى	kˈæbɪ
داۋاملىشىدۇ	dˌɑwɑmlɪʃˈɪdu
مىلادى	mɪlˈɑdɪ
دەرىجە	dæɾˈɪd͡ʒæ
مەپكۇرىنىڭ	mˌæpkuɾˈɪnɪŋ
يولدا	jˈoldɑ
چۆچەك	t͡ʃˈœt͡ʃæk
شۇنداقتىمۇ	ʃˌundɑqtˈɪmu
زەنجىۋىل	zænd͡ʒˈɪwɪl
تەييارلانغان	tˌæjjɑrlˈɑnʁɑn
بولۇپمۇ	bolˈupmu
ھاياتىدىكى	hˌɑjɑtɪdˈɪkɪ
ئەللەر	ˈællær
تور	tˈor
مۇڭلۇق	mˈuŋluq
يادرو	jˈɑdro
موھىم	mˈohɪm
غايەت	ʁˈɑjæt
قۇرئان	qˈuɾɑn
تىل	tˈɪl
چىڭ	t͡ʃˈɪŋ
چېدىر	t͡ʃˈedɪr
قەيت	qˈæjt
تەسىرى	tæsˈɪɾɪ
بېيجىڭدا	bejd͡ʒˈɪŋdɑ
ئايلىنىدۇ	ˌɑjlɪnˈɪdu
كان	kˈɑn
چۈشىدۇ	t͡ʃyʃˈɪdu
ئەۋلادى	æwlˈɑdɪ
تەسەۋۋۇر	tæsˈæwwur
سەۋەبتىن	sæwˈæbtɪn
قويۇشنى	qojˈuʃnɪ
ئىزدەپ	ˈɪzdæp
قۇردى	qˈurdɪ
مۇ	mˈu
ئامما	ˈɑmmɑ
مىقداردا	mɪqdˈɑrdɑ
قويسا	qˈojsɑ
ئۆزۈم	ˈœzym
توپلىمى	toplˈɪmɪ
كۆزىتىش	kœzˈɪtɪʃ
ھالەتتە	hɑlˈættæ
مەكتەپلەردە	mˌæktæplˈærdæ
سىنىپى	sɪnˈɪpɪ
ئىپادىلەيدۇ	ˌɪpɑdɪlˈæjdu
يارىدەم	jɑɾˈɪdæm
يۇمشاق	jˈumʃɑq
ياساش	jˈɑsɑʃ
ئىلان	ˈɪlɑn
مەنىنى	mænˈɪnɪ
X	χ
ئېغىر	ˈeʁɪr
تۇيغۇ	tˈujʁu
قىلىنغۇچى	qˌɪlɪnʁˈut͡ʃɪ
تاتلىق	tˈɑtlɪq
مۇتلەق	mˈutlæq
خەلقلەر	χˈælqlær
ئاللاھنىڭ	ɑllˈɑhnɪŋ
مۇراسىم	muɾˈɑsɪm
ئاتالغۇسى	ˌɑtɑlʁˈusɪ
موگۇ	mˈoɡu
ئەگىشىپ	æɡˈɪʃɪp
ھوقۇق	hˈoquq
كۈچىگە	kyt͡ʃˈɪɡæ
نەۋائىينىڭ	nˌæwɑˈɪjnɪŋ
ئەشۇ	ˈæʃu
ئاتىغان	ɑtˈɪʁɑn
شايار	ʃˈɑjɑr
دەرەخ	dˈæɾæχ
ئالىملارنىڭ	ˌɑlɪmlˈɑrnɪŋ
يېنىدا	jenˈɪdɑ
كامالەتكە	kˌɑmɑlˈætkæ
تىرىشقان	tɪɾˈɪʃqɑn
ئورخۇن	ˈorχun
پورتى	pˈortɪ
قوي	qˈoj
قىلغانلىقى	qˌɪlʁɑnlˈɪqɪ
كىملىك	kˈɪmlɪk
تۈزگەن	tˈyzɡæn
ئوقۇش	ˈoquʃ
سالام	sˈɑlɑm
تۇغقان	tˈuʁqɑn
قېنى	qˈenɪ
ئولتۇرغان	oltˈurʁɑn
جايلارغا	d͡ʒɑjlˈɑrʁɑ
تەس	tˈæs
سېرىق	sˈeɾɪq
قاتتىق	qˈɑttɪq
نومۇر	nˈomur
ئىدى	ˈɪdɪ
ئېيىنىڭ	ejˈɪnɪŋ
بولۇشى	bolˈuʃɪ
جۇڭگۇ	d͡ʒˈuŋɡu
بۇزۇلۇش	buzˈuluʃ
ئاساسىدا	ˌɑsɑsˈɪdɑ
نەپەر	nˈæpær
يىلغا	jˈɪlʁɑ
ھوقۇقىغا	hˌoquqˈɪʁɑ
ئورۇنلاشقان	ˌoɾunlˈɑʃqɑn
ئېدى	ˈedɪ
ئۆزلىرىنىڭ	ˌœzlɪɾˈɪnɪŋ
بېتى	bˈetɪ
ئايلاندۇرۇش	ˌɑjlɑndˈuɾuʃ
كۈننىڭ	kˈynnɪŋ
تەرەققىي	tæɾˈæqqɪj
قىلماي	qˈɪlmɑj
چاشقان	t͡ʃˈɑʃqɑn
ئوسمانلى	osmˈɑnlɪ
تەرپىدىن	tærpˈɪdɪn
يۈزىگە	jyzˈɪɡæ
قېزىلما	qezˈɪlmɑ
كېسەل	kˈesæl
بەلگىلىمە	bˌælɡɪlˈɪmæ
قۇدرەت	qˈudræt
شىركەتنى	ʃɪrkˈætnɪ
ئىگىلىك	ɪɡˈɪlɪk
ئاھالە	ɑhˈɑlæ
بۇرۇنقى	buɾˈunqɪ
ئۇقۇمى	uqˈumɪ
يەردە	jˈærdæ
ئالاھىدە	ˌɑlɑhˈɪdæ
تارتىپلا	tɑrtˈɪplɑ
مەنپەئەت	mænpˈææt
شارى	ʃˈɑɾɪ
ئىسىمنى	ɪsˈɪmnɪ
مېتر	mˈetr
ئۆتۈنۈپ	œtˈynyp
تۇرۇشقا	tuɾˈuʃqɑ
تىياتىر	tɪjˈɑtɪr
بېسىم	bˈesɪm
جەھەتتىن	d͡ʒæhˈættɪn
نۇقتىلىق	nuqtˈɪlɪq
نەرسە	nˈærsæ
تېشى	tˈeʃɪ
پىروگرامما	pˌɪɾoɡrˈɑmmɑ
شائىرى	ʃɑˈɪɾɪ
قانۇنىيىتى	qˌɑnunɪjˈɪtɪ
يوللار	jˈollɑr
باشقۇرۇش	bɑʃqˈuɾuʃ
ئۇيغۇرلۇق	ujʁˈurluq
ئەينى	ˈæjnɪ
قىممەتلىك	qɪmmˈætlɪk
قوللىنىدىغان	qˌollɪnɪdˈɪʁɑn
بىرنى	bˈɪrnɪ
بېقىپ	bˈeqɪp
نەقىل	nˈæqɪl
تولۇقسىز	tolˈuqsɪz
ساقلىنىش	sɑqlˈɪnɪʃ
سېلىنغان	selˈɪnʁɑn
كۆپلەپ	kˈœplæp
رەھبەرلىرى	rˌæhbærlˈɪɾɪ
تەشنا	tˈæʃnɑ
قەدىمقى	qædˈɪmqɪ
مەجبۇرىي	mæd͡ʒbˈuɾɪj
كۈندۇر	kˈyndur
دوستۇم	dˈostum
ئۆچمەنلىك	œt͡ʃmˈænlɪk
تارىخىدا	tˌɑɾɪχˈɪdɑ
شۇڭلاشقا	ʃuŋlˈɑʃqɑ
مەكتەپنى	mæktˈæpnɪ
پوقتانومۇرى	pˌoqtɑnomˈuɾɪ
مېنى	mˈenɪ
بۇ	bˈu
تارىختىن	tɑɾˈɪχtɪn
ئەۋلاد	ˈæwlɑd
چىڭگىزخاننىڭ	t͡ʃˌɪŋɡɪzχˈɑnnɪŋ
سۆزلەرنى	sœzlˈærnɪ
يۈەن	jˈyæn
كىردى	kˈɪrdɪ
بالىنىڭ	bɑlˈɪnɪŋ
تەپەككۈر	tæpˈækkyr
يېزىشنى	jezˈɪʃnɪ
ھېكمەت	hˈekmæt
ھە	hˈæ
توردا	tˈordɑ
جۇغراپىيە	d͡ʒˌuʁrɑpˈɪjæ
رىم	rˈɪm
رەسىمى	ræsˈɪmɪ
خادىملىرى	χˌɑdɪmlˈɪɾɪ
قۇمۇلغا	qumˈulʁɑ
مەنىۋى	mænˈɪwɪ
ئۈستى	ˈystɪ
تىخىمۇ	tɪχˈɪmu
خەلقىنىڭ	χælqˈɪnɪŋ
مېۋىسى	mewˈɪsɪ
تۇرۇش	tˈuɾuʃ
ھەرقانچە	hærqˈɑnt͡ʃæ
مائارىپنىڭ	mˌɑɑɾˈɪpnɪŋ
ئېتىبار	etˈɪbɑr
دەۋا	dˈæwɑ
ئىنقىلاب	ɪnqˈɪlɑb
شەرققە	ʃˈærqqæ
مېدىيا	medˈɪjɑ
ئۇممۇ	ˈummu
مۇناسىۋىتىنى	mˌunɑsˌɪwɪtˈɪnɪ
قاتارلىقلاردىن	qˌɑtɑrlɪqlˈɑrdɪn
ئايكۆل	ˈɑjkœl
رايونلاردا	rˌɑjonlˈɑrdɑ
بۇلاردىن	bulˈɑrdɪn
ئەپ	ˈæp
يېتەكچى	jetˈækt͡ʃɪ
تەنتەربىيە	tˌæntærbˈɪjæ
ئالغان	ˈɑlʁɑn
قارىشىچە	qˌɑɾɪʃˈɪt͡ʃæ
قارايتتى	qɑɾˈɑjttɪ
ئاكتىپ	ˈɑktɪp
تىلىنىڭ	tɪlˈɪnɪŋ
خۇددى	χˈuddɪ
ئۆزگىرىش	œzɡˈɪɾɪʃ
ئۇرۇش	ˈuɾuʃ
مۆھلەت	mˈœhlæt
مۇرات	mˈuɾɑt
ۋەزىر	wˈæzɪr
نامايان	nɑmˈɑjɑn
چەكلەنگەن	t͡ʃæklˈænɡæn
دېموكراتىك	dˌemokrˈɑtɪk
ھازىرقىدەك	hˌɑzɪrqˈɪdæk
ئاۋازى	ɑwˈɑzɪ
نىسبىتى	nɪsbˈɪtɪ
بالىلارنى	bˌɑlɪlˈɑrnɪ
دېگىنى	deɡˈɪnɪ
ئۆگەتكەن	œɡˈætkæn
مابەينىدە	mˌɑbæjnˈɪdæ
بولىشى	bolˈɪʃɪ
بۇلاق	bˈulɑq
ئىدىيىسى	ˌɪdɪjˈɪsɪ
تۇراتتى	tuɾˈɑttɪ
قارىتا	qɑɾˈɪtɑ
ئاشقازان	ɑʃqˈɑzɑn
باج	bˈɑd͡ʒ
بازار	bˈɑzɑr
قەبرىسى	qæbrˈɪsɪ
ھەمراھى	hæmrˈɑhɪ
يىپ	jˈɪp
ئالىمى	ɑlˈɪmɪ
كېلەتتى	kelˈættɪ
مايىل	mˈɑjɪl
جەمئىيىتىدە	d͡ʒˌæmɪjɪtˈɪdæ
تال	tˈɑl
فاتىمە	fɑtˈɪmæ
بولغان	bˈolʁɑn
پىكرى	pˈɪkrɪ
سىزدە	sˈɪzdæ
قولىدىكى	qˌolɪdˈɪkɪ
ئەسكىرى	æskˈɪɾɪ
كىشىنى	kɪʃˈɪnɪ
يېزىقچىلىق	jˌezɪqt͡ʃˈɪlɪq
كېسىلى	kesˈɪlɪ
يۈرۈش	jˈyɾyʃ
ئىستانسىسىنىڭ	ˌɪstɑnsɪsˈɪnɪŋ
ئىنقىلابى	ˌɪnqɪlˈɑbɪ
ئىنسانلارنىڭ	ˌɪnsɑnlˈɑrnɪŋ
ھىندىستان	hɪndˈɪstɑn
باسقۇچ	bˈɑsqut͡ʃ
خېمىرتۇرۇچ	χˌemɪrtˈuɾut͡ʃ
كۆرىدۇ	kœɾˈɪdu
قىلىنمايدۇ	qˌɪlɪnmˈɑjdu
گۇما	ɡˈumɑ
تۇرىدىغان	tˌuɾɪdˈɪʁɑn
كىلىپ	kˈɪlɪp
ساھەسىدىكى	sˌɑhæsɪdˈɪkɪ
ساھەدىكى	sˌɑhædˈɪkɪ
ئىستىمال	ɪstˈɪmɑl
پارچىسى	pɑrt͡ʃˈɪsɪ
تارتىپ	tˈɑrtɪp
ئىبنى	ˈɪbnɪ
باشچىلىقىدىكى	bˌɑʃt͡ʃɪlˌɪqɪdˈɪkɪ
يىلنىڭ	jˈɪlnɪŋ
ئاممىۋى	ɑmmˈɪwɪ
يىغىپ	jˈɪʁɪp
ئىسسىق	ˈɪssɪq
ئىلاھ	ˈɪlɑh
مەزمۇندىكى	mˌæzmundˈɪkɪ
قىلىپ	qˈɪlɪp
بارى	bˈɑɾɪ
يوقىتىپ	joqˈɪtɪp
قوبۇل	qˈobul
تائالا	tɑˈɑlɑ
ئوخشىمىغان	ˌoχʃɪmˈɪʁɑn
ئاسىيانىڭ	ˌɑsɪjˈɑnɪŋ
سىناق	sˈɪnɑq
قارشىلىق	qɑrʃˈɪlɪq
خەنچە	χˈænt͡ʃæ
كۆرسىتىدىغان	kˌœrsɪtɪdˈɪʁɑn
نۆۋەتلىك	nœwˈætlɪk
تەشكىلاتلار	tˌæʃkɪlˈɑtlɑr
قىزلار	qˈɪzlɑr
تارىخىي	tɑɾˈɪχɪj
تۇرپان	tˈurpɑn
يۈرەك	jˈyɾæk
رەئىس	rˈæɪs
تورى	tˈoɾɪ
قۇتۇلۇش	qutˈuluʃ
ئەخمەق	ˈæχmæq
سىنىڭ	sˈɪnɪŋ
تائالانىڭ	tˌɑɑlˈɑnɪŋ
مەۋجۇد	mˈæwd͡ʒud
پولات	pˈolɑt
گەندى	ɡˈændɪ
جەننەتكە	d͡ʒænnˈætkæ
نادىر	nˈɑdɪr
ئەسكەرلىرى	ˌæskærlˈɪɾɪ
تىياتىرى	tˌɪjɑtˈɪɾɪ
مەسىلىسىدە	mˌæsɪlɪsˈɪdæ
داموللا	dɑmˈollɑ
تېلېفون	telˈefon
تەتقىقاتى	tˌætqɪqˈɑtɪ
دەۋردە	dˈæwrdæ
ئەپەندىنىڭ	ˌæpændˈɪnɪŋ
تەلىپىنى	tˌælɪpˈɪnɪ
تاراتقۇلاردا	tˌɑɾɑtqulˈɑrdɑ
بېرىلدى	beɾˈɪldɪ
ئاكىسى	ɑkˈɪsɪ
توي	tˈoj
يەكەن	jˈækæn
جىڭ	d͡ʒˈɪŋ
باشقا	bˈɑʃqɑ
توققۇز	tˈoqquz
ئىستېمالچىلار	ˌɪstemɑlt͡ʃˈɪlɑr
بېرىشتىن	beɾˈɪʃtɪn
يىللار	jˈɪllɑr
ۋەقەسى	wæqˈæsɪ
تۈركلەر	tˈyrklær
خىزمەتچى	χɪzmˈætt͡ʃɪ
ئەخلاق	ˈæχlɑq
جىسىم	d͡ʒˈɪsɪm
تەرجىمە	tærd͡ʒˈɪmæ
ئۇچرىمايدۇ	ˌut͡ʃrɪmˈɑjdu
ئارا	ˈɑɾɑ
شىنجاڭنىڭ	ʃɪnd͡ʒˈɑŋnɪŋ
نېمىشقا	nemˈɪʃqɑ
ئۇچۇن	ˈut͡ʃun
ئۆتكۈزگەن	œtkˈyzɡæn
ئامىرىكا	ˌɑmɪɾˈɪkɑ
يۇقىرىقىدەك	jˌuqɪɾɪqˈɪdæk
كېرەك	kˈeɾæk
كۆلەمدە	kœlˈæmdæ
ھەقتىكى	hæqtˈɪkɪ
قۇتقۇزۇش	qutqˈuzuʃ
تىلى	tˈɪlɪ
ئىستراتېگىيەلىك	ˌɪstrɑtˌeɡɪjˈælɪk
ئەر	ˈær
كەڭلىكى	kæŋlˈɪkɪ
يۈزى	jˈyzɪ
بالىسىنى	bˌɑlɪsˈɪnɪ
يېزىشقا	jezˈɪʃqɑ
ھونلارنىڭ	honlˈɑrnɪŋ
يۈەندىن	jyˈændɪn
ھەسەن	hˈæsæn
قەغەز	qˈæʁæz
بالىڭىز	bɑlˈɪŋɪz
پۇقرالىق	puqrˈɑlɪq
مەككىگە	mækkˈɪɡæ
سىرتىدا	sɪrtˈɪdɑ
باراۋەر	bɑɾˈɑwær
تۆگە	tˈœɡæ
كۇب	kˈub
ئىرىشكەن	ɪɾˈɪʃkæn
چۈشىنىش	t͡ʃyʃˈɪnɪʃ
جەلپ	d͡ʒˈælp
مىقداردىكى	mˌɪqdɑrdˈɪkɪ
قالاتتى	qɑlˈɑttɪ
قازا	qˈɑzɑ
قاتلام	qˈɑtlɑm
قىلدۇرغان	qɪldˈurʁɑn
ئۆسۈملۈك	œsˈymlyk
بېجى	bˈed͡ʒɪ
ھەدىسلەر	hædˈɪslær
مەشھۇر	mˈæʃhur
ئەزا	ˈæzɑ
بىرلىكتە	bɪrlˈɪktæ
مىڭلىغان	mɪŋlˈɪʁɑn
شۇنداق	ʃˈundɑq
ئەۋزەل	ˈæwzæl
يېڭىشەھەر	jˌeŋɪʃˈæhær
مەدەنىيىتىنى	mˌædænˌɪjɪtˈɪnɪ
قارىغاندا	qˌɑɾɪʁˈɑndɑ
زەربە	zˈærbæ
چىڭگىزخان	t͡ʃɪŋɡˈɪzχɑn
ئېلىشنى	elˈɪʃnɪ
ئېيتىش	ˈejtɪʃ
يۆتكەپ	jˈœtkæp
كىتابتىكى	kˌɪtɑbtˈɪkɪ
ئاساستا	ɑsˈɑstɑ
قالغانلار	qɑlʁˈɑnlɑr
مىنگو	mˈɪnɡo
كالىنىڭ	kɑlˈɪnɪŋ
كىرگۈزۈلگەن	kˌɪrɡyzˈylɡæn
باردى	bˈɑrdɪ
كەتمەيدۇ	kætmˈæjdu
داستىخانغا	dˌɑstɪχˈɑnʁɑ
باشقىلارنىڭ	bˌɑʃqɪlˈɑrnɪŋ
نىڭ	nˈɪŋ
قالغاندا	qɑlʁˈɑndɑ
ھاكىم	hˈɑkɪm
قىلغۇچىلار	qˌɪlʁut͡ʃˈɪlɑr
شىڭ	ʃˈɪŋ
قەشقەرگە	qæʃqˈærɡæ
تۇتىشىپ	tutˈɪʃɪp
مىرزا	mˈɪrzɑ
مىللەتلەر	mɪllˈætlær
تاشقىرى	tɑʃqˈɪɾɪ
ماتېرىيالى	mˌɑteɾɪjˈɑlɪ
يولىغا	jolˈɪʁɑ
يېزىقىدا	jˌezɪqˈɪdɑ
تەپسىلى	tæpsˈɪlɪ
تار	tˈɑr
پرىنسىپى	prɪnsˈɪpɪ
چېتىگە	t͡ʃetˈɪɡæ
ساڭا	sˈɑŋɑ
باشقارمىسى	bˌɑʃqɑrmˈɪsɪ
ئەكىلىپ	ækˈɪlɪp
سېتىش	sˈetɪʃ
كۆلىمى	kœlˈɪmɪ
دائىر	dˈɑɪr
ۋاقىتنىڭ	wɑqˈɪtnɪŋ
دېھقان	dˈehqɑn
ئىزدەيدۇ	ɪzdˈæjdu
ئىستانبۇلدا	ˌɪstɑnbˈuldɑ
مۇكەممەل	mukˈæmmæl
مەنسۇپ	mˈænsup
ئوپتىكا	optˈɪkɑ
قۇرۇلغان	quɾˈulʁɑn
ئۆيدە	ˈœjdæ
تەقدىم	tˈæqdɪm
تېز	tˈez
ئورۇنلاشتۇرۇلغان	ˌoɾunlˌɑʃtuɾˈulʁɑn
ھۈجەيرە	hyd͡ʒˈæjræ
بارىن	bˈɑɾɪn
مېدىيانىڭ	mˌedɪjˈɑnɪŋ
تۇتقان	tˈutqɑn
ئورتاق	ˈortɑq
بايقىغان	bɑjqˈɪʁɑn
ھون	hˈon
جەريانىدا	d͡ʒˌærjɑnˈɪdɑ
ئېرىشتى	eɾˈɪʃtɪ
خاس	χˈɑs
قىلغانلار	qɪlʁˈɑnlɑr
شەخسىي	ʃˈæχsɪj
ھەيۋەتلىك	hæjwˈætlɪk
ئىدىقۇت	ɪdˈɪqut
ئۇقۇملار	uqˈumlɑr
زامان	zˈɑmɑn
يېزىش	jˈezɪʃ
چۈشىنىپ	t͡ʃyʃˈɪnɪp
يۈسۈپنىڭ	jysˈypnɪŋ
ئاپئاق	ˈɑpɑq
بىڭتۇەنى	bˌɪŋtuˈænɪ
ھېچكىم	hˈet͡ʃkɪm
پارچە	pˈɑrt͡ʃæ
جەمئىيەتشۇناسلىق	d͡ʒˌæmɪjˌætʃunˈɑslɪq
ئەمىر	ˈæmɪr
ئىقتىسادى	ˌɪqtɪsˈɑdɪ
يۈزىدە	jyzˈɪdæ
شۇنىڭدەك	ʃunˈɪŋdæk
دىننىڭ	dˈɪnnɪŋ
مۇئامىلە	mˌuɑmˈɪlæ
قويۇش	qˈojuʃ
ياش	jˈɑʃ
تەقسىم	tˈæqsɪm
ئۆگىنىشكە	ˌœɡɪnˈɪʃkæ
مۇھەممەت	muhˈæmmæt
پىياز	pˈɪjɑz
غۇلجىدىكى	ʁˌuld͡ʒɪdˈɪkɪ
بولۇشىدىن	bˌoluʃˈɪdɪn
ئاجىز	ˈɑd͡ʒɪz
ياتقان	jˈɑtqɑn
ئەندىشە	ændˈɪʃæ
مەشرەپكە	mæʃrˈæpkæ
بىخەۋەر	bɪχˈæwær
جاۋابكارلىقىنى	d͡ʒˌɑwɑbkˌɑrlɪqˈɪnɪ
مەھسۇلات	mæhsˈulɑt
باسىدۇ	bɑsˈɪdu
پۇتبول	pˈutbol
ئويۇنى	ojˈunɪ
تەدبىر	tˈædbɪr
دانا	dˈɑnɑ
سۈيىدىن	syjˈɪdɪn
كورلا	kˈorlɑ
ئىمام	ˈɪmɑm
ماقال	mˈɑqɑl
ئىشلەيدۇ	ɪʃlˈæjdu
ئوخشاش	ˈoχʃɑʃ
غايىنى	ʁɑjˈɪnɪ
سابىت	sˈɑbɪt
تارماقتا	tɑrmˈɑqtɑ
شىركەتلىرى	ʃˌɪrkætlˈɪɾɪ
بۇخارىي	buχˈɑɾɪj
ئانىلارنىڭ	ˌɑnɪlˈɑrnɪŋ
ئۆتۈشى	œtˈyʃɪ
دىپلوماتىيە	dˌɪplomɑtˈɪjæ
مەككە	mˈækkæ
ساھابە	sɑhˈɑbæ
جەمەتى	d͡ʒæmˈætɪ
ئىگىز	ˈɪɡɪz
سۈيى	sˈyjɪ
سۆزلەر	sˈœzlær
ئاسان	ˈɑsɑn
قىل	qˈɪl
جۈملە	d͡ʒˈymlæ
شەھىرىدە	ʃˌæhɪɾˈɪdæ
سۆزلەرنىڭ	sœzlˈærnɪŋ
ئوچۇق	ˈot͡ʃuq
سامان	sˈɑmɑn
شەرىقى	ʃæɾˈɪqɪ
رىشات	rˈɪʃɑt
مىلادىيە	mˌɪlɑdˈɪjæ
بولسىمۇ	bolsˈɪmu
ئەسەر	ˈæsær
پەلسەپە	pælsˈæpæ
ئۇچۇرلارنىڭ	ˌut͡ʃurlˈɑrnɪŋ
ئانچە	ˈɑnt͡ʃæ
پەرقلىق	pˈærqlɪq
مۇقام	mˈuqɑm
سۆز	sˈœz
ئېھتىياجلىق	ˌehtɪjˈɑd͡ʒlɪq
ئاڭلىق	ˈɑŋlɪq
سالاھىيىتىگە	sˌɑlɑhˌɪjɪtˈɪɡæ
شەكىللەندى	ʃˌækɪllˈændɪ
كەلگۈسىگە	kˌælɡysˈɪɡæ
ئاياللىرى	ˌɑjɑllˈɪɾɪ
ئىشىنىدۇ	ˌɪʃɪnˈɪdu
سۈت	sˈyt
ئامېرىكىغا	ˌɑmeɾɪkˈɪʁɑ
مەزگىللىك	mæzɡˈɪllɪk
پۈتتۈرۈپ	pyttˈyɾyp
ھەقىقەت	hæqˈɪqæt
قانداق	qˈɑndɑq
تەدرىجىي	tædrˈɪd͡ʒɪj
گەنسۇ	ɡˈænsu
قانۇنسىز	qɑnˈunsɪz
ئە	ˈæ
نەدىن	nˈædɪn
دەۋرىگە	dæwrˈɪɡæ
بىزدىن	bˈɪzdɪn
ئىشلىتىدىغان	ˌɪʃlɪtɪdˈɪʁɑn
قىممەت	qˈɪmmæt
چۈشۈرۈپ	t͡ʃyʃˈyɾyp
چەكلىك	t͡ʃˈæklɪk
يېرىمىنى	jˌeɾɪmˈɪnɪ
نەگە	nˈæɡæ
چىقتىم	t͡ʃˈɪqtɪm
ئېتىراپ	etˈɪɾɑp
تاغلىق	tˈɑʁlɪq
مۇلازىمەت	mˌulɑzˈɪmæt
دىكىبىخاھار	dˌɪkɪbɪχˈɑhɑr
ئاۋۇت	ˈɑwut
سى	sˈɪ
قوشۇنىنىڭ	qˌoʃunˈɪnɪŋ
يازىدۇ	jɑzˈɪdu
قالىمەن	qɑlˈɪmæn
نەقىشلەر	næqˈɪʃlær
ئىزى	ˈɪzɪ
ئەسىرى	æsˈɪɾɪ
قۇيۇلغان	qujˈulʁɑn
تىلنىڭ	tˈɪlnɪŋ
بولغانلارغا	bˌolʁɑnlˈɑrʁɑ
ئەسكەر	ˈæskær
يىغىلىپ	jɪʁˈɪlɪp
ئوڭۇشلۇق	oŋˈuʃluq
شەكلىدە	ʃæklˈɪdæ
شاگىرتى	ʃɑɡˈɪrtɪ
ئۈچۈن	ˈyt͡ʃyn
تارقىتىشقا	tˌɑrqɪtˈɪʃqɑ
ئوردا	ˈordɑ
تارىختىكى	tˌɑɾɪχtˈɪkɪ
سۈرە	sˈyɾæ
تۈركى	tˈyrkɪ
قارىماققا	qˌɑɾɪmˈɑqqɑ
ئاينىڭ	ˈɑjnɪŋ
سىرلىق	sˈɪrlɪq
ئەتكەن	ˈætkæn
شارىدىكى	ʃˌɑɾɪdˈɪkɪ
ھالىتىدە	hˌɑlɪtˈɪdæ
ھاياتنىڭ	hɑjˈɑtnɪŋ
ئۆزىڭىزنىڭ	ˌœzɪŋˈɪznɪŋ
تەشكىلات	tæʃkˈɪlɑt
پېداگوگىكا	pˌedɑɡoɡˈɪkɑ
ساختا	sˈɑχtɑ
كىشى	kˈɪʃɪ
بالىلىرىنى	bˌɑlɪlɪɾˈɪnɪ
يىغىندا	jɪʁˈɪndɑ
قايتا	qˈɑjtɑ
ئۆزبېكلەر	œzbˈeklær
رايونلار	rɑjˈonlɑr
ھاياتىنى	hˌɑjɑtˈɪnɪ
ئۆلۈم	ˈœlym
مۆتىدىل	mœtˈɪdɪl
كېلىدىغان	kˌelɪdˈɪʁɑn
كىرىشى	kɪɾˈɪʃɪ
چىن	t͡ʃˈɪn
تەييارلىق	tæjjˈɑrlɪq
ئۇرۇپ	ˈuɾup
ماددىنىڭ	mɑddˈɪnɪŋ
يۇقارقى	juqˈɑrqɪ
كورىيە	koɾˈɪjæ
مېھرىبانۇ	mˌehrɪbˈɑnu
بەھرىمەن	bæhrˈɪmæn
ما	mˈɑ
داۋاملاشقان	dˌɑwɑmlˈɑʃqɑn
سەۋەبلىك	sæwˈæblɪk
ئازاد	ˈɑzɑd
مۇسا	mˈusɑ
بۇلۇپ	bˈulup
تۇرمۇشقا	turmˈuʃqɑ
ئۇدا	ˈudɑ
بارات	bˈɑɾɑt
ماقالىلىرى	mˌɑqɑlɪlˈɪɾɪ
قاچا	qˈɑt͡ʃɑ
بىۋاستە	bɪwˈɑstæ
بايقايمىز	bɑjqˈɑjmɪz
تۈرك	tˈyrk
تەھلىل	tˈæhlɪl
تېمىغا	temˈɪʁɑ
گەپ	ɡˈæp
بېرىشىنى	bˌeɾɪʃˈɪnɪ
توك	tˈok
بەكلا	bˈæklɑ
گرام	ɡrˈɑm
كىلومەتەر	kˌɪlomˈætær
ئادەملەرنى	ˌɑdæmlˈærnɪ
شىمالىغا	ʃˌɪmɑlˈɪʁɑ
ئارىلىقى	ˌɑɾɪlˈɪqɪ
ئۇيغۇرلارنىڭ	ˌujʁurlˈɑrnɪŋ
ئايلىنىش	ɑjlˈɪnɪʃ
باسقان	bˈɑsqɑn
كىشىلەرنىڭ	kˌɪʃɪlˈærnɪŋ
ئۈچۈنلا	yt͡ʃˈynlɑ
قېلىشى	qelˈɪʃɪ
ئۆيگە	ˈœjɡæ
كونترول	kˈontrol
جايلىرىدا	d͡ʒˌɑjlɪɾˈɪdɑ
بېرى	bˈeɾɪ
تەيىنلەنگەن	tˌæjɪnlˈænɡæn
تەرىقىدە	tˌæɾɪqˈɪdæ
شۇنى	ʃˈunɪ
كىتاپ	kˈɪtɑp
خانغا	χˈɑnʁɑ
تىببىي	tˈɪbbɪj
ئۇچۇپ	ˈut͡ʃup
ئەمدىلا	æmdˈɪlɑ
تۈگەپ	tˈyɡæp
تۇرمۇش	tˈurmuʃ
بەشىنچى	bæʃˈɪnt͡ʃɪ
ئەي	ˈæj
زەيدىن	zˈæjdɪn
گېن	ɡˈen
چەمبەر	t͡ʃˈæmbær
قاغان	qˈɑʁɑn
ئېقىمى	eqˈɪmɪ
يولىدىكى	jˌolɪdˈɪkɪ
ۋەتەندە	wætˈændæ
مەكتەپتە	mæktˈæptæ
ئەمدى	ˈæmdɪ
ئېلىنىدۇ	ˌelɪnˈɪdu
ئۆز	ˈœz
كۆرۈنگەن	kœɾˈynɡæn
مۇستەقىل	mustˈæqɪl
ئەسكى	ˈæskɪ
ئەسىرنىڭ	æsˈɪrnɪŋ
قىسىملىق	qɪsˈɪmlɪq
يۇيۇپ	jˈujup
ئاھالىنىڭ	ˌɑhɑlˈɪnɪŋ
ئۆزگىچە	œzɡˈɪt͡ʃæ
خوجا	χˈod͡ʒɑ
ياز	jˈɑz
كىملىكى	kɪmlˈɪkɪ
ئۆگىنىدۇ	ˌœɡɪnˈɪdu
گەۋدە	ɡˈæwdæ
ئۈچىنچى	yt͡ʃˈɪnt͡ʃɪ
ژۇرنال	ʒˈurnɑl
بوشلۇقى	boʃlˈuqɪ
مەجبۇرىيىتىنى	mˌæd͡ʒbuɾˌɪjɪtˈɪnɪ
قالدۇق	qˈɑlduq
ئۆينىڭ	ˈœjnɪŋ
كەبىسە	kæbˈɪsæ
ئەنئەنىسى	ˌænænˈɪsɪ
ئىرقى	ˈɪrqɪ
سورايمەن	soɾˈɑjmæn
ئۇنىڭدىن	unˈɪŋdɪn
مانا	mˈɑnɑ
ئەسەرلەر	æsˈærlær
مۇھەببەت	muhˈæbbæt
ئاشقان	ˈɑʃqɑn
ئەرلەرنىڭ	ærlˈærnɪŋ
لەشكەر	lˈæʃkær
توختىماي	toχtˈɪmɑj
ئەھۋالغا	æhwˈɑlʁɑ
ھۆكۈمەتنىڭ	hˌœkymˈætnɪŋ
كېتەتتى	ketˈættɪ
قولغا	qˈolʁɑ
كى	kˈɪ
يول	jˈol
خەلىق	χˈælɪq
ئاتوم	ˈɑtom
تەجەللىنىڭ	tˌæd͡ʒællˈɪnɪŋ
قەلبىدە	qælbˈɪdæ
بېرىپ	bˈeɾɪp
موڭغۇلىيە	mˌoŋʁulˈɪjæ
زىچ	zˈɪt͡ʃ
باشقىلارغا	bˌɑʃqɪlˈɑrʁɑ
جىگدە	d͡ʒˈɪɡdæ
قىلىنسا	qɪlˈɪnsɑ
سوئال	sˈoɑl
تىجارىتى	tˌɪd͡ʒɑɾˈɪtɪ
ئاڭ	ˈɑŋ
قارار	qˈɑɾɑr
بەرپا	bˈærpɑ
باشلىدى	bɑʃlˈɪdɪ
مىليارد	mˈɪljɑrd
كۈنلۈك	kˈynlyk
تىپى	tˈɪpɪ
ئۆتمەي	ˈœtmæj
ئوقۇغۇچى	ˌoquʁˈut͡ʃɪ
قىسمىدىن	qɪsmˈɪdɪn
ئۇلارنىڭ	ulˈɑrnɪŋ
سەۋىيىسى	sˌæwɪjˈɪsɪ
بۆلۈنگەن	bœlˈynɡæn
ئۆزەمنىڭ	œzˈæmnɪŋ
ۋاقىتنى	wɑqˈɪtnɪ
مۇھىمى	muhˈɪmɪ
دەلىل	dˈælɪl
ياشايدۇ	jɑʃˈɑjdu
ئىچىگە	ɪt͡ʃˈɪɡæ
قاراشەھەر	qˌɑɾɑʃˈæhær
نەشرى	nˈæʃrɪ
كۆرىدىغان	kˌœɾɪdˈɪʁɑn
ئادەتتە	ɑdˈættæ
ناخشا	nˈɑχʃɑ
گېزىتى	ɡezˈɪtɪ
ئۈستۈن	ˈystyn
پىلانلىق	pɪlˈɑnlɪq
ئۈنۈم	ˈynym
ئامىللارنى	ˌɑmɪllˈɑrnɪ
شۇلارنىڭ	ʃulˈɑrnɪŋ
پەرزەنت	pˈærzænt
ئارىلىقتا	ˌɑɾɪlˈɪqtɑ
سىرتىغا	sɪrtˈɪʁɑ
مەھەللە	mæhˈællæ
نەزەرىيە	nˌæzæɾˈɪjæ
مەنىدىن	mænˈɪdɪn
