теорією	teɔrʲijejʊ
слівцями	sʲlʲiu̯t͡sʲɐme
хмара	xmɑrɐ
між	mʲiʒ
промежина	prɔmɛʒenɐ
запитувати	zɐpɪtʊʋɐte
зал	zɑɫ
колір	kɔlʲir
українська	ʊkrɐjinʲsʲkɐ
ледащо	ɫedɑʃt͡ʃɔ
трьохсот	tʲrʲɔxsɔt
ящірка	jɑʃt͡ʃʲirkɐ
правопорушник	prɐwɔporuʃnek
чотирьохсот	t͡ʃɔterʲɔxsɔt
завжди	zɑu̯ʒde
стрибати	strebɑte
діафрагмах	dʲiɐfrɑɦmɐx
французький	frɐnt͡suzʲkei̯
об'єкт	ɔbjɛkt
палац	pɐɫɑt͡s
слівця	sʲlʲiu̯t͡sʲɐ
савченко	sɑu̯t͡ʃenkɔ
вираховувати	ʋerɐxɔwʊʋɐte
віє	ʋʲije
сильний	sɪlʲnei̯
спідниць	sʲpʲidnɪt͡sʲ
причинність	pret͡ʃɪnʲːisʲtʲ
лекцій	ɫɛkt͡sʲii̯
глибокий	ɦɫebɔkei̯
канадець	kɐnɑdet͡sʲ
лиходійка	ɫexodʲii̯kɐ
гармата	ɦɐrmɑtɐ
нести	nestɪ
одно	ɔdnɔ
вимирати	ʋemerɑte
уміти	ʊmʲite
стрункий	strʊnkɪi̯
озимі	ɔzɪmʲi
коханець	kɔxɑnet͡sʲ
ув'язнити	ʊʋjɐznɪte
артерії	ɐrtɛrʲiji
романтизм	rɔmɐntɪzm
надії	nɐdʲiji
задоволень	zɐdɔwɔɫenʲ
стрічки	stʲrʲit͡ʃkɪ
скорпіон	skɔrpʲiɔn
знедолити	znedɔɫete
причинний	pret͡ʃɪnːei̯
епістемологія	epʲistemɔɫɔɦʲijɐ
загальновідомий	zɐɦɐlʲnɔʋʲidɔmei̯
трубкозуб	trʊbkozub
каліграфія	kɐlʲiɦrɑfʲijɐ
безграмотність	bezɦrɑmɔtʲnʲisʲtʲ
заґреб	zɑɡreb
білок	bʲiɫɔk
мізантропія	mʲizɐntrɔpʲijɐ
дисциплінувати	dest͡seplʲinʊʋɑte
авіарозвідування	ɐʋʲiɐrɔzʲʋʲidʊʋɐnʲːɐ
логіка	ɫɔɦʲikɐ
першомучениця	perʃomut͡ʃenet͡sʲɐ
відкласти	ʋʲidkɫɑste
тишина	teʃenɑ
щоразу	ʃt͡ʃɔrɑzʊ
друзях	druzʲɐx
припинити	prepenɪte
антарктичний	ɐntɐrktɪt͡ʃnei̯
білий	bʲiɫei̯
лекціями	ɫɛkt͡sʲijɐme
розмова	rɔzmɔʋɐ
двісті	dʲʋʲisʲtʲi
наприклад	nɐprɪkɫɐd
клімат	klʲimɐt
серб	sɛrb
отвір	ɔtʲʋʲir
ювелір	jʊʋelʲir
письменниць	pesʲmɛnːet͡sʲ
дитсадок	det͡sɐdɔk
вибух	ʋɪbʊx
пасажир	pɐsɐʒɪr
битви	bɪtʋe
проголосити	prɔɦɔɫɔsɪte
благоговійний	bɫɐɦɔɦɔʋʲii̯nei̯
інтелектуалізувати	inteɫektʊɐlʲizʊʋɑte
кандидат	kɐndedɑt
терапія	terɐpʲijɐ
їхній	jixnʲii̯
пасічник	pɑsʲit͡ʃnek
дзиґа	d͡zɪɡɐ
гоголь	ɦɔɦɔlʲ
шиях	ʃɪjɐx
інерцією	inɛrt͡sʲijejʊ
соромливий	sɔrɔmɫɪʋei̯
тілесний	tʲiɫɛsnei̯
зад	zɑd
кінь	kʲinʲ
вам	ʋɑm
авіаракетобудування	ɐʋʲiɐrɐketɔbʊdʊʋɑnʲːɐ
прислухатися	presɫʊxɑtesʲɐ
замінити	zɐmʲinɪte
тунелів	tʊnɛlʲiu̯
більшості	bʲilʲʃɔsʲtʲi
утруднювати	ʊtrudʲnʲʊʋɐte
баритися	bɐrɪtesʲɐ
абетка	ɐbɛtkɐ
твердий	tʋerdɪi̯
серпень	sɛrpenʲ
слівцям	sʲlʲiu̯t͡sʲɐm
цивілізація	t͡seʋʲilʲizɑt͡sʲijɐ
помилка	pɔmeɫkɐ
зоряний	zɔrʲɐnei̯
передній	perɛdʲnʲii̯
тисяча	tɪsʲɐt͡ʃɐ
дані	dɑnʲi
здоров	zdɔrɔu̯
словечками	sɫɔʋɛt͡ʃkɐme
винахід	ʋɪnɐxʲid
красуня	krɐsunʲɐ
стандартові	stɐndɑrtɔʋʲi
поем	pɔɛm
дорогий	dɔrɔɦɪi̯
існуючий	isnujʊt͡ʃei̯
кувати	kʊʋɑte
безіменний	bezʲimɛnːei̯
прислівник	presʲlʲiu̯nek
декларативний	dekɫɐrɐtɪu̯nei̯
вищезазначений	ʋeʃt͡ʃezɐznɑt͡ʃenei̯
абортування	ɐbɔrtʊʋɑnʲːɐ
золотом	zɔɫɔtɔm
бабка	bɑbkɐ
повікою	pɔʋʲikɔjʊ
вечори	ʋet͡ʃɔrɪ
макові	mɑkɔʋʲi
четвертий	t͡ʃetʋɛrtei̯
неподалік	nepɔdɐlʲik
експорт	ɛkspɔrt
автократія	ɐu̯tɔkrɑtʲijɐ
мінералогія	mʲinerɐɫɔɦʲijɐ
трактористка	trɐktɔrɪstkɐ
несподіваний	nespodʲiʋɐnei̯
підошво	pʲidɔʃwɔ
двоїна	dwɔjinɑ
гаїті	ɦɐjitʲi
кар	kɑr
риса	rɪsɐ
інфекція	infɛkt͡sʲijɐ
бідність	bʲidʲnʲisʲtʲ
насіння	nɐsʲinʲːɐ
виставка	ʋɪstɐu̯kɐ
серйозний	serʲɔznei̯
шкіри	ʃkʲire
синхронний	senxrɔnːei̯
перемога	peremɔɦɐ
знищувати	znɪʃt͡ʃʊʋɐte
парша	pɑrʃɐ
літературний	lʲiterɐturnei̯
помічниця	pɔmʲit͡ʃnɪt͡sʲɐ
список	spɪsɔk
близький	bɫezʲkɪi̯
паузам	pɑʊzɐm
зумовити	zʊmɔʋete
слів	sʲlʲiu̯
плавець	pɫɐʋɛt͡sʲ
провінція	prɔʋʲinʲt͡sʲijɐ
автовокзал	ɐu̯tɔwɔɡzɑɫ
призупиняти	prezʊpenʲɑte
досяжний	dɔsʲɐʒnɪi̯
довгочасний	dɔu̯ɦɔt͡ʃɑsnei̯
замість	zɑmʲisʲtʲ
неорганічний	neɔrɦɐnʲit͡ʃnei̯
гурченко	ɦurt͡ʃenkɔ
галактичний	ɦɐɫɐktɪt͡ʃnei̯
дощова	dɔʃt͡ʃɔʋɑ
мій	mʲii̯
скайдайвінг	skɐi̯dɑjʋʲinɦ
пеніс	pɛnʲis
древній	drɛu̯nʲii̯
добробут	dɔbrɔbʊt
властивий	wɫɐstɪʋei̯
утратою	ʊtrɑtɔjʊ
оренда	ɔrɛndɐ
дорости	dɔrɔstɪ
символічно	semwolʲit͡ʃnɔ
знання	znɐnʲːɑ
чарувати	t͡ʃɐrʊʋɑte
шпигун	ʃpeɦun
риторичний	retɔrɪt͡ʃnei̯
тобі	tobʲi
миша	mɪʃɐ
сонце	sɔnt͡se
спосіб	spɔsʲib
полька	pɔlʲkɐ
литвиненко	ɫetʋenɛnkɔ
верховний	ʋerxɔu̯nei̯
тиша	tɪʃɐ
приготувати	preɦɔtʊʋɑte
цей	t͡sɛi̯
серотонін	serɔtonʲin
якщо	jɐkʃt͡ʃɔ
пізно	pʲiznɔ
запальничка	zɐpɐlʲnɪt͡ʃkɐ
когут	kɔɦʊt
жарити	ʒɑrete
прочитати	prɔt͡ʃetɑte
сахар	sɑxɐr
ображати	ɔbrɐʒɑte
східний	sʲxʲidnei̯
вільнюс	ʋʲilʲnʲʊs
купальний	kʊpɑlʲnei̯
валюта	ʋɐlʲutɐ
авіаматка	ɐʋʲiɐmɑtkɐ
старанний	stɐrɑnːei̯
заснувати	zɐsnʊʋɑte
дефект	defɛkt
соратник	sɔrɑtnek
чесність	t͡ʃɛsʲnʲisʲtʲ
тополями	tɔpɔlʲɐme
маріонетка	mɐrʲiɔnɛtkɐ
лицарський	ɫet͡sɑrsʲkei̯
інструкцію	instrukt͡sʲijʊ
уже	ʊʒɛ
нирка	nɪrkɐ
коса	kɔsɑ
залупа	zɐɫupɐ
кошик	kɔʃek
шиям	ʃɪjɐm
ексгібіціонізм	eɡzʲɦʲibʲit͡sʲionʲizm
браму	brɑmʊ
портфеля	pɔrtfɛlʲɐ
патріотизмі	pɐtʲrʲiɔtɪzʲmʲi
більший	bʲilʲʃei̯
марність	mɑrnʲisʲtʲ
шибеницю	ʃɪbenet͡sʲʊ
зайнятий	zɑi̯nʲɐtei̯
вуж	wuʒ
волейболіст	wɔɫei̯bolʲist
екологічний	ekɔɫoɦʲit͡ʃnei̯
прабаба	prɐbɑbɐ
наркоз	nɐrkɔz
переважний	pereʋɑʒnei̯
будівельник	bʊdʲiʋɛlʲnek
літо	lʲitɔ
інфляція	inflʲɑt͡sʲijɐ
наживо	nɐʒɪwɔ
штатів	ʃtɑtʲiu̯
директор	derɛktɔr
служити	sɫʊʒɪte
авіабаза	ɐʋʲiɐbɑzɐ
збройний	zbrɔi̯nei̯
бюрократія	bʲʊrɔkrɑtʲijɐ
продукція	produkt͡sʲijɐ
онтологія	ɔntɔɫɔɦʲijɐ
вісімдесятий	ʋʲisʲimdesʲɑtei̯
литка	ɫɪtkɐ
доставляти	dɔstɐu̯lʲɑte
амбітний	ɐmbʲitnei̯
огидний	ɔɦɪdnei̯
лібералізація	lʲiberɐlʲizɑt͡sʲijɐ
човен	t͡ʃɔʋen
суровий	sʊrɔʋei̯
представниця	pred͡zstɐu̯nɪt͡sʲɐ
прихильник	prexɪlʲnek
недостатній	nedɔstɑtʲnʲii̯
підошву	pʲidɔʃwʊ
мітологія	mʲitɔɫɔɦʲijɐ
акціонерний	ɐkt͡sʲiɔnɛrnei̯
екологія	ekɔɫɔɦʲijɐ
відомство	ʋʲidɔmstwɔ
врахувати	wrɐxʊʋɑte
фосфат	fɔsfɑt
хлопець	xɫɔpet͡sʲ
штормило	ʃtɔrmɪɫɔ
пасивний	pɐsɪu̯nei̯
схема	sxɛmɐ
літератор	lʲiterɑtɔr
континент	kɔntenɛnt
дня	dʲnʲɑ
підручник	pʲidrut͡ʃnek
утратам	ʊtrɑtɐm
практика	prɑktekɐ
активація	ɐkteʋɑt͡sʲijɐ
їжа	jiʒɐ
політичний	pɔlʲitɪt͡ʃnei̯
авіазасіб	ɐʋʲiɐzɑsʲib
куций	kut͡sei̯
реалізувати	reɐlʲizʊʋɑte
ситуаціями	setʊɑt͡sʲijɐme
займається	zɐi̯mɑjet͡sʲːɐ
здійснити	zʲdʲii̯snɪte
туди	tʊdɪ
другий	druɦei̯
литва	ɫetʋɑ
маківка	mɑkʲiu̯kɐ
взимку	wzɪmkʊ
авансик	ɐʋɑnsek
борошно	bɔrɔʃnɔ
реклама	rekɫɑmɐ
похіть	pɔxʲitʲ
команда	kɔmɑndɐ
крохмаль	krɔxmɑlʲ
рації	rɑt͡sʲiji
обурення	oburenʲːɐ
ступати	stʊpɑte
індивідуалізувати	indeʋʲidʊɐlʲizʊʋɑte
полтава	pɔɫtɑʋɐ
бірюзовий	bʲirʲʊzɔʋei̯
подробицях	pɔdrɔbet͡sʲɐx
мікроскопія	mʲikrɔskopʲijɐ
трагедіям	trɐɦɛdʲijɐm
жарко	ʒɑrkɔ
хто	xtɔ
олива	ɔɫɪʋɐ
закінчення	zɐkʲint͡ʃenʲːɐ
фарфор	fɐrfɔr
таць	tɑt͡sʲ
опозиційний	ɔpɔzet͡sʲii̯nei̯
гагауз	ɦɐɦɐuz
абревіатура	ɐbreʋʲiɐturɐ
гривне	ɦrɪu̯ne
справо	sprɑwɔ
авіавиставка	ɐʋʲiɐʋɪstɐu̯kɐ
регіональний	reɦʲiɔnɑlʲnei̯
самшит	sɐmʃɪt
світовий	sʲʋʲitɔʋɪi̯
експонат	ekspɔnɑt
хотітися	xotʲitesʲɐ
свердловина	sʋerdɫɔʋɪnɐ
опитувати	ɔpɪtʊʋɐte
розрізнити	rɔzʲrʲiznɪte
гуслі	ɦusʲlʲi
сестриць	sestrɪt͡sʲ
десертом	desɛrtɔm
шкірою	ʃkʲirɔjʊ
незалежности	nezɐɫɛʒnɔste
арістотель	ɐrʲistɔtelʲ
уродливий	ʊrɔdɫɪʋei̯
розмір	rɔzʲmʲir
абикуди	ɐbɪkʊde
скубти	skubte
імунна	imunːɐ
коло	kɔɫɔ
вторгнення	ʍtɔrɦnenʲːɐ
міжвоєнний	mʲiʒwɔjɛnːei̯
поздоровити	pɔzdɔrɔʋete
прислухатися	presɫuxɐtesʲɐ
інформація	infɔrmɑt͡sʲijɐ
шовковистий	ʃɔu̯kɔʋɪstei̯
шарф	ʃɑrf
ліхтар	lʲixtɑr
помічати	pɔmʲit͡ʃɑte
закривати	zɐkreʋɑte
пропаганда	prɔpɐɦɑndɐ
пропорцій	prɔpɔrt͡sʲii̯
простота	prɔstɔtɑ
начальство	nɐt͡ʃɑlʲstwɔ
альбатрос	ɐlʲbɐtrɔs
гуманістка	ɦʊmɐnʲistkɐ
провакцинувати	prɔʋɐkt͡senʊʋɑte
гавана	ɦɐʋɑnɐ
розкішний	rozʲkʲiʃnei̯
ніздрею	nʲizdrejʊ
зв'язок	zʋjɑzɔk
знайти	znɐi̯tɪ
працівник	prɐt͡sʲiu̯nɪk
тістечко	tʲistet͡ʃkɔ
середовище	seredɔʋeʃt͡ʃe
монументальний	mɔnʊmentɑlʲnei̯
працювати	prɐt͡sʲʊʋɑte
морок	mɔrɔk
літр	lʲitr
ощасливлювати	ɔʃt͡ʃɐsɫɪu̯lʲʊʋɐte
тисячоліттями	tesʲɐt͡ʃolʲitʲːɐme
конфета	kɔnfɛtɐ
замовниця	zɐmɔu̯net͡sʲɐ
рилах	rɪɫɐx
болгари	bɔɫɦɑre
авізо	ɐʋʲizɔ
радісний	rɑdʲisnei̯
перевести	pereʋestɪ
колосальний	kɔɫɔsɑlʲnei̯
виступати	ʋestʊpɑte
снодійний	snodʲii̯nei̯
похорони	pɔxɔrɔne
гість	ɦʲisʲtʲ
фактичний	fɐktɪt͡ʃnei̯
зоопарк	zɔɔpɑrk
прибрати	prebrɑte
погляди	pɔɦlʲɐde
добрий	dɔbrei̯
дебелий	debɛɫei̯
законами	zɐkɔnɐme
міжурядовий	mʲiʒʊrʲɐdɔʋei̯
вельможа	ʋelʲmɔʒɐ
максим	mɐksɪm
м'яти	mjɑte
дивина	deʋenɑ
суконь	sukɔnʲ
аттик	ɑtːek
зіниця	zʲinɪt͡sʲɐ
сюди	sʲʊdɪ
сестрицю	sestrɪt͡sʲʊ
депресія	deprɛsʲijɐ
відмежовувати	ʋʲidmeʒɔwʊʋɐte
абсанс	ɐbsɑns
авіасалон	ɐʋʲiɐsɐɫɔn
звертати	zʋertɑte
бур'ян	bʊrjɑn
неправомірний	neprɐwomʲirnei̯
варіантам	ʋɐrʲiɑntɐm
арахнологію	ɐrɐxnɔɫɔɦʲijʊ
фасад	fɐsɑd
авіарозвідка	ɐʋʲiɐrɔzʲʋʲidkɐ
очолити	ɔt͡ʃɔɫete
тацею	tɑt͡sejʊ
чорної	t͡ʃɔrnɔji
характерний	xɐrɐktɛrnei̯
заводити	zɐwɔdete
заподіяти	zɐpodʲijɐte
диспетчер	despɛt͡ʃːer
бігати	bʲiɦɐte
кошуля	koʃulʲɐ
попіл	pɔpʲiɫ
взірець	wzʲirɛt͡sʲ
сербський	sɛrbsʲkei̯
аура	ɑʊrɐ
канонерський	kɐnɔnɛrsʲkei̯
купець	kʊpɛt͡sʲ
типовий	tepɔʋɪi̯
авантюрниця	ɐʋɐnʲtʲurnet͡sʲɐ
килим	kɪɫem
організацій	ɔrɦɐnʲizɑt͡sʲii̯
дефініцію	defʲinʲit͡sʲijʊ
дельфін	delʲfʲin
порушувати	poruʃʊʋɐte
завантажити	zɐʋɐntɑʒete
довічне	dɔʋʲit͡ʃne
дисертаціями	desertɑt͡sʲijɐme
прийняття	prei̯nʲɐtʲːɑ
імпорт	impɔrt
рекомендація	rekɔmendɑt͡sʲijɐ
віям	ʋʲijɐm
прототип	prɔtɔtɪp
трикутний	trekutnei̯
півстоліття	pʲiu̯stolʲitʲːɐ
відданість	ʋʲidːɐnʲisʲtʲ
трагічний	trɐɦʲit͡ʃnei̯
семи	semɪ
легко	ɫɛɦkɔ
кукіль	kʊkʲilʲ
мовлення	mɔu̯ɫenʲːɐ
персональний	persɔnɑlʲnei̯
ранку	rɑnkʊ
щиколотці	ʃt͡ʃɪkɔɫɔt͡sʲːi
відокремлювати	ʋʲidɔkrɛmlʲʊʋɐte
бік	bʲik
девіантний	deʋʲiɑntnei̯
фільтрувати	fʲilʲtrʊʋɑte
комора	kɔmɔrɐ
лекціям	ɫɛkt͡sʲijɐm
виявити	ʋɪjɐʋete
аблактування	ɐbɫɐktʊʋɑnʲːɐ
абака	ɐbɑkɐ
характер	xɐrɑkter
григоріанський	ɦreɦɔrʲiɑnʲsʲkei̯
апостроф	ɐpɔstrɔf
бурулька	bʊrulʲkɐ
померти	pɔmɛrte
поживний	pɔʒɪu̯nei̯
перевиховати	pereʋɪxɔʋɐte
запізнюватися	zɐpʲizʲnʲʊʋɐtesʲɐ
періодизаціям	perʲiɔdezɑt͡sʲijɐm
авіадиспетчер	ɐʋʲiɐdespɛt͡ʃːer
імперій	impɛrʲii̯
активність	ɐktɪu̯nʲisʲtʲ
примирення	premɪrenʲːɐ
чайна	t͡ʃɐi̯nɑ
лиходій	ɫexodʲii̯
законослухняний	zɐkɔnɔsɫʊxnʲɑnei̯
підпорядкувати	pʲidpɔrʲɐdkʊʋɑte
перекласти	perekɫɑste
льоха	lʲɔxɐ
богослів'я	bɔɦosʲlʲiʋjɐ
антена	ɐntɛnɐ
викладач	ʋekɫɐdɑt͡ʃ
ластівочка	ɫɑsʲtʲiwɔt͡ʃkɐ
послідовниця	pɔsʲlʲidɔu̯net͡sʲɐ
всеохоплюючий	ʍseɔxɔplʲʊjʊt͡ʃei̯
боєць	bɔjɛt͡sʲ
закупити	zɐkʊpɪte
нейтральний	nei̯trɑlʲnei̯
дебютний	debʲutnei̯
безпрецедентний	bezpret͡sedɛntnei̯
сестрин	sestrɪn
вирости	ʋɪrɔste
автовантажник	ɐu̯tɔʋɐntɑʒnek
машина	mɐʃɪnɐ
гладіатор	ɦɫɐdʲiɑtɔr
маніпулювати	mɐnʲipʊlʲʊʋɑte
звати	zʋɑte
виглянути	ʋɪɦlʲɐnʊte
додавати	dɔdɐʋɑte
здивувати	zdewʊʋɑte
готівка	ɦotʲiu̯kɐ
тюхтій	tʲʊxtʲii̯
небог	nebɔɦ
крайній	krɑi̯nʲii̯
вівторковий	ʋʲiu̯tɔrkɔʋei̯
брюссельський	brʲʊsːɛlʲsʲkei̯
нетерплячий	neterplʲɑt͡ʃei̯
японією	jɐpɔnʲijejʊ
вікісловник	ʋʲikʲisɫɔu̯nɪk
референдуму	referɛndʊmʊ
скарб	skɑrb
заперечити	zɐperɛt͡ʃete
словникам	sɫɔu̯nekɑm
крилатка	kreɫɑtkɐ
тунелем	tʊnɛɫem
скребти	skrebtɪ
щиколоткою	ʃt͡ʃɪkɔɫɔtkɔjʊ
рамка	rɑmkɐ
мурахоїд	mʊrɐxɔjid
номенклатурні	nɔmenkɫɐturnʲi
самозакоханий	sɐmɔzɐkɔxɐnei̯
абісаль	ɐbʲisɑlʲ
кінець	kʲinɛt͡sʲ
клас	kɫɑs
решето	rɛʃetɔ
авіаметеослужба	ɐʋʲiɐmeteosɫuʒbɐ
каплиць	kɐpɫɪt͡sʲ
різдвяний	rʲizdʲʋʲɑnei̯
підтверджувати	pʲidtʋɛrd͡ʒʊʋɐte
наміри	nɑmʲire
травмувати	trɐu̯mʊʋɑte
негативно	neɦɐtɪu̯nɔ
інституційний	instetʊt͡sʲii̯nei̯
ліки	lʲike
дівча	dʲiu̯t͡ʃɑ
феям	fɛjɐm
оцією	ɔt͡sʲijɛjʊ
ісус	isus
навмисний	nɐu̯mɪsnei̯
карбованець	kɐrbɔʋɐnet͡sʲ
оптична	ɔptɪt͡ʃnɐ
самореференція	sɐmɔreferɛnʲt͡sʲijɐ
готовий	ɦɔtɔʋei̯
довготривалий	dɔu̯ɦɔtreʋɑɫei̯
чоловікам	t͡ʃɔɫɔʋʲikɐm
кажан	kɐʒɑn
клавіатурами	kɫɐʋʲiɐturɐme
профіль	prɔfʲilʲ
привчити	preu̯t͡ʃɪte
косити	kɔsɪte
молодицями	mɔɫɔdɪt͡sʲɐme
хтивий	xtɪʋei̯
портфелів	pɔrtfɛlʲiu̯
справедливий	sprɐʋedɫɪʋei̯
символічний	semwolʲit͡ʃnei̯
постатях	pɔstɐtʲɐx
мене	menɛ
семен	semɛn
друкарня	drʊkɑrnʲɐ
ринковий	rɪnkɔʋei̯
межи	meʒɪ
демократичний	demɔkrɐtɪt͡ʃnei̯
угорщина	ʊɦɔrʃt͡ʃenɐ
фразеологічний	frɐzeɔɫoɦʲit͡ʃnei̯
данія	dɑnʲijɐ
гінекологія	ɦʲinekɔɫɔɦʲijɐ
коник	kɔnek
хмарочос	xmɐrɔt͡ʃɔs
працівниць	prɐt͡sʲiu̯nɪt͡sʲ
споряджати	spɔrʲɐd͡ʒɑte
вії	ʋʲiji
промовляти	prɔmɔu̯lʲɑte
щеплень	ʃt͡ʃɛpɫenʲ
виноград	ʋenɔɦrɑd
молдавія	mɔɫdɑʋʲijɐ
смітник	sʲmʲitnɪk
якісний	jɑkʲisnei̯
також	tɐkɔʒ
друзям	druzʲɐm
кип'ятити	kepjɐtɪte
трупа	pret͡ʃɪnɐ
релігієзнавство	relʲiɦʲijeznɑu̯stwɔ
зустрічі	zustʲrʲit͡ʃʲi
клавіатури	kɫɐʋʲiɐture
двадцятий	dʋɐd͡zʲt͡sʲɑtei̯
полумисок	poɫumesɔk
працівникам	prɐt͡sʲiu̯nekɑm
граната	ɦrɐnɑtɐ
промисловий	prɔmesɫɔʋei̯
інфраструктурний	infrɐstrʊkturnei̯
помічник	pɔmʲit͡ʃnɪk
запевнити	zɐpɛu̯nete
контамінація	kɔntɐmʲinɑt͡sʲijɐ
крити	krɪte
мурашко	mʊrɑʃkɔ
знаменитість	znɐmenɪtʲisʲtʲ
влаштуватися	wɫɐʃtʊʋɑtesʲɐ
книжками	kneʒkɑme
честь	t͡ʃɛsʲtʲ
труба	trʊbɑ
недовірливий	nedɔʋʲirɫeʋei̯
чернігів	t͡ʃernʲiɦʲiu̯
словечках	sɫɔʋɛt͡ʃkɐx
початківець	pɔt͡ʃɐtʲkʲiʋet͡sʲ
богослов	bɔɦɔsɫɔu̯
популяції	pɔpʊlʲɑt͡sʲiji
звуковий	zwʊkɔʋɪi̯
постачання	pɔstɐt͡ʃɑnʲːɐ
неправді	neprɑu̯dʲi
взірцевий	wzʲirt͡sɛʋei̯
ложе	ɫɔʒe
критерію	kretɛrʲijʊ
столиця	stɔɫɪt͡sʲɐ
виключний	ʋɪklʲʊt͡ʃnei̯
посталий	pɔstɑɫei̯
відрізнятися	ʋʲidʲrʲizʲnʲɑtesʲɐ
фабрика	fɑbrekɐ
зошит	zɔʃet
порося	pɔrɔsʲɑ
перевантажити	pereʋɐntɑʒete
допитливий	dɔpɪtɫeʋei̯
кров'яний	krɔʋjɐnɪi̯
ангольський	ɐnɦɔlʲsʲkei̯
завтра	zɑu̯trɐ
пристрасть	prɪstrɐsʲtʲ
страта	strɑtɐ
одночасність	ɔdnɔt͡ʃɑsʲnʲisʲtʲ
абсурдність	ɐbsurdʲnʲisʲtʲ
італійський	itɐlʲii̯sʲkei̯
виграш	ʋɪɦrɐʃ
мотоциклам	mɔtɔt͡sɪkɫɐm
абсорбціометр	ɐbsɔrbt͡sʲiɔmetr
намірів	nɑmʲirʲiu̯
ніздрям	nʲizdʲrʲɐm
петицією	petɪt͡sʲijejʊ
зазначати	zɐznɐt͡ʃɑte
божественне	bɔʒɛstʋenːe
зоологія	zɔɔɫɔɦʲijɐ
генасамблея	ɦenɐsɐmbɫɛjɐ
пацюк	pɐt͡sʲuk
подвір'я	pɔdʲʋʲirjɐ
сонячний	sɔnʲɐt͡ʃnei̯
приголосний	prɪɦɔɫɔsnei̯
капелан	kɐpeɫɑn
пінистий	pʲinestei̯
скумбрія	skumbrʲijɐ
кліматологічний	klʲimɐtɔɫoɦʲit͡ʃnei̯
пращур	prɑʃt͡ʃʊr
ясла	jɑsɫɐ
погоджуватися	pɔɦɔd͡ʒʊʋɐtesʲɐ
теребейчук	terebei̯t͡ʃuk
нуль	nulʲ
цими	t͡sɪme
болгарка	bɔɫɦɑrkɐ
нещодавній	neʃt͡ʃɔdɑu̯nʲii̯
ковзкий	kɔu̯zkɪi̯
коефіцієнт	kɔefʲit͡sʲijɛnt
інтерактивний	interɐktɪu̯nei̯
помилка	pɔmɪɫkɐ
печиві	pɛt͡ʃeʋʲi
літній	lʲitʲnʲii̯
гріховний	ɦrʲixɔu̯nei̯
глобалізація	ɦɫɔbɐlʲizɑt͡sʲijɐ
четвер	t͡ʃetʋɛr
кухонний	kʊxɔnːei̯
нещирість	neʃt͡ʃɪrʲisʲtʲ
величезний	ʋeɫet͡ʃɛznei̯
повставати	pɔu̯stɐʋɑte
політизація	pɔlʲitezɑt͡sʲijɐ
повторювати	pɔu̯tɔrʲʊʋɐte
вівтар	ʋʲiu̯tɐr
аудиторія	ɐʊdetɔrʲijɐ
відміна	ʋʲidʲmʲinɐ
оцінювати	ot͡sʲinʲʊʋɐte
сестрицях	sestrɪt͡sʲɐx
репродуктивний	reprɔdʊktɪu̯nei̯
інфекціями	infɛkt͡sʲijɐme
полігамія	pɔlʲiɦɑmʲijɐ
еміграція	emʲiɦrɑt͡sʲijɐ
засмучений	zɐsmut͡ʃenei̯
модрина	mɔdrɪnɐ
безвідсотковий	bezʲʋʲid͡zsɔtkɔʋei̯
аутсайдер	ɐʊt͡sɑi̯der
віддаляти	ʋʲidːɐlʲɑte
шукати	ʃʊkɑte
кукурудза	kʊkʊrud͡zɐ
райдуга	rɑi̯dʊɦɐ
щеплення	ʃt͡ʃɛpɫenʲːɐ
вадам	ʋɑdɐm
друзів	druzʲiu̯
печива	pɛt͡ʃeʋɐ
запозичати	zɐpɔzet͡ʃɑte
простити	prɔstɪte
артеріях	ɐrtɛrʲijɐx
знімати	zʲnʲimɑte
відповідати	ʋʲidpɔʋʲidɑte
керівник	kerʲiu̯nɪk
черевний	t͡ʃereu̯nɪi̯
сфальсифікувати	sfɐlʲsefʲikʊʋɑte
мобілізація	mɔbʲilʲizɑt͡sʲijɐ
масть	mɑsʲtʲ
досконалість	dɔskɔnɑlʲisʲtʲ
янтар	jɐntɑr
страхувати	strɐxʊʋɑte
одяг	ɔdʲɐɦ
земля	zemlʲɑ
твір	tʲʋʲir
заборона	zɐbɔrɔnɐ
зося	zɔsʲɐ
зимний	zɪmnei̯
експозиція	ekspɔzɪt͡sʲijɐ
зграя	zɦrɑjɐ
забавний	zɐbɑu̯nei̯
підкреслити	pʲidkrɛsɫete
каштан	kɐʃtɑn
захворіти	zɐxworʲite
сумнів	sumnʲiu̯
ускладнити	ʊskɫɐdnɪte
повзик	pɔu̯zek
цю	t͡sʲu
вмирати	wmerɑte
оподатковувати	ɔpɔdɐtkɔwʊʋɐte
пропорціям	prɔpɔrt͡sʲijɐm
африканка	ɐfrekɑnkɐ
гарний	ɦɑrnei̯
ресторанний	restɔrɑnːei̯
повага	pɔʋɑɦɐ
мігрантка	mʲiɦrɑntkɐ
спробувати	sprɔbʊʋɐte
клуатр	kɫʊɑtr
банк	bɑnk
пленум	pɫɛnʊm
абсорбування	ɐbsɔrbʊʋɑnʲːɐ
лимонад	ɫemɔnɑd
заєць	zɑjet͡sʲ
додатка	dɔdɑtkɐ
зазвичай	zɐzʋet͡ʃɑi̯
знадобитися	znɐdɔbɪtesʲɐ
родителька	rɔdɪtelʲkɐ
замовити	zɐmɔʋete
риба	rɪbɐ
формула	fɔrmʊɫɐ
станціях	stɑnʲt͡sʲijɐx
демократка	demɔkrɑtkɐ
позичати	pɔzet͡ʃɑte
викорінювати	ʋekorʲinʲʊʋɐte
ліцензія	lʲit͡sɛnʲzʲijɐ
кредитор	kredetɔr
зімбабве	zʲimbɑbʋe
додаткам	dɔdɑtkɐm
село	seɫɔ
заперечний	zɐperɛt͡ʃnei̯
знахідний	znɐxʲidnei̯
повертати	pɔʋertɑte
ель	ɛlʲ
міркувати	mʲirkʊʋɑte
рад	rɑd
заварювати	zɐʋɑrʲʊʋɐte
природознавства	prerɔdɔznɑu̯stʋɐ
скроня	skrɔnʲɐ
турчанка	tʊrt͡ʃɑnkɐ
слюсар	sʲlʲusɐr
іспанський	ispɑnʲsʲkei̯
хвилина	xʋeɫɪnɐ
сумка	sumkɐ
піскар	pʲiskɑr
дебют	debʲut
світанок	sʲʋʲitɑnɔk
інтерес	interɛs
бавовна	bɐwɔu̯nɐ
релігійний	relʲiɦʲii̯nei̯
чирва	t͡ʃɪrʋɐ
наркотик	nɐrkɔtek
площа	pɫɔʃt͡ʃɐ
файний	fɑi̯nei̯
дитя	detʲɑ
довіряти	dɔʋʲirʲɑte
завважити	zɐʋːɑʒete
вимирання	ʋemerɑnʲːɐ
документ	dɔkʊmɛnt
дикунський	dekunʲsʲkei̯
потягнути	pɔtʲɐɦnute
печивам	pɛt͡ʃeʋɐm
природний	prerɔdnei̯
мексиканка	meksekɑnkɐ
перетин	perɛten
австрійський	ɐu̯stʲrʲii̯sʲkei̯
направляти	nɐprɐu̯lʲɑte
доброволець	dɔbrɔwɔɫet͡sʲ
призупинити	prezʊpenɪte
квартира	kʋɐrtɪrɐ
пришви	prɪʃʋe
жінка	ʒʲinkɐ
гімно	ɦʲimnɔ
екран	ekrɑn
фільтр	fʲilʲtr
герцог	ɦɛrt͡sɔɦ
підлокітник	pʲidɫokʲitnek
зачиняти	zɐt͡ʃenʲɑte
сідниць	sʲidnɪt͡sʲ
лівія	lʲiʋʲijɐ
сарана	sɐrɐnɑ
вагінальний	ʋɐɦʲinɑlʲnei̯
трансформації	trɐnsfɔrmɑt͡sʲiji
сприйняття	sprei̯nʲɑtʲːɐ
порнографічний	pɔrnɔɦrɐfʲit͡ʃnei̯
руці	rʊt͡sʲi
художник	xʊdɔʒnek
революціонерка	rewɔlʲʊt͡sʲiɔnɛrkɐ
мужність	muʒnʲisʲtʲ
рятувати	rʲɐtʊʋɑte
розпізнавання	rɔzʲpʲiznɐʋɑnʲːɐ
гладкий	ɦɫɑdkei̯
словник	sɫɔu̯nɪk
інспектувати	inspektʊʋɑte
альтернатива	ɐlʲternɐtɪʋɐ
косметика	kɔsmɛtekɐ
консервативний	kɔnserʋɐtɪu̯nei̯
булава	bʊɫɐʋɑ
погіршити	poɦʲirʃete
стакан	stɐkɑn
пообіцяти	pɔɔbʲit͡sʲɑte
пивний	peu̯nɪi̯
психологічний	psexɔɫoɦʲit͡ʃnei̯
танцювати	tɐnʲt͡sʲʊʋɑte
суті	sutʲi
бурштиновий	bʊrʃtenɔʋei̯
дрібний	dʲrʲibnɪi̯
ром	rɔm
янукович	jɐnʊkɔʋet͡ʃ
метрів	mɛtʲrʲiu̯
плакати	pɫɐkɑte
дихати	dɪxɐte
вівсів	ʋʲiu̯sʲiu̯
передмістя	peredʲmʲisʲtʲɐ
вечеряти	ʋet͡ʃɛrʲɐte
звізда	zʲʋʲizdɑ
портретів	pɔrtrɛtʲiu̯
близнюки	bɫezʲnʲʊkɪ
довший	dɔu̯ʃei̯
коробка	kɔrɔbkɐ
співпраця	sʲpʲiu̯prɑt͡sʲɐ
етап	etɑp
ряд	rʲɑd
крикнути	krɪknʊte
безглуздий	bezɦɫuzdei̯
дискусійний	deskʊsʲii̯nei̯
книжок	kneʒɔk
міжособовий	mʲiʒɔsɔbɔʋei̯
повз	pɔu̯z
ввесь	ʋːɛsʲ
щедрість	ʃt͡ʃɛdʲrʲisʲtʲ
вчиняти	ʍt͡ʃenʲɑte
ягідка	jɑɦʲidkɐ
козаком	kɔzɐkɔm
співучасть	sʲpʲiwut͡ʃɐsʲtʲ
заручниця	zɐrut͡ʃnet͡sʲɐ
авіабілет	ɐʋʲiɐbʲiɫɛt
уявіть	ʊjɐʋʲitʲ
повторяти	pɔu̯tɔrʲɑte
лучник	ɫut͡ʃnek
загальнодержавний	zɐɦɐlʲnɔderʒɑu̯nei̯
ріка	rʲikɑ
помаранчевий	pɔmɐrɑnt͡ʃeʋei̯
автодидакт	ɐu̯tɔdedɑkt
епох	epɔx
буряк	bʊrʲɑk
надання	nɐdɑnʲːɐ
обмежувати	ɔbmɛʒʊʋɐte
напередодні	nɐperedɔdʲnʲi
абстиненція	ɐbstenɛnʲt͡sʲijɐ
липень	ɫɪpenʲ
олень	ɔɫenʲ
заявити	zɐjɐʋɪte
лексикографія	ɫeksekɔɦrɑfʲijɐ
прелюдія	prelʲudʲijɐ
аванпост	ɐʋɐnpɔst
законопроект	zɐkɔnɔprɔɛkt
касувати	kɐsʊʋɑte
свекор	sʋɛkɔr
нюх	nʲux
нерегулярний	nereɦʊlʲɑrnei̯
принаймні	prenɑi̯mnʲi
куртка	kurtkɐ
казан	kɐzɑn
розвідування	rɔzʲʋʲidʊʋɐnʲːɐ
різноманіття	rʲiznɔmɐnʲitʲːɐ
прислівниковий	presʲlʲiu̯nekɔʋei̯
невичерпний	neʋet͡ʃɛrpnei̯
автаркізм	ɐu̯tɐrkʲizm
сумніватися	sʊmnʲiʋɑtesʲɐ
пробудження	probud͡ʒenʲːɐ
й	j
недооцінити	nedɔɔt͡sʲinɪte
дому	dɔmʊ
фальсифікувати	fɐlʲsefʲikʊʋɑte
звичайно	zʋet͡ʃɑi̯nɔ
арифметика	ɐrefmɛtekɐ
шестикутний	ʃestekutnei̯
членський	t͡ʃɫɛnʲsʲkei̯
оці	ot͡sʲi
науково	nɐʊkɔwɔ
жолудь	ʒɔɫʊdʲ
маковий	mɑkɔʋei̯
думка	dumkɐ
обшукати	ɔbʃʊkɑte
бачити	bɑt͡ʃete
необхідність	neobxʲidʲnʲisʲtʲ
невидимість	neʋɪdemʲisʲtʲ
непокоїти	nepɔkɔjite
на	nɑ
поглинати	pɔɦɫenɑte
конвалія	kɔnʋɑlʲijɐ
кишенями	keʃɛnʲɐme
дев'яносто	deʋjɐnɔstɔ
закрити	zɐkrɪte
гіпотеза	ɦʲipɔtezɐ
руський	rusʲkei̯
фольклор	fɔlʲkɫɔr
авіагармата	ɐʋʲiɐɦɐrmɑtɐ
дрівця	dʲrʲiu̯t͡sʲɑ
бузок	bʊzɔk
ворота	wɔrɔtɐ
креслення	krɛsɫenʲːɐ
дециметр	det͡semɛtr
двигун	dʋeɦun
дріжджі	dʲrʲiʒd͡ʒʲi
харків	xɑrkʲiu̯
вітчизняний	ʋʲit͡ʃːezʲnʲɑnei̯
кравченко	krɑu̯t͡ʃenkɔ
запізнитися	zɐpʲiznɪtesʲɐ
яловичина	jɑɫɔʋet͡ʃenɐ
привозити	prewɔzete
водень	wɔdenʲ
випадків	ʋɪpɐdʲkʲiu̯
варіанту	ʋɐrʲiɑntʊ
когут	koɦut
щоденний	ʃt͡ʃɔdɛnːei̯
підвищення	pʲidʋɪʃt͡ʃenʲːɐ
подвоїти	pɔdwɔjite
прогалина	prɔɦɑɫenɐ
множина	mnɔʒenɑ
обґрунтований	ɔbɡrʊntɔʋɐnei̯
поет	pɔɛt
хижак	xeʒɑk
недооцінювати	nedɔot͡sʲinʲʊʋɐte
ігролад	iɦrɔɫɑd
звісно	zʲʋʲisnɔ
втрачати	ʍtrɐt͡ʃɑte
хрестовий	xrestɔʋei̯
анімалістичний	ɐnʲimɐlʲistɪt͡ʃnei̯
реванш	reʋɑnʃ
безготівковий	bezɦɔtʲiu̯kɔʋei̯
країна	krɐjinɐ
хворіти	xworʲite
колода	kɔɫɔdɐ
широкий	ʃerɔkei̯
ідеалізувати	ideɐlʲizʊʋɑte
південноамериканський	pʲiu̯denːɔɐmerekɑnʲsʲkei̯
читання	t͡ʃetɑnʲːɐ
страшенно	strɐʃɛnːɔ
радник	rɑdnek
повіку	pɔʋʲikʊ
горіх	ɦorʲix
можливий	mɔʒɫɪʋei̯
виконувати	ʋekɔnʊʋɐte
організацію	ɔrɦɐnʲizɑt͡sʲijʊ
книжка	knɪʒkɐ
поглинути	pɔɦɫenute
мальта	mɑlʲtɐ
великодушність	ʋeɫekoduʃnʲisʲtʲ
друже	druʒe
дефіцит	defʲit͡sɪt
садівник	sɐdʲiu̯nɪk
письменник	pesʲmɛnːek
тобою	tɔbɔjʊ
авіаескадрилья	ɐʋʲiɐeskɐdrɪlʲjɐ
елегантний	eɫeɦɑntnei̯
надіти	nɐdʲite
аграрний	ɐɦrɑrnei̯
забагти	zɐbɑɦte
видужувати	ʋeduʒʊʋɐte
лише	ɫeʃɛ
століттю	stolʲitʲːʊ
академія	ɐkɐdɛmʲijɐ
жук	ʒuk
довгоніг	dɔu̯ɦonʲiɦ
лебединий	ɫebedɪnei̯
наразі	nɐrɑzʲi
виклик	ʋɪkɫek
соловейко	sɔɫɔʋɛi̯kɔ
справи	sprɑʋe
каструля	kɐstrulʲɐ
битвою	bɪtwɔjʊ
мозок	mɔzɔk
спостереження	spɔsterɛʒenʲːɐ
метами	mɛtɐme
конкретизувати	kɔnkretezʊʋɑte
форма	fɔrmɐ
лабораторією	ɫɐbɔrɐtɔrʲijejʊ
корисний	kɔrɪsnei̯
сторінка	storʲinkɐ
співбесідник	sʲpʲiu̯bɛsʲidnek
сімферополь	sʲimferɔpɔlʲ
щасливий	ʃt͡ʃɐsɫɪʋei̯
акваріум	ɐkʋɑrʲiʊm
небезпека	nebezpɛkɐ
відмова	ʋʲidmɔʋɐ
олово	ɔɫɔwɔ
канава	kɐnɑʋɐ
феміністський	femʲinʲisʲkei̯
досі	dɔsʲi
книжки	knɪʒke
грамотний	ɦrɑmɔtnei̯
діра	dʲirɑ
перевантажувати	pereʋɐntɑʒʊʋɐte
максимальний	mɐksemɑlʲnei̯
сечогінний	set͡ʃoɦʲinːei̯
бонусів	bɔnʊsʲiu̯
оприлюднити	ɔprelʲudnete
тема	tɛmɐ
таця	tɑt͡sʲɐ
бадьорий	bɐdʲɔrei̯
догма	dɔɦmɐ
біолог	bʲiɔɫɔɦ
гідність	ɦʲidʲnʲisʲtʲ
персія	pɛrsʲijɐ
фірма	fʲirmɐ
натовп	nɑtɔu̯p
орфографічний	ɔrfɔɦrɐfʲit͡ʃnei̯
хронологічний	xrɔnɔɫoɦʲit͡ʃnei̯
важіль	ʋɑʒʲilʲ
виверження	ʋɪʋerʒenʲːɐ
мирний	mɪrnei̯
дратувати	drɐtʊʋɑte
миролюбний	merolʲubnei̯
береза	berɛzɐ
якнайшвидше	jɐknɐi̯ʃʋɪd͡ʒʃe
мертвий	mɛrtʋei̯
крок	krɔk
стандартизація	stɐndɐrtezɑt͡sʲijɐ
банківський	bɑnʲkʲiu̯sʲkei̯
норвезький	nɔrʋɛzʲkei̯
свояк	swɔjɑk
відокремити	ʋʲidɔkrɛmete
виховати	ʋɪxɔʋɐte
таїландка	tɐjiɫɑndkɐ
лекцію	ɫɛkt͡sʲijʊ
гривні	ɦrɪu̯nʲi
сотня	sɔtʲnʲɐ
удосконалювати	ʊdɔskɔnɑlʲʊʋɐte
переміщати	peremʲiʃt͡ʃɑte
космос	kɔsmɔs
ягода	jɑɦɔdɐ
празеодим	prɐzeɔdɪm
таємнице	tɐjemnɪt͡se
італійка	itɐlʲii̯kɐ
розпізнати	rɔzʲpʲiznɑte
тренінг	trɛnʲinɦ
буйний	bui̯nei̯
авантюристка	ɐʋɐnʲtʲʊrɪstkɐ
фотографіях	fɔtɔɦrɑfʲijɐx
рукавиця	rʊkɐʋɪt͡sʲɐ
компетентний	kɔmpetɛntnei̯
смарагд	smɐrɑɦd
доїхати	dɔjixɐte
приїзд	prejizd
зозуля	zozulʲɐ
абсорбція	ɐbsɔrbt͡sʲijɐ
завдати	zɐu̯dɑte
аварець	ɐʋɑret͡sʲ
беж	bɛʒ
алло	ɐɫːɔ
венеціанський	ʋenet͡sʲiɑnʲsʲkei̯
брусниця	brʊsnɪt͡sʲɐ
аврал	ɐu̯rɑɫ
емоцію	emɔt͡sʲijʊ
парашутизм	pɐrɐʃʊtɪzm
богословський	bɔɦɔsɫɔu̯sʲkei̯
албанський	ɐɫbɑnʲsʲkei̯
розробляти	rɔzrɔblʲɑte
майонез	mɐjɔnɛz
матеріальний	mɐterʲiɑlʲnei̯
повія	pɔʋʲijɐ
кодекс	kɔdeks
штучний	ʃtut͡ʃnei̯
скоротити	skɔrɔtɪte
сік	sʲik
вірус	ʋʲirʊs
перейменовувати	perei̯menɔwʊʋɐte
турнір	tʊrnʲir
поселити	pɔseɫɪte
готовність	ɦɔtɔu̯nʲisʲtʲ
пес	pɛs
відстань	ʋʲid͡zstɐnʲ
українським	ʊkrɐjinʲsʲkem
закони	zɐkɔne
механізм	mexɐnʲizm
страва	strɑʋɐ
п'ятеро	pjɑterɔ
урочистий	ʊrɔt͡ʃɪstei̯
позначитися	pɔznɐt͡ʃɪtesʲɐ
священство	sʲʋʲɐʃt͡ʃɛnstwɔ
книжкою	knɪʒkɔjʊ
руйнівний	rʊi̯nʲiu̯nɪi̯
нинішній	nɪnʲiʃnʲii̯
перевантажений	pereʋɐntɑʒenei̯
сервер	sɛrʋer
простий	prɔstɪi̯
заморозити	zɐmɔrɔzete
особа	ɔsɔbɐ
ряса	rʲɑsɐ
священик	sʲʋʲɐʃt͡ʃɛnek
виконання	ʋekɔnɑnʲːɐ
шкірам	ʃkʲirɐm
хімія	xʲimʲijɐ
шиї	ʃɪji
форель	fɔrɛlʲ
розгляд	rɔzɦlʲɐd
підкреслювати	pʲidkrɛsʲlʲʊʋɐte
референдумах	referɛndʊmɐx
таліям	tɑlʲijɐm
потягти	pɔtʲɐɦtɪ
норвегія	nɔrʋɛɦʲijɐ
зацікавлений	zɐt͡sʲikɑu̯ɫenei̯
наче	nɑt͡ʃe
чхнути	t͡ʃxnute
герцогиня	ɦert͡sɔɦɪnʲɐ
скільки	sʲkʲilʲke
заздрощі	zɑzdrɔʃt͡ʃʲi
абсолюція	ɐbsolʲut͡sʲijɐ
мармур	mɑrmʊr
нормалізувати	nɔrmɐlʲizʊʋɑte
сестриці	sestrɪt͡sʲi
церемоніальний	t͡seremɔnʲiɑlʲnei̯
комаха	kɔmɑxɐ
ананас	ɐnɐnɑs
битися	bɪtesʲɐ
математичний	mɐtemɐtɪt͡ʃnei̯
чемпіонський	t͡ʃempʲiɔnʲsʲkei̯
поліцію	polʲit͡sʲijʊ
пунктуально	pʊnktʊɑlʲnɔ
метелик	metɛɫek
привселюдний	preu̯selʲudnei̯
завада	zɐʋɑdɐ
христина	xrestɪnɐ
нагромаджувати	nɐɦrɔmɑd͡ʒʊʋɐte
звузити	zwuzete
гуска	ɦuskɐ
жало	ʒɐɫɔ
литвин	ɫetʋɪn
температура	temperɐturɐ
розслідування	rozsʲlʲidʊʋɐnʲːɐ
ласка	ɫɑskɐ
британський	bretɑnʲsʲkei̯
тікати	tʲikɐte
управлінський	ʊprɐu̯lʲinʲsʲkei̯
дзвіниця	d͡zʲʋʲinɪt͡sʲɐ
тиждень	tɪʒdenʲ
петиції	petɪt͡sʲiji
трагедію	trɐɦɛdʲijʊ
проінспектувати	prɔinspektʊʋɑte
багатий	bɐɦɑtei̯
ізраїль	izrɑjilʲ
винахідливість	ʋenɐxʲidɫeʋʲisʲtʲ
уособлювати	ʊɔsɔblʲʊʋɐte
діагностика	dʲiɐɦnɔstekɐ
німецький	nʲimɛt͡sʲkei̯
надати	nɐdɑte
точка	tɔt͡ʃkɐ
ступінь	stupʲinʲ
рейтузи	rei̯tuze
рука	rʊkɑ
художній	xʊdɔʒnʲii̯
національний	nɐt͡sʲiɔnɑlʲnei̯
дрімати	dʲrʲimɑte
тріщина	tʲrʲiʃt͡ʃenɐ
база	bɑzɐ
співпереживання	sʲpʲiu̯pereʒeʋɑnʲːɐ
те	tɛ
поза	pɔzɐ
переорієнтовувати	pereɔrʲijentɔwʊʋɐte
гай	ɦɑi̯
простір	prɔsʲtʲir
саундтрек	sɐʊndtrɛk
асимптота	ɐsemptɔtɐ
вестися	ʋestɪsʲɐ
горло	ɦɔrɫɔ
іншими	inʃeme
критеріями	kretɛrʲijɐme
авіакомпанія	ɐʋʲiɐkɔmpɑnʲijɐ
шахівниця	ʃɐxʲiu̯nɪt͡sʲɐ
адвокат	ɐdwɔkɑt
вже	wʒɛ
послаблювати	pɔsɫɑblʲʊʋɐte
вісім	ʋʲisʲim
сани	sɑne
мусульманство	mʊsʊlʲmɑnstwɔ
потужний	potuʒnei̯
експедиціях	ekspedɪt͡sʲijɐx
бавовняний	bɐwɔu̯nʲɑnei̯
перезаписувати	perezɐpɪsʊʋɐte
люд	lʲud
страшило	strɐʃɪɫɔ
байт	bɑi̯t
напрям	nɑprʲɐm
новини	nɔʋɪne
журити	ʒʊrɪte
випадок	ʋɪpɐdɔk
кінчик	kʲint͡ʃek
блакитний	bɫɐkɪtnei̯
мою	mɔju
застуді	zɐstudʲi
альянс	ɐlʲjɑns
душевний	dʊʃɛu̯nei̯
ацтек	ɐt͡stɛk
діяти	dʲijɐte
сосна	sɔsnɐ
ідентифікаційний	identefʲikɐt͡sʲii̯nei̯
ріпу	rʲipʊ
приземлення	prezɛmɫenʲːɐ
артерій	ɐrtɛrʲii̯
атака	ɐtɑkɐ
візантій	ʋʲizɑnʲtʲii̯
бик	bɪk
панство	pɑnstwɔ
г	ɦ
македонський	mɐkedɔnʲsʲkei̯
чемний	t͡ʃɛmnei̯
гібридна	ɦʲibrɪdnɐ
олімпіада	ɔlʲimpʲiɑdɐ
навколишнє	nɐu̯kɔɫeʃnʲe
ткаля	tkɑlʲɐ
лелека	ɫeɫɛkɐ
тацям	tɑt͡sʲɐm
листопад	ɫestɔpɑd
сімнадцятий	sʲimnɑd͡zʲt͡sʲɐtei̯
ґендер	ɡɛnder
женева	ʒenɛʋɐ
літак	lʲitɑk
кури	kure
середньовічний	seredʲnʲɔʋʲit͡ʃnei̯
парадигматичний	pɐrɐdeɦmɐtɪt͡ʃnei̯
актуальний	ɐktʊɑlʲnei̯
супутниковий	sʊputnekɔʋei̯
самоконтроль	sɐmɔkɔntrɔlʲ
гіперактивність	ɦʲiperɐktɪu̯nʲisʲtʲ
розвага	rɔzʋɑɦɐ
паралель	pɐrɐɫɛlʲ
узаконювати	ʊzɐkɔnʲʊʋɐte
пляж	plʲɑʒ
конкурентний	kɔnkʊrɛntnei̯
брак	brɑk
станція	stɑnʲt͡sʲijɐ
лікарство	lʲikɑrstwɔ
коригувати	kɔreɦʊʋɑte
сирота	serɔtɑ
хобі	xɔbʲi
з	z
щоранку	ʃt͡ʃɔrɑnkʊ
холодильник	xɔɫɔdɪlʲnek
катастрофічний	kɐtɐstrofʲit͡ʃnei̯
виглядати	ʋeɦlʲɐdɑte
сполучення	spoɫut͡ʃenʲːɐ
забруднити	zɐbrʊdnɪte
очікувати	ot͡ʃʲikʊʋɐte
розв'язувати	rɔzʋjɑzʊʋɐte
спідниця	sʲpʲidnɪt͡sʲɐ
йорданія	jɔrdɑnʲijɐ
безпека	bezpɛkɐ
біометрія	bʲiɔmɛtʲrʲijɐ
атлантичний	ɐtɫɐntɪt͡ʃnei̯
муж	muʒ
організмів	ɔrɦɐnʲizʲmʲiu̯
довірити	dɔʋʲirete
комунікація	kɔmʊnʲikɑt͡sʲijɐ
космологічний	kɔsmɔɫoɦʲit͡ʃnei̯
безболісність	bezbɔlʲisʲnʲisʲtʲ
мереживо	merɛʒewɔ
відповісти	ʋʲidpɔʋʲistɪ
працівницями	prɐt͡sʲiu̯nɪt͡sʲɐme
невіста	neʋʲistɐ
нещасливий	neʃt͡ʃɐsɫɪʋei̯
внук	wnuk
пішохода	pʲiʃɔxɔdɐ
несвідомо	nesʲʋʲidɔmɔ
маастрихт	mɐɑstrɪxt
думати	dumɐte
визнати	ʋɪznɐte
прекрасний	prekrɑsnei̯
ситуацій	setʊɑt͡sʲii̯
маніпуляція	mɐnʲipʊlʲɑt͡sʲijɐ
стаття	stɐtʲːɑ
місіонер	mʲisʲiɔnɛr
дрізд	dʲrʲizd
бондар	bɔndɐr
кість	kʲisʲtʲ
еякуляція	ejɐkʊlʲɑt͡sʲijɐ
вісла	ʋʲisɫɐ
хліб	xlʲib
оптимістичний	ɔptemʲistɪt͡ʃnei̯
цегляний	t͡seɦlʲɐnɪi̯
ясний	jɑsnei̯
практично	prɐktɪt͡ʃnɔ
пересічний	peresʲit͡ʃnɪi̯
слівця	sʲlʲiu̯t͡sʲɑ
фальшивий	fɐlʲʃɪʋei̯
трапитися	trɑpetesʲɐ
брамо	brɑmɔ
титар	tɪtɐr
лакрос	ɫɐkrɔs
упорядковувати	ʊpɔrʲɐdkɔwʊʋɐte
утратах	ʊtrɑtɐx
громило	ɦrɔmɪɫɔ
космологія	kɔsmɔɫɔɦʲijɐ
ключ	klʲut͡ʃ
підтримка	pʲidtrɪmkɐ
костьол	kɔsʲtʲɔɫ
повномасштабний	pɔu̯nɔmɐʃːtɑbnei̯
максимум	mɑksemʊm
телеведуча	teɫeʋedut͡ʃɐ
чомусь	t͡ʃɔmʊsʲ
ензим	enzɪm
інерційний	inert͡sʲii̯nei̯
потрібний	potʲrʲibnei̯
ґандж	ɡɑnd͡ʒ
гальмо	ɦɐlʲmɔ
мінімізувати	mʲinʲimʲizʊʋɑte
вантажити	ʋɐntɑʒete
ховати	xɔʋɑte
замощувати	zɐmɔʃt͡ʃʊʋɐte
совість	sɔʋʲisʲtʲ
століття	stolʲitʲːɐ
реля	rɛlʲɐ
вад	ʋɑd
господине	ɦɔspɔdɪne
дубові	dʊbɔʋʲi
самоціль	sɐmot͡sʲilʲ
щит	ʃt͡ʃɪt
блокада	bɫɔkɑdɐ
дерзкий	derzkɪi̯
олена	ɔɫɛnɐ
вищезгаданий	ʋeʃt͡ʃezɦɑdɐnei̯
пароплав	pɐrɔpɫɑu̯
формулювати	fɔrmʊlʲʊʋɑte
сусідка	sʊsʲidkɐ
кравчук	krɐu̯t͡ʃuk
впевненість	ʍpɛu̯nenʲisʲtʲ
матрьошка	mɐtʲrʲɔʃkɐ
масажувати	mɐsɐʒʊʋɑte
війна	ʋʲii̯nɑ
писар	pɪsɐr
татусь	tɐtusʲ
модифікувати	mɔdefʲikʊʋɑte
муніципальний	mʊnʲit͡sepɑlʲnei̯
міцний	mʲit͡snɪi̯
арктангенс	ɐrktɑnɦens
академічний	ɐkɐdemʲit͡ʃnei̯
брехати	brexɑte
туреччина	tʊrɛt͡ʃːenɐ
тунелями	tʊnɛlʲɐme
діафрагму	dʲiɐfrɑɦmʊ
тварина	tʋɐrɪnɐ
кліматологія	klʲimɐtɔɫɔɦʲijɐ
референдумам	referɛndʊmɐm
зв'язки	zʋjɑzke
нещодавно	neʃt͡ʃɔdɑu̯nɔ
перешкодити	pereʃkɔdete
розташований	rɔztɐʃɔʋɐnei̯
трудність	trudʲnʲisʲtʲ
річний	rʲit͡ʃnɪi̯
від	ʋʲid
в'їзд	ʋjizd
руанда	rʊɑndɐ
метеорит	meteɔrɪt
мерти	mɛrte
груша	ɦruʃɐ
ланцет	ɫɐnt͡sɛt
тривалість	treʋɑlʲisʲtʲ
скласти	skɫɑste
батярки	bɐtʲɐrkɪ
вистачати	ʋestɐt͡ʃɑte
наручний	nɐrut͡ʃnei̯
держава	derʒɑʋɐ
кислотний	kesɫɔtnei̯
найманка	nɑi̯mɐnkɐ
критерій	kretɛrʲii̯
динаміка	denɑmʲikɐ
штани	ʃtɐnɪ
убивство	ʊbɪu̯stwɔ
напружити	nɐpruʒete
відзвітувати	zʲʋʲitʊʋɑte
запобігти	zɐpobʲiɦte
письменність	pesʲmɛnʲːisʲtʲ
примусити	premusete
схематизувати	sxemɐtezʊʋɑte
юність	junʲisʲtʲ
постати	pɔstɑte
хлорувати	xɫɔrʊʋɑte
референдум	referɛndʊm
практичний	prɐktɪt͡ʃnei̯
попередній	pɔperɛdʲnʲii̯
тацями	tɑt͡sʲɐme
брехням	brɛxnʲɐm
упорядкувати	ʊpɔrʲɐdkʊʋɑte
недоконаний	nedɔkɔnɐnei̯
органів	ɔrɦɐnʲiu̯
кілька	kʲilʲkɐ
сторож	stɔrɔʒ
втручання	ʍtrʊt͡ʃɑnʲːɐ
календарів	kɐɫendɐrʲiu̯
охоронити	ɔxɔrɔnɪte
ефір	efʲir
таке	tɐkɛ
небога	nebɔɦɐ
цукерка	t͡sʊkɛrkɐ
тестування	testʊʋɑnʲːɐ
авіаполіт	ɐʋʲiɐpolʲit
мостовий	mɔstɔʋɪi̯
дванадцять	dʋɐnɑd͡zʲt͡sʲɐtʲ
несподіванка	nespodʲiʋɐnkɐ
додати	dɔdɑte
стріла	stʲrʲiɫɑ
персефона	persefɔnɐ
вітальням	ʋʲitɑlʲnʲɐm
україна	ʊkrɐjinɐ
еректильний	erektɪlʲnei̯
вихваляти	ʋexʋɐlʲɑte
ізраїльтянин	izrɐjilʲtʲɑnen
підприємницький	pʲidprejɛmnet͡sʲkei̯
аеропорт	ɐerɔpɔrt
червень	t͡ʃɛrʋenʲ
покладати	pɔkɫɐdɑte
диня	dɪnʲɐ
комір	kɔmʲir
бутан	bʊtɑn
жати	ʒɑte
переговори	pereɦɔwɔre
неправдивий	neprɐu̯dɪʋei̯
делегаціями	deɫeɦɑt͡sʲijɐme
зрозуміти	zrɔzʊmʲite
смак	smɑk
волонтерство	wɔɫɔntɛrstwɔ
хутро	xutrɔ
неправдою	neprɑu̯dɔjʊ
невідкладний	neʋʲidkɫɑdnei̯
джунглі	d͡ʒunɦlʲi
лікарне	lʲikɑrne
безнадійність	beznɐdʲii̯nʲisʲtʲ
щік	ʃt͡ʃʲik
обставина	ɔbstɑʋenɐ
вогонь	wɔɦɔnʲ
повіками	pɔʋʲikɐme
стомити	stɔmɪte
мітохондрія	mʲitɔxɔndʲrʲijɐ
пердіти	perdʲite
досяжний	dɔsʲɑʒnei̯
споживати	spɔʒeʋɑte
вірьовка	ʋʲirʲɔu̯kɐ
хвилинка	xʋeɫɪnkɐ
том	tɔm
швидкостями	ʃʋɪdkɔsʲtʲɐme
наступниця	nɐstupnet͡sʲɐ
чому	t͡ʃomu
дійти	dʲii̯tɪ
велосипед	ʋeɫɔsepɛd
гаджуґа	ɦɐd͡ʒuɡɐ
тягати	tʲɐɦɑte
наука	nɐukɐ
батьківщина	bɑtʲkʲiu̯ʃt͡ʃenɐ
зоомагазин	zɔɔmɐɦɐzɪn
ґей	ɡɛi̯
диво	dɪwɔ
течія	tet͡ʃʲijɑ
евтаназія	eu̯tɐnɑzʲijɐ
версія	ʋɛrsʲijɐ
складатися	skɫɐdɑtesʲɐ
пляшка	plʲɑʃkɐ
аерофлот	ɐerɔfɫɔt
колись	kɔɫɪsʲ
належати	nɐɫɛʒɐte
ліфт	lʲift
стар	stɑr
цифра	t͡sɪfrɐ
чотирнадцять	t͡ʃɔternɑd͡zʲt͡sʲɐtʲ
кава	kɑʋɐ
винахідник	ʋenɐxʲidnek
антагонізм	ɐntɐɦonʲizm
поздоровляти	pɔzdɔrɔu̯lʲɑte
адаптувати	ɐdɐptʊʋɑte
євразія	jeu̯rɑzʲijɐ
кримові	krɪmɔʋʲi
лабораторіє	ɫɐbɔrɐtɔrʲije
щорічний	ʃt͡ʃorʲit͡ʃnei̯
кубічний	kʊbʲit͡ʃnei̯
психіатричний	psexʲiɐtrɪt͡ʃnei̯
підсумувати	pʲid͡zsʊmʊʋɑte
тротуарі	trɔtʊɑrʲi
змова	zmɔʋɐ
закарпаття	zɐkɐrpɑtʲːɐ
авантура	ɐʋɐnturɐ
кільце	kʲilʲt͡sɛ
імперіями	impɛrʲijɐme
р	r
приїжджати	prejiʒd͡ʒɑte
етнічний	etʲnʲit͡ʃnei̯
оцінка	ot͡sʲinkɐ
диплома	depɫɔmɐ
бритва	brɪtʋɐ
магніт	mɐɦnʲit
поема	pɔɛmɐ
король	kɔrɔlʲ
супруги	sʊpruɦe
пташка	ptɑʃkɐ
чемпіон	t͡ʃempʲiɔn
прабабуся	prɐbɐbusʲɐ
нескінченний	nesʲkʲint͡ʃɛnːei̯
збільшити	zʲbʲilʲʃete
зцілити	zʲt͡sʲiɫɪte
політика	polʲitekɐ
сонячна	sɔnʲɐt͡ʃnɐ
господиням	ɦɔspɔdɪnʲɐm
смарагдовий	smɐrɑɦdɔʋei̯
засновувати	zɐsnɔwʊʋɐte
теплий	tɛpɫei̯
хоронити	xɔrɔnɪte
зв'язку	zʋjɐzku
допомагати	dɔpɔmɐɦɑte
знайомитися	znɐjɔmetesʲɐ
авіз	ɐʋʲiz
електромагніт	eɫektrɔmɐɦnʲit
рис	rɪs
самопочуття	sɐmɔpɔt͡ʃʊtʲːɑ
двоногий	dwɔnɔɦei̯
червець	t͡ʃerʋɛt͡sʲ
живопис	ʒewɔpes
віддаленість	ʋʲidːɑɫenʲisʲtʲ
вміння	wmʲinʲːɐ
варіантах	ʋɐrʲiɑntɐx
дипломатія	depɫɔmɑtʲijɐ
інструкціями	instrukt͡sʲijɐme
автоапологія	ɐu̯tɔɐpɔɫɔɦʲijɐ
цивілізаційний	t͡seʋʲilʲizɐt͡sʲii̯nei̯
лікарнями	lʲikɑrnʲɐme
перед	pɛred
упередження	ʊperɛd͡ʒenʲːɐ
вівсі	ʋʲiu̯sʲi
японець	jɐpɔnet͡sʲ
чаклунство	t͡ʃɐkɫunstwɔ
надлишковий	nɐdɫɪʃkɔʋei̯
градус	ɦrɑdʊs
блокади	bɫɔkɑde
інтеграція	inteɦrɑt͡sʲijɐ
тротуарами	trɔtʊɑrɐme
лікарня	lʲikɑrnʲɐ
фін	fʲin
летіти	ɫetʲite
поінформувати	pɔinfɔrmʊʋɑte
індія	inʲdʲijɐ
постатей	pɔstɐtei̯
монархію	mɔnɑrxʲijʊ
трефа	trɛfɐ
острів	ɔstʲrʲiu̯
сонечко	sɔnet͡ʃkɔ
почувати	pɔt͡ʃʊʋɑte
газета	ɦɐzɛtɐ
природознавець	prerɔdɔznɑʋet͡sʲ
смартфон	smɐrtfɔn
анексувати	ɐneksʊʋɑte
постатями	pɔstɐtʲɐme
періодично	perʲiɔdɪt͡ʃnɔ
нева	neʋɑ
мет	mɛt
щавель	ʃt͡ʃɐʋɛlʲ
телеведучий	teɫeʋedut͡ʃei̯
розпач	rɔzpɐt͡ʃ
чабер	t͡ʃɐbɛr
мусити	musete
полячка	pɔlʲɑt͡ʃkɐ
відпочилий	ʋʲidpɔt͡ʃɪɫei̯
бета	bɛtɐ
їдиш	jideʃ
битвах	bɪtʋɐx
іго	iɦɔ
шкода	ʃkɔdɐ
приборкувати	prebɔrkʊʋɐte
данелаг	dɐneɫɑɦ
тютюн	tʲʊtʲun
точний	tɔt͡ʃnei̯
садівниця	sɐdʲiu̯nɪt͡sʲɐ
ваш	ʋɑʃ
вовкулака	wɔu̯kʊɫɑkɐ
арабський	ɐrɑbsʲkei̯
дубові	dubɔʋʲi
автоводоцистерна	ɐu̯tɔwɔdɔt͡sestɛrnɐ
шановний	ʃɐnɔu̯nei̯
баклан	bɐkɫɑn
батяр	bɐtʲɑr
чорничник	t͡ʃɔrnɪt͡ʃnek
середній	serɛdʲnʲii̯
показувати	pɔkɑzʊʋɐte
привітати	preʋʲitɑte
жовч	ʒɔu̯t͡ʃ
дбайливий	dbɐi̯ɫɪʋei̯
експедицій	ekspedɪt͡sʲii̯
авіафахівець	ɐʋʲiɐfɐxʲiʋɛt͡sʲ
землевласник	zemɫeu̯ɫɑsnek
сукало	sʊkɑɫɔ
георгій	ɦeɔrɦʲii̯
юшка	juʃkɐ
етнограф	etnɔɦrɐf
сльоза	sʲlʲɔzɑ
бісексуальний	bʲiseksʊɑlʲnei̯
транзит	trɐnzɪt
специфікація	spet͡sefʲikɑt͡sʲijɐ
епізодичний	epʲizɔdɪt͡ʃnei̯
восьмий	wɔsʲmei̯
зміщувати	zʲmʲiʃt͡ʃʊʋɐte
оксана	ɔksɑnɐ
вентиляція	ʋentelʲɑt͡sʲijɐ
худнути	xudnʊte
єгор	jeɦɔr
народжувати	nɐrɔd͡ʒʊʋɐte
ігнорувати	iɦnɔrʊʋɑte
пакистан	pɐkestɑn
вийти	ʋɪi̯te
інженерка	inʒenɛrkɐ
берег	bɛreɦ
суб'єктивний	sʊbjektɪu̯nei̯
австрійка	ɐu̯stʲrʲii̯kɐ
жила	ʒɪɫɐ
рушник	rʊʃnɪk
маленький	mɐɫɛnʲkei̯
аномалія	ɐnɔmɑlʲijɐ
відмінний	ʋʲidʲmʲinːei̯
зображувати	zɔbrɑʒʊʋɐte
теорії	teɔrʲiji
персонаж	persɔnɑʒ
тепловий	tepɫɔʋɪi̯
застуда	zɐstudɐ
відлічувати	ʋʲidʲlʲit͡ʃʊʋɐte
миттєвий	metʲːɛʋei̯
вохра	wɔxrɐ
тирана	terɑnɐ
руча	rʊt͡ʃɑ
перевірка	pereʋʲirkɐ
доросліший	dɔrɔsʲlʲiʃei̯
корея	kɔrɛjɐ
період	perʲiɔd
абстинентка	ɐbstenɛntkɐ
цукрова	t͡sʊkrɔʋɐ
келих	kɛɫex
криму	krɪmʊ
дерен	derɛn
знайомити	znɐjɔmete
п'ятисот	pjɐtesɔt
щомісячний	ʃt͡ʃomʲisʲɐt͡ʃnei̯
віно	ʋʲinɔ
конкретний	kɔnkrɛtnei̯
меж	mɛʒ
віяти	ʋʲijɐte
фінський	fʲinʲsʲkei̯
чудовий	t͡ʃʊdɔʋei̯
адміністративний	ɐdʲmʲinʲistrɐtɪu̯nei̯
використати	ʋɪkɔrestɐte
крапля	krɑplʲɐ
внесок	wnɛsɔk
словечко	sɫɔʋɛt͡ʃkɔ
коротший	kɔrɔt͡ʃʃei̯
подвоювати	pɔdwɔjʊʋɐte
швидко	ʃʋɪdkɔ
сумісний	sʊmʲisnei̯
автореференція	ɑu̯tɔreferɛnʲt͡sʲijɐ
посередниця	pɔserɛdnet͡sʲɐ
заможний	zɐmɔʒnei̯
куниця	kʊnɪt͡sʲɐ
тополею	tɔpɔɫejʊ
конфіскувати	kɔnʲfʲiskʊʋɑte
пішохідна	pʲiʃoxʲidnɐ
сергій	serɦʲii̯
загострювати	zɐɦɔstʲrʲʊʋɐte
лісівництво	lʲisʲiu̯nɪt͡stwɔ
віях	ʋʲijɐx
переводити	perewɔdete
кіно	kʲinɔ
англійка	ɐnɦlʲii̯kɐ
молодий	mɔɫɔdɪi̯
десертів	desɛrtʲiu̯
крикливий	krekɫɪʋei̯
автоматична	ɐu̯tɔmɐtɪt͡ʃnɐ
наявність	nɐjɑu̯nʲisʲtʲ
зменшувати	zmɛnʃʊʋɐte
лист	ɫɪst
заробітна	zɐrobʲitnɐ
монархіях	mɔnɑrxʲijɐx
схід	sʲxʲid
різниця	rʲiznɪt͡sʲɐ
схильність	sxɪlʲnʲisʲtʲ
стремено	stremenɔ
ансамбль	ɐnsɑmblʲ
авансотримач	ɐʋɐnsɔtremɑt͡ʃ
черненко	t͡ʃernɛnkɔ
погрозити	pɔɦrɔzɪte
вагатися	ʋɐɦɑtesʲɐ
стародавній	stɐrɔdɑu̯nʲii̯
михайло	mexɑi̯ɫɔ
беззастережний	bezːɐsterɛʒnei̯
комп'ютеризація	kɔmpjʊterezɑt͡sʲijɐ
осел	ɔsɛɫ
учити	ʊt͡ʃɪte
анексія	ɐnɛksʲijɐ
тугий	tʊɦɪi̯
скоблити	skɔbɫɪte
сісти	sʲiste
ззаду	zːɑdʊ
стандартизувати	stɐndɐrtezʊʋɑte
артеріям	ɐrtɛrʲijɐm
боржниця	bɔrʒnɪt͡sʲɐ
переважувати	pereʋɑʒʊʋɐte
казахський	kɐzɑxsʲkei̯
суперниця	sʊpɛrnet͡sʲɐ
харчування	xɐrt͡ʃʊʋɑnʲːɐ
сирник	sɪrnek
зупинятися	zʊpenʲɑtesʲɐ
худий	xʊdɪi̯
тошо	tɔʃɔ
пилосос	peɫɔsɔs
центральноєвропейський	t͡sentrɐlʲnɔjeu̯rɔpɛi̯sʲkei̯
дочка	dɔt͡ʃkɑ
самодостатність	sɐmɔdɔstɑtʲnʲisʲtʲ
чернець	t͡ʃernɛt͡sʲ
прийменник	prei̯mɛnːek
динамічно	denɐmʲit͡ʃnɔ
оволодіти	ɔwɔɫodʲite
сідниці	sʲidnɪt͡sʲi
кубинка	kʊbɪnkɐ
вірний	ʋʲirnei̯
скорб	skɔrb
ватру	ʋɑtrʊ
фрагменти	frɐɦmɛnte
авіалайнер	ɐʋʲiɐɫɑi̯ner
організаціями	ɔrɦɐnʲizɑt͡sʲijɐme
авіазагін	ɐʋʲiɐzɐɦʲin
пропозицію	prɔpɔzɪt͡sʲijʊ
відображати	ʋʲidɔbrɐʒɑte
якнайскоріше	jɐknɐi̯skorʲiʃe
гринда	ɦrɪndɐ
шабля	ʃɑblʲɐ
онтологічний	ɔntɔɫoɦʲit͡ʃnei̯
трибунал	trebʊnɑɫ
експедицією	ekspedɪt͡sʲijejʊ
скульптор	skulʲptɔr
територіальний	teretɔrʲiɑlʲnei̯
страшидло	strɐʃɪdɫɔ
цілком	t͡sʲiɫkɔm
пекло	pɛkɫɔ
пан	pɑn
ялта	jɑɫtɐ
інерцію	inɛrt͡sʲijʊ
суднобудівник	sʊdnɔbʊdʲiu̯nɪk
ведмідь	ʋedʲmʲidʲ
рівень	rʲiʋenʲ
та	tɑ
паразит	pɐrɐzɪt
юрисдикція	jʊrezdɪkt͡sʲijɐ
співати	sʲpʲiʋɑte
кубинський	kʊbɪnʲsʲkei̯
авіфауна	ɐʋʲifɑʊnɐ
старий	stɐrɪi̯
ратифікація	rɐtefʲikɑt͡sʲijɐ
треба	trɛbɐ
позбуватися	pɔzbʊʋɑtesʲɐ
записувати	zɐpɪsʊʋɐte
бавитися	bɑʋetesʲɐ
інженер	inʒenɛr
основному	ɔsnɔu̯nɔmʊ
семінар	semʲinɑr
переслідувати	peresʲlʲidʊʋɐte
небо	nɛbɔ
реконструювати	rekɔnstrʊjʊʋɑte
витрачати	ʋetrɐt͡ʃɑte
вузол	wuzɔɫ
повноваження	pɔu̯nɔʋɑʒenʲːɐ
експериментувати	eksperementʊʋɑte
стандартів	stɐndɑrtʲiu̯
баварський	bɐʋɑrsʲkei̯
рилами	rɪɫɐme
нечутний	net͡ʃutnei̯
катастрофах	kɐtɐstrɔfɐx
гуляш	ɦʊlʲɑʃ
висота	ʋesɔtɑ
тренер	trɛner
відати	ʋʲidɐte
лисиця	ɫesɪt͡sʲɐ
якір	jɑkʲir
розмити	rɔzmɪte
глек	ɦɫɛk
процвітати	prɔt͡sʲʋʲitɑte
федерації	federɑt͡sʲiji
фотографії	fɔtɔɦrɑfʲiji
син	sɪn
колега	kɔɫɛɦɐ
ігри	iɦre
хвалити	xʋɐɫɪte
євразійський	jeu̯rɐzʲii̯sʲkei̯
рукою	rʊkɔjʊ
щиколотку	ʃt͡ʃɪkɔɫɔtkʊ
таці	tɑt͡sʲi
технологія	texnɔɫɔɦʲijɐ
страйк	strɑi̯k
рильцях	rɪlʲt͡sʲɐx
ній	nʲii̯
взаємозалежний	wzɐjemɔzɐɫɛʒnei̯
вільна	ʋʲilʲnɐ
призначення	preznɑt͡ʃenʲːɐ
церква	t͡sɛrkʋɐ
витратити	ʋɪtrɐtete
зняти	zʲnʲɑte
присутність	presutʲnʲisʲtʲ
зубр	zubr
вершки	ʋerʃkɪ
енциклопедія	ent͡sekɫɔpɛdʲijɐ
чоловік	t͡ʃɔɫɔʋʲik
відчувати	ʋʲid͡ʒt͡ʃʊʋɑte
сороковий	sɔrɔkɔʋei̯
гуляти	ɦʊlʲɑte
словечкові	sɫɔʋɛt͡ʃkɔʋʲi
сексуальний	seksʊɑlʲnei̯
вихідний	ʋexʲidnɪi̯
мечами	met͡ʃɑme
пробачити	prɔbɑt͡ʃete
проголошення	prɔɦɔɫɔʃenʲːɐ
революція	rewolʲut͡sʲijɐ
гамузом	ɦɑmʊzɔm
бджола	bd͡ʒɔɫɑ
поневолити	pɔnewɔɫete
який	jɐkɪi̯
ти	tɪ
книжках	kneʒkɑx
прапор	prɑpɔr
додатків	dɔdɑtʲkʲiu̯
запитання	zɐpetɑnʲːɐ
звертатися	zʋertɑtesʲɐ
всюдисущий	ʍsʲʊdesuʃt͡ʃei̯
сімнадцять	sʲimnɑd͡zʲt͡sʲɐtʲ
імперський	impɛrsʲkei̯
мусульманський	mʊsʊlʲmɑnʲsʲkei̯
автовакцина	ɐu̯tɔʋɐkt͡sɪnɐ
оса	ɔsɑ
добувати	dɔbʊʋɑte
структура	strʊkturɐ
ім'я	imjɑ
плутократіям	pɫʊtɔkrɑtʲijɐm
дзьоб	d͡zʲɔb
пенсія	pɛnʲsʲijɐ
дзвонити	d͡zwɔnɪte
могутній	mɔɦʊtʲnʲii̯
лабораторій	ɫɐbɔrɐtɔrʲii̯
авіаобприскування	ɐʋʲiɐɔbprɪskʊʋɐnʲːɐ
півень	pʲiʋenʲ
геометрична	ɦeɔmetrɪt͡ʃnɐ
корона	kɔrɔnɐ
сірий	sʲirei̯
селянство	selʲɑnstwɔ
конкретизація	kɔnkretezɑt͡sʲijɐ
інфекцію	infɛkt͡sʲijʊ
істерія	isterʲijɐ
фоб	fɔb
заслужити	zɐsɫʊʒɪte
ґазда	ɡɐzdɑ
неможливий	nemɔʒɫɪʋei̯
піднебіння	pʲidnebʲinʲːɐ
вони	wɔnɪ
купи	kupe
швеція	ʃʋɛt͡sʲijɐ
мимоволі	memɔwɔlʲi
емоцій	emɔt͡sʲii̯
посередник	pɔserɛdnek
ствол	stwɔɫ
містобудування	mʲistɔbʊdʊʋɑnʲːɐ
їх	jix
воша	wɔʃɐ
приваблювати	preʋɑblʲʊʋɐte
шанс	ʃɑns
поняття	pɔnʲɑtʲːɐ
довгий	dɔu̯ɦei̯
аварійник	ɐʋɐrʲii̯nek
інфекції	infɛkt͡sʲiji
зубрило	zʊbrɪɫɔ
екстремальний	ekstremɑlʲnei̯
одержувачка	ɔdɛrʒʊʋɐt͡ʃkɐ
зовнішня	zɔu̯nʲiʃnʲɐ
підлогу	pʲidɫɔɦʊ
стоматолог	stɔmɐtɔɫɔɦ
пригодницький	preɦɔdnet͡sʲkei̯
птах	ptɑx
бідувати	bʲidʊʋɑte
специфіка	spet͡sɪfʲikɐ
груди	ɦrude
бистрий	bɪstrei̯
вчити	ʍt͡ʃɪte
професор	prɔfɛsɔr
пральня	prɑlʲnʲɐ
ірландець	irɫɑndet͡sʲ
лаваш	ɫɐʋɑʃ
легітимація	ɫeɦʲitemɑt͡sʲijɐ
вбити	wbɪte
менеджмент	mɛned͡ʒment
компактність	kɔmpɑktʲnʲisʲtʲ
інтерпретувати	interpretʊʋɑte
дідусь	dʲidusʲ
риторика	retɔrekɐ
улюбленка	ʊlʲubɫenkɐ
сконцентрувати	skɔnt͡sentrʊʋɑte
клуб	kɫub
тою	tɔjʊ
абрис	ɑbres
ілона	iɫɔnɐ
кардіологія	kɐrdʲiɔɫɔɦʲijɐ
з'їдати	zjidɑte
свинець	sʋenɛt͡sʲ
імунологічний	imʊnɔɫoɦʲit͡ʃnei̯
налаштовувати	nɐɫɐʃtɔwʊʋɐte
австралійський	ɐu̯strɐlʲii̯sʲkei̯
неспокій	nespɔkʲii̯
кондитерський	kɔndɪtersʲkei̯
цвіль	t͡sʋilʲ
конференція	kɔnferɛnʲt͡sʲijɐ
доброчесний	dɔbrɔt͡ʃɛsnei̯
чудило	t͡ʃʊdɪɫɔ
масштаб	mɐʃːtɑb
урядовий	ʊrʲɐdɔʋei̯
делірій	delʲirʲii̯
тацю	tɑt͡sʲʊ
авіасполучення	ɐʋʲiɐspoɫut͡ʃenʲːɐ
сатира	sɐtɪrɐ
патологія	pɐtɔɫɔɦʲijɐ
діагностувати	dʲiɐɦnɔstʊʋɑte
підкорити	pʲidkɔrɪte
складний	skɫɑdnei̯
видра	ʋɪdrɐ
аблатив	ɐbɫɐtɪu̯
іванов	iʋɐnɔu̯
винаходити	ʋenɐxɔdete
словечкам	sɫɔʋɛt͡ʃkɐm
посміхатися	pɔsʲmʲixɑtesʲɐ
каплице	kɐpɫɪt͡se
сінгапур	sʲinɦɐpur
інцидент	int͡sedɛnt
троль	trɔlʲ
геоморфологія	ɦeɔmɔrfɔɫɔɦʲijɐ
феях	fɛjɐx
деталь	detɑlʲ
навидіти	nɑʋedʲite
страждати	strɐʒdɑte
інцидентах	int͡sedɛntɐx
забобон	zɐbɔbɔn
завдяки	zɐu̯dʲɐkɪ
милосердний	meɫɔsɛrdnei̯
додому	dɔdɔmʊ
випроменити	ʋɪprɔmenete
козирок	kɔzerɔk
назвати	nɐzʋɑte
майже	mɑi̯ʒe
нестача	nestɑt͡ʃɐ
абаз	ɐbɑz
стіг	sʲtʲiɦ
теоріях	teɔrʲijɐx
структурувати	strʊktʊrʊʋɑte
селезінка	seɫezʲinkɐ
голландський	ɦɔɫːɑnd͡zʲsʲkei̯
абстракціоніст	ɐbstrɐkt͡sʲionʲist
торкнутися	torknutesʲɐ
мені	menʲi
призвичаювати	prezʋet͡ʃɑjʊʋɐte
ясний	jɐsnɪi̯
лякатися	lʲɐkɑtesʲɐ
перевезення	pereʋɛzenʲːɐ
буржуазний	bʊrʒʊɑznei̯
молодице	mɔɫɔdɪt͡se
дорослішати	dɔrɔsʲlʲiʃɐte
згадувати	zɦɑdʊʋɐte
відчуття	ʋʲid͡ʒt͡ʃʊtʲːɑ
державний	derʒɑu̯nei̯
в'єтнам	ʋjetnɑm
похибка	pɔxebkɐ
почарківець	pɔt͡ʃɐrkʲiʋet͡sʲ
вивезти	ʋɪʋezte
еволюція	ewolʲut͡sʲijɐ
переводити	perewɔdɪte
лавреат	ɫɐu̯reɑt
фігура	fʲiɦurɐ
пиріг	perʲiɦ
бородавка	bɔrɔdɑu̯kɐ
квиток	kʋetɔk
учень	ut͡ʃenʲ
білоруска	bʲiɫoruskɐ
зображати	zɔbrɐʒɑte
мелодіє	meɫɔdʲije
єгипет	jeɦɪpet
вуглевод	wʊɦɫewɔd
чадо	t͡ʃɑdɔ
виборів	ʋɪbɔrʲiu̯
шомпол	ʃɔmpɔɫ
шлунок	ʃɫunɔk
телеглядачка	teɫeɦlʲɐdɑt͡ʃkɐ
причина	pret͡ʃɪnɐ
реформування	refɔrmʊʋɑnʲːɐ
доза	dɔzɐ
непередбачений	neperedbɑt͡ʃenei̯
змінювати	zʲmʲinʲʊʋɐte
абатиса	ɐbɐtɪsɐ
участь	ut͡ʃɐsʲtʲ
епічний	epʲit͡ʃnei̯
традицію	trɐdɪt͡sʲijʊ
додаткові	dɔdɑtkɔʋʲi
трав'яний	trɐʋjɐnɪi̯
заварити	zɐʋɐrɪte
номінальний	nɔmʲinɑlʲnei̯
популяризувати	pɔpʊlʲɐrezʊʋɑte
виробничий	ʋerɔbnɪt͡ʃei̯
роман	rɔmɑn
депутат	depʊtɑt
норма	nɔrmɐ
номер	nɔmer
адреса	ɑdresɐ
курва	kurʋɐ
терміновий	termʲinɔʋei̯
оптика	ɔptekɐ
битв	bɪtʋ
узлісся	ʊzʲlʲisʲːɐ
утрата	ʊtrɑtɐ
блокаді	bɫɔkɑdʲi
рилам	rɪɫɐm
посольство	pɔsɔlʲstwɔ
протитанковий	prɔtetɑnkɔʋei̯
ремісник	remʲisnɪk
турок	turɔk
швейцарка	ʃʋei̯t͡sɑrkɐ
прикордонний	prekɔrdɔnːei̯
наврез	nɐu̯rɛz
щедрий	ʃt͡ʃɛdrei̯
ґешефт	ɡeʃɛft
дрижаки	dreʒɐkɪ
ненавидіти	nenɑʋedʲite
календареві	kɐɫendɐrɛʋʲi
селище	sɛɫeʃt͡ʃe
ґатунок	ɡɐtunɔk
берлін	berlʲin
федерація	federɑt͡sʲijɐ
авіапідживлення	ɐʋʲiɐpʲid͡ʒɪu̯ɫenʲːɐ
старіти	stɐrʲite
термометрія	termɔmɛtʲrʲijɐ
віз	ʋʲiz
продовження	prɔdɔu̯ʒenʲːɐ
перевиховувати	pereʋexɔwʊʋɐte
християнин	xrestejɐnɪn
кіготь	kʲiɦɔtʲ
цім	t͡sʲim
горизонті	ɦɔrezɔnʲtʲi
мучити	mut͡ʃete
кокос	kɔkɔs
книжкова	kneʒkɔʋɐ
мрії	mrʲiji
вимова	ʋemɔʋɐ
адреса	ɐdrɛsɐ
скептицизм	skeptet͡sɪzm
творити	twɔrɪte
абандон	ɐbɐndɔn
авансцена	ɐʋɐnst͡sɛnɐ
крихітний	krɪxʲitnei̯
неділя	nedʲilʲɐ
кенія	kɛnʲijɐ
приданий	prɪdɐnei̯
співчуття	sʲpʲiu̯t͡ʃʊtʲːɑ
англіцизм	ɐnɦlʲit͡sɪzm
відчай	ʋʲid͡ʒt͡ʃɐi̯
різновид	rʲiznɔʋed
дядько	dʲɑdʲkɔ
власність	wɫɑsʲnʲisʲtʲ
сам	sɑm
обеззброїти	ɔbezːbrɔjite
вночі	wnot͡ʃʲi
військовий	ʋʲii̯sʲkɔʋei̯
порівняти	pɔrʲiu̯nʲɑte
обшукувати	obʃukʊʋɐte
дружити	drʊʒɪte
дорожчий	dɔrɔʒt͡ʃei̯
ненависть	nenɑʋesʲtʲ
вантажівка	ʋɐntɐʒʲiu̯kɐ
сталь	stɑlʲ
пень	pɛnʲ
поглиблювати	pɔɦɫɪblʲʊʋɐte
ковбаси	kɔu̯bɐsɪ
автобаза	ɐu̯tɔbɑzɐ
триста	trɪstɐ
ностальгувати	nɔstɐlʲɦʊʋɑte
абсурдно	ɐbsurdnɔ
звиклий	zʋɪkɫei̯
фіскальний	fʲiskɑlʲnei̯
познань	pɔznɐnʲ
карликова	kɑrɫekɔʋɐ
словника	sɫɔu̯nekɑ
аритметика	ɐretmɛtekɐ
інтересувати	interesʊʋɑte
авантурник	ɐʋɐnturnek
пропорцією	prɔpɔrt͡sʲijejʊ
відпочивати	ʋʲidpɔt͡ʃeʋɑte
приборкати	prebɔrkɐte
вхід	ʍxʲid
бомбосховище	bɔmbɔsxɔʋeʃt͡ʃe
багнистий	bɐɦnɪstei̯
гендер	ɦɛnder
галун	ɦɐɫun
територіальна	teretɔrʲiɑlʲnɐ
різнорідність	rʲiznorʲidʲnʲisʲtʲ
дороговказ	dɔrɔɦɔu̯kɑz
повезти	pɔʋeztɪ
брехнями	brɛxnʲɐme
зібрати	zʲibrɑte
відмінювання	ʋʲidʲmʲinʲʊʋɐnʲːɐ
лошак	ɫɔʃɑk
настати	nɐstɑte
столичний	stɔɫɪt͡ʃnei̯
телугу	tɛɫʊɦʊ
істота	istɔtɐ
конформізм	kɔnformʲizm
бойко	bɔi̯kɔ
навколишній	nɐu̯kɔɫeʃnʲii̯
мотоцикла	mɔtɔt͡sɪkɫɐ
супутник	sʊputnek
сузір'я	sʊzʲirjɐ
плотський	pɫɔt͡sʲkei̯
атеїстичний	ɐtejistɪt͡ʃnei̯
добридень	dɔbredɛnʲ
кіберпростір	kʲiberprɔsʲtʲir
діафрагм	dʲiɐfrɑɦm
аденозин	ɐdenɔzɪn
кишенька	keʃɛnʲkɐ
м'ята	mjɑtɐ
битво	bɪtwɔ
патоген	pɐtɔɦɛn
полон	pɔɫɔn
великомученик	ʋeɫekomut͡ʃenek
смородина	smɔrɔdenɐ
кишені	keʃɛnʲi
газ	ɦɑz
дуже	duʒe
так	tɑk
гад	ɦɑd
вирішення	ʋɪrʲiʃenʲːɐ
самоук	sɐmɔuk
ім'я	imjɐ
опис	ɔpes
довічний	dɔʋʲit͡ʃnei̯
критика	krɪtekɐ
словникові	sɫɔu̯nekɔʋʲi
королевич	kɔrɔɫɛʋet͡ʃ
внутрішній	wnutʲrʲiʃnʲii̯
мамо	mɑmɔ
зустріч	zustʲrʲit͡ʃ
дровця	drɔu̯t͡sʲɑ
племінниця	pɫemʲinːet͡sʲɐ
толерантність	tɔɫerɑntʲnʲisʲtʲ
гривню	ɦrɪu̯nʲʊ
колесо	kɔɫesɔ
репортер	repɔrtɛr
ідеологічний	ideɔɫoɦʲit͡ʃnei̯
шантажувати	ʃɐntɐʒʊʋɑte
вниз	wnɪz
безплатний	bezpɫɑtnei̯
наше	nɑʃe
благоговіння	bɫɐɦɔɦɔʋʲinʲːɐ
пасажирка	pɐsɐʒɪrkɐ
роззброєння	rɔzːbrɔjenʲːɐ
луна	ɫʊnɑ
здійснювати	zʲdʲii̯sʲnʲʊʋɐte
поставити	pɔstɑʋete
уманець	ʊmɐnɛt͡sʲ
ідіотичний	idʲiɔtɪt͡ʃnei̯
найбільший	nɐi̯bʲilʲʃei̯
зразок	zrɐzɔk
швидкістю	ʃʋɪdʲkʲisʲtʲʊ
сертифікація	sertefʲikɑt͡sʲijɐ
абракадабризм	ɐbrɐkɐdɐbrɪzm
довжина	dɔu̯ʒenɑ
фразеологія	frɐzeɔɫɔɦʲijɐ
дев'ять	dɛʋjɐtʲ
соціалістка	sɔt͡sʲiɐlʲistkɐ
багатозначний	bɐɦɐtɔznɑt͡ʃnei̯
християнство	xrestejɑnstwɔ
внука	wnukɐ
біднота	bʲidnɔtɑ
обов'язково	ɔbɔʋjɐzkɔwɔ
пугач	puɦɐt͡ʃ
вірменський	ʋʲirmɛnʲsʲkei̯
шпальта	ʃpɑlʲtɐ
престижний	prestɪʒnei̯
кріпкий	krʲipkɪi̯
кварк	kʋɑrk
асоціація	ɐsɔt͡sʲiɑt͡sʲijɐ
затверджувати	zɐtʋɛrd͡ʒʊʋɐte
волокти	wɔɫɔktɪ
переконувати	perekɔnʊʋɐte
настрій	nɑstʲrʲii̯
утомлений	ʊtɔmɫenei̯
перемир'я	peremɪrjɐ
очевидець	ɔt͡ʃeʋɪdet͡sʲ
теологія	teɔɫɔɦʲijɐ
енциклопедист	ent͡sekɫɔpedɪst
закохатися	zɐkɔxɑtesʲɐ
вітальні	ʋʲitɑlʲnʲi
окупувати	ɔkʊpʊʋɑte
крокодил	krɔkɔdɪɫ
адміністратор	ɐdʲmʲinʲistrɑtɔr
смертельний	smertɛlʲnei̯
консервувати	kɔnserwʊʋɑte
розумовий	rɔzʊmɔʋei̯
мис	mɪs
вершків	ʋerʃkʲiu̯
шкір	ʃkʲir
очолювати	ɔt͡ʃɔlʲʊʋɐte
роки	rɔke
буква	bukʋɐ
телескоп	teɫeskɔp
морквяний	mɔrkʋʲɑnei̯
більшого	bʲilʲʃɔɦɔ
виявляти	ʋejɐu̯lʲɑte
нейтралітет	nei̯trɐlʲitɛt
квартир	kʋɐrtɪr
юґославія	jʊɡɔsɫɑʋʲijɐ
припущення	prepuʃt͡ʃenʲːɐ
монастир	mɔnɐstɪr
фрукт	frukt
америка	ɐmɛrekɐ
містечко	mʲistɛt͡ʃkɔ
застерегти	zɐstereɦtɪ
ізраїльтянка	izrɐjilʲtʲɑnkɐ
побачити	pɔbɑt͡ʃete
обрус	obrus
наперсток	nɐpɛrstɔk
заперечувати	zɐperɛt͡ʃʊʋɐte
дякую	dʲɑkʊjʊ
всі	ʍsʲi
клятьба	klʲɐdʲbɑ
мелодій	meɫɔdʲii̯
шкірами	ʃkʲirɐme
завод	zɐwɔd
вакації	ʋɐkɑt͡sʲiji
передчасна	pered͡ʒt͡ʃɑsnɐ
ковбаса	kɔu̯bɐsɑ
сінаж	sʲinɑʒ
нагий	nɐɦɪi̯
святкувати	sʲʋʲɐtkʊʋɑte
підприємниця	pʲidprejɛmnet͡sʲɐ
бюрократ	bʲʊrɔkrɑt
повсякденний	pɔu̯sʲɐɡdɛnːei̯
радянський	rɐdʲɑnʲsʲkei̯
особливість	ɔsɔbɫɪʋʲisʲtʲ
бджільництво	bd͡ʒʲilʲnɪt͡stwɔ
індивід	indeʋʲid
криптовалюта	kreptɔʋɐlʲutɐ
сіль	sʲilʲ
хаос	xɑɔs
отрута	otrutɐ
дирижабль	dereʒɑblʲ
живий	ʒeʋɪi̯
венам	ʋɛnɐm
пізніший	pʲizʲnʲiʃei̯
знижувати	znɪʒʊʋɐte
націоналістичний	nɐt͡sʲiɔnɐlʲistɪt͡ʃnei̯
освіжати	ɔsʲʋʲiʒɑte
душ	duʃ
вітальнями	ʋʲitɑlʲnʲɐme
вербальний	ʋerbɑlʲnei̯
принцеса	prent͡sɛsɐ
емігрувати	emʲiɦrʊʋɑte
звідси	zʲʋʲid͡zse
органи	ɔrɦɐne
фіолетовий	fʲiɔɫɛtɔʋei̯
дзвінкий	d͡zʲʋʲinkɪi̯
ґава	ɡɑʋɐ
проголошений	prɔɦɔɫɔʃenei̯
безболісний	bezbɔlʲisnei̯
ізолювати	izɔlʲʊʋɑte
віднести	ʋʲidnestɪ
мужчина	mʊʒt͡ʃɪnɐ
однина	ɔdnenɑ
підтримуючий	pʲidtrɪmʊjʊt͡ʃei̯
порівнювати	porʲiu̯nʲʊʋɐte
уможливити	ʊmɔʒɫɪʋete
куба	kubɐ
деїзм	dejizm
вкус	ʍkus
число	t͡ʃesɫɔ
костел	kɔstɛɫ
особистий	ɔsɔbɪstei̯
вижлуктити	ʋɪʒɫʊktete
закономірний	zɐkɔnomʲirnei̯
спорожняти	spɔrɔʒnʲɑte
моїй	mɔjii̯
пірнути	pʲirnute
вторгатися	ʍtɔrɦɑtesʲɐ
шестисотий	ʃestesɔtei̯
танки	tɑnke
енергія	enɛrɦʲijɐ
слов'янко	sɫɔʋjɑnkɔ
авітаміноз	ɐʋʲitɐmʲinɔz
дорослий	dɔrɔsɫei̯
рало	rɑɫɔ
зоря	zɔrʲɑ
швидкість	ʃʋɪdʲkʲisʲtʲ
аномальний	ɐnɔmɑlʲnei̯
скронь	skrɔnʲ
метод	mɛtɔd
школа	ʃkɔɫɐ
ринок	rɪnɔk
обрати	ɔbrɑte
інструкцією	instrukt͡sʲijejʊ
м'язів	mjɑzʲiu̯
клітина	klʲitɪnɐ
ґвалт	ɡʋɑɫt
брід	brʲid
супруга	sʊpruɦɐ
яловичини	jɑɫɔʋet͡ʃene
автовласник	ɐu̯tɔu̯ɫɑsnek
пустиня	pʊstɪnʲɐ
раціях	rɑt͡sʲijɐx
афганський	ɐvɦɑnʲsʲkei̯
вовна	wɔu̯nɐ
корінь	kɔrʲinʲ
обіцянка	ɔbʲit͡sʲɑnkɐ
ведучий	ʋedut͡ʃei̯
мир	mɪr
олег	ɔɫɛɦ
мріє	mrʲije
сосна	sɔsnɑ
аварка	ɐʋɑrkɐ
ґедзь	ɡɛd͡zʲ
дихальний	dɪxɐlʲnei̯
погляд	pɔɦlʲɐd
ідіотка	idʲiɔtkɐ
сигнал	seɦnɑɫ
експедиціє	ekspedɪt͡sʲije
м'язі	mjɑzʲi
північноамериканський	pʲiu̯nʲit͡ʃnɔɐmerekɑnʲsʲkei̯
арештувати	ɐreʃtʊʋɑte
періодизацій	perʲiɔdezɑt͡sʲii̯
схвальний	sxʋɑlʲnei̯
почесть	pɔt͡ʃesʲtʲ
позбутися	pozbutesʲɐ
слов'янах	sɫɔʋjɑnɐx
китоголов	ketɔɦɔɫɔu̯
правопис	prɐwɔpes
авіадесант	ɐʋʲiɐdesɑnt
щокою	ʃt͡ʃɔkɔjʊ
глядач	ɦlʲɐdɑt͡ʃ
морозиво	mɔrɔzewɔ
тяти	tʲɑte
коханий	kɔxɐnei̯
словниковий	sɫɔu̯nekɔʋei̯
подібний	podʲibnei̯
джгутик	d͡ʒɦutek
ваді	ʋɑdʲi
інохідь	inɔxʲidʲ
лотерея	ɫɔterɛjɐ
бежевий	bɛʒeʋei̯
дамба	dɑmbɐ
одежа	ɔdɛʒɐ
фінляндія	fʲinʲlʲɑnʲdʲijɐ
спішити	sʲpʲiʃete
табличка	tɐbɫɪt͡ʃkɐ
вітка	ʋʲitkɐ
ложка	ɫɔʒkɐ
вим'я	ʋɪmjɐ
пояснення	pɔjɑsnenʲːɐ
аспект	ɐspɛkt
кликати	kɫɪkɐte
дієта	dʲijɛtɐ
тополь	tɔpɔlʲ
намокати	nɐmɔkɑte
автентичність	ɐu̯tentɪt͡ʃnʲisʲtʲ
менший	mɛnʃei̯
марнувати	mɐrnʊʋɑte
еякулювати	ejɐkʊlʲʊʋɑte
ні	nʲi
педагогіка	pedɐɦɔɦʲikɐ
промінь	prɔmʲinʲ
послідовний	pɔsʲlʲidɔu̯nei̯
домініканський	dɔmʲinʲikɑnʲsʲkei̯
криж	krɪʒ
яловичино	jɑɫɔʋet͡ʃenɔ
ґерлиґа	ɡerɫɪɡɐ
сплатити	spɫɐtɪte
духовенство	dʊxɔʋɛnstwɔ
дрова	drɔʋɐ
хмельницький	xmelʲnɪt͡sʲkei̯
ресторан	restɔrɑn
чернівці	t͡ʃernʲiu̯t͡sʲi
домашній	dɔmɑʃnʲii̯
трансплантація	trɐnspɫɐntɑt͡sʲijɐ
тлумачити	tɫʊmɑt͡ʃete
процес	prɔt͡sɛs
архієпископ	ɐrxʲijepɪskɔp
влаштовувати	wɫɐʃtɔwʊʋɐte
могила	mɔɦɪɫɐ
дефініції	defʲinʲit͡sʲiji
корейський	kɔrɛi̯sʲkei̯
перекладачок	perekɫɐdɑt͡ʃɔk
характеризувати	xɐrɐkterezʊʋɑte
офіра	ofʲirɐ
докторат	dɔktɔrɑt
краків	krɑkʲiu̯
фальш	fɑlʲʃ
допустимий	dɔpʊstɪmei̯
трансформацією	trɐnsfɔrmɑt͡sʲijejʊ
сніжинка	sʲnʲiʒɪnkɐ
болниця	bɔɫnɪt͡sʲɐ
території	teretɔrʲiji
гладилка	ɦɫɐdɪɫkɐ
викрутка	ʋɪkrʊtkɐ
фотографією	fɔtɔɦrɑfʲijejʊ
неправду	neprɑu̯dʊ
швидкостям	ʃʋɪdkɔsʲtʲɐm
гілка	ɦʲiɫkɐ
весняний	ʋesʲnʲɑnei̯
емілія	emʲilʲijɐ
модернізувати	mɔdernʲizʊʋɑte
зобов'язання	zɔbɔʋjɑzɐnʲːɐ
беріг	bɛrʲiɦ
русин	rʊsɪn
феєю	fɛjejʊ
смішний	sʲmʲiʃnɪi̯
голий	ɦɔɫei̯
автобатальйон	ɐu̯tɔbɐtɐlʲjɔn
авдитор	ɐu̯dɪtɔr
венеціанка	ʋenet͡sʲiɑnkɐ
мережа	merɛʒɐ
виявитися	ʋɪjɐʋetesʲɐ
природничих	prerɔdnɪt͡ʃex
засновниць	zɐsnɔu̯net͡sʲ
океан	ɔkeɑn
авіапереліт	ɐʋʲiɐperelʲit
книгарні	kneɦɑrnʲi
єременко	jerɛmenkɔ
вітальню	ʋʲitɑlʲnʲʊ
іслам	isɫɑm
блокаду	bɫɔkɑdʊ
успішний	ʊsʲpʲiʃnei̯
відгородити	ʋʲidɦɔrɔdɪte
галка	ɦɑɫkɐ
яке	jɐkɛ
продуктивний	prɔdʊktɪu̯nei̯
кора	kɔrɑ
жіночий	ʒʲinɔt͡ʃei̯
жалоба	ʒɑɫɔbɐ
вихвалити	ʋɪxʋɐɫete
переклад	perɛkɫɐd
короп	kɔrɔp
поспішати	pɔsʲpʲiʃɑte
купатися	kʊpɑtesʲɐ
надіятися	nɐdʲijɐtesʲɐ
цінність	t͡sʲinʲːisʲtʲ
байдужість	bɐi̯duʒʲisʲtʲ
гінекологічний	ɦʲinekɔɫoɦʲit͡ʃnei̯
асинхронний	ɐsenxrɔnːei̯
мойого	mɔjɔɦɔ
нетиповий	netepɔʋei̯
світогляд	sʲʋʲitɔɦlʲɐd
відстрочувати	ʋʲid͡zstrɔt͡ʃʊʋɐte
шахта	ʃɑxtɐ
ксьондз	ksʲɔnd͡z
глузд	ɦɫuzd
одужати	oduʒɐte
сільськогосподарський	sʲilʲsʲkɔɦɔspɔdɑrsʲkei̯
янтарний	jɐntɑrnei̯
абсида	ɐbsɪdɐ
мислитель	mesɫɪtelʲ
завершити	zɐʋerʃɪte
авіамаяк	ɐʋʲiɐmɐjɑk
ностальгія	nɔstɐlʲɦʲijɐ
патруль	pɐtrulʲ
ракло	rɐkɫɔ
перемістити	peremʲistɪte
психіка	psɪxʲikɐ
рим	rɪm
авіатехнік	ɐʋʲiɐtɛxnʲik
погляду	pɔɦlʲɐdʊ
печивами	pɛt͡ʃeʋɐme
вечора	ʋɛt͡ʃɔrɐ
антикорупційний	ɐntekɔrʊpt͡sʲii̯nei̯
будувати	bʊdʊʋɑte
телеканал	teɫekɐnɑɫ
відповідальний	ʋʲidpɔʋʲidɑlʲnei̯
надією	nɐdʲijejʊ
неньо	nɛnʲɔ
вигода	ʋɪɦɔdɐ
монолог	mɔnɔɫɔɦ
ноші	nɔʃʲi
шоколадка	ʃɔkɔɫɑdkɐ
програмістка	prɔɦrɐmʲistkɐ
деклараціє	dekɫɐrɑt͡sʲije
лікар	lʲikɐr
щиколоткам	ʃt͡ʃɪkɔɫɔtkɐm
подібність	podʲibnʲisʲtʲ
грець	ɦrɛt͡sʲ
босоногий	bɔsɔnɔɦei̯
фармакологія	fɐrmɐkɔɫɔɦʲijɐ
під	pʲid
найняти	nɐi̯nʲɑte
джміль	d͡ʒmʲilʲ
добраніч	dɔbrɑnʲit͡ʃ
класти	kɫɑste
керівництво	kerʲiu̯nɪt͡stwɔ
носити	nɔsɪte
річ	rʲit͡ʃ
туалет	tʊɐɫɛt
злий	zɫɪi̯
дерев'яний	dereʋjɑnei̯
тут	tut
закон	zɐkɔn
карт	kɑrt
хустка	xustkɐ
повіка	pɔʋʲikɐ
рельєф	relʲjɛf
брама	brɑmɐ
самогубство	sɐmoɦubstwɔ
позначити	pɔznɑt͡ʃete
довідник	dɔʋʲidnɪk
поїзд	pɔjizd
річка	rʲit͡ʃkɐ
абревіація	ɐbreʋʲiɑt͡sʲijɐ
змагатися	zmɐɦɑtesʲɐ
овід	ɔʋʲid
спалах	spɑɫɐx
потягати	pɔtʲɐɦɑte
шкірі	ʃkʲirʲi
житло	ʒetɫɔ
желе	ʒeɫɛ
глибина	ɦɫebenɑ
презирливий	prezɪrɫeʋei̯
приміряти	premʲirʲɐte
поїхати	pɔjixɐte
самодисципліна	sɐmɔdest͡seplʲinɐ
набагато	nɐbɐɦɑtɔ
розлючений	rozʲlʲut͡ʃenei̯
автовага	ɐu̯tɔʋɐɦɑ
авторизувати	ɐu̯tɔrezʊʋɑte
плахта	pɫɑxtɐ
шістдесятий	ʃʲizdesʲɑtei̯
сміливий	sʲmʲiɫɪʋei̯
ентомолог	entɔmɔɫɔɦ
молитва	mɔɫɪtʋɐ
париж	pɐrɪʒ
боягузливий	bɔjɐɦuzɫeʋei̯
співчутливий	sʲpʲiu̯t͡ʃʊtɫɪʋei̯
компетентність	kɔmpetɛntʲnʲisʲtʲ
тисячоліттю	tesʲɐt͡ʃolʲitʲːʊ
олігархія	ɔlʲiɦɑrxʲijɐ
клятий	klʲɑtei̯
цегла	t͡sɛɦɫɐ
університетський	ʊnʲiʋersetɛt͡sʲkei̯
колядування	kɔlʲɐdʊʋɑnʲːɐ
гнити	ɦnɪte
гамуз	ɦɑmʊz
українському	ʊkrɐjinʲsʲkɔmʊ
прадід	prɑdʲid
кораблебудівник	kɔrɐbɫebʊdʲiu̯nɪk
містичний	mʲistɪt͡ʃnei̯
повернути	pɔʋernute
глибинний	ɦɫebɪnːei̯
пінистий	pʲinɪstei̯
зайняти	zɐi̯nʲɑte
сарна	sɑrnɐ
хронологія	xrɔnɔɫɔɦʲijɐ
запам'ятовувати	zɐpɐmjɐtɔwʊʋɐte
домен	dɔmɛn
порошковий	pɔrɔʃkɔʋei̯
город	ɦɔrɔd
дівчина	dʲiu̯t͡ʃenɐ
задній	zɑdʲnʲii̯
трутень	trutenʲ
варіація	ʋɐrʲiɑt͡sʲijɐ
коштовний	kɔʃtɔu̯nei̯
ячмінь	jɐt͡ʃmʲinʲ
горизонтів	ɦɔrezɔnʲtʲiu̯
різдво	rʲizdwɔ
пасажирський	pɐsɐʒɪrsʲkei̯
безграмотний	bezɦrɑmɔtnei̯
підмет	pʲidmet
тренування	trenʊʋɑnʲːɐ
школярка	ʃkɔlʲɑrkɐ
далеко	dɐɫɛkɔ
складовий	skɫɐdɔʋɪi̯
арешт	ɐrɛʃt
поточний	pɔtɔt͡ʃnei̯
польща	pɔlʲʃt͡ʃɐ
випрати	ʋɪprɐte
арахнології	ɐrɐxnɔɫɔɦʲiji
коліс	kolʲis
висіти	ʋɪsʲite
авантюрин	ɐʋɐnʲtʲʊrɪn
партнерство	pɐrtnɛrstwɔ
доброзичливиця	dɔbrɔzɪt͡ʃɫeʋet͡sʲɐ
задовільний	zɐdɔʋʲilʲnei̯
абичого	ɐbɪt͡ʃɔɦɔ
соловій	sɔɫɔʋʲii̯
вводити	ʋːɔdete
потилицям	pɔtɪɫet͡sʲɐm
лебідь	ɫɛbʲidʲ
мінімізація	mʲinʲimʲizɑt͡sʲijɐ
дослівно	dosʲlʲiu̯nɔ
гвінея	ɦʋʲinɛjɐ
ірландський	irɫɑnd͡zʲsʲkei̯
популярний	pɔpʊlʲɑrnei̯
доступність	dostupnʲisʲtʲ
саботаж	sɐbɔtɑʒ
необмежений	neɔbmɛʒenei̯
диверсифікація	deʋersefʲikɑt͡sʲijɐ
двадцять	dʋɑd͡zʲt͡sʲɐtʲ
срібло	sʲrʲibɫɔ
канадієць	kɐnɐdʲijet͡sʲ
пальчик	pɑlʲt͡ʃek
перезаписати	perezɐpesɑte
спадщини	spɑdʃt͡ʃene
описати	ɔpesɑte
галамагати	ɦɐɫɐmɑɦɐte
переносний	perenɔsnɪi̯
пити	pɪte
людці	lʲʊd͡zʲt͡sʲi
масаж	mɐsɑʒ
каплицям	kɐpɫɪt͡sʲɐm
адміністрація	ɐdʲmʲinʲistrɑt͡sʲijɐ
виріб	ʋɪrʲib
хмарний	xmɑrnei̯
сірка	sʲirkɐ
враховувати	wrɐxɔwʊʋɐte
розподібнення	rɔzpodʲibnenʲːɐ
дилема	deɫɛmɐ
авіапошта	ɐʋʲiɐpɔʃtɐ
холодний	xɔɫɔdnei̯
критеріїв	kretɛrʲijiu̯
бабченко	bɑbt͡ʃenkɔ
пошук	pɔʃʊk
гордий	ɦɔrdei̯
м'язові	mjɑzɔʋʲi
кнайпа	knɑi̯pɐ
свобода	swɔbɔdɐ
потилиць	pɔtɪɫet͡sʲ
механіст	mexɐnʲist
вість	ʋʲisʲtʲ
підлога	pʲidɫɔɦɐ
суднобудування	sʊdnɔbʊdʊʋɑnʲːɐ
префікс	prɛfʲiks
бутерброд	bʊterbrɔd
поганий	pɔɦɑnei̯
гривня	ɦrɪu̯nʲɐ
перевозити	perewɔzete
дружелюбний	drʊʒelʲubnei̯
зустрічатися	zʊstʲrʲit͡ʃɑtesʲɐ
гігієна	ɦʲiɦʲijɛnɐ
потік	potʲik
імітація	imʲitɑt͡sʲijɐ
кишеня	keʃɛnʲɐ
панас	pɐnɑs
панікерство	pɐnʲikɛrstwɔ
мечам	met͡ʃɑm
реальний	reɑlʲnei̯
праслов'янський	prɐsɫɔʋjɑnʲsʲkei̯
брамою	brɑmɔjʊ
неістота	neistɔtɐ
віза	ʋʲizɐ
забити	zɐbɪte
діти	dʲite
спеціаліст	spet͡sʲiɐlʲist
заяви	zɐjɑʋe
соняшниковий	sɔnʲɐʃnekɔʋei̯
археологія	ɐrxeɔɫɔɦʲijɐ
господинь	ɦɔspɔdɪnʲ
маргіналізація	mɐrɦʲinɐlʲizɑt͡sʲijɐ
чиновник	t͡ʃenɔu̯nek
філіжанка	fʲilʲiʒɑnkɐ
успіх	usʲpʲix
пілот	pʲiɫɔt
віко	ʋʲikɔ
підвіконня	pʲidʲʋʲikɔnʲːɐ
супругам	sʊpruɦɐm
смакові	smɐkɔʋʲi
громико	ɦrɔmɪkɔ
слов'янках	sɫɔʋjɑnkɐx
стандартами	stɐndɑrtɐme
неврологічний	nɛu̯rɔɫoɦʲit͡ʃnei̯
одуд	ɔdʊd
початківка	pɔt͡ʃɐtʲkʲiu̯kɐ
плакати	pɫɑkɐte
індивідуалізація	indeʋʲidʊɐlʲizɑt͡sʲijɐ
працівниця	prɐt͡sʲiu̯nɪt͡sʲɐ
відеогра	ʋʲideɔɦrɑ
тротуар	trɔtʊɑr
знаходитися	znɐxɔdetesʲɐ
занотовувати	zɐnɔtɔwʊʋɐte
автентика	ɐu̯tɛntekɐ
цуценя	t͡sʊt͡senʲɑ
скло	skɫɔ
замовляти	zɐmɔu̯lʲɑte
лимонний	ɫemɔnːei̯
стовбур	stɔu̯bʊr
портфелем	pɔrtfɛɫem
безвідповідальність	bezʲʋʲidpɔʋʲidɑlʲnʲisʲtʲ
прямо	prʲɑmɔ
самотність	sɐmɔtʲnʲisʲtʲ
співзасновниця	sʲpʲiu̯zɐsnɔu̯net͡sʲɐ
осмислити	ɔsmɪsɫete
філософічний	fʲiɫɔsɔfsʲkei̯
гаяти	ɦɑjɐte
угорськомовний	ʊɦɔrsʲkɔmɔu̯nei̯
різанина	rʲizɐnɪnɐ
вітамін	ʋʲitɐmʲin
мед	mɛd
борода	bɔrɔdɑ
авіатраса	ɐʋʲiɐtrɑsɐ
ідіот	idʲiɔt
орієнтувати	ɔrʲijentʊʋɑte
пандемічний	pɐndemʲit͡ʃnei̯
траєкторія	trɐjektɔrʲijɐ
музичний	mʊzɪt͡ʃnei̯
красивий	krɐsɪʋei̯
абонування	ɐbɔnʊʋɑnʲːɐ
чобіт	t͡ʃɔbʲit
бобер	bɔbɛr
установлювати	ʊstɐnɔu̯lʲʊʋɐte
фараон	fɐrɐɔn
дізнатися	dʲiznɑtesʲɐ
готівковий	ɦɔtʲiu̯kɔʋei̯
будапештський	bʊdɐpɛsʲt͡sʲkei̯
анекдот	ɐneɡdɔt
тиск	tɪsk
визнавати	ʋeznɐʋɑte
читаний	t͡ʃɪtɐnei̯
поставати	pɔstɐʋɑte
вузький	wʊzʲkɪi̯
двоколісний	dwɔkolʲisnei̯
трагедіями	trɐɦɛdʲijɐme
захоплюватися	zɐxɔplʲʊʋɐtesʲɐ
щовечора	ʃt͡ʃɔʋɛt͡ʃɔrɐ
атом	ɑtɔm
народовладдя	nɐrɔdɔu̯ɫɑdʲːɐ
токар	tɔkɐr
наталія	nɐtɑlʲijɐ
федераціям	federɑt͡sʲijɐm
іграшка	iɦrɐʃkɐ
тріска	tʲrʲiskɑ
відповісти	ʋʲidpɔʋʲiste
назавжди	nɐzɑu̯ʒde
водночас	wɔdnɔt͡ʃɐs
приручати	prerʊt͡ʃɑte
слов'янині	sɫɔʋjɐnɪnʲi
зазначений	zɐznɐt͡ʃɛnei̯
час	t͡ʃɑs
виробити	ʋɪrɔbete
рига	rɪɦɐ
коханка	kɔxɑnkɐ
знайомий	znɐjɔmei̯
нічия	nʲit͡ʃejɑ
фотосинтетичний	fɔtɔsentetɪt͡ʃnei̯
лось	ɫɔsʲ
налаштувати	nɐɫɐʃtʊʋɑte
комедію	kɔmɛdʲijʊ
ставати	stɐʋɑte
смажити	smɑʒete
приземлятися	prezemlʲɑtesʲɐ
ескалація	eskɐɫɑt͡sʲijɐ
аварійність	ɐʋɐrʲii̯nʲisʲtʲ
убити	ʊbɪte
мироточення	merɔtɔt͡ʃenʲːɐ
паломництво	pɐɫɔmnet͡stwɔ
бажання	bɐʒɑnʲːɐ
виклад	ʋɪkɫɐd
паперовий	pɐperɔʋei̯
комах	kɔmɑx
експортувати	ekspɔrtʊʋɑte
запровадити	zɐprɔʋɑdete
турецький	tʊrɛt͡sʲkei̯
руко	rukɔ
висловитися	ʋɪsɫɔʋetesʲɐ
ефект	efɛkt
обдарувати	ɔbdɐrʊʋɑte
аллах	ɐɫːɑx
шокований	ʃɔkɔʋɐnei̯
ранній	rɑnʲːii̯
сідницю	sʲidnɪt͡sʲʊ
діафрагмі	dʲiɐfrɑɦmʲi
непривітний	nepreʋʲitnei̯
путь	putʲ
агенція	ɐɦɛnʲt͡sʲijɐ
засновник	zɐsnɔu̯nek
словачка	sɫɔʋɑt͡ʃkɐ
абразивність	ɐbrɐzɪu̯nʲisʲtʲ
березовий	berɛzɔʋei̯
єврейка	jeu̯rɛi̯kɐ
корисний	kɔresnei̯
авансодавець	ɐʋɐnsɔdɑʋet͡sʲ
патогенний	pɐtɔɦɛnːei̯
посилання	pɔseɫɑnʲːɐ
принциповий	prent͡sepɔʋei̯
зникнути	znɪknʊte
інтервал	interʋɑɫ
революціонізувати	rewɔlʲʊt͡sʲiɔnʲizʊʋɑte
глядіти	ɦlʲɐdʲite
відфільтрувати	ʋʲidʲfʲilʲtrʊʋɑte
пробудити	prɔbʊdɪte
повсталий	pɔu̯stɑɫei̯
попереджувальний	pɔperɛd͡ʒʊʋɐlʲnei̯
багатошлюбність	bɐɦɐtoʃlʲubnʲisʲtʲ
диктант	dektɑnt
використовувати	ʋekɔrestɔwʊʋɐte
скроні	skrɔnʲi
горілка	ɦorʲiɫkɐ
газопровід	ɦɐzɔprɔʋʲid
прийняти	prei̯nʲɑte
мазати	mɑzɐte
дитсадка	det͡sɐdkɑ
трансформаціями	trɐnsfɔrmɑt͡sʲijɐme
ароматний	ɐrɔmɑtnei̯
ферзь	fɛrzʲ
вівсом	ʋʲiu̯sɔm
квантова	kʋɑntɔʋɐ
самостійний	sɐmosʲtʲii̯nei̯
діафрагма	dʲiɐfrɑɦmɐ
ноша	nɔʃɐ
подобатися	pɔdɔbɐtesʲɐ
легковірний	ɫeɦkɔʋʲirnei̯
учасниця	ʊt͡ʃɑsnet͡sʲɐ
нижчий	nɪʒt͡ʃei̯
курбико	kʊrbɪkɔ
передумувати	peredumʊʋɐte
нам	nɑm
найнижчий	nɐi̯nɪʒt͡ʃei̯
викидень	ʋɪkedenʲ
конституційність	kɔnstetʊt͡sʲii̯nʲisʲtʲ
жовтогарячий	ʒɔu̯tɔɦɐrʲɑt͡ʃei̯
знищити	znɪʃt͡ʃete
лисий	ɫɪsei̯
виражати	ʋerɐʒɑte
перевершити	pereʋɛrʃete
учора	ʊt͡ʃɔrɐ
вважатися	ʋːɐʒɑtesʲɐ
враження	wrɑʒenʲːɐ
трохи	trɔxe
пастка	pɑstkɐ
шестикутник	ʃestekutnek
вуглець	wʊɦɫɛt͡sʲ
спадкоємиця	spɐdkɔjɛmet͡sʲɐ
уряд	urʲɐd
венеція	ʋenɛt͡sʲijɐ
іноземний	inɔzɛmnei̯
слава	sɫɑʋɐ
гнів	ɦnʲiu̯
передова	peredɔʋɑ
слов'янками	sɫɔʋjɑnkɐme
зуби	zube
річниця	rʲit͡ʃnɪt͡sʲɐ
абсурдистка	ɐbsʊrdɪstkɐ
рибка	rɪbkɐ
перстень	pɛrstenʲ
абазинець	ɐbɐzɪnet͡sʲ
міряти	mʲirʲɐte
рицар	rɪt͡sɐr
череп	t͡ʃɛrep
христос	xrestɔs
ідеалізм	ideɐlʲizm
термодинаміка	termɔdenɑmʲikɐ
володіти	wɔɫodʲite
нагадати	nɐɦɐdɑte
координувати	kɔɔrdenʊʋɑte
чапля	t͡ʃɑplʲɐ
увесь	ʊʋɛsʲ
стероїд	sterɔjid
слівцю	sʲlʲiu̯t͡sʲu
імпульс	impʊlʲs
ексгібіціоністка	eɡzʲɦʲibʲit͡sʲionʲistkɐ
абсолютний	ɐbsolʲutnei̯
установити	ʊstɐnɔʋɪte
декларація	dekɫɐrɑt͡sʲijɐ
онкологія	ɔnkɔɫɔɦʲijɐ
болотистий	bɔɫɔtɪstei̯
кумач	kʊmɑt͡ʃ
вітряний	ʋʲitʲrʲɐnei̯
покій	pokʲii̯
фрагментові	frɐɦmɛntɔʋʲi
людський	lʲʊd͡zʲsʲkɪi̯
фольга	fɔlʲɦɑ
битві	bɪtʲʋʲi
вижити	ʋɪʒete
сорок	sɔrɔk
пивовар	pewɔʋɑr
вона	wɔnɑ
біомаса	bʲiɔmɑsɐ
панічний	pɐnʲit͡ʃnei̯
лев	ɫɛu̯
просьба	prɔzʲbɐ
мечу	met͡ʃu
аркуш	ɑrkʊʃ
екваторіальний	ekʋɐtɔrʲiɑlʲnei̯
сідницею	sʲidnɪt͡sejʊ
скульптура	skʊlʲpturɐ
милий	mɪɫei̯
близнята	bɫezʲnʲɑtɐ
теща	tɛʃt͡ʃɐ
пудра	pudrɐ
чуттєвий	t͡ʃʊtʲːɛʋei̯
полуниця	pɔɫʊnɪt͡sʲɐ
східноєвропейський	sʲxʲidnɔjeu̯rɔpɛi̯sʲkei̯
іти	itɪ
нелюб'язний	nelʲʊbjɑznei̯
тактика	tɑktekɐ
відео	ʋʲideɔ
слов'янок	sɫɔʋjɑnɔk
теоріями	teɔrʲijɐme
еліпс	ɛlʲips
погуляти	pɔɦʊlʲɑte
хуй	xui̯
ломи	ɫɔmɪ
приземлитися	prezemɫɪtesʲɐ
гіперактивний	ɦʲiperɐktɪu̯nei̯
середньостатистичний	seredʲnʲɔstɐtestɪt͡ʃnei̯
канадійський	kɐnɐdʲii̯sʲkei̯
сковорідка	skɔworʲidkɐ
обмеженню	ɔbmɛʒenʲːʊ
допомога	dɔpɔmɔɦɐ
проігнорувати	prɔiɦnɔrʊʋɑte
синій	sɪnʲii̯
супруг	sʊpruɦ
дума	dumɐ
виживати	ʋeʒeʋɑte
абдикація	ɐbdekɑt͡sʲijɐ
прилад	prɪɫɐd
богослов'я	bɔɦɔsɫɔʋjɐ
білорус	bʲiɫorus
судити	sʊdɪte
діаграма	dʲiɐɦrɑmɐ
дивізію	deʋʲizʲijʊ
казати	kɐzɑte
пара	pɑrɐ
трагедіях	trɐɦɛdʲijɐx
ножиці	nɔʒet͡sʲi
будяк	bʊdʲɑk
скорочувати	skɔrɔt͡ʃʊʋɐte
тікати	tʲikɑte
пункт	punkt
стюардеса	sʲtʲʊɐrdɛsɐ
їм	jim
радуватися	rɑdʊʋɐtesʲɐ
пам'ятати	pɐmjɐtɑte
сміливість	sʲmʲiɫeʋʲisʲtʲ
іспанія	ispɑnʲijɐ
заподіювати	zɐpodʲijʊʋɐte
вологий	wɔɫɔɦei̯
споживчий	spɔʒɪu̯t͡ʃei̯
регулятор	reɦʊlʲɑtɔr
перса	pɛrsɐ
кохання	kɔxɑnʲːɐ
цар	t͡sɑr
чад	t͡ʃɑd
рости	rɔstɪ
добуток	dobutɔk
рік	rʲik
оголошувати	ɔɦɔɫɔʃʊʋɐte
кинджал	kend͡ʒɑɫ
серп	sɛrp
застуд	zɐstud
тісто	tʲistɔ
філологічний	fʲiɫɔɫoɦʲit͡ʃnei̯
гоститися	ɦɔstɪtesʲɐ
молоко	mɔɫɔkɔ
перебудова	perebʊdɔʋɐ
сімдесятий	sʲimdesʲɑtei̯
вухо	wuxɔ
україно	ʊkrɐjinɔ
еректильна	erektɪlʲnɐ
зорієнтувати	zɔrʲijentʊʋɑte
промокнути	prɔmɔknʊte
дорога	dɔrɔɦɑ
убогий	ʊbɔɦei̯
поступку	pɔstʊpkʊ
абонемент	ɐbɔnemɛnt
безпілотний	bezʲpʲiɫɔtnei̯
переглянути	pereɦlʲɑnʊte
авантюрник	ɐʋɐnʲtʲurnek
пов'язаний	pɔʋjɑzɐnei̯
куди	kʊdɪ
музика	mʊzɪkɐ
меблі	mɛblʲi
раціонально	rɐt͡sʲiɔnɑlʲnɔ
діуретичний	dʲiʊretɪt͡ʃnei̯
готель	ɦɔtɛlʲ
акул	ɐkuɫ
автоматизація	ɐu̯tɔmɐtezɑt͡sʲijɐ
білосніжка	bʲiɫosʲnʲiʒkɐ
дешевий	deʃɛʋei̯
повзти	pɔu̯ztɪ
єреван	jereʋɑn
княгиня	knʲɐɦɪnʲɐ
галюциногенний	ɦɐlʲʊt͡senɔɦɛnːei̯
потилиця	pɔtɪɫet͡sʲɐ
купівля	kʊpʲiu̯lʲɐ
імунний	imunːei̯
застудою	zɐstudɔjʊ
кілько	kʲilʲkɔ
відстоювати	ʋʲid͡zstɔjʊʋɐte
цим	t͡sɪm
донбас	dɔnbɑs
амбіція	ɐmbʲit͡sʲijɐ
живіт	ʒeʋʲit
дерево	dɛrewɔ
тридцятиріччя	tred͡zʲt͡sʲɐterʲit͡ʃʲːɐ
кишенею	keʃɛnejʊ
марта	mɑrtɐ
призвичаїти	prezʋet͡ʃɑjite
смертний	smɛrtnei̯
врятовувати	wrʲɐtɔwʊʋɐte
компанія	kɔmpɑnʲijɐ
барельєф	bɐrelʲjɛf
панікер	pɐnʲikɛr
моєю	mɔjɛjʊ
беззахисний	bezːɐxɪsnei̯
слов'янине	sɫɔʋjɐnɪne
жлуктити	ʒɫuktete
настроїти	nɐstrɔjite
мимовільний	memɔʋʲilʲnei̯
антибіотик	ɐntebʲiɔtek
парші	pɑrʃʲi
хрін	xrʲin
оточувати	ɔtɔt͡ʃʊʋɐte
сховище	sxɔʋeʃt͡ʃe
бібліотекарка	bʲiblʲiɔtɛkɐrkɐ
пелюстка	pelʲustkɐ
медалями	medɑlʲɐme
кікбоксинг	kʲiɡbɔksenɦ
авіаучилище	ɐʋʲiɐʊt͡ʃɪɫeʃt͡ʃe
будьмо	budʲmɔ
російськомовний	rɔsʲii̯sʲkɔmɔu̯nei̯
мева	mɛʋɐ
філологія	fʲiɫɔɫɔɦʲijɐ
оборона	ɔbɔrɔnɐ
аквамариновий	ɐkʋɐmɐrɪnɔʋei̯
спланувати	spɫɐnʊʋɑte
письменниці	pesʲmɛnːet͡sʲi
комфортний	kɔmfɔrtnei̯
австрофіл	ɐu̯strofʲiɫ
тополям	tɔpɔlʲɐm
попередниця	pɔperɛdnet͡sʲɐ
експерт	ekspɛrt
білка	bʲiɫkɐ
надмір	nɑdʲmʲir
небажання	nebɐʒɑnʲːɐ
транспорт	trɑnspɔrt
зубенята	zʊbenʲɑtɐ
книжці	knɪzʲt͡sʲi
співавтор	sʲpʲiʋɑu̯tɔr
стандартний	stɐndɑrtnei̯
оригінальність	ɔreɦʲinɑlʲnʲisʲtʲ
коловодниця	kɔɫɔwɔdnet͡sʲɐ
недолік	nedɔlʲik
абсурдний	ɐbsurdnei̯
працівницею	prɐt͡sʲiu̯nɪt͡sejʊ
тротуарах	trɔtʊɑrɐx
які	jɐkʲi
пиво	pɪwɔ
ріпо	rʲipɔ
родинний	rɔdɪnːei̯
сором	sɔrɔm
притомний	pretɔmnei̯
предок	prɛdɔk
погоди	pɔɦɔde
хитрий	xɪtrei̯
фотографіє	fɔtɔɦrɑfʲije
манго	mɑnɦɔ
кожух	koʒux
бетяр	bɛtʲɐr
мінімум	mʲinʲimʊm
інтенсифікувати	intensefʲikʊʋɑte
лаванд	ɫɐʋɑnd
шведка	ʃʋɛdkɐ
блювати	blʲʊʋɑte
дослідити	dɔsʲlʲidɪte
здання	zdɑnʲːɐ
яка	jɐkɑ
обережний	ɔberɛʒnei̯
цілковитий	t͡sʲiɫkɔʋɪtei̯
згідність	zʲɦʲidʲnʲisʲtʲ
релігія	relʲiɦʲijɐ
абхаз	ɐbxɑz
кар'єра	kɐrjɛrɐ
прийнятний	prei̯nʲɑtnei̯
зекономити	zekɔnɔmete
долото	dɔɫɔtɔ
воєначальник	wɔjenɐt͡ʃɑlʲnek
значити	znɑt͡ʃete
секунда	sekundɐ
рильця	rɪlʲt͡sʲɐ
рейка	rɛi̯kɐ
залежний	zɐɫɛʒnei̯
підлива	pʲidɫɪʋɐ
британія	bretɑnʲijɐ
ірод	irɔd
іменник	imɛnːek
попільничка	pɔpʲilʲnɪt͡ʃkɐ
удосвіта	ʊdɔsʲʋʲitɐ
амстердам	ɐmsterdɑm
серед	sɛred
молодість	mɔɫɔdʲisʲtʲ
прибічниця	prebʲit͡ʃnet͡sʲɐ
киянин	kejɑnen
магазин	mɐɦɐzɪn
гірший	ɦʲirʃei̯
сповіщення	spɔʋʲiʃt͡ʃenʲːɐ
вільний	ʋʲilʲnei̯
намет	nɐmɛt
інерції	inɛrt͡sʲiji
додатках	dɔdɑtkɐx
періодичний	perʲiɔdɪt͡ʃnei̯
психотерапія	psexɔterɐpʲijɐ
обід	obʲid
авгіт	ɐu̯ɦʲit
козакові	kɔzɐkɔʋʲi
радикалізувати	rɐdekɐlʲizʊʋɑte
одночасно	ɔdnɔt͡ʃɑsnɔ
соня	sɔnʲɐ
трансформація	trɐnsfɔrmɑt͡sʲijɐ
горілок	ɦɔrʲiɫɔk
висловлюватися	ʋesɫɔu̯lʲʊʋɐtesʲɐ
переосмислювати	pereɔsmɪsʲlʲʊʋɐte
невралгічний	neu̯rɐlʲɦʲit͡ʃnei̯
конкурентоспроможний	kɔnkʊrentɔsprɔmɔʒnei̯
нічний	nʲit͡ʃnɪi̯
навмисно	nɐu̯mɪsnɔ
послуга	posɫuɦɐ
аскетизм	ɐsketɪzm
бонусу	bɔnʊsʊ
однокласниця	ɔdnɔkɫɑsnet͡sʲɐ
батярувати	bɐtʲɐrʊʋɑte
урбанізація	ʊrbɐnʲizɑt͡sʲijɐ
дефініція	defʲinʲit͡sʲijɐ
брити	brɪte
кода	kɔdɐ
трон	trɔn
новітній	nɔʋʲitʲnʲii̯
союзниця	sɔjuznet͡sʲɐ
бузина	bʊzenɑ
аравія	ɐrɑʋʲijɐ
українці	ʊkrɐjinʲt͡sʲi
виноградник	ʋenɔɦrɑdnek
паливо	pɑɫewɔ
лазити	ɫɑzete
змі	zʲmʲi
травень	trɑʋenʲ
специфічний	spet͡sefʲit͡ʃnei̯
громада	ɦrɔmɑdɐ
ліричний	lʲirɪt͡ʃnei̯
жалоба	ʒɐɫɔbɐ
горизонтам	ɦɔrezɔntɐm
референдумі	referɛndʊmʲi
гній	ɦnʲii̯
операція	ɔperɑt͡sʲijɐ
енергії	enɛrɦʲiji
голландія	ɦɔɫːɑnʲdʲijɐ
яблуко	jɑbɫʊkɔ
карат	kɐrɑt
випромінювати	ʋepromʲinʲʊʋɐte
волейболістка	wɔɫei̯bolʲistkɐ
ніготь	nʲiɦɔtʲ
днях	dʲnʲɑx
сват	sʋɑt
ткати	tkɑte
однокласник	ɔdnɔkɫɑsnek
канонерка	kɐnɔnɛrkɐ
австралоїд	ɐu̯strɐɫɔjid
привчати	preu̯t͡ʃɑte
декорація	dekɔrɑt͡sʲijɐ
свинина	sʋenɪnɐ
ріп	rʲip
маврикій	mɐu̯rɪkʲii̯
лекціях	ɫɛkt͡sʲijɐx
коханий	kɔxɑnei̯
зберігати	zberʲiɦɑte
мусульманка	mʊsʊlʲmɑnen
веною	ʋɛnɔjʊ
санітарний	sɐnʲitɑrnei̯
окремий	ɔkrɛmei̯
корчма	kɔrt͡ʃmɑ
шістнадцять	ʃʲistnɑd͡zʲt͡sʲɐtʲ
телебачення	teɫebɑt͡ʃenʲːɐ
кав'ярня	kɐʋjɑrnʲɐ
безпосередньо	bezpɔserɛdʲnʲɔ
бенін	benʲin
замах	zɑmɐx
книга	knɪɦɐ
оладка	ɔɫɑdkɐ
авіапатруль	ɐʋʲiɐpɐtrulʲ
полігамний	pɔlʲiɦɑmnei̯
хазяїн	xɐzʲɑjin
скляний	sklʲɐnɪi̯
раніше	rɐnʲiʃe
генерація	ɦenerɑt͡sʲijɐ
порозмовляти	pɔrɔzmɔu̯lʲɑte
чорні	t͡ʃɔrnʲi
ісландія	isɫɑnʲdʲijɐ
русь	rusʲ
різкий	rʲizkɪi̯
смертельна	smertɛlʲnɐ
конфлікт	konflʲikt
кріпкий	krʲipkei̯
англомовний	ɐnɦɫɔmɔu̯nei̯
гнути	ɦnute
чех	t͡ʃɛx
нити	nɪte
латвія	ɫɑtʲʋʲijɐ
заспокійливий	zɐspokʲii̯ɫeʋei̯
них	nɪx
завершення	zɐʋɛrʃenʲːɐ
викреслювати	ʋekrɛsʲlʲʊʋɐte
тодішній	todʲiʃnʲii̯
коноплі	kɔnɔplʲi
бугай	bʊɦɑi̯
переорієнтація	pereɔrʲijentɑt͡sʲijɐ
безумовний	bezʊmɔu̯nei̯
органічна	ɔrɦɐnʲit͡ʃnɐ
факт	fɑkt
обдурювати	obdurʲʊʋɐte
ик	ɪk
люстерко	lʲʊstɛrkɔ
комірець	kɔmʲirɛt͡sʲ
бойкот	bɔi̯kɔt
ексгібіціоніст	eɡzʲɦʲibʲit͡sʲionʲist
турків	turkʲiu̯
двозначний	dwɔznɑt͡ʃnei̯
зубна	zʊbnɑ
аналізувати	ɐnɐlʲizʊʋɑte
ріг	rʲiɦ
кролик	krɔɫek
спізнитися	sʲpʲiznɪtesʲɐ
стимулювати	stemʊlʲʊʋɑte
женитися	ʒenɪtesʲɐ
калій	kɑlʲii̯
перець	pɛret͡sʲ
умисний	ʊmɪsnei̯
меморандум	memɔrɑndʊm
ательє	ɐtelʲjɛ
севастополь	seʋɐstɔpɔlʲ
систематичний	sestemɐtɪt͡ʃnei̯
відвага	ʋʲidʋɑɦɐ
авгур	ɐu̯ɦur
петиція	petɪt͡sʲijɐ
комедії	kɔmɛdʲiji
переважно	pereʋɑʒnɔ
рутина	rʊtɪnɐ
розмивати	rɔzmeʋɑte
очеревина	ɔt͡ʃerɛʋenɐ
гончар	ɦɔnt͡ʃɑr
диплом	depɫɔm
добросусідський	dɔbrɔsʊsʲid͡zʲsʲkei̯
потім	pɔtʲim
досягти	dɔsʲɐɦtɪ
підготовка	pʲidɦɔtɔu̯kɐ
генетичний	ɦenetɪt͡ʃnei̯
чепець	t͡ʃepɛt͡sʲ
почуття	pɔt͡ʃʊtʲːɑ
авар	ɐʋɑr
нудно	nudnɔ
оцього	ɔt͡sʲɔɦɔ
завершувати	zɐʋɛrʃʊʋɐte
гладкість	ɦɫɑdʲkʲisʲtʲ
стратегія	strɐtɛɦʲijɐ
оцет	ɔt͡set
антибіотиків	ɐntebʲiɔtekʲiu̯
сюрприз	sʲʊrprɪz
яничар	jɐnet͡ʃɑr
потилицях	pɔtɪɫet͡sʲɐx
законе	zɐkɔne
грізний	ɦrʲiznei̯
або	ɐbɔ
вакцина	ʋɐkt͡sɪnɐ
місто	mʲistɔ
татко	tɑtkɔ
щоби	ʃt͡ʃɔbe
лабораторіях	ɫɐbɔrɐtɔrʲijɐx
абонент	ɐbɔnɛnt
торговий	tɔrɦɔʋei̯
кельнерка	kɛlʲnerkɐ
ситуацією	setʊɑt͡sʲijejʊ
мур	mur
політеїстичний	pɔlʲitejistɪt͡ʃnei̯
множинний	mnɔʒɪnːei̯
інтуїція	intʊjit͡sʲijɐ
хотіти	xotʲite
підміняти	pʲidʲmʲinʲɑte
ночви	nɔt͡ʃʋe
дути	dute
шкарпетка	ʃkɐrpɛtkɐ
експедиції	ekspedɪt͡sʲiji
механічний	mexɐnʲit͡ʃnei̯
погрожувати	pɔɦrɔʒʊʋɐte
симптом	semptɔm
впливовий	ʍpɫewɔʋei̯
епоха	epɔxɐ
курка	kurkɐ
цілковито	t͡sʲiɫkɔʋɪtɔ
заступ	zɑstʊp
становище	stɐnɔʋeʃt͡ʃe
зупа	zupɐ
емоція	emɔt͡sʲijɐ
орієнтація	ɔrʲijentɑt͡sʲijɐ
анатомічний	ɐnɐtomʲit͡ʃnei̯
американський	ɐmerekɑnʲsʲkei̯
синагога	senɐɦɔɦɐ
зареєструвати	zɐrejestrʊʋɑte
батон	bɐtɔn
політизувати	pɔlʲitezʊʋɑte
оленина	ɔɫenɪnɐ
тім	tʲim
фрагменті	frɐɦmɛnʲtʲi
відгороджувати	ʋʲidɦɔrɔd͡ʒʊʋɐte
палестина	pɐɫestɪnɐ
ще	ʃt͡ʃɛ
чилі	t͡ʃɪlʲi
молдова	mɔɫdɔʋɐ
велосипедистка	ʋeɫɔsepedɪstkɐ
ніздря	nʲizdʲrʲɐ
підприємництво	pʲidprejɛmnet͡stwɔ
радість	rɑdʲisʲtʲ
чоло	t͡ʃɔɫɔ
надзвичайно	nɐd͡zʋet͡ʃɑi̯nɔ
сировина	serɔʋenɑ
абітурієнт	ɐbʲitʊrʲijɛnt
мести	mestɪ
зайнятість	zɑi̯nʲɐtʲisʲtʲ
авіарейс	ɐʋʲiɐrɛi̯s
шибениця	ʃɪbenet͡sʲɐ
саміт	sɑmʲit
скидати	skedɑte
курчата	kʊrt͡ʃɑtɐ
метал	metɑɫ
організаціях	ɔrɦɐnʲizɑt͡sʲijɐx
авіамеханік	ɐʋʲiɐmexɑnʲik
топір	topʲir
вата	ʋɑtɐ
вимога	ʋemɔɦɐ
стегно	steɦnɔ
чверті	t͡ʃʋɛrtʲi
князь	knʲɑzʲ
зміщати	zʲmʲiʃt͡ʃɑte
професорка	prɔfɛsɔrkɐ
аболіціоніст	ɐbɔlʲit͡sʲionʲist
нормалізація	nɔrmɐlʲizɑt͡sʲijɐ
співак	sʲpʲiʋɑk
засудити	zɐsʊdɪte
морквяний	mɔrkʋʲɐnɪi̯
жартувати	ʒɐrtʊʋɑte
лицар	ɫɪt͡sɐr
концентраційний	kɔnt͡sentrɐt͡sʲii̯nei̯
тернопіль	ternɔpʲilʲ
богиня	bɔɦɪnʲɐ
дієвий	dʲijɛʋei̯
труна	trʊnɑ
гравітація	ɦrɐʋʲitɑt͡sʲijɐ
баран	bɐrɑn
чоловіками	t͡ʃɔɫɔʋʲikɐme
щеня	ʃt͡ʃenʲɑ
сила	sɪɫɐ
працівниках	prɐt͡sʲiu̯nekɑx
будда	budːɐ
авіадвигун	ɐʋʲiɐdʋeɦun
дівчата	dʲiu̯t͡ʃɑtɐ
заручений	zɐrut͡ʃenei̯
руки	rʊkɪ
сірник	sʲirnɪk
безперебійний	bezperebʲii̯nei̯
дійсність	dʲii̯sʲnʲisʲtʲ
дзядко	d͡zʲɐdkɔ
справді	sprɑu̯dʲi
розмовляти	rɔzmɔu̯lʲɑte
обговорити	ɔbɦɔwɔrɪte
кривий	kreʋɪi̯
блокувати	bɫɔkʊʋɑte
визначати	ʋeznɐt͡ʃɑte
гостювати	ɦɔsʲtʲʊʋɑte
сусідів	sʊsʲidʲiu̯
наголос	nɑɦɔɫɔs
сідницями	sʲidnɪt͡sʲɐme
практичність	prɐktɪt͡ʃnʲisʲtʲ
колектив	kɔɫektɪu̯
меланія	meɫɑnʲijɐ
давид	dɐʋɪd
цукровий	t͡sʊkrɔʋei̯
глядачка	ɦlʲɐdɑt͡ʃkɐ
трагедія	trɐɦɛdʲijɐ
повстати	pɔu̯stɑte
соціальна	sɔt͡sʲiɑlʲnɐ
тротуарам	trɔtʊɑrɐm
кришка	krɪʃkɐ
нервуватися	nerwʊʋɑtesʲɐ
звинуватити	zʋenʊʋɑtete
кучма	kut͡ʃmɐ
русифікація	rʊsefʲikɑt͡sʲijɐ
негайний	neɦɑi̯nei̯
яблучна	jɑbɫʊt͡ʃnɐ
рівносильний	rʲiu̯nɔsɪlʲnei̯
вдячний	wdʲɑt͡ʃnei̯
єпископ	jepɪskɔp
голландець	ɦɔɫːɑndet͡sʲ
підніжжя	pʲidʲnʲiʒʲːɐ
азія	ɑzʲijɐ
фриз	frɪz
іноземна	inɔzɛmnɐ
симбіотичний	sembʲiɔtɪt͡ʃnei̯
восени	wɔsenɪ
борис	bɔrɪs
посидіти	pɔsɪdʲite
золото	zɔɫɔtɔ
тополі	tɔpɔlʲi
україні	ʊkrɐjinʲi
малина	mɐɫɪnɐ
експлуатація	ekspɫʊɐtɑt͡sʲijɐ
албанка	ɐɫbɑnkɐ
цибуля	t͡sebulʲɐ
заучити	zɐʊt͡ʃɪte
авіабудівник	ɐʋʲiɐbʊdʲiu̯nɪk
інфекціям	infɛkt͡sʲijɐm
кисень	kɪsenʲ
запобіжний	zɐpobʲiʒnei̯
засвідчувати	zɐsʲʋʲid͡ʒt͡ʃʊʋɐte
мідь	mʲidʲ
кориця	kɔrɪt͡sʲɐ
конвенція	kɔnʋɛnʲt͡sʲijɐ
статистика	stɐtɪstekɐ
спідницю	sʲpʲidnɪt͡sʲʊ
невротичний	neu̯rɔtɪt͡ʃnei̯
мироточець	merɔtɔt͡ʃet͡sʲ
квадрат	kʋɐdrɑt
діафрагми	dʲiɐfrɑɦme
нейтралізувати	nei̯trɐlʲizʊʋɑte
виростити	ʋɪrɔstete
ріпам	rʲipɐm
імперіях	impɛrʲijɐx
вересень	ʋɛresenʲ
замісто	zɐmʲistɔ
суп	sup
розуміти	rɔzʊmʲite
курити	kʊrɪte
розробка	rɔzrɔbkɐ
адріан	ɐdʲrʲiɑn
незахищений	nezɐxɪʃt͡ʃenei̯
насолоджуватися	nɐsɔɫɔd͡ʒʊʋɐtesʲɐ
тюремний	tʲʊrɛmnei̯
господинях	ɦɔspɔdɪnʲɐx
японії	jɐpɔnʲiji
казуїстичний	kɐzʊjistɪt͡ʃnei̯
слов'янином	sɫɔʋjɐnɪnɔm
каплицях	kɐpɫɪt͡sʲɐx
суниця	sʊnɪt͡sʲɐ
одночасний	ɔdnɔt͡ʃɑsnei̯
населити	nɐseɫɪte
ін'єкція	injɛkt͡sʲijɐ
пісня	pʲisʲnʲɐ
функція	funkt͡sʲijɐ
першого	pɛrʃɔɦɔ
тої	tɔji
співпрацювати	sʲpʲiu̯prɐt͡sʲʊʋɑte
поліціє	polʲit͡sʲije
вагітність	ʋɐɦʲitʲnʲisʲtʲ
вигляд	ʋɪɦlʲɐd
катастроф	kɐtɐstrɔf
стрічка	stʲrʲit͡ʃkɐ
гольф	ɦɔlʲf
сторона	stɔrɔnɑ
космічний	kosʲmʲit͡ʃnei̯
американізація	ɐmerekɐnʲizɑt͡sʲijɐ
піч	pʲit͡ʃ
пригадувати	preɦɑdʊʋɐte
восьмисотий	wɔsʲmesɔtei̯
правильний	prɑʋelʲnei̯
метах	mɛtɐx
вік	ʋʲik
остаточний	ɔstɐtɔt͡ʃnei̯
бервено	berʋenɔ
новий	nɔʋɪi̯
цьоця	t͡sʲɔt͡sʲɐ
феміністичний	femʲinʲistɪt͡ʃnei̯
маршрутів	mɐrʃrutʲiu̯
марксист	mɐrksɪst
крашанка	krɑʃɐnkɐ
законам	zɐkɔnɐm
словники	sɫɔu̯nekɪ
семисотий	semesɔtei̯
була	bʊɫɑ
включати	ʍklʲʊt͡ʃɑte
імпровізаційний	imprɔʋʲizɐt͡sʲii̯nei̯
видовище	ʋedɔʋeʃt͡ʃe
могильов	mɔɦelʲɔu̯
уряд	ʊrʲɑd
обманювати	ɔbmɑnʲʊʋɐte
недавній	nedɑu̯nʲii̯
тісний	tʲisnɪi̯
субтитр	sʊbtɪtr
прокидатися	prɔkedɑtesʲɐ
критикувати	kretekʊʋɑte
розчарувати	rɔʒt͡ʃɐrʊʋɑte
переобрати	pereɔbrɑte
подруга	pɔdrʊɦɐ
інстинктивний	instenktɪu̯nei̯
лікарнях	lʲikɑrnʲɐx
абсурд	ɐbsurd
послуга	pɔsɫʊɦɐ
слівець	sʲlʲiʋet͡sʲ
два	dʋɑ
прогрес	prɔɦrɛs
галиця	ɦɑɫet͡sʲɐ
дерен	dɛren
нудний	nʊdnɪi̯
працівником	prɐt͡sʲiu̯nekɔm
обдаровувати	ɔbdɐrɔwʊʋɐte
словосполучення	sɫɔwɔspoɫut͡ʃenʲːɐ
тимошенко	temɔʃɛnkɔ
відень	ʋʲidenʲ
електрифікувати	eɫektrefʲikʊʋɑte
вінниця	ʋʲinːet͡sʲɐ
мікрохвильовий	mʲikrɔxʋelʲɔʋɪi̯
типовий	tepɔʋei̯
насінина	nɐsʲinɪnɐ
пришвидшити	preʃʋɪd͡ʒʃete
глитати	ɦɫetɑte
етимологічний	etemɔɫoɦʲit͡ʃnei̯
поцілувати	pɔt͡sʲiɫʊʋɑte
зменшень	zmɛnʃenʲ
міжряддя	mʲiʒrʲɑdʲːɐ
сліпота	sʲlʲipɔtɑ
симетрія	semetʲrʲijɐ
євромайдан	jeu̯rɔmɐi̯dɑn
левурда	ɫɛwʊrdɐ
вівсяний	ʋʲiu̯sʲɑnei̯
щитоподібна	ʃt͡ʃetɔpodʲibnɐ
таємниць	tɐjemnɪt͡sʲ
поблажливість	pɔbɫɑʒɫeʋʲisʲtʲ
чан	t͡ʃɑn
черевик	t͡ʃereʋɪk
когось	kɔɦɔsʲ
вітрило	ʋʲitrɪɫɔ
простирадло	prɔsterɑdɫɔ
союзник	sɔjuznek
кульгавий	kʊlʲɦɑʋei̯
авіатика	ɐʋʲiɑtekɐ
експлуатувати	ekspɫʊɐtʊʋɑte
відпочинок	ʋʲidpɔt͡ʃɪnɔk
пустий	pʊstɪi̯
щирість	ʃt͡ʃɪrʲisʲtʲ
еволюційний	ewɔlʲʊt͡sʲii̯nei̯
козаках	kɔzɐkɑx
яєчний	jɐjɛt͡ʃnei̯
зрадниця	zrɑdnet͡sʲɐ
нирковий	nerkɔʋɪi̯
явище	jɑʋeʃt͡ʃe
погроза	pɔɦrɔzɐ
абразія	ɐbrɑzʲijɐ
яловичину	jɑɫɔʋet͡ʃenʊ
союз	sɔjuz
вайло	ʋɐi̯ɫɔ
шлангів	ʃɫɑnʲɦʲiu̯
ґара	ɡɑrɐ
оцим	ɔt͡sɪm
малі	mɐlʲi
збудувати	zbʊdʊʋɑte
мука	mʊkɑ
урбанізм	ʊrbɐnʲizm
нами	nɑme
знак	znɑk
видатний	ʋedɐtnɪi̯
авіадесантування	ɐʋʲiɐdesɐntʊʋɑnʲːɐ
самовираження	sɐmɔʋɪrɐʒenʲːɐ
сім'я	sʲimjɑ
екстатичний	ekstɐtɪt͡ʃnei̯
лопата	ɫɔpɑtɐ
йому	jomu
ліс	lʲis
іран	irɑn
біологічний	bʲiɔɫoɦʲit͡ʃnei̯
сучасний	sʊt͡ʃɑsnei̯
коментувати	kɔmentʊʋɑte
слина	sɫɪnɐ
книжки	kneʒkɪ
лічити	lʲit͡ʃɪte
фрагментах	frɐɦmɛntɐx
охопити	ɔxɔpɪte
осмислювати	ɔsmɪsʲlʲʊʋɐte
одержувач	ɔdɛrʒʊʋɐt͡ʃ
бажати	bɐʒɑte
слабкість	sɫɑbkʲisʲtʲ
екскурсовод	ekskʊrsɔwɔd
адмініструвати	ɐdʲmʲinʲistrʊʋɑte
супроводжувати	sʊprɔwɔd͡ʒʊʋɐte
демократизувати	demɔkrɐtezʊʋɑte
мамут	mɑmʊt
дощ	dɔʃt͡ʃ
відділяти	ʋʲidʲːilʲɑte
лікарні	lʲikɑrnʲi
здаватися	zdɐʋɑtesʲɐ
долоне	dɔɫɔne
суб'єкт	sʊbjɛkt
йога	jɔɦɐ
горизонтові	ɦɔrezɔntɔʋʲi
невідворотний	neʋʲidwɔrɔtnei̯
додатком	dɔdɑtkɔm
винокурня	ʋenokurnʲɐ
регулярний	reɦʊlʲɑrnei̯
вертикальний	ʋertekɑlʲnei̯
ґрати	ɡrɑte
споживачка	spɔʒeʋɑt͡ʃkɐ
ватрушка	ʋɐtruʃkɐ
улюблений	ʊlʲubɫenei̯
ніж	nʲiʒ
гребінь	ɦrɛbʲinʲ
едо	ɛdɔ
візуальний	ʋʲizʊɑlʲnei̯
елегантність	eɫeɦɑntʲnʲisʲtʲ
постачальник	pɔstɐt͡ʃɑlʲnek
частинка	t͡ʃɐstɪnkɐ
зірка	zʲirkɐ
родовий	rɔdɔʋɪi̯
австралійці	ɐu̯strɐlʲii̯t͡sʲi
смілий	sʲmʲiɫei̯
суперечити	sʊperɛt͡ʃete
абищиця	ɐbɪʃt͡ʃet͡sʲɐ
чверть	t͡ʃʋɛrtʲ
допізна	dopʲiznɐ
назавжди	nɐzɐu̯ʒdɪ
соціаліст	sɔt͡sʲiɐlʲist
танцюристи	tɐnʲt͡sʲʊrɪste
культ	kulʲt
ретельний	retɛlʲnei̯
арка	ɑrkɐ
новаторство	nɔʋɑtɔrstwɔ
пиття	petʲːɑ
впевнений	ʍpɛu̯nenei̯
родовище	rɔdɔʋeʃt͡ʃe
застудами	zɐstudɐme
запам'ятати	zɐpɐmjɐtɑte
спідницею	sʲpʲidnɪt͡sejʊ
проблемний	prɔbɫɛmnei̯
корисна	kɔresnɐ
перерва	perɛrʋɐ
вівторок	ʋʲiu̯tɔrɔk
маслина	mɐsɫɪnɐ
потом	pɔtɔm
сичуг	set͡ʃuɦ
потворний	pɔtwɔrnei̯
розгромити	rɔzɦrɔmɪte
перевірка	perɛʋʲirkɐ
повх	pɔu̯x
арфістка	ɐrfʲistkɐ
сербія	sɛrbʲijɐ
кібець	kʲibet͡sʲ
ретельно	retɛlʲnɔ
окуляри	ɔkʊlʲɑre
працівника	prɐt͡sʲiu̯nekɑ
рила	rɪɫɐ
хава	xɑʋɐ
шафа	ʃɑfɐ
курд	kurd
молодиць	mɔɫɔdɪt͡sʲ
обмежити	ɔbmɛʒete
пуголовок	puɦɔɫɔwɔk
пюпітр	pʲʊpʲitr
комунікаційний	kɔmʊnʲikɐt͡sʲii̯nei̯
майбутній	mɐi̯butʲnʲii̯
крим	krɪm
зап'ястя	zɐpjɑsʲtʲɐ
сприймати	sprei̯mɑte
целакант	t͡seɫɐkɑnt
перейменувати	perei̯menʊʋɑte
возити	wɔzɪte
відроджувати	ʋʲidrɔd͡ʒʊʋɐte
мрій	mrʲii̯
глина	ɦɫɪnɐ
хай	xɑi̯
висловити	ʋɪsɫɔʋete
описовий	ɔpesɔʋei̯
громадянська	ɦrɔmɐdʲɑnʲsʲkɐ
забава	zɐbɑʋɐ
подумати	podumɐte
плантація	pɫɐntɑt͡sʲijɐ
брам	brɑm
розташовувати	rɔztɐʃɔwʊʋɐte
нянів	nʲɑnʲiu̯
туризм	tʊrɪzm
пастернак	pɐsternɑk
підшлункова	pʲid͡ʒʃɫʊnkɔʋɐ
повість	pɔʋʲisʲtʲ
рештою	rɛʃtɔjʊ
бурдей	bʊrdɛi̯
азбука	ɑzbʊkɐ
продовжувати	prɔdɔu̯ʒʊʋɐte
машинерія	mɐʃenɛrʲijɐ
блюзнірство	blʲʊzʲnʲirstwɔ
нещирий	neʃt͡ʃɪrei̯
вус	wus
медаль	medɑlʲ
потилице	pɔtɪɫet͡se
станцію	stɑnʲt͡sʲijʊ
тисячний	tɪsʲɐt͡ʃnei̯
кохати	kɔxɑte
патріотизму	pɐtʲrʲiɔtɪzmʊ
ґніт	ɡnʲit
павич	pɐʋɪt͡ʃ
мотоцикл	mɔtɔt͡sɪkɫ
органів	ɔrɦɑnʲiu̯
гостинний	ɦɔstɪnːei̯
затриматися	zɐtrɪmɐtesʲɐ
слівце	sʲlʲiu̯t͡sɛ
стрибнути	strebnute
високосний	ʋesɔkɔsnei̯
пауза	pɑʊzɐ
дев'ятий	deʋjɑtei̯
поліцій	polʲit͡sʲii̯
чахохбілі	t͡ʃɐxoɦbʲilʲi
надій	nɐdʲii̯
начиння	nɐt͡ʃɪnʲːɐ
мріям	mrʲijɐm
ростити	rɔstɪte
лондон	ɫɔndɔn
туз	tuz
іволга	iwɔɫɦɐ
досить	dɔsetʲ
закордон	zɐkɔrdɔn
тож	tɔʒ
п'ятнадцятий	pjɐtnɑd͡zʲt͡sʲɐtei̯
сироватка	serɔʋɐtkɐ
ферма	fɛrmɐ
інфікування	inʲfʲikʊʋɑnʲːɐ
взаємодіяти	wzɐjemodʲijɐte
узагальнювати	ʊzɐɦɑlʲnʲʊʋɐte
механіка	mexɑnʲikɐ
покупець	pɔkʊpɛt͡sʲ
сербка	sɛrbkɐ
артерію	ɐrtɛrʲijʊ
аборт	ɐbɔrt
систематизація	sestemɐtezɑt͡sʲijɐ
шлях	ʃlʲɑx
відпустка	ʋʲidpustkɐ
об'єм	ɔbjɛm
періодизацію	perʲiɔdezɑt͡sʲijʊ
сновидіння	snɔʋedʲinʲːɐ
більшість	bʲilʲʃʲisʲtʲ
чиновниця	t͡ʃenɔu̯net͡sʲɐ
безконечний	bezkɔnɛt͡ʃnei̯
калитка	kɐɫɪtkɐ
кобзар	kɔbzɑr
чеснота	t͡ʃesnɔtɐ
святкування	sʲʋʲɐtkʊʋɑnʲːɐ
граматичний	ɦrɐmɐtɪt͡ʃnei̯
примарний	premɑrnei̯
русинка	rʊsɪnkɐ
місяцевий	mʲisʲɐt͡sɛʋei̯
фотосинтез	fɔtɔsɪntez
сполучити	spɔɫʊt͡ʃɪte
ягнятина	jɐɦnʲɑtenɐ
борсук	borsuk
навесні	nɐʋesʲnʲi
сокіл	sɔkʲiɫ
циклічний	t͡seklʲit͡ʃnei̯
контроль	kɔntrɔlʲ
занедбати	zɐnedbɑte
світло	sʲʋʲitɫɔ
сердечний	serdɛt͡ʃnei̯
ураження	ʊrɑʒenʲːɐ
сорго	sɔrɦɔ
різноманітність	rʲiznɔmɐnʲitʲnʲisʲtʲ
богдан	bɔɦdɑn
непомірний	nepomʲirnei̯
снідати	sʲnʲidɐte
новела	nɔʋɛɫɐ
окупаційний	ɔkʊpɐt͡sʲii̯nei̯
приземлюватися	prezɛmlʲʊʋɐtesʲɐ
підказати	pʲidkɐzɑte
киплячий	keplʲɑt͡ʃei̯
переселяти	pereselʲɑte
подія	podʲijɐ
логістика	ɫoɦʲistekɐ
один	ɔdɪn
кіт	kʲit
збереження	zberɛʒenʲːɐ
мікрорайон	mʲikrɔrɐjɔn
це	t͡sɛ
безшумний	beʒʃumnei̯
етика	ɛtekɐ
ризик	rɪzek
домен	dɔmen
кишеню	keʃɛnʲʊ
першомученик	perʃomut͡ʃenek
перевершувати	pereʋɛrʃʊʋɐte
дозволяти	dɔzwɔlʲɑte
дурний	dʊrnɪi̯
нерегулярність	nereɦʊlʲɑrnʲisʲtʲ
щитоподібний	ʃt͡ʃetɔpodʲibnei̯
козак	kɔzɑk
перебільшувати	perebʲilʲʃʊʋɐte
скеля	skɛlʲɐ
приблизний	prebɫɪznei̯
губа	ɦʊbɑ
тривога	trewɔɦɐ
телефон	teɫefɔn
комедіями	kɔmɛdʲijɐme
мітотичний	mʲitɔtɪt͡ʃnei̯
торкнути	torknute
восьмеро	wɔsʲmerɔ
кримськотатарський	kremsʲkɔtɐtɑrsʲkei̯
бюрократка	bʲʊrɔkrɑtkɐ
палити	pɐɫɪte
заряджати	zɐrʲɐd͡ʒɑte
конституційний	kɔnstetʊt͡sʲii̯nei̯
генетика	ɦenɛtekɐ
переведений	pereʋɛdenei̯
яєчко	jɐjɛt͡ʃkɔ
варіанта	ʋɐrʲiɑntɐ
третій	trɛtʲii̯
евакуювати	eʋɐkʊjʊʋɑte
тим	tɪm
філіппіни	fʲilʲipʲːine
унікальний	ʊnʲikɑlʲnei̯
липа	ɫɪpɐ
спеціальний	spet͡sʲiɑlʲnei̯
вадах	ʋɑdɐx
міх	mʲix
музей	mʊzɛi̯
залізний	zɐlʲiznei̯
дракон	drɐkɔn
здання	zdɐnʲːɑ
негура	nɛɦʊrɐ
госпіталізувати	ɦɔsʲpʲitɐlʲizʊʋɑte
бразильський	brɐzɪlʲsʲkei̯
ненька	nɛnʲkɐ
покої	pɔkɔji
шлюб	ʃlʲub
зразкові	zrɐzkɔʋʲi
вітчизна	ʋʲit͡ʃːɪznɐ
ірландка	irɫɑndkɐ
я	jɑ
огидливий	ɔɦɪdɫeʋei̯
м'ясорубка	mjɐsorubkɐ
бути	bute
мішок	mʲiʃɔk
троє	trɔje
позбавити	pɔzbɑʋete
вечір	ʋɛt͡ʃʲir
приймати	prei̯mɑte
сім'я	sʲimjɐ
щипці	ʃt͡ʃɪpt͡sʲi
авіазавод	ɐʋʲiɐzɐwɔd
одношлюбність	ɔdnoʃlʲubnʲisʲtʲ
парашут	pɐrɐʃut
двоповерховий	dwɔpɔʋerxɔʋei̯
самотній	sɐmɔtʲnʲii̯
нормальність	nɔrmɑlʲnʲisʲtʲ
відтворити	ʋʲidtwɔrɪte
сутінки	sutʲinke
вужчий	wuʒt͡ʃei̯
ставлення	stɑu̯ɫenʲːɐ
межі	mɛʒʲi
репресія	reprɛsʲijɐ
аболіція	ɐbolʲit͡sʲijɐ
ліпший	lʲipʃei̯
штраф	ʃtrɑf
підсумок	pʲid͡zsʊmɔk
електорат	eɫektɔrɑt
англійська	ɐnɦlʲii̯sʲkɐ
раніший	rɐnʲiʃei̯
самодостатній	sɐmɔdɔstɑtʲnʲii̯
напад	nɑpɐd
автоматичний	ɐu̯tɔmɐtɪt͡ʃnei̯
зацікавлювати	zɐt͡sʲikɑu̯lʲʊʋɐte
рекомендувати	rekɔmendʊʋɑte
своє	swɔjɛ
сауна	sɑʊnɐ
ісламський	isɫɑmsʲkei̯
декорум	dekɔrʊm
алжир	ɐɫʒɪr
дислокація	desɫɔkɑt͡sʲijɐ
майстерня	mɐi̯stɛrnʲɐ
залишити	zɐɫeʃɪte
спорт	spɔrt
збиратися	zberɑtesʲɐ
діагноз	dʲiɑɦnɔz
паузах	pɑʊzɐx
гумор	ɦumɔr
баский	bɐskɪi̯
струм	strum
льотчиця	lʲɔt͡ʃːek
австріяк	ɐu̯stʲrʲijɑk
дивізії	deʋʲizʲiji
авіавдар	ɐʋʲiɐu̯dɑr
відміну	ʋʲidʲmʲinʊ
посол	pɔsɔɫ
фармацевтичний	fɐrmɐt͡seu̯tɪt͡ʃnei̯
мріяти	mrʲijɐte
абластика	ɐbɫɑstekɐ
пінний	pʲinːei̯
цієї	t͡sʲijɛji
поглибити	pɔɦɫɪbete
кубань	kʊbɑnʲ
перешкоджати	pereʃkɔd͡ʒɑte
кухарка	kʊxɑrkɐ
століттями	stolʲitʲːɐme
ірак	irɑk
вихідні	ʋexʲidʲnʲi
давай	dɐʋɑi̯
інтелект	inteɫɛkt
привіт	preʋʲit
пріоритет	prʲiɔretɛt
вівсами	ʋʲiu̯sɐme
чехословаччина	t͡ʃexɔsɫɔʋɑt͡ʃːenɐ
ентомологічний	entɔmɔɫoɦʲit͡ʃnei̯
авіаконструювання	ɐʋʲiɐkɔnstrʊjʊʋɑnʲːɐ
виключати	ʋeklʲʊt͡ʃɑte
прагнути	prɑɦnʊte
перевидання	pereʋedɑnʲːɐ
суми	sume
грузія	ɦruzʲijɐ
перетворити	peretwɔrɪte
корито	kɔrɪtɔ
поступка	pɔstʊpkɐ
суд	sud
такий	tɐkɪi̯
правоохоронний	prɐwɔɔxɔrɔnːei̯
швидший	ʃʋɪd͡ʒʃei̯
короткий	kɔrɔtkei̯
психолог	psexɔɫɔɦ
цьогорічний	t͡sʲɔɦorʲit͡ʃnei̯
чага	t͡ʃɑɦɐ
товмач	tɔu̯mɑt͡ʃ
салатовий	sɐɫɑtɔʋei̯
депресивний	depresɪu̯nei̯
експериментальний	eksperementɑlʲnei̯
політично	pɔlʲitɪt͡ʃnɔ
сентиментальний	sentementɑlʲnei̯
геральдика	ɦerɑlʲdekɐ
результативний	rezʊlʲtɐtɪu̯nei̯
говорити	ɦɔwɔrɪte
солдат	sɔɫdɑt
черниця	t͡ʃernɪt͡sʲɐ
пухлина	pʊxɫɪnɐ
морфологія	mɔrfɔɫɔɦʲijɐ
переносний	perenɔsnei̯
узяти	ʊzʲɑte
рів	rʲiu̯
відносно	ʋʲidnɔsnɔ
очевидиця	ɔt͡ʃeʋɪdet͡sʲɐ
офісний	ɔfʲisnei̯
шанобливий	ʃɐnɔbɫɪʋei̯
геофізичний	ɦeɔfʲizɪt͡ʃnei̯
славити	sɫɑʋete
слон	sɫɔn
ілюзія	ilʲuzʲijɐ
приходити	prexɔdete
досьє	dɔsʲjɛ
вареник	ʋɐrɛnek
зупинитися	zʊpenɪtesʲɐ
обережність	ɔberɛʒnʲisʲtʲ
пережити	pereʒɪte
близькість	bɫɪzʲkʲisʲtʲ
шкіро	ʃkʲirɔ
питний	petnɪi̯
авіабомба	ɐʋʲiɐbɔmbɐ
рубіж	rʊbʲiʒ
безпритульний	bezpretulʲnei̯
лукашенко	ɫʊkɐʃɛnkɔ
відомий	ʋʲidɔmei̯
літопис	lʲitɔpes
важчий	ʋɑʒt͡ʃei̯
вина	ʋenɑ
батярка	bɐtʲɑrkɐ
кипіти	kepʲite
цитата	t͡setɑtɐ
люб'язний	lʲʊbjɑznei̯
сполучник	spoɫut͡ʃnek
палестинець	pɐɫestɪnet͡sʲ
уникнути	ʊnɪknʊte
братський	brɑt͡sʲkei̯
цигарка	t͡seɦɑrkɐ
криза	krɪzɐ
філософський	fʲiɫɔsɔfsʲkei̯
принизливий	prenɪzɫeʋei̯
ріпою	rʲipɔjʊ
після	pʲisʲlʲɐ
скронями	skrɔnʲɐme
тисячоліттям	tesʲɐt͡ʃolʲitʲːɐm
купувати	kʊpʊʋɑte
ознака	ɔznɑkɐ
халепа	xɑɫepɐ
гавань	ɦɑʋɐnʲ
гормони	ɦɔrmɔne
шия	ʃɪjɐ
авіамоделізм	ɐʋʲiɐmɔdelʲizm
спростовувати	sprɔstɔwʊʋɐte
демократизація	demɔkrɐtezɑt͡sʲijɐ
слов'янину	sɫɔʋjɐnɪnʊ
доповнювати	dɔpɔu̯nʲʊʋɐte
важко	ʋɑʒkɔ
податок	pɔdɑtɔk
русини	rusene
оповісти	ɔpɔʋʲistɪ
копито	kɔpɪtɔ
присвячувати	presʲʋʲɑt͡ʃʊʋɐte
українською	ʊkrɐjinʲsʲkɔjʊ
схожість	sxɔʒʲisʲtʲ
розповсюдити	rɔzpɔu̯sʲudete
слизький	sɫezʲkɪi̯
дівчинка	dʲiu̯t͡ʃenkɐ
дівчина	dʲiu̯t͡ʃɪnɐ
енергіях	enɛrɦʲijɐx
дієприслівник	dʲijepresʲlʲiu̯nek
суми	sʊmɪ
гелій	ɦɛlʲii̯
гористий	ɦɔrɪstei̯
піти	pʲitɪ
симпатичний	sempɐtɪt͡ʃnei̯
гомель	ɦɔmelʲ
шестірня	ʃesʲtʲirnʲɑ
тебе	tebɛ
той	tɔi̯
теж	tɛʒ
світанку	sʲʋʲitɑnkʊ
голота	ɦɔɫɔtɐ
кличний	kɫɪt͡ʃnei̯
співзасновник	sʲpʲiu̯zɐsnɔu̯nek
партійний	pɐrtʲii̯nei̯
лід	lʲid
моїм	mɔjim
випустити	ʋɪpʊstete
абсолютно	ɐbsolʲutnɔ
найновіший	nɐi̯nɔʋʲiʃei̯
ієрархічний	ijerɐrxʲit͡ʃnei̯
агресія	ɐɦrɛsʲijɐ
сир	sɪr
партнер	pɐrtnɛr
воювати	wɔjʊʋɑte
інцидентом	int͡sedɛntɔm
словенія	sɫɔʋɛnʲijɐ
поліпшувати	polʲipʃʊʋɐte
тимчасовий	temt͡ʃɐsɔʋei̯
ломбард	ɫɔmbɑrd
дошкам	dɔʃkɐm
теплиця	tepɫɪt͡sʲɐ
білорусь	bʲiɫorusʲ
замінювати	zɐmʲinʲʊʋɐte
чорногуз	t͡ʃɔrnoɦuz
інтенсивний	intensɪu̯nei̯
даремний	dɐrɛmnei̯
одноманітний	ɔdnɔmɐnʲitnei̯
справам	sprɑʋɐm
зерно	zɛrnɔ
спитати	spetɑte
постійний	posʲtʲii̯nei̯
весілля	ʋesʲilʲːɐ
чорна	t͡ʃɔrnɐ
ужити	ʊʒɪte
абулія	ɐbʊlʲijɐ
мураха	mʊrɑxɐ
схуднути	sxudnʊte
відновлювати	ʋʲidnɔu̯lʲʊʋɐte
переважити	pereʋɑʒete
тетеря	tetɛrʲɐ
русин	rusen
тунелеві	tʊnɛɫeʋʲi
щастя	ʃt͡ʃɑsʲtʲɐ
полиця	pɔɫɪt͡sʲɐ
парижанин	pɐreʒɑnen
завважувати	zɐʋːɑʒʊʋɐte
фотографія	fɔtɔɦrɑfʲijɐ
застарілий	zɐstɐrʲiɫei̯
безкраїсть	bezkrɑjisʲtʲ
гостинність	ɦɔstɪnʲːisʲtʲ
танки	tɐnkɪ
спільний	sʲpʲilʲnei̯
ситуація	setʊɑt͡sʲijɐ
критеріям	kretɛrʲijɐm
правовий	prɐwɔʋɪi̯
посмішка	pɔsʲmʲiʃkɐ
таблиця	tɐbɫɪt͡sʲɐ
надіях	nɐdʲijɐx
марнотратити	mɐrnɔtrɑtete
рій	rʲii̯
австрієць	ɐu̯stʲrʲijet͡sʲ
лоб	ɫɔb
просторовий	prɔstɔrɔʋei̯
верхній	ʋɛrxnʲii̯
пестицид	pestet͡sɪd
автовиробник	ɐu̯tɔʋerɔbnɪk
тис	tɪs
німецька	nʲimɛt͡sʲkɐ
енциклопедичний	ent͡sekɫɔpedɪt͡ʃnei̯
порушити	poruʃete
божественний	bɔʒɛstʋenːei̯
супругою	sʊpruɦɔjʊ
діловий	dʲiɫɔʋɪi̯
порівнянь	pɔrʲiu̯nʲɑnʲ
стримувати	strɪmʊʋɐte
емпатія	empɑtʲijɐ
страх	strɑx
післявоєнний	pʲisʲlʲɐwɔjɛnːei̯
покарати	pɔkɐrɑte
жовток	ʒɔu̯tɔk
електричка	eɫektrɪt͡ʃkɐ
антиномія	ɐntenɔmʲijɐ
прогнозів	prɔɦnɔzʲiu̯
мотивувати	mɔtewʊʋɑte
незалежності	nezɐɫɛʒnɔsʲtʲi
гусятко	ɦʊsʲɑtkɔ
інколи	inkɔɫe
собою	sɔbɔjʊ
десять	dɛsʲɐtʲ
кузина	kʊzɪnɐ
орбіті	orbʲitʲi
словником	sɫɔu̯nekɔm
альв	ɑlʲʋ
скроням	skrɔnʲɐm
неправдам	neprɑu̯dɐm
голод	ɦɔɫɔd
процедура	prɔt͡sedurɐ
сопіти	sopʲite
централізувати	t͡sentrɐlʲizʊʋɑte
тисяч	tɪsʲɐt͡ʃ
розвідувати	rɔzʲʋʲidʊʋɐte
шинок	ʃenɔk
патентувати	pɐtentʊʋɑte
вечорів	ʋet͡ʃorʲiu̯
вітальне	ʋʲitɑlʲne
законах	zɐkɔnɐx
блакить	bɫɐkɪtʲ
плід	plʲid
звернутися	zʋernutesʲɐ
австромарксист	ɐu̯strɔmɐrksɪst
активно	ɐktɪu̯nɔ
пішоходах	pʲiʃɔxɔdɐx
напій	nɐpʲii̯
капітан	kɐpʲitɑn
кладовище	kɫɑdɔʋeʃt͡ʃe
іграми	iɦrɐme
арештовувати	ɐreʃtɔwʊʋɐte
тріска	tʲrʲiskɐ
огірок	ɔɦʲirɔk
пізній	pʲizʲnʲii̯
носоріг	nɔsorʲiɦ
скинути	skɪnʊte
громадянин	ɦrɔmɐdʲɑnen
осінній	osʲinʲːii̯
вирок	ʋɪrɔk
делегаціях	deɫeɦɑt͡sʲijɐx
співгромадянка	sʲpʲiu̯ɦrɔmɐdʲɑnkɐ
охоронець	ɔxɔrɔnet͡sʲ
конструктивний	kɔnstrʊktɪu̯nei̯
рабство	rɑbstwɔ
висіти	ʋesʲite
кермо	kermɔ
регулярність	reɦʊlʲɑrnʲisʲtʲ
поруч	pɔrʊt͡ʃ
кухарка	kuxɐrkɐ
аверс	ɑʋers
нутрощі	nutrɔʃt͡ʃʲi
грошей	ɦrɔʃei̯
новина	nɔʋenɑ
ширший	ʃɪrʃei̯
діставатися	dʲistɐʋɑtesʲɐ
південний	pʲiu̯dɛnːei̯
параметричний	pɐrɐmetrɪt͡ʃnei̯
вибуховий	ʋebʊxɔʋei̯
член	t͡ʃɫɛn
катастрофою	kɐtɐstrɔfɔjʊ
гал	ɦɑɫ
власноручний	wɫɐsnorut͡ʃnei̯
автаркія	ɐu̯tɑrkʲijɐ
верства	ʋerstʋɑ
козакам	kɔzɐkɑm
опитати	ɔpetɑte
галерея	ɦɐɫerɛjɐ
прогнозувати	prɔɦnɔzʊʋɑte
лексичний	ɫeksɪt͡ʃnei̯
календаря	kɐɫendɐrʲɑ
трьохсотий	tʲrʲɔxsɔtei̯
автобальзам	ɐu̯tɔbɐlʲzɑm
поступовий	pɔstʊpɔʋei̯
катастрофам	kɐtɐstrɔfɐm
незнайомець	neznɐjɔmet͡sʲ
спальня	spɑlʲnʲɐ
ґенерація	ɡenerɑt͡sʲijɐ
сотий	sɔtei̯
припинення	prepɪnenʲːɐ
кримом	krɪmɔm
шопінг	ʃɔpʲinɦ
кара	kɑrɐ
словотвір	sɫɔwɔtʲʋʲir
дієвідмінювання	dʲijeʋʲidʲmʲinʲʊʋɐnʲːɐ
баскетбол	bɐskedbɔɫ
нищити	nɪʃt͡ʃete
безматок	bezmɑtɔk
постать	pɔstɐtʲ
береговий	bereɦɔʋɪi̯
інфекцій	infɛkt͡sʲii̯
нарік	nɑrʲik
ейфорія	ei̯forʲijɐ
гаванський	ɦɐʋɑnʲsʲkei̯
тієї	tʲijɛji
дипломат	depɫɔmɑt
щоденник	ʃt͡ʃɔdɛnːek
двохсот	dwɔxsɔt
когнітивний	kɔɦnʲitɪu̯nei̯
усьому	ʊsʲɔmʊ
москва	mɔskʋɑ
фінік	fʲinʲik
слов'янці	sɫɔʋjɑnʲt͡sʲi
трансформаціям	trɐnsfɔrmɑt͡sʲijɐm
надворі	nɐdwɔrʲi
поліцією	polʲit͡sʲijejʊ
короткочасний	kɔrɔtkɔt͡ʃɑsnei̯
поневолювати	pɔnewɔlʲʊʋɐte
попередник	pɔperɛdnek
століттям	stolʲitʲːɐm
вся	ʍsʲɑ
рідна	rʲidnɐ
тихий	tɪxei̯
тунель	tʊnɛlʲ
перервати	pererʋɑte
мордувати	mɔrdʊʋɑte
мегаліт	meɦɐlʲit
рейтинг	rɛi̯tenɦ
дір	dʲir
купа	kupɐ
срібний	sʲrʲibnei̯
ворожнеча	wɔrɔʒnɛt͡ʃɐ
м'який	mjɐkɪi̯
сова	sɔʋɑ
перевантаженість	pereʋɐntɑʒenʲisʲtʲ
неприємний	neprejɛmnei̯
порнографія	pɔrnɔɦrɑfʲijɐ
неприйнятність	neprei̯nʲɑtʲnʲisʲtʲ
водопостачання	wɔdɔpɔstɐt͡ʃɑnʲːɐ
відсотковий	ʋʲid͡zsɔtkɔʋei̯
візовий	ʋʲizɔʋei̯
вивчати	ʋeu̯t͡ʃɑte
опублікувати	ɔpʊblʲikʊʋɑte
озеро	ɔzerɔ
аматор	ɐmɑtɔr
американець	ɐmerekɑnet͡sʲ
об'ємний	ɔbjɛmnei̯
тягнути	tʲɐɦnute
джаз	d͡ʒɑz
щі	ʃt͡ʃʲi
голка	ɦɔɫkɐ
орган	ɔrɦɐn
коза	kɔzɑ
батіг	bɐtʲiɦ
пані	pɑnʲi
аво	ɑwɔ
пов'язати	pɔʋjɐzɑte
око	ɔkɔ
нестабільність	nestɐbʲilʲnʲisʲtʲ
йогурт	jɔɦʊrt
твій	tʲʋʲii̯
є	jɛ
геноциди	ɦenɔt͡sɪde
шльомпа	ʃlʲɔmpɐ
жителька	ʒɪtelʲkɐ
міфологічний	mʲifɔɫoɦʲit͡ʃnei̯
вада	ʋɑdɐ
істеричний	isterɪt͡ʃnei̯
уставати	ʊstɐʋɑte
звернення	zʋɛrnenʲːɐ
портрета	pɔrtrɛtɐ
календарю	kɐɫendɐrʲu
авантюрист	ɐʋɐnʲtʲʊrɪst
подорож	pɔdɔrɔʒ
жарт	ʒɑrt
трагедії	trɐɦɛdʲiji
венеціанець	ʋenet͡sʲiɑnet͡sʲ
в'єтнамський	ʋjetnɑmsʲkei̯
гострити	ɦɔstrɪte
дитсадків	det͡sɐdʲkʲiu̯
вибачити	ʋɪbɐt͡ʃete
комусь	komusʲ
вільнодумство	ʋʲilʲnodumstwɔ
акація	ɐkɑt͡sʲijɐ
дурити	dʊrɪte
ковтати	kɔu̯tɑte
вуздечка	wʊzdɛt͡ʃkɐ
дискримінаційний	deskremʲinɐt͡sʲii̯nei̯
пила	peɫɑ
сексуальність	seksʊɑlʲnʲisʲtʲ
тополя	tɔpɔlʲɐ
грамотність	ɦrɑmɔtʲnʲisʲtʲ
щур	ʃt͡ʃur
водневий	wɔdnɛʋei̯
теоріє	teɔrʲije
емблематичний	embɫemɐtɪt͡ʃnei̯
утрат	ʊtrɑt
психічний	psexʲit͡ʃnei̯
балкон	bɐɫkɔn
індієць	inʲdʲijet͡sʲ
екслібрис	eksʲlʲibres
охорона	ɔxɔrɔnɐ
троянда	trɔjɑndɐ
дніпро	dʲnʲiprɔ
міф	mʲif
криниця	krenɪt͡sʲɐ
досвід	dɔsʲʋʲid
стригти	strɪɦte
туркменістан	tʊrkmenʲistɑn
найбільш	nɐi̯bʲilʲʃ
кота	kɔtɑ
плести	pɫestɪ
грузинський	ɦrʊzɪnʲsʲkei̯
бурунді	bʊrunʲdʲi
зупиняти	zʊpenʲɑte
схильний	sxɪlʲnei̯
подолання	pɔdɔɫɑnʲːɐ
неписьменність	nepesʲmɛnʲːisʲtʲ
грудь	ɦrudʲ
смерека	smerɛkɐ
нестерпний	nestɛrpnei̯
груповий	ɦrʊpɔʋɪi̯
строїти	strɔjite
фашизм	fɐʃɪzm
акт	ɑkt
успішно	ʊsʲpʲiʃnɔ
бельгія	bɛlʲɦʲijɐ
концептуальний	kɔnt͡septʊɑlʲnei̯
заступник	zɐstupnek
норвежка	nɔrʋɛʒkɐ
транспортний	trɑnspɔrtnei̯
коктейль	kɔktɛi̯lʲ
реабілітувати	reɐbʲilʲitʊʋɑte
досліджувати	dosʲlʲid͡ʒʊʋɐte
таїланд	tɐjiɫɑnd
мешкання	mɛʃkɐnʲːɐ
і	i
автобензоцистерна	ɐu̯tɔbenzɔt͡sestɛrnɐ
спідниці	sʲpʲidnɪt͡sʲi
нетопир	netɔpɪr
рівновага	rʲiu̯nɔʋɑɦɐ
електрифікація	eɫektrefʲikɑt͡sʲijɐ
безсторонній	bezstɔrɔnʲːii̯
вівса	ʋʲiu̯sɐ
давальний	dɐʋɑlʲnei̯
афіни	ɐfʲine
зумовлювати	zʊmɔu̯lʲʊʋɐte
чхати	t͡ʃxɑte
дорожній	dɔrɔʒnʲii̯
мер	mɛr
стандарту	stɐndɑrtʊ
львівський	lʲʋʲiu̯sʲkei̯
метою	metɔjʊ
вісь	ʋʲisʲ
папір	pɐpʲir
цілісність	t͡sʲilʲisʲnʲisʲtʲ
одноокий	ɔdnɔɔkei̯
єдваб	jedʋɑb
фінансування	fʲinɐnsʊʋɑnʲːɐ
грішити	ɦrʲiʃɪte
чешка	t͡ʃɛʃkɐ
наблизити	nɐbɫɪzete
посередній	pɔserɛdʲnʲii̯
телевізор	teɫeʋʲizɔr
виразний	ʋerɑznei̯
обережно	ɔberɛʒnɔ
виборі	ʋɪbɔrʲi
лякати	lʲɐkɑte
проживання	prɔʒeʋɑnʲːɐ
аналітичний	ɐnɐlʲitɪt͡ʃnei̯
присвійний	presʲʋʲii̯nei̯
апарат	ɐpɐrɑt
мотоциклом	mɔtɔt͡sɪkɫɔm
розказати	rɔzkɐzɑte
бондарня	bɔndɑrnʲɐ
брехнею	brexnɛjʊ
гідний	ɦʲidnei̯
городище	ɦɔrɔdɪʃt͡ʃe
подробицями	pɔdrɔbet͡sʲɐme
попри	pɔprɪ
королівський	kɔrolʲiu̯sʲkei̯
відновити	ʋʲidnɔʋɪte
своячка	swɔjɑt͡ʃkɐ
мода	mɔdɐ
клітка	klʲitkɐ
грива	ɦrɪʋɐ
сукню	suknʲʊ
імунологія	imʊnɔɫɔɦʲijɐ
судинний	sʊdɪnːei̯
забезпечити	zɐbezpɛt͡ʃete
застудам	zɐstudɐm
замбія	zɑmbʲijɐ
нетрадиційний	netrɐdet͡sʲii̯nei̯
блювотний	blʲʊwɔtnei̯
авіабензин	ɐʋʲiɐbenzɪn
африка	ɑfrekɐ
кишки	keʃkɪ
звір	zʲʋʲir
демократія	demɔkrɑtʲijɐ
ефективний	efektɪu̯nei̯
ембріон	embrʲiɔn
незвичний	nezʋɪt͡ʃnei̯
єва	jɛʋɐ
північний	pʲiu̯nʲit͡ʃnei̯
озерце	ɔzert͡sɛ
індивідуальний	indeʋʲidʊɑlʲnei̯
авто	ɐu̯tɔ
дубовий	dʊbɔʋei̯
ощасливити	ɔʃt͡ʃɐsɫɪʋete
млин	mɫɪn
абстрагування	ɐbstrɐɦʊʋɑnʲːɐ
обмеженнях	ɔbmɛʒenʲːɐx
станціє	stɑnʲt͡sʲije
цнота	t͡snɔtɐ
фармакологічний	fɐrmɐkɔɫoɦʲit͡ʃnei̯
пелюстка	pelʲʊstkɑ
нейтралізація	nei̯trɐlʲizɑt͡sʲijɐ
кожний	kɔʒnei̯
китайський	ketɑi̯sʲkei̯
замок	zɑmɔk
субстрат	sʊbstrɑt
маневр	mɐnɛu̯r
пасіка	pɑsʲikɐ
патологічний	pɐtɔɫoɦʲit͡ʃnei̯
щиколотках	ʃt͡ʃɪkɔɫɔtkɐx
нюанс	nʲʊɑns
королеві	kɔrɔɫɛʋʲi
невблаганний	neu̯bɫɐɦɑnːei̯
рішучість	rʲiʃut͡ʃʲisʲtʲ
витерти	ʋɪterte
сказати	skɐzɑte
пішохід	pʲiʃoxʲid
споживання	spɔʒeʋɑnʲːɐ
мадяр	mɐdʲɑr
колапс	kɔɫɑps
концепція	kɔnt͡sɛpt͡sʲijɐ
починати	pɔt͡ʃenɑte
шість	ʃʲisʲtʲ
репресивність	represɪu̯nʲisʲtʲ
послати	pɔsɫɑte
кардіолог	kɐrdʲiɔɫɔɦ
пароль	pɐrɔlʲ
лов	ɫɔu̯
гостиниця	ɦɔstɪnet͡sʲɐ
чистити	t͡ʃɪstete
авієтка	ɐʋʲijɛtkɐ
авіамоделіст	ɐʋʲiɐmɔdelʲist
комунізм	kɔmʊnʲizm
слобода	sɫɔbɔdɑ
завести	zɐʋestɪ
підвищити	pʲidʋɪʃt͡ʃete
господар	ɦɔspɔdɐr
своєрідний	swɔjerʲidnei̯
безмін	bɛzʲmʲin
торкатися	tɔrkɑtesʲɐ
поеми	pɔɛme
обмеженні	ɔbmɛʒenʲːi
відкладати	ʋʲidkɫɐdɑte
в'язниця	ʋjɐznɪt͡sʲɐ
кораблебудування	kɔrɐbɫebʊdʊʋɑnʲːɐ
запоріжжя	zɐporʲiʒʲːɐ
складний	skɫɐdnɪi̯
донець	dɔnɛt͡sʲ
бензовоз	benzɔwɔz
долина	dɔɫɪnɐ
сідниця	sʲidnɪt͡sʲɐ
пропозиція	prɔpɔzɪt͡sʲijɐ
каріатида	kɐrʲiɐtɪdɐ
геноцид	ɦenɔt͡sɪd
море	mɔre
стайня	stɑi̯nʲɐ
свастика	sʋɑstekɐ
протягом	prɔtʲɐɦɔm
велоспорт	ʋeɫɔspɔrt
лікарням	lʲikɑrnʲɐm
тринадцять	trenɑd͡zʲt͡sʲɐtʲ
електрик	eɫɛktrek
контраст	kɔntrɑst
достатньо	dɔstɑtʲnʲɔ
небезпеки	nebezpɛke
комедіє	kɔmɛdʲije
грім	ɦrʲim
мокнути	mɔknʊte
роззброїти	rɔzːbrɔjite
скрізь	skrʲizʲ
епідеміолог	epʲidemʲiɔɫɔɦ
сьомий	sʲɔmei̯
товариство	tɔʋɐrɪstwɔ
вівсам	ʋʲiu̯sɐm
пропорційний	prɔport͡sʲii̯nei̯
поліціями	polʲit͡sʲijɐme
портфелеві	pɔrtfɛɫeʋʲi
частина	t͡ʃɐstɪnɐ
ацтекський	ɐt͡stɛksʲkei̯
черешня	t͡ʃerɛʃnʲɐ
парада	pɐrɑdɐ
шено	ʃɛnɔ
справедливість	sprɐʋedɫɪʋʲisʲtʲ
співорганізаторка	sʲpʲiwɔrɦɐnʲizɑtɔrkɐ
тепер	tepɛr
законний	zɐkɔnːei̯
трагедією	trɐɦɛdʲijejʊ
чемпіонка	t͡ʃempʲiɔnkɐ
ігор	iɦɔr
ідеал	ideɑɫ
вій	ʋʲii̯
золота	zɔɫɔtɐ
аврикула	ɐu̯rɪkʊɫɐ
частота	t͡ʃɐstɔtɑ
кріт	krʲit
автентифікація	ɐu̯tentefʲikɑt͡sʲijɐ
прокоментувати	prɔkɔmentʊʋɑte
фонтан	fɔntɑn
номенклатура	nɔmenkɫɐturɐ
свічка	sʲʋʲit͡ʃkɐ
кутя	kʊtʲɑ
суперечка	sʊperɛt͡ʃkɐ
справ	sprɑu̯
неписьменний	nepesʲmɛnːei̯
дискримінувати	deskremʲinʊʋɑte
скоп'є	skɔpje
арфуш	ɐrfuʃ
фотограф	fɔtɔɦrɐf
співгромадянин	sʲpʲiu̯ɦrɔmɐdʲɑnen
тенденція	tendɛnʲt͡sʲijɐ
стан	stɑn
вікісловнику	ʋʲikʲisɫɔu̯neku
прославити	prɔsɫɑʋete
пріоритетний	prʲiɔretɛtnei̯
орудний	orudnei̯
вежа	ʋɛʒɐ
ланцюговий	ɫɐnʲt͡sʲʊɦɔʋei̯
софія	sɔfʲijɐ
зв'язку	zʋjɑzkʊ
відмежувати	ʋʲidmeʒʊʋɑte
соняшник	sɔnʲɐʃnek
бюро	bʲʊrɔ
лабораторію	ɫɐbɔrɐtɔrʲijʊ
столична	stɔɫɪt͡ʃnɐ
котрий	kɔtrɪi̯
авіакатастрофа	ɐʋʲiɐkɐtɐstrɔfɐ
кашлянути	kɐʃlʲɐnute
автор	ɑu̯tɔr
еякулят	ejɐkʊlʲɑt
тесть	tɛsʲtʲ
століть	stolʲitʲ
хасидизм	xɐsedɪzm
бездоганно	bezdɔɦɑnːɔ
зцілювати	zʲt͡sʲilʲʊʋɐte
дисертації	desertɑt͡sʲiji
шип	ʃɪp
кордон	kɔrdɔn
зручний	zrut͡ʃnei̯
стомлений	stɔmɫenei̯
сукні	suknʲi
кончина	kɔnt͡ʃɪnɐ
торкати	tɔrkɑte
нічий	nʲit͡ʃɪi̯
володілець	wɔɫodʲiɫet͡sʲ
прийнятність	prei̯nʲɑtʲnʲisʲtʲ
мить	mɪtʲ
ваша	ʋɑʃɐ
організовувати	ɔrɦɐnʲizɔwʊʋɐte
знеохотити	zneɔxɔtete
павутина	pɐwʊtɪnɐ
ось	ɔsʲ
потилицею	pɔtɪɫet͡sejʊ
візантія	ʋʲizɐnʲtʲijɐ
продавати	prɔdɐʋɑte
стабільність	stɐbʲilʲnʲisʲtʲ
грудень	ɦrudenʲ
ідеологія	ideɔɫɔɦʲijɐ
гребля	ɦrɛblʲɐ
таємницям	tɐjemnɪt͡sʲɐm
мамонт	mɑmɔnt
повсюдний	pɔu̯sʲudnei̯
ламати	ɫɐmɑte
ратифікувати	rɐtefʲikʊʋɑte
капітулювати	kɐpʲitʊlʲʊʋɑte
бос	bɔs
постійно	posʲtʲii̯nɔ
обмежений	ɔbmɛʒenei̯
винахідниця	ʋenɐxʲidnet͡sʲɐ
однозначно	ɔdnɔznɑt͡ʃnɔ
діафрагмам	dʲiɐfrɑɦmɐm
всесвітньовідомий	ʍsesʲʋʲitʲnʲɔʋʲidɔmei̯
наступного	nɐstupnɔɦɔ
інсценувати	inst͡senʊʋɑte
отава	ɔtɑʋɐ
правий	prɑʋei̯
вищий	ʋɪʃt͡ʃei̯
наймати	nɐi̯mɑte
пробудитися	prɔbʊdɪtesʲɐ
вторгнутися	ʍtɔrɦnʊtesʲɐ
блокадою	bɫɔkɑdɔjʊ
імперію	impɛrʲijʊ
покращувати	pɔkrɑʃt͡ʃʊʋɐte
проститутка	prɔstetutkɐ
наддержава	nɐdːerʒɑʋɐ
кримський	krɪmsʲkei̯
коаліційний	kɔɐlʲit͡sʲii̯nei̯
пропонувати	prɔpɔnʊʋɑte
російський	rosʲii̯sʲkei̯
прощатися	prɔʃt͡ʃɑtesʲɐ
інтермецо	intermɛt͡sɔ
визнання	ʋeznɑnʲːɐ
суддя	sʊdʲːɑ
рішучий	rʲiʃut͡ʃei̯
імператор	imperɑtɔr
кальцій	kɑlʲt͡sʲii̯
перга	perɦɑ
шаньга	ʃɑnʲɦɐ
професійний	prɔfesʲii̯nei̯
лихий	ɫexɪi̯
радянська	rɐdʲɑnʲsʲkɐ
тверезий	tʋerɛzei̯
десертах	desɛrtɐx
федераціях	federɑt͡sʲijɐx
скип'ятити	skepjɐtɪte
позбавлення	pɔzbɑu̯ɫenʲːɐ
абазія	ɐbɑzʲijɐ
шолом	ʃɔɫɔm
щітка	ʃt͡ʃʲitkɐ
гру	ɦru
одноголосний	ɔdnɔɦɔɫɔsnei̯
переглядати	pereɦlʲɐdɑte
уповноважувати	ʊpɔu̯nɔʋɑʒʊʋɐte
нудота	nʊdɔtɐ
яловичині	jɑɫɔʋet͡ʃenʲi
онука	onukɐ
систематично	sestemɐtɪt͡ʃnɔ
задоволеність	zɐdɔwɔɫenʲisʲtʲ
рукам	rʊkɑm
міністерство	mʲinʲistɛrstwɔ
черкаси	t͡ʃerkɑse
ситуацію	setʊɑt͡sʲijʊ
справі	sprɑʋʲi
перевага	pereʋɑɦɐ
незмінний	nezʲmʲinːei̯
дбати	dbɑte
конгрес	kɔnɦrɛs
патетичний	pɐtetɪt͡ʃnei̯
смачний	smɐt͡ʃnɪi̯
брамам	brɑmɐm
сестрице	sestrɪt͡se
смертоносний	smertɔnɔsnei̯
піаніно	pʲiɐnʲinɔ
геноцидів	ɦenɔt͡sɪdʲiu̯
сестриця	sestrɪt͡sʲɐ
спадкоємець	spɐdkɔjɛmet͡sʲ
тому	tɔmʊ
ссавці	sːɐu̯t͡sʲi
датувати	dɐtʊʋɑte
автоаматор	ɐu̯tɔɐmɑtɔr
італія	itɑlʲijɐ
конституція	kɔnstetut͡sʲijɐ
прийми	prei̯mɪ
блокад	bɫɔkɑd
наволочка	nɑwɔɫɔt͡ʃkɐ
дуб	dub
здатний	zdɑtnei̯
сом	sɔm
рекламувати	rekɫɐmʊʋɑte
несправедливий	nesprɐʋedɫɪʋei̯
обмін	ɔbmʲin
знижка	znɪʒkɐ
ваги	ʋɐɦɪ
перешийок	pereʃɪjɔk
увечері	ʊʋɛt͡ʃerʲi
ера	ɛrɐ
токіо	tɔkʲiɔ
стати	stɑte
захищати	zɐxeʃt͡ʃɑte
епідемія	epʲidɛmʲijɐ
марка	mɑrkɐ
чотирикутний	t͡ʃɔterekutnei̯
прийдешній	prei̯dɛʃnʲii̯
гума	ɦumɐ
плавати	pɫɑʋɐte
відродити	ʋʲidrɔdɪte
авіаційник	ɐʋʲiɐt͡sʲii̯nek
персидський	persɪd͡zʲsʲkei̯
трагедіє	trɐɦɛdʲije
годувати	ɦɔdʊʋɑte
авіамоторобудування	ɐʋʲiɐmɔtɔrɔbʊdʊʋɑnʲːɐ
росіянка	rɔsʲijɑnkɐ
засвідчити	zɐsʲʋʲid͡ʒt͡ʃete
дендрохронологія	dendrɔxrɔnɔɫɔɦʲijɐ
втрата	ʍtrɑtɐ
цікавий	t͡sʲikɑʋei̯
виховувати	ʋexɔwʊʋɐte
лоша	ɫɔʃɑ
намисто	nɐmɪstɔ
бесіда	bɛsʲidɐ
прагнення	prɑɦnenʲːɐ
темрява	tɛmrʲɐʋɐ
ніздрів	nʲizdʲrʲiu̯
транзитний	trɐnzɪtnei̯
лінивий	lʲinɪʋei̯
організувати	ɔrɦɐnʲizʊʋɑte
припадати	prepɐdɑte
євген	jeu̯ɦɛn
теля	telʲɑ
слати	sɫɑte
образний	ɔbrɐznei̯
реальність	reɑlʲnʲisʲtʲ
образливий	ɔbrɑzɫeʋei̯
низький	nezʲkɪi̯
емпіричний	empʲirɪt͡ʃnei̯
виразити	ʋɪrɐzete
бісексуальність	bʲiseksʊɑlʲnʲisʲtʲ
довгошиїй	dɔu̯ɦɔʃɪjii̯
андріїв	ɐndʲrʲijiu̯
аґрусівка	ɐɡrʊsʲiu̯kɐ
задоволення	zɐdɔwɔɫenʲːɐ
чехія	t͡ʃɛxʲijɐ
персоніфікація	persɔnʲifʲikɑt͡sʲijɐ
теолог	teɔɫɔɦ
коротше	kɔrɔt͡ʃʃe
металобрухт	metɐɫobruxt
найменше	nɐi̯mɛnʃe
лавина	ɫɐʋɪnɐ
прискорити	preskɔrete
реєструвати	rejestrʊʋɑte
індійка	inʲdʲii̯kɐ
калина	kɐɫɪnɐ
дистанційне	destɐnʲt͡sʲii̯ne
ідеаліст	ideɐlʲist
перевищувати	pereʋɪʃt͡ʃʊʋɐte
соціалістична	sɔt͡sʲiɐlʲistɪt͡ʃnɐ
ціна	t͡sʲinɑ
дошку	dɔʃkʊ
скена	skɛnɐ
загадка	zɐɦɑdkɐ
безлюддя	bezʲlʲudʲːɐ
військо	ʋʲii̯sʲkɔ
співучасник	sʲpʲiwʊt͡ʃɑsnek
ресурс	resurs
тварина	tʋɐrenɑ
вовк	wɔu̯k
сонет	sɔnɛt
юрба	jʊrbɑ
гроші	ɦroʃʲi
готувати	ɦɔtʊʋɑte
лісовий	lʲisɔʋɪi̯
західний	zɑxʲidnei̯
азіатський	ɐzʲiɑt͡sʲkei̯
одягти	ɔdʲɐɦtɪ
автостоянка	ɐu̯tɔstɔjɑnkɐ
з'їбатися	zjibɑtesʲɐ
інциденту	int͡sedɛntʊ
авіачастина	ɐʋʲiɐt͡ʃɐstɪnɐ
перевірений	pereʋʲirenei̯
бетонний	betɔnːei̯
цистерна	t͡sestɛrnɐ
закохуватися	zɐkɔxʊʋɐtesʲɐ
акціонерне	ɐkt͡sʲiɔnɛrne
позитивно	pɔzetɪu̯nɔ
боснійський	bosʲnʲii̯sʲkei̯
привід	prɪʋʲid
присвятити	presʲʋʲɐtɪte
олігарх	ɔlʲiɦɑrx
паризький	pɐrɪzʲkei̯
відреагувати	ʋʲidreɐɦʊʋɑte
людство	lʲud͡zstwɔ
залізничний	zɐlʲiznɪt͡ʃnei̯
оман	ɔmɑn
пасти	pɑste
вівера	ʋʲiʋɛrɐ
волейбол	wɔɫei̯bɔɫ
картопля	kɐrtɔplʲɐ
довірливий	dɔʋʲirɫeʋei̯
попит	pɔpet
спішний	sʲpʲiʃnei̯
алергія	ɐɫerɦʲijɐ
дуріан	dʊrʲiɑn
організована	ɔrɦɐnʲizɔʋɐnɐ
оцей	ɔt͡sɛi̯
видання	ʋedɑnʲːɐ
виправдати	ʋɪprɐu̯dɐte
слов'яни	sɫɔʋjɑne
робітник	rɔbʲitnɪk
кацапський	kɐt͡sɑpsʲkei̯
можна	mɔʒnɐ
делегувати	deɫeɦʊʋɑte
ґуральник	ɡʊrɑlʲnek
підтримувати	pʲidtrɪmʊʋɐte
шити	ʃɪte
ділити	dʲiɫɪte
критеріях	kretɛrʲijɐx
підборідь	pʲidborʲidʲ
новорічний	nɔworʲit͡ʃnei̯
буду	budʊ
п'ятий	pjɑtei̯
результат	rezʊlʲtɑt
моря	mɔrʲɑ
плащ	pɫɑʃt͡ʃ
швед	ʃʋɛd
учениця	ʊt͡ʃenɪt͡sʲɐ
щоб	ʃt͡ʃɔb
м'ясо	mjɑsɔ
погіршувати	poɦʲirʃʊʋɐte
пізніше	pʲizʲnʲiʃe
диявола	dejɑwɔɫɐ
набійка	nɐbʲii̯kɐ
глава	ɦɫɐʋɑ
поціновувач	pɔt͡sʲinɔwʊʋɐt͡ʃ
сідницям	sʲidnɪt͡sʲɐm
сатана	sɐtɐnɑ
етимолог	etemɔɫɔɦ
мовити	mɔʋete
брами	brɑme
розглянути	rɔzɦlʲɑnʊte
вартість	ʋɑrtʲisʲtʲ
складати	skɫɐdɑte
пригадати	preɦɐdɑte
заповнити	zɐpɔu̯nete
науковий	nɐʊkɔʋei̯
бухгалтерка	bʊɦɦɑɫterkɐ
хом'як	xɔmjɑk
каплиця	kɐpɫɪt͡sʲɐ
легалізація	ɫeɦɐlʲizɑt͡sʲijɐ
німа	nʲimɑ
потенційний	pɔtenʲt͡sʲii̯nei̯
минулий	menuɫei̯
протистояти	prɔtestɔjɑte
постаті	pɔstɐtʲi
багатогранний	bɐɦɐtɔɦrɑnːei̯
захід	zɐxʲid
абсолют	ɐbsolʲut
підошвам	pʲidɔʃʋɐm
поштовий	pɔʃtɔʋei̯
восьмисот	wɔsʲmesɔt
котел	kɔtɛɫ
вечері	ʋet͡ʃɛrʲi
шаповал	ʃɐpɔʋɑɫ
автобус	ɐu̯tɔbʊs
синтетичний	sentetɪt͡ʃnei̯
піна	pʲinɐ
підземний	pʲid͡zzɛmnei̯
дістати	dʲistɑte
наголосити	nɐɦɔɫɔsɪte
федерацію	federɑt͡sʲijʊ
відчинити	ʋʲid͡ʒt͡ʃenɪte
пояснювальний	pɔjɑsʲnʲʊʋɐlʲnei̯
бетон	betɔn
таємницею	tɐjemnɪt͡sejʊ
діри	dʲirɪ
лабораторний	ɫɐbɔrɐtɔrnei̯
доля	dɔlʲɐ
сприйняття	sprei̯nʲɐtʲːɑ
прощати	prɔʃt͡ʃɑte
раз	rɑz
дурисвіт	dʊrɪsʲʋʲit
затримувати	zɐtrɪmʊʋɐte
бухгалтер	bʊɦɦɑɫter
куштувати	kʊʃtʊʋɑte
секрет	sekrɛt
дати	dɑte
поштова	pɔʃtɔʋɐ
основа	ɔsnɔʋɐ
відповідний	ʋʲidpɔʋʲidnei̯
віктор	ʋʲiktɔr
придбати	predbɑte
брехнях	brɛxnʲɐx
фундаментальний	fʊndɐmentɑlʲnei̯
тип	tɪp
багаж	bɐɦɑʒ
стимул	stɪmʊɫ
україну	ʊkrɐjinʊ
труїти	trʊjite
дядя	dʲɑdʲɐ
умирати	ʊmerɑte
японка	jɐpɔnkɐ
сполучати	spɔɫʊt͡ʃɑte
інна	inːɐ
весільна	ʋesʲilʲnɐ
кількагодинний	kʲilʲkɐɦɔdɪnːei̯
вікісловника	ʋʲikʲisɫɔu̯nekɑ
благоговіти	bɫɐɦɔɦɔʋʲite
яструб	jɑstrʊb
розвинути	rɔzʋɪnʊte
ворожість	wɔrɔʒʲisʲtʲ
чвертей	t͡ʃʋɛrtei̯
яна	jɑnɐ
сатиричний	sɐterɪt͡ʃnei̯
відвертати	ʋʲidʋertɑte
професія	prɔfɛsʲijɐ
настільний	nɐsʲtʲilʲnei̯
дисертацією	desertɑt͡sʲijejʊ
психіатрія	psexʲiɐtʲrʲijɐ
шкода	ʃkɔdɑ
невідомий	neʋʲidɔmei̯
протиповітряний	prɔtepɔʋʲitʲrʲɐnei̯
забороняти	zɐbɔrɔnʲɑte
рилом	rɪɫɔm
якби	jɐɡbɪ
звичай	zʋɪt͡ʃɐi̯
шпиталь	ʃpetɑlʲ
багатство	bɐɦɑt͡stwɔ
ймовірний	i̯mɔʋʲirnei̯
горох	ɦɔrɔx
перлина	perɫɪnɐ
слива	sɫɪʋɐ
абсциса	ɐbst͡sɪsɐ
додаток	dɔdɑtɔk
повторити	pɔu̯tɔrɪte
спізнюватися	sʲpʲizʲnʲʊʋɐtesʲɐ
навігаційний	nɐʋʲiɦɐt͡sʲii̯nei̯
бурштин	bʊrʃtɪn
влада	wɫɑdɐ
афаліна	ɐfɐlʲinɐ
згуртованість	zɦʊrtɔʋɐnʲisʲtʲ
зціляти	zʲt͡sʲilʲɑte
всесвітньо	ʍsesʲʋʲitʲnʲɔ
стандартом	stɐndɑrtɔm
ксеркс	ksɛrks
антидот	ɐntedɔt
легальний	ɫeɦɑlʲnei̯
перетинка	perɛtenkɐ
роззброювати	rɔzːbrɔjʊʋɐte
п'ятнадцять	pjɐtnɑd͡zʲt͡sʲɐtʲ
вступати	ʍstʊpɑte
занадто	zɐnɑdtɔ
мегалітичний	meɦɐlʲitɪt͡ʃnei̯
чоловіки	t͡ʃɔɫɔʋʲike
візок	ʋʲizɔk
фею	fɛjʊ
гри	ɦrɪ
обладнати	ɔbɫɐdnɑte
йордан	jɔrdɑn
в'язи	ʋjɑze
шахи	ʃɑxe
вихід	ʋɪxʲid
моїх	mɔjix
резина	rezɪnɐ
ганебний	ɦɐnɛbnei̯
чось	t͡ʃɔsʲ
завантажувати	zɐʋɐntɑʒʊʋɐte
згинути	zɦɪnʊte
повноважний	pɔu̯nɔʋɑʒnei̯
хлопчик	xɫɔpt͡ʃek
освітологія	ɔsʲʋʲitɔɫɔɦʲijɐ
чудій	t͡ʃʊdʲii̯
сміх	sʲmʲix
організований	ɔrɦɐnʲizɔʋɐnei̯
термометричний	termɔmetrɪt͡ʃnei̯
опановувати	ɔpɐnɔwʊʋɐte
калька	kɑlʲkɐ
м'язу	mjɑzʊ
карликовий	kɑrɫekɔʋei̯
веселка	ʋesɛɫkɐ
зарядити	zɐrʲɐdɪte
фрагменту	frɐɦmɛntʊ
родзинки	rɔd͡zɪnke
бджолосім'я	bd͡ʒɔɫɔsʲimjɑ
ренесанс	renesɑns
старик	stɐrɪk
абиколи	ɐbɪkɔɫe
криму	kremu
бактерія	bɐktɛrʲijɐ
горностай	ɦɔrnɔstɑi̯
вісімнадцять	ʋʲisʲimnɑd͡zʲt͡sʲɐtʲ
недвозначний	nedwɔznɑt͡ʃnei̯
стиль	stɪlʲ
культурний	kʊlʲturnei̯
покажчик	pɔkɑʒt͡ʃek
смерч	smɛrt͡ʃ
сміливий	sʲmʲiɫeʋei̯
бездомний	bezdɔmnei̯
києвом	kɪjewɔm
відбуватися	ʋʲidbʊʋɑtesʲɐ
консервація	kɔnserʋɑt͡sʲijɐ
сімейний	sʲimɛi̯nei̯
козаками	kɔzɐkɑme
метаболічний	metɐbolʲit͡ʃnei̯
вулик	wuɫek
ловелас	ɫɔʋeɫɑs
напружувати	nɐpruʒʊʋɐte
військовий	ʋʲii̯sʲkɔʋɪi̯
композиторка	kɔmpɔzɪtɔrkɐ
таємницях	tɐjemnɪt͡sʲɐx
здійснення	zʲdʲii̯snenʲːɐ
їсти	jiste
імпровізувати	imprɔʋʲizʊʋɑte
вівсу	ʋʲiu̯su
єдність	jɛdʲnʲisʲtʲ
унеможливлювати	ʊnemɔʒɫɪu̯lʲʊʋɐte
шовковиця	ʃɔu̯kɔʋet͡sʲɐ
фаза	fɑzɐ
таїсія	tɐjisʲijɐ
ішак	iʃɑk
селити	seɫɪte
удосконалити	ʊdɔskɔnɑɫete
косово	kɔsɔwɔ
ювелірний	jʊʋelʲirnei̯
білосніжний	bʲiɫosʲnʲiʒnei̯
сімсот	sʲimsɔt
споживач	spɔʒeʋɑt͡ʃ
стереотип	stereɔtɪp
дятел	dʲɑteɫ
слово	sɫɔwɔ
стигматизація	steɦmɐtezɑt͡sʲijɐ
вулкан	wʊɫkɑn
халепа	xɐɫɛpɐ
металевий	metɐɫɛʋei̯
довоєнний	dɔwɔjɛnːei̯
кусати	kʊsɑte
великодній	ʋeɫekɔdʲnʲii̯
коментар	kɔmentɑr
українській	ʊkrɐjinsʲkʲii̯
виправдовувати	ʋeprɐu̯dɔwʊʋɐte
лауреат	ɫɐʊreɑt
автопортрет	ɐu̯tɔpɔrtrɛt
орбіту	orbʲitʊ
автобіограф	ɐu̯tɔbʲiɔɦrɐf
потилиці	pɔtɪɫet͡sʲi
щиколотко	ʃt͡ʃɪkɔɫɔtkɔ
вмерти	wmɛrte
зимовий	zemɔʋɪi̯
давньогрецький	dɐu̯nʲɔɦrɛt͡sʲkei̯
дітки	dʲitke
прямокутник	prʲɐmokutnek
запозичувати	zɐpɔzɪt͡ʃʊʋɐte
спорядити	spɔrʲɐdɪte
поліції	polʲit͡sʲiji
гідравлічний	ɦʲidrɐu̯lʲit͡ʃnei̯
зерно	zernɔ
баско	bɐskɔ
ураган	ʊrɐɦɑn
покоління	pɔkolʲinʲːɐ
осінь	ɔsʲinʲ
аргентина	ɐrɦentɪnɐ
спричиняти	spret͡ʃenʲɑte
найменший	nɐi̯mɛnʃei̯
багатомовність	bɐɦɐtɔmɔu̯nʲisʲtʲ
ці	t͡sʲi
федерацією	federɑt͡sʲijejʊ
отець	ɔtɛt͡sʲ
поглядах	pɔɦlʲɐdɐx
гуманітарний	ɦʊmɐnʲitɑrnei̯
власник	wɫɑsnek
пропозицій	prɔpɔzɪt͡sʲii̯
ідеалізація	ideɐlʲizɑt͡sʲijɐ
віросповідання	ʋʲirɔspɔʋʲidɑnʲːɐ
розпитувати	rɔzpɪtʊʋɐte
змій	zʲmʲii̯
обговорювати	ɔbɦɔwɔrʲʊʋɐte
декриміналізація	dekremʲinɐlʲizɑt͡sʲijɐ
пішоходів	pʲiʃɔxɔdʲiu̯
дисбаланс	dezbɐɫɑns
куток	kʊtɔk
доступний	dostupnei̯
гігієнічний	ɦʲiɦʲijenʲit͡ʃnei̯
порівняльний	pɔrʲiu̯nʲɑlʲnei̯
глухий	ɦɫʊxɪi̯
ознайомлення	ɔznɐjɔmɫenʲːɐ
використання	ʋekɔrestɑnʲːɐ
плутократіє	pɫʊtɔkrɑtʲije
анастасія	ɐnɐstɑsʲijɐ
ніколи	nʲikɔɫe
дозувати	dɔzʊʋɑte
дозвіл	dɔzʲʋʲiɫ
обміркувати	ɔbmʲirkʊʋɑte
докладний	dɔkɫɑdnei̯
кіровоград	kʲirɔwɔɦrɑd
детальний	detɑlʲnei̯
іспит	ispet
доростати	dɔrɔstɑte
досягнення	dɔsʲɑɦnenʲːɐ
вимазати	ʋɪmɐzɐte
божевілля	bɔʒeʋʲilʲːɐ
категоричний	kɐteɦɔrɪt͡ʃnei̯
горище	ɦɔrɪʃt͡ʃe
негативний	neɦɐtɪu̯nei̯
твар	tʋɑr
аґрус	ɑɡrʊs
узагальнити	ʊzɐɦɑlʲnete
вичерпувати	ʋet͡ʃɛrpʊʋɐte
ким	kɪm
зразків	zrɐzʲkʲiu̯
ми	mɪ
м'язам	mjɑzɐm
поступці	pɔstʊpt͡sʲi
популяцій	pɔpʊlʲɑt͡sʲii̯
нідерландський	nʲiderɫɑnd͡zʲsʲkei̯
абазинка	ɐbɐzɪnkɐ
лекція	ɫɛkt͡sʲijɐ
народити	nɐrɔdɪte
познайомити	pɔznɐjɔmete
сцена	st͡sɛnɐ
руслана	rʊsɫɑnɐ
дітлахи	dʲitɫɐxɪ
контрастувати	kɔntrɐstʊʋɑte
сестра	sestrɑ
бачення	bɑt͡ʃenʲːɐ
поспішити	pɔsʲpʲiʃɪte
словечка	sɫɔʋɛt͡ʃkɐ
кредит	kredɪt
спеціалізувати	spet͡sʲiɐlʲizʊʋɑte
швидкоплинний	ʃʋedkɔpɫɪnːei̯
парниковий	pɐrnekɔʋei̯
одужувати	oduʒʊʋɐte
свіжий	sʲʋʲiʒei̯
звинувачувати	zʋenʊʋɑt͡ʃʊʋɐte
підготовити	pʲidɦɔtɔʋete
бабище	bɐbɪʃt͡ʃe
засідання	zɐsʲidɐnʲːɐ
звичка	zʋɪt͡ʃkɐ
гравець	ɦrɐʋɛt͡sʲ
ссати	sːɑte
розпочинати	rɔzpɔt͡ʃenɑte
молекула	mɔɫɛkʊɫɐ
будівництво	bʊdʲiu̯nɪt͡stwɔ
шокувати	ʃɔkʊʋɑte
підпис	pʲidpes
шантаж	ʃɐntɑʒ
собі	sobʲi
дизайн	dezɑi̯n
чемпіонат	t͡ʃempʲiɔnɑt
переорієнтувати	pereɔrʲijentʊʋɑte
комуністичний	kɔmʊnʲistɪt͡ʃnei̯
вітрильний	ʋʲitrɪlʲnei̯
означати	ɔznɐt͡ʃɑte
більше	bʲilʲʃe
бонусами	bɔnʊsɐme
міра	mʲirɐ
називати	nɐzeʋɑte
працівники	prɐt͡sʲiu̯nekɪ
матч	mɑt͡ʃː
феями	fɛjɐme
супругах	sʊpruɦɐx
захаренко	zɐxɑrenkɔ
найдружелюбніший	nɐi̯drʊʒelʲubnʲiʃei̯
арктичний	ɐrktɪt͡ʃnei̯
схематизація	sxemɐtezɑt͡sʲijɐ
разі	rɑzʲi
імбир	imbɪr
переривати	perereʋɑte
освітній	ɔsʲʋʲitʲnʲii̯
пекін	pekʲin
чутний	t͡ʃutnei̯
кентавр	kentɑu̯r
римський	rɪmsʲkei̯
слуховий	sɫʊxɔʋɪi̯
безсумнівний	bezsʊmnʲiu̯nei̯
пильний	pɪlʲnei̯
сексуальна	seksʊɑlʲnɐ
француз	frɐnt͡suz
дівка	dʲiu̯kɐ
згадати	zɦɐdɑte
спіднице	sʲpʲidnɪt͡se
самоповага	sɐmɔpɔʋɑɦɐ
студенець	stʊdenɛt͡sʲ
усмішка	ʊsʲmʲiʃkɐ
атеїзм	ɐtejizm
притаманний	pretɐmɑnːei̯
авізування	ɐʋʲizʊʋɑnʲːɐ
слуга	sɫʊɦɑ
догадатися	dɔɦɐdɑtesʲɐ
кличко	kɫet͡ʃkɔ
русскій	rusːkʲii̯
кат	kɑt
сміятися	sʲmʲijɑtesʲɐ
бараболя	bɐrɐbɔlʲɐ
провінційний	prɔʋʲinʲt͡sʲii̯nei̯
ідеальний	ideɑlʲnei̯
розташувати	rɔztɐʃʊʋɑte
інциденти	int͡sedɛnte
оргазм	ɔrɦɑzm
перебільшити	perebʲilʲʃete
вісімсот	ʋʲisʲimsɔt
пивоварство	pewɔʋɑrstwɔ
герой	ɦerɔi̯
крига	krɪɦɐ
ніс	nʲis
телевізійний	teɫeʋʲizʲii̯nei̯
торба	tɔrbɐ
гора	ɦɔrɐ
кавоварка	kɐwɔʋɑrkɐ
антропологія	ɐntrɔpɔɫɔɦʲijɐ
бруд	brud
авіадесантник	ɐʋʲiɐdesɑntnek
бонус	bɔnʊs
спілкування	sʲpʲiɫkʊʋɑnʲːɐ
патріотизм	pɐtʲrʲiɔtɪzm
новаторський	nɔʋɑtɔrsʲkei̯
неправди	neprɑu̯de
перський	pɛrsʲkei̯
дальше	dɑlʲʃe
кому	kɔmʊ
програмний	prɔɦrɑmnei̯
дзеркало	d͡zɛrkɐɫɔ
трансплантацій	trɐnspɫɐntɑt͡sʲii̯
коліно	kolʲinɔ
організація	ɔrɦɐnʲizɑt͡sʲijɐ
сучасник	sʊt͡ʃɑsnek
презирство	prezɪrstwɔ
підміна	pʲidʲmʲinɐ
палітурник	pɐlʲiturnek
праска	prɑskɐ
чоловіків	t͡ʃɔɫɔʋʲikʲiu̯
банан	bɐnɑn
асиміляція	ɐsemʲilʲɑt͡sʲijɐ
автомобіліст	ɐu̯tɔmɔbʲilʲist
дніпропетровськ	dʲnʲiprɔpetrɔu̯sʲk
профілактика	prɔfʲiɫɑktekɐ
біль	bʲilʲ
стремено	stremɛnɔ
здивування	zdewʊʋɑnʲːɐ
асистент	ɐsestɛnt
ліван	lʲiʋɑn
любий	lʲubei̯
віями	ʋʲijɐme
ремесло	remesɫɔ
школяр	ʃkɔlʲɑr
суцільний	sʊt͡sʲilʲnei̯
самовпевненість	sɐmɔu̯pɛu̯nenʲisʲtʲ
ендокринний	endɔkrɪnːei̯
словечку	sɫɔʋɛt͡ʃkʊ
запрошувати	zɐprɔʃʊʋɐte
баклажан	bɐkɫɐʒɑn
неспростовний	nesprɔstɔu̯nei̯
іграм	iɦrɐm
мовний	mɔu̯nei̯
ніхто	nʲixtɔ
інструкції	instrukt͡sʲiji
ради	rɑde
ковдра	kɔu̯drɐ
ганьбити	ɦɐnʲbɪte
падати	pɑdɐte
кремній	krɛmnʲii̯
ляльки	lʲɐlʲkɪ
жаль	ʒɑlʲ
скупий	skʊpɪi̯
ґринджоли	ɡrend͡ʒɔɫe
поселяти	pɔselʲɑte
панкреатит	pɐnkreɐtɪt
звідкись	zʲʋʲidkesʲ
конкурентоспроможність	kɔnkʊrentɔsprɔmɔʒnʲisʲtʲ
бонуси	bɔnʊse
сусід	sʊsʲid
візуалізація	ʋʲizʊɐlʲizɑt͡sʲijɐ
авлос	ɐu̯ɫɔs
чотирикутник	t͡ʃɔterekutnek
одношлюбний	ɔdnoʃlʲubnei̯
тхір	tʲxʲir
влаштувати	wɫɐʃtʊʋɑte
рукав	rʊkɑu̯
пересадка	peresɑdkɐ
зростання	zrɔstɑnʲːɐ
неухильний	neʊxɪlʲnei̯
стандартам	stɐndɑrtɐm
загреб	zɑɦreb
покарання	pɔkɐrɑnʲːɐ
дієвідміна	dʲijeʋʲidʲmʲinɐ
віддаль	ʋʲidːɐlʲ
приємність	prejɛmnʲisʲtʲ
активувати	ɐktewʊʋɑte
цілодобовий	t͡sʲiɫɔdɔbɔʋɪi̯
братів	brɑtʲiu̯
година	ɦɔdɪnɐ
вадою	ʋɑdɔjʊ
поглинути	pɔɦɫɪnʊte
мандрівник	mɐndʲrʲiu̯nɪk
рідкий	rʲidkɪi̯
така	tɐkɑ
ганяти	ɦɐnʲɑte
підозра	pʲidɔzrɐ
тетяна	tetʲɑnɐ
вітер	ʋʲiter
мінімаліст	mʲinʲimɐlʲist
зарплата	zɐrpɫɑtɐ
рот	rɔt
все	ʍsɛ
толерантний	tɔɫerɑntnei̯
дзюбенко	d͡zʲʊbɛnkɔ
плазун	pɫɐzun
молодицям	mɔɫɔdɪt͡sʲɐm
завдавати	zɐu̯dɐʋɑte
монохромний	mɔnɔxrɔmnei̯
несвідомий	nesʲʋʲidɔmei̯
вішати	ʋʲiʃɐte
брест	brɛst
саботажниця	sɐbɔtɑʒnet͡sʲɐ
архітектурний	ɐrxʲitekturnei̯
предмет	predmɛt
естонія	estɔnʲijɐ
шевчук	ʃeu̯t͡ʃuk
ув'язнювати	ʊʋjɑzʲnʲʊʋɐte
ґратар	ɡrɐtɑr
запросити	zɐprɔsɪte
залізняк	zɐlʲizʲnʲɑk
слова	sɫɔʋɑ
безсмертний	bezsmɛrtnei̯
гинути	ɦɪnʊte
ковбаси	kɔu̯bɑse
обідній	obʲidʲnʲii̯
гусениця	ɦusenet͡sʲɐ
кулак	kʊɫɑk
комплекс	kɔmpɫeks
придатний	predɑtnei̯
дивний	dɪu̯nei̯
лис	ɫɪs
пекар	pɛkɐr
циклічність	t͡seklʲit͡ʃnʲisʲtʲ
скандал	skɐndɑɫ
підсумок	pʲid͡zsumɔk
численний	t͡ʃesɫɛnːei̯
радіоактивний	rɑdʲiɔɐktɪu̯nei̯
хорватський	xɔrʋɑt͡sʲkei̯
недостатність	nedɔstɑtʲnʲisʲtʲ
попросити	pɔprɔsɪte
багно	bɐɦnɔ
ваші	ʋɑʃʲi
реалістичний	reɐlʲistɪt͡ʃnei̯
олівець	ɔlʲiʋɛt͡sʲ
могутній	moɦutʲnʲii̯
регулювати	reɦʊlʲʊʋɑte
спеціальність	spet͡sʲiɑlʲnʲisʲtʲ
гамбія	ɦɑmbʲijɐ
талією	tɑlʲijejʊ
сектор	sɛktɔr
перукар	perʊkɑr
невже	neu̯ʒɛ
кріп	krʲip
тією	tʲijɛjʊ
справою	sprɑwɔjʊ
запрограмувати	zɐprɔɦrɐmʊʋɑte
висновок	ʋɪsnɔwɔk
печивом	pɛt͡ʃewɔm
політеїст	pɔlʲitejist
картографія	kɐrtɔɦrɑfʲijɐ
сталевий	stɐɫɛʋei̯
гачек	ɦɑt͡ʃek
авіарейд	ɐʋʲiɐrɛi̯d
сон	sɔn
представник	pred͡zstɐu̯nɪk
бангладеш	bɐnɦɫɐdɛʃ
картка	kɑrtkɐ
ґрунтовий	ɡrʊntɔʋɪi̯
міський	mʲisʲkɪi̯
вмикати	wmekɑte
цап	t͡sɑp
драматургія	drɐmɐtʊrɦʲijɐ
катастрофами	kɐtɐstrɔfɐme
відважний	ʋʲidʋɑʒnei̯
дитячий	detʲɑt͡ʃei̯
просити	prɔsɪte
виборець	ʋɪbɔret͡sʲ
морозити	mɔrɔzete
бігти	bʲiɦte
євгенія	jeu̯ɦɛnʲijɐ
степ	stɛp
вертоліт	ʋertolʲit
спонукати	spɔnʊkɑte
ганьба	ɦɐnʲbɑ
григорій	ɦreɦɔrʲii̯
видимий	ʋɪdemei̯
зволожувати	zwɔɫɔʒʊʋɐte
наркозалежний	nɐrkɔzɐɫɛʒnei̯
клавіатуру	kɫɐʋʲiɐturʊ
засіб	zɑsʲib
креативний	kreɐtɪu̯nei̯
вія	ʋʲijɐ
окупація	ɔkʊpɑt͡sʲijɐ
одностатевий	ɔdnɔstɐtɛʋei̯
комісія	komʲisʲijɐ
пільга	pʲilʲɦɐ
шестигранний	ʃesteɦrɑnːei̯
небувалий	nebʊʋɑɫei̯
зауваження	zɐʊʋɑʒenʲːɐ
безліч	bɛzʲlʲit͡ʃ
потуга	potuɦɐ
сніп	sʲnʲip
ріпах	rʲipɐx
дефініцією	defʲinʲit͡sʲijejʊ
небіж	nɛbʲiʒ
самопроголошений	sɐmɔprɔɦɔɫɔʃenei̯
фракція	frɑkt͡sʲijɐ
довгота	dɔu̯ɦɔtɑ
оточення	ɔtɔt͡ʃenʲːɐ
листя	ɫɪsʲtʲɐ
портрет	pɔrtrɛt
чуття	t͡ʃʊtʲːɑ
тактовний	tɐktɔu̯nei̯
зізнатися	zʲiznɑtesʲɐ
абстракт	ɐbstrɑkt
македонія	mɐkedɔnʲijɐ
інквілін	inkʋʲilʲin
селянин	selʲɐnɪn
спонукати	sponukɐte
долоням	dɔɫɔnʲɐm
гідрологія	ɦʲidrɔɫɔɦʲijɐ
активізм	ɐkteʋʲizm
катастрофа	kɐtɐstrɔfɐ
вітальнею	ʋʲitɑlʲnejʊ
обрус	ɔbrʊs
насильство	nɐsɪlʲstwɔ
рукопис	rʊkɔpes
розпочати	rɔzpɔt͡ʃɑte
модернізація	mɔdernʲizɑt͡sʲijɐ
полум'я	pɔɫʊmjɐ
молоття	mɔɫɔtʲːɑ
гривнях	ɦrɪu̯nʲɐx
їжакевич	jiʒɐkɛʋet͡ʃ
робот	rɔbɔt
піраміда	pʲirɐmʲidɐ
програмувати	prɔɦrɐmʊʋɑte
вірити	ʋʲirete
геополітичний	ɦeɔpɔlʲitɪt͡ʃnei̯
цвях	t͡sʲʋʲɑx
лук	ɫuk
надлишок	nɐdɫɪʃɔk
субота	sʊbɔtɐ
вітальнях	ʋʲitɑlʲnʲɐx
назва	nɑzʋɐ
українськім	ʊkrɐjinsʲkʲim
приблизно	prebɫɪznɔ
делегацію	deɫeɦɑt͡sʲijʊ
потилицю	pɔtɪɫet͡sʲʊ
баня	bɑnʲɐ
полоти	pɔɫɔte
структурний	strʊkturnei̯
користь	kɔrɪsʲtʲ
зоставатися	zɔstɐʋɑtesʲɐ
пороховий	pɔrɔxɔʋɪi̯
паузу	pɑʊzʊ
допустимість	dɔpʊstɪmʲisʲtʲ
важкодоступний	ʋɐʒkɔdostupnei̯
календарний	kɐɫendɑrnei̯
відвернути	ʋʲidʋernute
повік	pɔʋʲik
вертіти	ʋertʲite
немилосердний	nemeɫɔsɛrdnei̯
бити	bɪte
успадкувати	ʊspɐdkʊʋɑte
багаторічний	bɐɦɐtorʲit͡ʃnei̯
авіапарк	ɐʋʲiɐpɑrk
катастрофи	kɐtɐstrɔfe
лекцією	ɫɛkt͡sʲijejʊ
поважати	pɔʋɐʒɑte
паузами	pɑʊzɐme
бережок	bereʒɔk
перевалювати	pereʋɑlʲʊʋɐte
сантиметр	sɐntemɛtr
композитор	kɔmpɔzɪtɔr
життя	ʒetʲːɑ
сербохорватський	serbɔxɔrʋɑt͡sʲkei̯
учасник	ʊt͡ʃɑsnek
єдиноріг	jedenorʲiɦ
чорногорський	t͡ʃɔrnɔɦɔrsʲkei̯
м'ясоїдний	mjɐsɔjidnei̯
авіафауна	ɐʋʲiɐfɑʊnɐ
вуглецевий	wʊɦɫet͡sɛʋei̯
зоровий	zɔrɔʋɪi̯
виправити	ʋɪprɐʋete
енергіями	enɛrɦʲijɐme
верховна	ʋerxɔu̯nɐ
кандидатура	kɐndedɐturɐ
затвердити	zɐtʋɛrdete
абітурієнтка	ɐbʲitʊrʲijɛntkɐ
колонізувати	kɔɫɔnʲizʊʋɑte
другом	druɦɔm
культура	kʊlʲturɐ
пародія	pɐrɔdʲijɐ
вагітний	ʋɐɦʲitnei̯
медичний	medɪt͡ʃnei̯
віталень	ʋʲitɑɫenʲ
київський	kɪjiu̯sʲkei̯
магній	mɑɦnʲii̯
станціями	stɑnʲt͡sʲijɐme
обладнувати	ɔbɫɑdnʊʋɐte
поступок	pɔstʊpɔk
інформувати	infɔrmʊʋɑte
заявляти	zɐjɐu̯lʲɑte
безпомічний	bezpɔmʲit͡ʃnei̯
вадами	ʋɑdɐme
автоматизувати	ɐu̯tɔmɐtezʊʋɑte
мітинг	mʲitenɦ
сардинка	sɐrdɪnkɐ
мізантроп	mʲizɐntrɔp
тигр	tɪɦr
рев	rɛu̯
речовина	ret͡ʃɔʋenɑ
рильцем	rɪlʲt͡sem
видання	ʋedɐnʲːɑ
сукням	suknʲɐm
розбиратися	rɔzberɑtesʲɐ
нестабільний	nestɐbʲilʲnei̯
споживачів	spɔʒeʋɐt͡ʃʲiu̯
гуртожиток	ɦʊrtɔʒetɔk
пархоменко	pɐrxɔmenkɔ
схвалювати	sxʋɑlʲʊʋɐte
відсутність	ʋʲid͡zsutʲnʲisʲtʲ
годинник	ɦɔdɪnːek
селище	seɫɪʃt͡ʃe
галасливий	ɦɐɫɐsɫɪʋei̯
кондитер	kɔndɪter
переоцінювати	pereot͡sʲinʲʊʋɐte
аутизм	ɐʊtɪzm
терплячість	terplʲɑt͡ʃʲisʲtʲ
забути	zɐbute
споживача	spɔʒeʋɐt͡ʃɑ
маршрути	mɐrʃrute
німець	nʲimet͡sʲ
жити	ʒɪte
індекс	indeks
жоден	ʒɔden
слов'янами	sɫɔʋjɑnɐme
більш	bʲilʲʃ
сексуально	seksʊɑlʲnɔ
прага	prɑɦɐ
антропологічний	ɐntrɔpɔɫoɦʲit͡ʃnei̯
інноваційний	inːɔʋɐt͡sʲii̯nei̯
більшати	bʲilʲʃɐte
рельєфний	relʲjɛfnei̯
поезія	pɔɛzʲijɐ
рахунок	rɐxunɔk
таємниці	tɐjemnɪt͡sʲi
груба	ɦrubɐ
подробицею	pɔdrɔbet͡sejʊ
правило	prɑʋeɫɔ
переважати	pereʋɐʒɑte
білолиций	bʲiɫɔɫɪt͡sei̯
зацікавити	zɐt͡sʲikɑʋete
саботажник	sɐbɔtɑʒnek
очерет	ɔt͡ʃerɛt
таїландський	tɐjiɫɑnd͡zʲsʲkei̯
гібридний	ɦʲibrɪdnei̯
валентина	ʋɐɫentɪnɐ
смола	smɔɫɑ
романтичний	rɔmɐntɪt͡ʃnei̯
покласти	pɔkɫɑste
узаконити	ʊzɐkɔnete
ексклюзивний	eksklʲʊzɪu̯nei̯
навичка	nɑʋet͡ʃkɐ
алюміній	ɐlʲʊmʲinʲii̯
відвідати	ʋʲidʲʋʲidɐte
вибратися	ʋɪbrɐtesʲɐ
необґрунтований	ɔbɡrʊntɔʋɐnei̯
звук	zwuk
щиколотками	ʃt͡ʃɪkɔɫɔtkɐme
шибеницям	ʃɪbenet͡sʲɐm
згодний	zɦɔdnei̯
розібрати	rɔzʲibrɑte
рішення	rʲiʃenʲːɐ
унеможливити	ʊnemɔʒɫɪʋete
соус	sɔʊs
вижлоктати	ʋɪʒɫɔktɐte
також	tɑkɔʒ
дієприкметник	dʲijeprekmɛtnek
його	jɔɦɔ
панпсихізм	pɐnpsexʲizm
вівтарний	ʋʲiu̯tɑrnei̯
бувати	bʊʋɑte
корупція	korupt͡sʲijɐ
зрости	zrɔstɪ
діри	dʲire
джгут	d͡ʒɦut
робітниця	rɔbʲitnɪt͡sʲɐ
дитинство	detɪnstwɔ
вчорашній	ʍt͡ʃɔrɑʃnʲii̯
надавати	nɐdɐʋɑte
рильцям	rɪlʲt͡sʲɐm
корабел	kɔrɐbɛɫ
стехіометрія	stexʲiɔmɛtʲrʲijɐ
хрущ	xruʃt͡ʃ
інсталятор	instɐlʲɑtɔr
нетерпіння	terpʲinʲːɐ
отже	ɔdʒe
тепло	tepɫɔ
хрест	xrɛst
гігантський	ɦʲiɦɑnʲsʲkei̯
популярність	pɔpʊlʲɑrnʲisʲtʲ
мазь	mɑzʲ
самодостатньо	sɐmɔdɔstɑtʲnʲɔ
збагачувати	zbɐɦɑt͡ʃʊʋɐte
галина	ɦɐɫɪnɐ
суржик	surʒek
каса	kɑsɐ
нарід	nɑrʲid
містити	mʲistɪte
європейський	jeu̯rɔpɛi̯sʲkei̯
ртуть	rtutʲ
спрямовувати	sprʲɐmɔwʊʋɐte
іржавий	irʒɑʋei̯
існувати	isnʊʋɑte
палтус	pɑɫtʊs
бісексуал	bʲiseksʊɑɫ
вид	ʋɪd
тесля	tɛsʲlʲɐ
вівса	ʋʲiu̯sɑ
відвідувач	ʋʲidʲʋʲidʊʋɐt͡ʃ
боліти	bolʲite
лінійний	lʲinʲii̯nei̯
мусульманин	mʊsʊlʲmɑnen
мандрувати	mɐndrʊʋɑte
равлик	rɑu̯ɫek
горілок	ɦorʲiɫɔk
вина	ʋɪnɐ
бере	berɛ
молочний	mɔɫɔt͡ʃnei̯
вислів	ʋɪsʲlʲiu̯
ненависний	nenɑʋesnei̯
кореспондентка	kɔrespɔndɛntkɐ
заздрість	zɑzdʲrʲisʲtʲ
зубенко	zʊbɛnkɔ
немовля	nemɔu̯lʲɑ
дихання	dexɑnʲːɐ
лібералізувати	lʲiberɐlʲizʊʋɑte
горизонтом	ɦɔrezɔntɔm
веселий	ʋesɛɫei̯
легший	ɫɛɦʃei̯
суперництво	sʊpɛrnet͡stwɔ
розкіш	rɔzʲkʲiʃ
ліворуч	lʲiwɔrʊt͡ʃ
сучасниця	sʊt͡ʃɑsnet͡sʲɐ
монумент	mɔnʊmɛnt
біженець	bʲiʒenet͡sʲ
задоволений	zɐdɔwɔɫenei̯
підприємство	pʲidprejɛmstwɔ
дисертація	desertɑt͡sʲijɐ
героїчний	ɦerɔjit͡ʃnei̯
промокати	prɔmɔkɑte
люба	lʲubɐ
вивільга	ʋɪʋʲilʲɦɐ
застуди	zɐstude
роса	rɔsɑ
він	ʋʲin
посада	pɔsɑdɐ
конкурс	kɔnkʊrs
кімната	kʲimnɑtɐ
популяція	pɔpʊlʲɑt͡sʲijɐ
календарі	kɐɫendɐrʲi
брамі	brɑmʲi
подивитися	pɔdeʋɪtesʲɐ
затримуватися	zɐtrɪmʊʋɐtesʲɐ
пригорщ	prɪɦɔrʃt͡ʃ
сестрицями	sestrɪt͡sʲɐme
куркуль	kʊrkulʲ
престол	prestɔɫ
поліціях	polʲit͡sʲijɐx
мілкий	mʲiɫkɪi̯
планета	pɫɐnɛtɐ
природному	prerɔdnɔmʊ
ревнощі	rɛu̯nɔʃt͡ʃʲi
фольга	fɔlʲɦɐ
самоврядування	sɐmɔu̯rʲɐdʊʋɑnʲːɐ
перехід	perexʲid
намір	nɑmʲir
перо	perɔ
занепокоєння	zɐnepɔkɔjenʲːɐ
себе	sebɛ
виборові	ʋɪbɔrɔʋʲi
словниках	sɫɔu̯nekɑx
офіціант	ɔfʲit͡sʲiɑnt
автоген	ɐu̯tɔɦɛn
стежити	stɛʒete
вирішувати	ʋerʲiʃʊʋɐte
судноплавство	sʊdnɔpɫɑu̯stwɔ
проголошувати	prɔɦɔɫɔʃʊʋɐte
розвивати	rɔzʋeʋɑte
медалей	medɑɫei̯
тотальний	tɔtɑlʲnei̯
держав	derʒɑu̯
кишене	keʃɛne
артишок	ɐrteʃɔk
петро	petrɔ
абразив	ɐbrɐzɪu̯
талії	tɑlʲiji
авіаобробка	ɐʋʲiɐɔbrɔbkɐ
ґрунтик	ɡruntek
мудрий	mudrei̯
свість	sʲʋʲisʲtʲ
аріка	ɐrʲikɐ
клясти	klʲɑste
жасмин	ʒɐsmɪn
провокативний	prɔwɔkɐtɪu̯nei̯
чорнобиль	t͡ʃɔrnɔbelʲ
авангардизм	ɐʋɐnɦɐrdɪzm
гладіаторський	ɦɫɐdʲiɑtɔrsʲkei̯
мінімалізм	mʲinʲimɐlʲizm
кишенькові	keʃenʲkɔʋʲi
продавець	prɔdɐʋɛt͡sʲ
абат	ɐbɑt
добуток	dɔbʊtɔk
нападник	nɐpɑdnek
литовський	ɫetɔu̯sʲkei̯
алфавіт	ɐɫfɐʋʲit
затримати	zɐtrɪmɐte
законодавчий	zɐkɔnɔdɑu̯t͡ʃei̯
урожай	ʊrɔʒɑi̯
крутий	krʊtɪi̯
пласт	pɫɑst
математика	mɐtemɑtekɐ
талію	tɑlʲijʊ
публікація	pʊblʲikɑt͡sʲijɐ
капелюх	kɐpelʲux
поступкою	pɔstʊpkɔjʊ
капіталізм	kɐpʲitɐlʲizm
відчути	ʋʲid͡ʒt͡ʃute
стіл	sʲtʲiɫ
агнеса	ɐɦnɛsɐ
неофіційний	neɔfʲit͡sʲii̯nei̯
голубий	ɦɔɫʊbɪi̯
оглянути	ɔɦlʲɑnʊte
спостерігачка	spɔsterʲiɦɑt͡ʃkɐ
сидіти	sedʲite
оригінальний	ɔreɦʲinɑlʲnei̯
шістнадцятий	ʃʲistnɑd͡zʲt͡sʲɐtei̯
авіахім	ɐʋʲiɐxʲim
лице	ɫet͡sɛ
якийсь	jɐkɪi̯sʲ
намокнути	nɐmɔknʊte
аналітик	ɐnɐlʲitek
багатолітній	bɐɦɐtolʲitʲnʲii̯
життєздатний	ʒetʲːezdɑtnei̯
інтенсифікація	intensefʲikɑt͡sʲijɐ
голосний	ɦɔɫɔsnɪi̯
авіація	ɐʋʲiɑt͡sʲijɐ
федорович	fedɔrɔʋet͡ʃ
організацією	ɔrɦɐnʲizɑt͡sʲijejʊ
афіша	ɐfʲiʃɐ
орбітою	orbʲitɔjʊ
небіж	nebʲiʒ
обмеженням	ɔbmɛʒenʲːɐm
портрети	pɔrtrɛte
винороб	ʋenɔrɔb
уста	ʊstɑ
інцидентами	int͡sedɛntɐme
товаришка	tɔʋɑreʃkɐ
лапша	ɫɐpʃɑ
трудовий	trʊdɔʋɪi̯
української	ʊkrɐjinʲsʲkɔji
окупант	ɔkʊpɑnt
смертельної	smertɛlʲnɔji
напам'ять	nɐpɑmjɐtʲ
золотий	zɔɫɔtɪi̯
без	bɛz
першість	pɛrʃʲisʲtʲ
синок	senɔk
берестя	berɛsʲtʲɐ
парадоксальний	pɐrɐdɔksɑlʲnei̯
кошт	kɔʃt
гординя	ɦɔrdɪnʲɐ
покарань	pɔkɐrɑnʲ
венами	ʋɛnɐme
скловидний	skɫɔʋɪdnei̯
твітнути	tʲʋʲitnʊte
поле	pɔɫe
паламар	pɐɫɐmɑr
збір	zʲbʲir
показник	pɔkɑznek
гель	ɦɛlʲ
знизити	znɪzete
ладо	ɫɑdɔ
григоріанського	ɦreɦɔrʲiɑnʲsʲkɔɦɔ
ароматичний	ɐrɔmɐtɪt͡ʃnei̯
розгромлювати	rɔzɦrɔmlʲʊʋɐte
молодиці	mɔɫɔdɪt͡sʲi
оден	ɔdɛn
меншість	mɛnʲʃʲisʲtʲ
болючий	bolʲut͡ʃei̯
мешканець	mɛʃkɐnet͡sʲ
спорожнити	spɔrɔʒnɪte
центральний	t͡sentrɑlʲnei̯
фрагмент	frɐɦmɛnt
лунь	ɫunʲ
вирок	ʋerɔk
патріотизмом	pɐtʲrʲiɔtɪzmɔm
перевищити	pereʋɪʃt͡ʃete
шевченко	ʃeu̯t͡ʃɛnkɔ
заглядати	zɐɦlʲɐdɑte
викоренити	ʋɪkɔrenete
повечеряти	pɔʋet͡ʃɛrʲɐte
вену	ʋɛnʊ
поцілунок	pɔt͡sʲiɫunɔk
проголосувати	prɔɦɔɫɔsʊʋɑte
кишеням	keʃɛnʲɐm
текстовий	tekstɔʋɪi̯
картина	kɐrtɪnɐ
сніданок	sʲnʲidɑnɔk
вигук	ʋɪɦʊk
пропорціях	prɔpɔrt͡sʲijɐx
шиєю	ʃɪjejʊ
експертний	ekspɛrtnei̯
трубопровід	trʊbɔprɔʋʲid
екстаз	ekstɑz
потилицями	pɔtɪɫet͡sʲɐme
навмання	nɐu̯mɐnʲːɑ
коли	kɔɫɪ
поставка	pɔstɑu̯kɐ
овочевий	ɔwɔt͡ʃɛʋei̯
цьому	t͡sʲomu
черв'як	t͡ʃerʋjɑk
несвідоме	nesʲʋʲidɔme
покупка	pokupkɐ
дивак	deʋɑk
жених	ʒenɪx
уточнити	ʊtɔt͡ʃnɪte
турнікет	tʊrnʲikɛt
галушка	ɦɐɫuʃkɐ
двомовний	dwɔmɔu̯nei̯
прямокутний	prʲɐmokutnei̯
вбивство	wbɪu̯stwɔ
карта	kɑrtɐ
тлумач	tɫʊmɑt͡ʃ
арахнологією	ɐrɐxnɔɫɔɦʲijejʊ
канадський	kɐnɑd͡zʲsʲkei̯
києву	kɪjewʊ
гривнею	ɦrɪu̯nejʊ
називний	nɐzeu̯nɪi̯
талій	tɑlʲii̯
філософ	fʲiɫɔsɔf
реалізм	reɐlʲizm
втілити	ʍtʲiɫete
міністр	mʲinʲistr
гарбуз	ɦɐrbuz
бувайте	bʊʋɑi̯te
перекладачка	perekɫɐdɑt͡ʃkɐ
експедиціям	ekspedɪt͡sʲijɐm
антибіотику	ɐntebʲiɔtekʊ
омбудсмен	ɔmbʊd͡zsmɛn
нахил	nɑxeɫ
безбородий	bezbɔrɔdei̯
одномовний	ɔdnɔmɔu̯nei̯
законодавиця	zɐkɔnɔdɑʋet͡sʲɐ
мексиканець	meksekɑnet͡sʲ
уживати	ʊʒeʋɑte
двомовність	dwɔmɔu̯nʲisʲtʲ
наскрізь	nɑskrʲizʲ
парник	pɐrnɪk
шостий	ʃɔstei̯
рідний	rʲidnei̯
попереджати	pɔpered͡ʒɑte
навчальний	nɐu̯t͡ʃɑlʲnei̯
дисфункція	desfunkt͡sʲijɐ
слабкий	sɫɐbkɪi̯
корити	kɔrɪte
засновниці	zɐsnɔu̯net͡sʲi
взаємодіяння	wzɐjemodʲijɐnʲːɐ
фарба	fɑrbɐ
тестувати	testʊʋɑte
аварійний	ɐʋɐrʲii̯nei̯
вродливіший	wrɔdɫɪʋʲiʃei̯
тіні	tʲinʲi
відстрочити	ʋʲid͡zstrɔt͡ʃete
шкідливий	ʃkʲidɫɪʋei̯
епітет	epʲitet
щелепа	ʃt͡ʃɛɫepɐ
клінічний	klʲinʲit͡ʃnei̯
страхування	strɐxʊʋɑnʲːɐ
клей	kɫɛi̯
наймит	nɑi̯met
кредит	krɛdet
уточнювати	ʊtɔt͡ʃnʲʊʋɐte
абсолютність	ɐbsolʲutʲnʲisʲtʲ
нерішучість	nerʲiʃut͡ʃʲisʲtʲ
варіанті	ʋɐrʲiɑnʲtʲi
вікіпедія	ʋʲikʲipɛdʲijɐ
фестиваль	festeʋɑlʲ
пекти	pektɪ
піст	pʲist
а	ɑ
урок	urɔk
інцидентові	int͡sedɛntɔʋʲi
еміграційний	emʲiɦrɐt͡sʲii̯nei̯
нейробіологія	nɛi̯rɔbʲiɔɫɔɦʲijɐ
кінці	kʲinʲt͡sʲi
беззахисний	bezːɑxesnei̯
власті	wɫɑsʲtʲi
політик	polʲitek
гуманіст	ɦʊmɐnʲist
надзвуковий	nɐd͡zwʊkɔʋɪi̯
десерти	desɛrte
субтитри	sʊbtɪtre
співбесідниця	sʲpʲiu̯besʲidnet͡sʲɐ
агресивність	ɐɦresɪu̯nʲisʲtʲ
петицій	petɪt͡sʲii̯
заміняти	zɐmʲinʲɑte
єзуч	jɛzʊt͡ʃ
тезис	tɛzes
скроне	skrɔne
археологічний	ɐrxeɔɫoɦʲit͡ʃnei̯
топографічний	tɔpɔɦrɐfʲit͡ʃnei̯
емоцією	emɔt͡sʲijejʊ
святковий	sʲʋʲɐtkɔʋei̯
портфелями	pɔrtfɛlʲɐme
емоціях	emɔt͡sʲijɐx
раритет	rɐretɛt
гроза	ɦrɔzɑ
говіркий	ɦɔʋʲirkɪi̯
працівницям	prɐt͡sʲiu̯nɪt͡sʲɐm
запозичення	zɐpɔzɪt͡ʃenʲːɐ
органи	ɔrɦɑne
компенсація	kɔmpensɑt͡sʲijɐ
солодкий	sɔɫɔdkei̯
допомогти	dɔpɔmɔɦtɪ
сад	sɑd
маскат	mɐskɑt
фальсифікування	fɐlʲsefʲikʊʋɑnʲːɐ
маріїн	mɐrʲijin
мобільний	mobʲilʲnei̯
числівник	t͡ʃesʲlʲiu̯nek
візантія	ʋʲizɑnʲtʲijɐ
дефініціям	defʲinʲit͡sʲijɐm
рай	rɑi̯
умовний	ʊmɔu̯nei̯
абрек	ɐbrɛk
антибіотики	ɐntebʲiɔteke
інструкцій	instrukt͡sʲii̯
жупан	ʒʊpɑn
консалтинг	kɔnsɑɫtenɦ
ґречний	ɡrɛt͡ʃnei̯
врятувати	wrʲɐtʊʋɑte
замовлення	zɐmɔu̯ɫenʲːɐ
іпотека	ipɔtɛkɐ
барза	bɑrzɐ
доконаний	dɔkɔnɐnei̯
раціє	rɑt͡sʲije
недільний	nedʲilʲnei̯
невідповідний	neʋʲidpɔʋʲidnei̯
зір	zʲir
останній	ɔstɑnʲːii̯
свідчити	sʲʋʲid͡ʒt͡ʃete
мастурбація	mɐstʊrbɑt͡sʲijɐ
українські	ʊkrɐjinsʲkʲi
летовище	ɫetɔʋeʃt͡ʃe
самоцвіт	sɐmɔt͡sʲʋʲit
росія	rosʲijɐ
доброзичливиця	dɔbrɔzet͡ʃɫɪʋet͡sʲɐ
пляма	plʲɑmɐ
синтаксичний	sentɐksɪt͡ʃnei̯
штормовий	ʃtɔrmɔʋɪi̯
мурашка	mʊrɑʃkɐ
приманити	premɐnɪte
інструкціям	instrukt͡sʲijɐm
міжзоряне	mʲiʒzɔrʲɐne
порекомендувати	pɔrekɔmendʊʋɑte
прозорість	prɔzɔrʲisʲtʲ
воротар	wɔrɔtɑr
двері	dʋɛrʲi
оштрафувати	ɔʃtrɐfʊʋɑte
перевалити	pereʋɐɫɪte
житній	ʒɪtʲnʲii̯
діяння	dʲijɑnʲːɐ
індивідуально	indeʋʲidʊɑlʲnɔ
розрізняти	rɔzʲrʲizʲnʲɑte
скромний	skrɔmnei̯
ад'єктивація	ɐdjekteʋɑt͡sʲijɐ
стильний	stɪlʲnei̯
південь	pʲiu̯denʲ
розум	rɔzʊm
слов'янинові	sɫɔʋjɐnɪnɔʋʲi
спір	sʲpʲir
бурмило	bʊrmɪɫɔ
великий	ʋeɫɪkei̯
омела	ɔmɛɫɐ
відобразити	ʋʲidɔbrɐzɪte
україна	ʊkrɑjinɐ
альтернативний	ɐlʲternɐtɪu̯nei̯
дефініціях	defʲinʲit͡sʲijɐx
розвиток	rɔzʋetɔk
абрикосівка	ɐbrekɔsʲiu̯kɐ
тарілка	tɐrʲiɫkɐ
опариш	ɔpɑreʃ
занотувати	zɐnɔtʊʋɑte
інвестиційний	inʋestet͡sʲii̯nei̯
гуся	ɦʊsʲɑ
барвінок	bɐrʋʲinɔk
мрією	mrʲijejʊ
європа	jeu̯rɔpɐ
гарантувати	ɦɐrɐntʊʋɑte
гавкати	ɦɑu̯kɐte
попередження	pɔperɛd͡ʒenʲːɐ
населяти	nɐselʲɑte
дослідник	dosʲlʲidnek
скерувати	skerʊʋɑte
критерієві	kretɛrʲijeʋʲi
випускати	ʋepʊskɑte
закордонний	zɐkɔrdɔnːei̯
довг	dɔu̯ɦ
катастрофі	kɐtɐstrɔfʲi
для	dʲlʲɑ
публічно	pʊblʲit͡ʃnɔ
вибором	ʋɪbɔrɔm
ними	nɪme
шляхетний	ʃlʲɐxɛtnei̯
економіст	ekɔnomʲist
захворювати	zɐxwɔrʲʊʋɐte
дехто	dɛxtɔ
змінюватися	zʲmʲinʲʊʋɐtesʲɐ
поспати	pɔspɑte
абіссінка	ɐbʲisʲːinkɐ
грати	ɦrɑte
назавше	nɐzɑu̯ʃe
сімдесят	sʲimdesʲɑt
фінка	fʲinkɐ
чинник	t͡ʃɪnːek
працівницю	prɐt͡sʲiu̯nɪt͡sʲʊ
деклараціях	dekɫɐrɑt͡sʲijɐx
критичний	kretɪt͡ʃnei̯
постаттю	pɔstɐtʲːʊ
шістдесят	ʃʲizdesʲɑt
дошкою	dɔʃkɔjʊ
місія	mʲisʲijɐ
свербіж	sʋerbʲiʒ
божевільний	bɔʒeʋʲilʲnei̯
крило	kreɫɔ
природознавство	prerɔdɔznɑu̯stwɔ
іншого	inʃɔɦɔ
принц	prɪnt͡s
брехень	brɛxenʲ
зміняти	zʲmʲinʲɑte
приватизація	preʋɐtezɑt͡sʲijɐ
вирощувати	ʋerɔʃt͡ʃʊʋɐte
наприкінці	nɐprɪkʲinʲt͡sʲi
щирі	ʃt͡ʃɪrʲi
ефективність	efektɪu̯nʲisʲtʲ
індустрія	industʲrʲijɐ
ожина	ɔʒɪnɐ
наймичка	nɑi̯met͡ʃkɐ
мізерний	mʲizernei̯
зазначити	zɐznɑt͡ʃete
єврей	jeu̯rɛi̯
зараз	zɐrɑz
задовольняти	zɐdɔwɔlʲnʲɑte
заробітний	zɐrobʲitnei̯
сура	surɐ
організації	ɔrɦɐnʲizɑt͡sʲiji
снігопад	sʲnʲiɦɔpɑd
утрату	ʊtrɑtʊ
крихта	krɪxtɐ
вільнодумець	ʋʲilʲnodumet͡sʲ
патина	pɐtɪnɐ
друге	druɦe
вираження	ʋɪrɐʒenʲːɐ
червоний	t͡ʃerwɔnei̯
душа	dʊʃɑ
автомобіль	ɐu̯tɔmobʲilʲ
бидло	bɪdɫɔ
набряк	nɑbrʲɐk
прелат	preɫɑt
довгоніжка	dɔu̯ɦonʲiʒkɐ
понести	pɔnestɪ
запропонувати	zɐprɔpɔnʊʋɑte
демілітаризація	demʲilʲitɐrezɑt͡sʲijɐ
некультурний	nekʊlʲturnei̯
пересічний	peresʲit͡ʃnei̯
коала	kɔɑɫɐ
законодавець	zɐkɔnɔdɑʋet͡sʲ
дурість	durʲisʲtʲ
концентрація	kɔnt͡sentrɑt͡sʲijɐ
німецькомовний	nʲimet͡sʲkɔmɔu̯nei̯
безчесний	beʒt͡ʃɛsnei̯
фрагмента	frɐɦmɛntɐ
заручити	zɐrʊt͡ʃɪte
прискорювати	preskɔrʲʊʋɐte
племінник	pɫemʲinːek
конфесія	kɔnfɛsʲijɐ
іванова	iʋɐnɔʋɐ
момент	mɔmɛnt
слідство	sʲlʲid͡zstwɔ
порядок	pɔrʲɑdɔk
менеджер	mɛned͡ʒer
вибирати	ʋeberɑte
слухати	sɫuxɐte
запобігати	zɐpɔbʲiɦɑte
поліглот	pɔlʲiɦɫɔt
початковий	pɔt͡ʃɐtkɔʋei̯
привітний	preʋʲitnei̯
поліція	polʲit͡sʲijɐ
безжалісний	beʒːɑlʲisnei̯
алкоголь	ɐɫkɔɦɔlʲ
серенада	serenɑdɐ
доросла	dɔrɔsɫɐ
зустріти	zʊstʲrʲite
жало	ʒɑɫɔ
вероніка	ʋeronʲikɐ
надіям	nɐdʲijɐm
лавандовий	ɫɐʋɑndɔʋei̯
хороший	xɔrɔʃei̯
особистість	ɔsɔbɪsʲtʲisʲtʲ
піранья	pʲirɑnʲjɐ
полк	pɔɫk
дощовий	dɔʃt͡ʃɔʋɪi̯
козачий	kɔzɑt͡ʃei̯
багатокутник	bɐɦɐtokutnek
повінь	pɔʋʲinʲ
сфер	sfɛr
автогемотерапія	ɐu̯tɔɦemɔterɐpʲijɐ
перетворювати	peretwɔrʲʊʋɐte
шмата	ʃmɑtɐ
товстий	tɔu̯stɪi̯
лекціє	ɫɛkt͡sʲije
природничі	prerɔdnɪt͡ʃʲi
дякувати	dʲɑkʊʋɐte
чудище	t͡ʃudeʃt͡ʃe
авіагоризонт	ɐʋʲiɐɦɔrezɔnt
гривень	ɦrɪʋenʲ
робочий	rɔbɔt͡ʃei̯
ластівка	ɫɑsʲtʲiu̯kɐ
недорозвинений	nedɔrɔzʋɪnenei̯
слабий	sɫɐbɪi̯
сфера	sfɛrɐ
незадоволений	nezɐdɔwɔɫenei̯
журналіст	ʒʊrnɐlʲist
нього	nʲɔɦɔ
статус	stɑtʊs
житіє	ʒetʲijɛ
референдумами	referɛndʊmɐme
скеровувати	skerɔwʊʋɐte
пандемія	pɐndemʲijɐ
цілувати	t͡sʲiɫʊʋɑte
страхувань	strɐxʊʋɑnʲ
абракадабра	ɐbrɐkɐdɑbrɐ
уможливлювати	ʊmɔʒɫɪu̯lʲʊʋɐte
російська	rosʲii̯sʲkɐ
асортимент	ɐsɔrtemɛnt
буря	burʲɐ
палець	pɑɫet͡sʲ
лапа	ɫɑpɐ
красний	krɑsnei̯
подзвонити	pɔd͡zwɔnɪte
цех	t͡sɛx
міграційний	mʲiɦrɐt͡sʲii̯nei̯
кіш	kʲiʃ
мілина	mʲiɫenɑ
плач	pɫɑt͡ʃ
авеню	ɐʋenʲu
цигарок	t͡seɦɑrɔk
паузи	pɑʊze
мотоциклів	mɔtɔt͡sɪklʲiu̯
копил	kɔpɪɫ
обеззброювати	ɔbezːbrɔjʊʋɐte
жахливий	ʒɐxɫɪʋei̯
споруда	sporudɐ
маска	mɑskɐ
поширювати	pɔʃɪrʲʊʋɐte
україномовний	ʊkrɐjinɔmɔu̯nei̯
поганяти	pɔɦɐnʲɑte
конструкція	konstrukt͡sʲijɐ
дизайнер	dezɑi̯ner
літати	lʲitɑte
дефіс	defʲis
стосовно	stɔsɔu̯nɔ
терпіти	terpʲite
щирий	ʃt͡ʃɪrei̯
печиво	pɛt͡ʃewɔ
кубинець	kʊbɪnet͡sʲ
житель	ʒɪtelʲ
виборчий	ʋɪbɔrt͡ʃei̯
навіть	nɑʋʲitʲ
оптимальний	ɔptemɑlʲnei̯
шибеницями	ʃɪbenet͡sʲɐme
дивізіях	deʋʲizʲijɐx
пов'язувати	pɔʋjɑzʊʋɐte
геном	ɦɛnɔm
повідомляти	pɔʋʲidɔmlʲɑte
сильно	sɪlʲnɔ
прогноз	prɔɦnɔz
рада	rɑdɐ
горілки	ɦɔrʲiɫkɪ
постулат	pɔstʊɫɑt
копійка	kopʲii̯kɐ
тримати	tremɑte
самокат	sɐmɔkɑt
спростити	sprɔstɪte
парижанка	pɐreʒɑnkɐ
оповідання	ɔpɔʋʲidɑnʲːɐ
положення	pɔɫɔʒenʲːɐ
пизда	pezdɑ
вугол	wuɦɔɫ
абузус	ɐbuzʊs
конотіп	kɔnotʲip
досконалий	dɔskɔnɑɫei̯
біженка	bʲiʒenkɐ
чоловіка	t͡ʃɔɫɔʋʲikɐ
перспектива	perspektɪʋɐ
барліг	bɐrlʲiɦ
радикальний	rɐdekɑlʲnei̯
принести	prenestɪ
копати	kɔpɑte
забезпечення	zɐbezpɛt͡ʃenʲːɐ
слов'янка	sɫɔʋjɑnkɐ
щоки	ʃt͡ʃɔkɪ
талант	tɐɫɑnt
путівник	pʊtʲiu̯nɪk
працівниками	prɐt͡sʲiu̯nekɑme
старомодний	stɐrɔmɔdnei̯
нормальний	nɔrmɑlʲnei̯
конкурувати	kɔnkʊrʊʋɑte
вихідних	ʋexʲidnɪx
світлий	sʲʋʲitɫei̯
католицький	kɐtɔɫɪt͡sʲkei̯
азербайджан	ɐzerbɐi̯d͡ʒɑn
войовничий	wɔjɔu̯nɪt͡ʃei̯
мешкати	mɛʃkɐte
хозар	xɔzɑr
зрештою	zrɛʃtɔjʊ
теорія	teɔrʲijɐ
знижень	znɪʒenʲ
антитіло	ɐntetʲiɫɔ
багатолюдний	bɐɦɐtolʲudnei̯
радий	rɑdei̯
зупинка	zʊpɪnkɐ
ранок	rɑnɔk
аероліт	ɐerolʲit
страшний	strɐʃnɪi̯
одноплемінник	ɔdnɔpɫemʲinːek
партія	pɑrtʲijɐ
надіями	nɐdʲijɐme
дим	dɪm
матися	mɑtesʲɐ
дошками	dɔʃkɐme
розробити	rɔzrɔbɪte
передвоєнний	peredwɔjɛnːei̯
садовий	sɐdɔʋei̯
заслуговувати	zɐsɫʊɦɔwʊʋɐte
братерський	brɐtɛrsʲkei̯
англіканство	ɐnɦlʲikɑnstwɔ
навруз	nɐu̯ruz
зробити	zrɔbɪte
козел	kɔzɛɫ
включити	ʍklʲʊt͡ʃɪte
соціалізм	sɔt͡sʲiɐlʲizm
скандинавський	skɐndenɑu̯sʲkei̯
аванзал	ɐʋɐnzɑɫ
митний	mɪtnei̯
маківочка	mɑkʲiwɔt͡ʃkɐ
аби	ɐbɪ
дупа	dupɐ
дозволити	dɔzwɔɫete
капуста	kɐpustɐ
духовний	dʊxɔu̯nei̯
доторкатися	dɔtɔrkɑtesʲɐ
хірургічний	xʲirʊrɦʲit͡ʃnei̯
албанія	ɐɫbɑnʲijɐ
незнання	neznɐnʲːɑ
суперник	sʊpɛrnek
кайман	kɐi̯mɑn
шоколад	ʃɔkɔɫɑd
урбанізувати	ʊrbɐnʲizʊʋɑte
ускладнювати	ʊskɫɑdʲnʲʊʋɐte
ходити	xɔdɪte
чужий	t͡ʃʊʒɪi̯
суглоб	sʊɦɫɔb
паморозь	pɑmɔrɔzʲ
речі	rɛt͡ʃʲi
працівницях	prɐt͡sʲiu̯nɪt͡sʲɐx
плуг	pɫuɦ
кинути	kɪnʊte
розпродавати	rɔzprɔdɐʋɑte
чоловіку	t͡ʃɔɫɔʋʲikʊ
варіанти	ʋɐrʲiɑnte
несумісність	nesʊmʲisʲnʲisʲtʲ
згоден	zɦɔden
автобусна	ɐu̯tɔbʊsnɐ
батько	bɑtʲkɔ
декларувати	dekɫɐrʊʋɑte
віртуальний	ʋʲirtʊɑlʲnei̯
автобіографія	ɐu̯tɔbʲiɔɦrɑfʲijɐ
горе	ɦɔre
садів	sɐdʲiu̯
спека	spɛkɐ
лондоні	ɫɔndɔnʲi
купити	kʊpɪte
фіксація	fʲiksɑt͡sʲijɐ
терен	tɛren
технократія	texnɔkrɑtʲijɐ
сценарій	st͡senɑrʲii̯
вісімдесят	ʋʲisʲimdesʲɑt
лік	lʲik
олександр	ɔɫeksɑndr
благий	bɫɐɦɪi̯
діалект	dʲiɐɫɛkt
радниця	rɑdnet͡sʲɐ
аваль	ɐʋɑlʲ
подовження	pɔdɔu̯ʒenʲːɐ
пінцет	pʲint͡sɛt
вакцинувати	ʋɐkt͡senʊʋɑte
ужгород	uʒɦɔrɔd
акціонер	ɐkt͡sʲiɔnɛr
глобус	ɦɫɔbʊs
глаголиця	ɦɫɐɦɔɫet͡sʲɐ
абхазка	ɐbxɑzkɐ
пазл	pɑzɫ
джерело	d͡ʒereɫɔ
зазнати	zɐznɑte
ґирлиґа	ɡerɫɪɡɐ
товар	tɔʋɑr
авантитул	ɐʋɐntɪtʊɫ
пекарень	pekɑrenʲ
використання	ʋɪkɔrestɐnʲːɐ
інцидентам	int͡sedɛntɐm
межі	meʒʲi
дев'ятеро	dɛʋjɐterɔ
абрикосник	ɐbrekɔsnek
папа	pɑpɐ
чутливий	t͡ʃʊtɫɪʋei̯
мечах	met͡ʃɑx
діло	dʲiɫɔ
плутократію	pɫʊtɔkrɑtʲijʊ
альфабет	ɐlʲfɐbɛt
емблема	embɫɛmɐ
верх	ʋɛrx
ночі	nɔt͡ʃʲi
родити	rɔdɪte
корпорація	kɔrpɔrɑt͡sʲijɐ
реб	rɛb
раціональність	rɐt͡sʲiɔnɑlʲnʲisʲtʲ
андріан	ɐndʲrʲiɑn
абстракціонізм	ɐbstrɐkt͡sʲionʲizm
антибіотиком	ɐntebʲiɔtekɔm
ліберальний	lʲiberɑlʲnei̯
блокадами	bɫɔkɑdɐme
пам'ятний	pɑmjɐtnei̯
затор	zɐtɔr
датський	dɑt͡sʲkei̯
мільярд	mʲilʲjɑrd
перукарня	perʊkɑrnʲɐ
профілактичний	prɔfʲiɫɐktɪt͡ʃnei̯
психоз	psexɔz
коровай	kɔrɔʋɑi̯
теплота	tepɫɔtɑ
часто	t͡ʃɑstɔ
старання	stɐrɑnʲːɐ
сибір	sebʲir
франція	frɑnʲt͡sʲijɐ
істина	istenɐ
вівсами	ʋʲiu̯sɑme
цнотливий	t͡snɔtɫɪʋei̯
множення	mnɔʒenʲːɐ
безсторонність	bezstɔrɔnʲːisʲtʲ
ніде	nʲidɛ
одягнути	ɔdʲɐɦnute
реформа	refɔrmɐ
березень	bɛrezenʲ
виняток	ʋɪnʲɐtɔk
боже	bɔʒe
самодержавство	sɐmɔderʒɑu̯stwɔ
гродно	ɦrɔdnɔ
японіє	jɐpɔnʲije
вродливий	wrɔdɫɪʋei̯
доїжджати	dɔjiʒd͡ʒɑte
гін	ɦʲin
орбітах	orbʲitɐx
авіста	ɐʋʲistɐ
ендокринологічний	endɔkrenɔɫoɦʲit͡ʃnei̯
грецький	ɦrɛt͡sʲkei̯
помешкання	pɔmɛʃkɐnʲːɐ
відлічити	ʋʲidʲlʲit͡ʃɪte
болгарський	bɔɫɦɑrsʲkei̯
підлогою	pʲidɫɔɦɔjʊ
пляжний	plʲɑʒnei̯
вітальня	ʋʲitɑlʲnʲɐ
метри	mɛtre
розширити	rɔʒʃɪrete
письмо	pesʲmɔ
долоню	dɔɫɔnʲʊ
палестинка	pɐɫestɪnkɐ
яйцеклітина	jɐi̯t͡seklʲitɪnɐ
категорично	kɐteɦɔrɪt͡ʃnɔ
конґрес	kɔnɡrɛs
помідор	pɔmʲidɔr
індексувати	indeksʊʋɑte
фауна	fɑʊnɐ
притулок	pretuɫɔk
лукія	ɫʊkʲijɐ
овощ	ɔwɔʃt͡ʃ
пропозиції	prɔpɔzɪt͡sʲiji
композиція	kɔmpɔzɪt͡sʲijɐ
молюск	molʲusk
виборами	ʋɪbɔrɐme
повстання	pɔu̯stɑnʲːɐ
український	ʊkrɐjinʲsʲkei̯
медицина	medet͡sɪnɐ
дірка	dʲirkɐ
область	ɔbɫɐsʲtʲ
міхур	mʲixur
герцеговина	ɦert͡seɦɔʋɪnɐ
холоднокровний	xɔɫɔdnɔkrɔu̯nei̯
плутократіях	pɫʊtɔkrɑtʲijɐx
сідати	sʲidɑte
йти	i̯tɪ
мистецтво	mestɛt͡stwɔ
плиска	pɫɪskɐ
місячний	mʲisʲɐt͡ʃnei̯
чорних	t͡ʃɔrnex
палати	pɐɫɑte
агресивний	ɐɦresɪu̯nei̯
зміна	zʲmʲinɐ
припущень	prepuʃt͡ʃenʲ
залежати	zɐɫɛʒɐte
неймовірно	nei̯mɔʋʲirnɔ
салон	sɐɫɔn
фінансовий	fʲinɑnsɔʋei̯
знижки	znɪʒke
виникати	ʋenekɑte
динамічний	denɐmʲit͡ʃnei̯
радикалізація	rɐdekɐlʲizɑt͡sʲijɐ
фармацевтика	fɐrmɐt͡sɛu̯tekɐ
передбачити	peredbɑt͡ʃete
глиняний	ɦɫɪnʲɐnei̯
івасюк	iʋɐsʲuk
вперше	ʍpɛrʃe
зазначити	zɐznɐt͡ʃɪte
робити	rɔbɪte
зменшити	zmɛnʃete
був	buu̯
шкатулка	ʃkɐtuɫkɐ
шоколадний	ʃɔkɔɫɑdnei̯
інтуїтивність	intʊjitɪu̯nʲisʲtʲ
геометрія	ɦeɔmɛtʲrʲijɐ
волейбольний	wɔɫei̯bɔlʲnei̯
цариця	t͡sɐrɪt͡sʲɐ
привабливий	preʋɑbɫeʋei̯
самостійність	sɐmosʲtʲii̯nʲisʲtʲ
танцюристка	tɐnʲt͡sʲʊrɪstkɐ
морква	mɔrkʋɐ
сльозогінний	sʲlʲɔzoɦʲinːei̯
класичний	kɫɐsɪt͡ʃnei̯
охра	ɔxrɐ
гуцульщина	ɦʊt͡sulʲʃt͡ʃenɐ
припиняти	prepenʲɑte
наближати	nɐbɫeʒɑte
англієць	ɐnɦlʲijet͡sʲ
кіпр	kʲipr
австралійка	ɐu̯strɐlʲii̯kɐ
чисельний	t͡ʃesɛlʲnei̯
фрагментам	frɐɦmɛntɐm
студент	stʊdɛnt
швейцарець	ʃʋei̯t͡sɑret͡sʲ
моєму	mɔjɛmʊ
вбивати	wbeʋɑte
водосховище	wɔdɔsxɔʋeʃt͡ʃe
дім	dʲim
прославляти	prɔsɫɐu̯lʲɑte
неня	nɛnʲɐ
авіаполк	ɐʋʲiɐpɔɫk
слідкувати	sʲlʲidkʊʋɑte
сирий	serɪi̯
диктаторський	dektɑtɔrsʲkei̯
хома	xɔmɑ
діяльність	dʲijɑlʲnʲisʲtʲ
пропорційність	prɔport͡sʲii̯nʲisʲtʲ
кілометр	kʲiɫɔmɛtr
авіамодель	ɐʋʲiɐmɔdɛlʲ
нерівність	nerʲiu̯nʲisʲtʲ
її	jiji
позначатися	pɔznɐt͡ʃɑtesʲɐ
синонім	senɔnʲim
катерина	kɐterɪnɐ
акція	ɑkt͡sʲijɐ
град	ɦrɑd
врочистий	wrɔt͡ʃɪstei̯
важливий	ʋɐʒɫɪʋei̯
пробувати	prɔbʊʋɐte
залишатися	zɐɫeʃɑtesʲɐ
делегаціям	deɫeɦɑt͡sʲijɐm
автомобільний	ɐu̯tɔmobʲilʲnei̯
демонстрація	demɔnstrɑt͡sʲijɐ
очевидно	ɔt͡ʃeʋɪdnɔ
написати	nɐpesɑte
боснія	bɔsʲnʲijɐ
родич	rɔdet͡ʃ
федерацій	federɑt͡sʲii̯
пропорціями	prɔpɔrt͡sʲijɐme
самобутній	sɐmobutʲnʲii̯
з'їзд	zjizd
автоводій	ɐu̯tɔwodʲii̯
показати	pɔkɐzɑte
змістити	zʲmʲistɪte
перевізник	pereʋʲiznek
красти	krɑste
моторний	mɔtɔrnei̯
терем	tɛrem
ґудзик	ɡud͡zek
шкільний	ʃkʲilʲnɪi̯
бувай	bʊʋɑi̯
шедевр	ʃedɛu̯r
сільський	sʲilʲsʲkɪi̯
стовп	stɔu̯p
безмежний	bezmɛʒnei̯
організми	ɔrɦɐnʲizme
чистий	t͡ʃɪstei̯
ріпами	rʲipɐme
румунський	rʊmunʲsʲkei̯
тополях	tɔpɔlʲɐx
доречний	dɔrɛt͡ʃnei̯
віковічний	ʋʲikɔʋʲit͡ʃnei̯
парта	pɑrtɐ
броварня	brɔʋɑrnʲɐ
безстрашний	bezstrɑʃnei̯
осло	ɔsɫɔ
справах	sprɑʋɐx
вагітна	ʋɐɦʲitnɐ
ріпи	rʲipe
шістсот	ʃʲisːɔt
ніде	nʲide
синонімічний	senɔnʲimʲit͡ʃnei̯
стрілка	stʲrʲiɫkɐ
археолог	ɐrxeɔɫɔɦ
бізон	bʲizɔn
пасивність	pɐsɪu̯nʲisʲtʲ
трав'янистий	trɐʋjɐnɪstei̯
вилов	ʋɪɫɔu̯
чародій	t͡ʃɐrodʲii̯
кремінь	krɛmʲinʲ
гріш	ɦrʲiʃ
страж	strɑʒ
справжній	sprɑu̯ʒnʲii̯
централізація	t͡sentrɐlʲizɑt͡sʲijɐ
гомосексуальний	ɦɔmɔseksʊɑlʲnei̯
спроба	sprɔbɐ
підписувати	pʲidpɪsʊʋɐte
оцієї	ɔt͡sʲijɛji
ваговий	ʋɐɦɔʋɪi̯
зачинити	zɐt͡ʃenɪte
шторм	ʃtɔrm
догматичний	dɔɦmɐtɪt͡ʃnei̯
ольга	ɔlʲɦɐ
позбавляти	pɔzbɐu̯lʲɑte
зв'язки	zʋjɐzkɪ
відсутній	ʋʲid͡zsutʲnʲii̯
рилець	rɪɫet͡sʲ
гінеколог	ɦʲinekɔɫɔɦ
дошко	dɔʃkɔ
рішити	rʲiʃɪte
греція	ɦrɛt͡sʲijɐ
розлити	rɔzɫɪte
вісімнадцятий	ʋʲisʲimnɑd͡zʲt͡sʲɐtei̯
клієнт	klʲijɛnt
сміття	sʲmʲitʲːɑ
вичерпати	ʋɪt͡ʃerpɐte
зворушливий	zworuʃɫeʋei̯
підходящий	pʲidxɔdʲɑʃt͡ʃei̯
астрологія	ɐstrɔɫɔɦʲijɐ
авгіїв	ɑu̯ɦʲijiu̯
поїздка	pɔjizdkɐ
розважальний	rɔzʋɐʒɑlʲnei̯
києві	kɪjeʋʲi
стілець	sʲtʲiɫɛt͡sʲ
озброювати	ɔzbrɔjʊʋɐte
підошва	pʲidɔʃʋɐ
велосипедист	ʋeɫɔsepedɪst
слов'янки	sɫɔʋjɑnke
повоєнний	pɔwɔjɛnːei̯
слов'янин	sɫɔʋjɐnɪn
помста	pɔmstɐ
консультація	kɔnsʊlʲtɑt͡sʲijɐ
зібратися	zʲibrɑtesʲɐ
інгредієнт	inɦredʲijɛnt
свекруха	sʋekruxɐ
корзина	kɔrzɪnɐ
ложа	ɫɔʒɐ
індустріальний	indʊstʲrʲiɑlʲnei̯
якість	jɑkʲisʲtʲ
українське	ʊkrɐjinʲsʲke
зволожити	zwɔɫɔʒete
галич	ɦɑɫet͡ʃ
легітимізація	ɫeɦʲitemʲizɑt͡sʲijɐ
бабисько	bɐbɪsʲkɔ
крім	krʲim
увага	ʊʋɑɦɐ
педагог	pedɐɦɔɦ
веретено	ʋeretɛnɔ
стіна	sʲtʲinɑ
об'єктивний	ɔbjektɪu̯nei̯
правознавство	prɐwɔznɑu̯stwɔ
парадокс	pɐrɐdɔks
прибутковий	prebʊtkɔʋei̯
вдосвіта	wdɔsʲʋʲitɐ
абордаж	ɐbɔrdɑʒ
лизати	ɫezɑte
менструація	menstrʊɑt͡sʲijɐ
ропуха	ropuxɐ
правомірний	prɐwomʲirnei̯
чин	t͡ʃɪn
турбота	tʊrbɔtɐ
легкий	ɫeɦkɪi̯
будівник	bʊdʲiu̯nɪk
днище	dnɪʃt͡ʃe
статевий	stɐtɛʋei̯
інвестор	inʋɛstɔr
поблажливий	pɔbɫɑʒɫeʋei̯
посадка	pɔsɑdkɐ
зимній	zɪmnʲii̯
вадо	ʋɑdɔ
плутократичний	pɫʊtɔkrɐtɪt͡ʃnei̯
автентичний	ɐu̯tentɪt͡ʃnei̯
заощаджувати	zɐɔʃt͡ʃɑd͡ʒʊʋɐte
бензин	benzɪn
подарунок	pɔdɐrunɔk
танець	tɑnet͡sʲ
портфелі	pɔrtfɛlʲi
роки	rɔkɪ
започатковувати	zɐpɔt͡ʃɐtkɔwʊʋɐte
доброта	dɔbrɔtɑ
десь	dɛsʲ
вивчити	ʋɪu̯t͡ʃete
психотерапевтичний	psexɔterɐpeu̯tɪt͡ʃnei̯
порошенко	pɔrɔʃɛnkɔ
волосся	wɔɫɔsʲːɐ
чоловічий	t͡ʃɔɫɔʋʲit͡ʃei̯
січень	sʲit͡ʃenʲ
парадигма	pɐrɐdɪɦmɐ
абіогенез	ɐbʲiɔɦenɛz
піший	pʲiʃei̯
страждання	strɐʒdɑnʲːɐ
кишка	kɪʃkɐ
вишня	ʋɪʃnʲɐ
морфологічний	mɔrfɔɫoɦʲit͡ʃnei̯
фотографічний	fɔtɔɦrɐfʲit͡ʃnei̯
дупло	dʊpɫɔ
аллах	ɐɫɑx
печінка	pet͡ʃʲinkɐ
забувати	zɐbʊʋɑte
магнетизм	mɐɦnetɪzm
їздити	jizdete
уважний	ʊʋɑʒnei̯
постачати	pɔstɐt͡ʃɑte
кафедра	kɑfedrɐ
переддень	peredːɛnʲ
скоро	skɔrɔ
кислий	kɪsɫei̯
заплатити	zɐpɫɐtɪte
онкологічний	ɔnkɔɫoɦʲit͡ʃnei̯
тренувати	trenʊʋɑte
традиція	trɐdɪt͡sʲijɐ
пообідати	pɔobʲidɐte
цвіт	t͡sʲʋʲit
реалізація	reɐlʲizɑt͡sʲijɐ
їй	jii̯
підмінити	pʲidʲmʲinɪte
знову	znɔwʊ
вульва	wulʲʋɐ
абрикос	ɐbrekɔs
бог	bɔɦ
харизматичний	xɐrezmɐtɪt͡ʃnei̯
сяти	sʲɑte
безсмертя	bezsmɛrtʲɐ
в'ячеслав	ʋjɐt͡ʃesɫɑu̯
синдром	sendrɔm
десерту	desɛrtʊ
дійсний	dʲii̯snei̯
нога	nɔɦɑ
медикамент	medekɐmɛnt
обґрунтовувати	ɔbɡrʊntɔwʊʋɐte
рильці	rɪlʲt͡sʲi
висловлювати	ʋesɫɔu̯lʲʊʋɐte
раціям	rɑt͡sʲijɐm
здоров'я	zdɔrɔʋjɐ
комахоїдний	kɔmɐxɔjidnei̯
молитися	mɔɫɪtesʲɐ
природничий	prerɔdnɪt͡ʃei̯
нещасний	neʃt͡ʃɑsnei̯
ставити	stɑʋete
мабуть	mɐbutʲ
дивізій	deʋʲizʲii̯
бонуса	bɔnʊsɐ
медаллю	medɑlʲːʊ
заробляти	zɐrɔblʲɑte
танковий	tɑnkɔʋei̯
нафта	nɑftɐ
малий	mɐɫɪi̯
наркоманія	nɐrkɔmɑnʲijɐ
цьогоріч	t͡sʲɔɦorʲit͡ʃ
смаку	smɑkʊ
спростувати	sprɔstʊʋɑte
біоматеріал	bʲiɔmɐterʲiɑɫ
циган	t͡sɪɦɐn
працюючий	prɐt͡sʲujʊt͡ʃei̯
чоловіче	t͡ʃɔɫɔʋʲit͡ʃe
голуб	ɦɔɫʊb
людина	lʲʊdɪnɐ
тля	tʲlʲɑ
молодицею	mɔɫɔdɪt͡sejʊ
молекулярний	mɔɫekʊlʲɑrnei̯
капітал	kɐpʲitɑɫ
руками	rʊkɑme
грабельки	ɦrɐbelʲkɪ
взаємно	wzɐjɛmnɔ
швейцарський	ʃʋei̯t͡sɑrsʲkei̯
трамвай	trɐmʋɑi̯
мовчання	mɔu̯t͡ʃɑnʲːɐ
онколог	ɔnkɔɫɔɦ
зосереджувати	zɔserɛd͡ʒʊʋɐte
сіно	sʲinɔ
слов'янкою	sɫɔʋjɑnkɔjʊ
сяяти	sʲɐjɑte
персоніфікувати	persɔnʲifʲikʊʋɑte
ліхтенштейн	lʲixtenʃtɛi̯n
сморід	smɔrʲid
боржник	bɔrʒnɪk
повітря	pɔʋʲitʲrʲɐ
повільно	pɔʋʲilʲnɔ
недоторканний	nedɔtɔrkɑnːei̯
повозити	pɔwɔzɪte
срака	srɑkɐ
сьогодні	sʲɔɦɔdʲnʲi
дно	dnɔ
супроводити	sʊprɔwɔdete
колонія	kɔɫɔnʲijɐ
натще	nɑtʃt͡ʃe
босняцький	bɔsʲnʲɑt͡sʲkei̯
руку	rukʊ
неправдах	neprɑu̯dɐx
саботувати	sɐbɔtʊʋɑte
кінотеатр	kʲinɔteɑtr
рильце	rɪlʲt͡se
свиня	sʋenʲɑ
брати	brɐtɪ
заборонити	zɐbɔrɔnɪte
бактеріологічний	bɐkterʲiɔɫoɦʲit͡ʃnei̯
класовий	kɫɑsɔʋei̯
вади	ʋɑde
фортепіано	fɔrtepʲiɑnɔ
горілки	ɦorʲiɫke
бо	bɔ
таємниця	tɐjemnɪt͡sʲɐ
безглуздя	bezɦɫuzʲdʲɐ
спокійний	spokʲii̯nei̯
вроцлав	wrɔt͡sɫɐu̯
грам	ɦrɑm
чудак	t͡ʃʊdɑk
крамниця	krɐmnɪt͡sʲɐ
шершень	ʃɛrʃenʲ
микола	mekɔɫɐ
план	pɫɑn
десерт	desɛrt
систематизувати	sestemɐtezʊʋɑte
рил	rɪɫ
освіжити	ɔsʲʋʲiʒɪte
сніг	sʲnʲiɦ
місяцевий	mʲisʲɐt͡seʋei̯
голосування	ɦɔɫɔsʊʋɑnʲːɐ
текти	tektɪ
ланцюгова	ɫɐnʲt͡sʲʊɦɔʋɐ
утруднити	ʊtrʊdnɪte
видужати	ʋɪdʊʒɐte
корчма	kɔrt͡ʃmɐ
виборах	ʋɪbɔrɐx
ему	ɛmʊ
орбіти	orbʲite
любов	lʲʊbɔu̯
буття	bʊtʲːɑ
верем'я	ʋerɛmjɐ
чаклувати	t͡ʃɐkɫʊʋɑte
повільний	pɔʋʲilʲnei̯
обґрунтувати	ɔbɡrʊntʊʋɑte
обов'язковий	ɔbɔʋjɐzkɔʋei̯
семисот	semesɔt
гадюка	ɦɐdʲukɐ
вишневий	ʋeʃnɛʋei̯
аквамарин	ɐkʋɐmɐrɪn
демократично	demɔkrɐtɪt͡ʃnɔ
тілі	tʲilʲi
моєго	mɔjeɦɔ
автобензовоз	ɐu̯tɔbenzɔwɔz
астрономія	ɐstrɔnɔmʲijɐ
підлозі	pʲidɫɔzʲi
авіабудування	ɐʋʲiɐbʊdʊʋɑnʲːɐ
озерце	ɔzɛrt͡se
умовах	ʊmɔʋɐx
вірменія	ʋʲirmɛnʲijɐ
біднота	bʲidnɔtɐ
подробиць	pɔdrɔbet͡sʲ
актор	ɐktɔr
опозиція	ɔpɔzɪt͡sʲijɐ
учитель	ʊt͡ʃɪtelʲ
раптовий	rɐptɔʋei̯
боятися	bɔjɑtesʲɐ
похорон	pɔxɔrɔn
нерв	nɛrʋ
іллірія	ilʲːirʲijɐ
популяризація	pɔpʊlʲɐrezɑt͡sʲijɐ
паркан	pɐrkɑn
нагромадити	nɐɦrɔmɑdete
ющенко	juʃt͡ʃenkɔ
популізм	pɔpʊlʲizm
трок	trɔk
корисна	kɔrɪsnɐ
туман	tʊmɑn
мокрий	mɔkrei̯
другові	druɦɔʋʲi
міліампер	mʲilʲiɐmpɛr
прогуляти	prɔɦʊlʲɑte
друг	druɦ
колумбія	koɫumbʲijɐ
камуфляж	kɐmʊflʲɑʒ
хорватія	xɔrʋɑtʲijɐ
дисиміляція	desemʲilʲɑt͡sʲijɐ
абияк	ɐbɪjɐk
ця	t͡sʲɑ
алфавіт	ɐɫfɑʋʲit
фізіологічний	fʲizʲiɔɫoɦʲit͡ʃnei̯
нечуваний	net͡ʃuʋɐnei̯
гранат	ɦrɐnɑt
таліє	tɑlʲije
названий	nɐzʋɑnei̯
танк	tɑnk
розчарування	rɔʒt͡ʃɐrʊʋɑnʲːɐ
повідомлення	pɔʋʲidɔmɫenʲːɐ
перевантаження	pereʋɐntɑʒenʲːɐ
розповісти	rɔzpɔʋʲiste
вені	ʋɛnʲi
трансформаціях	trɐnsfɔrmɑt͡sʲijɐx
ах	ɑx
повний	pɔu̯nei̯
печера	pet͡ʃɛrɐ
інфекційний	infekt͡sʲii̯nei̯
працівниці	prɐt͡sʲiu̯nɪt͡sʲi
престиж	prestɪʒ
чорногорія	t͡ʃɔrnɔɦɔrʲijɐ
абеткування	ɐbetkʊʋɑnʲːɐ
ввімкнути	ʋʲːimknute
кобальт	kɔbɐlʲt
банків	bɑnʲkʲiu̯
черепаха	t͡ʃerepɑxɐ
свербіти	sʋerbʲite
подружжя	podruʒʲːɐ
венесуела	ʋenesʊɛɫɐ
створення	stwɔrenʲːɐ
авіаль	ɐʋʲiɑlʲ
кубанський	kʊbɑnʲsʲkei̯
усувати	ʊsʊʋɑte
наступник	nɐstupnek
суботній	sʊbɔtʲnʲii̯
бетономішалка	betɔnɔmʲiʃɑɫkɐ
полювати	pɔlʲʊʋɑte
гетьман	ɦɛtʲmɐn
онук	onuk
дзвінкість	d͡zʲʋʲinʲkʲisʲtʲ
ад'ютант	ɐdjʊtɑnt
невтомний	neu̯tɔmnei̯
моє	mɔjɛ
відродження	ʋʲidrɔd͡ʒenʲːɐ
битва	bɪtʋɐ
література	lʲiterɐturɐ
транспортувати	trɐnspɔrtʊʋɑte
гідравліка	ɦʲidrɑu̯lʲikɐ
навігація	nɐʋʲiɦɑt͡sʲijɐ
винний	ʋɪnːei̯
загальнонаціональний	zɐɦɐlʲnɔnɐt͡sʲiɔnɑlʲnei̯
пацалунак	pɐt͡sɐɫunɐk
бронзовий	brɔnzɔʋei̯
авторство	ɑu̯tɔrstwɔ
грязь	ɦrʲɑzʲ
праіндоєвропейський	prɐindɔjeu̯rɔpɛi̯sʲkei̯
олігархічний	ɔlʲiɦɐrxʲit͡ʃnei̯
аскетично	ɐsketɪt͡ʃnɔ
щотижня	ʃt͡ʃɔtɪʒnʲɐ
дисципліна	dest͡seplʲinɐ
гілля	ɦʲilʲːɑ
міжособистісний	mʲiʒɔsɔbɪsʲtʲisnei̯
сканер	skɑner
тоталітаризм	tɔtɐlʲitɐrɪzm
запроваджувати	zɐprɔʋɑd͡ʒʊʋɐte
віддалений	ʋʲidːɑɫenei̯
фрагментами	frɐɦmɛntɐme
торт	tɔrt
пристрій	prɪstʲrʲii̯
рожевий	rɔʒɛʋei̯
театр	teɑtr
голодний	ɦɔɫɔdnei̯
дозволений	dɔzwɔɫenei̯
нива	nɪʋɐ
інтернаціональний	internɐt͡sʲiɔnɑlʲnei̯
плутократія	pɫʊtɔkrɑtʲijɐ
республіка	respublʲikɐ
легендарний	ɫeɦendɑrnei̯
економіка	ekɔnɔmʲikɐ
лавка	ɫɑu̯kɐ
дія	dʲijɐ
чистота	t͡ʃestɔtɑ
непоганий	nepɔɦɑnei̯
прати	prɑte
жона	ʒɔnɑ
панчоха	pɐnt͡ʃɔxɐ
приватність	preʋɑtʲnʲisʲtʲ
королів	kɔrolʲiu̯
батальйон	bɐtɐlʲjɔn
авіатехніка	ɐʋʲiɐtɛxnʲikɐ
заважати	zɐʋɐʒɑte
позначати	pɔznɐt͡ʃɑte
програміст	prɔɦrɐmʲist
знімок	zʲnʲimɔk
вівця	ʋʲiu̯t͡sʲɑ
язик	jɐzɪk
переконати	perekɔnɑte
пробачати	prɔbɐt͡ʃɑte
пауз	pɑʊz
пропорція	prɔpɔrt͡sʲijɐ
калюжа	kɐlʲuʒɐ
схематичний	sxemɐtɪt͡ʃnei̯
пошта	pɔʃtɐ
авіамотор	ɐʋʲiɐmɔtɔr
уникати	ʊnekɑte
господинею	ɦɔspɔdɪnejʊ
португалія	pɔrtʊɦɑlʲijɐ
євдокія	jeu̯dokʲijɐ
сервіс	sɛrʋʲis
варшав'янка	ʋɐrʃɐʋjɑnkɐ
подібне	podʲibne
квантовий	kʋɑntɔʋei̯
ісландський	isɫɑnd͡zʲsʲkei̯
орел	ɔrɛɫ
фрагментів	frɐɦmɛnʲtʲiu̯
стерня	sternʲɑ
докупи	dokupe
уява	ʊjɑʋɐ
де	dɛ
нерухомість	nerʊxɔmʲisʲtʲ
духівництво	dʊxʲiu̯nɪt͡stwɔ
повідати	pɔʋʲidɐte
абищо	ɐbɪʃt͡ʃɔ
понеділковий	pɔnedʲiɫkɔʋei̯
дійний	dʲii̯nei̯
середньовіччя	seredʲnʲɔʋʲit͡ʃʲːɐ
дітлах	dʲitɫɑx
італієць	itɐlʲijet͡sʲ
монархій	mɔnɑrxʲii̯
гадати	ɦɐdɑte
реєстрація	rejestrɑt͡sʲijɐ
відбутися	ʋʲidbutesʲɐ
диверсифікувати	deʋersefʲikʊʋɑte
пліт	plʲit
вівсах	ʋʲiu̯sɑx
органічний	ɔrɦɐnʲit͡ʃnei̯
жах	ʒɑx
стабільний	stɐbʲilʲnei̯
контролювати	kɔntrɔlʲʊʋɑte
вена	ʋɛnɐ
гілля	ɦʲilʲːɐ
методичний	metɔdɪt͡ʃnei̯
порох	pɔrɔx
біженський	bʲiʒenʲsʲkei̯
слимак	sɫemɑk
високий	ʋesɔkei̯
вигідний	ʋɪɦʲidnei̯
похід	poxʲid
лінія	lʲinʲijɐ
кожного	kɔʒnɔɦɔ
плутократією	pɫʊtɔkrɑtʲijejʊ
захищений	zɐxɪʃt͡ʃenei̯
лялька	lʲɑlʲkɐ
поверхня	pɔʋɛrxnʲɐ
розбирати	rɔzberɑte
бразилець	brɐzɪɫet͡sʲ
реконструкція	rekonstrukt͡sʲijɐ
знижок	znɪʒɔk
постачальниця	pɔstɐt͡ʃɑlʲnet͡sʲɐ
студентка	stʊdɛntkɐ
радіостанція	rɑdʲiɔstɑnʲt͡sʲijɐ
справа	sprɑʋɐ
власниця	wɫɑsnet͡sʲɐ
зріти	zʲrʲite
глупий	ɦɫupei̯
авіакомплекс	ɐʋʲiɐkɔmpɫeks
волинь	wɔɫɪnʲ
беліз	belʲiz
взяти	wzʲɑte
паспорт	pɑspɔrt
борг	bɔrɦ
дивитися	deʋɪtesʲɐ
штандарт	ʃtɐndɑrt
чинити	t͡ʃenɪte
трясти	tʲrʲɐstɪ
повіки	pɔʋʲike
втілювати	ʍtʲilʲʊʋɐte
анжеліка	ɐnʒelʲikɐ
прем'єр	premjɛr
прагнень	prɑɦnenʲ
відмінок	ʋʲidʲmʲinɔk
кліматичний	klʲimɐtɪt͡ʃnei̯
м'якість	mjɑkʲisʲtʲ
слід	sʲlʲid
загальний	zɐɦɑlʲnei̯
інвалід	inʋɐlʲid
співбесідниця	sʲpʲiu̯bɛsʲidnet͡sʲɐ
колгосп	kɔɫɦɔsp
поступкам	pɔstʊpkɐm
підписати	pʲidpesɑte
перше	pɛrʃe
краб	krɑb
примушувати	premuʃʊʋɐte
відносини	ʋʲidnɔsene
плата	pɫɑtɐ
космонавт	kɔsmɔnɑu̯t
поріг	porʲiɦ
зразки	zrɐzkɪ
перевірити	pereʋʲirete
уміння	ʊmʲinʲːɐ
як	jɑk
відфільтровувати	ʋʲidʲfʲilʲtrɔwʊʋɐte
геймплей	ɦei̯mpɫɛi̯
теорій	teɔrʲii̯
дід	dʲid
портфелю	pɔrtfɛlʲʊ
в'язень	ʋjɑzenʲ
авіабудівництво	ɐʋʲiɐbʊdʲiu̯nɪt͡stwɔ
ірина	irɪnɐ
відсвяткувати	ʋʲid͡zsʲʋʲɐtkʊʋɑte
підказувати	pʲidkɑzʊʋɐte
кримінальний	kremʲinɑlʲnei̯
іноходець	inɔxɔdet͡sʲ
мораторій	mɔrɐtɔrʲii̯
мотиваційний	mɔteʋɐt͡sʲii̯nei̯
хтось	xtɔsʲ
категорія	kɐteɦɔrʲijɐ
гострий	ɦɔstrei̯
префікс	prefʲiks
святий	sʲʋʲɐtɪi̯
суттєвий	sʊtʲːɛʋei̯
хала	xɑɫɐ
гіперінфляція	ɦʲiperʲinflʲɑt͡sʲijɐ
абреже	ɐbreʒɛ
армія	ɑrmʲijɐ
текст	tɛkst
дев'ятнадцятий	deʋjɐtnɑd͡zʲt͡sʲɐtei̯
обсерваторія	ɔbserʋɐtɔrʲijɐ
самота	sɐmɔtɑ
бегемот	beɦemɔt
будова	bʊdɔʋɐ
здріти	zdʲrʲite
овес	ɔʋɛs
тунелі	tʊnɛlʲi
засновниця	zɐsnɔu̯net͡sʲɐ
ірландія	irɫɑnʲdʲijɐ
змінитися	zʲmʲinɪtesʲɐ
валютний	ʋɐlʲutnei̯
привід	preʋʲid
бідний	bʲidnei̯
помилковий	pɔmeɫkɔʋei̯
алістер	ɑlʲister
ґеймплей	ɡei̯mpɫɛi̯
епохи	epɔxe
шоколадник	ʃɔkɔɫɑdnek
силікон	selʲikɔn
рацій	rɑt͡sʲii̯
чоловіках	t͡ʃɔɫɔʋʲikɐx
таксі	tɐksʲi
погода	pɔɦɔdɐ
меті	metʲi
мною	mnɔjʊ
метафора	metɑfɔrɐ
абхазець	ɐbxɑzet͡sʲ
шістнадцять	ʃʲisnɑd͡zʲt͡sʲɐtʲ
аваліст	ɐʋɐlʲist
мовчати	mɔu̯t͡ʃɑte
норвежець	nɔrʋɛʒet͡sʲ
токсикологічний	tɔksekɔɫoɦʲit͡ʃnei̯
нудьгувати	nʊdʲɦʊʋɑte
автобусик	ɐu̯tɔbʊsek
термодинамічний	termɔdenɐmʲit͡ʃnei̯
торік	torʲik
сусідський	sʊsʲid͡zʲsʲkei̯
навидіти	nɐʋɪdʲite
вівсам	ʋʲiu̯sɑm
делегація	deɫeɦɑt͡sʲijɐ
ферії	fɛrʲiji
політеїзм	pɔlʲitejizm
дебютувати	debʲʊtʊʋɑte
тисячоліття	tesʲɐt͡ʃolʲitʲːɐ
рабиня	rɐbɪnʲɐ
недоступний	nedostupnei̯
з'явитися	zjɐʋɪtesʲɐ
різати	rʲizɐte
фарфор	fɑrfɔr
регулярно	reɦʊlʲɑrnɔ
автоалієнація	ɐu̯tɔɐlʲijenɑt͡sʲijɐ
значний	znɐt͡ʃnɪi̯
набряк	nɐbrʲɑk
злочинець	zɫɔt͡ʃɪnet͡sʲ
вікторія	ʋʲiktɔrʲijɐ
дискримінація	deskremʲinɑt͡sʲijɐ
залізна	zɐlʲiznɐ
оптимізм	ɔptemʲizm
зима	zemɑ
август	ɑu̯ɦʊst
кисть	kɪsʲtʲ
м'янма	mjɑnmɐ
левиця	ɫeʋɪt͡sʲɐ
громадянство	ɦrɔmɐdʲɑnstwɔ
утратами	ʊtrɑtɐme
авантюризм	ɐʋɐnʲtʲʊrɪzm
лікоть	lʲikɔtʲ
потяг	pɔtʲɐɦ
підприємець	pʲidprejɛmet͡sʲ
доброзичливий	dɔbrɔzet͡ʃɫɪʋei̯
неправдами	neprɑu̯dɐme
усмішка	usʲmʲiʃkɐ
твої	twɔji
віртуальна	ʋʲirtʊɑlʲnɐ
зрозумілий	zrɔzʊmʲiɫei̯
три	trɪ
брамах	brɑmɐx
локомотив	ɫɔkɔmɔtɪu̯
вен	ʋɛn
автобусний	ɐu̯tɔbʊsnei̯
досі	dosʲi
захід	zɑxʲid
болівія	bolʲiʋʲijɐ
яма	jɑmɐ
водій	wodʲii̯
світосприйняття	sʲʋʲitɔsprei̯nʲɐtʲːɑ
елефант	eɫefɑnt
ділянка	dʲilʲɑnkɐ
цирк	t͡sɪrk
філософія	fʲiɫɔsɔfʲijɐ
розумний	rozumnei̯
гормон	ɦɔrmɔn
революціонер	rewɔlʲʊt͡sʲiɔnɛr
швидкости	ʃʋɪdkɔste
волос	wɔɫɔs
вибрати	ʋɪbrɐte
тарас	tɐrɑs
роботодавець	rɔbɔtɔdɑʋet͡sʲ
автоматично	ɐu̯tɔmɐtɪt͡ʃnɔ
зворотний	zwɔrɔtnei̯
о	ɔ
рушників	rʊʃnekʲiu̯
імперією	impɛrʲijejʊ
блокадах	bɫɔkɑdɐx
пожежа	pɔʒɛʒɐ
цацка	t͡sɑt͡skɐ
жорстокий	ʒɔrstɔkei̯
кобила	kɔbɪɫɐ
цеглина	t͡seɦɫɪnɐ
користувач	kɔrɪstʊʋɐt͡ʃ
несумісний	nesʊmʲisnei̯
чи	t͡ʃɪ
розуміння	rɔzʊmʲinʲːɐ
постатям	pɔstɐtʲɐm
лабораторії	ɫɐbɔrɐtɔrʲiji
апатичний	ɐpɐtɪt͡ʃnei̯
отаман	ɔtɑmɐn
глянути	ɦlʲɑnʊte
лесбійка	ɫezʲbʲii̯kɐ
орден	ɔrden
заяць	zɑjɐt͡sʲ
качка	kɑt͡ʃkɐ
спаса	spɑsɐ
біологія	bʲiɔɫɔɦʲijɐ
пшениця	pʃenɪt͡sʲɐ
рідкість	rʲidʲkʲisʲtʲ
чекати	t͡ʃekɑte
періодизацією	perʲiɔdezɑt͡sʲijejʊ
експедиція	ekspedɪt͡sʲijɐ
особовий	ɔsɔbɔʋei̯
тристоронній	trestɔrɔnʲːii̯
емоціями	emɔt͡sʲijɐme
декоративний	dekɔrɐtɪu̯nei̯
бюджет	bʲʊd͡ʒɛt
тобто	tɔbtɔ
клавіатурам	kɫɐʋʲiɐturɐm
малювати	mɐlʲʊʋɑte
бурлак	bʊrɫɑk
авіалінія	ɐʋʲiɐlʲinʲijɐ
бацяр	bɑt͡sʲɐr
неживий	neʒeʋɪi̯
садівництво	sɐdʲiu̯nɪt͡stwɔ
паприка	pɑprekɐ
відкриття	ʋʲidkretʲːɑ
автогенник	ɐu̯tɔɦɛnːek
ситуації	setʊɑt͡sʲiji
орнітологія	ɔrnʲitɔɫɔɦʲijɐ
функціонувати	fʊnkt͡sʲiɔnʊʋɑte
довготерміновий	dɔu̯ɦɔtermʲinɔʋei̯
глід	ɦlʲid
делегацій	deɫeɦɑt͡sʲii̯
козака	kɔzɐkɑ
харизма	xɐrɪzmɐ
випивати	ʋepeʋɑte
інструкціє	instrukt͡sʲije
розказувати	rɔzkɑzʊʋɐte
дослідження	dosʲlʲid͡ʒenʲːɐ
тюлень	tʲʊɫɛnʲ
ізумрудний	izʊmrudnei̯
абстракціоністка	ɐbstrɐkt͡sʲionʲistkɐ
дитсадки	det͡sɐdkɪ
плутократій	pɫʊtɔkrɑtʲii̯
русини	rʊsɪne
вода	wɔdɑ
оголошення	ɔɦɔɫɔʃenʲːɐ
брошура	broʃurɐ
букініст	bʊkʲinʲist
менш	mɛnʃ
коронавірус	kɔrɔnɐʋʲirʊs
широка	ʃerɔkɐ
дивізія	deʋʲizʲijɐ
експедиціями	ekspedɪt͡sʲijɐme
суспільний	sʊsʲpʲilʲnei̯
босий	bɔsei̯
авіаносець	ɐʋʲiɐnɔset͡sʲ
регіон	reɦʲiɔn
шкіру	ʃkʲirʊ
зміїв	zʲmʲijiu̯
зовнішній	zɔu̯nʲiʃnʲii̯
заучувати	zɐut͡ʃʊʋɐte
організаторка	ɔrɦɐnʲizɑtɔrkɐ
періодизації	perʲiɔdezɑt͡sʲiji
медсестра	med͡zsestrɑ
дзвоник	d͡zwɔnek
зовнішність	zɔu̯nʲiʃnʲisʲtʲ
луска	ɫʊskɑ
умова	ʊmɔʋɐ
сечовий	set͡ʃɔʋɪi̯
речовин	ret͡ʃɔʋɪn
низка	nɪzkɐ
києве	kɪjeʋe
сміття	sʲmʲitʲːɐ
серія	sɛrʲijɐ
правдоподібний	prɐu̯dɔpodʲibnei̯
артеріє	ɐrtɛrʲije
замостити	zɐmɔstɪte
пам'ятник	pɑmjɐtnek
збільшення	zʲbʲilʲʃenʲːɐ
зимувати	zemʊʋɑte
програш	prɔɦrɐʃ
делегат	deɫeɦɑt
породілля	pɔrodʲilʲːɐ
священний	sʲʋʲɐʃt͡ʃɛnːei̯
поляк	pɔlʲɑk
марія	mɐrʲijɐ
кшталт	kʃtɑɫt
територія	teretɔrʲijɐ
хвороба	xwɔrɔbɐ
заохочувати	zɐɔxɔt͡ʃʊʋɐte
входити	ʍxɔdete
ізраїльський	izrɑjilʲsʲkei̯
вас	ʋɑs
ніщо	nʲiʃt͡ʃɔ
спостерігач	spɔsterʲiɦɑt͡ʃ
обороняти	ɔbɔrɔnʲɑte
тротуари	trɔtʊɑre
об'єднувати	ɔbjɛdnʊʋɐte
змагання	zmɐɦɑnʲːɐ
кір	kʲir
катувати	kɐtʊʋɑte
повісити	pɔʋʲisete
спрогнозувати	sprɔɦnɔzʊʋɑte
рацією	rɑt͡sʲijejʊ
проект	prɔɛkt
боротися	bɔrɔtesʲɐ
аброгація	ɐbrɔɦɑt͡sʲijɐ
дізнаватися	dʲiznɐʋɑtesʲɐ
пояснювати	pɔjɑsʲnʲʊʋɐte
шумний	ʃumnei̯
спрямувати	sprʲɐmʊʋɑte
канада	kɐnɑdɐ
раціональний	rɐt͡sʲiɔnɑlʲnei̯
брова	brɔʋɑ
десертами	desɛrtɐme
красуня	krɐsʊnʲɑ
підстава	pʲid͡zstɑʋɐ
громадянський	ɦrɔmɐdʲɑnʲsʲkei̯
зуба	zubɐ
гранатомет	ɦrɐnɐtɔmɛt
чавун	t͡ʃɐwun
рись	rɪsʲ
кефір	kefʲir
але	ɐɫɛ
доставити	dɔstɑʋete
створити	stwɔrɪte
блокадам	bɫɔkɑdɐm
формальний	fɔrmɑlʲnei̯
програма	prɔɦrɑmɐ
авіаподорож	ɐʋʲiɐpɔdɔrɔʒ
планувати	pɫɐnʊʋɑte
офіціантка	ɔfʲit͡sʲiɑntkɐ
минуле	menuɫe
брати	brɑte
госпіталізація	ɦɔsʲpʲitɐlʲizɑt͡sʲijɐ
пропускати	prɔpʊskɑte
зупинити	zʊpenɪte
заручник	zɐrut͡ʃnek
простирало	prɔsterɑɫɔ
сердитий	serdɪtei̯
стяг	sʲtʲɑɦ
суднобудівний	sʊdnɔbʊdʲiu̯nɪi̯
москаль	mɔskɑlʲ
японію	jɐpɔnʲijʊ
варити	ʋɐrɪte
михаїл	mexɐjiɫ
внучка	wnut͡ʃkɐ
поліно	polʲinɔ
словників	sɫɔu̯nekʲiu̯
антибіотика	ɐntebʲiɔtekɐ
поліна	polʲinɐ
голова	ɦɔɫɔʋɑ
вареники	ʋɐrɛneke
дарвінізм	dɐrʋʲinʲizm
папуга	pɐpuɦɐ
об'єднання	ɔbjɛdnɐnʲːɐ
трикутник	trekutnek
формування	fɔrmʊʋɑnʲːɐ
ангеліна	ɐnɦelʲinɐ
рило	rɪɫɔ
пересаджування	peresɑd͡ʒʊʋɐnʲːɐ
віденський	ʋʲidenʲsʲkei̯
хибний	xɪbnei̯
нюхати	nʲuxɐte
отруйний	otrui̯nei̯
пензель	pɛnzelʲ
чотирьохсотий	t͡ʃɔterʲɔxsɔtei̯
зрада	zrɑdɐ
вокзал	wɔɡzɑɫ
блоха	bɫɔxɑ
женевський	ʒenɛu̯sʲkei̯
інвестиція	inʋestɪt͡sʲijɐ
випадковий	ʋepɐdkɔʋei̯
аеродром	ɐerɔdrɔm
забудькуватий	zɐbudʲkʊʋɐtei̯
інструмент	instrʊmɛnt
ґазда	ɡɑzdɑ
артерією	ɐrtɛrʲijejʊ
португальський	pɔrtʊɦɑlʲsʲkei̯
криголам	kreɦɔɫɑm
нелінійний	nelʲinʲii̯nei̯
світлина	sʲʋʲitɫɪnɐ
інтегрувати	inteɦrʊʋɑte
імперіє	impɛrʲije
комп'ютер	kɔmpjuter
житомир	ʒetɔmer
озброїти	ɔzbrɔjite
коливатися	kɔɫeʋɑtesʲɐ
абвер	ɑbʋer
трепанація	trepɐnɑt͡sʲijɐ
словацький	sɫɔʋɑt͡sʲkei̯
уподібнення	ʊpodʲibnenʲːɐ
поступками	pɔstʊpkɐme
двічі	dʲʋʲit͡ʃʲi
код	kɔd
міжнародний	mʲiʒnɐrɔdnei̯
миротворець	merɔtwɔret͡sʲ
визначний	ʋeznɐt͡ʃnɪi̯
мільйон	mʲilʲjɔn
педагогічний	pedɐɦoɦʲit͡ʃnei̯
лопух	ɫopux
марсохід	mɐrsoxʲid
криме	krɪme
упевненість	ʊpɛu̯nenʲisʲtʲ
хворий	xwɔrei̯
правителька	prɐʋɪtelʲkɐ
здібний	zʲdʲibnei̯
оцій	ot͡sʲii̯
визначення	ʋɪznɐt͡ʃenʲːɐ
співавторство	sʲpʲiʋɑu̯tɔrstwɔ
зміст	zʲmʲist
книгарня	kneɦɑrnʲɐ
приводити	prewɔdete
будапешт	bʊdɐpɛʃt
нічо	nʲit͡ʃɔ
монархія	mɔnɑrxʲijɐ
приємний	prejɛmnei̯
дикий	dɪkei̯
вуглеводень	wʊɦɫewɔdenʲ
книжкам	kneʒkɑm
безцінний	bezʲt͡sʲinːei̯
тривати	treʋɑte
уособити	ʊɔsɔbete
невдача	neu̯dɑt͡ʃɐ
дефініціями	defʲinʲit͡sʲijɐme
тоді	todʲi
цього	t͡sʲɔɦɔ
небажаний	nebɑʒɐnei̯
віддалити	ʋʲidːɐɫɪte
імпровізація	imprɔʋʲizɑt͡sʲijɐ
зосередити	zɔserɛdete
тарган	tɐrɦɑn
часопис	t͡ʃɐsɔpes
мінськ	mʲinʲsʲk
автоаматорка	ɐu̯tɔɐmɑtɔrkɐ
заручини	zɐrut͡ʃene
археологів	ɐrxeɔɫɔɦʲiu̯
болгарин	bɔɫɦɑren
оточити	ɔtɔt͡ʃɪte
зеленський	zeɫɛnʲsʲkei̯
межа	meʒɑ
чорт	t͡ʃɔrt
погодитися	pɔɦɔdetesʲɐ
півзахисник	pʲiu̯zɐxesnɪk
кімоно	kʲimɔnɔ
психоактивний	psexɔɐktɪu̯nei̯
брудний	brʊdnɪi̯
отруїти	ɔtrʊjite
різний	rʲiznei̯
питати	petɑte
термінологічний	termʲinɔɫoɦʲit͡ʃnei̯
управління	ʊprɐu̯lʲinʲːɐ
стандарти	stɐndɑrte
каплицю	kɐpɫɪt͡sʲʊ
заохотити	zɐɔxɔtete
жучиха	ʒʊt͡ʃɪxɐ
епідеміологія	epʲidemʲiɔɫɔɦʲijɐ
спідницях	sʲpʲidnɪt͡sʲɐx
прибирати	preberɑte
стандарт	stɐndɑrt
диявол	dejɑwɔɫ
переселити	pereseɫɪte
контрабандист	kɔntrɐbɐndɪst
станції	stɑnʲt͡sʲiji
вогнище	wɔɦneʃt͡ʃe
демонструвати	demɔnstrʊʋɑte
стефанія	stefɑnʲijɐ
ввечері	ʋːɛt͡ʃerʲi
портфелям	pɔrtfɛlʲɐm
естетичний	estetɪt͡ʃnei̯
аналогічний	ɐnɐɫoɦʲit͡ʃnei̯
супруго	sʊpruɦɔ
обманути	ɔbmɐnute
вимовляти	ʋemɔu̯lʲɑte
портфелях	pɔrtfɛlʲɐx
рахунків	rɐxunʲkʲiu̯
брехні	brɛxnʲi
незалежністю	nezɐɫɛʒnʲisʲtʲʊ
пекарня	pekɑrnʲɐ
шухляда	ʃʊxlʲɑdɐ
дослід	dɔsʲlʲid
імла	imɫɑ
мінімальний	mʲinʲimɑlʲnei̯
незалежний	nezɐɫɛʒnei̯
обідній	ɔbʲidʲnʲii̯
діставати	dʲistɐʋɑte
протиотрута	prɔteotrutɐ
хвора	xwɔrɐ
проблематика	prɔbɫemɑtekɐ
поведінка	pɔʋedʲinkɐ
перший	pɛrʃei̯
гонконг	ɦɔnkɔnɦ
консультаційний	kɔnsʊlʲtɐt͡sʲii̯nei̯
недовіра	nedɔʋʲirɐ
виживання	ʋeʒeʋɑnʲːɐ
курча	kʊrt͡ʃɑ
граблі	ɦrɐblʲi
філантропічний	fʲiɫɐntropʲit͡ʃnei̯
літераторка	lʲiterɑtɔrkɐ
миколаїв	mekɔɫɑjiu̯
борозна	bɔrɔznɑ
решта	rɛʃtɐ
хірургія	xʲirʊrɦʲijɐ
журналістський	ʒʊrnɐlʲisʲkei̯
залишати	zɐɫeʃɑte
специфічно	spet͡sefʲit͡ʃnɔ
вага	ʋɐɦɑ
інструкціях	instrukt͡sʲijɐx
скандинавія	skɐndenɑʋʲijɐ
авіаекспрес	ɐʋʲiɐeksprɛs
непохитний	nepɔxɪtnei̯
вечірка	ʋet͡ʃʲirkɐ
радіо	rɑdʲiɔ
щука	ʃt͡ʃukɐ
артеріями	ɐrtɛrʲijɐme
завзяття	zɐu̯zʲɑtʲːɐ
українка	ʊkrɐjinkɐ
маршрутка	mɐrʃrutkɐ
богатир	bɔɦɐtɪr
фрустрація	frʊstrɑt͡sʲijɐ
паузою	pɑʊzɔjʊ
брехню	brexnʲu
метаболізм	metɐbolʲizm
регулювання	reɦʊlʲʊʋɑnʲːɐ
музикантка	mʊzekɑntkɐ
дощок	dɔʃt͡ʃɔk
похорону	pɔxɔrɔnʊ
відкрити	ʋʲidkrɪte
імперія	impɛrʲijɐ
тополю	tɔpɔlʲʊ
спадщина	spɑdʃt͡ʃenɐ
егоїзм	eɦɔjizm
насправді	nɐsprɑu̯dʲi
хоробрий	xɔrɔbrei̯
граніт	ɦrɐnʲit
самий	sɐmɪi̯
жито	ʒɪtɔ
мощі	mɔʃt͡ʃʲi
оповідати	ɔpɔʋʲidɑte
десятиліття	desʲɐtelʲitʲːɐ
абстрагованість	ɐbstrɐɦɔʋɐnʲisʲtʲ
актриса	ɐktrɪsɐ
зимородок	zɪmɔrɔdɔk
зненацька	znenɑt͡sʲkɐ
виступити	ʋɪstʊpete
журналістка	ʒʊrnɐlʲistkɐ
вставати	ʍstɐʋɑte
танцюриста	tɐnʲt͡sʲʊrɪstɐ
ссавець	sːɐʋɛt͡sʲ
відсоток	ʋʲid͡zsɔtɔk
неперервний	neperɛrwnei̯
тунелю	tʊnɛlʲʊ
метафоричний	metɐfɔrɪt͡ʃnei̯
поліцейський	pɔlʲit͡sɛi̯sʲkei̯
календар	kɐɫendɑr
заглянути	zɐɦlʲɑnʊte
навчити	nɐu̯t͡ʃɪte
документувати	dɔkʊmentʊʋɑte
цікавити	t͡sʲikɑʋete
пенсильванія	penselʲʋɑnʲijɐ
лінгвістичний	lʲinɦʋʲistɪt͡ʃnei̯
тих	tɪx
валіза	ʋɐlʲizɐ
обирати	ɔberɑte
носилки	nɔsɪɫke
мороз	mɔrɔz
свято	sʲʋʲɑtɔ
ваги	ʋɑɦe
повіці	pɔʋʲit͡sʲi
нарвал	nɐrʋɑɫ
сойка	sɔi̯kɐ
медалях	medɑlʲɐx
архітектура	ɐrxʲitekturɐ
казахстан	kɐzɐxstɑn
небесний	nebɛsnei̯
вжити	wʒɪte
мотивація	mɔteʋɑt͡sʲijɐ
цикл	t͡sɪkɫ
зусилля	zʊsɪlʲːɐ
тій	tʲii̯
засуджувати	zɐsud͡ʒʊʋɐte
вашингтон	ʋɐʃenɦtɔn
процесія	prɔt͡sɛsʲijɐ
вождь	wɔʒdʲ
дурень	durenʲ
жила	ʒeɫɑ
спідницями	sʲpʲidnɪt͡sʲɐme
слівці	sʲlʲiu̯t͡sʲi
мечу	mɛt͡ʃʊ
вибиратися	ʋeberɑtesʲɐ
мізерний	mʲizɛrnei̯
абсорбер	ɐbsɔrber
загальна	zɐɦɑlʲnɐ
активістка	ɐkteʋʲistkɐ
ситуаціях	setʊɑt͡sʲijɐx
цією	t͡sʲijɛjʊ
поведінковий	pɔʋedʲinkɔʋei̯
несерйозний	neserʲɔznei̯
вівси	ʋʲiu̯sɪ
книгарень	kneɦɑrenʲ
організатор	ɔrɦɐnʲizɑtɔr
прамова	prɐmɔʋɐ
авіасервіс	ɐʋʲiɐsɛrʋʲis
австралієць	ɐu̯strɐlʲijet͡sʲ
зубрій	zʊbrʲii̯
молодята	mɔɫɔdʲɑtɐ
щотижневий	ʃt͡ʃɔteʒnɛʋei̯
міль	mʲilʲ
елементарний	eɫementɑrnei̯
корисність	kɔresʲnʲisʲtʲ
двигати	dʋɪɦɐte
центавр	t͡sentɑu̯r
бджілка	bd͡ʒʲiɫkɐ
горіти	ɦorʲite
зрілість	zʲrʲilʲisʲtʲ
нікарагуа	nʲikɐrɑɦʊɐ
вакцинація	ʋɐkt͡senɑt͡sʲijɐ
наслідок	nɑsʲlʲidɔk
відкривати	ʋʲidkreʋɑte
фотографіям	fɔtɔɦrɑfʲijɐm
частка	t͡ʃɑstkɐ
привид	prɪʋed
смаковий	smɐkɔʋɪi̯
запах	zɑpɐx
епідеміологічний	epʲidemʲiɔɫoɦʲit͡ʃnei̯
абруптив	ɐbrʊptɪu̯
ідентифікувати	identefʲikʊʋɑte
споживачі	spɔʒeʋɐt͡ʃʲi
скаржитися	skɑrʒetesʲɐ
авіаколедж	ɐʋʲiɐkɔɫed͡ʒ
низ	nɪz
протиракетний	prɔterɐkɛtnei̯
стадіон	stɐdʲiɔn
наркотичний	nɐrkɔtɪt͡ʃnei̯
увімкнути	ʊʋʲimknute
лізти	lʲizte
протиповітряний	prɔtepɔʋʲitʲrʲɑnei̯
оцими	ɔt͡sɪme
одинадцять	ɔdenɑd͡zʲt͡sʲɐtʲ
суцвіття	sʊt͡sʲʋʲitʲːɐ
лютий	lʲutei̯
боротьба	bɔrɔdʲbɑ
перед	perɛd
співпереживати	sʲpʲiu̯pereʒeʋɑte
роль	rɔlʲ
талія	tɑlʲijɐ
впізнавати	ʍpʲiznɐʋɑte
пунктуальний	pʊnktʊɑlʲnei̯
емоціям	emɔt͡sʲijɐm
цих	t͡sɪx
фіскальна	fʲiskɑlʲnɐ
твоя	twɔjɑ
залізо	zɐlʲizɔ
дофамін	dɔfɐmʲin
слівцях	sʲlʲiu̯t͡sʲɐx
ревнивий	reu̯nɪʋei̯
неминучий	nemenut͡ʃei̯
фахівець	fɐxʲiʋɛt͡sʲ
діаметрально	dʲiɐmetrɑlʲnɔ
періодизаціями	perʲiɔdezɑt͡sʲijɐme
похвала	pɔxʋɐɫɑ
презентація	prezentɑt͡sʲijɐ
повстанець	pɔu̯stɑnet͡sʲ
фізичний	fʲizɪt͡ʃnei̯
монархією	mɔnɑrxʲijejʊ
дебіл	debʲiɫ
підошві	pʲidɔʃʋʲi
усний	usnei̯
контрабанда	kɔntrɐbɑndɐ
густота	ɦʊstɔtɑ
лікарнею	lʲikɑrnejʊ
приманювати	premɑnʲʊʋɐte
ворон	wɔrɔn
перевезти	pereʋeztɪ
гумору	ɦumɔrʊ
абонентка	ɐbɔnɛntkɐ
коштувати	kɔʃtʊʋɑte
ікло	ikɫɔ
питання	petɑnʲːɐ
двохсотий	dwɔxsɔtei̯
анамнії	ɐnɑmnʲiji
нічліг	nʲit͡ʃlʲiɦ
центр	t͡sɛntr
повіках	pɔʋʲikɐx
роком	rɔkɔm
словами	sɫɔʋɑme
обіцяти	ɔbʲit͡sʲɑte
короткотерміновий	kɔrɔtkɔtermʲinɔʋei̯
трансформацій	trɐnsfɔrmɑt͡sʲii̯
імператриця	imperɐtrɪt͡sʲɐ
благо	bɫɑɦɔ
добривечір	dɔbreʋɛt͡ʃʲir
абсолютизм	ɐbsɔlʲʊtɪzm
наставати	nɐstɐʋɑte
служба	sɫuʒbɐ
сердитися	sɛrdetesʲɐ
рея	rɛjɐ
восьми	wɔsʲmɪ
вчитель	ʍt͡ʃɪtelʲ
поверх	pɔʋerx
цензура	t͡senzurɐ
приватний	preʋɑtnei̯
виліковувати	ʋelʲikɔwʊʋɐte
начальник	nɐt͡ʃɑlʲnek
наміру	nɑmʲirʊ
австралійська	ɐu̯strɐlʲii̯sʲkɐ
беркут	bɛrkʊt
молекулярна	mɔɫekʊlʲɑrnɐ
іноземець	inɔzɛmet͡sʲ
монархіям	mɔnɑrxʲijɐm
пандус	pɑndʊs
вичерпний	ʋet͡ʃɛrpnei̯
суспільство	sʊsʲpʲilʲstwɔ
пішоходи	pʲiʃɔxɔde
гро	ɦrɔ
зреагувати	zreɐɦʊʋɑte
китай	ketɑi̯
путін	putʲin
гомосексуалізм	ɦɔmɔseksʊɐlʲizm
стільниковий	sʲtʲilʲnekɔʋei̯
фюзеляж	fʲʊzelʲɑʒ
кавун	kɐwun
поспішний	posʲpʲiʃnei̯
гребти	ɦrebtɪ
гнилий	ɦneɫɪi̯
скриня	skrɪnʲɐ
тем	tɛm
августа	ɐu̯ɦustɐ
спішити	sʲpʲiʃɪte
авіаклуб	ɐʋʲiɐkɫub
собачка	sɔbɑkɐ
авіамайстерня	ɐʋʲiɐmɐi̯stɛrnʲɐ
плювати	plʲʊʋɑte
класифікація	kɫɐsefʲikɑt͡sʲijɐ
відлякувати	ʋʲidʲlʲɑkʊʋɐte
короткостроковий	kɔrɔtkɔstrɔkɔʋei̯
локон	ɫɔkɔn
неподільний	nepodʲilʲnei̯
генерувати	ɦenerʊʋɑte
городянин	ɦɔrɔdʲɑnen
поразка	pɔrɑzkɐ
тільки	tʲilʲke
весна	ʋesnɑ
міліметр	mʲilʲimɛtr
антиамериканський	ɑnteɐmerekɑnʲsʲkei̯
зарубіжний	zɐrʊbʲiʒnei̯
загострити	zɐɦɔstrɪte
активний	ɐktɪu̯nei̯
природа	prerɔdɐ
день	dɛnʲ
зайченя	zɐi̯t͡ʃenʲɑ
гвинтівка	ɦʋenʲtʲiu̯kɐ
ягня	jɐɦnʲɑ
екскурсія	ekskursʲijɐ
громадянка	ɦrɔmɐdʲɑnkɐ
варіантами	ʋɐrʲiɑntɐme
охороняти	ɔxɔrɔnʲɑte
метам	mɛtɐm
вугілля	wʊɦʲilʲːɐ
дієтичний	dʲijetɪt͡ʃnei̯
дошці	dɔsʲt͡sʲi
причт	prɪt͡ʃt
абсурдизм	ɐbsʊrdɪzm
спраглий	sprɑɦɫei̯
вимагати	ʋemɐɦɑte
півострів	pʲiwɔstʲrʲiu̯
вплив	ʍpɫɪu̯
телефонувати	teɫefɔnʊʋɑte
василь	ʋɐsɪlʲ
земноводне	zemnɔwɔdne
щільний	ʃt͡ʃʲilʲnei̯
уганда	ʊɦɑndɐ
фінляндський	fʲinʲlʲɑnd͡zʲsʲkei̯
чорниця	t͡ʃɔrnɪt͡sʲɐ
тоталітарний	tɔtɐlʲitɑrnei̯
ендокринна	endɔkrɪnːɐ
термометр	termɔmetr
подробиця	pɔdrɔbet͡sʲɐ
тацях	tɑt͡sʲɐx
обмежень	ɔbmɛʒenʲ
клавдія	kɫɑu̯dʲijɐ
долонями	dɔɫɔnʲɐme
ляльки	lʲɑlʲke
скроню	skrɔnʲʊ
круглий	kruɦɫei̯
абсорбент	ɐbsɔrbɛnt
помірний	pomʲirnei̯
залоза	zɑɫɔzɐ
жадний	ʒɑdnei̯
вчинок	ʍt͡ʃɪnɔk
розширювати	rɔʒʃɪrʲʊʋɐte
монгольський	mɔnɦɔlʲsʲkei̯
терти	tɛrte
м'яз	mjɑz
помиї	pɔmɪji
шкірах	ʃkʲirɐx
влаштовуватися	wɫɐʃtʊʋɑtesʲɐ
підборіддя	pʲidborʲidʲːɐ
туристичний	tʊrestɪt͡ʃnei̯
вітебськ	ʋʲitebsʲk
поляки	pɔlʲɑke
панікувати	pɐnʲikʊʋɑte
заява	zɐjɑʋɐ
арахнологія	ɐrɐxnɔɫɔɦʲijɐ
пришвидшувати	preʃʋɪd͡ʒʃʊʋɐte
логістичний	ɫɔɦʲistɪt͡ʃnei̯
тридцятий	tred͡zʲt͡sʲɑtei̯
прямий	prʲɐmɪi̯
послабити	pɔsɫɑbete
юридичний	jʊredɪt͡ʃnei̯
бересклет	bereskɫɛt
віконце	ʋʲikɔnt͡se
руки	ruke
гуманізм	ɦʊmɐnʲizm
мікрофон	mʲikrɔfɔn
обдарований	ɔbdɐrɔʋɐnei̯
бібліотека	bʲiblʲiɔtɛkɐ
серцевий	sert͡sɛʋei̯
тіло	tʲiɫɔ
допускати	dɔpʊskɑte
лабораторіями	ɫɐbɔrɐtɔrʲijɐme
авіатравма	ɐʋʲiɐtrɑu̯mɐ
взаємний	wzɐjɛmnei̯
вимерлий	ʋɪmerɫei̯
ввічливий	ʋʲːit͡ʃɫeʋei̯
металургійний	metɐɫʊrɦʲii̯nei̯
спричинити	spret͡ʃenɪte
лозунг	ɫɔzʊnɦ
кардіологічний	kɐrdʲiɔɫoɦʲit͡ʃnei̯
притомність	pretɔmnʲisʲtʲ
тітка	tʲitkɐ
азербайджанський	ɐzerbɐi̯d͡ʒɑnʲsʲkei̯
рояль	rɔjɑlʲ
дискутувати	deskʊtʊʋɑte
семантика	semɑntekɐ
вживати	wʒeʋɑte
монархії	mɔnɑrxʲiji
мем	mɛm
зникати	znekɑte
раба	rɐbɑ
група	ɦrupɐ
квартири	kʋɐrtɪre
спідницям	sʲpʲidnɪt͡sʲɐm
космодром	kɔsmɔdrɔm
ріпа	rʲipɐ
кишенях	keʃɛnʲɐx
любисток	lʲʊbɪstɔk
вірш	ʋʲirʃ
сьодні	sʲɔdʲnʲi
нещастя	neʃt͡ʃɑsʲtʲɐ
вранці	wrɑnʲt͡sʲi
дипломи	depɫɔme
рак	rɑk
варіантові	ʋɐrʲiɑntɔʋʲi
дві	dʲʋʲi
кухар	kuxɐr
християнський	xrestejɑnʲsʲkei̯
нема	nemɑ
були	bʊɫɪ
спірний	sʲpʲirnei̯
золоту	zɔɫɔtʊ
безпідставний	bezʲpʲid͡zstɑu̯nei̯
щоками	ʃt͡ʃɔkɑme
песимізм	pesemʲizm
християнин	xrestejɑnen
цілий	t͡sʲiɫei̯
пришва	prɪʃʋɐ
донька	dɔnʲkɐ
королева	kɔrɔɫɛʋɐ
гомосексуальність	ɦɔmɔseksʊɑlʲnʲisʲtʲ
собор	sɔbɔr
звикати	zʋekɑte
зобов'язувати	zɔbɔʋjɑzʊʋɐte
договір	dɔɦɔʋʲir
ґазда	ɡɑzdɐ
джибуті	d͡ʒebutʲi
антибіотикам	ɐntebʲiɔtekɐm
завойовувати	zɐwɔjɔwʊʋɐte
занедбувати	zɐnɛdbʊʋɐte
черга	t͡ʃɛrɦɐ
крива	kreʋɑ
обстежувати	ɔbstɛʒʊʋɐte
позиція	pɔzɪt͡sʲijɐ
судак	sʊdɑk
пробуджувати	probud͡ʒʊʋɐte
лінгвіст	lʲinɦʋʲist
бересть	bɛresʲtʲ
різноманітний	rʲiznɔmɐnʲitnei̯
металургія	metɐɫurɦʲijɐ
стать	stɑtʲ
меч	mɛt͡ʃ
птиця	ptɪt͡sʲɐ
спортивний	spɔrtɪu̯nei̯
іграх	iɦrɐx
стабілізувати	stɐbʲilʲizʊʋɑte
судно	sʊdnɔ
крів	krʲiu̯
легеня	ɫeɦɛnʲɐ
словнику	sɫɔu̯neku
повікам	pɔʋʲikɐm
підмінювати	pʲidʲmʲinʲʊʋɐte
їхати	jixɐte
схвалити	sxʋɐɫɪte
вдовець	wdɔʋɛt͡sʲ
багатошлюбний	bɐɦɐtoʃlʲubnei̯
недостатньо	nedɔstɑtʲnʲɔ
авіатранспорт	ɐʋʲiɐtrɑnspɔrt
платити	pɫɐtɪte
надійний	nɐdʲii̯nei̯
відчиняти	ʋʲid͡ʒt͡ʃenʲɑte
братислава	brɐtesɫɑʋɐ
зрусифікувати	zrʊsefʲikʊʋɑte
розчаровувати	rɔʒt͡ʃɐrɔwʊʋɐte
безособовий	bezɔsɔbɔʋei̯
шовковий	ʃɔu̯kɔʋei̯
раціями	rɑt͡sʲijɐme
вилікувати	ʋɪlʲikʊʋɐte
гданськ	ɦdɑnʲsʲk
лікарню	lʲikɑrnʲʊ
багатогодинний	bɐɦɐtɔɦɔdɪnːei̯
пелюшка	pelʲuʃkɐ
абрикотин	ɐbrekɔtɪn
пил	pɪɫ
бенін	bɛnʲin
ідеалістичний	ideɐlʲistɪt͡ʃnei̯
часник	t͡ʃɐsnɪk
олин	ɔɫen
близько	bɫɪzʲkɔ
препарат	prepɐrɑt
ґаздиня	ɡɐzdɪnʲɐ
долар	dɔɫɐr
швидкостях	ʃʋɪdkɔsʲtʲɐx
фей	fɛi̯
каша	kɑʃɐ
втратити	ʍtrɑtete
звикнути	zʋɪknʊte
німка	nʲimkɐ
президент	prezedɛnt
пекарні	pekɑrnʲi
авіаквиток	ɐʋʲiɐkʋetɔk
запевняти	zɐpeu̯nʲɑte
народний	nɐrɔdnei̯
безпроцентний	bezprɔt͡sɛntnei̯
сковорода	skɔwɔrɔdɑ
торпеда	tɔrpɛdɐ
золоті	zɔɫɔtʲi
малайзія	mɐɫɑi̯zʲijɐ
диктатор	dektɑtɔr
вкраїна	ʍkrɐjinɐ
арккосинус	ɐrkːɔsenʊs
гіперпосилання	ɦʲiperpɔseɫɑnʲːɐ
урізноманітнити	ʊrʲiznɔmɐnʲitnete
аґрусовий	ɑɡrʊsɔʋei̯
аванкамера	ɐʋɐnkɑmerɐ
недавно	nedɑu̯nɔ
розліт	rɔzʲlʲit
поламати	pɔɫɐmɑte
кирилиця	kerɪɫet͡sʲɐ
що	ʃt͡ʃɔ
надію	nɐdʲijʊ
батяри	bɑtʲɐre
молот	mɔɫɔt
турист	tʊrɪst
поступки	pɔstʊpke
рівнем	rʲiu̯nem
неорганічна	neɔrɦɐnʲit͡ʃnɐ
українську	ʊkrɐjinʲsʲkʊ
абихто	ɐbɪxtɔ
далекий	dɐɫɛkei̯
мильна	mɪlʲnɐ
інтуїтивний	intʊjitɪu̯nei̯
протилежний	prɔteɫɛʒnei̯
стандартах	stɐndɑrtɐx
ерекція	erɛkt͡sʲijɐ
мелодія	meɫɔdʲijɐ
феї	fɛji
оце	ɔt͡sɛ
праця	prɑt͡sʲɐ
священнослужитель	sʲʋʲɐʃt͡ʃenːɔsɫʊʒɪtelʲ
комерційний	kɔmert͡sʲii̯nei̯
паливний	pɑɫeu̯nei̯
ближчий	bɫɪʒt͡ʃei̯
урок	ʊrɔk
трудівник	trʊdʲiu̯nɪk
ставатися	stɐʋɑtesʲɐ
образити	ɔbrɑzete
стояти	stɔjɑte
грі	ɦrʲi
десятий	desʲɑtei̯
значення	znɑt͡ʃenʲːɐ
лінгвістика	lʲinɦʋʲistekɐ
розпізнавати	rɔzʲpʲiznɐʋɑte
абажурчик	ɐbɐʒurt͡ʃek
декларації	dekɫɐrɑt͡sʲiji
оранжерея	ɔrɐnʒerɛjɐ
спостерегти	spɔstereɦtɪ
рильче	rɪlʲt͡ʃe
принципово	prent͡sepɔwɔ
шанувати	ʃɐnʊʋɑte
синочок	senɔt͡ʃɔk
тридцятиліття	tred͡zʲt͡sʲɐtelʲitʲːɐ
металург	metɐɫurɦ
піддашшя	pʲidːɑʃʲːɐ
іван	iʋɑn
слівче	sʲlʲiu̯t͡ʃɛ
концерт	kɔnt͡sɛrt
мігрень	mʲiɦrɛnʲ
цьому	t͡sʲɔmʊ
румунія	rʊmunʲijɐ
ленін	ɫɛnʲin
королівство	kɔrolʲiu̯stwɔ
офіс	ɔfʲis
вершина	ʋerʃɪnɐ
уявляти	ʊjɐu̯lʲɑte
підошвою	pʲidɔʃwɔjʊ
концентрацій	kɔnt͡sentrɑt͡sʲii̯
могти	mɔɦtɪ
суть	sutʲ
вимираючий	ʋemerɑjʊt͡ʃei̯
павза	pɑu̯zɐ
трудний	trʊdnɪi̯
здогадуватися	zdɔɦɑdʊʋɐtesʲɐ
полічити	pɔlʲit͡ʃɪte
індонезія	indɔnɛzʲijɐ
угорський	ʊɦɔrsʲkei̯
помирати	pɔmerɑte
забрало	zɐbrɑɫɔ
безвідповідально	bezʲʋʲidpɔʋʲidɑlʲnɔ
сестрицям	sestrɪt͡sʲɐm
хвороботворний	xwɔrɔbɔtwɔrnei̯
відчутний	ʋʲid͡ʒt͡ʃutnei̯
особливо	ɔsɔbɫɪwɔ
енергіям	enɛrɦʲijɐm
персоналізувати	persɔnɐlʲizʊʋɑte
віск	ʋʲisk
географія	ɦeɔɦrɑfʲijɐ
незабаром	nezɐbɑrɔm
календарем	kɐɫendɐrɛm
одержувати	ɔdɛrʒʊʋɐte
вечірній	ʋet͡ʃʲirnʲii̯
правитель	prɐʋɪtelʲ
горизонтах	ɦɔrezɔntɐx
надійність	nɐdʲii̯nʲisʲtʲ
африканський	ɐfrekɑnʲsʲkei̯
суміжний	sʊmʲiʒnei̯
мало	mɑɫɔ
образ	ɔbrɐz
рахувати	rɐxʊʋɑte
садова	sɐdɔʋɐ
слухняний	sɫʊxnʲɑnei̯
алжирський	ɐɫʒɪrsʲkei̯
обладнання	ɔbɫɑdnɐnʲːɐ
мешканка	mɛʃkɐnkɐ
великдень	ʋeɫɪɡdenʲ
поло	pɔɫɔ
земфіра	zemfʲirɐ
арахнологіє	ɐrɐxnɔɫɔɦʲije
зимовий	zemɔʋei̯
чудовисько	t͡ʃʊdɔʋesʲkɔ
дідух	dʲidux
галузь	ɦɑɫʊzʲ
пекарка	pɛkɐrkɐ
змінити	zʲmʲinɪte
ванна	ʋɑnːɐ
обдумати	obdumɐte
саудівський	sɐudʲiu̯sʲkei̯
народжуваність	nɐrɔd͡ʒʊʋɐnʲisʲtʲ
забезпечувати	zɐbezpɛt͡ʃʊʋɐte
достатній	dɔstɑtʲnʲii̯
правопорушення	prɐwɔporuʃenʲːɐ
публічний	pʊblʲit͡ʃnei̯
дослідниця	dosʲlʲidnet͡sʲɐ
місіонерка	mʲisʲiɔnɛrkɐ
дев'ятисот	deʋjɐtesɔt
зв'язок	zʋjɐzɔk
друзі	druzʲi
бонусах	bɔnʊsɐx
наречена	nɐrɛt͡ʃenɐ
подружній	podruʒnʲii̯
промовити	prɔmɔʋete
югославія	jʊɦɔsɫɑʋʲijɐ
захист	zɑxest
намібія	nɐmʲibʲijɐ
рівноцінний	rʲiu̯not͡sʲinːei̯
горб	ɦɔrb
вічко	ʋʲit͡ʃkɔ
меморіальний	memɔrʲiɑlʲnei̯
клавіатурою	kɫɐʋʲiɐturɔjʊ
психологія	psexɔɫɔɦʲijɐ
рук	ruk
іноземка	inɔzɛmkɐ
відтік	ʋʲidʲtʲik
здоровий	zdɔrɔʋei̯
електрика	eɫɛktrekɐ
публікувати	pʊblʲikʊʋɑte
військовослужбовець	ʋʲii̯sʲkɔwɔsɫʊʒbɔʋet͡sʲ
дихотомія	dexɔtomʲijɐ
нація	nɑt͡sʲijɐ
маргінальний	mɐrɦʲinɑlʲnei̯
стоматологія	stɔmɐtɔɫɔɦʲijɐ
безвідповідальний	bezʲʋʲidpɔʋʲidɑlʲnei̯
палиця	pɑɫet͡sʲɐ
ідіотський	idʲiɔt͡sʲkei̯
вести	ʋestɪ
орнітологічний	ɔrnʲitɔɫoɦʲit͡ʃnei̯
бонусам	bɔnʊsɐm
страховий	strɐxɔʋɪi̯
художньо	xʊdɔʒnʲɔ
позначити	pɔznɐt͡ʃɪte
тривалий	treʋɑɫei̯
дев'ятисотий	deʋjɐtesɔtei̯
п'ятниця	pjɑtnet͡sʲɐ
спокуса	spokusɐ
поширений	pɔʃɪrenei̯
спочатку	spɔt͡ʃɑtkʊ
наречена	nɐret͡ʃɛnɐ
дарина	dɐrɪnɐ
зобразити	zɔbrɐzɪte
мікроскоп	mʲikrɔskɔp
самостійно	sɐmosʲtʲii̯nɔ
донецьк	dɔnɛt͡sʲk
кишеньковий	keʃenʲkɔʋei̯
давати	dɐʋɑte
портфель	pɔrtfɛlʲ
трансплантації	trɐnspɫɐntɑt͡sʲiji
мабуть	mɑbʊtʲ
латиський	ɫɐtɪsʲkei̯
вище	ʋɪʃt͡ʃe
доступ	dɔstʊp
щоки	ʃt͡ʃɔke
авіаобприскувач	ɐʋʲiɐɔbprɪskʊʋɐt͡ʃ
еквівалентний	ekʋʲiʋɐɫɛntnei̯
вижлуктати	ʋɪʒɫʊktɐte
обдумувати	obdumʊʋɐte
омлет	ɔmɫɛt
гуманістичний	ɦʊmɐnʲistɪt͡ʃnei̯
житловий	ʒetɫɔʋɪi̯
придане	prɪdɐne
фруктовий	frʊktɔʋei̯
обмеженнями	ɔbmɛʒenʲːɐme
черга	t͡ʃerɦɑ
націоналіст	nɐt͡sʲiɔnɐlʲist
авіапромисловість	ɐʋʲiɐprɔmesɫɔʋʲisʲtʲ
прикордонник	prekɔrdɔnːek
геоморфологічний	ɦeɔmɔrfɔɫoɦʲit͡ʃnei̯
вітати	ʋʲitɑte
членство	t͡ʃɫɛnstwɔ
городня	ɦɔrɔdʲnʲɐ
менше	mɛnʃe
збирати	zberɑte
шарманка	ʃɐrmɑnkɐ
розпродаж	rɔzprɔdɐʒ
гей	ɦɛi̯
неї	nɛji
чеський	t͡ʃɛsʲkei̯
впізнати	ʍpʲiznɑte
пральний	prɑlʲnei̯
брехун	brexun
мова	mɔʋɐ
геморой	ɦemɔrɔi̯
вирослий	ʋɪrɔsɫei̯
властивість	wɫɐstɪʋʲisʲtʲ
деркач	derkɑt͡ʃ
тім'я	tʲimjɐ
мрія	mrʲijɐ
нідерланди	nʲiderɫɑnde
імперіям	impɛrʲijɐm
пхати	pxɑte
київ	kɪjiu̯
усім	ʊsʲim
диканя	dekɑnʲɐ
домашнє	dɔmɑʃnʲe
закупівля	zɐkʊpʲiu̯lʲɐ
жлуктати	ʒɫʊktɑte
новизна	nɔʋeznɑ
обстежити	ɔbstɛʒete
оцім	ot͡sʲim
автомобільна	ɐu̯tɔmobʲilʲnɐ
орбіт	orbʲit
багатоповерховий	bɐɦɐtɔpɔʋerxɔʋei̯
касир	kɐsɪr
андрій	ɐndʲrʲii̯
клавіатура	kɫɐʋʲiɐturɐ
лити	ɫɪte
занурювати	zɐnurʲʊʋɐte
контрабандний	kɔntrɐbɑndnei̯
міць	mʲit͡sʲ
специфікувати	spet͡sefʲikʊʋɑte
м'язах	mjɑzɐx
друга	druɦɐ
еволюціонувати	ewɔlʲʊt͡sʲiɔnʊʋɑte
триповерховий	trepɔʋerxɔʋei̯
матвійчук	mɐtʲʋʲii̯t͡ʃuk
мілітаризувати	mʲilʲitɐrezʊʋɑte
каблучка	kɐbɫut͡ʃkɐ
універсальний	ʊnʲiʋersɑlʲnei̯
гора	ɦɔrɑ
кацапка	kɐt͡sɑpkɐ
щиколоток	ʃt͡ʃɪkɔɫɔtɔk
манометр	mɐnɔmetr
стеля	stɛlʲɐ
вимір	ʋɪmʲir
щонайменше	ʃt͡ʃɔnɐi̯mɛnʃe
інтуїтивно	intʊjitɪu̯nɔ
долонь	dɔɫɔnʲ
біржа	bʲirʒɐ
анна	ɑnːɐ
марко	mɐrkɔ
концентрувати	kɔnt͡sentrʊʋɑte
помітити	pomʲitete
поскаржитися	pɔskɑrʒetesʲɐ
майдан	mɐi̯dɑn
дефініцій	defʲinʲit͡sʲii̯
двадцятиоднокутник	dʋɐd͡zʲt͡sʲɐteɔdnokutnek
хід	xʲid
композиційний	kɔmpɔzet͡sʲii̯nei̯
супругу	sʊpruɦʊ
відвідувати	ʋʲidʲʋʲidʊʋɐte
швидкостей	ʃʋɪdkɔstei̯
воєнний	wɔjɛnːei̯
щоках	ʃt͡ʃɔkɑx
умикати	ʊmekɑte
термітник	termʲitnek
міжгалактичний	mʲiʒɦɐɫɐktɪt͡ʃnei̯
кишинів	keʃenʲiu̯
комп'ютеризувати	kɔmpjʊterezʊʋɑte
господинями	ɦɔspɔdɪnʲɐme
тунелях	tʊnɛlʲɐx
трава	trɐʋɑ
гречка	ɦrɛt͡ʃkɐ
уявити	ʊjɐʋɪte
автобудівник	ɐu̯tɔbʊdʲiu̯nɪk
крейда	krɛi̯dɐ
заздрити	zɑzdrete
рух	rux
дев'ясил	deʋjɐsɪɫ
мити	mɪte
співрозмовник	sʲpʲiu̯rɔzmɔu̯nek
терапевтичний	terɐpeu̯tɪt͡ʃnei̯
ґрунтець	ɡrʊntɛt͡sʲ
ворона	wɔrɔnɐ
історичний	istɔrɪt͡ʃnei̯
вміти	wmʲite
обмірковувати	ɔbmʲirkɔwʊʋɐte
піца	pʲit͡sɐ
розбити	rɔzbɪte
посилати	pɔseɫɑte
словечком	sɫɔʋɛt͡ʃkɔm
незадоволення	nezɐdɔwɔɫenʲːɐ
фотель	fɔtɛlʲ
критерієм	kretɛrʲijem
побачення	pɔbɑt͡ʃenʲːɐ
поступках	pɔstʊpkɐx
доповнити	dɔpɔu̯nete
багато	bɐɦɑtɔ
вибору	ʋɪbɔrʊ
процесуальний	prɔt͡sesʊɑlʲnei̯
арифметичний	ɐrefmetɪt͡ʃnei̯
президентський	prezedɛnʲsʲkei̯
прислухування	presɫuxʊʋɐnʲːɐ
симетрично	semetrɪt͡ʃnɔ
льотчик	lʲɔt͡ʃːek
проблема	prɔbɫɛmɐ
твоє	twɔjɛ
ідентифікація	identefʲikɑt͡sʲijɐ
спорожнювати	spɔrɔʒnʲʊʋɐte
співіснування	sʲpʲiʋʲisnʊʋɑnʲːɐ
україною	ʊkrɐjinɔjʊ
повідомити	pɔʋʲidɔmete
прогнози	prɔɦnɔze
горизонтальний	ɦɔrezɔntɑlʲnei̯
кількісний	kʲilʲkʲisnei̯
репутація	repʊtɑt͡sʲijɐ
судина	sʊdɪnɐ
аванпорт	ɐʋɐnpɔrt
відпочити	ʋʲidpɔt͡ʃɪte
провокувати	prɔwɔkʊʋɑte
очі	ɔt͡ʃʲi
припускати	prepʊskɑte
мішаний	mʲiʃɐnei̯
мікроскопічний	mʲikrɔskopʲit͡ʃnei̯
котинги	kɔtɪnɦe
лад	ɫɑd
вуглеводний	wʊɦɫewɔdnei̯
обличчя	ɔbɫɪt͡ʃʲːɐ
біблія	bʲiblʲijɐ
діагностичний	dʲiɐɦnɔstɪt͡ʃnei̯
мікрохвильова	mʲikrɔxʋelʲɔʋɑ
зерновий	zernɔʋɪi̯
м'язами	mjɑzɐme
краєвид	krɐjeʋɪd
видимість	ʋɪdemʲisʲtʲ
тижня	tɪʒnʲɐ
достатність	dɔstɑtʲnʲisʲtʲ
посилити	pɔsɪɫete
безкінечний	bezʲkʲinɛt͡ʃnei̯
капітуляція	kɐpʲitʊlʲɑt͡sʲijɐ
наш	nɑʃ
біомеханіка	bʲiɔmexɑnʲikɐ
гладкий	ɦɫɐdkɪi̯
доба	dɔbɑ
занедбаний	zɐnɛdbɐnei̯
кобальтовий	kɔbɐlʲtɔʋei̯
рослина	rɔsɫɪnɐ
барва	bɑrʋɐ
лихо	ɫɪxɔ
соломія	sɔɫomʲijɐ
звичайний	zʋet͡ʃɑi̯nei̯
латинський	ɫɐtɪnʲsʲkei̯
єдиний	jedɪnei̯
медуза	meduzɐ
дивізією	deʋʲizʲijejʊ
меча	met͡ʃɑ
вепр	ʋɛpr
волость	wɔɫɔsʲtʲ
авіашоу	ɐʋʲiɐʃɔʊ
абстракція	ɐbstrɑkt͡sʲijɐ
синтезувати	sentezʊʋɑte
інспекція	inspɛkt͡sʲijɐ
концепт	kɔnt͡sɛpt
будівельниця	bʊdʲiʋɛlʲnet͡sʲɐ
дріт	dʲrʲit
працьовитий	prɐt͡sʲɔʋɪtei̯
претендент	pretendɛnt
посередницький	pɔserɛdnet͡sʲkei̯
зустрічати	zʊstʲrʲit͡ʃɑte
моєї	mɔjɛji
клен	kɫɛn
яйце	jɐi̯t͡sɛ
освіта	ɔsʲʋʲitɐ
дорога	dɔrɔɦɐ
різнорідний	rʲiznorʲidnei̯
спати	spɑte
ніжний	nʲiʒnei̯
смертність	smɛrtʲnʲisʲtʲ
вибір	ʋɪbʲir
кореспондент	kɔrespɔndɛnt
рильцями	rɪlʲt͡sʲɐme
посміхнутися	pɔsʲmʲixnutesʲɐ
медитація	medetɑt͡sʲijɐ
вищеназваний	ʋeʃt͡ʃenɑzʋɐnei̯
походження	pɔxɔd͡ʒenʲːɐ
індустріалізувати	indʊstʲrʲiɐlʲizʊʋɑte
киргизстан	kerɦezstɑn
тисячоліттях	tesʲɐt͡ʃolʲitʲːɐx
кит	kɪt
недосвідченість	nedɔsʲʋʲid͡ʒt͡ʃenʲisʲtʲ
поєднання	pɔjednɑnʲːɐ
бінокль	bʲinɔklʲ
модифікація	mɔdefʲikɑt͡sʲijɐ
завше	zɑu̯ʃe
вечорі	ʋɛt͡ʃɔrʲi
чемодан	t͡ʃemɔdɑn
волога	wɔɫɔɦɐ
екосистем	ekɔsestɛm
особливий	ɔsɔbɫɪʋei̯
оберігати	ɔberʲiɦɑte
соціалістичний	sɔt͡sʲiɐlʲistɪt͡ʃnei̯
заощадити	zɐɔʃt͡ʃɑdete
досвідчений	dɔsʲʋʲid͡ʒt͡ʃenei̯
трансформацію	trɐnsfɔrmɑt͡sʲijʊ
коштувати	kɔʃtʊʋɐte
спостерігати	spɔsterʲiɦɑte
волонтерка	wɔɫɔntɛrkɐ
плакат	pɫɐkɑt
юриспруденція	jʊresprʊdɛnʲt͡sʲijɐ
важливість	ʋɐʒɫɪʋʲisʲtʲ
беззубий	bezːubei̯
вугор	wʊɦɔr
абсолютист	ɐbsɔlʲʊtɪst
ріпі	rʲipʲi
теніс	tɛnʲis
гуси	ɦuse
слов'ян	sɫɔʋjɑn
архаїзація	ɐrxɐjizɑt͡sʲijɐ
спрощувати	sprɔʃt͡ʃʊʋɐte
віскі	ʋʲisʲkʲi
босоніж	bɔsɔnʲiʒ
оладок	ɔɫɑdɔk
м'язи	mjɑze
виделка	ʋedɛɫkɐ
біля	bʲilʲɐ
кривавий	kreʋɑʋei̯
тисячолітті	tesʲɐt͡ʃolʲitʲːi
шпіхлір	ʃpʲixlʲir
володимир	wɔɫɔdɪmer
вестернізація	ʋesternʲizɑt͡sʲijɐ
кров	krɔu̯
тюрма	tʲʊrmɑ
автовеломотогонки	ɑu̯tɔʋɛɫɔmɔtɔɦɔnke
суфікс	sufʲiks
чужина	t͡ʃʊʒenɑ
застерігати	zɐsterʲiɦɑte
разом	rɑzɔm
бавовняний	bɐwɔu̯nʲɐnei̯
муха	muxɐ
критерії	kretɛrʲiji
верблюд	ʋerblʲud
вікісловникові	ʋʲikʲisɫɔu̯nekɔʋʲi
місце	mʲist͡se
грач	ɦrɑt͡ʃ
передчасний	pered͡ʒt͡ʃɑsnei̯
рилі	rɪlʲi
гриб	ɦrɪb
паровоз	pɐrɔwɔz
українських	ʊkrɐjinʲsʲkex
щось	ʃt͡ʃɔsʲ
теорію	teɔrʲijʊ
оцінити	ɔt͡sʲinɪte
блокнот	bɫɔknɔt
зазначений	zɐznɑt͡ʃenei̯
пропозиціями	prɔpɔzɪt͡sʲijɐme
спокій	spɔkʲii̯
анатолій	ɐnɐtɔlʲii̯
імовірно	imɔʋʲirnɔ
мітоз	mʲitɔz
співбесідник	sʲpʲiu̯besʲidnek
лихоманка	ɫexɔmɑnkɐ
промова	prɔmɔʋɐ
вівсові	ʋʲiu̯sɔʋʲi
камбоджа	kɐmbɔd͡ʒɐ
каплицями	kɐpɫɪt͡sʲɐme
взаємоповага	wzɐjemɔpɔʋɑɦɐ
аромат	ɐrɔmɑt
смердіти	smerdʲite
черево	t͡ʃɛrewɔ
наступний	nɐstupnei̯
їстівний	jisʲtʲiu̯nɪi̯
байдужий	bɐi̯duʒei̯
вказівний	ʍkɐzʲiu̯nɪi̯
наближення	nɐbɫɪʒenʲːɐ
наголошувати	nɐɦɔɫɔʃʊʋɐte
шибениці	ʃɪbenet͡sʲi
скіф	sʲkʲif
іскра	iskrɐ
паніка	pɑnʲikɐ
богоподібний	bɔɦɔpodʲibnei̯
міжнародними	mʲiʒnɐrɔdneme
вибори	ʋɪbɔre
горизонти	ɦɔrezɔnte
будинок	bʊdɪnɔk
мети	metɪ
здебільшого	zdebʲilʲʃɔɦɔ
брехня	brexnʲɑ
репресивний	represɪu̯nei̯
націоналізм	nɐt͡sʲiɔnɐlʲizm
нумограй	nʊmɔɦrɑi̯
шанувальник	ʃɐnʊʋɑlʲnek
опір	ɔpʲir
абдомінопластика	ɐbdɔmʲinɔpɫɑstekɐ
планомірний	pɫɐnomʲirnei̯
сонько	sɔnʲkɔ
додатковий	dɔdɐtkɔʋei̯
обмеження	ɔbmɛʒenʲːɐ
електронний	eɫektrɔnːei̯
сукнях	suknʲɐx
хоробрість	xɔrɔbrʲisʲtʲ
попередити	pɔperɛdete
концерн	kɔnt͡sɛrn
кількісно	kʲilʲkʲisnɔ
каска	kɑskɐ
семеро	sɛmerɔ
станцій	stɑnʲt͡sʲii̯
магнітофон	mɐɦnʲitɔfɔn
білоруська	bʲiɫorusʲkɐ
ментовка	mentɔu̯kɐ
прийміть	prei̯mʲitʲ
солома	sɔɫɔmɐ
петиціям	petɪt͡sʲijɐm
підлого	pʲidɫɔɦɔ
кабель	kɑbelʲ
виснажувати	ʋesnɑʒʊʋɐte
псевдонім	pseu̯donʲim
теоретичний	teɔretɪt͡ʃnei̯
мої	mɔji
прихильниця	prexɪlʲnet͡sʲɐ
тяжкий	tʲɐʒkɪi̯
родитися	rɔdɪtesʲɐ
австрія	ɑu̯stʲrʲijɐ
братній	brɑtʲnʲii̯
бюрократичний	bʲʊrɔkrɐtɪt͡ʃnei̯
нижній	nɪʒnʲii̯
теперішній	tepɛrʲiʃnʲii̯
багатомовний	bɐɦɐtɔmɔu̯nei̯
сукнями	suknʲɐme
іржа	irʒɑ
користувач	kɔrestʊʋɑt͡ʃ
зараз	zɑrɐz
лідер	lʲider
заперечення	zɐperɛt͡ʃenʲːɐ
незамінний	nezɐmʲinːei̯
еластичний	eɫɐstɪt͡ʃnei̯
везти	ʋeztɪ
оселедець	ɔseɫɛdet͡sʲ
склянка	sklʲɑnkɐ
звідти	zʲʋʲidte
зубний	zʊbnɪi̯
кобза	kɔbzɐ
передвиборчий	peredʋɪbɔrt͡ʃei̯
українець	ʊkrɐjinet͡sʲ
абсурдист	ɐbsʊrdɪst
абориген	ɐbɔreɦɛn
весняний	ʋesʲnʲɐnɪi̯
клоччя	kɫɔt͡ʃʲːɐ
найменш	nɐi̯mɛnʃ
цінник	t͡sʲinːɪk
випити	ʋɪpete
взуттєвий	wzʊtʲːɛʋei̯
законодавство	zɐkɔnɔdɑu̯stwɔ
порушення	poruʃenʲːɐ
фінвал	fʲinʋɑɫ
буревій	bʊreʋʲii̯
далі	dɑlʲi
псилоцибін	pseɫɔt͡sɪbʲin
мелодіях	meɫɔdʲijɐx
старіти	stɑrʲite
яхта	jɑxtɐ
нитка	nɪtkɐ
хлів	xlʲiu̯
принтер	prɪnter
авіаперевезення	ɐʋʲiɐpereʋɛzenʲːɐ
стримати	strɪmɐte
підошви	pʲidɔʃʋe
руках	rʊkɑx
міт	mʲit
пропозицією	prɔpɔzɪt͡sʲijejʊ
край	krɑi̯
терпеливість	terpeɫɪʋʲisʲtʲ
ремінь	rɛmʲinʲ
федераціями	federɑt͡sʲijɐme
авіатор	ɐʋʲiɑtɔr
мелодіями	meɫɔdʲijɐme
єврейський	jeu̯rɛi̯sʲkei̯
егоцентричний	eɦɔt͡sentrɪt͡ʃnei̯
заяви	zɐjɐʋɪ
арфіст	ɐrfʲist
анонімний	ɐnonʲimnei̯
динамізм	denɐmʲizm
юний	junei̯
природничої	prerɔdnɪt͡ʃɔji
зростати	zrɔstɑte
перекладати	perekɫɐdɑte
прощальний	prɔʃt͡ʃɑlʲnei̯
гідрологічний	ɦʲidrɔɫoɦʲit͡ʃnei̯
шибенице	ʃɪbenet͡se
четверо	t͡ʃɛtʋerɔ
страхіття	strɐxʲitʲːɐ
лабораторіям	ɫɐbɔrɐtɔrʲijɐm
ветхий	ʋɛtxei̯
кулемет	kʊɫemɛt
широкомасштабний	ʃerɔkɔmɐʃːtɑbnei̯
направити	nɐprɑʋete
аварія	ɐʋɑrʲijɐ
кращий	krɑʃt͡ʃei̯
організаціям	ɔrɦɐnʲizɑt͡sʲijɐm
підлоги	pʲidɫɔɦe
питальний	petɑlʲnei̯
п'єса	pjɛsɐ
автобетономішалка	ɐu̯tɔbetɔnɔmʲiʃɑɫkɐ
профанація	prɔfɐnɑt͡sʲijɐ
місяць	mʲisʲɐt͡sʲ
травоїдний	trɐwɔjidnei̯
авантюрність	ɐʋɐnʲtʲurnʲisʲtʲ
мети	mɛte
хоч	xɔt͡ʃ
ввести	ʋːestɪ
біс	bʲis
битвами	bɪtʋɐme
реанімація	reɐnʲimɑt͡sʲijɐ
довідник	dɔʋʲidnek
великодушний	ʋeɫekoduʃnei̯
оприлюднювати	ɔprelʲudʲnʲʊʋɐte
авансування	ɐʋɐnsʊʋɑnʲːɐ
пробуджуватися	probud͡ʒʊʋɐtesʲɐ
покій	pɔkʲii̯
короїд	kɔrɔjid
холодно	xɔɫɔdnɔ
дошки	dɔʃke
когнітивна	kɔɦnʲitɪu̯nɐ
процвітаючий	prɔt͡sʲʋʲitɑjʊt͡ʃei̯
конкурент	kɔnkʊrɛnt
персонально	persɔnɑlʲnɔ
покупниця	pɔkʊpnɪt͡sʲɐ
церковний	t͡serkɔu̯nei̯
бруднитися	brʊdnɪtesʲɐ
моя	mɔjɑ
експедицію	ekspedɪt͡sʲijʊ
неодмінно	neodʲmʲinːɔ
делегацією	deɫeɦɑt͡sʲijejʊ
доброзичливець	dɔbrɔzet͡ʃɫɪʋet͡sʲ
плавчиня	pɫɐu̯t͡ʃɪnʲɐ
бюст	bʲust
німий	nʲimɪi̯
шибениць	ʃɪbenet͡sʲ
черемха	t͡ʃerɛmxɐ
безжальний	beʒːɑlʲnei̯
автобудування	ɐu̯tɔbʊdʊʋɑnʲːɐ
спис	spɪs
авансоутримувач	ɐʋɐnsɔʊtrɪmʊʋɐt͡ʃ
оця	ɔt͡sʲɑ
гервасій	ɦerʋɑsʲii̯
злочинність	zɫɔt͡ʃɪnʲːisʲtʲ
токсикологія	tɔksekɔɫɔɦʲijɐ
офіційний	ɔfʲit͡sʲii̯nei̯
порахувати	pɔrɐxʊʋɑte
статистичний	stɐtestɪt͡ʃnei̯
бішкек	bʲiʃkɛk
підняти	pʲidʲnʲɑte
марево	mɑrewɔ
болгарія	bɔɫɦɑrʲijɐ
очко	ɔt͡ʃkɔ
правоохоронні	prɐwɔɔxɔrɔnʲːi
батьківщина	bɐtʲkʲiu̯ʃt͡ʃɪnɐ
перспективний	perspektɪu̯nei̯
вистачити	ʋɪstɐt͡ʃete
дзюрчалка	d͡zʲʊrt͡ʃɑɫkɐ
присутній	presutʲnʲii̯
підхід	pʲidʲxʲid
недоторканий	nedɔtɔrkɐnei̯
організм	ɔrɦɐnʲizm
канал	kɐnɑɫ
лаванда	ɫɐʋɑndɐ
вважати	ʋːɐʒɑte
бедринець	bedrɪnet͡sʲ
симбіоз	sembʲiɔz
плутократіями	pɫʊtɔkrɑtʲijɐme
визначальний	ʋeznɐt͡ʃɑlʲnei̯
ув'язнення	ʊʋjɑznenʲːɐ
опера	ɔperɐ
інспектор	inspɛktɔr
хотів	xotʲiu̯
заспокоювати	zɐspɔkɔjʊʋɐte
заморожувати	zɐmɔrɔʒʊʋɐte
залізниця	zɐlʲiznɪt͡sʲɐ
порядковий	pɔrʲɐdkɔʋei̯
затвердження	zɐtʋɛrd͡ʒenʲːɐ
наркозалежність	nɐrkɔzɐɫɛʒnʲisʲtʲ
орган	ɔrɦɑn
чай	t͡ʃɑi̯
пугач	pʊɦɑt͡ʃ
сьогоднішній	sʲɔɦɔdʲnʲiʃnʲii̯
простий	prɔstei̯
східнослов'янський	sʲxʲidnɔsɫɔʋjɑnʲsʲkei̯
заміна	zɐmʲinɐ
прогулювати	proɦulʲʊʋɐte
фрагментом	frɐɦmɛntɔm
прожитковий	prɔʒetkɔʋei̯
ефіопія	efʲiɔpʲijɐ
сповільнювати	spɔʋʲilʲnʲʊʋɐte
провокаційний	prɔwɔkɐt͡sʲii̯nei̯
емоційний	emot͡sʲii̯nei̯
розтерти	rɔztɛrte
захворювання	zɐxwɔrʲʊʋɐnʲːɐ
рученя	rʊt͡ʃenʲɑ
дитята	detʲɑtɐ
квітка	kʋʲitkɐ
режим	reʒɪm
потребувати	pɔtrebʊʋɑte
поносити	pɔnɔsɪte
переживати	pereʒeʋɑte
заручин	zɐrut͡ʃen
поспішно	posʲpʲiʃnɔ
нагадувати	nɐɦɑdʊʋɐte
десятиріччя	desʲɐterʲit͡ʃʲːɐ
енциклопедистка	ent͡sekɫɔpedɪstkɐ
віра	ʋʲirɐ
артерія	ɐrtɛrʲijɐ
терпеливий	terpeɫɪʋei̯
розбивати	rɔzbeʋɑte
надзвичайний	nɐd͡zʋet͡ʃɑi̯nei̯
яловичиною	jɑɫɔʋet͡ʃenɔjʊ
діяння	dʲijɐnʲːɐ
мотоциклах	mɔtɔt͡sɪkɫɐx
жовтень	ʒɔu̯tenʲ
залишити	zɐɫɪʃete
власний	wɫɑsnei̯
обід	ɔbʲid
слов'янку	sɫɔʋjɑnkʊ
інженерія	inʒenɛrʲijɐ
словак	sɫɔʋɑk
родитель	rɔdɪtelʲ
ізумруд	izʊmrud
доживати	dɔʒeʋɑte
таліями	tɑlʲijɐme
шведський	ʃʋɛd͡zʲsʲkei̯
ескадрилья	eskɐdrɪlʲjɐ
шаблон	ʃɐbɫɔn
авіаконструктор	ɐʋʲiɐkonstruktɔr
легітимний	ɫeɦʲitɪmnei̯
зелений	zeɫɛnei̯
агентство	ɐɦɛnstwɔ
хребет	xrebɛt
обсяг	ɔbsʲɐɦ
застудах	zɐstudɐx
заворушення	zɐworuʃenʲːɐ
зостатися	zɔstɑtesʲɐ
національність	nɐt͡sʲiɔnɑlʲnʲisʲtʲ
періодичність	perʲiɔdɪt͡ʃnʲisʲtʲ
давній	dɑu̯nʲii̯
м'язом	mjɑzɔm
ледар	ɫɛdɐr
кому	komu
іванна	iʋɑnːɐ
ворожий	wɔrɔʒei̯
інституція	instetut͡sʲijɐ
тривимірний	treʋɪmʲirnei̯
підхожий	pʲidxɔʒei̯
церемонія	t͡seremɔnʲijɐ
застосовувати	zɐstɔsɔwʊʋɐte
протидіяти	prɔtedʲijɐte
водка	wɔdkɐ
надмірний	nɐdʲmʲirnei̯
цапеня	t͡sɐpenʲɑ
автогараж	ɐu̯tɔɦɐrɑʒ
рідко	rʲidkɔ
індустріалізація	indʊstʲrʲiɐlʲizɑt͡sʲijɐ
корабель	kɔrɐbɛlʲ
клясти	klʲɐstɪ
застраховувати	zɐstrɐxɔwʊʋɐte
справу	sprɑwʊ
року	rɔkʊ
автоаерозапчастина	ɐu̯tɔɐerɔzɐpt͡ʃɐstɪnɐ
процедурний	prɔt͡sedurnei̯
працівників	prɐt͡sʲiu̯nekʲiu̯
делегації	deɫeɦɑt͡sʲiji
ті	tʲi
технічний	texnʲit͡ʃnei̯
штрафувати	ʃtrɐfʊʋɑte
машинний	mɐʃɪnːei̯
кидати	kɪdɐte
сажалка	sɑʒɐɫkɐ
механік	mexɑnʲik
надвір	nɐdʲʋʲir
трансформувати	trɐnsfɔrmʊʋɑte
клавіатурах	kɫɐʋʲiɐturɐx
дивізіями	deʋʲizʲijɐme
ваше	ʋɑʃe
виразно	ʋerɑznɔ
архітектор	ɐrxʲitɛktɔr
привабити	preʋɑbete
незалежносте	nezɐɫɛʒnɔste
щоку	ʃt͡ʃoku
тайський	tɑi̯sʲkei̯
сушарка	sʊʃɑrkɐ
смалець	smɑɫet͡sʲ
дух	dux
журавель	ʒʊrɐʋɛlʲ
погнати	pɔɦnɑte
замок	zɐmɔk
ступити	stʊpɪte
хвіст	xʋʲist
слов'янкам	sɫɔʋjɑnkɐm
п'ядун	pjɐdun
підозріливий	pʲidozʲrʲiɫeʋei̯
традиційно	trɐdet͡sʲii̯nɔ
перекладач	perekɫɐdɑt͡ʃ
прийти	prei̯tɪ
цінний	t͡sʲinːei̯
комбінація	kɔmbʲinɑt͡sʲijɐ
тими	tɪme
перепрошую	pereprɔʃʊjʊ
кажи	kɐʒɪ
батяри	bɐtʲɑre
ї	ji
дисертаціям	desertɑt͡sʲijɐm
родина	rɔdɪnɐ
бульба	bulʲbɐ
штати	ʃtɑte
середа	seredɑ
пальто	pɐlʲtɔ
сіднице	sʲidnɪt͡se
вимерти	ʋɪmerte
нічиє	nʲit͡ʃejɛ
комедія	kɔmɛdʲijɐ
міграція	mʲiɦrɑt͡sʲijɐ
австралопітек	ɐu̯strɐɫɔpʲitɛk
лягти	lʲɐɦtɪ
зяблик	zʲɑbɫek
дивувати	dewʊʋɑte
рід	rʲid
піка	pʲikɐ
солідарність	sɔlʲidɑrnʲisʲtʲ
переоцінити	pereɔt͡sʲinɪte
доцільний	dot͡sʲilʲnei̯
вікно	ʋʲiknɔ
конлі	kɔnʲlʲi
психоделічний	psexɔdelʲit͡ʃnei̯
інформатика	infɔrmɑtekɐ
підрости	pʲidrɔstɪ
емоції	emɔt͡sʲiji
ніздрях	nʲizdʲrʲɐx
бика	bekɑ
блискавка	bɫɪskɐu̯kɐ
щокам	ʃt͡ʃɔkɑm
смутний	smʊtnɪi̯
зразковий	zrɐzkɔʋei̯
геном	ɦenɔm
шибеницях	ʃɪbenet͡sʲɐx
з'ясовувати	zjɐsɔwʊʋɐte
богомаз	bɔɦɔmɑz
ідеалістка	ideɐlʲistkɐ
схвилювати	sxʋelʲʊʋɑte
їдальня	jidɑlʲnʲɐ
абрикоса	ɐbrekɔsɐ
незаконний	nezɐkɔnːei̯
успадковувати	ʊspɐdkɔwʊʋɐte
забруднювати	zɐbrudʲnʲʊʋɐte
авіапорт	ɐʋʲiɐpɔrt
співбесіда	sʲpʲiu̯bɛsʲidɐ
громадський	ɦrɔmɑd͡zʲsʲkei̯
невмирущий	neu̯meruʃt͡ʃei̯
мексиканський	meksekɑnʲsʲkei̯
авіаз'єднання	ɐʋʲiɐzjɛdnɐnʲːɐ
письменний	pesʲmɛnːei̯
безнадійно	beznɐdʲii̯nɔ
фотографій	fɔtɔɦrɑfʲii̯
електромагнетизм	eɫektrɔmɐɦnetɪzm
підсумовувати	pʲid͡zsʊmɔwʊʋɐte
убивати	ʊbeʋɑte
діл	dʲiɫ
піт	pʲit
винятковий	ʋenʲɐtkɔʋei̯
соромно	sɔrɔmnɔ
парасолька	pɐrɐsɔlʲkɐ
ковтун	kɔu̯tun
існування	isnʊʋɑnʲːɐ
потреба	pɔtrɛbɐ
курс	kurs
чайна	t͡ʃɑi̯nɐ
песимістичний	pesemʲistɪt͡ʃnei̯
молодицях	mɔɫɔdɪt͡sʲɐx
пролетаріат	prɔɫetɐrʲiɑt
привабливість	preʋɑbɫeʋʲisʲtʲ
столітті	stolʲitʲːi
моногамний	mɔnɔɦɑmnei̯
огляд	ɔɦlʲɐd
алегорія	ɐɫeɦɔrʲijɐ
термін	tɛrmʲin
крісло	krʲisɫɔ
варшав'янин	ʋɐrʃɐʋjɑnen
рідина	rʲidenɑ
марний	mɑrnei̯
принизити	prenɪzete
мілітаризація	mʲilʲitɐrezɑt͡sʲijɐ
фільм	fʲilʲm
брат	brɑt
екосистема	ekɔsestɛmɐ
фактично	fɐktɪt͡ʃnɔ
ножовий	nɔʒɔʋɪi̯
соціологія	sɔt͡sʲiɔɫɔɦʲijɐ
душевнохворий	dʊʃeu̯nɔxwɔrei̯
експеримент	eksperemɛnt
соціальний	sɔt͡sʲiɑlʲnei̯
гомосексуаліст	ɦɔmɔseksʊɐlʲist
локшина	ɫɔkʃenɐ
гусак	ɦʊsɑk
наша	nɑʃɐ
енергію	enɛrɦʲijʊ
долоні	dɔɫɔnʲi
баба	bɑbɐ
ломака	ɫɔmɑkɐ
улюбленець	ʊlʲubɫenet͡sʲ
пакет	pɐkɛt
постанова	pɔstɐnɔʋɐ
монополіст	mɔnɔpolʲist
із	iz
п'ять	pjɑtʲ
козаки	kɔzɐkɪ
китаянка	ketɐjɑnkɐ
сусідній	sʊsʲidʲnʲii̯
жебрак	ʒebrɑk
лабораторія	ɫɐbɔrɐtɔrʲijɐ
маріуполь	mɐrʲiupɔlʲ
авангард	ɐʋɐnɦɑrd
взаємодія	wzɐjemodʲijɐ
зелен	zɛɫen
неприйнятний	neprei̯nʲɐtnɪi̯
особисто	ɔsɔbɪstɔ
вирізнятися	ʋerʲizʲnʲɑtesʲɐ
менськ	mɛnʲsʲk
мелодіям	meɫɔdʲijɐm
ампер	ɐmpɛr
родовий	rɔdɔʋei̯
пропустити	prɔpʊstɪte
белград	beɫɦrɑd
аванложа	ɐʋɐnɫɔʒɐ
тато	tɑtɔ
нерухомий	nerʊxɔmei̯
узбекистан	ʊzbekestɑn
ультиматум	ʊlʲtemɑtʊm
провокація	prɔwɔkɑt͡sʲijɐ
українізація	ʊkrɐjinʲizɑt͡sʲijɐ
іванови	iʋɐnɔʋe
фагот	fɐɦɔt
ланцюг	ɫɐnʲt͡sʲuɦ
післязавтра	pʲisʲlʲɐzɑu̯trɐ
вогню	woɦnʲu
обідати	obʲidɐte
мавпа	mɑu̯pɐ
названий	nɑzʋɐnei̯
мікрохвильовка	mʲikrɔxʋelʲɔu̯kɐ
епідемічний	epʲidemʲit͡ʃnei̯
бухарест	bʊxɐrɛst
рецесія	ret͡sɛsʲijɐ
козаків	kɔzɐkʲiu̯
делегатка	deɫeɦɑtkɐ
авіаудар	ɐʋʲiɐʊdɑr
прізвище	prʲizʋeʃt͡ʃe
посередництво	pɔserɛdnet͡stwɔ
конфіскація	kɔnʲfʲiskɑt͡sʲijɐ
палестинський	pɐɫestɪnʲsʲkei̯
познайомитися	pɔznɐjɔmetesʲɐ
пролетар	prɔɫetɑr
жодний	ʒɔdnei̯
дієслово	dʲijesɫɔwɔ
авантюра	ɐʋɐnʲtʲurɐ
фізика	fʲizekɐ
україни	ʊkrɐjine
інфекціях	infɛkt͡sʲijɐx
суверенний	sʊʋerɛnːei̯
вино	ʋenɔ
гаятися	ɦɑjɐtesʲɐ
підошов	pʲidɔʃɔu̯
університет	ʊnʲiʋersetɛt
корова	kɔrɔʋɐ
колодязь	kɔɫɔdʲɐzʲ
одномовність	ɔdnɔmɔu̯nʲisʲtʲ
селянка	selʲɑnkɐ
тому	tomu
чотириста	t͡ʃɔtɪrestɐ
казка	kɑzkɐ
організаціє	ɔrɦɐnʲizɑt͡sʲije
кравець	krɐʋɛt͡sʲ
століттях	stolʲitʲːɐx
чоловіком	t͡ʃɔɫɔʋʲikɔm
неодмінний	neodʲmʲinːei̯
продавщиця	prɔdɐu̯ʃt͡ʃɪt͡sʲɐ
австралія	ɐu̯strɑlʲijɐ
імпотенція	impɔtɛnʲt͡sʲijɐ
рацію	rɑt͡sʲijʊ
інший	inʃei̯
дистанційний	destɐnʲt͡sʲii̯nei̯
здогадатися	zdɔɦɐdɑtesʲɐ
хурма	xʊrmɑ
інтелектуальний	inteɫektʊɑlʲnei̯
ізюм	izʲum
зовні	zɔu̯nʲi
смачного	smɐt͡ʃnɔɦɔ
люди	lʲude
змусити	zmusete
цукор	t͡sukɔr
сенс	sɛns
сповільнити	spɔʋʲilʲnete
будучи	budʊt͡ʃe
дипломів	depɫɔmʲiu̯
сповістити	spɔʋʲistɪte
інфекцією	infɛkt͡sʲijejʊ
дружелюбніший	drʊʒelʲubnʲiʃei̯
албанець	ɐɫbɑnet͡sʲ
шкодити	ʃkɔdete
сполучений	spoɫut͡ʃenei̯
автовізок	ɐu̯tɔʋʲizɔk
кібербезпека	kʲiberbezpɛkɐ
лівий	lʲiʋei̯
обшук	ɔbʃʊk
корисність	kɔrɪsʲnʲisʲtʲ
над	nɑd
кочерга	kɔt͡ʃerɦɑ
утраті	ʊtrɑtʲi
записати	zɐpesɑte
труп	trup
чутливість	t͡ʃʊtɫɪʋʲisʲtʲ
абшит	ɐbʃɪt
спора	spɔrɐ
угода	ʊɦɔdɐ
туристка	tʊrɪstkɐ
друкувати	drʊkʊʋɑte
терпіння	terpʲinʲːɐ
неоніла	neonʲiɫɐ
спортсмен	spɔrt͡smɛn
спроможний	sprɔmɔʒnei̯
парк	pɑrk
незрівнянний	nezʲrʲiu̯nʲɑnːei̯
хата	xɑtɐ
прокинутися	prɔkɪnʊtesʲɐ
дівер	dʲiʋer
опанувати	ɔpɐnʊʋɑte
стандарті	stɐndɑrtʲi
таліях	tɑlʲijɐx
баранина	bɐrɑnenɐ
аскет	ɐskɛt
посібник	posʲibnek
звужувати	zwuʒʊʋɐte
кречет	krɛt͡ʃet
брамами	brɑmɐme
нарешті	nɐrɛʃtʲi
топографія	tɔpɔɦrɑfʲijɐ
повільність	pɔʋʲilʲnʲisʲtʲ
діафрагмами	dʲiɐfrɑɦmɐme
випадок	ʋepɑdɔk
зайченятко	zɐi̯t͡ʃenʲɑtkɔ
суботи	sʊbɔte
знаходити	znɐxɔdete
похітливий	pɔxʲitɫɪʋei̯
зара	zɑrɐ
дата	dɑtɐ
десятеро	dɛsʲɐterɔ
продукт	produkt
певною	pɛu̯nɔjʊ
розвальні	rɔzʋɐlʲnʲi
пониззя	pɔnɪzʲːɐ
взірцеві	wzʲirt͡sɛʋʲi
збрехати	zbrexɑte
ідея	idɛjɐ
злодій	zɫɔdʲii̯
безперервний	bezperɛrwnei̯
слова	sɫɔʋɐ
шапка	ʃɑpkɐ
петицію	petɪt͡sʲijʊ
курятина	kurʲɐtenɐ
виростати	ʋerɔstɑte
гаманець	ɦɐmɐnɛt͡sʲ
омела	ɔmeɫɑ
мило	mɪɫɔ
посилювати	pɔsɪlʲʊʋɐte
японія	jɐpɔnʲijɐ
англія	ɑnɦlʲijɐ
регламентувати	reɦɫɐmentʊʋɑte
храм	xrɑm
демократ	demɔkrɑt
завдання	zɐu̯dɑnʲːɐ
банкнота	bɐnknɔtɐ
сперма	spɛrmɐ
личинка	ɫet͡ʃɪnkɐ
числовий	t͡ʃesɫɔʋɪi̯
імпортувати	impɔrtʊʋɑte
безстроковий	bezstrɔkɔʋei̯
оподаткувати	ɔpɔdɐtkʊʋɑte
паралельний	pɐrɐɫɛlʲnei̯
глобальний	ɦɫɔbɑlʲnei̯
звідки	zʲʋʲidke
диван	deʋɑn
утрати	ʊtrɑte
архонт	ɐrxɔnt
баварія	bɐʋɑrʲijɐ
абзац	ɐbzɑt͡s
користь	kɔresʲtʲ
слухачка	sɫʊxɑt͡ʃkɐ
абсцес	ɐbst͡sɛs
передчуття	pered͡ʒt͡ʃʊtʲːɑ
стрічки	stʲrʲit͡ʃke
вирішити	ʋɪrʲiʃete
ненаголошений	nenɐɦɔɫɔʃenei̯
виправляти	ʋeprɐu̯lʲɑte
феє	fɛje
соха	sɔxɑ
гормональний	ɦɔrmɔnɑlʲnei̯
вибачати	ʋebɐt͡ʃɑte
інновація	inːɔʋɑt͡sʲijɐ
рівний	rʲiu̯nei̯
павук	pɐwuk
розбіжний	rozʲbʲiʒnei̯
серце	sɛrt͡se
доріжка	dorʲiʒkɐ
модель	mɔdɛlʲ
референдуми	referɛndʊme
задовольнити	zɐdɔwɔlʲnɪte
авіапатрулювання	ɐʋʲiɐpɐtrʊlʲʊʋɑnʲːɐ
німеччина	nʲimɛt͡ʃːenɐ
плоть	pɫɔtʲ
києва	kɪjeʋɐ
постачити	pɔstɑt͡ʃete
кілограм	kʲiɫɔɦrɑm
неуважний	neʊʋɑʒnei̯
держпозика	derʒpɔzekɐ
абсолютизування	ɐbsɔlʲʊtezʊʋɑnʲːɐ
новини	nɔʋenɪ
горизонт	ɦɔrezɔnt
ландшафт	ɫɐnd͡ʒʃɑft
вівсе	ʋʲiu̯se
неґура	nɛɡʊrɐ
вагання	ʋɐɦɑnʲːɐ
наук	nɐuk
траплятися	trɐplʲɑtesʲɐ
комедіях	kɔmɛdʲijɐx
тріумфальна	tʲrʲiʊmfɑlʲnɐ
джинси	d͡ʒɪnse
службовий	sɫʊʒbɔʋei̯
етимологія	etemɔɫɔɦʲijɐ
рівність	rʲiu̯nʲisʲtʲ
абак	ɐbɑk
лайно	ɫɐi̯nɔ
здатен	zdɑten
раптом	rɑptɔm
співробітниця	sʲpʲiu̯robʲitnet͡sʲɐ
літера	lʲiterɐ
десертові	desɛrtɔʋʲi
розпитати	rɔzpetɑte
бридкий	bredkɪi̯
вдова	wdɔʋɑ
інтерв'ю	interʋju
празник	prɑznek
музикант	mʊzekɑnt
живець	ʒeʋɛt͡sʲ
господарство	ɦɔspɔdɑrstwɔ
станіслав	stɐnʲisɫɑu̯
доторкнутися	dɔtorknutesʲɐ
економічний	ekɔnomʲit͡ʃnei̯
обговорення	ɔbɦɔwɔrenʲːɐ
бензиновий	benzɪnɔʋei̯
непотрібний	nepotʲrʲibnei̯
багряний	bɐɦrʲɑnei̯
тонна	tɔnːɐ
телеглядач	teɫeɦlʲɐdɑt͡ʃ
автомобілістка	ɐu̯tɔmɔbʲilʲistkɐ
дизентерія	dezenterʲijɐ
шкіра	ʃkʲirɐ
автовідповідач	ɐu̯tɔʋʲidpɔʋʲidɑt͡ʃ
рамено	rɐmɛnɔ
оволодівати	ɔwɔɫɔdʲiʋɑte
піп	pʲip
розпізнавальний	rɔzʲpʲiznɐʋɑlʲnei̯
гріб	ɦrʲib
оглядини	ɔɦlʲɑdene
навчати	nɐu̯t͡ʃɑte
монах	mɔnɑx
талановитий	tɐɫɐnɔʋɪtei̯
горобець	ɦɔrɔbɛt͡sʲ
внаслідок	wnɑsʲlʲidɔk
абстрактний	ɐbstrɑktnei̯
декілька	dɛkʲilʲkɐ
енергіє	enɛrɦʲije
підпорядковувати	pʲidpɔrʲɐdkɔwʊʋɐte
правдивий	prɐu̯dɪʋei̯
автовагон	ɐu̯tɔʋɐɦɔn
ґрунт	ɡrunt
писанка	pɪsɐnkɐ
стабілізація	stɐbʲilʲizɑt͡sʲijɐ
неба	nɛbɐ
створювати	stwɔrʲʊʋɐte
мелодією	meɫɔdʲijejʊ
оцих	ɔt͡sɪx
абажур	ɐbɐʒur
винокур	ʋenokur
отримувати	ɔtrɪmʊʋɐte
частіше	t͡ʃɐsʲtʲiʃe
плюш	plʲuʃ
щока	ʃt͡ʃɔkɑ
салдат	sɐɫdɑt
всередині	ʍserɛdenʲi
чимось	t͡ʃɪmɔsʲ
невидимий	neʋɪdemei̯
передумова	peredʊmɔʋɐ
знедолювати	znedɔlʲʊʋɐte
вітчизняний	ʋʲit͡ʃːɪzʲnʲɐnei̯
вираз	ʋɪrɐz
автобан	ɐu̯tɔbɑn
стезя	stezʲɑ
ту	tu
таджикистан	tɐd͡ʒekestɑn
маргіналізувати	mɐrɦʲinɐlʲizʊʋɑte
заздалегідь	zɐzdɐɫeɦʲidʲ
позитивний	pɔzetɪu̯nei̯
камінь	kɑmʲinʲ
секція	sɛkt͡sʲijɐ
полководець	pɔɫkɔwɔdet͡sʲ
пацієнт	pɐt͡sʲijɛnt
горн	ɦɔrn
вуста	wʊstɑ
різнитися	rʲiznɪtesʲɐ
щоці	ʃt͡ʃot͡sʲi
незнайомка	neznɐjɔmkɐ
поїти	pɔjite
двоє	dwɔje
спрага	sprɑɦɐ
десертам	desɛrtɐm
почати	pɔt͡ʃɑte
інакше	inɑkʃe
плем'я	pɫɛmjɐ
подякувати	pɔdʲɑkʊʋɐte
авдиторія	ɐu̯detɔrʲijɐ
амніоти	ɐmnʲiɔte
смоктати	smɔktɑte
залишитися	zɐɫeʃɪtesʲɐ
ініціатива	inʲit͡sʲiɐtɪʋɐ
гівно	ɦʲiu̯nɔ
настроювати	nɐstrɔjʊʋɐte
деклараціями	dekɫɐrɑt͡sʲijɐme
нерішучий	nerʲiʃut͡ʃei̯
англійський	ɐnɦlʲii̯sʲkei̯
авіашкола	ɐʋʲiɐʃkɔɫɐ
інтерпретація	interpretɑt͡sʲijɐ
херсон	xersɔn
всесвіт	ʍsɛsʲʋʲit
дур	dur
аберація	ɐberɑt͡sʲijɐ
необхідний	neobxʲidnei̯
процвітання	prɔt͡sʲʋʲitɑnʲːɐ
вити	ʋɪte
автогальмо	ɐu̯tɔɦɐlʲmɔ
шестеро	ʃɛsterɔ
чий	t͡ʃɪi̯
гарячий	ɦɐrʲɑt͡ʃei̯
андоррський	ɐndɔrːsʲkei̯
безлюдний	bezʲlʲudnei̯
укріп	ʊkrʲip
тура	tʊrɑ
абсолютистка	ɐbsɔlʲʊtɪstkɐ
умань	umɐnʲ
жаркий	ʒɐrkɪi̯
ішли	iʃɫɪ
двір	dʲʋʲir
безпосередній	bezpɔserɛdʲnʲii̯
рівне	rʲiu̯ne
міліція	mʲilʲit͡sʲijɐ
ліванський	lʲiʋɑnʲsʲkei̯
додатки	dɔdɑtke
співробітництво	sʲpʲiu̯robʲitnet͡stwɔ
жадоба	ʒɐdɔbɐ
медовий	medɔʋei̯
шию	ʃɪjʊ
авіаметеостанція	ɐʋʲiɐmeteɔstɑnʲt͡sʲijɐ
гніздо	ɦnʲizdɔ
ящик	jɑʃt͡ʃek
суверенітет	sʊʋerenʲitɛt
першокласний	perʃɔkɫɑsnei̯
тощо	tɔʃt͡ʃɔ
нерідко	nerʲidkɔ
проститися	prɔstɪtesʲɐ
сезон	sezɔn
врем'я	wrɛmjɐ
бездумний	bezdumnei̯
вікісловником	ʋʲikʲisɫɔu̯nekɔm
графік	ɦrɑfʲik
туніс	tʊnʲis
охоплювати	ɔxɔplʲʊʋɐte
шина	ʃɪnɐ
рутинний	rʊtɪnːei̯
ведуча	ʋedut͡ʃɐ
допустити	dɔpʊstɪte
тринадцятий	trenɑd͡zʲt͡sʲɐtei̯
спина	spɪnɐ
закуповувати	zɐkʊpɔwʊʋɐte
нежуйні	neʒui̯nʲi
каплиці	kɐpɫɪt͡sʲi
до	dɔ
черняк	t͡ʃernʲɑk
мастурбувати	mɐstʊrbʊʋɑte
винахідливий	ʋenɐxʲidɫeʋei̯
дикобраз	dekɔbrɑz
варіант	ʋɐrʲiɑnt
еротичний	erɔtɪt͡ʃnei̯
мето	mɛtɔ
об'єднати	ɔbjednɑte
долонях	dɔɫɔnʲɐx
розліт	rozʲlʲit
фотографіями	fɔtɔɦrɑfʲijɐme
стилістика	stelʲistekɐ
монархіями	mɔnɑrxʲijɐme
пательня	pɐtɛlʲnʲɐ
пам'ять	pɑmjɐtʲ
валець	ʋɐɫɛt͡sʲ
хірург	xʲirurɦ
вподобайка	ʍpɔdɔbɑi̯kɐ
відповідь	ʋʲidpɔʋʲidʲ
абсентеїзм	ɐbsentejizm
кишень	keʃɛnʲ
ковадло	kɔʋɑdɫɔ
молодиця	mɔɫɔdɪt͡sʲɐ
комусь	kɔmʊsʲ
книжковий	kneʒkɔʋei̯
горизонтами	ɦɔrezɔntɐme
сформулювати	sfɔrmʊlʲʊʋɑte
щиколотки	ʃt͡ʃɪkɔɫɔtke
раса	rɑsɐ
бруднити	brʊdnɪte
лосось	ɫɔsɔsʲ
реабілітаційний	reɐbʲilʲitɐt͡sʲii̯nei̯
бібліоманія	bʲiblʲiɔmɑnʲijɐ
скасувати	skɐsʊʋɑte
завадити	zɐʋɑdete
заповнювати	zɐpɔu̯nʲʊʋɐte
байрак	bɐi̯rɑk
система	sestɛmɐ
еротика	erɔtekɐ
мовознавець	mɔwɔznɑʋet͡sʲ
руїна	rʊjinɐ
сусанна	sʊsɑnːɐ
біг	bʲiɦ
правда	prɑu̯dɐ
абстинент	ɐbstenɛnt
доходити	dɔxɔdete
зателефонувати	zɐteɫefɔnʊʋɑte
справжнє	sprɑu̯ʒnʲe
доброчесність	dɔbrɔt͡ʃɛsʲnʲisʲtʲ
від'їбатися	ʋʲidjibɑtesʲɐ
зайвий	zɑjʋei̯
пішоходами	pʲiʃɔxɔdɐme
плющ	plʲuʃt͡ʃ
замовник	zɐmɔu̯nek
кількість	kʲilʲkʲisʲtʲ
авіаперевізник	ɐʋʲiɐpereʋʲiznek
піддержати	pʲidːɛrʒɐte
прикметник	prekmɛtnek
проблематичний	prɔbɫemɐtɪt͡ʃnei̯
застосування	zɐstɔsʊʋɑnʲːɐ
польський	pɔlʲsʲkei̯
радо	rɑdɔ
рилу	rɪɫʊ
консалтинговий	kɔnsɑɫtenɦɔʋei̯
піхвовий	pʲixwɔʋei̯
навіщо	nɐʋʲiʃt͡ʃɔ
сплачувати	spɫɑt͡ʃʊʋɐte
головно	ɦɔɫɔu̯nɔ
буквальний	bʊkʋɑlʲnei̯
підписка	pʲidpɪskɐ
вірувати	ʋʲirʊʋɐte
декларацій	dekɫɐrɑt͡sʲii̯
навчання	nɐu̯t͡ʃɑnʲːɐ
вольний	wɔlʲnei̯
позаземний	pɔzɐzɛmnei̯
помити	pɔmɪte
вівсах	ʋʲiu̯sɐx
богдана	bɔɦdɑnɐ
об'єднання	ɔbjednɑnʲːɐ
витрата	ʋɪtrɐtɐ
фальсифікація	fɐlʲsefʲikɑt͡sʲijɐ
жир	ʒɪr
матерія	mɐtɛrʲijɐ
самовладання	sɐmɔu̯ɫɐdɑnʲːɐ
спожити	spɔʒɪte
мама	mɑmɐ
істотний	istɔtnei̯
навколосвітній	nɐu̯kɔɫɔsʲʋʲitʲnʲii̯
традиційний	trɐdet͡sʲii̯nei̯
бомба	bɔmbɐ
позавчора	pɔzɐu̯t͡ʃɔrɐ
мати	mɑte
поговорити	pɔɦɔwɔrɪte
танцюристки	tɐnʲt͡sʲʊrɪstke
звернути	zʋernute
кислотність	kesɫɔtʲnʲisʲtʲ
безкраїй	bezkrɑjii̯
ніздрями	nʲizdʲrʲɐme
пошукати	pɔʃʊkɑte
гравітаційний	ɦrɐʋʲitɐt͡sʲii̯nei̯
феномен	fenɔmen
вчора	ʍt͡ʃɔrɐ
печиву	pɛt͡ʃewʊ
бізнес	bʲiznes
цифровий	t͡sefrɔʋɪi̯
сміливість	sʲmʲiɫɪʋʲisʲtʲ
баддя	bɐdʲːɑ
торгівля	torɦʲiu̯lʲɐ
діалог	dʲiɐɫɔɦ
сорока	sɔrɔkɐ
виконати	ʋɪkɔnɐte
цікавитися	t͡sʲikɑʋetesʲɐ
словечок	sɫɔʋɛt͡ʃɔk
восьмитисячний	wɔsʲmetɪsʲɐt͡ʃnei̯
вами	ʋɑme
кацап	kɐt͡sɑp
абатство	ɐbɑt͡stwɔ
непитущий	nepetuʃt͡ʃei̯
варшава	ʋɐrʃɑʋɐ
губернатор	ɦʊbernɑtɔr
несмачний	nesmɐt͡ʃnɪi̯
уповноважити	ʊpɔu̯nɔʋɑʒete
лом	ɫɔm
авіасекстант	ɐʋʲiɐsekstɑnt
скарга	skɑrɦɐ
молодицю	mɔɫɔdɪt͡sʲʊ
завтрашній	zɑu̯trɐʃnʲii̯
домініка	dɔmʲinʲikɐ
позначитися	pɔznɑt͡ʃetesʲɐ
співвітчизник	sʲpʲiʋʲːit͡ʃːɪznek
референдумові	referɛndʊmɔʋʲi
белґрад	beɫɡrɑd
меншина	menʃɪnɐ
землетрус	zemɫetrus
проконтролювати	prɔkɔntrɔlʲʊʋɑte
обчислити	ɔbt͡ʃɪsɫete
чебрець	t͡ʃebrɛt͡sʲ
кібуц	kʲibut͡s
краватка	krɐʋɑtkɐ
безнадійний	beznɐdʲii̯nei̯
угорець	ʊɦɔret͡sʲ
авокадо	ɐwɔkɑdɔ
пуп	pup
доброзичливий	dɔbrɔzɪt͡ʃɫeʋei̯
світ	sʲʋʲit
отримати	ɔtrɪmɐte
наявний	nɐjɑu̯nei̯
рушниця	rʊʃnɪt͡sʲɐ
пральна	prɑlʲnɐ
марихуана	mɐrexʊɑnɐ
ненавмисний	nenɐu̯mɪsnei̯
засада	zɐsɑdɐ
абляція	ɐblʲɑt͡sʲijɐ
кий	kɪi̯
диск	dɪsk
розглядати	rɔzɦlʲɐdɑte
інструкція	instrukt͡sʲijɐ
верес	ʋɛres
фізіологія	fʲizʲiɔɫɔɦʲijɐ
дев'ятнадцять	deʋjɐtnɑd͡zʲt͡sʲɐtʲ
визначити	ʋɪznɐt͡ʃete
мід	mʲid
лоно	ɫɔnɔ
авантурниця	ɐʋɐnturnet͡sʲɐ
перебувати	perebʊʋɑte
хвилювати	xʋelʲʊʋɑte
візантійський	ʋʲizɐnʲtʲii̯sʲkei̯
гірський	ɦʲirsʲkɪi̯
акула	ɐkuɫɐ
планування	pɫɐnʊʋɑnʲːɐ
декларацією	dekɫɐrɑt͡sʲijejʊ
холоднокровність	xɔɫɔdnɔkrɔu̯nʲisʲtʲ
логарифм	ɫɔɦɐrɪfm
ненароджений	nenɐrɔd͡ʒenei̯
піхва	pʲixʋɐ
яблуня	jɑbɫʊnʲɐ
консультантка	kɔnsʊlʲtɑntkɐ
започаткувати	zɐpɔt͡ʃɐtkʊʋɑte
бабуся	bɐbusʲɐ
підкоряти	pʲidkɔrʲɑte
зруйнувати	zrʊi̯nʊʋɑte
юлія	julʲijɐ
епізод	epʲizɔd
галюцинація	ɦɐlʲʊt͡senɑt͡sʲijɐ
характерний	xɐrɑkternei̯
лісоруб	lʲisorub
слівцем	sʲlʲiu̯t͡sɛm
коливання	kɔɫeʋɑnʲːɐ
параліч	pɐrɑlʲit͡ʃ
підвищувати	pʲidʋɪʃt͡ʃʊʋɐte
поступово	pɔstʊpɔwɔ
стомлювати	stɔmlʲʊʋɐte
сукня	suknʲɐ
приїхати	prejixɐte
озимий	ɔzɪmei̯
договірний	dɔɦɔʋʲirnei̯
спричинювати	spret͡ʃɪnʲʊʋɐte
надіє	nɐdʲije
універсальність	ʊnʲiʋersɑlʲnʲisʲtʲ
барвник	bɐrwnɪk
купування	kʊpʊʋɑnʲːɐ
довго	dɔu̯ɦɔ
авіапасажир	ɐʋʲiɐpɐsɐʒɪr
свідок	sʲʋʲidɔk
склад	skɫɑd
вію	ʋʲijʊ
своя	swɔjɑ
кишки	kɪʃke
крук	kruk
обчислювати	ɔbt͡ʃɪsʲlʲʊʋɐte
імперії	impɛrʲiji
батярка	bɑtʲɐrkɐ
плече	pɫet͡ʃɛ
долоня	dɔɫɔnʲɐ
оцю	ot͡sʲu
гнідий	ɦnʲidɪi̯
симетричний	semetrɪt͡ʃnei̯
умерти	ʊmɛrte
проживати	prɔʒeʋɑte
дунай	dʊnɑi̯
українськими	ʊkrɐjinʲsʲkeme
танцюристок	tɐnʲt͡sʲʊrɪstɔk
думках	dʊmkɑx
вимкнути	ʋɪmknʊte
мандрівник	mɐndʲrʲiu̯nek
комедіям	kɔmɛdʲijɐm
зараза	zɐrɑzɐ
таце	tɑt͡se
плівка	plʲiu̯kɐ
лицарський	ɫɪt͡sɐrsʲkei̯
угорка	ʊɦɔrkɐ
виробництво	ʋerɔbnɪt͡stwɔ
окрім	okrʲim
відлякати	ʋʲidʲlʲɐkɑte
гормонів	ɦɔrmɔnʲiu̯
орбітам	orbʲitɐm
чудово	t͡ʃʊdɔwɔ
п'ята	pjɐtɑ
гратися	ɦrɑtesʲɐ
розв'язати	rɔzʋjɐzɑte
авіадивізія	ɐʋʲiɐdeʋʲizʲijɐ
весільний	ʋesʲilʲnei̯
периферія	pereferʲijɐ
ракета	rɐkɛtɐ
п'ятисотий	pjɐtesɔtei̯
ексгібіціоністський	eɡzʲɦʲibʲit͡sʲionʲisʲkei̯
мошонка	mɔʃɔnkɐ
господиня	ɦɔspɔdɪnʲɐ
підошвах	pʲidɔʃʋɐx
скрутний	skrʊtnɪi̯
наші	nɑʃʲi
п'ятдесят	pjɐdesʲɑt
пішохідний	pʲiʃoxʲidnei̯
повіко	pɔʋʲikɔ
президентство	prezedɛnstwɔ
амнезія	ɐmnezʲijɐ
їжак	jiʒɑk
секта	sɛktɐ
поліпшити	polʲipʃete
автобіографічність	ɐu̯tɔbʲiɔɦrɐfʲit͡ʃnʲisʲtʲ
інтелектуалізація	inteɫektʊɐlʲizɑt͡sʲijɐ
супругами	sʊpruɦɐme
гітара	ɦʲitɑrɐ
насолодитися	nɐsɔɫɔdɪtesʲɐ
довіра	dɔʋʲirɐ
падь	pɑdʲ
лісова	lʲisɔʋɑ
аналіз	ɐnɑlʲiz
дискусія	deskusʲijɐ
дивізіє	deʋʲizʲije
діловодство	dʲiɫɔwɔd͡zstwɔ
революційний	rewɔlʲʊt͡sʲii̯nei̯
скульптурний	skʊlʲpturnei̯
пацієнтка	pɐt͡sʲijɛntkɐ
цій	t͡sʲii̯
покруч	pɔkrʊt͡ʃ
порожній	pɔrɔʒnʲii̯
референдумом	referɛndʊmɔm
м'яза	mjɑzɐ
метр	mɛtr
липнем	ɫɪpnem
костянтин	kɔsʲtʲɐntɪn
ватра	ʋɑtrɐ
кросівка	krosʲiu̯kɐ
небеса	nebesɑ
менталітет	mentɐlʲitɛt
купи	kʊpɪ
свіча	sʲʋʲit͡ʃɐ
авіакаса	ɐʋʲiɐkɑsɐ
геофізика	ɦeofʲizekɐ
катастрофу	kɐtɐstrɔfʊ
клавіатур	kɫɐʋʲiɐtur
давньоримський	dɐu̯nʲɔrɪmsʲkei̯
ваду	ʋɑdʊ
приміряти	premʲirʲɑte
афганістан	ɐvɦɐnʲistɑn
лежати	ɫeʒɑte
сокира	sɔkɪrɐ
дошка	dɔʃkɐ
розбіжність	rozʲbʲiʒnʲisʲtʲ
згода	zɦɔdɐ
тунелям	tʊnɛlʲɐm
порівняння	pɔrʲiu̯nʲɑnʲːɐ
нескладовий	neskɫɐdɔʋɪi̯
бронза	brɔnzɐ
нудьга	nʊdʲɦɑ
темний	tɛmnei̯
безтурботний	beztʊrbɔtnei̯
щиколотка	ʃt͡ʃɪkɔɫɔtkɐ
абіссінець	ɐbʲisʲːinet͡sʲ
токсичний	tɔksɪt͡ʃnei̯
очиці	ɔt͡ʃɪt͡sʲi
населений	nɐsɛɫenei̯
бородатий	bɔrɔdɑtei̯
рація	rɑt͡sʲijɐ
ґанок	ɡɑnɔk
раб	rɑb
покриття	pɔkretʲːɑ
пригода	preɦɔdɐ
шестигранник	ʃesteɦrɑnːek
застрахувати	zɐstrɐxʊʋɑte
тупий	tʊpɪi̯
імунізація	imʊnʲizɑt͡sʲijɐ
епіфіз	epʲifʲiz
противник	prɔtɪu̯nek
козаку	kɔzɐku
сумісність	sʊmʲisʲnʲisʲtʲ
супрузі	sʊpruzʲi
народитися	nɐrɔdɪtesʲɐ
танець	tɐnɛt͡sʲ
дев'яти	deʋjɐtɪ
фонд	fɔnd
прожити	prɔʒɪte
дисертацій	desertɑt͡sʲii̯
мелодії	meɫɔdʲiji
обопільний	ɔbopʲilʲnei̯
книжку	knɪʒkʊ
пустеля	pʊstɛlʲɐ
застосувати	zɐstɔsʊʋɑte
інцидентів	int͡sedɛnʲtʲiu̯
надто	nɑdtɔ
словенський	sɫɔʋɛnʲsʲkei̯
купати	kʊpɑte
звітувати	zʲʋʲitʊʋɑte
сумочка	sumɔt͡ʃkɐ
метро	metrɔ
діаспора	dʲiɑspɔrɐ
думку	dumkʊ
політ	polʲit
концентрації	kɔnt͡sentrɑt͡sʲiji
взагалі	wzɐɦɐlʲi
урізноманітнювати	ʊrʲiznɔmɐnʲitʲnʲʊʋɐte
документація	dɔkʊmentɑt͡sʲijɐ
комар	kɔmɑr
морський	mɔrsʲkɪi̯
молотьба	mɔɫɔdʲbɑ
взаємозалежність	wzɐjemɔzɐɫɛʒnʲisʲtʲ
терен	terɛn
застудитися	nɐrɔdɪtesʲɐ
займатися	zɐi̯mɑtesʲɐ
патент	pɐtɛnt
карлик	kɑrɫek
оголосити	ɔɦɔɫɔsɪte
мапа	mɑpɐ
верф	ʋɛrf
одержувачів	ɔdɛrʒʊʋɐt͡ʃʲiu̯
портативний	pɔrtɐtɪu̯nei̯
великомучениця	ʋeɫekomut͡ʃenet͡sʲɐ
прилюдний	prelʲudnei̯
софія	sofʲijɐ
нарік	nɐrʲik
фосфор	fɔsfɔr
лоза	ɫɔzɑ
занурити	zɐnurete
літ	lʲit
ярмарок	jɑrmɐrɔk
прогресивний	prɔɦresɪu̯nei̯
мак	mɑk
голландка	ɦɔɫːɑndkɐ
зона	zɔnɐ
антибіотиками	ɐntebʲiɔtekɐme
шептати	ʃeptɑte
посередництва	pɔserɛdnet͡stʋɐ
мігрант	mʲiɦrɑnt
кампанія	kɐmpɑnʲijɐ
подробиці	pɔdrɔbet͡sʲi
недосвідчений	nedɔsʲʋʲid͡ʒt͡ʃenei̯
застуджуватися	zɐstud͡ʒʊʋɐtesʲɐ
слов'янам	sɫɔʋjɑnɐm
функціональний	fʊnkt͡sʲiɔnɑlʲnei̯
огайо	ɔɦɑjɔ
гнати	ɦnɑte
півкуля	pʲiu̯kulʲɐ
мука	mukɐ
можливість	mɔʒɫɪʋʲisʲtʲ
хрестоносець	xrestɔnɔset͡sʲ
розділ	rɔzʲdʲiɫ
швейцарія	ʃʋei̯t͡sɑrʲijɐ
близнюк	bɫezʲnʲuk
додатками	dɔdɑtkɐme
чо	t͡ʃɔ
зустрітися	zʊstʲrʲitesʲɐ
малярство	mɐlʲɑrstwɔ
відповідальність	ʋʲidpɔʋʲidɑlʲnʲisʲtʲ
монархіє	mɔnɑrxʲije
царство	t͡sɑrstwɔ
анонімність	ɐnonʲimnʲisʲtʲ
геометричний	ɦeɔmetrɪt͡ʃnei̯
битвам	bɪtʋɐm
легеневий	ɫeɦenɛʋei̯
дружина	drʊʒɪnɐ
драматургічний	drɐmɐtʊrɦʲit͡ʃnei̯
виникнути	ʋɪneknʊte
монако	mɔnɑkɔ
рапс	rɑps
промисловість	prɔmesɫɔʋʲisʲtʲ
піддержувати	pʲidːɛrʒʊʋɐte
одягати	ɔdʲɐɦɑte
шовк	ʃɔu̯k
кислота	kesɫɔtɑ
чотири	t͡ʃɔtɪre
запитати	zɐpetɑte
гордість	ɦɔrdʲisʲtʲ
запозичити	zɐpɔzɪt͡ʃete
нас	nɑs
кудись	kʊdɪsʲ
піл	pʲiɫ
віл	ʋʲiɫ
дужий	duʒei̯
мечем	met͡ʃɛm
слов'янина	sɫɔʋjɐnɪnɐ
безпорадний	bezpɔrɑdnei̯
приклад	prɪkɫɐd
постіль	posʲtʲilʲ
спогад	spɔɦɐd
замість	zɐmʲisʲtʲ
письменниця	pesʲmɛnːet͡sʲɐ
аероскопія	ɐerɔskopʲijɐ
чесний	t͡ʃɛsnei̯
насамперед	nɐsɑmpered
збільшувати	zʲbʲilʲʃʊʋɐte
шум	ʃum
безжурний	beʒːurnei̯
справами	sprɑʋɐme
розвідати	rɔzʲʋʲidɐte
ланцюжок	ɫɐnʲt͡sʲʊʒɔk
мінімалістичний	mʲinʲimɐlʲistɪt͡ʃnei̯
діафрагмо	dʲiɐfrɑɦmɔ
співачка	sʲpʲiʋɑt͡ʃkɐ
геополітика	ɦeɔpolʲitekɐ
рильцю	rɪlʲt͡sʲʊ
імператорський	imperɑtɔrsʲkei̯
безробіття	bezrobʲitʲːɐ
цитрина	t͡setrɪnɐ
евакуація	eʋɐkʊɑt͡sʲijɐ
дохід	doxʲid
агресор	ɐɦrɛsɔr
підтримати	pʲidtrɪmɐte
відлетіти	ʋʲidɫetʲite
маршрут	mɐrʃrut
мету	metu
певний	pɛu̯nei̯
протест	prɔtɛst
пішки	pʲiʃke
мох	mɔx
вибудувати	ʋɪbʊdʊʋɐte
вчинити	ʍt͡ʃenɪte
егоїстичний	eɦɔjistɪt͡ʃnei̯
бубна	bubnɐ
тисячоліть	tesʲɐt͡ʃolʲitʲ
багаття	bɐɦɑtʲːɐ
фах	fɑx
танцюристів	tɐnʲt͡sʲʊrɪsʲtʲiu̯
авран	ɐu̯rɑn
словаччина	sɫɔʋɑt͡ʃːenɐ
мого	mɔɦɔ
авіаторпеда	ɐʋʲiɐtɔrpɛdɐ
ярмо	jɐrmɔ
каштановий	kɐʃtɑnɔʋei̯
безробітний	bezrobʲitnei̯
зразка	zrɐzkɑ
паузі	pɑʊzʲi
сухожилля	sʊxɔʒɪlʲːɐ
попільний	pɔpʲilʲnei̯
зрілий	zʲrʲiɫei̯
передумати	peredumɐte
амфібія	ɐmfʲibʲijɐ
хабар	xɐbɑr
мильний	mɪlʲnei̯
платформа	pɫɐtfɔrmɐ
збіжжя	zʲbʲiʒʲːɐ
таємницю	tɐjemnɪt͡sʲʊ
уявлення	ʊjɑu̯ɫenʲːɐ
тротуарів	trɔtʊɑrʲiu̯
гендерний	ɦɛndernei̯
оглядати	ɔɦlʲɐdɑte
технологічний	texnɔɫoɦʲit͡ʃnei̯
різнити	rʲiznɪte
проіндексувати	prɔindeksʊʋɑte
поліціям	polʲit͡sʲijɐm
весь	ʋɛsʲ
сеул	seuɫ
табір	tɑbʲir
виснажити	ʋɪsnɐʒete
санкціонувати	sɐnkt͡sʲiɔnʊʋɑte
травлення	trɑu̯ɫenʲːɐ
станцією	stɑnʲt͡sʲijejʊ
переосмислити	pereɔsmɪsɫete
засмутити	zɐsmʊtɪte
технократичний	texnɔkrɐtɪt͡ʃnei̯
товариш	tɔʋɑreʃ
роділля	rodʲilʲːɐ
відлітати	ʋʲidʲlʲitɑte
посполу	pɔspɔɫʊ
тригліцерид	treɦlʲit͡serɪd
молитовник	mɔɫetɔu̯nek
гидкий	ɦedkɪi̯
гордитися	ɦɔrdɪtesʲɐ
вільнодумка	ʋʲilʲnodumkɐ
палка	pɑɫkɐ
брухт	bruxt
приручити	prerʊt͡ʃɪte
руйнувати	rʊi̯nʊʋɑte
патріарх	pɐtʲrʲiɑrx
гріх	ɦrʲix
зайнятися	zɐi̯nʲɑtesʲɐ
заручати	zɐrʊt͡ʃɑte
десерті	desɛrtʲi
усунути	ʊsunʊte
лимон	ɫemɔn
дивізіям	deʋʲizʲijɐm
схожий	sxɔʒei̯
відстояти	ʋʲid͡zstɔjɑte
пожежник	pɔʒɛʒnek
зниження	znɪʒenʲːɐ
шумливий	ʃʊmɫɪʋei̯
комендантська	kɔmendɑnʲsʲkɐ
друзями	druzʲɐme
велиґдень	ʋeɫɪɡdenʲ
тактовність	tɐktɔu̯nʲisʲtʲ
дзвін	d͡zʲʋʲin
дев'яностий	deʋjɐnɔstei̯
доброзичливець	dɔbrɔzɪt͡ʃɫeʋet͡sʲ
терплячий	terplʲɑt͡ʃei̯
мітла	mʲitɫɑ
емоціє	emɔt͡sʲije
космополітичний	kɔsmɔpɔlʲitɪt͡ʃnei̯
трактор	trɑktɔr
аврора	ɐu̯rɔrɐ
початкова	pɔt͡ʃɐtkɔʋɐ
ісландець	isɫɑndet͡sʲ
речення	rɛt͡ʃenʲːɐ
анафема	ɐnɑfemɐ
яків	jɑkʲiu̯
чотирнадцятий	t͡ʃɔternɑd͡zʲt͡sʲɐtei̯
перехідний	perexʲidnɪi̯
лекції	ɫɛkt͡sʲiji
зобов'язати	zɔbɔʋjɐzɑte
печив	pɛt͡ʃeu̯
незалежність	nezɐɫɛʒnʲisʲtʲ
тлустий	tɫustei̯
сліпий	sʲlʲipɪi̯
одружуватися	odruʒʊʋɐtesʲɐ
приклад	prekɫɑd
завіса	zɐʋʲisɐ
ніздрі	nʲizdʲrʲi
спортсменка	spɔrt͡smɛnkɐ
пунктуальність	pʊnktʊɑlʲnʲisʲtʲ
граматика	ɦrɐmɑtekɐ
переобирати	pereɔberɑte
синтез	sɪntez
бунт	bunt
незадовільний	nezɐdɔʋʲilʲnei̯
щоко	ʃt͡ʃɔkɔ
українського	ʊkrɐjinʲsʲkɔɦɔ
половина	pɔɫɔʋɪnɐ
печивах	pɛt͡ʃeʋɐx
знайтися	znɐi̯tɪsʲɐ
організаційний	ɔrɦɐnʲizɐt͡sʲii̯nei̯
обов'язок	ɔbɔʋjɐzɔk
американізм	ɐmerekɐnʲizm
сіни	sʲine
сприятливий	sprejɑtɫeʋei̯
початок	pɔt͡ʃɑtɔk
агролісівництво	ɐɦrɔlʲisʲiu̯nɪt͡stwɔ
принижувати	prenɪʒʊʋɐte
грішний	ɦrʲiʃnei̯
приходько	prexɔdʲkɔ
сестрицею	sestrɪt͡sejʊ
перепросити	pereprɔsɪte
одна	ɔdnɑ
луг	ɫuɦ
адепт	ɐdɛpt
бібліофіл	bʲiblʲiofʲiɫ
бонусові	bɔnʊsɔʋʲi
дошках	dɔʃkɐx
лексикограф	ɫeksekɔɦrɐf
семитисячний	semetɪsʲɐt͡ʃnei̯
шибеницею	ʃɪbenet͡sejʊ
аванс	ɐʋɑns
борщ	bɔrʃt͡ʃ
співіснувати	sʲpʲiʋʲisnʊʋɑte
змога	zmɔɦɐ
набій	nɐbʲii̯
сумління	sʊmlʲinʲːɐ
реагувати	reɐɦʊʋɑte
відділити	ʋʲidʲːiɫɪte
мінімальна	mʲinʲimɑlʲnɐ
надання	nɐdɐnʲːɑ
життєпис	ʒetʲːɛpes
вибудовувати	ʋebʊdɔwʊʋɐte
майбутнє	mɐi̯butʲnʲe
дядьо	dʲɑdʲɔ
зарубіжжя	zɐrʊbʲiʒʲːɐ
приятель	prɪjɐtelʲ
селянський	selʲɑnʲsʲkei̯
комп'ютерний	kɔmpjuternei̯
ґнотовий	ɡnɔtɔʋɪi̯
китаєць	ketɑjet͡sʲ
скорий	skɔrei̯
вічність	ʋʲit͡ʃnʲisʲtʲ
конотоп	kɔnɔtɔp
обдурити	ɔbdʊrɪte
мрію	mrʲijʊ
заклад	zɐkɫɑd
назви	nɑzʋe
чорнило	t͡ʃɔrnɪɫɔ
біомедицина	bʲiɔmedet͡sɪnɐ
свій	sʲʋʲii̯
зовсім	zɔu̯sʲim
кельнер	kɛlʲner
другу	druɦʊ
інформаційний	infɔrmɐt͡sʲii̯nei̯
застуду	zɐstudʊ
тепло	tɛpɫɔ
лікарень	lʲikɑrenʲ
самогон	sɐmɔɦɔn
хіба	xʲibɑ
постіль	pɔsʲtʲilʲ
компонент	kɔmpɔnɛnt
повторення	pɔu̯tɔrenʲːɐ
любити	lʲʊbɪte
естетика	estɛtekɐ
скронею	skrɔnejʊ
авіахімовець	ɐʋʲiɐxʲimɔʋet͡sʲ
каплицею	kɐpɫɪt͡sejʊ
експрес	eksprɛs
передусім	peredʊsʲim
матеріал	mɐterʲiɑɫ
пішоходам	pʲiʃɔxɔdɐm
галявина	ɦɐlʲɑʋenɐ
мірою	mʲirɔjʊ
почистити	pɔt͡ʃɪstete
вишиванка	ʋeʃeʋɑnkɐ
збагатити	zbɐɦɐtɪte
розмовний	rɔzmɔu̯nei̯
аболіціонізм	ɐbɔlʲit͡sʲionʲizm
совок	sɔwɔk
ґнотик	ɡnɔtek
варіантом	ʋɐrʲiɑntɔm
кухня	kuxnʲɐ
кредитний	kredɪtnei̯
консультант	kɔnsʊlʲtɑnt
частий	t͡ʃɑstei̯
алегоричний	ɐɫeɦɔrɪt͡ʃnei̯
семантичний	temɐtɪt͡ʃnei̯
парламент	pɐrɫɑment
про	prɔ
скульпторка	skulʲptɔrkɐ
чоловікові	t͡ʃɔɫɔʋʲikɔʋʲi
понеділок	pɔnedʲiɫɔk
порада	pɔrɑdɐ
тамада	tɐmɐdɑ
арфа	ɑrfɐ
долонею	dɔɫɔnejʊ
варшавський	ʋɐrʃɑu̯sʲkei̯
історія	istɔrʲijɐ
мексика	mɛksekɐ
народ	nɐrɔd
всесвітній	ʍsesʲʋʲitʲnʲii̯
розорений	rɔzɔrenei̯
ембріональний	embrʲiɔnɑlʲnei̯
аналогія	ɐnɐɫɔɦʲijɐ
гроші	ɦrɔʃʲi
густий	ɦʊstɪi̯
гербата	ɦerbɑtɐ
чаша	t͡ʃɑʃɐ
вівтарний	ʋʲiu̯tɐrnei̯
луганськ	ɫʊɦɑnʲsʲk
словниками	sɫɔu̯nekɑme
сеча	sɛt͡ʃɐ
змушувати	zmuʃʊʋɐte
помана	pɔmɑnɐ
сегрегація	seɦreɦɑt͡sʲijɐ
продаж	prɔdɐʒ
знаряддя	znɐrʲɑdʲːɐ
ємен	jɛmen
таємницями	tɐjemnɪt͡sʲɐme
орбітами	orbʲitɐme
пісок	pʲisɔk
викреслити	ʋɪkresɫete
делікатний	delʲikɑtnei̯
додатку	dɔdɑtkʊ
друкуватися	drʊkʊʋɑtesʲɐ
прозорий	prɔzɔrei̯
аб'юрація	ɐbjʊrɑt͡sʲijɐ
інфраструктура	infrɐstrʊkturɐ
знеохочувати	zneɔxɔt͡ʃʊʋɐte
одинадцятий	ɔdenɑd͡zʲt͡sʲɐtei̯
неформальний	nefɔrmɑlʲnei̯
ненавидіти	nenɐʋɪdʲite
номенклатурний	nɔmenkɫɐturnei̯
громадянських	ɦrɔmɐdʲɑnʲsʲkex
оптичний	ɔptɪt͡ʃnei̯
гвинт	ɦʋɪnt
оцьому	ɔt͡sʲomu
навколо	nɐu̯kɔɫɔ
підводний	pʲidwɔdnei̯
медалі	medɑlʲi
ювілей	jʊʋʲiɫɛi̯
приносити	prenɔsete
подробицю	pɔdrɔbet͡sʲʊ
одержати	ɔdɛrʒɐte
заздрісний	zɑzdʲrʲisnei̯
догадуватися	dɔɦɑdʊʋɐtesʲɐ
спровокувати	sprɔwɔkʊʋɑte
швидкий	ʃʋedkɪi̯
забруднення	zɐbrudnenʲːɐ
індійський	inʲdʲii̯sʲkei̯
майя	mɑi̯jɐ
княгині	knʲɐɦɪnʲi
рівномірний	rʲiu̯nomʲirnei̯
заїр	zɐjir
ситуаціям	setʊɑt͡sʲijɐm
вівтар	ʋʲiu̯tɑr
передбачати	peredbɐt͡ʃɑte
яблучний	jɑbɫʊt͡ʃnei̯
вечер	ʋet͡ʃɛr
незручність	nezrut͡ʃnʲisʲtʲ
стріляти	stʲrʲilʲɑte
повітряний	pɔʋʲitʲrʲɐnei̯
спеціалізація	spet͡sʲiɐlʲizɑt͡sʲijɐ
референдумів	referɛndʊmʲiu̯
федір	fɛdʲir
упевнений	ʊpɛu̯nenei̯
гарантія	ɦɐrɑnʲtʲijɐ
інерція	inɛrt͡sʲijɐ
левеня	ɫeʋenʲɑ
сукне	sukne
превентивний	preʋentɪu̯nei̯
самовпевнений	sɐmɔu̯pɛu̯nenei̯
упасти	ʊpɑste
легалізувати	ɫeɦɐlʲizʊʋɑte
господині	ɦɔspɔdɪnʲi
вечеря	ʋet͡ʃɛrʲɐ
розповсюджувати	rɔzpɔu̯sʲud͡ʒʊʋɐte
мотоциклами	mɔtɔt͡sɪkɫɐme
співробітник	sʲpʲiu̯robʲitnek
дозвілля	dɔzʲʋʲilʲːɐ
вією	ʋʲijejʊ
дипломатичний	depɫɔmɐtɪt͡ʃnei̯
цвинтар	t͡sʋɪntɐr
заколот	zɑkɔɫɔt
гана	ɦɑnɐ
моїми	mɔjime
найвродливіший	nɐjwrɔdɫɪʋʲiʃei̯
пивоварня	pewɔʋɑrnʲɐ
священник	sʲʋʲɐʃt͡ʃɛnːek
сідницях	sʲidnɪt͡sʲɐx
адаптація	ɐdɐptɑt͡sʲijɐ
м'яч	mjɑt͡ʃ
соціологічний	sɔt͡sʲiɔɫoɦʲit͡ʃnei̯
зуб	zub
злива	zɫɪʋɐ
спілкуватися	sʲpʲiɫkʊʋɑtesʲɐ
оберегти	ɔbereɦtɪ
маланка	mɐɫɑnkɐ
кішка	kʲiʃkɐ
кимось	kɪmɔsʲ
почути	pot͡ʃute
битву	bɪtwʊ
ситуаціє	setʊɑt͡sʲije
орбіта	orbʲitɐ
вдруге	wdruɦe
дніпр	dʲnʲipr
довгостроковий	dɔu̯ɦɔstrɔkɔʋei̯
шести	ʃestɪ
власна	wɫɑsnɐ
гризти	ɦrɪzte
періодизація	perʲiɔdezɑt͡sʲijɐ
п'яний	pjɑnei̯
чіткий	t͡ʃʲitkɪi̯
біомолекула	bʲiɔmɔɫɛkʊɫɐ
одягатися	ɔdʲɐɦɑtesʲɐ
підростати	pʲidrɔstɑte
терміт	termʲit
вено	ʋɛnɔ
зменшення	zmɛnʃenʲːɐ
грою	ɦrɔjʊ
голос	ɦɔɫɔs
штат	ʃtɑt
кур'єр	kʊrjɛr
точно	tɔt͡ʃnɔ
прапір	prɑpʲir
русифікувати	rʊsefʲikʊʋɑte
координація	kɔɔrdenɑt͡sʲijɐ
асія	ɐsʲijɐ
музика	muzekɐ
безкоштовний	bezkɔʃtɔu̯nei̯
електрон	eɫektrɔn
проміжний	promʲiʒnei̯
протизапальний	prɔtezɐpɐlʲnɪi̯
пшоно	pʃɔnɔ
тінь	tʲinʲ
головний	ɦɔɫɔu̯nɪi̯
волонтер	wɔɫɔntɛr
плутократії	pɫʊtɔkrɑtʲiji
писати	pesɑte
переобрання	pereɔbrɑnʲːɐ
конкуренція	kɔnkʊrɛnʲt͡sʲijɐ
