flodau	vloːdai̯
caredigrwydd	karɛdɪɡrʊi̯ð
hymenyn	həmɛnɪn
fuan	viːan
adferfol	advɛrvɔl
clun	kliːn
protestaniaeth	prɔtɛsdanjai̯θ
coes	kɔi̯s
ngadael	ŋadɛl
cod post	koːdpɔsd
yn achlysurol	ənaχləsɪrɔl
dydd llun	diːðɬiːn
anrhydeddu	anr̥ədɛði
fûm	viːm
diwedd	dɪu̯ɛð
garant	ɡarant
sioned	ʃɔnɛd
cyfundrefn	kəvɪndrɛvn
anoddach	anoːðaχ
busnes	bɪsnɛs
ngweriniaethau	ɡwɛrɪnjei̯θɛ
paned	paːnɛd
gofid	ɡɔvɪd
credes	krɛdɛs
oddf	ɔðv
meddiannol	mɛðjanɔl
pyramid	pɪramɪd
gorlifo	ɡɔrliːvɔ
tal	taːl
adeiladweithiau	adei̯ladwei̯θjɛ
chwain	χwai̯n
paentio	pei̯ntjɔ
hedyn	hɛdɪn
eirin mair	ei̯rɪmmai̯r
tua	tiːa
iesin	jɛsɪn
trannoeth	tranɔi̯θ
byrddydd gaeaf	bərðɪðɡei̯av
caches	kaːχɛs
unit	ɪnɪt
braster	brastɛr
hunain	hiːnai̯n
cyfieithydd	kəvjei̯θɪð
ffonia	fɔnja
ffilmiau	fɪlmjai̯
carant	karant
gofodoldeb	ɡɔvɔdɔldɛb
ysglodyn	sɡloːdɪn
heddluoedd	hɛðliːɔi̯ð
teulu brenhinol	tei̯librɛnhiːnɔl
talem	taːlɛm
mrechdan	mrɛχdan
amheuaf	amhei̯a
yng	əŋ
anafu	anaːvi
dihuno	dɪhɪnɔ
conwydd	kɔnʊi̯ð
condemni	kɔndɛmni
cefn	keːvɛn
rheoliadau	r̥ɛɔljadɛ
neidit	nei̯dɪt
brwmstan	brʊmsdan
ciciau cosb	kɪkjai̯ɡɔsb
atalnod	atalnɔd
deall	dɛaɬ
gwerinwr	ɡwɛrɪnʊr
symud	səmɪd
mynachdy	mənaχdi
fron	vrɔn
afal cariad	aːvalkarjad
gwladgarol	ɡwladɡaːrɔl
drwyddedau	drʊi̯ðɛdai̯
llwybr llaethog	əɬʊi̯brɬei̯θɔɡ
thân	θaːn
nheulu	n̥ei̯li
gweiriau	ɡwei̯rjɛ
picau ar y maen	pɪkɛarəmaːn
etyl	ɛtɪl
pedair	peːdɛr
criw	krɪu̯
eryr	ɛrɪr
ffonau	fɔnai̯
nghadair	ŋ̊adɛr
cymar	kəmar
crwt	krʊt
coeden afalau	kɔi̯dɛnavalai̯
daliad	daljad
rhuddwyn	r̥ɪðwɪn
cared	kaːrɛd
oes	ɔi̯s
dryswch	drəsʊχ
tyngedfenyddiaeth	təŋɛdvɛnəðjɛθ
sarhad	sarhaːd
chastell	χasdɛɬ
gwddw	ɡʊðu
bangor	baŋɡɔr
argraffiadydd	arɡrafjaːdɪð
esgyn	ɛsɡɪn
saethyddiaeth	sei̯θəðjai̯θ
saeth	sai̯θ
allgofnodi	aɬɡɔvnɔdi
ymrafaelgar	əmravei̯lɡar
toiledau	tɔi̯lɛdɛ
bryfed	brəvɛd
gwesty	ɡwɛsdi
aberdaugleddau	abɛrdai̯ɡleːðai̯
ymlaen llaw	əmlaːnɬau̯
tyllau yn y wal	təɬai̯ənəwal
acen ddyrchafedig	akɛnðərχaveːdɪɡ
ddrud	ðriːd
welsh cêc	wɛlʃkeːk
digalon	dɪɡaːlɔn
rhai	r̥ai̯
trefi	trɛvi
iselderau	ɪsɛldeːrai̯
dydw i ddim yn siarad y saesneg	dəduiðɪmənʃaradəsəisnɛɡ
disgyblion	dɪsɡəbljɔn
hufen	hiːvɛn
tri ar hugain	triːarhiːɡai̯n
dylid	dəlid
galon	ɡalɔn
etifeddu	ɛtɪveːði
eloch	eːlɔχ
gaed	ɡai̯d
thud	θiːd
clyw	klɪu̯
sgìl	sɡɪl
cynnud	kənɪd
manteision	mantei̯ʃɔn
lleuad	ɬei̯ad
asesiadau	asɛsjadɛ
gylfinir	ɡəlvɪnɪr
ymenyn	əmɛnɪn
goleuedig	ɡɔlei̯ɛdɪɡ
chalenigion	χalɛnɪɡjɔn
delen	deːlɛn
fab	vaːb
llwynog	ɬʊi̯nɔɡ
gwrthryfelwr	ɡʊrθrəvɛlʊr
unais	iːnɛs
adferent	advɛrɛnt
dylwn	dəlʊn
cyn	kɪn
addolgar	aðɔlɡar
ngwair	ŋwai̯r
anghytuno	aŋhətɪnɔ
egwyl	eːɡʊi̯l
phrynu	frəni
llond	ɬɔnd
hiraeth	hɪrai̯θ
aflwyddiannus	avlʊi̯ðjanɪs
budd	biːð
neidr	nei̯dɪr
mewnfodol	mɛu̯nvoːdɔl
amheuaeth	amhei̯ɛθ
pêr	peːr
cynghrair	kəŋrai̯r
daliff	daːlɪf
llydan	ɬədan
dalu	dali
creda	kreːda
dalia	dalja
adaryddiaeth	adarəðjai̯θ
sinc	sɪŋk
droen	drɔi̯n
bath	baːθ
merlota	mɛrlɔta
nghariad	ŋ̊arjad
leicio	lɪkɔ
allforyn	aɬvɔrɪn
tsimpansî	tʃɪmpanziː
thudalen	θɪdalɛn
te	teː
roeddet	rɔi̯ðɛt
ysboncio	əsbɔŋkjɔ
cosb	kɔsb
ambell	ambɛɬ
farus	vaːrɪs
cwestau	kwɛsdɛ
caro	karɔ
eirin ysgaw	ei̯rɪnəsɡau̯
addysgu	aðəsɡi
yn	ən
ystyr	əsdɪr
uwch	ɪu̯χ
fynyddoedd	vənəðɔð
adladd	adlað
amrywiaeth	amrɪu̯jai̯θ
cyfrwyo	kəvrʊi̯ɔ
mewnol	mɛu̯nɔl
clymu	kləmi
awyr	au̯ɪr
piclau	pɪklai̯
microsgopau	mɪkrɔsɡɔpai̯
adfywiadau	advɪu̯jaːdɛ
adlamau	adlamai̯
caran	karan
dan	dan
oen	oːn
efyrnwy	ɛvərnʊi̯
frenin	vreːnɪn
dienw	diɛnu
dafad	daːvad
welsh cêcs	wɛlʃkeːks
absen	absɛn
marchogaeth	marχɔɡɛθ
olwyn	oːlʊi̯n
addysg	aðɪsɡ
pastai	pasdai̯
eurgylch	ei̯rɡɪlχ
pwll nofio	pʊɬnɔvjɔ
mae'n ddrwg gen i	mai̯nðruːɡɡɛni
digalonni	dɪɡalɔni
agweddi	aɡweːði
frechdan	vrɛχdan
cherir	χɛrɪr
banc	baŋk
llesteiriant	ɬɛsdei̯rjant
hefyd	hɛvɪd
dudno	dɪdnɔ
protestant	prɔtɛsdant
sefyll	seːvɪɬ
saffari	safaːri
mhysgodyn	m̥əsɡoːdɪn
nheigrod	n̥ei̯ɡrɔd
gwyndyd	ɡʊi̯ndɪd
sbwriel	sbʊrjɛl
phoptai	fɔptai̯
swshi	suːʃi
adarwr	adaːrʊr
salamandr	salamandr
gwsberen	ɡʊsbɛrɛn
brawiau	brau̯jai̯
pump	pɪmp
enghraifft	ɛŋrɛfd
petryal	pɛtriːal
camsefyll	kamseːvɪɬ
gwrdd	ɡʊrð
ffi	fiː
chlefyd	χleːvɪd
crwydr	krʊi̯dr
bigwrn	biːɡʊrn
troa	troːa
cyfforddus	kəfɔrðɪs
arad	ərarad
wychach	wəχaχ
credaf	krɛdav
pasteiod	pasdei̯ɔd
clas	klaːs
chysgu	χəsɡi
pured	piːrɛd
edliw	ɛdlɪu̯
brawychdod	brau̯əχdɔd
echnos	ɛχnɔs
ddeng	ðɛŋ
cyngor	kəŋɔr
canet	kanɛt
deg ar hugain	deːɡarhɪɡɛn
mynachaidd	mənaχɛð
sefydlog	sɛvədlɔɡ
teisennau	tɪʃɛnɛ
hyn a hyn	hɪnahɪn
bronrhuddyn y mynydd	brɔnr̥iːðɪnəmənɪð
llenyddiaeth	ɬɛnəðjai̯θ
gwybodaeth	ɡwɪboːdɛθ
conwydd	kɔnwɪð
adwaenant	adwei̯nant
caffel	kafɛl
bleiddiaid	blei̯ðjɛd
arbedaf	arbɛda
ciwcymbrau	kɪu̯kəmbrɛ
bu	biː
sioned	ʃoːnɛd
ffrwydro	frʊi̯drɔ
cenedlaethol	kɛnɛdlei̯θɔl
canwyllbrennau	kanʊi̯ɬbrɛnɛ
amserlen	amsɛrlɛn
ngwystl	ŋwɪsdl
technoleg gwybodaeth	tɛχnɔlɛɡɡwɪbɔdɛθ
piclau	pɪklɛ
habadaethau	habadei̯θɛ
ddechrau	ðɛχrɛ
p'nawn	pnau̯n
cregynna	krɛɡəna
ddau	ðɔi̯
atebaf	ateːba
bryn	brɪn
milcant	milkant
rhiant	r̥iant
pâr minimol	paːrmɪnɪmɔl
barotach	barɔtaχ
sièd	ʃɛd
caergrawnt	kai̯rɡrau̯nt
meheryn	mɛhɛrɪn
blynyddoedd	blənəðɔð
threfydd	θreːvɪð
genweiriau	ɡɛnwei̯rjɛ
wythfed	ʊi̯θvɛd
gloset	ɡlɔsɛt
mewnforwyr	mɛu̯nvɔrwɪr
teipiadur	tei̯pjadɪr
afr	aːvar
ffyrdd	fɪrð
biws	bɪu̯s
aeronen	ei̯roːnɛn
i blith	iːbliːθ
peiriannau llungopïo	pei̯rjanɛɬɪŋɔpiːɔ
ddoli	ðɔli
rhyngrwyd y pethau	r̥əŋrʊi̯dəpɛθai̯
dwywaith	dʊi̯wɛθ
adweinaf	adwei̯nav
melyngoch	mɛləŋɡɔχ
fàs	vas
neng	nɛŋ
bobl	bɔbɔl
corhedydd	kɔrheːdɪð
ymrafael	əmravɛl
adio	adjɔ
nghusanu	ŋ̊ɪsaːni
llythyrennau	ɬəθərɛnai̯
saer	sai̯r
pennill	pɛnɪɬ
ddrama	ðrama
deyrnas	dei̯rnas
cysgu	kəsɡi
carest	kaːrɛsd
digoni	dɪɡɔni
asesiadau	asɛʃaːdai̯
adwaenoch	adwei̯nɔχ
hirddydd	hɪrðɪð
bleiddiau	blei̯ðjɛ
lyfrau	ləvrɛ
magnelau	maɡnɛlɛ
gwael	ɡwai̯l
awyrgylch	au̯ərɡɪlχ
beidio	beidjɔ
iseldiraidd	ɪsɛldɪrɛð
lleianaidd	ɬei̯aːnai̯ð
cyfrifeg	kəvrɪvɛɡ
caledu	kaleːdi
camau	kamai̯
fwyaf	vʊi̯av
rhywsut	rɪu̯sɪt
tawe	tau̯ɛ
adlefau	adlɛvai̯
ca	kaː
paroted	parɔtɛd
arolygiaethau	arɔləɡjei̯θai̯
jac a'i wagen	d͡ʒakai̯waːɡɛn
cyfranddeiliaid	kəvranðei̯ljai̯d
bonheddig	bɔnheːðɪɡ
garet	ɡaːrɛt
adfeddiannu	advɛðjani
adnabod	adnabɔd
menyw	meːnɪu̯
agora	aɡɔra
treisiol	trei̯ʃɔl
cynhenna	kənhɛna
rheoliaduron	r̥ɛɔljadiːrɔn
baned	banɛd
gyrraedd	ɡərai̯ð
pigan	piːɡan
tîm	tiːm
nhyn	n̥ɪn
cwblhau	kʊblhai̯
corhwyaden	kɔrhʊi̯aːdɛn
portiwgal	pɔrtjʊɡal
gwreiddiadur	ɡwrɛi̯ðjadɪr
rydw	rədʊ
aradr	arad
nodi	noːdi
pwyll	pʊi̯ɬ
hechrydus	hɛχrədɪs
wyau	ʊi̯ai̯
nghymedrolwr	ŋ̊əmɛdrɔlʊr
glanaf	ɡlaːnav
sylfaen	səlvai̯n
animeiddiad	anɪmei̯ðjad
cochyn	kɔχɪn
mochyn daear	moːχɪndei̯ar
affwysol	afʊi̯sɔl
anrhydeddu	anrədeːði
anghydwelediad	aŋhɪdwɛlɛdjad
gylchgrawn	ɡəlχɡrau̯n
tyllau	təɬɛ
dau ar hugain	dai̯arhɪɡɛn
nhywyll	n̥əʊi̯ɬ
darlledu	darɬɛdi
eisoes	ei̯ʃɔi̯s
telynor	tɛlənɔr
degau	deːɡɛ
charet	χaːrɛt
pasio	paʃɔ
cyhydnos yr hydref	kəhədnɔsərhədrɛ
blaen	blaːn
clefyd	kleːvɪd
rhyfela	r̥əveːla
cyfodi	kəvɔdi
urddau	ɪrðɛ
hi	hiː
eirinen wlanog	ei̯riːnɛŋwlaːnɔɡ
chwythu	χwəθi
diddorol	dɪðoːrɔl
modd	moːð
gwylio	ɡʊi̯ljɔ
dynion	dənɔn
nghenhinen	ŋ̊ɛnhɪnɛn
ffraeo	friɔ
ngroeg	ŋrɔi̯ɡ
llysieuyn	ɬəsjei̯ɪn
bi	biː
cydymdeimlad	kiːdəmdei̯mlad
brochod	broːχɔd
chlywed	χlɪu̯ɛd
glybiau	ɡləbjɛ
canais	kaːnɛs
canmoliaeth	kanmɔljai̯θ
mewnforiadwy	mɛu̯nvɔrjadʊi̯
mynedadwy	mənɛdaːdʊi̯
cyrchu	kərχi
taw	tə
theulu	θiːli
safle	savlɛ
recordio	rɛkɔrdjɔ
sgileffaith	sɡiːlɛfɛθ
trolïau	trɔliai̯
ffugenw	fɪɡeːnu
gyfoethog	ɡəvɔi̯θɔɡ
chlyw	χlɪu̯
eilir	ei̯lɪr
llafar	ɬavar
dw i'n meddwl	duiːnmɛðʊl
geiriau	ɡiːrɛ
ar daith	ardai̯θ
wddf	ʊðu
dair	dai̯r
tro	troː
ysgrifennu	əsɡrɪvɛni
gwen	ɡwɛn
peintio	pei̯ntjɔ
iwerddoneg	ɪu̯ɛrðɔnɛɡ
ocsigenu	ɔksɪɡɛni
dant	dant
'r	r
cyfrinach	kəvriːnaχ
diod	diːɔd
gormod	ɡɔrmɔd
ges	ɡeːs
pellweledydd	pɛɬwɛlɛdɪð
bengwin	bɛŋɡwɪn
eirinen ysgaw	ei̯rɪnɛnəsɡau̯
ffonau	foːnai̯
gwladfeydd	ɡwladvei̯ð
hangharad	haŋhaːrad
ddwywaith	ðʊi̯wɛθ
ŵyr	ʊi̯r
cofbin	kɔvbɪn
bei	bei
trueni	triɛni
gwyliedydd	ɡwɪljeːdɪð
llong	ɬɔŋ
cydweithredu	kiːdwei̯θrɛdi
flwyddi	vlʊi̯ði
myned	mənɛd
cyffwrdd	kəfʊrð
haddo	haðɔ
gweled	ɡwɛlɛd
cydwelediad	kɪdwɛlɛdjad
selotep	sɛlɔtɛp
caled	kaːlɛd
loyw	lɔi̯u
fenyn	vɛnɪn
huawdl	hiːau̯dl
cyswllt	kəsʊɬd
fedi	veːdi
twrch	tʊrχ
wele	weːlɛ
atebaf	atɛbav
pin	pɪn
phiws	fɪu̯s
choginio	χɔɡɪnjɔ
nid wrth ei big y mae mesur cyffylog	nɪdʊrθei̯biːɡəmai̯mɛsɪrkəfəlɔɡ
garan	ɡaran
calchfaen	kalχvai̯n
cymryd	kəmrɪd
claf	klaːv
hugain	hiːɡɛn
trybedd	trəbɛð
bag	baɡ
aeth	ai̯θ
gesyd	ɡɛsɪd
letys	lɛtɪs
cyfranddeiliad	kəvranðei̯ljad
ager	aːɡɛr
chwinciad	χwɪŋkjad
pery	peːri
aethid	ei̯θɪd
tanau gwyllt	tanai̯ɡwɪɬd
geni	ɡeːni
hiasoer	hjasɔi̯r
tywod	təu̯ɔd
bondigrybwyll	bɔndɪɡrəbʊi̯ɬ
ach	aχ
cwbl	kuːbʊl
symiau	səmjai̯
chorff	χɔrf
gweddïau	ɡwɛðiːɛ
gefell	ɡeːvɛɬ
serch	sɛrχ
elciaid	ɛlkjai̯d
aethwn	ei̯θʊn
ddangos	ðaŋɡɔs
gyngor	ɡəŋɔr
ymrysonwyr	əmrəsɔnwɪr
ebargofiant	ɛbarɡɔvjant
cysylltiad	kəsəɬdjad
digwyddiad	dɪɡʊi̯ðjad
llechi	ɬeːχi
gwan	ɡwan
hugain	hɪɡɛn
ydw	ədu
carai	karai̯
dryw	drɪu̯
aweddwr	au̯ɛðʊr
nharianau	n̥arjanai̯
siwmper	ʃʊmpɛr
cartre	kartrɛ
llamhidog	ɬamhiːdɔɡ
ogof	ɔɡɔv
rhiffio	r̥ɪfjɔ
achosi	aχɔsi
tyr	tɪr
anghyflogaeth	aŋhəvlɔɡɛθ
wybod	ʊbɔd
byliau	bəljɛ
beirniadaeth	bei̯rnjaːdɛθ
arweinyddion	arwei̯nəðjɔn
streiciau	sdrei̯kjɛ
agos	aːɡɔs
apêl	apeːl
gweriniaeth	ɡwɛrɪnjɛθ
mwyaf	mʊi̯av
santes	santɛs
cyfyd	kəvɪd
troan	trɔan
ysgrifbin	əsɡrɪvbɪn
rhynionyn	r̥ənjoːnɪn
chwarae	χwaːrai̯
meddwl	mɛðʊl
glanhau	ɡlanhai̯
sodlau uchel	sɔdlɛɪχɛl
adanedd	adanɛð
synio	sənjɔ
elain	eːlai̯n
ngŵr	ŋuːr
llyfn	ɬɪvn
pabydd	paːbɪð
nhudalen	n̥ɪdaːlɛn
treigladau	treiɡlaːdai̯
gellid	ɡɛɬid
adlefau	adleːvai̯
angen	aŋɛn
gweinydd	ɡwei̯nɪð
tadau	taːdɛ
rhwystredigaethau	r̥ʊi̯sdrɛdɪɡei̯θai̯
chynhadledd	χənhadlɛð
foes	vɔi̯s
adlynol	adlənɔl
ffwrcho	fʊrχɔ
goleuadau	ɡɔlei̯adɛ
mamoth	mamɔθ
tafodiaith	tavɔdjai̯θ
dafarnwr	davarnʊr
drysgoed	drəsɡɔi̯d
gwyrddion	ɡwərðjɔn
rydw	rədu
cerir	kɛrɪr
modrwy	mɔdrʊi̯
cais	kai̯s
albanau	albaːnɛ
wres	wreːs
anfanteision	anvantei̯ʃɔn
wydraid	wədrai̯d
torchau	tɔrχɛ
try	triː
o dan	ɔdan
dwrgi	dʊrɡi
llafariaid	ɬavarjai̯d
gwyneira	ɡwɪnei̯ra
dyfarniadau	dəvarnjadai̯
digon	diːɡɔn
torrid	tɔrɪd
tenau	tɛnɛ
mathau	maθai̯
teyrnged	tei̯rnɡɛd
eog	eːɔɡ
wedi	weːdi
cyntaf	kəntav
afiach	avjaχ
taliadau	taljaːdɛ
trydanwr	trədanʊr
llythyr	ɬəθɪr
ngwybodaeth	ŋwəbɔdɛθ
rheiddyn	r̥ei̯ðin
madfall ddŵr	madvaɬðuːr
gwasgaru	ɡwasɡaːri
ngherddoriaeth	ŋ̊ɛrðɔrjɛθ
ddeuddeg	ðei̯ðɛɡ
hafren	havrɛn
conglfaen	kɔŋlvai̯n
achub	aːχɪb
gwelais	ɡwɛlai̯s
deyrnaddoliant	dei̯rnaðɔljant
anafu	anavi
llusg	ɬɪsɡ
cyfeirio	kəvei̯rjɔ
anghymdeithasol	aŋhəmdei̯θasɔl
gerais	ɡɛrai̯s
chwilio	χwɪljɔ
caerwrangon	kai̯rwraŋɔn
dihuno	dɪhiːnɔ
pethau	pɛθɛ
mam	mam
dydd iau	diːðjai̯
dangos	daŋɡɔs
cathod	kaθɔd
dacluso	daklɪsɔ
gŵyth	ɡʊi̯θ
dros dro	droːsdroː
nathlu	naθli
rhentwyr	r̥ɛntwɪr
tybed	təbɛd
mhigwrn	m̥iːɡʊrn
gartref	ɡətrɛ
gwlana	ɡwlaːna
ngwely	ŋweːli
caret	karɛt
iasau	jasɛ
elc	ɛlk
taflu	tavli
uniongyrchol	ɪnjɔŋɡərχɔl
siwrnai	ʃʊrnɛ
pleth	pleːθ
ymlaen	əmlaːn
teithio	tei̯θjɔ
alban hyfed	albanhəvɛd
fflworin	fluːɔrɪn
ar agor	araːɡɔr
gwerddon	ɡwɛrðɔn
chwedl	ʍɛdɛl
cen coed	kɛnkoːd
ddyn	ðiːn
seiclo	sei̯klɔ
gweryd	ɡwɛrɪd
helwr	heːlʊr
cyfan	kəvan
stwrsiwn	sdʊrʃʊn
dychryniadau	dəχrənjadai̯
nos sadwrn	nɔsadʊrn
diogel	dɪɔɡɛl
cont	kɔnt
taranau	taranɛ
prydain	prədai̯n
ehöeg	ɛhoːɛɡ
cachgwn bwm	kaχɡʊmbʊm
trwyddedau	trʊi̯ðeːdai̯
magnelau	maɡnɛlai̯
gwyryf	ɡwɪrɪv
gwlad belg	ɡwlaːdbɛlɡ
deigrod	dei̯ɡrɔd
ddadlwytho	ðadlʊi̯θɔ
tri ar hugain	triːarhɪɡai̯n
honno	hɔnɔ
profiad	prɔvjad
wybodaeth	wəboːdai̯θ
cilydd	kiːlɪð
gwydr	ɡwɪdr
gwir	ɡwiːr
henffordd	hɛnfɔrð
adferiadau	advɛrjadɛ
cyfareddol	kəvarɛðɔl
nglanaf	ŋlaːna
pilen	piːlɛn
allant	aɬant
ngwres	ŋwreːs
motél	mɔtɛl
gwahardd	ɡwaharð
amcan	amkan
cofnodi	kɔvnɔdi
pharotach	farɔtaχ
tewyn	tɛu̯ɪn
rheoliadau	r̥ɛɔljadai̯
asesiadau	asɛsjadai̯
ni	niː
meddu	meːði
academïau	akadɛmiːai̯
losin	lɔʃɪn
dweud	dwei̯d
unais	ɪnai̯s
cwsmeriaid	kʊsmɛrjai̯d
trôi	troːi̯
cheri	χeːri
cherdded	χɛrðɛd
cwerylwyr	kwɛrəlwɪr
bwrw	bʊru
arestio	arɛstjɔ
tros	trɔs
plismon	plismɔn
unrhyw	ɪnr̥ɪu̯
corffluniwr	kɔrflɪnjʊr
unigol	ɪnɪɡɔl
sychin	səχɪn
gweinyddiadau	ɡwei̯nəðjaːdai̯
ngwychach	ŋwəχaχ
corhwyaid	kɔrhʊi̯ai̯d
hiach	hjaːχ
agoraf	aɡoːra
cynaeafu	knei̯avi
ngoleuadau	ŋɔliaːdɛ
elwa	ɛlwa
chwyrnaf	χwərnav
parot	paːrɔt
swistir	əswɪsdɪr
dueg	diːɛɡ
ddelw	ðɛlu
traed	trai̯d
hunllef	hɪnɬɛ
ngwybodaeth	ŋwəboːdai̯θ
ar bwys	arbʊi̯s
dalfa	dalva
teimlo	tʊmlɔ
symudol	səmɪdɔl
llafariaid thematig	ɬavarjai̯dθɛmatɪɡ
ddannoedd	ðanɔð
ymladdgar	əmlaðɡar
mol	mɔl
nos sadwrn	nɔsadʊn
celet	kɛlɛt
mapiau	mapjai̯
adargwn	adarɡʊn
sillgoll	sɪɬɡɔɬ
bychan	bəχan
adferaf	advɛrav
anfonaf	anvoːnav
treisiwr	trei̯sjʊr
charan	χaran
metelegwr	mɛtɛlɛɡʊr
wybodaeth	ʊi̯bɔdai̯θ
fathemateg	vaθɛmatɛɡ
gythraul	ɡəθrai̯l
pandemigau	pandɛmɪɡɛ
bychod	bəχɔd
gwregys llaethol	əɡwrɛɡɪsɬei̯θɔl
mwy	mʊi̯
gwahaniaeth	ɡwənjɛθ
wyneb	wɪnɛb
thelyn	θɛlɪn
neu	nɛ
gwenynen wyllt	ɡwenənɛŋwɪɬd
agor	aɡɔr
gaches	ɡaχɛs
celwydd	kɛlwɪð
toiled	tɔi̯lɛd
ymbarél	əmbarɛl
gweplyfr	ɡwɛplɪvr
gegin	ɡeːɡɪn
cyfryngi	kəvrəŋi
uchel	əχɛl
gweithiwr	ɡwiːθʊr
amhenodol	amhɛnɔdɔl
rod	roːd
hunllef	hɪnɬɛv
phedol	feːdɔl
cyfrifiad	kəvrɪvjad
swnllyd	sʊnɬɪd
hafodau	havɔdɛ
campfa	kampva
pen y fan	pɛnəvan
cref	kreːv
ffrwyth	frʊi̯θ
chwi	χwiː
mhastai	m̥asdai̯
berw	beːru
ymladd	əmlað
regen	rɛɡɛn
nitrogen	nɪtrɔɡɛn
throes	θrɔi̯s
aetsh	ai̯tʃ
anafa	anaːva
carom	kaːrɔm
hynny	həni
berf	bɛrv
treigladau	treiɡlaːdɛ
crac	krak
aildrefnu	ai̯ldrevni
helynt	hɛlɪnt
tanwydd	tanwɪð
mhencampwyr	m̥ɛŋkampwɪr
cynaniad	kənanjad
mêt	meːt
pwll	pʊɬ
llyn	ɬɪn
rhacs	r̥aks
ticio	tɪkɔ
cei	kei̯
syndodau	səndoːdai̯
isel	iːʃɛl
griliau	ɡrɪljai̯
troes	trɔi̯s
eraill	ɛrai̯ɬ
fys	viːs
anawsterau	anau̯sdeːrai̯
ysaf	əsav
achyddiaeth	aχəðjɛθ
cleren	kleːrɛn
tywyll	təʊi̯ɬ
hwn	hʊn
cynnau	kənai̯
ysguthan	əsɡɪθan
tonnau	tɔnai̯
menig	meːnɪɡ
regi	rɛɡi
hamerica	hamɛrɪka
gwrthiselydd	ɡʊrθɪseːlɪð
babi	baːbi
cachais	kaːχai̯s
teithio	tei̯θɔ
pasg	pasɡ
cynnig	kənɪɡ
sêr llong	seːrɬɔŋ
parcio	parkjɔ
gefn	ɡɛvɛn
mhethau	m̥eːθɛ
prysur	prəsɪr
ameba	amɛba
arolygiadau	arɔləɡjaːdai̯
fynyddoedd	vənəðɛ
ngwŷr	ŋwiːr
tomatos	tɔmatɔz
adain	adai̯n
clefyd y sul	kleːvɪdəsiːl
ynn	ɪn
dilyn	diːlɪn
argraff	arɡraf
anghywir	aŋhəu̯ɪr
coegog	kɔi̯ɡɔɡ
gwychach	ɡwəχaχ
fforc	fɔrk
eir	ei̯r
brecsit	brɛksɪt
allfudo	aɬvɪdɔ
â	a
gefn	ɡeːvɛn
hyrddod	hərðɔd
llychlyn	ɬəχlɪn
theyrnas	θei̯rnas
achos	χɔs
tewed	tɛu̯ɛd
anodd	anɔð
chwiorydd	ʍiɔrɪð
cydweithiwr	kɪdwei̯θjʊr
cwest	kwɛsd
dyfarniadau	dəvarnjaːdɛ
canlyniad	kanlənjad
genwair	ɡɛnwai̯r
dry	driː
mawr	mau̯r
cadlas	kadlas
norwy	nɔrʊi̯
thegan	θɛɡan
cathau	kaθai̯
sashimi	saʃɪmi
eiliadau	ei̯ljaːdɛ
pandemigau	pandɛmiːɡai̯
nghrwth	ŋ̊ruːθ
nharian	n̥arjan
golli	ɡɔɬi
cyfarthiadau	kəvarθjaːdai̯
chwith	wiːθ
ffyrnau	fərnai̯
gorfodog	ɡɔrvɔdɔɡ
ffrwchnedden	frʊχneːɛn
abladol	ablaːdɔl
mhabell	m̥abɛɬ
pesto	pɛsdɔ
gweles	ɡweːlɛs
gwrw	ɡʊru
berfenw	bɛrveːnu
rheoli	r̥ɛoːli
olau	ɔlɛ
arth fwyaf	arθvʊi̯a
dreisiwr	drei̯ʃʊr
mleiddiaid	mlei̯ðjai̯d
oddeutu	ɔðei̯ti
ddechrau	ðɛχrai̯
moliannau	mɔljanɛ
gyddfau	ɡəðvɛ
defnyddiwr	dɛvnəðjʊr
thudalen	θɪdaːlɛn
canen	kaːnɛn
neuddegfed	nei̯ðɛɡvɛd
brwydrwr	brʊi̯drʊr
harbwr	harbʊr
est	ɛsd
nghymaint	ŋ̊ɪmɛnt
lechi	leːχi
gwrthwynebu	ɡʊrθwɪneːbi
cheri	χɛri
rheolau	r̥ɛɔlai̯
chwpan	χʊpan
adargraffiadau	adarɡrafjaːdai̯
anodded	anɔðɛd
ffoniaf	fɔnjav
anghlodwiw	aŋhlɔdwɪu̯
gwobrau	ɡwɔbrɛ
mhethau	m̥ɛθɛ
alban	alban
lundain	lɪndɛn
ceiniog	kei̯nɔɡ
gwddf	ɡʊðv
rhaith	r̥ai̯θ
hwntws	hʊntuz
buwch	bɪu̯χ
nghroes	ŋ̊roːs
hen	heːn
glawio	ɡlau̯jɔ
plentyn	plɛntɪn
os	ɔs
bedw	bɛdu
garest	ɡarɛst
ach	aːχ
taranau	taraːnɛ
animeiddiadau	anɪmei̯ðjjaːdɛ
mewnfudo	mɛu̯nviːdɔ
daliadaeth	daljadai̯θ
plu eira	pliːei̯ra
cywyddau	kəwəðai̯
nglased	ŋlasɛd
helyntoedd	hɛləntɔi̯ð
cymaint	kəmɛnt
pymtheg	pəmθɛɡ
ymwneud	əmnei̯d
galli	ɡaɬi
difetha	dɪvɛθa
nheisen	n̥ei̯sɛn
cael	kaːl
cymorth	kəmɔrθ
piso	pɪsɔ
nai	nai̯
bermo	əbɛrmɔ
cathau	kaθɛ
chant	χant
adardy	adardi
wreiddiol	wrei̯ðjɔl
recriwtiaid	rɛkrɪu̯tjɛd
nghapel	ŋ̊apɛl
thi	θiː
llonydd	ɬoːnɪð
dyblu	dəbli
plygio	pləɡjɔ
rhys	r̥iːs
teisen	tei̯sɛn
iâr	jaːr
gog	ɡɔɡ
daflu	davli
gwenu	ɡwɛni
adferent	adveːrɛnt
teigrod	tei̯ɡrɔd
gorfod	ɡɔrvɔd
gwyliedydd	ɡʊi̯ljɛdɪð
moch coed	moːχkoːd
sidan	sɪdan
canent	kanɛnt
da	daː
gweinidog	ɡwei̯nɪdɔɡ
garejys	ɡarɛd͡ʒɪz
at	at
pethau	pɛθai̯
chanes	χanɛs
naid	nai̯d
ceirios	kei̯rjɔs
credaf	krɛda
condemnio	kɔndɛmnjɔ
hedfan	hɛdvan
gymaint	ɡəmɛnt
esgidiau	sɡɪtʃɛ
llusen	ɬɪsɛn
geiriadurwr	ɡei̯rjadɪrʊr
alarch	aːlarχ
moliannau	mɔljanai̯
achubwr	aχiːbʊr
rhuthraf	r̥ɪθra
dosbarthiadau	dɔsbarθjadai̯
wyth ar hugain	ʊi̯θarhiːɡɛn
buddsoddi	bɪðsɔði
grilio	ɡrɪlɔ
blin	bliːn
basen	basɛn
cynnau	kɪnɛ
llungopïwyr	ɬiːŋɡɔpiːwɪr
birmingham	bərmɪŋham
cydweithredwyr	kiːdwei̯θrɛdwɪr
allan	aɬan
ddôn	ðoːn
pysgodyn	pəsɡɔdɪn
rhywsut	r̥ɪu̯sɪt
pechod	peːχɔd
ffili	fiːli
agor	aːɡɔr
adwaenent	adwei̯nɛnt
afonfeirch	avɔnvei̯rχ
mamau	mamai̯
elsech	ɛlsɛχ
esgidiau	sɡɪdjɛ
pumdegau	pɪmdeːɡɛ
dosbarthiadau	dɔsbarθjadɛ
mhengwin	m̥ɛŋɡwɪn
camu	kami
gorchaw	ɡɔrχau̯
thyn	θɪn
goddef	ɡɔðɛ
cymal	kəmal
gachen	ɡaχɛn
tegan anwes	teːɡananwɛs
tiroedd	tiːrɔi̯ð
cymhlethdodau	kəmhlɛθdoːdai̯
argrafiadau	arɡrafjadai̯
allai	aɬɛ
dyrysni	dərəsni
anafais	anavai̯s
chwedl	χwɛdl
cyllell	kɪɬɛθ
llysiau	ɬɪʃɛ
delit	deːlɪt
treiddio	treiðjɔ
prys	priːs
huno	hɪnɔ
conwydden	kɔnwəðɛn
nghadair	ŋ̊adai̯r
achwyniadau	aχʊi̯njadɛ
chacha	χaːχa
cyfaredd	kəvarɛð
daearfoch	dei̯arvɔχ
contractau	kɔntraktɛ
llusgo	ɬɪsɡɔ
gwasanaethau	ɡwasanei̯θɛ
gwaedu	ɡwei̯di
chwyddo	χwɪðɔ
pigau	piːɡɛ
dail	dai̯l
lleol	ɬeːɔl
fas	vaːs
corfflunio	kɔrflɪnjɔ
poeni	pɔi̯ni
stori	sdɔri
nghloch	ŋ̊loːχ
gweinyddwr	ɡwei̯nəðʊr
peiriant	pei̯rjant
angyles	aŋəlɛs
helbulon	hɛlbɪlɔn
fwyaf	vʊi̯a
achyddol	aχəðɔl
chyfiawnder	χəvjau̯ndɛr
neiliad	nei̯ljad
dyfarniad	dəvarnjad
cacwn meirch	kakʊmmei̯rχ
ngyrru	ŋəri
swyddogaeth	sʊi̯ðoːɡɛθ
treigladau	treiɡladai̯
economegydd	ɛkɔnɔmeːɡɪð
arholiadau	arhɔljaːdɛ
elfen	ɛlvɛn
stopio	sdɔpjɔ
chynnwrf	χənʊrv
nwy	nʊi̯
habadau	habaːdai̯
caru	kari
rheoli	r̥ɛɔli
gellir	ɡɛɬir
iwrch	jʊrχ
hynt san ialm	hɪntsanjalm
ar agor	araɡɔr
chwisgi	wɪsɡi
ffrygydau	frəɡədɛ
cyfrifoldebau	kəvrɪvɔldɛbai̯
peiriannau arian parod	pei̯rjanɛarjanparɔd
arch	arχ
daliadaethau	daljadei̯θɛ
talwn	taːlʊn
gwahanu	ɡwahaːni
oedd	oːð
acer	akɛr
diwrnod	dʊrnɔd
peiriant arian parod	pei̯rjantarjampaːrɔd
habwyd	haːbʊi̯d
nharianau	n̥arjaːnai̯
credu	kreːdi
ngweddi	ŋweːði
nghegin	ŋ̊eːɡɪn
band llydan	bandɬədan
diffodd	dɪfɔð
dydd sadwrn	diːðsaːdʊrn
merlod	mɛrlɔd
llygota	ɬəɡɔta
pasiaf	pasja
armenia	armɛnja
i'r dim	iːrdɪm
bethau	beːθɛ
cenhinen sifi	kɛnhɪnɛnsɪvi
un ar hugain	iːnarhiːɡai̯n
talai	talɛ
ngolau	ŋoːlai̯
sef	seːv
unset	ɪnsɛt
asgwrn	asɡʊrn
gwawn	ɡwau̯n
caer gwydion	kai̯rɡwədjɔn
band eang	bandeːaŋ
ymgecru	əmɡɛkri
taw	ta
cain	kai̯n
dathlu	daθli
eleni	lɛni
brawychiadau	brau̯əχjadai̯
wyth ar hugain	ʊi̯θarhɪɡɛn
mwyar	mʊi̯ar
nhew	n̥ɛu̯
heddwch	hɛðʊχ
pan	pan
ymddwyn	əmðʊi̯n
porfa	pɔrva
cristnogion	krɪsdnɔɡjɔn
ryseitiau	rəsei̯tjai̯
dyfnion	dəvnjɔn
tonau	tɔnai̯
cam	kam
ladin	ladɪn
melon	mɛlɔn
bwydydd	bʊi̯dɪð
rhanbarthau	r̥anbarθai̯
peiriant arian parod	pei̯rjantarjamparɔd
dyn	diːn
chusanau	χɪsanɛ
anghydradd	aŋhədrað
croesgad	krɔi̯sɡad
oer	ɔi̯r
blynyddoedd	blənəðɔi̯ð
caerffili	kai̯rfɪli
wy	ʊi̯
daliadau	daljadai̯
trueni	trɛni
blynyddoedd golau	blənəðɔi̯ðɡoːlai̯
cyrsiau	kərsjai̯
gwddf	ɡuːðʊv
talais	talai̯s
gwladgarwr	ɡwladɡaːrʊr
ysgrifen	əsɡrɪvɛn
berfenw	bɛrvɛnu
ngwys	ŋwiːs
anoddach	anɔðaχ
ffordd wen	əfɔrðwɛn
edau	eːdai̯
wddf	ʊðuv
lysenw	liːsɛnu
eraill	ɛrɪɬ
afonfarch	avɔnvarχ
chwerwddwr	χwɛrwðʊr
nos	noːs
nyddu	nəði
hannwyd	hanʊi̯d
fyfyriwr	vəvərjʊr
mochyn	mɔχɪn
fwlgaria	vʊlɡarja
llyfrau	ɬəvrɛ
talais	taːlai̯s
caron	kaːrɔn
sawsiau	sau̯ʃai̯
lygaid	ləɡai̯d
chyrraedd	χərai̯ð
dylu	dəli
angharad	aŋhaːrad
oed	ɔi̯d
llungopïau	ɬiːŋɡɔpiːai̯
agorai	aɡoːrai̯
cyfryngau	kəvrəŋai̯
genedigaeth	ɡɛnɛdiːɡai̯θ
rhestrau	r̥ɛsdrɛ
nghanlyniad	ŋ̊anlənjad
mwyara	mʊi̯ara
caeaf	kei̯a
iorwg	joːrʊɡ
nghadair	ŋ̊aːdai̯r
dau ar hugain	dai̯arhiːɡai̯n
creisionllyd	krei̯ʃɔnɬɪd
hoyw	hɔi̯u
nos sadwrn	noːssaːdʊrn
athrawesau	aθrau̯ɛsai̯
canant	kaːnant
helaeth	hɛlɛθ
magnel	maɡnɛl
sosys	soːsɪz
dest	dɛsd
tyle	təlɛ
dechrau	dɛχrai̯
cani	kani
caron	karɔn
dylai	dəlai̯
tenantiaethau	tɛnantjei̯θɛ
chwiorydd	χwioːrɪð
neidio	nei̯dɔ
llochesau	ɬɔχɛsai̯
doem	dɔi̯m
her	hɛr
alli	aɬi
neuaddau	nei̯aːðai̯
blog	blɔɡ
stŵr	sduːr
torrent	tɔrɛnt
cnawdol	knau̯dɔl
leihau	lei̯hai̯
gwenithfaen	ɡwɛnɪθvai̯n
aradr	aradr
santesau	santɛsai̯
clodydd	kloːdɪð
rhodia	r̥ɔdja
gefnfor	ɡeːvɛnvɔr
brawychwyr	brau̯əχwɪr
gana	ɡana
gweryd	ɡweːrɪd
gwyrdd	ɡwɪrð
cenhinen sifi	kɛnhɪnɛnsiːvi
telyn	tɛlɪn
dynes	dənɛs
ffrwchnedden	frʊχnɛðɛn
blinedig	blɪnɛdɪɡ
agoret	aɡoːrɛt
planhigyn	planhɪɡɪn
canon	kaːnɔn
deledu	dɛlɛdi
hystafell	həsdaːvɛɬ
nghusanau	ŋ̊ɪsaːnɛ
elw	ɛlu
heini	hei̯ni
arholiadau	arɔljadɛ
llyfrgellydd	ɬəvrɡɛɬɪð
ysgrifen	sɡrɪvɛn
eogiaid	ɛɔɡjɛd
cynhesu	kənhɛsi
siafio	ʃavɔ
cacen fach	kakɛmbaːχ
prifddinas	prɪvðiːnas
calon	kaːlɔn
adeiladol	adei̯ladɔl
edau	ɛdai̯
sgrechian	sɡrɛχan
abadaeth	abaːdai̯θ
amwythig	amʊi̯θɪɡ
technoleg gwybodaeth	tɛχnɔlɛɡɡwəbɔdai̯θ
parth rhynglanw	parθr̥əŋlaːnu
cymer	kəmɛr
delet	deːlɛt
gwrthwynebiad	ɡʊrθwɪnɛbjad
ffenestr	feːnɛsdr
gwêl	ɡweːl
gwlychu	ɡləχi
deli	dɛli
awchus	au̯χɪs
darlithydd	darliːθɪð
naw	nau̯
flog	vlɔɡ
chae	χai̯
parod	parɔd
mygydau	məɡədai̯
nghant	ŋ̊ant
pentyrru	pɛntəri
cilddant	kɪlðant
bancio	baŋkjɔ
iti	ɪti
ehangach	ɛhaŋaχ
unet	ɪnɛt
dyrysfa	dərəsva
senedd	sɛnɛð
cadwch	kadʊχ
gweinyddiaeth	ɡwei̯nəðjɛθ
na	naː
trengholiadau	trɛŋhɔljaːdai̯
awd	au̯d
ngwddwg	ŋʊðʊɡ
clefyd	klɛvɪd
fore	voːrɛ
cyfansymiau	kəvansəmjɛ
rydych	rədɪχ
adref	adrɛ
ioan	jɔan
gweinyddiaethau	ɡwei̯nəðjei̯θai̯
hachos	haːχɔs
rysáit	rəsai̯t
athrefi	aθrɛvi
unan	iːnan
ngwybodaeth	ŋwəbɔdai̯θ
wyau	ʊi̯ɛ
mesa	meːsa
cwyr	kʊi̯r
cachen	kaːχɛn
atsain	atsai̯n
cynnau	kənɛ
gwybodaeth	ɡwəboːdai̯θ
yn barod	əmbaːrɔd
adardai	adardai̯
aberhonddu	abɛrhɔnði
phabell	fabɛɬ
cyfrifoldeb	kəvrɪvɔldɛb
nadolig	dɔlɪɡ
eirinen	ei̯riːnɛn
thewed	θɛu̯ɛd
deuparth	dei̯parθ
gyll	ɡɪɬ
mlynyddoedd	mlənəðɔi̯ð
ysglodyn	əsɡloːdɪn
cyrsiau	kərʃai̯
mafon	mavɔn
clywedog	kləu̯ɛdɔɡ
catholigiaeth	kaθɔlɪɡjɛθ
cafiâr	kavjaːr
calan	kaːlan
torret	tɔrɛt
ffon gof	fɔŋɡoːv
eto	ɛtɔ
chly	χliː
cyfamser	kəvamsɛr
eisiau	ei̯ʃai̯
gwrthryfela	ɡʊrθrəvɛla
methan	mɛθan
unen	iːnɛn
cydweithrediadau	kiːdwei̯θrɛdjaːdai̯
morwyn	moːrʊi̯n
ferfenw	vɛrveːnu
cwstard	kʊsdard
ffigys	fiːɡɪs
chara	χara
erw	eːru
bwced	bʊkɛd
ganit	ɡaːnɪt
chaffer	χafɛr
gachai	ɡaχai̯
braich	brai̯χ
ffrwgwd	frʊɡʊd
iddewesau	ɪðɛu̯ɛsai̯
prif	priːv
nheirw	n̥ei̯ru
epidemigau	ɛpɪdɛmiːɡai̯
closet	klɔsɛt
gell	ɡɛɬ
golygfa	ɡɔləɡva
adael	aːdai̯l
nage	naɡɛ
neiliaid	nei̯ljɛd
yn sgil	ənsɡiːl
ngadael	ŋadai̯l
caer arianrhod	kai̯rarjanr̥ɔd
nos lun	nɔsliːn
gwaelod	ɡwei̯lɔd
ffurfio	fɪrvjɔ
u	iːbɛdɔl
tato	tatɔ
cynnwys	kənʊi̯s
hwngari	hʊŋɡari
breifat	brei̯vat
ioan	joːan
adegau	adeːɡɛ
dywedodd	dəu̯ɛdɔð
tôn	toːn
cofiais	kɔvjai̯s
pei	pei̯
degau	deːɡai̯
rhywbeth	r̥ɪu̯bɛθ
gadael	ɡaːdai̯l
achwyniadau	aχʊi̯njaːdɛ
gwyn	ɡwɪn
rhwystro	r̥ʊi̯sdrɔ
pìn	pɪn
gwledig	ɡwlɛdɪɡ
gwâr	ɡwaːr
elciaid	ɛlkjɛd
mynediad	mənɛdjad
dagrau	daɡrɛ
rhif	r̥iːv
pwll	puːɬ
wystl	ʊi̯sdl
chwythaf	hʊθa
gweinyddwyr	ɡwei̯nəðwɪr
trigain	triːɡɛn
adenedigaethau	adɛnɛdɪɡei̯θai̯
ehangder	ɛhaŋdɛr
dewis	dɛu̯is
elet	eːlɛt
pres	prɛs
lin	liːn
wahanol	wahanɔl
olddodiad	oːlðɔdjad
brechdan	brɛχdan
plethwaith	plɛθwai̯θ
ganen	ɡanɛn
dynfeirch	dənvei̯rχ
nos wener	noːswɛnɛr
tad	taːd
fair	vai̯r
ddwylo	ðiːlɔ
pryf cop	priːvkɔp
phethau	fɛθɛ
dial	diːal
dalet	daːlɛt
symbol	sɪmbɔl
gacen	ɡakɛn
lun	liːn
gwylog	ɡʊi̯lɔɡ
cythreuliaid	kəθrei̯ljɛd
siaced	ʃakɛd
oleuadau	ɔliaːdɛ
sesh	sɛʃ
gefell	ɡɛvɛɬ
habatiroedd	habatiːrɔi̯ð
habad	habad
y gofid mawr	əɡɔvɪdmau̯r
posteri	pɔsdeːri
ceredigion	kɛrɛdɪɡjɔn
gweithwyr	ɡwei̯θwɪr
geifr	ɡei̯vɪr
dalom	daːlɔm
gwâl	ɡwaːl
pres	preːs
sianis	ʃaniz
llysiau	ɬəsjai̯
erbyn hyn	ɛrbɪnhɪn
regi	reːɡi
brydain	brədai̯n
dywedodd	dəu̯eːdɔð
adfydau	advədai̯
hwyad	hʊi̯ad
anghyflogaeth	aŋhəvloːɡai̯θ
daled	daːlɛd
lysenw	liːseːnu
nhroed	n̥roːd
datws	datʊs
petryalau	pɛtrialai̯
hyrwyddo	hərʊi̯ðɔ
masgau	masɡɛ
sychnant	səχnant
erbyn hyn	ɛrbɪnɪn
ebrill	ɛbrɪɬ
canais	kaːnai̯s
teipiadur	tei̯pjaːdɪr
oedi	ɔi̯di
ddigwydd	ðɪɡwɪð
rhiniart	r̥ɪnjart
beis	beiz
stafell	sdavɛɬ
aderyn y bwn	adɛrɪnəbʊn
geiriadurwyr	ɡei̯rjadɪrwɪr
esgidiau	ɛsɡɪdjai̯
tales	talɛs
gwrthwynebwyr	ɡʊrθwɪnɛbwɪr
brawychiad	brau̯əχjad
castanwydden	kasdanwiːðɛn
deildai	dei̯ldai̯
gwarchod	ɡwarχɔd
cneuen	knei̯ɛn
ffrwchnedd	frʊχnɛð
ddiod	ðiːɔd
thorrid	θɔrɪd
llaered	ɬei̯rɛd
cefnfor	keːvɛnvɔr
nghaws	ŋ̊au̯s
adeiladu	adei̯ladi
tharian	θarjan
olygu	ɔləɡi
carw	kaːru
bûm	biːm
lys	liːs
habadau	habadai̯
thala	θaːla
arwydd	arʊi̯ð
gini	ɡɪni
ysgol	əsɡɔl
plethedig	plɛθeːdɪɡ
fil	viːl
bongorff	bɔŋɡɔrf
gymru	ɡəmri
wddf	uːðuv
wele	wɛlɛ
gwregys llaethol	əɡwreːɡɪsɬei̯θɔl
nolis	nɔliz
cachu	kaːχi
rhedeg	r̥ɛdɛɡ
eisoes	ei̯sɔi̯s
chantor	χantɔr
babi	babi
dafad	davad
peiriannau arian parod	pei̯rjanai̯arjanparɔd
adferiadydd	advɛrjaːdɪð
deulo	diːlɔ
dros	drɔs
gweddïwr	ɡwɛðiʊr
strach	sdraːχ
dolen	dɔlɛn
arolwg	arɔlʊɡ
cylchgrawn	kɪlχɡrau̯n
crychau	krəχai̯
llysieuyn	ɬəʃei̯ɪn
anadlu	anadli
acen	akɛn
euog	ei̯ɔɡ
gaffer	ɡafɛr
'ma	mə
thaler	θaːlɛr
mws	muːs
mynachod	mənaχɔd
lleiandai	ɬei̯andai̯
iäaidd	jaːai̯ð
bore	boːrɛ
claddu	klaːði
gorau	ɡoːrai̯
afon	avɔn
allwedd	aɬwɛθ
un ar hugain	iːnarhɪɡai̯n
seddi	sɛði
egyr	ɛɡɪr
söolegydd	sɔɔlɛɡɪð
fel	vɛl
ymwneud	əmwnei̯d
w	w
twitter	twɪtər
godi	ɡɔdi
carwr	karʊr
gafrewig	ɡavrɛwɪɡ
seshys	sɛʃɪz
nos iau	nɔsjɔi̯
eisiau	ei̯sjai̯
arolygiaeth	arɔləɡjai̯θ
haberdâr	habɛrdaːr
ngolau	ŋɔlai̯
canmoladwy	kanmɔlaːdʊi̯
dyfeiswragedd	dəvei̯swraːɡɛð
credi	kreːdi
achlesu	aχlɛsi
pont	pɔnt
penelin	pɛnɛlɪn
adfywiad	advɪu̯jad
prydael	prədai̯l
gwalch y penwaig	ɡwalχəpɛnwai̯ɡ
gnau ffrengig	ɡnai̯frɛŋɪɡ
rhewi'n gorn	r̥ɛu̯iŋɡɔrn
acti	akti
teyrnaddoliant	tei̯rnaðɔljant
elwyf	eːlʊi̯v
gredo	ɡrɛdɔ
llygaid	ɬəɡai̯d
cyflogwr	kəvloːɡʊr
cymysglyd	kəməsɡlɪd
cymedroli	kəmɛdrɔli
mynychu	mənəχi
ngwario	ŋwarjɔ
thrennydd	θrɛnɪð
lleianaeth	ɬei̯aːnɛθ
cloriau	klɔrjɛ
piws	pɪu̯s
torres	tɔrɛs
hoffen	hɔfɛn
neb	neːb
pafin	paːvɪn
adferaf	adveːra
gwenynen	ɡwenənɛn
tŷ bach	tiːbaːχ
asesiadau	asɛʃadɛ
telid	tɛlɪd
dosbarthiadau	dɔsbarθjaːdai̯
ardderchog	arðɛrχɔɡ
gwaeth	ɡwai̯θ
nerthoedd	nɛrθɔi̯ð
mwyeilch	mui̯ei̯lχ
cytrefi	kətreːvi
chwefror	ʍɛvrɔr
thaliadau	θaljaːdai̯
corfflu	kɔrfli
cwrw	kuːru
bwgan	bʊɡan
canmolwyr	kanmɔlwɪr
nghawl	ŋ̊au̯l
gylfinau	ɡəlviːnai̯
elem	eːlɛm
treigladau	treiɡladaɛ
pedwar ar hugain	pɛdwararhiːɡɛn
deler	deːlɛr
brech	breːχ
help	hɛlp
aberdaugleddau	abɛrdai̯ɡlɛðɛ
teisen gri	tei̯sɛŋɡriː
geisio	ɡei̯sjɔ
archeb	arχɛb
sesiwn	sɛʃʊn
synnu	səni
cromfach	krɔmvaχ
adferiadyddion	advɛrjadəðjɔn
gobeithio	ɡɔbei̯θjɔ
ngwystl	ŋwɪsdɪl
elem	ɛlɛm
masgiau	masɡjɛ
adennill	adɛnɪɬ
bedr	bɛdr
adenydd	adeːnɪð
nghefn	ŋ̊ɛvn
tery	tɛri
erchyll	ɛrχɪɬ
iro	ɪrɔ
cywir	kəu̯ɪr
afon	aːvɔn
iechyd da	jeːχɪddaː
dawnsio	dau̯nsjɔ
cerdd dant	kɛrðdant
men siarlys	mɛnʃarlɪs
eraill	eːrai̯ɬ
biau	biːai̯
nyth	niːθ
pery	pɛri
urddau	ɪrðai̯
enw	ɛnu
hatyr	hatɪr
jaciau	dʒakjɛ
ciciau adlam	kikjai̯adlam
cudyn	kɪdɪn
albaneg	albanɛɡ
frith	vriːθ
ymennydd	əmɛnɪð
ceri	keːri
gwe	ɡweː
gweler	ɡweːlɛr
darparu	darpaːri
weled	wɛlɛd
peint	pei̯nt
ngwrando	ŋrɪndɔ
rhydau	r̥ədɛ
grwth	ɡruːθ
gaffai	ɡafai̯
cŵn	kuːn
pheidio	feidjɔ
phobl	fɔbɔl
canolaf	kanoːlav
llinell	ɬɪnɛɬ
sosys	sɔsɪz
canol	keːnɔl
agoraf	aɡɔrav
melys	meːlɪs
glaned	ɡlanɛd
iddi	ɪði
adfyw	advɪu̯
gwneud	ɡwnei̯d
ymlaen	mlaːn
alltud	aɬdɪd
carbon	karbɔn
amaethyddiaeth	amei̯θəðjai̯θ
mae	mai̯
jam	d͡ʒam
ffenestr	fɛnɛsdr
mabwysiadu	mabʊi̯sjadi
nodwydd	nɔdwɪð
phigwrn	fiːɡʊrn
derwydd	dɛrwɪð
dalet	dalɛt
puteindy	pɪtei̯ndi
cysylltair	kəsəɬdai̯r
cydweithredwr	kiːdwei̯θrɛdʊr
gefnau	ɡɛvnai̯
canoli	kanɔli
meddyg	meːðɪɡ
merch	mɛrχ
hunan	hɪnan
terfysgoedd	tɛrvəsɡɔi̯ð
peiriannau arian parod	pei̯rjanɛarjanpaːrɔd
pengwiniaid	pɛŋɡwɪnjɛd
blogiwr	blɔɡjʊr
gusanau	ɡɪsaːnɛ
malwod	malwɔd
gweinyddesau	ɡwei̯nəðɛsai̯
i lawr	ɪlau̯r
casáu	kasai̯
neiliaid	nei̯ljai̯d
llythrennog	ɬəθrɛnɔɡ
codau	kɔdai̯
cyn‌gyd	kəŋɡɪd
cynhennu	kənhɛni
hynt	hɪnt
elsid	ɛlsɪd
caerdydd	kai̯rdiːð
lliwydd	ɬɪu̯ɪð
cachais	kaχɛs
thîm	θiːm
wybodaeth	ʊi̯bɔdɛθ
geiriadur	ɡei̯rjadɪr
poptai	pɔptai̯
ar hyn o bryd	arhɪnɔbriːd
flynyddoedd	vlənəðɔð
phengwiniaid	fɛŋɡwɪnjai̯d
deri	dɛri
gwrthryfela	ɡʊrθrəveːla
rhydd	r̥iːð
porffor	pɔrfɔr
peintwyr	pei̯ntwɪr
gwau	ɡwai̯
drysleoedd	drəsleːɔi̯ð
hanner	hanɛr
aberystwyth	abɛrəstʊi̯θ
chwaer	wai̯r
wenoliaid	wɛnɔljai̯d
tun te	tɪnteː
putain	pɪtɛn
syniad	sənjad
dest	deːsd
cyfrin	kəvrɪn
adre	adrɛ
arholiad	arhɔljad
blynyddoedd golau	blənəðɔi̯ðɡoːlɛ
gweddïwr	ɡwɛðiːʊr
llawen	ɬau̯ɛn
traeth	traːθ
cecrus	kɛkrɪs
chloan	χlɔan
lestr	lɛstɛr
âi	aːi̯
olwg	oːlʊɡ
gwenyn gwyllt	ɡwɛnɪŋɡwɪɬd
rhynion	r̥ənjɔn
angladd	aŋlað
chwerw	χwɛru
rhyngrwyd pethau	r̥əŋrʊi̯dpɛθɛ
adenedigaeth	adɛnɛdiːɡɛθ
gwrthwynebiadau	ɡʊrθwɪnɛbjadɛ
cnewyllyn	knɛu̯əɬɪn
achwynwyr	aχʊi̯nwɪr
hwyaid	hʊi̯ai̯d
ger	ɡɛr
pabyddion	pabəðjɔn
cyfweliad	kəvwɛljad
oes	oːs
cwar	kwar
adawed	adau̯ɛd
ymddangos	əmðaŋɡɔs
seithongl	sei̯θɔŋl
cyfareddol	kəvareːðɔl
aceniad	akɛnjad
ngheffyl	ŋ̊ɛfɪl
eni	ɛni
chnwd	χnuːd
rhyw	r̥ɪu̯
chares	χarɛs
lygaid	ləɡɛd
cyfrifydd	kəvriːvɪð
doli	dɔli
sgandinafia	sɡandɪnavja
dy	də
credet	krɛdɛt
cyfamodi	kəvamoːdi
adara	adaːra
llefarydd	ɬɛvarɪð
gweithgaredd	ɡwei̯θɡaːrɛð
creisionen	krei̯ʃɔnɛn
angylion	aŋəljɔn
dawns	dau̯ns
swshi	sʊʃi
adar y bwn	aːdarəbʊn
cyflafaredd	kəvlavarɛð
ymlaen llaw	əmlai̯nɬau̯
cystal	kəsdal
tu ôl i	tjoːli
gweinyddiadau	ɡwei̯nəðjadai̯
protestannaidd	prɔtɛsdanai̯ð
cwyn	kʊi̯n
hwngari	hʊŋɡri
traethodau	trei̯θoːdɛ
phont	fɔnt
aelwyd	ei̯lʊi̯d
adar y bwn	adarəbʊn
prydain	prədɛn
cachais	kaχai̯s
siomedig	ʃɔmɛdɪɡ
gwybod	ɡuːbɔ
mwyaren	mʊi̯aːrɛn
ystad	əsdad
system	sɪsdɛm
benthyg	bɛnθɪɡ
abadesau	abadɛsai̯
thywyll	θəu̯ɪɬ
beirniadol	bei̯rnjadɔl
ngwanwyn	ŋwanwɪn
hardal	hardal
pabell	pabɛɬ
iwd	ɪu̯d
clou	klɔi̯
crynwyr	krənwɪr
telynorion	tɛlənɔrjɔn
byddarol	bəðaːrɔl
thewi	θɛu̯i
pobol	pɔbɔl
heno	heːnɔ
toddyf	tɔðɪv
les	leːs
talen	talɛn
nghael	ŋ̊aːl
dali	daːli
siani	ʃani
cydweithwyr	kiːdwei̯θwɪr
gorasgellu	ɡɔrasɡɛɬi
caf	kaːv
cyfenw	kəvɛnu
gorfod	ɡɔfɔd
doedd	doːð
technoleg gwybodaeth	tɛχnoːlɛɡɡwɪboːdɛθ
èth	ɛθ
rhaff	r̥aːf
bwrdd	bʊrð
llysiau	ɬəʃai̯
rheiddiau	r̥ei̯ðjai̯
pell	peːɬ
munudau	mɪnɪdɛ
mewn	mɪu̯n
dydd sul	dɪðsiːl
phedwar	fɛdwar
ystlum	əsdlɪm
afanen	avaːnɛn
gorllewin	ɡɔrɬɛu̯ɪn
drefydd	drɛvɪð
nghyngor	ŋ̊əŋɔr
canhwyllbren	kanhʊi̯ɬbrɛn
leidr	lei̯dr
eirin	ei̯rɪn
ynysoedd dedwydd	ənəsɔi̯ðdɛdwɪð
tudalen	tɪdalɛn
caren	karɛn
gach	ɡaːχ
picen fach	pɪkɛnvaːχ
aden	adɛn
crech	kreːχ
ymuno	əmɪnɔ
physgod	fəsɡɔd
faint	vai̯nt
utganaf	ɪtɡanav
deugain	dei̯ɡai̯n
dyrrau	dərai̯
cyfrol	kəvrɔl
creisionen	krei̯ʃoːnɛn
sero	zeːrɔ
trueni	treːni
swydd	sʊi̯ð
anogaf	anoːɡav
trist	trɪst
darianau	darjanai̯
hiliaeth	hɪljɛθ
anableddau	anablɛðai̯
ugain	iːɡɛn
chystadlu	χəsdadli
eisoes	ei̯ʃɔs
buddug	bɪðɪɡ
papaia	papai̯a
canmol	kanmɔl
meddiannau	mɛðjanai̯
nglanaf	ŋlaːnav
anifail	anɪvɛl
nghlustdlws	ŋ̊lɪsdlʊs
hunanladdwr	hɪnanɬaðʊr
priod	priɔd
gyda hyn	ɡɪdahɪn
thegan	θeːɡan
cyfryngwr	kəvrəŋʊr
nhywyll	n̥əu̯ɪɬ
afreolaidd	avrɛɔlai̯ð
saith ar hugain	sai̯θarhɪɡai̯n
unfed ar ddeg	ɪnvɛdarðeːɡ
nghais	ŋ̊ai̯s
galan	ɡaːlan
gweinyddesau	ɡwei̯nəðɛsɛ
cyfartalog	kəvartaːlɔɡ
muwch	mɪu̯χ
pedwaredd	pɛdwaːrɛð
telid	teːlɪd
chwarae	waːrɛ
dynion	dənjɔn
adfail	advai̯l
cheisio	χei̯sjɔ
pured	pɪrɛd
ieithyddiaeth	jei̯θəðjɛθ
nadolig	nadoːlɪɡ
delir	dɛlɪt
grwpiau	ɡrʊpjɛ
chweched	χweːχɛd
tua thref	tiːaθreːv
ogwr	ɔɡʊr
briallen	briaɬɛn
cactws	kaktʊs
hedd	heːð
drych	driːχ
selerau	sɛleːrai̯
bara	baːra
gwestai	ɡwɛsdai̯
galanas	ɡalaːnas
rhyfedd	r̥əvɛð
prifion	prɪvjɔn
chnau ffrengig	χnai̯frɛŋɪɡ
bastai	basdai̯
gachai	ɡaχɛ
llywio	ɬɪu̯jɔ
thalo	θalɔ
heisteddfod	hei̯sdɛðvɔd
gwybod	ɡwɪbɔd
cynhaeaf	kənhei̯av
ffoniwch	fɔnjʊχ
rhywun	r̥ɪu̯ɪn
thaliadau	θaljadai̯
sylwebu	səlwɛbi
telynores	tɛlənɔrɛs
darw	daːru
adenedigaeth	adɛnɛdiːɡai̯θ
cewri	kɛu̯ri
wlad belg	wlaːdbɛlɡ
deiliaid	dei̯ljɛd
garent	ɡarɛnt
phobl	fɔbl
canol	kanɔl
gacha	ɡaːχa
iytan	jətan
saltring	saltrɪŋ
pig	piːɡ
eni	eːni
am byth	ambɪθ
llysenw	ɬɪseːnu
newid	nɛu̯ɪd
daith	dai̯θ
wyll	wɪɬ
bywyd	bəu̯ɪd
chot law	χɔtlau̯
twrw	tʊru
caen	kai̯n
ciledrych	kɪlɛdrɪχ
nyrsys	nərsɪz
gwobrau	ɡwɔbrai̯
oferedd	ɔvɛrɛð
mynachaeth	mənaχai̯θ
taith	tai̯θ
nithio	nɪθjɔ
gweriniaethau	ɡwɛrɪnjei̯θɛ
gweithluoedd	ɡwei̯θliːɔi̯ð
adanedd	adaːnɛð
arwain	arwai̯n
siwgr	ʃʊɡɪr
taclus	taklɪs
jac codi baw	dʒakkoːdibau̯
afal	aːval
sglodyn	sɡloːdɪn
meddai	mɛðai̯
teisen radell	tei̯sɛnradɛɬ
waliau	waljai̯
tir	tiːr
nos iau	noːsjai̯
anghyfreithlon	aŋhəvrei̯θlɔn
habadaeth	habaːdɛθ
wyn	wɪn
degau	dɛɡɛ
weriniaeth	wɛrɪnjai̯θ
iau	jai̯
gwrthwynebiadau	ɡʊrθwɪnɛbjaːdɛ
ferwi	vɛrwi
dwfr	dʊvr
athrodwr	aθrɔdʊr
tybaco	təbakɔ
cymreig	kəmrei̯ɡ
anodd	aːnɔð
teisen radell	tei̯sɛnraːdɛɬ
aderyn y bwn	adeːrɪnəbʊn
edrych	ɛdrɪχ
cachai	kaːχɛ
nerf	nɛrv
oen	ɔi̯n
munudau	mɪniːdɛ
canolog	kanoːlɔɡ
dafydd	daːvɪð
nghlywed	ŋ̊lɪu̯ɛd
blaen	blai̯n
hirsgwariau	hɪrsɡwarjɛ
brenin	brɛnɪn
èf	ɛv
llwybr y gwynt	ɬʊi̯bɪrəɡwɪnt
cymraesau	kəmrei̯sai̯
meteleg	mɛteːlɛɡ
abergofiant	abɛrɡɔvjant
llong foel	ɬɔŋvɔi̯l
taf	taːv
gwladgarol	ɡwladɡarɔl
gwnaeth	ɡnaːθ
nghacen	ŋ̊akɛn
mad	maːd
abatiroedd	abatiːrɔi̯ð
daler	daːlɛr
coronafirws	kɔrɔnavɪrʊs
trolïau	trɔliːɛ
bys troed	biːstroːd
pryf	priːv
chymorth	χəmɔrθ
mhengwiniaid	m̥ɛŋɡwɪnjɛd
aromatherapyddion	arɔmaθɛrapəðjɔn
arolwg	aroːlʊɡ
delynores	dɛlənoːrɛs
heddiw	hɛði
cwestiwn	kwɛsdjʊn
argraffiadydd	arɡrafjadɪð
dydw i ddim yn siarad cymraeg	dəduiðɪmənʃaradkəmraɪɡ
gyrdd	ɡɪrð
nharw	n̥aru
bore	bɔrɛ
dyrrau	dərɛ
pathew	paθɛu̯
pïod	piːɔd
cylch	kɪlχ
adfeiliadau	advei̯ljadɛ
gorffennaf	ɡɔrfɛnav
cafon	kaːvɔn
peren	pɛrɛn
melen	mɛlɛn
bod	boːd
caru	kaːri
cymedrolwyr	kəmɛdrɔlwɪr
trolïau	trɔliːai̯
pêl droed	peːldroːd
lledr	ɬɛdr
nghath	ŋ̊aːθ
beidr	bei̯dɪr
gwpan	ɡʊpan
carem	karɛm
adeiniog	adei̯njɔɡ
addas	aðas
heulog	hei̯lɔɡ
adar o'r unlliw hedant i'r unlle	adarɔrɪnɬɪu̯hɛdantɪrɪnɬɛ
blynyddoedd golau	blənəðɔðɡɔlɛ
pi	piː
glanaf	ɡlana
'ma	ma
cythraul	kəθrɛl
iddo	iːðɔ
ateli	atɛli
ysbrydion	əsbrədjɔn
blychau llwch	bləχai̯ɬuːχ
toiledi	tɔi̯lɛdi
liwio	lɪu̯jɔ
seleri	sɛleːri
ffordd laethog	əfɔrðɬei̯θɔɡ
diogel	dɪoːɡɛl
abadaethau	abadei̯θai̯
gweithio	ɡwiːθɔ
elswn	ɛlsʊn
athrodus	aθrɔdɪs
canais	kanɛs
adwaen	adwai̯n
cadarn	kaːdarn
pentref	pɛntrɛ
epidemigau	ɛpɪdɛmɪɡai̯
meddal	meːðal
cyflym	kəvlɪm
isteitl	iːsdei̯tl
croeshoeliad	krɔi̯shɔi̯ljad
hangharad	haŋharad
preifatrwydd	prei̯vatrʊi̯ð
anghofus	aŋhoːvɪs
gweddw	ɡwɛðu
nghneuen gyll	ŋ̊nei̯ɛnɡɪɬ
dodi	dɔdi
uchelwr	ɪχeːlʊr
ffoniodd	fɔnjɔð
nawn	nau̯n
gwyllt	ɡwɪɬd
protestaniaid	prɔtɛsdanjɛd
naear	nei̯ar
adferiadau	advɛrjaːdai̯
redeg	rɛdɛɡ
nheisen	n̥iːʃɛn
cul	kiːl
mae	mə
plentynnaidd	plɛntənai̯ð
cystadleuaeth	kəsdadlei̯ɛθ
gyda	da
dyrysgoed	dərəsɡɔi̯d
chwythaf	ʍəθa
rhyngrwyd pethau	r̥əŋrʊi̯dpeːθai̯
dofn	dɔvɔn
nheledu	n̥ɛlɛdi
darianau	darjanɛ
canent	kaːnɛnt
sioe	ʃɔi̯
gwenyn	ɡweːnɪn
syml	sɪml
cyfrifiadur	kəvrɪvjaːdɪr
mis	miːs
teulu brenhinol	tei̯librɛnhɪnɔl
helc	hɛlk
elsai	ɛlsai̯
medd	meːð
iwch	ɪu̯χ
casgen	kasɡɛn
mharc	m̥ark
milwrol	mɪlʊrɔl
llawlyfr	ɬau̯lɪvɪr
teisen	tei̯ʃɛn
wddw	uːðu
bob	boːb
bord	bɔrd
heirdd	hei̯rð
athrodus	aθroːdɪs
ddaru	ðari
yr amwythig	əramʊi̯θɪɡ
tryferi	trəvɛri
cawr	kau̯r
chefn	χɛvn
pyjamas	pəd͡ʒamaz
prydain fawr	prədɛnvau̯r
banllawr	banɬau̯r
gnei	ɡnei̯
tomato	tɔmatɔ
aneiriol	anei̯rjɔl
wnsach	ʊnsaχ
timoedd	tiːmɔi̯ð
lesau	lɛsɛ
gobaith	ɡɔbɛθ
carfilod bach	karvɪlɔdbaːχ
madfallod	madvaɬɔd
chwydd	hwiːð
dogfen	dɔɡvɛn
edn	ɛdn
ais	ai̯s
oni	ɔni
ngafr	ŋaːvar
siwmperi	ʃʊmpeːri
chwech	hweːχ
mynachaeth	mənaːχɛθ
cwerylau	kwɛrəlɛ
dydd iau	diːðjɔi̯
madfallod dŵr	madvaɬɔdduːr
dre	dreː
addoldy	aðɔldi
canaf	kaːnav
cyflafareddwr	kəvlavareːðʊr
trengholiadau	trɛŋhɔljadai̯
adferol	advɛrɔl
sgri	sɡriː
cytuno	kətiːnɔ
gusanau	ɡɪsanɛ
hail	hai̯l
crydiau	krədjai̯
blodau	blɔdai̯
feirysau	vei̯rəsai̯
ait	ai̯t
pedr	pɛdr
ffedog	fɛdɔɡ
pethau	peːθai̯
talant	talant
person	pɛrsɔn
aen	ai̯n
gwenyn gwyllt	ɡweːnɪŋɡwɪɬd
dychwelyd	dəχweːlɪd
thalo	θaːlɔ
caed	kai̯d
rhagenw	r̥aɡeːnu
ysgwydd	əsɡʊi̯ð
eangderau	ɛaŋdɛrai̯
blingo	blɪŋɔ
agerddlong	aɡɛrðlɔŋ
fflworin	flʊɔrɪn
dwrci	dʊrki
chwedl	ʍeːdɛl
ffion	fiːɔn
cbac	kbak
moch daear	moːχdei̯ar
silff	sɪlf
chais	χai̯s
chwythaf	χwəθav
eog	ɛɔɡ
iseldiraidd	ɪsɛldɪrai̯ð
tarw	taru
ffenestr	fɛnɛsd
shibwns	ʃiːbʊnz
isteitlau	iːsdei̯tlɛ
twlu	tuːli
pencampwriaethau	pɛŋkampʊrjei̯θɛ
anafa	anava
ysgrifennu	sɡrɪvɛni
annwyl	anʊl
es	eːs
parot	parɔt
rewi	rɛu̯i
ryddhaf	rəðhaːv
bin	bɪn
gronellau	ɡrɔnɛɬɛ
ceisio	kei̯sjɔ
nghôt	ŋ̊oːt
gŵydd	ɡʊi̯ð
lysiau	ləsjɛ
gwynedd	ɡui̯nɛð
pennau	pɛnai̯
erioed	rjoːd
mynachaeth	mənaːχai̯θ
is	iːʃ
diodydd	djoːdɪð
torchau	tɔrχai̯
help llaw	hɛlpɬau̯
athro	aθrɔ
theisen	θei̯sɛn
olifau	ɔliːvɛ
swyddogaeth	sʊi̯ðɔɡai̯θ
copïwr	kɔpiːʊr
cae	kai̯
gwenu	ɡweːni
gwleidydd	ɡwlei̯dɪð
tewach	tɛu̯aχ
biolegydd	bjɔleːɡɪð
lled	ɬeːd
cnwd	knuːd
pedolwyr	pɛdɔlwɪr
coronafeirws	kɔroːnavei̯rʊs
fu	viː
arddangosfeydd	arðaŋɡɔsvei̯ð
abaty	abati
rheolaidd	r̥ɛoːlai̯ð
wybodaeth	wɪboːdɛθ
mynydd	məni
munudau	mɪniːdai̯
cer	kɛr
cwsg	kʊsɡ
ngwybod	ŋʊbɔd
sgwâr	sɡwaːr
ap	ap
mynd	mɪnd
egni	ɛɡni
ffonau	foːnɛ
weled	weːlɛd
llatai	ɬatai̯
elw	eːlu
garanod	ɡaraːnɔd
dydd iau	dɪðjɔi̯
ar amrantiad	aramrantjad
trof	troːv
gwybodaeth	ɡʊi̯bɔdɛθ
dawn	dau̯n
gwrando	ɡrɪndɔ
mhedol	m̥eːdɔl
denu	deːni
ngwŷdd	ŋwiːð
ngwybodaeth	ŋwɪbɔdɛθ
rhegfa	r̥ɛɡva
toiledi	tɔi̯leːdi
cachlwyth	kaχlʊi̯θ
gogleddol	ɡɔɡleːðɔl
hirddydd haf	hɪrðɪðhaːv
cacen gri	kakɛŋɡriː
ngelyn	ŋeːlɪn
chwaer	ʍaːr
saethwyr	sei̯θwɪr
gapel	ɡapɛl
clwb	kluːb
plethau	plɛθɛ
wythnos	ʊθnɔs
rhywiol	r̥ɪu̯jɔl
diodydd	djɔdɪð
ynys manaw	ənɪsmanau̯
hunanynysu	hɪnanənəsi
grêt	ɡreːt
hun	hiːn
gyd	ɡiːd
hamod	hamɔd
ychydig	χədɪɡ
goleudy	ɡɔlei̯di
carais	kaːrɛs
anuniongyrchol	anɪnjɔŋɡərχɔl
ngharafán	ŋ̊aravan
anghyflawn	aŋhəvlau̯n
ngwrando	ŋrandɔ
nhrwyddedau	n̥rʊi̯ðeːdɛ
ry	riː
mwnci	mʊŋki
telynoresau	tɛlənɔrɛsai̯
syml	sɪmɪl
barnau	barnɛ
gwelais	ɡwɛlɛs
mhyliau	m̥əljai̯
cadw	kaːdu
gordderch	ɡɔrðɛrχ
credo	krɛdɔ
annedd	anað
rhywle	r̥ʊlɛ
parch	parχ
trennydd	trɛnɪð
cylchoedd	kəlχɔð
hirgrynion	hɪrɡrənjɔn
undeg	ɪndɛɡ
cacynen	kakənɛn
sgydau	sɡədɛ
sach	saːχ
chwerw	ʍeːru
buan	biːan
cyfwelydd	kəvwɛlɪð
abades	abadɛs
mhabell	m̥aːbɛɬ
hen galan	heːnɡaːlan
piclo	pɪklɔ
dwfn	dʊvn
tudalen	tɪdaːlɛn
gorlifaf	ɡɔrliːvav
gachais	ɡaːχɛs
heog	hɛɔɡ
ford	vɔrd
helciaid	hɛlkjɛd
gyrraedd	ɡərɛð
achub	aχɪb
rai	rai̯
stemars	sdɛmarz
nysgu	nəsɡi
casnewydd	kaːsnɛu̯ɪð
hendrefydd	hɛndreːvɪð
pigan	pɪɡan
masgiau	masɡjai̯
pert	pɛrt
cynddrwg	kənðrʊɡ
nghythreuliaid	ŋ̊əθrei̯ljai̯d
rhywbeth	r̥ʊbɛθ
mhapur	m̥apɪr
holi	hɔli
gwrthwynebydd	ɡʊrθwɪneːbɪð
pechu	pɛχi
hedyn	heːdɪn
weithiwr	wei̯θʊr
winoedd	wɪnɔi̯ð
dosbarthiad	dɔsbarθjad
tharianau	θarjanai̯
euro	ei̯rɔ
mhrynu	m̥rəni
cyfarwydd	kəvarwɪð
hadar	hadar
gerir	ɡeːrɪr
prifddinas	prɪvðɪnas
enwog	ɛnwɔɡ
aethon	ɛθɔn
dwfn	dʊvʊn
unes	ɪnɛs
gwarthal	ɡwarθal
creision	krei̯ʃɔn
slej	slɛd͡ʒ
mwnt	mʊnt
darlunio	darlɪnjɔ
mollt	mɔɬt
rhwyd	r̥ʊi̯d
deunaw	dei̯nau̯
cyfle	kəvlɛ
hwyl	hʊi̯l
adargraffiadau	adarɡrafjaːdɛ
chei	χei̯
rhyddid	r̥əðɪd
chadair	χadai̯r
anodded	anoːðɛd
chwe	χweː
hefo	hɛvɔ
dysglaid	dɪʃɡlɛd
golwr	ɡɔlʊr
agora	aɡoːra
adfywiadau	advɪu̯jadai̯
clodfawr	klɔdvau̯r
teulu	tei̯li
delo	dɛlɔ
am	am
cychwyn	kəχwɪn
nghychwyn	ŋ̊əχwɪn
cynghori	kəŋhɔri
cyrhaeddaf	kərhai̯ðav
gwisgo	ɡwɪʃɡɔ
ceffyl	kɛfɪl
teifi	tei̯vi
ffordd laethwen	əfɔrðɬei̯θwɛn
iasoer	jasɔi̯r
ngwystl	ŋʊi̯sdl
rheiddiau	r̥ei̯ðjɛ
erioed	ɛrjɔi̯d
plethi	plɛθi
te gwyrdd	teːɡwɪrð
adwaenwch	adwei̯nʊχ
deses	dɛsɛs
elsent	ɛlsɛnt
grŵp	ɡruːp
wennol	wɛnɔl
nghwningen	ŋ̊ʊnɪŋɛn
eiliadau	ei̯ljadɛ
bobl	bɔbl
pyg	piːɡ
rhes	r̥eːs
eirinen fair	ei̯riːnɛnvai̯r
wyt	ʊi̯t
diwyr	diːʊi̯r
blorai	bloːrai̯
hadar	haːdar
tafarn	tavarn
mhant	m̥ant
daliadaethau	daljadei̯θai̯
delysg	deːlɪsɡ
rhinart	r̥ɪnart
migwrn	miːɡʊrn
egluro	ɛɡlɪrɔ
tegan	teːɡan
ai	ai̯
phrif	friːv
wych	wiːχ
iau	jɔi̯
chwerwddwr	χwɛrðʊr
byddwch	bəðʊχ
garet	ɡarɛt
sgîl	sɡiːl
rhyngrwyd y pethau	r̥əŋrʊi̯dəpeːθai̯
hiddewiaeth	hɪðeu̯jai̯θ
popty	pɔpti
chathod	χaθɔd
llanw	ɬanu
aros	aːrɔs
mas	maːs
coed afalau	koːdavaːlɛ
cari	kaːri
lliwyddion	ɬɪu̯əðjɔn
penblethau	pɛmblɛθɛ
ngolwg	ŋoːlʊɡ
rhewi	r̥ɛu̯i
llyfrgellwyr	ɬəvrɡɛɬwɪr
munud	mɪnɪd
weithiwr	wei̯θjʊr
chyflym	χəvlɪm
ffionau	fɪɔnai̯
sgythia	sɡəθja
ngwych	ŋwiːχ
dyrchafu	dərχaːvi
ceulo	kei̯lɔ
bore da	boːrɛdaː
gwahanol	ɡwahanɔl
acen ddisgynedig	akɛnðɪsɡənɛdɪɡ
cynghanedd	kəŋhanɛð
caniatâd	kanjataːd
maes awyr	mai̯sau̯ɪr
gwyll	ɡʊi̯ɬ
chweina	χwei̯na
damwain	damwai̯n
tharianau	θarjaːnai̯
wyth	ʊi̯θ
ffesant	fɛzant
pren	prɛn
melynion	mɛlənjɔn
taranu	taraːni
ufelai	ɪvɛlai̯
dewch	dɛu̯χ
ysmygu	əsməɡi
argraffiadaeth	arɡrafjadɛθ
helpwr	hɛlpʊr
prifddinas	priːvðiːnas
caffis	kafiz
agori	aɡɔri
pasta	pasda
mapio	mapjɔ
laeth	lai̯θ
chadair	χaːdɛr
anghydfod	aŋhədvɔd
ffeindio	fei̯ndɔ
breuddwydio	brei̯ðʊi̯djɔ
dewed	dɛu̯ɛd
chanwr	χaːnʊr
chwys	ʍiːs
cwmpas	kʊmpas
ffydd	fiːð
mewnforion	mɛu̯nvɔrjɔn
adroddaf	adroːðav
datblygu	datbləɡi
tân gwyllt	taːŋɡwɪɬd
heboca	hɛbɔka
effaith	ɛfai̯θ
nalen	naːlɛn
adegau	adɛɡɛ
mislif	mɪslɪv
craf y geifr	kraːvəɡei̯vr
arholiadau	arɔljaːdɛ
sbaen	sbai̯n
brawychiadau	brau̯əχjaːdai̯
eloch	ɛlɔχ
nghalan	ŋ̊alan
glefyd	ɡlɛvɪd
clicio	klɪkjɔ
aseswyr	asɛswɪr
chwys	χwiːs
troa	trɔa
adfeiliadau	advei̯ljadai̯
eith	ei̯θ
tatws	tatʊs
cafon	kavɔn
ŵyn	ʊi̯n
beth	beːθ
ffawydd	fau̯ɪð
colled	kɔɬɛd
actio	aktjɔ
camau	kamɛ
thywyll	θəʊi̯ɬ
camlwrw	kamlʊru
bigan	bɪɡan
cerpyn	kɛrpɪn
egwyl	ɛɡʊi̯l
big	biːɡ
carais	karɛs
lloer	ɬɔi̯r
penelin	pɛneːlɪn
sych	siːχ
wledydd	wlɛdɪð
argraffwyr	arɡrafwɪr
oriau	ɔrjai̯
caeir	kei̯ɪr
croth	kroːθ
lledieithog	ɬɛdjei̯θɔɡ
trwbl	trʊbʊl
tybio	təbjɔ
ciwcymber	kɪu̯kəmbɛr
llên	ɬeːn
thalai	θaːlai̯
arhosan	arhɔsan
eisteddfodau	sdɛðvoːdɛ
annerch	anɛrχ
bopty	bɔpti
awch	au̯χ
gallo	ɡaɬɔ
gweddi	ɡwɛði
llys	ɬiːs
treisio	trei̯ʃɔ
weddi'r arglwydd	weːðirarɡlui̯ð
ngwybodaeth	ŋwɪboːdɛθ
grilio	ɡrɪljɔ
tenant	tɛnant
mefus	meːvɪs
cawna	kau̯na
ateb	atɛb
clwb te	klʊbteː
llygaid	ɬəɡɛd
ocsiwn	ɔkʃʊn
basen	sɛn
afalau cariad	avaːlɛkarjad
seland newydd	seːlandnɛu̯ɪð
agoraf	aɡɔra
i'w	ɪu̯
gwahaniaeth	ɡwahanjɛθ
cneuen gyll	knei̯ɛnɡɪɬ
cil	kiːl
cilwg	kiːlʊɡ
hirion	hɪrjɔn
baedd	bai̯ð
caled	kalɛd
cylion	kəljɔn
heddiw	heːðɪu̯
ifan	ɪvan
ffurf	fɪrv
gwylogod	ɡʊi̯loːɡɔd
melltithio	mɛɬdɪθjɔ
ar gau	arɡai̯
corhwyaid	kɔrhʊi̯ɛd
tafwys	taːvʊi̯s
seithfed	sei̯θvad
elont	ɛlɔnt
tua thref	ʃaθreː
gwelais	ɡweːlai̯s
dalent	daːlɛnt
reis	rei̯s
diweddar	dɪu̯ɛðar
dyma	dəma
nhegan	n̥eːɡan
throed	θroːd
canit	kaːnɪt
gei	ɡei̯
ngadael	ŋaːdai̯l
ganu	ɡani
mefus	mɛvɪs
echdoe	ɛχðɔi̯
nôl	noːl
cyfaill	kəvai̯ɬ
nwyf	nʊi̯v
erch	ɛrχ
ag	aɡ
o hyn allan	ɔhɪnaɬan
gait	ɡai̯t
dydd mawrth	diːðmau̯rθ
pib	piːb
cwm	kʊm
allanol	aɬanɔl
delw	deːlu
gwraig	ɡwrai̯ɡ
awtistig	au̯tɪsdɪɡ
byth	bɪθ
thalai	θaːlɛ
chyfnither	χəvniːθɛr
adnabyddwn	adnabəðʊn
canmoliaeth	kanmɔljɛθ
chwech ar hugain	χweːχarhɪɡai̯n
draed	drai̯d
hymasiad	həmasjad
isteitlau	iːsdei̯tlai̯
chwalu	χwali
adlynu	adləni
do'ch	doːχ
ceiliog	kei̯lɔɡ
adleisiau	adlei̯sjɛ
cwpaneidiau	kʊpanei̯djɛ
credit	krɛdɪt
baratoi	baratɔi̯
bric	brɪk
gwragedd	ɡwraːɡɛð
gloan	ɡlɔan
cano	kanɔ
sefyll	sɛvɪɬ
cen cerrig	kɛnkɛrɪɡ
daliaf	daljav
ifanc	iːvaŋk
llungopïwr	ɬiːŋɡɔpiːʊr
lasach	lasaχ
iechyd	jeːχɪd
elech	eːlɛχ
manteision	mantei̯sjɔn
chochlas	χɔχlas
contractau	kɔntraktai̯
pibonwy	pɪbɔnui̯
galluog	ɡaɬiːɔɡ
gwerdd	ɡwɛrð
daeargrynfeydd	dei̯arɡrənvei̯ð
gwal	ɡwal
bargen	barɡɛn
mercher	mɛrχɛr
fleiddiau	vlei̯ðjai̯
datys	datɪs
wylio	wɪljɔ
afreolaidd	avrɛoːlai̯ð
elych	ɛlɪχ
dalu	daːli
mynegi	mənɛɡi
wrth	ʊrθ
perllan	pɛrɬan
gartre	ɡɪtrɛ
canlyn	kanlɪn
darpar	darpar
bachau	baːχɛ
amgylch	amɡɪlχ
daliadaeth	daljaːdɛθ
llyf	ɬiːv
megis	meːɡɪs
cathbysgod	kaθbəsɡɔd
phaned	faːnɛd
anghytgord	aŋhətɡɔrd
mwyaren	mʊi̯arɛn
eisiau	ɪʃɛ
ngwyddion	ŋwəðjɔn
derwyddiaeth	dɛrwəðjɛθ
bricyll	brɪkɪɬ
cyrn	kɪrn
aran	aːran
derwen	dɛrwɛn
pyliau	pəljɛ
llenydda	ɬɛnəða
duw	dɪu̯
ngwddw	ŋuːðu
bae	bai̯
hafod	havɔd
ynys wyth	ənɪsʊi̯θ
afan	aːvan
buan	bian
delais	deːlai̯s
nerfus	nɛrvɪs
teledu	tɛleːdi
gwraig	ɡrai̯ɡ
hiarll	hjarɬ
lesau	lɛsai̯
ceni	kɛni
canhwyllau	kanhʊi̯ɬɛ
well	wɛɬ
plethedig	plɛθɛdɪɡ
clywed	klɪu̯ɛd
delir	deːlɪr
graff	ɡraːf
ngweriniaeth	ŋwɛrɪnjai̯θ
dirwy	dɪrʊi̯
myfanwy	məvaːnʊi̯
ngwely	ŋwɛli
dreidl	drei̯dl
anoddaf	anoːðav
pandy	pandi
gobaith	ɡoːbɛθ
cyfatebol	kəvateːbɔl
gath	ɡaːθ
gwahaniaeth	ɡwanjɛθ
ddathlu	ðaθli
gyrru	ɡəri
rhyngwladol	r̥əŋwladɔl
ysgubor	əsɡɪbɔr
pam	pam
cyfddydd	kəvðɪð
gwrol	ɡuːrɔl
talan	taːlan
farn	varn
blwydd	blʊi̯ð
neuaddau	nei̯aðai̯
poeth	poːθ
wenoliaid	wɛnɔljɛd
adeiladaeth	adei̯ladai̯θ
tgau	tɡai̯
glŷn	ɡliːn
llesteiriau	ɬɛsdei̯rjɛ
chael	χai̯l
charai	χarai̯
gwneud	ɡnei̯d
lleian	ɬei̯an
gofynnod	ɡɔvənɔd
trengholiadau	trɛŋhɔljaːdɛ
air	ai̯r
crydiau	krədjɛ
acw	aku
chwilio	ʍɪljɔ
disgwyl	dɪsɡʊl
wiwerod	wɪu̯eːrɔd
pibonwyen	pɪbɔnui̯ɛn
adlefau	adlɛvɛ
rheiddiadur	r̥ei̯ðjadɪr
daliadaeth	daljadɛθ
phinc	fɪŋk
eglwys	ɛɡlʊs
lyfrau	lɪvrɛ
phortiwgal	fɔrtjʊɡal
haberaeron	habɛrei̯rɔn
gwenyn meirch	ɡweːnɪmmei̯rχ
carreg	karɛɡ
moresg	moːrɛsɡ
nghaint	ŋ̊ai̯nt
ager	aɡɛr
nes	neːs
adeiladaeth	adei̯laːdai̯θ
timau	tɪmai̯
caill	kai̯ɬ
paneidiau	panei̯djɛ
cyfryngiadau	kəvrəŋjadɛ
elir	eːlɪr
beiriannwr	bei̯rjanʊr
charet	χarɛt
pandai	pandai̯
nghymedrolwyr	ŋ̊əmɛdrɔlwɪr
alban arthan	albanarθan
cerddor	kɛrðɔr
cymedroldeb	kəmɛdrɔldɛb
aethpwyd	ei̯θpʊi̯d
dau	dai̯
adeiladaeth	adei̯ladɛθ
prifiau	prɪvjɛ
wythongl	ʊi̯θɔŋl
erioed	rjɔi̯d
gwahaniaeth	ɡwahanjai̯θ
gorau	ɡɔrɛ
llwgu	ɬʊɡi
gelen	ɡɛlɛn
tair ar ddeg	tai̯rarðeːɡ
'na	nə
thafarn	θavarn
nofwraig	nɔvwrai̯ɡ
gwyliedydd	ɡwɪljɛdɪð
godi	ɡoːdi
beirniadaethau	bei̯rnjadei̯θɛ
eled	eːlɛd
adfer	advɛr
rhoi	r̥ɔi̯
gwrthwynebair	ɡʊrθwɪnɛbai̯r
er	ɛr
fam	mam
gwlych	ɡwliːχ
datblygiad	datbləɡjad
teisen	tiːʃɛn
cyfarwys	kəvaːrʊi̯s
ffeindiaf	fɪnda
gaeredin	ɡai̯rɛdɪn
tud	tiːd
adnabyddwch	adnabəðʊχ
ngwddw	ŋʊðu
trefedigaeth	trɛvɛdɪɡai̯θ
ambeutu	ambei̯ti
anffurfiol	anfɪrvjɔl
herwhela	hɛrwhɛla
crëyr	krɛɪr
gwymona	ɡʊi̯moːna
swper	sʊpɛr
traddodiad	traðɔdjad
timau	tɪmɛ
farnwr	varnʊr
chwilio	ʍɪlɔ
trigeiniau	trɪɡei̯njai̯
feddwl	vɛðʊl
pryna	prəna
gusanau	ɡɪsaːnai̯
gwledydd	ɡwlɛdɪð
athrefi	aθreːvi
gallant	ɡaɬant
un ar bymtheg	iːnarbəmθɛɡ
ffraeau	frei̯ai̯
carthennau	karθɛnai̯
nudden	nɪðɛn
phyliau	fəljɛ
nghinio	ŋ̊ɪnjɔ
wythnos	ʊsnɔs
gneuen gyll	ɡnei̯ɛnɡɪɬ
cydseiniol	kɪdsei̯jɔl
golwr	ɡoːlʊr
eisiau	ɪsɛ
goleuadau	ɡɔlei̯aːdɛ
bapur	bapɪr
heraill	hɛrɪɬ
atebaf	ateːbav
ngoleuadau	ŋɔljaːdɛ
terfysgaeth	tɛrvəsɡɛθ
mynachaidd	mənaχai̯ð
cawn	kau̯n
gloch	ɡloːχ
golosg	ɡoːlɔsɡ
agerlongau	aɡɛrlɔŋai̯
dwylo	dʊi̯lɔ
onn	ɔn
nghalenigion	ŋ̊alɛnɪɡjɔn
cefn	kɛvn
cryf	kriːv
hirsgwarau	hɪrsɡwaːrɛ
peintiwr	pei̯ntjʊr
brwyna	brʊi̯na
dydd iau	dɪjai̯
canem	kaːnɛm
awgrym	au̯ɡrɪm
pwynt	pʊi̯nt
chyfoethog	χəvɔi̯θɔɡ
muchudd	mɪχɪð
tri ar hugain	triːarhiːɡɛn
mewnforio	mɛu̯nvɔrjɔ
ef	eːv
gwlad yr iâ	ɡwlaːdərjaː
llungopi	ɬɪŋɡɔpi
dor	dɔr
llaeth	ɬai̯θ
pedoli	pɛdoːli
cyflogi	kəvlɔɡi
rhyngwladol	r̥əŋladɔl
gedy	ɡɛdi
dydd mercher	dɪðmɛrχɛr
barhau	barhai̯
economegydd	ɛkɔnɔmɛɡɪð
chwrw	χuːru
eisoes	ei̯ʃʊs
chani	χani
gadael	ɡadɛl
merlyn	mɛrlɪn
traddodiadol	traðɔdjaːdɔl
oddi	ɔði
chwery	χwɛri
chwarel	χwaːrɛl
berfenwau	bɛrvɛnwɛ
wyneb	ʊi̯nɛb
yfory	əvoːri
tlawd	tlau̯d
creisionen ŷd	krei̯sjoːnɛniːd
tatŵ	tatuː
astrusi	asdrɪsi
cornel	kɔrnɛl
adfero	adveːrɔ
gwisg	ɡwɪsɡ
meiddio	meiðjɔ
crymu	krəmi
trydar	trədar
pabi	pabi
cystadleuydd	kəsdadlei̯ɪð
awstralia	au̯sdralja
neidr	nei̯dr
prudd	priːð
chanu	χaːni
lyfrau	ləvrai̯
hanes	haːnɛs
ieuenctid	jei̯ɛŋktɪd
drydanwr	drədanʊr
cefnfor	kɛvɛnvɔr
ceiniog	kiːnɔɡ
adfydus	advədɪs
ehangiad	ɛhaŋjad
elit	ɛlɪt
cu	kiː
carfil	karvɪl
tŷ	tiː
cachi	kaːχi
nghyfreithiwr	ŋ̊əvrei̯θjʊr
adlaw	adlau̯
cyfiawnder	kəvjau̯ndɛr
nheledu	n̥ɛleːdi
rhanddeiliad	r̥anðei̯ljad
awr	au̯r
llau	ɬai̯
rhisgl	r̥ɪsɡɪl
llall	ɬaɬ
carai	kaːrɛ
twrw	tuːru
cwrw	kʊru
hunion	hɪnjɔn
broch	broːχ
hwpo	hʊpɔ
ffroenuchel	frɔi̯nɪχɛl
sodlau uchel	sɔdlai̯iːχɛl
pwnc	pʊŋk
conyn	kɔnɪn
atseinio	atsei̯njɔ
ban	ban
aflafar	avlavar
dyfarnwr	dəvarnʊr
trefydd	trɛvɪð
o	oː
ffionau	fioːnɛ
chwiorydd	ʍioːrɪð
bydd	biːð
be'	bɛ
ffeindiaf	fɪndja
ffenest	fɛnɛsd
graff	ɡraf
drysfa	drəsva
goch	ɡoːχ
nyrs	nərs
gweud	ɡwei̯d
gwenith	ɡwɛnɪθ
llungopïau	ɬiːŋɡɔpiːɛ
trawsenw	trau̯sɛnu
anobaith	anoːbaiθ
ddail	ðai̯l
chwydd	χʊi̯ð
pîn	piːn
pentwr	pɛntʊr
nei	nei̯
amanita droednoeth	amanɪtadrɔi̯dnɔi̯θ
genidol	ɡɛniːdɔl
llysieua	ɬəsjei̯a
march	marχ
bywgraffiadur	bɪu̯ɡrafjadɪr
ethrefig	ɛθreːvɪɡ
llinyn	ɬɪnɪn
marchogaeth	marχoːɡɛθ
coginio	kɔɡɪnjɔ
mhobl	m̥oːbɔl
arhosfa	arhɔsva
wrth hyn	ʊrθhɪn
gwrw	ɡuːru
picau maen	pɪkɛmai̯n
chymedrolwr	χəmɛdrɔlʊr
gwylogod	ɡʊi̯lɔɡɔd
amanita benfelen	amanɪtabɛnvɛlɛn
darianau	darjaːnɛ
ysglodyn	sɡlɔdɪn
nhewed	n̥ɛu̯ɛd
nhraed	n̥raːd
hadeilad	hadei̯lad
llesteirio	ɬɛsdei̯rjɔ
theisen	θei̯ʃɛn
droet	drɔi̯t
fforch	fɔrχ
brawychwr	brau̯əχʊr
penddu	pɛnði
caerfaddon	kai̯rvaːðɔn
addolwr	aðɔlʊr
fydd	viːð
het	hɛt
parth	parθ
cheisio	χei̯ʃɔ
allblyg	aɬblɪɡ
gwddwg	ɡuːðuɡ
aelod seneddol	ei̯lɔdsɛneːðɔl
abwydyn	abʊi̯dɪn
mwst	mʊsd
trwy	trʊi̯
heliwm	hɛljʊm
roi	rɔi̯
cyfyng	kəvɪŋ
ngwddwg	ŋuːðuɡ
gwenoliaid	ɡwɛnɔljai̯d
heddlu	hɛðli
chymedrolwr	χəmɛdroːlʊr
benyw	beːnɪu̯
bysell	bəsɛɬ
diffydd	dɪfɪð
caerwynt	kai̯rwɪnt
hon	hɔn
closed	klɔsɛd
rasel	rasɛl
hesgen	hɛsɡɛn
gartref	ɡatrɛ
mynydd	mɪni
chwyldro	χwɪldrɔ
pellweledydd	pɛɬwɛleːdɪð
gaches	ɡaːχɛs
danfon	danvɔn
ngwybodaeth	ŋʊi̯bɔdai̯θ
eithaf	əi̯θav
cyfnodolyn	kəvnɔdɔlɪn
cylchu	kəlχi
cysylltu	kəsəɬdi
sadwrn	saːdʊn
tanwydd	taːnʊi̯ð
diweddar	dɪu̯eːðar
offeren	ɔfɛrɛn
amcangyfrif	amkaŋɡəvri
gwy	ɡʊi̯
caerwysg	kai̯rʊi̯sɡ
carafannau	karavanai̯
farus	varɪs
it	ɪt
awyddus	au̯əðɪs
echdoe	ɛχdɔi̯
cyfrifoldebau	kəvrɪvɔldeːbɛ
llam	ɬam
hwyaden	hʊi̯aːdɛn
chythreuliaid	χəθrei̯ljɛd
lleihau	ɬei̯hai̯
bedw	beːdu
thaclus	θaklɪs
blogiau	blɔɡjɛ
rwyd	rʊi̯d
cynaeafu	kənei̯aːvi
teisen gri	tiːʃɛŋɡriː
efallai	ɛvaɬai̯
radwla	radʊla
uchaf	əχa
lysiau	lɪʃɛ
creisionllyd	krei̯sjɔnɬɪd
teipio	tei̯pjɔ
ysbrydoli	əsbrədɔli
dynladdiad	diːnlaðjad
cangarŵ	kaŋɡaruː
busnes	bɪznɛs
tyngu	təŋi
gelyn	ɡɛlɪn
nest	nɛsd
cyfartaledd	kəvartalɛð
phedol	fɛdɔl
cwestiynau	kwɛsdjənai̯
metelegydd	mɛtɛleːɡɪð
h	hə
ysgafnder	əsɡavndɛr
culdiroedd	kɪldɪrɔi̯ð
oleuadau	ɔlei̯aːdai̯
ymladdwr	əmlaðʊr
arf	arv
glanaf	ɡlaːna
wyddion	wəðjɔn
hiddewiaeth	hɪðeu̯jɛθ
adweithegydd	adwei̯θɛɡɪð
putain	pɪtai̯n
dychrynllyd	dəχrənɬɪd
drudwen	drɪdwɛn
bryf	briːv
penfelyn	pɛnveːlɪn
gwybedyn	ɡwəbeːdɪn
aethom	ei̯θɔm
eisiau	iːʃɛ
drefydd	dreːvɪð
heibio	hei̯bɔ
mhib	m̥iːb
gwlithlaw	ɡwlɪθlau̯
ithfaen	ɪθvai̯n
munud	mɪnɛd
cymedroli	kəmɛdroːli
adweinid	adwei̯nɪd
faneg	vaːnɛɡ
ffionau	fioːnai̯
offeren	ɔfeːrɛn
draenog	drai̯nɔɡ
bachgennyn	baχɡɛnɪn
pur	piːr
ngweriniaeth	ŋwɛrɪnjɛθ
raced	rakɛd
glust	ɡlɪst
sebon	sɛbɔn
ffilmiau	fɪlmjɛ
barc	bark
mhryf	m̥riːv
jac codi baw	dʒakkɔdibau̯
rheoliadau	r̥ɛɔljaːdai̯
tadau	tadai̯
iwan	ɪu̯an
clefyd y galon	kleːvɪdəɡaːlɔn
diamod	diaːmɔd
pics	pɪks
wiwerod	wɪu̯ɛrɔd
blew	blɛu̯
gweddi'r arglwydd	ɡwɛðirarɡlui̯ð
blawd	blau̯d
ofnadwy	ɔvnaːdʊi̯
sydd	siːð
cymylau	kəməlai̯
pysgod	pəsɡɔd
glynu	ɡləni
phrydain	frədɛn
chwyno	χʊi̯nɔ
ebol	eːbɔl
bwa	buːa
ymlaen	mlai̯n
af	aːv
melfaréd	mɛlvarɛd
briciau	brikjai̯
nes	nɛs
farchnad	varχnad
gyfiawnder	ɡəvjau̯ndɛr
gain	ɡai̯n
brwdfrydedd	brʊdvrədɛð
tarianau	tarjanɛ
eraill	eːrɪɬ
ymadael	əmaːdɛl
pentis	pɛntɪs
cyfartal	kəvartal
amanita'r gwybed	amanɪtarɡwəbɛd
rhychau	r̥əχɛ
llamidogion	ɬamɪdɔɡjɔn
ticio	tɪkjɔ
huna	hɪna
gadair	ɡaːdɛr
treiglad	trei̯ɡlad
dywyll	dəʊi̯ɬ
merfenw	mɛrvɛnu
genedigaeth	ɡɛnɛdiːɡɛθ
llanc	ɬaŋk
calon	kalɔn
nghwch	ŋ̊ʊχ
tŵr	tuːr
nhafarn	n̥aːvarn
cyn‌gyd	kəŋɪd
cledr	klɛdr
erys	ɛrɪs
gymaint	ɡəmai̯nt
tg	təɡə
chnau	χnai̯
hirgrwn	hɪrɡrʊn
adrodd	adrɔð
iddewig	ɪðɛu̯ɪɡ
nhain	n̥ai̯n
brawychiadau	brau̯əχjaːdɛ
llifogydd	ɬivoːɡɪð
fara	vaːra
celet	keːlɛt
egwyl	eːɡʊl
miliwn	mɪljʊn
coronafeirws	kɔrɔnavei̯rʊs
beirniaid	bei̯rnjɛd
chacha	χaχa
diolchgarwch	diːɔlχɡarʊχ
saethu	sei̯θi
chwarren	χwarɛn
pedair	pɛdɛr
gwelwn	ɡwɛlʊn
mêl	meːl
èff	ɛf
magnelau	maɡneːlai̯
cweryl	kweːrɪl
nef	neːv
hoffet	hɔfɛt
troen	trɔi̯n
cynhennus	kənhɛnɪs
gampfa	ɡampva
beirniadu	bei̯rnjaːdi
paham	paham
tenau	teːnɛ
ofnadwy	ɔvnadʊi̯
thrwyddedau	θrʊi̯ðɛdai̯
cwstardiau	kʊsdardjɛ
blogio	blɔɡjɔ
gwrthiselder	ɡʊrθɪsɛldɛr
charai	χaːrai̯
nharianau	n̥arjaːnɛ
hynafol	hənavɔl
blodfresych	blɔdvrɛsɪχ
gano	ɡaːnɔ
chwyddiant	χwəðjant
adfilwyr	advɪlwɪr
llestr	ɬɛstɛr
gwybodaeth	ɡʊi̯boːdɛθ
pumdeg	pɪmdɛɡ
des	deːs
rhofio	r̥ɔvjɔ
laned	lanɛd
afalau	vaːlɛ
barnwr	barnʊr
cyflogaeth	kəvlɔɡɛθ
gwin newydd	ɡwiːnnɛu̯ɪð
gweles	ɡwɛlɛs
syrpréis	sərprei̯z
ngwrando	ŋwrandɔ
wyau	wiɛ
dybarth	dəbarθ
credes	kreːdɛs
athrawon	aθrau̯ɔn
phoeni	fɔi̯ni
aeled	ei̯lɛd
llwybr	ɬʊi̯bɪr
ecs	ɛks
chwaer	ʍai̯r
daled	dalɛd
gelyn	ɡeːlɪn
cyfeillgar	kəvei̯ɬɡar
teledu	tɛlɛdi
beic	bei̯k
talan	talan
ddeiliad	ðei̯ljad
du	diː
gwrthrych	ɡʊrθrɪχ
cythraul	kəθrai̯l
atelid	atɛlɪd
meddai	meːðɛ
caergaint	kai̯rɡai̯nt
pabyddiaeth	pabəðjai̯θ
hywel	həu̯ɛl
clwt	klʊt
nadlwytho	nadlʊi̯θɔ
allforion	aɬvɔrjɔn
aidd	ai̯ð
anghymreigio	aŋhəmrei̯ɡjɔ
ngoleuadau	ŋɔlei̯adɛ
gwylliaid	ɡʊi̯ɬjai̯d
cofia	kɔvja
gaeaf	ɡei̯a
cryddiaeth	krəðjɛθ
blynyddoedd golau	blənəðɔðɡoːlɛ
goleuadau	ɡɔljaːdɛ
gôt	ɡoːt
ffeindio	fei̯ndjɔ
hadwaenent	hadwei̯nɛnt
chaleted	χalɛtɛd
awtistiaeth	au̯tɪsdjai̯θ
habwyd	habʊi̯d
ymgloi	əmɡlɔi̯
eryr	eːrɪr
seleri	sɛlɛri
lasen	lasɛn
awyren	au̯ərɛn
credant	krɛdant
tatŵs	tatuːz
nhreisiwr	n̥rei̯sjʊr
arwynebedd	arwɪneːbɛð
marchogaeth	marχɔɡai̯θ
pigwrn	piːɡʊrn
casglu	kasɡli
elen	ɛlɛn
lanaf	lanav
sychnentydd	səχnɛntɪð
lleua	ɬei̯a
gogs	ɡɔɡz
cyllell	kəɬɛɬ
achubwr	aχɪbʊr
geiriadur	ɡei̯rjaːdɪr
sgôr	sɡoːr
phen	fɛn
weddïo	wɛðiɔ
biliwn	bɪljʊn
seliau	sɛljai̯
chwech ar hugain	weːχarɪɡɛn
telynoresau	tɛlənɔrɛsɛ
edfryd	ɛdvrɪd
aeaf	ei̯av
ddalen	ðaːlɛn
piau	piːai̯
nghymedrolwr	ŋ̊əmɛdroːlʊr
chefnau	χɛvnɛ
ionawr	jɔnau̯r
cafas	kavas
swynol	sʊi̯nɔl
flaidd	vlai̯ð
cymharu	kəmari
magnelau	maɡneːlɛ
gwefan	ɡweːvan
llew	ɬɛu̯
lesoedd	lɛsɔi̯ð
mynydd	mənɪð
ffion	fiɔn
u	iːbeːdɔl
cyfnodol	kəvnoːdɔl
cynnyrch	kənɪrχ
anfantais	anvantɛs
dalo	daːlɔ
thematig	θɛmatɪɡ
grawnwin	ɡrau̯nwɪn
deset	ðɛsɛt
haden	haːdɛn
gwnaeth	naːθ
iogwrt	jɔɡʊrt
cefnau	kɛvnai̯
metelegwyr	mɛtɛlɛɡwɪr
tybiwyd	təbjʊi̯d
dw i'n iawn	duinjaun
ymrafaelion	əmravei̯ljɔn
goes	ɡoːs
achubiaeth	aχɪbjai̯θ
pleidleisio	plei̯dlei̯sjɔ
côr y cewri	koːrəkɛu̯ri
cilgant	kɪlɡant
arolygiadau	arɔləɡjaːdɛ
neithiwr	niθʊr
beicio	bei̯kjɔ
cwerylau	kwɛrəlai̯
arholiadau	arhɔljadɛ
mân	maːn
dalo	dalɔ
gwelet	ɡweːlɛt
anialwch	anjalʊχ
petryalau	pɛtriaːlai̯
pin	piːn
adnodd	adnɔð
w	uː
dringo	drɪŋɔ
adborth	adbɔrθ
barbeciwio	barbɛkɪu̯jɔ
ugeiniau	ɪɡei̯njɛ
tudno	tɪdnɔ
tarian	tarjan
neud	nei̯d
unfed	ɪnvɛd
gweled	ɡweːlɛd
sylwebu	səlweːbi
aethent	ei̯θɛnt
tewi	tɛu̯i
taliff	talɪf
gwenyn mêl	ɡwɛnɪmmeːl
hogiau	hɔɡjɛ
gwaethaf	ɡwei̯θa
teires	tei̯rɛs
gychwyn	ɡəχwɪn
llaith	ɬai̯θ
chaffi	χafi
efo	ɛvɔ
bwlgaria	bʊlɡarja
pyrwydd	pɪrʊi̯ð
pyglyd	pəɡlɪd
unan	ɪnan
adaregydd	adareːɡɪð
nythfeydd	nəθvei̯ð
llyfrgell	ɬəvrɡɛɬ
achan	aχan
llinos	ɬiːnɔs
ngwylio	ŋwɪljɔ
roeg	rɔi̯ɡ
anfanteision	anvantei̯sjɔn
ymlacio	əmlakjɔ
penfelyn	pɛnvɛlɪn
athrodi	aθroːdi
helwyr	hɛlwɪr
leician	lɪkjan
ugeiniau	ɪɡei̯njai̯
dirmygu	dɪrməɡi
gredo	ɡreːdɔ
dydd sadwrn	diːðsadʊrn
chymaint	χəmɛnt
ffraeon	frei̯ɔn
llwchwr	ɬʊχʊr
llythrennedd	ɬəθrɛnɛð
nerth	nɛrθ
eiddgarwch	ei̯ðɡarʊχ
cyfair	kəvai̯r
gwlyb	ɡwliːb
maestref	meisdrɛv
rhaid	rai̯d
llywodraethu	ɬəu̯ɔdrei̯θi
bibgorn	bɪbɡɔrn
canmoladwy	kanmɔladʊi̯
syndodau	səndɔdai̯
negfed	nɛɡvɛd
anobeithiol	anɔbei̯θjɔl
peiriannau llungopïo	pei̯rjanai̯ɬiːŋɡɔpiːɔ
credaf	kreːda
celai	keːlɛ
sgandinafaidd	sɡandɪnavai̯ð
winoedd	wiːnɔi̯ð
aethem	ei̯θɛm
bronrhuddyn y mynydd	brɔnr̥ɪðɪnəmənɪð
deles	dɛlɛs
cloddfa	klɔðva
hydref	hədrɛv
pethau	peːθɛ
buddugwyr	bɪðɪɡwɪr
hwnna	hʊna
chwech ar hugain	hweːχarhɪɡɛn
pori	pɔri
gaffed	ɡafɛd
heno	hɛnɔ
chaled	χaːlɛd
rydw	rədw
digalondid	dɪɡalɔndɪd
caerdydd	kərdiːð
ystiflogod	əsdɪflɔɡɔd
geilw	ɡei̯lu
ril	riːl
cyfandir	kəvandɪr
siafio	ʃavjɔ
ngweithiwr	ŋwei̯θʊr
ngwybodaeth	ŋʊi̯boːdai̯θ
cydweithio	kiːdwei̯θjɔ
benywaidd	bɛnɪu̯ai̯ð
dyddiadau	dəðjaːdɛ
pharoted	farɔtɛd
hefyd	heːvɪd
gorchymyn	ɡɔrχəmɪn
ciwcymbr	kɪu̯kəmbr
terfynau	tɛrvənai̯
gẃraidd	ɡʊrai̯ð
rheolaidd	r̥ɛoːlɛð
daliadau	daljadɛ
yn achlysurol	ənaχləsiːrɔl
hendrefydd	hɛndrɛvɪð
glythineb	ɡləθɪnɛb
erfyn	ɛrvɪn
gradd	ɡraːð
goddef	ɡoːðɛ
cwstardiau	kʊsdardjai̯
ers	ɛrs
argoel	arɡɔi̯l
brawychiadau	brau̯əχjadɛ
ôl	oːl
colledion	kɔɬɛdjɔn
uchel	iːχɛl
argraffyddion	arɡrafəðjɔn
hysbys	həsbɪs
efo	eːvɔ
thei	θei̯
archebu	arχeːbi
sothach	sɔθaχ
saith ar hugain	sai̯θarhɪɡɛn
efrog	ɛvrɔɡ
laeth	laːθ
mheiriannwr	m̥ei̯rjanʊr
mrawd	mrau̯d
adfywiol	advɪu̯jɔl
canolig	kanoːlɪɡ
amlwg	amlʊɡ
garnau	ɡarnai̯
chwyrn	χwɪrn
ffrind	frɪnd
eleni	leːni
arth fwyaf	arθvʊi̯av
more	mɔrɛ
cloent	klɔi̯nt
syflyd	səvlɪd
penderfynu	pɛndɛrvəni
anafais	anaːvɛs
còd	kɔd
chlybiau	χləbjɛ
dawnsio	dau̯nsɔ
dychryn	dəχrɪn
dryslwyn	drəslʊi̯n
norwy	noːrʊi̯
gobeithio	ɡɔbei̯θɔ
rhudd	r̥iːð
ceinach	kei̯naχ
dewi	dɛu̯i
elai	eːlɛ
gwybodaeth	ɡʊi̯boːdai̯θ
siopa	ʃɔpa
tor	tɔr
drysle	drəslɛ
alban cyntefin	albankənteːvɪn
cacha	kaːχa
ymladdfeydd	əmlaðvei̯ð
carais	kaːrai̯s
brân gernyw	braːnɡɛrnɪu̯
greto	ɡrɛtɔ
ganit	ɡanɪt
paentiau	pei̯ntjai̯
adferadwy	advɛraːdʊi̯
rhyfeddu	r̥əvɛði
corneli	kɔrneːli
meddygfa	mɛðəɡva
afancod	avaŋkɔd
rhwng	r̥ʊŋ
mhethau	m̥eːθai̯
teitlau	tei̯tlai̯
siocled	ʃɔklɛd
eiliad	ei̯ljad
anobaith	anɔbɛθ
henaint	hɛnai̯nt
arian	arjan
asesiad	asɛsjad
ffermio	fɛrmjɔ
gwell	ɡwɛɬ
fenig	veːnɪɡ
gafael	ɡavɛl
warws	waːrʊs
dafarn	davarn
oriau	ɔrjɛ
peithiau	pei̯θjɛ
cernyweg	kɛrnəu̯ɛɡ
pedol	peːdɔl
èdd	ɛð
economegwyr	ɛkɔnɔmɛɡwɪr
charo	χarɔ
tery	teːri
effaith	ɛfɛθ
lwnc	lʊŋk
poenit	pɔi̯nɪt
eisteddfodau	ei̯sdɛðvoːdai̯
elent	ɛlɛnt
llun y llong	ɬiːnəɬɔŋ
oferedd	ɔveːrɛð
blychau llwch	bləχɛɬuːχ
sgwd	sɡuːd
rhegen	r̥eːɡɛn
helaeth	heːlai̯θ
arllwys	arɬʊi̯s
aech	ai̯χ
gall	ɡaːɬ
grefi	ɡreːvi
rywbeth	rʊbɛθ
bwm y gors	bʊməɡɔrs
deigryn	dei̯ɡrɪn
yn union	ənɪnjɔn
gwenhwyfar	ɡwɛnhʊi̯var
gwahanol	ɡwahaːnɔl
drwyddedau	drʊi̯ðɛdɛ
gerdded	ɡɛrðɛd
gemwaith	ɡɛmwai̯θ
ddenmarc	ðɛnmark
chegin	χeːɡɪn
aethoch	ei̯θɔχ
siwan	ʃʊan
coronafirws	kɔroːnaviːrʊs
syml	səml
rhwystredigaeth	r̥ʊi̯sdrɛdiːɡɛθ
hunarddeg	hiːnarðeːɡ
heddiw	heːði
llundain	ɬɪndɛn
huna	hiːna
bengwiniaid	bɛŋɡwɪnjɛd
unigrywiaeth	ɪnɪɡrɪu̯jɛθ
tudalennau gwe	tɪdalɛnɛɡweː
frenin	vrɛnɪn
adferiedydd	advɛrjɛdɪð
radio	radjɔ
gwrthgymdeithasol	ɡʊrθɡəmdei̯θasɔl
croen	kroːn
carafán	karavan
leision	lei̯sjɔn
ymrysonwr	əmrəsoːnʊr
anobaith	anɔbaiθ
treisiol	trei̯sjɔl
siarad	ʃaːrad
drysi	drəsi
dydd sadwrn	dɪsadʊrn
henaint	heːnai̯nt
adnebydd	adnɛbɪð
gwiwerod	ɡwɪu̯ɛrɔd
garais	ɡaːrɛs
archangylion	arχaŋəljɔn
caffed	kafɛd
dyryslwyni	dərəslʊi̯ni
cyfartalog	kəvartalɔɡ
llosgi	ɬɔsɡi
perfeddion	pɛrvɛðjɔn
helyglys	hɛləɡlɪs
archfarchnad	arχvarχnad
gweinyddiad	ɡwei̯nəðjad
daioni	dajɔni
cod	koːd
pengwin	pɛŋɡwɪn
adolygu	adɔləɡi
palu	paːli
colomen	kɔlɔmɛn
melin	mɛlɪn
byddwn	bəðʊn
cynuta	kənɪta
hysgi	həsɡi
peiriannau	pei̯rjanai̯
asgellog	asɡɛɬɔɡ
nhaliadau	n̥aljadɛ
sgwariau	sɡwarjai̯
fochyn	voːχɪn
hosbisau	hɔsbɪsai̯
dengys	dɛŋɡɪs
gloyw	ɡlɔi̯u
ebychnod	ɛbəχnɔd
cyhyrog	kəhərɔɡ
pinafal	pɪnaval
sidan	siːdan
tocyn	tɔkɪn
cweryl	kwɛrɪl
ystiflogod	əsdɪfloːɡɔd
long	lɔŋ
tâp	taːp
adael	aːdɛl
cadair	kadɛr
ganai	ɡaːnai̯
cau	kai̯
geni	ɡɛni
eidal	ei̯dal
helciaid	hɛlkjai̯d
gachais	ɡaːχai̯s
ffenestr	feːnɛsd
seibiau	sei̯bjɛ
byddai	bəðɛ
adarwr	adarʊr
peli troed	pɛlitroːd
unigolyn	ɪnɪɡoːlɪn
ymrysongar	əmrəsɔŋɡar
chell	χɛɬ
telynores	tɛlənoːrɛs
nodi	nɔdi
nabod	naːbɔd
abades	abaːdɛs
anaf	aːnav
adfeiliadau	advei̯ljaːdɛ
chinio	χɪnjɔ
chlust	χlɪst
talet	taːlɛt
twyllwr du	tʊi̯ɬʊrdiː
riliau	rɪljai̯
cwtshys	kʊtʃɪz
dorrai	dɔrai̯
geiriau	ɡei̯rɛ
ardaloedd	ardaːlɔi̯ð
perthyn	pɛrθɪn
cledr	kleːdɛr
aderyn	adeːrɪn
dyrnu	dərni
chafas	χaːvas
ieithyddion	jei̯θəðjɔn
ymuno	əmiːnɔ
rhwydd	r̥ʊi̯ð
doliau	dɔljɛ
mordydd	mɔrdɪð
gwyryf	ɡwərɪv
basio	basjɔ
picls	pɪklz
nghastell	ŋ̊asdɛɬ
garit	ɡaːrɪt
draed	draːd
harlwy	harlui̯
delom	deːlɔm
thelynores	θɛlənoːrɛs
bencampwr	bɛŋkampʊr
dwywaith	dʊi̯wai̯θ
wŷr	wiːr
ychwanegiad	əχwanɛɡjad
adwaenid	adwei̯nɪd
wlad	wlaːd
nhrydanwr	n̥rədaːnʊr
protocol	prɔtɔkɔl
nghwrw	ŋ̊uːru
cloriau	klɔrjai̯
bach	baːχ
gwaethaf	ɡwei̯θav
cyrsiau	kərsjɛ
char	χar
hechrydu	hɛχrədi
o'r gloch	ɔrɡloːχ
byrddydd gaeaf	bərðɪðɡei̯a
hach	aːχ
cerwch	keːrʊχ
metelegol	mɛtɛleːɡɔl
afalau	valɛ
hirnod	hɪrnɔd
cydsynio	kɪdsənjɔ
hinon	hiːnɔn
ohirio	ɔhɪrjɔ
dyfrfarch	dəvrvarχ
caner	kaːnɛr
brathu	braθi
rhwydwaith	r̥ʊi̯dwai̯θ
lifft	lɪfd
uwchben	ɪu̯χbɛn
ngleision	ŋlei̯sjɔn
arfer	arvɛr
elai	ɛlai̯
hunanladdwr	hɪnanɬaːðʊr
canslo	kanslɔ
söolegwr	sɔɔlɛɡʊr
croes	krɔi̯s
wyth ar hugain	ʊi̯θarhiːɡai̯n
nrama	nrama
troli	trɔli
allai	aɬai̯
ymlŷn	əmliːn
buddsoddi	bɪðsoːði
ysbrydoli	əsbrədoːli
gwylio	ɡwɪljɔ
anweddu	anwɛði
anogaf	anɔɡav
gwybedyn	ɡwəbɛdɪn
phigwrn	fɪɡʊrn
fod	voːd
llaswyr	ɬasʊi̯r
cynhyrchu	kənhərχi
rhywbeth	rʊbɛθ
rondefŵ	rɔndɛvuː
o flaen	ɔvlaːn
sawdd	sau̯ð
gweld	ɡwɛld
crychau	krəχɛ
asesiadau	asɛsjaːdai̯
adar duon	adardiːɔn
ffenest	feːnɛsd
goleuadau	ɡɔlei̯adai̯
cwerylwr	kwɛrəlʊr
adweitheg	adwei̯θɛɡ
clawr	klau̯r
cryddiaeth	krəðjai̯θ
blogiau	blɔɡjai̯
utganu	ɪtɡani
angel	aŋɛl
cyfryngu	kəvrəŋi
iselydd	ɪseːlɪð
carw llychlyn	kaːruɬəχlɪn
heisteddfodau	hei̯sdɛðvɔdɛ
caerau	kei̯rɛ
ar gof a chadw	arɡoːvaχaːdu
carco	karkɔ
cyfnos	kəvnɔs
bryna	brəna
nadroedd	nadrɔð
un	iːn
glyw	ɡlɪu̯
nglawio	ŋlau̯jɔ
oleuadau	ɔljadɛ
canai	kanɛ
actores	aktɔrɛs
lanaf	laːnav
hendrefa	hɛndreːva
abadau	abaːdai̯
gwylanod	ɡʊi̯lanɔd
ystafell	əsdavɛɬ
gwobr	ɡwɔbr
cefnog	kɛvnɔɡ
ddefnyddio	ðɛvnəðjɔ
cosyn	kɔsɪn
chlefyd	χlɛvɪd
llasen	ɬasɛn
gegin	ɡɛɡɪn
wybodaeth	ʊi̯boːdɛθ
hoffest	hɔfɛsd
trafod	travɔd
llawfeddyg	ɬau̯vɛðɪɡ
deng	dɛŋ
gael	ɡaːl
gwaredu	ɡwarɛdi
mair	mai̯r
castell	kasdɛɬ
cerwyn	keːrui̯n
talem	talɛm
codi	koːdi
chadair	χadɛr
sadwrn	saːdʊrn
gwelsen	ɡwɛlsɛn
anghofuster	aŋhɔvɪsdɛr
blogwyr	blɔɡwɪr
torchog	tɔrχɔɡ
ddeud	ðei̯d
ciw	kɪu̯
trengholiad	trɛŋhɔljad
drydanwr	drədaːnʊr
berfau	bɛrvɛ
gyda	ɡɪda
hances	hankɛs
blaidd	blai̯ð
gobeithiol	ɡɔbei̯θjɔl
newydd	nɛu̯ɪð
cyfnither	kəvniːθɛr
prysglwyn	prəsɡlʊi̯n
gares	ɡaːrɛs
dau ar hugain	dai̯arhɪɡai̯n
cronni	krɔni
caerfaddon	kai̯rvaðɔn
chwech ar hugain	weːχariːɡɛn
phastai	fasdai̯
coed	kɔi̯d
cara	kara
adeiladu	adei̯laːdi
helwr	hɛlʊr
corgi	kɔrɡi
olaf	oːlav
crëyr	kreːɪr
chefn	χɛvɛn
swyddfa	sʊi̯ðva
adargraffiadau	adarɡrafjadɛ
betws	bɛtʊs
sawl	sau̯l
hadu	hadi
gostyngaidd	ɡɔsdəŋai̯ð
hunain	hɪnai̯n
oren	oːrɛn
dîm	diːm
damweiniau	damwei̯njɛ
briallu	brjaɬi
hudlath	hɪdlaθ
adaregol	adareːɡɔl
gallai	ɡaɬɛ
uchaf	iːχav
iddew	ɪðɛu̯
torrem	tɔrɛm
gemau	ɡeːmai̯
garchar	ɡarχar
hifanc	hɪvaŋk
abergwaun	abɛrɡwai̯n
tyred	tərɛd
gof	ɡoːv
dihareb	dɪhaːrɛb
gofalus	ɡɔvalɪs
anghydraddoldeb	aŋhədraðɔldɛb
sgriau	sɡriːai̯
cyn hyn	kɪnhɪn
rhodri	r̥ɔdri
gadair	ɡaːdai̯r
chlustdlws	χlɪsdlʊs
theulu	θei̯li
in	ɪn
iasol	jasɔl
loegr	lɔi̯ɡr
nghoch	ŋ̊oːχ
gweinyddes	ɡwei̯nəðɛs
fforest	fɔrɛst
sawsiau	sau̯sjɛ
crwst	krʊsd
genhinen	ɡɛnhɪnɛn
laned	laːnɛd
nhaliadau	n̥aljaːdɛ
tywydd	təʊi̯ð
coes	koːs
iddi	iːði
gyfforddus	ɡəfɔrðɪs
asgell	asɡɛɬ
achwyn	aːχʊi̯n
ocsigenu	ɔksɪɡeːni
adferol	adveːrɔl
pabyddiaeth	pabəðjɛθ
dyddiadau	dəðjaːdai̯
glynol	ɡlənɔl
glaw	ɡlau̯
peth	peːθ
gwg	ɡuːɡ
ceith	kəi̯θ
cig	kiːɡ
rywun	rɪu̯ɪn
nharw	n̥aːru
actores	aktoːrɛs
llysg	ɬɪsɡ
cinio	kɪnɔ
cadernid	kadɛrnid
olau	ɔlai̯
angharad	aŋharad
edrydd	ɛdrɪð
diodydd	diɔdɪð
dannoedd	danɔð
pobl	pɔbl
jôc	d͡ʒoːk
nghefnfor	ŋ̊eːvɛnvɔr
garais	ɡarai̯s
est	eːsd
cnoi	knɔi̯
hardded	harðɛd
llwytho	ɬʊi̯θɔ
mango	maŋɡɔ
llinos	ɬɪnɔs
dirmygus	dɪrməɡɪs
boddi	bɔði
diwethaf	dɪu̯ɛθa
diodydd	dioːdɪð
galanas	ɡalanas
deunydd	dei̯nɪð
llychlynnaidd	ɬəχlənai̯ð
chana	χana
ffionau	fɪɔnɛ
beirniadaethau	bei̯rnjadei̯θai̯
eng	ɛŋ
cyfamodi	kəvamɔdi
lefrith	lɛvrɪθ
brythoneg	brəθoːnɛɡ
clodwiw	klɔdwɪu̯
nail	nai̯l
crewyr	krɛu̯ɪr
tenantiaid	tɛnantjai̯d
achwynydd	aχʊi̯njɪð
selerau	sɛleːrɛ
elltydd	ɛɬdɪð
berfau	bɛrvai̯
amddiffyn	amðɪfɪn
tâp masgio	taːpmasɡjɔ
carchar	karχar
iesu	jɛsi
meddwl	meːðʊl
gwyar	ɡʊi̯ar
prysglwyni	prəsɡlʊi̯ni
unwaith	ɪnwai̯θ
pluen eira	pliɛnei̯ra
wybodaeth	wəboːdɛθ
baned	baːnɛd
grist	ɡrɪst
machgenyn	maχɡɛnɪn
cyntefin	kəntɛvɪn
trigain	trɪɡai̯n
disgybl	dɪsɡɪbl
taid	tai̯d
syth	siːθ
cynnar	kɪnar
heddwch	heːðʊχ
gafael	ɡavai̯l
awyrgylchoedd	au̯ərɡəlχɔi̯ð
adleisiau	adlei̯ʃai̯
gair	ɡai̯r
dysglaid	dɪsɡlai̯d
masgau	masɡai̯
ngardd	ŋarð
pencampwr	pɛŋkampʊr
rhwydwaith	r̥ʊi̯dwɛθ
'y	ə
ferdis	vɛrdɪs
chain	χai̯n
telyn deires	teːlɪndei̯rɛs
glöyn	ɡlɔɪn
celen	kɛlɛn
eirin gwlanog	ei̯rɪŋɡwlaːnɔɡ
toddf	tɔðv
hydrefau	hədreːvai̯
crwban	krʊban
wyres	ʊi̯rɛs
marnau	marnai̯
gwasanaeth	ɡwasanɛθ
wystl	wɪsdl
aberaeron	abɛrei̯rɔn
brasterog	brasdɛrɔɡ
hollti	hɔɬdi
gymedrolwr	ɡəmɛdroːlʊr
sèd	zɛd
tryweli	trəu̯ɛli
gweinidog	ɡwei̯niːdɔɡ
bachau	baːχai̯
conwydden	kɔnwɪðɛn
oedolion	ɔi̯dɔljɔn
cachet	kaχɛt
mynachaeth	mənaχɛθ
dodi	doːdi
menig	mɛnɪɡ
peiriant llungopïo	pei̯rjantɬiːŋɡɔpiːɔ
ystifflog	əsdɪflɔɡ
cywyddau	kəwəðɛ
rhwyg	r̥ʊi̯ɡ
gest	ɡɛst
nhatws	n̥atʊs
defnyddio	dɛvnəðjɔ
ddalen	ðalɛn
ymateb	əmatɛb
chyfarfod	χwarvɔd
huno	hiːnɔ
conwy	kɔnʊi̯
gwerthu	ɡwɛrθi
cachu	kaχi
byddarol	bəðarɔl
degfed	dɛɡvɛd
talwch	taːlʊχ
crynwr	krənʊr
siomau	ʃɔmɛ
dadleuol	dadlei̯ɔl
llai	ɬai̯
nglanaf	ŋlana
creision ŷd	krei̯sjɔniːd
cynnydd	kənɪð
paradwys	paradʊi̯s
llusen america	ɬɪsɛnamɛrɪka
anner	anɛr
trefor	trɛvɔr
ffêr	feːr
lluddias	ɬɪðjas
sut wyt ti	sɪtʊi̯ttiː
cusan	kɪsan
mwsogla	mʊsɔɡla
cyflwyno	kəvlʊi̯nɔ
nhrefydd	n̥reːvɪð
storïau	sdɔriːai̯
barbeciws	barbɛkɪu̯z
gwernog	ɡwɛrnɔɡ
cadwyn	kadʊi̯n
ogledd	ɔɡlɛð
ymerodraeth	əmɛrɔdrai̯θ
phum	fɪm
sêls	seːlz
talo	talɔ
beiddio	beiðjɔ
dali	dali
trafferthus	trafɛrθɪs
cana	kana
mhedol	m̥ɛdɔl
genedlaethol	ɡɛnɛdlei̯θɔl
heddluoedd	hɛðliɔi̯ð
map	map
boneddigesau	bɔnɛðɪɡɛsɛ
morwyn	mɔrʊi̯n
charwr	χarʊr
ynys manaw	ənɪsmaːnau̯
tost	tɔst
academïau	akadɛmiːɛ
cowyll	kɔu̯ɪɬ
olew olewydd	oːlɛu̯ɔlɛu̯ɪð
phaith	fai̯θ
llyfr	ɬɪvɪr
nos sadwrn	noːssaːdʊn
anifail	aniːvɛl
ymryson	əmrəsɔn
iselder	ɪʃɛldɛr
llaw	ɬau̯
llawfeddygon	ɬau̯vɛðəɡɔn
dwyt	dʊi̯t
dosbarthwyr	dɔsbarθwɪr
sêl	seːl
chegin	χɛɡɪn
undebau	ɪndɛbai̯
trydanwr	trədaːnʊr
cloen	klɔi̯n
cyfnewid	kəvnɛu̯ɪd
cachi	kaχi
chyrraedd	χərɛð
aberafan	abɛraːvan
canem	kanɛm
doit	dɔi̯t
gartre	ɡatrɛ
cysylltnod	kəsəɬdnɔd
ffensio	fɛnsjɔ
gachais	ɡaχai̯s
llanelli	ɬanɛɬi
chweched	ʍɛχɛd
cucumer	kɪkɪmɛr
colur	kɔlɪr
jac	dʒak
synnwyr	sənwɪr
dwg	duːɡ
wybodaeth	wɪbɔdai̯θ
llu	ɬiː
cydweithiwr	kiːdwei̯θjʊr
ngweddïo	ŋwɛðiːɔ
coleg	kɔlɛɡ
afallen	avaɬɛn
gwisg	ɡwɪʃɡ
deall	deːaɬ
gwerthwr	ɡwɛrθʊr
asid	asɪd
nghwrdd	ŋ̊ʊrð
gornestau	ɡɔrnɛsdɛ
byddi	bəði
technoleg gwybodaeth	tɛχnɔlɛɡɡwɪbɔdai̯θ
gordderchadon	ɡɔrðɛrχadɔn
chweched	χwɛχɛd
gwragedd	ɡraːɡɛð
heisteddfodau	hei̯sdɛðvoːdai̯
le	leː
pau	pai̯
talai	taːlai̯
cocsa	kɔksa
chymaint	χəmai̯nt
teisen gri	tei̯ʃɛŋɡriː
parc	park
adfero	advɛrɔ
bachwr	baːχʊr
mewnfodol	mɛu̯nvɔdɔl
nhegan	n̥ɛɡan
nhrwydded	n̥rʊi̯ðɛd
beirniadaeth	bei̯rnjadai̯θ
olaf	oːla
allforyn	aɬvoːrɪn
gartre	ɡətrɛ
cafodd	kavɔð
gochlas	ɡɔχlas
ngweithiwr	ŋwei̯θjʊr
i	iːðɔt
nest	neːsd
coed afalau	kɔi̯davalai̯
achwyniadau	aχʊi̯njadai̯
gaf	ɡaːv
bambŵ	bambuː
allforio	aɬvɔrjɔ
garnau	ɡarnɛ
dorsen	dɔrsɛn
'th	θ
haeddel	hei̯ðɛl
aifft	ai̯ft
cyfieithu	kəvjei̯θi
canais	kanai̯s
phabell	faːbɛɬ
pêl droed	peːldrɔi̯d
lyf	liːv
telais	teːlai̯s
rhodiwch	r̥ɔdjʊχ
fwthyn	vʊθɪn
celyn	kɛlɪn
rheolwr	r̥ɛoːlʊr
ffens	fɛns
bengwiniaid	bɛŋɡwɪnjai̯d
firws	vɪrʊs
nghymaint	ŋ̊əmai̯nt
gedy	ɡeːdi
rhesymol	r̥ɛsəmɔl
gwenyn meirch	ɡwɛnɪmmei̯rχ
ngwyched	ŋwəχɛd
adran	adran
anafai	anaːvai̯
tudalennau	tɪdalɛnai̯
medi	mɛdi
blodyn	blɔdɪn
ocsiynau	ɔkʃənɛ
cristnogaeth	krɪsdnɔɡai̯θ
cyfarwydd	kəvaːrʊi̯ð
hyn a'r llall	hɪnarɬaɬ
deiliaid	dei̯ljai̯d
chul	χiːl
ymrysonwr	əmrəsɔnʊr
mwthyn	mʊθɪn
lleianod	ɬei̯aːnɔd
llursod	ɬɪrsɔd
nghlybiau	ŋ̊ləbjai̯
cachen	kaχɛn
peirianwaith	pei̯rjanwai̯θ
santesau	santɛsɛ
maes	maːs
ngaeaf	ŋei̯av
ffrygydau	frəɡədai̯
cadwch	kaːdʊχ
fleiddiaid	vlei̯ðjɛd
trefor	treːvɔr
cynulleidfa	kənɪɬei̯dva
anghydsynio	aŋhɪdsənjɔ
wyll	ʊi̯ɬ
cwsmer	kʊsmɛr
tŷ bwyta	tiːbʊi̯ta
ergyd	ɛrɡɪd
nglasach	ŋlasaχ
cenhinen	kɛnhɪnɛn
ieithadur	jeiθadɪr
codau	koːdai̯
cath	kaːθ
môn	moːn
menyn	meːnɪn
detyd	dɛtɪd
siomedig	ʃɔmeːdɪɡ
nhewi	n̥ɛu̯i
gwybod	ɡʊbɔ
cyfiawnhad	kəvjau̯nhaːd
ffrainc	frai̯ŋk
gathod	ɡaθɔd
tawa	tau̯a
pedoli	pɛdɔli
teisennau	tei̯sɛnɛ
tawel	tau̯ɛl
cyhydnos yr hydref	kəhədnɔsərhədrɛv
anwybyddu	anwɪbəði
helbulus	hɛlbɪlɪs
roeddwn	rɔi̯ðɛn
didranc	dɪdraŋk
chael	χaːl
phyliau	fəljai̯
cymhlethdodau	kəmhlɛθdɔdɛ
faint o'r gloch	vai̯ntoːrɡloːχ
awydd	au̯ɪð
em	ɛm
neidio	nei̯djɔ
anghyflogaeth	aŋhəvlɔɡai̯θ
cenhinen bedr	kɛnhiːnɛmbɛdr
talom	taːlɔm
gylfinau	ɡəlvɪnɛ
nos iau	nɔsjai̯
petryalau	pɛtriaːlɛ
dorra	dɔra
neges	neːɡɛs
trawstrefa	trau̯sdreːva
chaf	χaːv
lifftiau	lɪfdjɛ
cythreuliaid	kəθrei̯ljai̯d
hawl	hau̯l
brochion	brɔχjɔn
albwm	albʊm
colur	koːlɪr
caws	kau̯s
diwethaf	dwɛθa
campwr	kampʊr
trydanwyr	trədanwɪr
peiriannau llungopïo	pei̯rjanɛɬiːŋɡɔpiːɔ
got law	ɡɔtlau̯
brig y nos	briːɡənoːs
pasiaf	pasjav
teipiadur	tei̯padɪr
be'	beː
traethawd	trei̯θau̯d
esgaladur	ɛsɡalaːdɪr
peren	peːrɛn
banana	banaːna
goleuadau	ɡɔlei̯aːdai̯
ffwng	fʊŋ
rhaidd	r̥ai̯ð
marchgacwn	marχɡakʊn
gymedrolwr	ɡəmɛdrɔlʊr
corwg	koːrʊɡ
crwth	kruːθ
achydd	aːχɪð
ymladdwr	əmlaːðʊr
hogen	hɔɡɛn
homan	hɔman
frain	vrai̯n
rhafnwydd	r̥avnwɪð
peiriannau llungopïo	pei̯rjanai̯ɬɪŋɔpiːɔ
cacynen feirch	kakənɛnvei̯rχ
streic	sdrei̯k
gornest	ɡɔrnɛsd
genidol	ɡɛnɪdɔl
ysgubor	əsɡiːbɔr
angladdau	aŋlaðɛ
gwenllian	ɡwɛnɬiːan
credit	kreːdɪt
cach	kaːχ
'i	i̯
curo	kɪrɔ
anghytuno	aŋətɪnɔ
brawiau	brau̯jɛ
bresych	brɛsɪχ
allfudo	aɬviːdɔ
ffensiau	fɛnʃɛ
mhencampwriaeth	m̥ɛŋkampʊrjɛθ
sgwrs	sɡʊrs
dyddiadau	dəðjadɛ
seddi	seːði
ymrafael	əmraːvɛl
atseiniau	atsei̯njɛ
cwpan	kʊpan
argrafiadau	arɡrafjadɛ
cwrs	kʊrs
mynachlogydd	mənaχloːɡɪð
ffonioch	fɔnjɔχ
garai	ɡaːrai̯
dad	daːd
lân	laːn
tales	taːlɛs
rhod	r̥oːd
dychmygu	dəχməɡi
chyrraedd	χərað
wybodaeth	wəbɔdai̯θ
delysg	dɛlɪsɡ
rheolaidd	r̥ɛɔlɛð
cwta	kʊta
hagor	haːɡɔr
cwpanaid	kʊpaːnai̯d
siôn corn	ʃoːŋkɔrn
taran	taran
abadau	abadai̯
ryddhau	rəðhai̯
hygyrch	həɡɪrχ
ddolur	ðɔlɪr
berllan	bɛrɬan
gŵr	ɡuːr
ewro	ɛu̯rɔ
fechan	veːχan
printio	prɪntjɔ
olif	ɔlɪv
uwd	ɪu̯d
gellyg	ɡɛɬɪɡ
berw	bɛru
ffrengig	frɛŋɪɡ
deil	dei̯l
afal cariad	avalkarjad
pump ar hugain	pɪmparhɪɡɛn
wysg	ʊi̯sɡ
ngherddoriaeth	ŋ̊ɛrðɔrjai̯θ
debyg	deːbɪɡ
stopi	sdɔpi
bryngaer	brɪŋɡai̯r
chwe	ʍeː
chweugain	χwei̯ɡai̯n
nhŷ	n̥iː
daliadau	daljaːdai̯
dewr	dɛu̯r
ganai	ɡanai̯
ngeiriadurwyr	ŋei̯rjadɪrwɪr
carthen	karθɛn
bwyty	bʊi̯ti
lasgoch	lasɡɔχ
pedrsill	pɛdrsɪɬ
aderyn	deːrɪn
cyfundrefnol	kəvɪndrɛvnɔl
dydd sadwrn	dɪðsadʊrn
llwythau	ɬʊi̯θai̯
achlod	aχlɔd
croesffordd	krɔi̯sfɔrð
mislifol	mɪsliːvɔl
afu	aːvi
llong noa	ɬɔŋnoːa
bynnag	bənaɡ
boneddigesau	bɔnɛðɪɡɛsai̯
fwlfa	vʊlva
gynnar	ɡənar
ulai	iːlai̯
llysenw	ɬiːseːnu
nhalcen	n̥alkɛn
gwalch marth	ɡwalχmarθ
gaint	ɡai̯nt
lleianaidd	ɬei̯aːnɛð
gwregys	ɡwreːɡɪs
chalan	χalan
chdi	χdiː
arolygol	arɔləɡɔl
byddaru	bəðaːri
bysgota	bəsɡɔta
nigon	niːɡɔn
thelyn	θeːlɪn
arllwysaf	arɬʊi̯sa
ches	χeːs
hawlio	hau̯ljɔ
llnau	ɬnai̯
mewnrwyd	mɛu̯nrʊi̯d
söolegwr	soːɔleːɡʊr
syfl	sɪvl
twng	tʊŋ
cwbl	kʊbʊl
sefyllfaoedd	sɛvəɬvaːɔi̯ð
cyfun	kəvɪn
argraffydd	arɡrafɪð
bwch	buːχ
union	ɪnjɔn
adfyd	advɪd
teiars	tei̯ars
lwy	lʊi̯
gaffi	ɡafi
triongl	triːɔŋl
taranu	tarani
cymharu	kəmhaːri
sumbol	sɪmbɔl
llawer	ɬau̯ɛr
thaith	θai̯θ
nglân	ŋlaːn
traidd	trai̯ð
utgyrn	ɪtɡɪrn
gythraul	ɡəθrɛl
llafariaid	ɬavarjɛd
nghad	ŋ̊aːd
hunanynysu	hiːnanənəsi
muchudd	miːχɪð
arddelw	arðɛl
cwestiynau	kwɛsdjuːnɛ
cystadlaethau	kəsdadlei̯θai̯
sunthesis	sɪnθɛsɪs
talent	talɛnt
fur	viːr
ffonian	foːnjan
taradr	taradr
deugeiniau	dei̯ɡei̯njai̯
camsefyll	kamsɛvɪɬ
pedolwr	pɛdɔlʊr
chusanu	χɪsaːni
mela	meːla
dos	doːs
eiddgarwch	ei̯ðɡaːrʊχ
helpu	hɛlpi
ffraeo	friːɔ
crog	kroːɡ
sbageti	sbaɡɛti
cristnogol	krɪsdnɔɡɔl
acha	aχa
chaws	χau̯s
teli	teːli
phaned	fanɛd
nghaled	ŋ̊aːlɛd
thalent	θalɛnt
gwladfa	ɡwladva
gwyliedydd	ɡʊi̯ljeːdɪð
deildy	dei̯ldi
gwlana	ɡwlana
bachan	baːχan
ddelo	ðɛlɔ
talai	talai̯
sglodyn	sɡlɔdɪn
achubiaeth	aχɪbjɛθ
gruga	ɡrɪɡa
elont	eːlɔnt
ymdrafferthu	əmdrafɛrθi
trengholiadau	trɛŋhɔljadɛ
cari	kari
allo	aɬɔ
annog	anɔɡ
rhith	r̥iːθ
medren	mɛdrɛn
neuaddau	nei̯aðɛ
ymwelwr	əmwɛlʊr
lleidr	ɬei̯dɪr
bortiwgal	bɔrtjʊɡal
amryw	amrɪu̯
brwydro	brʊi̯drɔ
archebu	arχɛbi
theisen	θiːʃɛn
disgwyl	dɪʃɡʊi̯l
anrhydeddu	anrədɛði
desen	dɛsɛn
euthum	ei̯θɪm
chansen	χansɛn
rheoliadur	r̥ɛɔljaːdɪr
gwybodaeth	ɡwəbɔdai̯θ
genedigaeth	ɡɛnɛdɪɡɛθ
thro	θroː
gwall	ɡwaːɬ
technoleg gwybodaeth	tɛχnoːlɛɡɡwəboːdai̯θ
gwybodaeth	ɡwɪbɔdai̯θ
halen	haːlɛn
ydau	ədai̯
rhy	r̥iː
cwd	kuːd
dalit	daːlɪt
buddugoliaeth	bɪðɪɡɔljɛθ
sgriau	sɡriːɛ
nglas	ŋlaːs
gwsberis	ɡʊsbɛrɪs
llungopïwr	ɬɪŋɡɔpiːʊr
caem	kai̯m
oleuadau	ɔlei̯adɛ
gylfinau	ɡəlvɪnai̯
halen	halɛn
croglen	krɔɡlɛn
trefi	treːvi
wociau	wɔkjai̯
ciwdod	kɪu̯dɔd
dydd gwener	diːðɡweːnɛr
êl	eːl
chymru	χəmri
meddw	meːðu
nglanach	ŋlaːnaχ
traed	traːd
helyntion	hɛləntjɔn
diogel	djoːɡɛl
ngwybod	ŋʊi̯bɔd
lyfr	lɪvr
ofnadwy	ɔvnadu
ngoleuadau	ŋɔljadɛ
ficer	vɪkɛr
cymraes	kəmrai̯s
hyd	hiːd
saith	sai̯θ
hofran	hɔvran
geiriog	ɡei̯rjɔɡ
hafodau	havɔdai̯
awgrymog	au̯ɡrəmɔɡ
una	iːna
garent	ɡaːrɛnt
coed afalau	kɔi̯davalɛ
ifanc	ɪvaŋk
pedolau	pɛdɔlai̯
araf	aːrav
penfras	pɛnvras
protestaniaeth	prɔtɛsdanjɛθ
blwyddyn golau	blʊi̯ðɪnɡoːlɛ
cansai	kansɛ
ysgafnhau	əsɡavnhai̯
gwddf	ɡuːðu
taran	taːran
ngwinoedd	ŋwɪnɔi̯ð
plygiau	pləɡjai̯
eangderau	ɛaŋdeːrai̯
pengwiniaid	pɛŋɡwɪnjai̯d
aton	atɔn
gwalch y pysgod	ɡwalχəpəsɡɔd
cymro	kəmrɔ
iddynt	iːðɪnt
peli troed	peːlitrɔi̯d
cyhydnos y gwanwyn	kəhədnɔsəɡwanwɪn
dales	daːlɛs
paentiau	pei̯ntjɛ
coch	koːχ
chared	χarɛd
llysiau	ɬəsjɛ
marw	maru
cafas	kaːvas
cwmpawd	kʊmpau̯d
unid	ɪnɪd
rhedeg	r̥eːdɛɡ
llwrw	ɬʊru
cystadleuaeth	kəsdadlei̯ai̯θ
yn gymwys	əŋɡəmʊi̯s
unem	ɪnɛm
canai	kaːnai̯
rheolau	r̥ɛoːlɛ
unedau	ɪneːdai̯
eirinen	ei̯rɪnɛn
mehefin	mɛhɛvɪn
adeiladwaith	adei̯ladwɛθ
cesail	kɛsai̯l
laith	lai̯θ
hyn	hɪn
creder	krɛdɛr
rhyngrwyd	r̥əŋrʊi̯d
yfed	iːvɛd
cadair	kadai̯r
cristnogol	krɪsdnoːɡɔl
hechryd	hɛχrɪd
chanu	χani
eangfrydig	ɛaŋvrədɪɡ
agoraf	aɡoːrav
ânt	aːnt
ar dân	ardaːn
y tu ôl i	tioːli
wŷdd	wiːð
cerir	keːrɪr
dorrent	dɔrɛnt
ddau	ðai̯
cerdd	kɛrð
chest	χɛst
mag	maɡ
teli	tɛli
basio	baʃɔ
heulsaf	hei̯lsav
ceri	kɛri
anifail	aniːvai̯l
arholiadau	arhɔljaːdai̯
amod	amɔd
dro	droː
hinon	hɪnɔn
buddugwr	bɪðiːɡʊr
atgoffa	atɡɔfa
hafodau	havoːdai̯
nghyfarfod	ŋ̊əvarvɔd
adferiadwyr	advɛrjadəðwɪr
cwpla	kʊpla
diddordeb	dɪðɔrdɛb
ngolau	ŋɔlɛ
chachi	χaχi
cyfansymiau	kəvansəmjai̯
nwylo	nʊi̯lɔ
fa's	vaːs
ffôi	foːi̯
dde	ðeː
ymrysonydd	əmrəsɔnɪð
ngwledydd	ŋwleːdɪð
traeth	trai̯θ
nod	noːd
nghythraul	ŋ̊əθrai̯l
got	ɡɔt
ŷd	iːd
geiriau	ɡei̯rjɛ
clodfori	klɔdvoːri
aradr	aːradr
cyhydnos	kəhədnɔs
nghnau	ŋ̊nai̯
ngeni	ŋɛni
titr	tɪtr
ffenestri	fɛnɛsdri
twrf	tʊrv
diamod	diːaːmɔd
chythraul	χəθrɛl
sachell	saχɛɬ
cyfnodolion	kəvnɔdɔljɔn
deuddegfed	dɪðɛɡvɛd
brain	brai̯n
ddwywaith	ðʊi̯wai̯θ
fara	vara
tyn	tɪn
rheiddio	r̥eiðjɔ
cristnogaeth	krɪsdnoːɡɛθ
nadolig	nadɔlɪɡ
unai	iːnai̯
cotiau	kɔtjɛ
seibiau	sei̯bjai̯
sìl	sɪl
anobeithiau	anɔbei̯θjai̯
aller	aɬɛr
wybod	wɪbɔd
glybiau	ɡləbjai̯
ieithoedd	jei̯θɔi̯ð
ber	bɛr
cyfatebiaethau	kəvatɛbjei̯θai̯
habatiroedd	habatɪrɔi̯ð
bywiog	bɪu̯jɔɡ
caner	kanɛr
bôm	boːm
poster	pɔsdɛr
taro	taːrɔ
caer gwydion	kai̯rɡwɪdjɔn
pinc	pɪŋk
lladin	ɬaːdɪn
llungopïau	ɬɪŋɡɔpiːɛ
cynnes	kənɛs
loncian	lɔŋkjan
gwerddonau	ɡwɛrðoːnai̯
amgyffred	amɡəfrɛd
ymdrech	əmdrɛχ
ddere	ðeːrɛ
canmoliaethau	kanmɔljei̯θai̯
clyfar	kləvar
siôn	ʃoːn
fflyd	fliːd
golau	ɡɔlai̯
berfau annherfynol	bɛrvɛanhɛrvənɔl
enillydd	ɛnɪɬɪð
cynt	kɪnt
ieithadur	jeiθaːdɪr
amlach	amlaχ
haddo	haːðɔ
lloegr	ɬɔi̯ɡr
gadd	ɡaːð
brasterog	brasdeːrɔɡ
pwyllgor	pʊi̯ɬɡɔr
hwyaid	hʊi̯ɛd
melin	meːlɪn
estrys	ɛsdrɪs
teisennau	tei̯ʃɛnai̯
chelyn	χɛlɪn
dost	dɔst
casnewydd	kasnɛu̯ɪð
adeiladwr	adei̯ladʊr
celai	kɛlai̯
safon	saːvɔn
sir	siːr
fordydd	vɔrdɪð
cartref	kartrɛ
adwaenir	adwei̯nɪr
pleidleisio	plei̯dlei̯ʃɔ
isel	ɪsɛl
pioden	pjɔdɛn
droed	drɔi̯d
carai	kaːrai̯
pry'r gannwyll	priːrɡanʊi̯ɬ
enillion	ɛnɪɬjɔn
lysiau	ləʃai̯
peiriannol	pei̯rjanɔl
cystal	kɪsdal
mhei	m̥ei
cydseiniol	kiːdsei̯jɔl
siwan	ʃuːan
cymedrol	kəmɛdrɔl
gwasanaeth	ɡwasaːnɛθ
wybodaeth	wɪboːdai̯θ
gwared	ɡwaːrɛd
llawfeddyg	ɬau̯veːðɪɡ
gweinyddiaethau	ɡwei̯nəðjei̯θɛ
farnau	varnɛ
chalan	χaːlan
odl	ɔdl
pumed	pɪmɛd
echdoe	ɛχðɔ
tydy	tədi
rhosyn	r̥ɔsɪn
pedwar ar bymtheg	pɛdwararbəmθɛɡ
trafferth	trafɛrθ
gwraidd	ɡwrai̯ð
diweithdra	dɪwei̯θdra
teimlad	tei̯mlad
aeth	aːθ
sodlau uchel	sɔdlɛiːχɛl
cosbau	kɔsbai̯
adleisiau	adlei̯ʃɛ
cewch	kɛu̯χ
achubol	aχiːbɔl
cen y coed	kɛnəkoːd
albanau	albaːnai̯
perthynas	pɛrθənas
galw	ɡaːlu
wyt	iːt
plethdorch	plɛθdɔrχ
gwymona	ɡʊi̯mɔna
jacs	dʒaks
dug	diːɡ
sylw	səlu
goed	ɡoːd
portiwgal	pɔrtɪu̯ɡal
tei	tei̯
pafán	pavan
bysellfwrdd	bəsɛɬvʊrð
llansamlet	ɬansamlɛt
nghymru	ŋ̊əmri
gaeafgysgu	ɡei̯avɡəsɡi
cymwys	kəmʊi̯s
hel	hɛl
caniau	kanjai̯
llythrennau	ɬəθrɛnɛ
ngeiriadurwr	ŋei̯rjadɪrʊr
lysenw	lɪseːnu
argraffiadaeth	arɡrafjadai̯θ
naet	nai̯t
ryfelwyr	rəvɛlwɪr
safon	savɔn
phethau	fɛθai̯
aelod cynulliad	ei̯lɔdkənɪɬjad
bwyd	bʊi̯d
credi	krɛdi
ydy	ədi
snwcer	snʊkɛr
adarydd	adarɪð
bleidleisio	blei̯dlei̯ʃɔ
saethyddiaeth	sei̯θəðjɛθ
tegan	tɛɡan
henghraifft	hɛŋ̊rɛfd
hachos	haχɔs
glywed	ɡlɪu̯ɛd
paned	panɛd
dyfrdwy	dəvrdʊi̯
arholiadau	arhɔljadai̯
cyfryngiadau	kəvrəŋjadai̯
adenedigaethau	adɛnɛdɪɡei̯θɛ
berthynas	bɛrθənas
gwregys	ɡwrɛɡɪs
datrys	datrɪs
nhalent	n̥aːlɛnt
amser	amsɛr
yn hyn o beth	ənhɪnɔbeːθ
milddail	milðai̯l
llith	ɬiːθ
nhâl	n̥aːl
barn	barn
brenin	breːnɪn
gwasanaeth	ɡwasaːnai̯θ
creisionen ŷd	krei̯sjɔnɛniːd
debyg	dɛbɪɡ
gwaywffon	ɡwei̯wfɔn
gylfin	ɡəlvɪn
tanau gwyllt	taːnai̯ɡwɪɬd
dolffin	dɔlfɪn
gwrthwynebydd	ɡʊrθwɪnɛbɪð
cyfatebiaeth	kəvatɛbjai̯θ
chad	χaːd
ddaear	ðei̯ar
diwrnod	dɪu̯rnɔd
arddaf	arðav
throednoeth	θrɔi̯dnɔi̯θ
leician	lɪkan
wely	weːli
enw	eːnu
tawn	tau̯n
'n	n
adfydau	advədɛ
unais	iːnai̯s
genweiriau	ɡɛnwei̯rjai̯
mhencampwriaeth	m̥ɛŋkampʊrjai̯θ
merlotwr	mɛrlɔtʊr
doniol	dɔnjɔl
tradwy	traːdʊi̯
mara	mara
rhedyn	r̥ɛdɪn
milwr	mɪlʊr
gwerinwr	ɡwɛriːnʊr
negeseua	nɛɡɛsei̯a
poeth	pɔi̯θ
gwyddel	ɡʊi̯ðɛl
addawa	aðau̯a
ffrwgwd	fruːɡʊd
ofer	ɔvɛr
dull	dɪɬ
gwddf	ɡʊðu
amlen	amlɛn
trenau	treːnɛ
dydd sadwrn	dɪðsaːdʊrn
phengwin	fɛŋɡwɪn
byddaru	bəðari
wythnos	ʊi̯θnɔs
adara	adara
nghaeredin	ŋ̊ai̯reːdɪn
mochyn	moːχɪn
gwennol	ɡwɛnɔl
gweriniaethau	ɡwɛrɪnjei̯θai̯
lwc	lʊk
heol	hɛu̯l
sesiynau	sɛʃənɛ
cyfrannog	kəvranɔɡ
puramid	pɪramɪd
cysgaf	kəsɡav
mellt	mɛɬd
habades	habadɛs
gynnwrf	ɡənʊrv
biti	bɪti
croesair	krɔi̯sai̯r
adfywio	advɪu̯jɔ
cares	karɛs
cafiar	kavjar
bildar	bɪldar
trwchus	truːχɪs
gwall	ɡwaɬ
rhwystr	r̥ʊi̯sdr
cennin sifi	kɛnhɪnɛnsiːvi
peniad	pɛnjad
ehedydd	ɛhɛdɪð
post	pɔsd
arfedd	arvɛð
cyflogwr	kəvlɔɡʊr
ngwybodaeth	ŋʊi̯boːdɛθ
hwythfed	hʊi̯θvɛd
gwrthiselydd	ɡʊrθɪsɛlɪð
fasen	sɛn
adwen	adwɛn
faneg	vanɛɡ
arolygydd	arɔləɡɪð
pasio	pasjɔ
anogaf	anoːɡa
torlan	tɔrlan
gweinyddion	ɡwei̯nəðjɔn
cacen	kakɛn
sebon	seːbɔn
llyfr	ɬəvɪr
adareg	adarɛɡ
cyẅres	kəuːrɛs
ymesyd	əmɛsɪd
cildwrn	kɪldʊrn
rheg	r̥eːɡ
nhelyn	n̥ɛlɪn
ebol	ɛbɔl
tyllau yn y wal	təɬɛənəwal
dyddio	dəðjɔ
diolchgarwch	diɔlχɡarʊχ
dydd gwener	dɪɡweːnɛr
ngair	ŋai̯r
caniatáu	kanjatai̯
coronafeirysau	kɔrɔnavei̯rəsɛ
charai	χarɛ
blwyddyn	blʊi̯ðɪn
academydd	akadɛmɪð
nofio	nɔvjɔ
chas	χaːs
lysiau	ləʃɛ
gynnar	ɡɪnar
bwa'r gwynt	buːarɡwɪnt
talais	taːlɛs
trawsenw	trau̯seːnu
adfeiliedig	advei̯ljɛdɪɡ
derbynfa	dɛrbənva
lleoli	ɬɛoːli
helbul	hɛlbɪl
trwydded	trʊi̯ðɛd
thali	θaːli
bryniau	brənjai̯
roedd	roːð
perseiniol	pɛrsei̯njɔl
epidemigau	ɛpɪdɛmɪɡɛ
rhwyfo	r̥ʊi̯vɔ
salm	salm
hir	hiːr
nghydbreswylwyr	ŋ̊iːdbrɛsʊi̯lwɪr
anifail	anɪvai̯l
dydy	dədi
phobloedd	fɔblɔi̯ð
eira	ei̯ra
agorai	aɡɔrai̯
tywydd	təu̯ɪð
phortiwgal	fɔrtɪu̯ɡal
llysenw	ɬɪsɛnu
migwrn	mɪɡʊrn
ato	atɔ
gweddol	ɡwɛðɔl
melyster	mɛləsdɛr
belffast	bɛlfasd
derbyniad	dɛrbənjad
cyẅres	kəʊrɛs
soddi	soːði
tonau	tɔnɛ
mari	mari
cyfrifon	kəvriːvɔn
tyrrau	tərai̯
ffensio	fɛnʃɔ
llwyth	ɬʊi̯θ
söolegydd	soːɔleːɡɪð
nage ddim	naɡɛðɪm
tali	taːli
gwddf	ɡʊðʊv
habadesau	habadɛsai̯
garu	ɡari
iselydd	ɪsɛlɪð
car	kar
cymhlethdod	kəmhlɛθdɔd
gwaed	ɡwaːd
ffonion	fɔnjɔn
helynt	heːlɪnt
prifiau	prɪvjai̯
gwystl	ɡwɪsdl
cynaeafu	kənei̯avi
dyfynnod	dəvənɔd
gwelet	ɡwɛlɛt
cynnar	kənar
enfys	ɛnvɪs
chwarren	ʍarɛn
awst	au̯sd
drama	draːma
gemau	ɡɛmai̯
redeg	reːdɛɡ
iechyd	jɛχɪd
roedden	rɔi̯ðɛn
rhagddodiad	r̥aɡðɔdjad
adroddaf	adrɔða
chneuen gyll	χnei̯ɛnɡɪɬ
blodau	blɔdɛ
boddi	boːði
fawn	vau̯n
chares	χaːrɛs
gwreiddio	ɡrɛi̯ðjɔ
gwahodd	ɡwahoːð
dduw	ðɪu̯
cydweithrediad	kiːdwei̯θrɛdjad
picau bach	pɪkɛbaːχ
ehanged	ɛhaŋɛd
nheyrnaddoliant	n̥ei̯rnaðɔljant
charai	χaːrɛ
choed	χoːd
dadwreiddio	dadrɛi̯ðjɔ
gachai	ɡaːχɛ
ffeindiaf	fei̯ndjav
arolygiaeth	arɔləɡjɛθ
rith	riːθ
rywle	rʊlɛ
band	band
anableddau	anableːðai̯
caleted	kalɛtɛd
dolis	dɔliz
arswyd	arsʊi̯d
doedden	dɔi̯ðɛn
canwr	kanʊr
ngwddf	ŋʊðuv
gythreuliaid	ɡəθrei̯ljai̯d
parcio	parkɔ
astrus	asdrɪs
cerwyn	kɛrui̯n
bwyta	bɪta
bordydd	bɔrdɪð
tonau	toːnai̯
glased	ɡlasɛd
disgyn	dɪsɡɪn
glin	ɡliːn
twlu	tʊli
ngweithiwr	ŋwiːθʊr
adferiedydd	advɛrjeːdɪð
gwledydd	ɡwleːdɪð
goleuad	ɡɔlei̯ad
afalau	avalai̯
lleianaeth	ɬei̯anai̯θ
gwenith	ɡweːnɪθ
gwely	ɡwɛli
olaf	ɔlav
pŵer	puːɛr
allforiadwy	aɬvɔrjaːdʊi̯
cano	kaːnɔ
anfantais	anvantai̯s
crynhoad	krənhɔad
lased	lasɛd
rybela	rəbeːla
beirniadaeth	bei̯rnjaːdai̯θ
colli	kɔɬi
adflas	advlas
wybod	ʊi̯bɔd
dalent	dalɛnt
undebau	ɪndɛbɛ
sero	zɛrɔ
galenigion	ɡalɛnɪɡjɔn
dallt	daɬt
cyfarwydd	kəvarʊi̯ð
dydd gwener	dɪðɡweːnɛr
archangel	arχaŋɛl
collen	kɔɬɛn
sioeau	ʃɔi̯ai̯
braint	brai̯nt
aer	aːr
chyfforddus	χəfɔrðɪs
abadaeth	abaːdɛθ
brython	brəθɔn
abl	aːbal
tylluan	təɬian
cilwg	kɪlʊɡ
ystradwel	əsdradwɛl
telyn	teːlɪn
poenen	pɔi̯nɛn
mhibgorn	m̥ɪbɡɔrn
angylesau	aŋəlɛsɛ
rhaid	r̥ai̯d
allanfa	aɬanva
cân	kaːn
olewydden	ɔlɛu̯əðɛn
peiriant llungopïo	pei̯rjantɬɪŋɔpiːɔ
anawsterau	anau̯sdɛrɛ
gymaint	ɡɪmɛnt
sgarff	sɡarf
amrywio	amrɪu̯jɔ
adaregol	adarɛɡɔl
canolig	kanɔlɪɡ
fwg	vuːɡ
cheffyl	χɛfɪl
gŵyr	ɡʊi̯r
ble	bleː
digwydd	dɪɡwɪð
celen	keːlɛn
plyg	pliːɡ
tymor	təmɔr
mefusa	mɛvɪsa
fynydd	vənɪð
gwragedd	ɡraɡɛð
ddeuddegfed	ðei̯ðɛɡvɛd
wanwyn	wanwɪn
caerwysg	kai̯rwɪsɡ
sêr	seːr
allen	aɬɛn
ambiti	ambɪti
cut	kɪt
thrwyn	θrʊi̯n
dileu	dɪlei̯
moresg	mɔrɛsɡ
selerau	sɛlɛrɛ
trin	triːn
cochlas	kɔχlas
ieirll	jei̯rɬ
raser	rasɛr
gallai	ɡaɬai̯
terfysglyd	tɛrvəsɡlɪd
recriwtiaid	rɛkrɪu̯tjai̯d
cynnen	kənɛn
côt	koːt
rhad	r̥aːd
ngweld	ŋwɛld
sicr	sɪkɪr
cannwyll	kanʊi̯ɬ
trefgordd	trɛvɡɔrð
gorffennol	ɡɔrfɛnɔl
arth fawr	arθvau̯r
gwag	ɡwaːɡ
gemau	ɡɛmɛ
dwys	dʊi̯s
plaid	plai̯d
mur	miːr
mynydda	mənəða
terfysgwyr	tɛrvəsɡwɪr
dyrchaif	dərχai̯v
clod	kloːd
os gwelwch yn dda	ɔsɡwɛlʊχənðaː
brawychiaeth	brau̯əχjai̯θ
chwningen	χʊnɪŋɛn
aradr	aːrad
ysglodyn	əsɡlɔdɪn
gafas	ɡaːvas
cymhlethdodau	kəmlɛθdɔdɛ
dymuno	dəmɪnɔ
teitlau	tei̯tlɛ
adwaenem	adwei̯nɛm
baths	baθs
anffodus	anfoːdɪs
tair	tai̯r
mhrif	m̥riːv
rheoliaduron	r̥ɛɔljadɪrɔn
doeddet	dɔi̯ðɛt
nhre	n̥reː
toesaidd	tɔi̯sɛð
mwlgaria	mʊlɡarja
briw	brɪu̯
cyngyd	kəŋɡɪd
ngoleuadau	ŋɔlei̯aːdai̯
pryf copyn	priːkɔpɪn
rhodio	r̥ɔdjɔ
cymraesau	kəmrei̯sɛ
carent	kaːrɛnt
heddferch	hɛðvɛrχ
gwreiddiadur	ɡwrɛi̯ðjaːdɪr
sawdl	sau̯dʊl
brig	briːɡ
alban hefin	albanheːvɪn
torheulo	tɔrhei̯lɔ
llwchwr	ɬuːχʊr
gylfinir	ɡəlviːnɪr
metelegol	mɛtɛlɛɡɔl
iddewon	ɪðɛu̯ɔn
ceisio	kei̯ʃɔ
stemars	sdeːmarz
rho	r̥oː
surdoes	sɪrdɔi̯s
cyfrif	kəvri
plwyf	plʊi̯v
trigeiniau	trɪɡei̯njɛ
fory	voːri
llunio	ɬɪnjɔ
fleiddiaid	vlei̯ðjai̯d
crwban	kruːban
heddiw	hɛðɪu̯
gwayw	ɡwei̯u
symiau	səmjɛ
planhigion	planhɪɡjɔn
phethau	feːθɛ
teifl	tei̯vl
weddi	wɛði
lleidr	ɬei̯dr
taliadau	taljaːdai̯
aden	aːdɛn
cloit	klɔi̯t
lleinw	ɬei̯nu
tarianau	tarjaːnai̯
ysgub	əsɡɪb
dyfarnwyr	dəvarnwɪr
ngwahanol	ŋwahanɔl
llyfrau	ɬɪvrɛ
aran	aran
credent	krɛdɛnt
smwddio	smʊðjɔ
pedair	peːdai̯r
edwyn	ɛdwɪn
warysau	warəsai̯
ciciau	kikjai̯
cerddoriaeth	kɛrðɔrjai̯θ
crwyn	krʊi̯n
os gweli di'n dda	ɔsɡwɛlidiːnðaː
rhenti	r̥ɛnti
theigr	θei̯ɡr
teisennau	tei̯sɛnai̯
ngelyn	ŋɛlɪn
gofod	ɡoːvɔd
ro	roː
isel	ɪʃɛl
agos	aɡɔs
heibio	hiːbɔ
newynau	nɛu̯ənai̯
côd	koːd
daw	dau̯
beichiog	bei̯χjɔɡ
utganaf	ɪtɡaːnav
popeth	pɔpɛθ
lonciwr	lɔŋkjʊr
arwydd	aːrʊi̯ð
arweiniad	arwei̯njad
rw	rʊ
cwerylau	kwɛrəla
talit	talɪt
garant	ɡaːrant
habadaeth	habaːdai̯θ
cernyw	kɛrnɪu̯
baidd	bai̯ð
iorwg	jɔrʊɡ
abadaethau	abadei̯θɛ
thre	θreː
ar gyfer	arɡəvɛr
acen ddisgynedig	akɛnðɪsɡəneːdɪɡ
arian parod	arjamparɔd
trefedigaethau	trɛvɛdɪɡei̯θɛ
talon	taːlɔn
pheidio	fiːdɔ
adflasau	advlasɛ
garw	ɡaːru
cyd	kiːd
gwerthiant	ɡwɛrθjant
canyddion	kanəðjɔn
mynyddig	mənəðɪɡ
losin	loːʃɪn
peiriannau arian	pei̯rjanai̯arjan
diwyr	diʊi̯r
abwyd	abʊi̯d
llawr	ɬau̯r
amgueddfa	amɡiɛðva
synnwyr	sənʊi̯r
pryf genwair	priːvɡɛnwai̯r
rhywun	rɪu̯ɪn
cyflafareddu	kəvlavarɛði
twymyn	tʊi̯mɪn
thrwyddedau	θrʊi̯ðɛdɛ
dyfarniadau	dəvarnjadɛ
glaswellt	ɡlaswɛɬd
dydd mercher	diːðmɛrχɛr
pellter	pɛɬdɛr
carent	karɛnt
gelai	ɡeːlai̯
mhasta	m̥asda
cyfiawn	kəvjau̯n
ryseitiau	rəsei̯tjɛ
gwaed	ɡwai̯d
nhadau	n̥adɛ
galler	ɡaɬɛr
rils	riːlz
gwadd	ɡwaːð
bencampwyr	bɛŋkampwɪr
penfelen	penveːlɛn
wddwg	uːðuɡ
angel	aŋal
ychwanegu	əχwanɛɡi
hwyr	hʊi̯r
terfyn	tɛrvɪn
cynghrair	kəŋrɛr
lan	lan
sashimi	saʃiːmi
caeth	kaːθ
dysglaid	dɪsɡlɛd
llawysgrif	ɬau̯əsɡrɪv
economeg	ɛkɔnɔmɛɡ
clefyd y sul	klɛvɪdəsiːl
magnelwr	maɡnɛlʊr
castanwydd	kasdanʊi̯ð
chwythu	hwəθi
nos sadwrn	nɔsaːdʊrn
goginio	ɡɔɡɪnjɔ
pedrongl	pɛdrɔŋl
bwrw hen wragedd â ffyn	bʊruheːnwraɡɛðafɪn
nglaned	ŋlanɛd
chwarae	ʍaːrɛ
meddai	mɛðɛ
seiclwr	sei̯klʊr
dudalen	dɪdalɛn
arolygiadau	arɔləɡjadɛ
troedfedd	trɔi̯dvɛð
heibio	hei̯bjɔ
chu	χiː
carfilod bach	karviːlɔdbaːχ
ansawdd	ansau̯ð
corwg	kɔrʊɡ
eiliadau	ei̯ljaːdai̯
epidemigau	ɛpɪdɛmiːɡɛ
eryri	ɛrəri
si	siː
rhanddeiliaid	r̥anðei̯ljɛd
cantores	kantɔrɛs
wiciadur	wɪkjaːdɪr
gwydraid	ɡwədrai̯d
ŵr	uːr
chana	χaːna
seintiau	sei̯ntjɛ
wyt ti'n iawn	ʊi̯ttiːnjau̯n
ocsiynau	ɔkʃənai̯
crychach	krəχaχ
bas	baːs
rhi	r̥iː
gweddwon	ɡwɛðwɔn
dihuno	diːnɔ
hesg	hɛsɡ
chwŷl	χwiːl
sianis	ʃaːniz
hardaloedd	hardaːlɔð
düwch	diːʊχ
pedwar ar hugain	pɛdwararhɪɡɛn
achwyniad	aχʊi̯njad
nhudalen	n̥ɪdalɛn
ngwybodaeth	ŋwɪbɔdai̯θ
mari	maːri
hanfon	hanvɔn
biolegol	bjɔleːɡɔl
hoffi	hɔfi
chafas	χavas
eglwys	ɛɡlʊi̯s
wedyn	wɛdɪn
ynglŷn	əŋliːn
brysur	brəsɪr
ngheir	ŋ̊ei̯r
llungopi	ɬiːŋɡɔpi
carw	karu
sawsiau	sau̯sjai̯
ffyrc	fɪrk
nghnwd	ŋ̊nuːd
dolïau	dɔliɛ
chydbreswylwyr	χiːdbrɛsʊi̯lwɪr
arall	araɬ
gornestau	ɡɔrnɛsdai̯
gwaedu	ɡwiːdi
animeiddiadau	anɪmei̯ðjjadɛ
wyau	wiːɛ
mhortiwgal	m̥ɔrtɪu̯ɡal
ffordd	fɔrð
habadaethau	habadei̯θai̯
losinen	lɔʃɪnɛn
argraffiadwyr	arɡrafjadwɪr
bib	biːb
aseswr	asɛsʊr
nal	nal
dydd llun	dɪðɬiːn
gwrendy	ɡwrɛndi
nghanu	ŋ̊aːni
ledled	lɛdlɛd
wladfa	wladva
chwch	χʊχ
bathdy	baθdi
cadd	kaːð
pridd	priːð
adargraffiadau	adarɡrafjadai̯
dwyn	dʊi̯n
trwbl	truːbʊl
ngoleuadau	ŋɔlei̯adai̯
dyrys	dərɪs
bachan	baχan
ddelo	ðeːlɔ
aelod seneddol	ei̯lɔdsɛnɛðɔl
ehangu	ɛhaŋi
chofio	χɔvjɔ
gefnfor	ɡɛvɛnvɔr
rhestrau	r̥ɛsdrai̯
addef	aːðɛv
hanodd	hanɔð
nhreisiwr	n̥rei̯ʃʊr
mỳg	məɡ
biolegol	bjɔlɛɡɔl
'na	na
saith seren	sai̯θseːrɛn
mleiddiau	mlei̯ðjai̯
blynyddoedd golau	blənəðɔi̯ðɡɔlai̯
cyngaws	kəŋau̯s
metelegydd	mɛtɛlɛɡɪð
dacw	daku
gadawed	ɡadau̯ɛd
arosfa	arɔsva
daioni	dajoːni
noli	nɔli
oedolyn	ɔi̯dɔlɪn
efydd	eːvɪð
gwreiddio	ɡwrɛi̯ðjɔ
cynaeafu	kniaːvi
bedd	beːð
argraffiadaeth	arɡrafjaːdɛθ
fuwch	vɪu̯χ
dinas	dɪnas
gwialen bysgota	ɡwjaːlɛmbəsɡɔta
o flaen llaw	ɔvlai̯nɬau̯
abermaw	abɛrmau̯
pwy dach chi	pʊi̯daχiː
meysydd awyr	mei̯sɪðau̯ɪr
brwydrwyr	brʊi̯drwɪr
tywodfaen	təu̯ɔdvai̯n
labovaidd	labɔvai̯ð
ddegfed	ðɛɡvɛd
ngwahanol	ŋwaːnɔl
chôt	χoːt
rheoliadau	r̥ɛɔljaːdɛ
talaf	taːlav
cyfrifoldebau	kəvrɪvɔldeːbai̯
ngwylio	ŋʊi̯ljɔ
gên	ɡeːn
ddwfr	ðʊvr
seler	seːlɛr
gwrthiselyddion	ɡʊrθɪsɛləðjɔn
nwylo	niːlɔ
esgaladur	ɛsɡaladɪr
dyddiad	dəðjad
nos fercher	noːsvɛrχɛr
ès	ɛs
gyddfau	ɡəðvai̯
ngwin	ŋwiːn
rhieni	r̥jeːni
ogwr	oːɡʊr
chara	χaːra
ddafydd	ðaːvɪð
pryfed genwair	prəvɛdɡɛnwai̯r
flew	vlɛu̯
rhew	r̥ɛu̯
chefnau	χɛvnai̯
reit	rei̯t
cop	kɔp
cyff	kiːf
gwahaniaethiad	ɡwahanjei̯θjad
teimlo	tɪmlɔ
gweithgaredd	ɡwei̯θɡarɛð
gwiwer	ɡwɪu̯ɛr
cerwch	kɛrʊχ
caffent	kafɛnt
coeden afalau	kɔi̯dɛnavalɛ
mlynedd	mlənɛð
llwydo	ɬʊi̯dɔ
gwaywffyn	ɡwei̯wfɪn
teisen radell	tei̯ʃɛnradɛɬ
faint o'r gloch	vai̯ntɔrɡloːχ
degau	dɛɡai̯
platfform	platfɔrm
cafwyd	kavʊi̯d
abatir	abatɪr
picil	pɪkɪl
teiar	tei̯ar
diarhebion	diarhɛbjɔn
gneuen	ɡnei̯ɛn
cynorthwywyr	kənɔrθʊi̯wɪr
amanita benfelen	amanɪtabɛnveːlɛn
nghusan	ŋ̊ɪsan
niwliog	nɪu̯ljɔɡ
gwymona	ɡwɪmɔna
ymweld	əmwɛld
ngŵyr	ŋʊi̯r
rheolau	r̥ɛɔlɛ
wys	wiːs
brwysg	brʊi̯sk
ladd	laːð
adwaenynt	adwei̯nɪnt
leicia	lei̯kja
ychen	əχɛn
cannu	kani
talaf	tala
arolygwr	arɔləɡʊr
ieuan	jei̯an
denfyn	dɛnvɪn
geisio	ɡei̯ʃɔ
basen	bəsɛn
braf	braːv
coch y berllan	koːχəbɛrɬan
taflod	tavlɔd
nhelyn	n̥eːlɪn
parddu	parði
gwydden	ɡwɪðɛn
gorff	ɡɔrf
athrawesau	aθrau̯ɛsɛ
awgrymu	au̯ɡrəmi
lygaid	lɪɡɛd
lloches	ɬɔχɛs
lladd	ɬaːð
carew	karɛu̯
stamp	stamp
ymasiad	əmasjad
dewis	dɛu̯iʃ
thew	θɛu̯
dòl	dɔl
coel	kɔi̯l
delfryd	dɛlvrɪd
adleisiau	adlei̯sjai̯
mhum	m̥ɪm
arswydo	arsʊi̯dɔ
nhyrrau	n̥ərai̯
rhaw	r̥au̯
llawlyfr	ɬau̯ləvɪr
neidiau	nei̯djɛ
technoleg gwybodaeth	tɛχnoːlɛɡɡʊi̯boːdɛθ
wyf	iːv
eirina	ei̯rɪna
lygad	lɪɡad
gwledd	ɡwleːð
weithio	wei̯θɔ
ffeindiaf	fei̯nda
ngoleuadau	ŋɔliadɛ
angylaidd	aŋəlɛð
taled	talɛd
cylchoedd	kəlχɔi̯ð
terydr	tɛrɪdr
recríwt	rɛkrɪu̯t
carthennau	karθɛnɛ
nghyfnither	ŋ̊əvniːθɛr
siwan	sɪu̯an
mach	maːχ
cyfer	kəvɛr
pharod	farɔd
fychan	fəχan
nghain	ŋ̊ai̯n
gostwng	ɡɔsdʊŋ
ffeindio	fɪndɔ
addaweb	aðau̯ɛb
charafán	χaravan
gweision	ɡwei̯ʃɔn
modfedd	mɔdvɛð
o flaen	ɔvlai̯n
blodfresychen	blɔdvrɛsəχɛn
peiriannau arian parod	pei̯rjanai̯arjanpaːrɔd
gwenwyn	ɡwɛnʊi̯n
alban cyntefin	albankəntɛvɪn
adaregwyr	adarɛɡwɪr
dryslyd	drəslɪd
phwl	fʊl
phrydain	frədai̯n
ymedy	əmeːdi
gneuen ffrengig	ɡnei̯ɛnfrɛŋɪɡ
arno	arnɔ
tawl	tau̯l
aderyn du	adeːrɪndiː
cyfrifwr	kəvriːvʊr
teithi	tei̯θi
mhoptai	m̥ɔptai̯
madfall	madvaɬ
siocled poeth	ʃɔklɛdpɔi̯θ
llwyn	ɬʊi̯n
cwbl	kʊbl
trueni	trieːni
unioni	ɪnjɔni
ffrygydau	frəɡəda
nhân	n̥aːn
bawn	bau̯n
llwch	ɬuːχ
alan	alan
ymdeimlad	əmdei̯mlad
canu	kani
garai	ɡaːrɛ
llen	ɬɛn
aderyn	adɛrɪn
meiddion	mei̯ðjɔn
awgrymiad	au̯ɡrəmjad
ffensiau	fɛnsjɛ
daeth	daːθ
llenwi	ɬɛnwi
drwy	drʊi̯
iseldiraidd	ɪsɛldiːrai̯ð
celyn	keːlɪn
chosyn	χɔsɪn
ddim	əm
rhwystr	r̥ʊi̯sdɪr
phant	fant
nid wrth ei big y mae mesur cyffylog	nɪdʊrθibiːɡəmamɛsɪrkəfəlɔɡ
efwr	ɛvʊr
echrydus	ɛχrədɪs
aberteifi	abɛrtiːvi
aeron	ei̯rɔn
nglaned	ŋlaːnɛd
plwg	plʊɡ
hawlfraint	hau̯lvrai̯nt
anabl	anabl
fag	vaɡ
canoli	kanoːli
fôn	voːn
dilledyn	dɪɬɛdɪn
aethon	ei̯θɔn
garem	ɡarɛm
adlef	adlɛv
shibwns	ʃɪbʊns
athrawes	aθrau̯ɛs
addoliad	aðɔljad
pedolau	pɛdɔlɛ
hudo	hiːdɔ
taliff	taːlɪf
mod	moːd
gaeredin	ɡai̯reːdɪn
damweiniau	damwei̯njai̯
adfilwr	advɪlʊr
blwyddyn golau	blʊi̯ðɪnɡɔlɛ
tlws	tluːs
taradr	taːradr
nacáu	nakai̯
iesu grist	jɛsiɡrɪst
thaliadau	θaljaːdɛ
mesa	mɛsa
gwybodaeth	ɡʊi̯bɔdai̯θ
adwaenech	adwei̯nɛχ
bocswyr	bɔkswɪr
wiciadur	wɪkjadɪr
dydd sadwrn	dɪsaːdʊrn
basta	basda
'i	iː
sir frycheiniog	siːrvrəχəi̯njɔɡ
thŷ	θiː
anafais	anaːvai̯s
wyth ar hugain	ʊi̯θarhɪɡai̯n
sant	sant
shibwns	ʃɪbʊnz
adarydd	adaːrɪð
albanau	albanai̯
glew	ɡlɛu̯
cyflymder	kəvləmdɛr
nhadau	n̥aːdai̯
phei	fei
gweithdy	ɡwəi̯θdi
ffwcio	fʊkjɔ
conyn	koːnɪn
llid	ɬiːd
gwalch	ɡwalχ
stafell	sdaːvɛɬ
gweinyddu	ɡwei̯nəði
megan	meːɡan
magnelwyr	maɡnɛlʊr
dosbarthu	dɔsbarθi
chefnfor	χeːvɛnvɔr
dichon	diːχɔn
llygad	ɬəɡad
carit	kaːrɪt
almaenwr	almei̯nʊr
clo	kloː
bortiwgal	bɔrtɪu̯ɡal
fynyddoedd	vənəðɔi̯ð
chopa	χɔpa
gwahanol	ɡwaːnɔl
nhrwyddedau	n̥rʊi̯ðeːdai̯
ngolwg	ŋɔlʊɡ
almanac	almanak
pedwar ar hugain	pɛdwararhɪɡai̯n
mewngofnodi	mɛu̯ŋɡɔvnɔdi
braen	brai̯n
cyflwr	kəvlʊr
gwern	ɡwɛrn
dydd gwener	dɪɡwɛnɛr
origami	ɔrɪɡami
anghytuno	aŋhətiːnɔ
craf	kraːv
cilbren	kɪlbrɛn
ifan	iːvan
torlannau	tɔrlanai̯
adnabyddant	adnabəðant
chaint	χai̯nt
ethrefig	ɛθrɛvɪɡ
tafarn	taːvarn
chath	χaːθ
mynwy	mənʊi̯
mewnfudo	mɛu̯nvɪdɔ
chato	χatɔ
dylanwad	dəlanwad
syndod	səndɔd
bonheddig	bɔnhɛðɪɡ
gwyddbwyll	ɡʊi̯ðbʊi̯ɬ
dyfi	dəvi
niod	niːɔd
picau maen	pɪkɛmaːn
teirw	tei̯ru
athref	aθrɛv
arswydau	arsʊi̯dai̯
nhaith	n̥ai̯θ
marchogaeth	marχoːɡai̯θ
habadesau	habadɛsɛ
glanaf	ɡlanav
bocsio	bɔkʃɔ
cadach	kaːdaχ
melys	mɛlɪs
twndish	tʊndɪʃ
mrân	mraːn
amgylcheddol	amɡəlχeːðɔl
petryalau	pɛtrialɛ
iddynt	ɪðɪnt
gwaith	ɡwai̯θ
mleiddiau	mlei̯ðjɛ
siort	ʃɔrt
gwladgarwyr	ɡwladɡarwɪr
pendrwm	pɛndrʊm
thafarn	θaːvarn
rhos	r̥oːs
nos iau	noːsjɔi̯
rhyngwladol	r̥əŋwlaːdɔl
syrthio	sərθjɔ
niwclear	nɪu̯klɛar
sgwariau	sɡwarjɛ
brif	briːv
melltithion	mɛɬdɪθjɔn
glywed	ɡləu̯ɛd
i gyd	ɪɡiːd
ariannin	ərarjanɪn
cwpanaid	kʊpanai̯d
bresychen	brɛsəχɛn
cywydd	kəu̯ɪð
tylluan	təɬiːan
bin	biːn
inni	ɪni
gwastraff	ɡwasdraf
blodau	bloːdɛ
cymraeg	kʊmraːɡ
cwb	kʊb
hyllt	hɪɬd
lestr	lɛstr
plismones	plismɔnɛs
gornestwyr	ɡɔrnɛsdwɪr
mwyara	mʊi̯aːra
rhag	r̥aɡ
rhywle	r̥ɪu̯lɛ
fersiwn	vɛrʃʊn
fleiddiau	vlei̯ðjɛ
ffy	fiː
afreolaidd	avrɛoːlɛð
stemar	sdeːmar
saig	sai̯ɡ
nhelynores	n̥ɛlənɔrɛs
tiroedd	tɪrɔi̯ð
facebook	feːsbʊk
efallai	vaɬɛ
teipio	tei̯pɔ
yf	iːv
beirniadol	bei̯rnjaːdɔl
enfawr	ɛnvau̯r
to	toː
copa	kɔpa
heddwas	hɛðwas
fe	veː
lyn	lɪn
tonau	toːnɛ
nglanaf	ŋlanav
tarianau	tarjaːnɛ
llythyren	ɬəθərɛn
mheth	m̥eːθ
adar	adar
chefnfor	χɛvɛnvɔr
gwirfoddol	ɡwɪrvoːðɔl
wythdegau	ui̯θdeːɡɛ
sgrechian	sɡreːχɛn
mesur	mɛsɪr
màs	mas
pasiaf	paʃav
bobl	boːbɔl
achlysur	aχləsɪr
pluf	pliːv
ansoddair	ansoːðai̯r
gyfreithiwr	ɡəvrei̯θjʊr
maes	mai̯s
piod	piːɔd
carthenni	karθɛni
ymadael	əmaːdai̯l
rywbeth	rɪu̯bɛθ
anafes	anaːvɛs
llundain	ɬɪndai̯n
haelwyd	hei̯lʊi̯d
dolur	doːlɪr
cofiai	kɔvjai̯
boenen	bɔi̯nɛn
mynach	mənaχ
agerlongau	aɡɛrlɔŋɛ
iyrchod	jərχɔd
telynau	tɛlənɛ
helyg	hɛlɪɡ
hendrefi	hɛndreːvi
weld	wɛld
storïau	sdɔriːɛ
cynaeafu	knei̯aːvi
bochdew	bɔχdɛu̯
golwg	ɡoːlʊɡ
ymadael	əmadai̯l
coelcerth	kɔi̯lkɛrθ
culdir	kɪldɪr
acen ddyrchafedig	akɛnðərχavɛdɪɡ
wyf	ʊi̯v
adref	adrɛv
amrantiad	amrantjad
glwth	ɡluːθ
iselder ysbryd	ɪʃɛldɛrəsbrɪd
amodiad	amɔdjad
goleuadau	ɡɔliadɛ
doet	dɔi̯t
nghusanau	ŋ̊ɪsanai̯
brawychiaeth	brau̯əχjɛθ
arglwydd	arɡlʊi̯ð
esgyll	ɛsɡɪɬ
cyffredinol	kəfrɛdiːnɔl
llysenw	ɬiːsɛnu
gwys	ɡwiːs
dydd iau	dɪðjai̯
phencampwriaeth	fɛŋkampʊrjɛθ
lludw	ɬiːdu
chwestiwn	kwɛsdjʊn
mi	miː
ocê	ɔkeː
ysbryd	əsbrɪd
myr	mɪr
emiw	ɛmɪu̯
flin	vliːn
unrhyw un	ɪnrɪu̯ɪn
gartref	ɡartrɛv
gansai	ɡansai̯
talet	talɛt
trên	treːn
coed afalau	kɔi̯davaːlai̯
iäaidd	jaai̯ð
cedor	kɛdɔr
mwyd	mʊi̯d
ysbyty	sbəti
maneg	maːnɛɡ
dawel	dau̯ɛl
nawr	nau̯r
eisteddfodau	ei̯sdɛðvɔdai̯
de	deː
rhan	r̥an
nhi	n̥iː
argraffu	arɡrafi
nghar	ŋ̊ar
nghanu	ŋ̊ani
wybodaeth	ʊi̯boːdai̯θ
roeddech	rɔi̯ðɛχ
dorrid	dɔrɪd
nghefnau	ŋ̊ɛvnai̯
cachais	kaːχɛs
pwrpas	pʊrpas
cyfraith	kəvrai̯θ
flwyddyn	vlʊi̯ðɪn
finegr	vɪnɛɡr
metelegwr	mɛtɛleːɡʊr
ffôn symudol	foːnsəmɪdɔl
teithio	tiθɔ
boch	boːχ
sut dach chi	sɪtdaχχiː
mrain	mrai̯n
byddar	bəðar
gwylan	ɡʊi̯lan
gordderchadon	ɡɔrðɛrχaːdɔn
adflasau	advlasai̯
cofiais	kɔvjɛs
cenhinen	kɛnhiːnɛn
terfynau	tɛrvənɛ
boptai	bɔptai̯
mordwy	mɔrdʊi̯
anoddaf	anɔða
gato	ɡatɔ
ymasiad	əmaʃad
doen	dɔi̯n
adnebydd	adneːbɪð
cristnogaeth	krɪsdnɔɡɛθ
ngolchi	ŋɔlχi
rhieni	r̥jɛni
chwarae	warɛ
imi	ɪmi
magnelwyr	maɡneːlʊr
fflamgwr	flamɡʊr
llwybr y gwynt	ɬʊi̯brəɡwɪnt
chneuen ffrengig	χnei̯ɛnfrɛŋɪɡ
coma	kɔma
elwn	ɛlʊn
gara	ɡaːra
cymdeithasol	kəmdei̯θasɔl
mherthynas	m̥ɛrθənas
atebaf	atɛba
fath	vaːθ
rhydau	r̥ədai̯
diwyd	dɪu̯ɪd
cyflogi	kəvloːɡi
noeth	nɔi̯θ
clwyd	klʊi̯d
ailosod	ai̯lɔsɔd
llandudno	ɬandɪdnɔ
cest	kɛsd
marus	marɪs
j	dʒeː
cyhoeddus	kəhɔi̯ðɪs
adfeilion	advei̯ljɔn
gwahanu	ɡwahani
drennydd	drɛnɪð
eisteddfodau	sdɛðvɔdɛ
dyfrgi	dəvrɡi
efallai	waɬɛ
mhobloedd	m̥ɔblɔi̯ð
hyblyg	həblɪɡ
codau	kɔdɛ
söolegwyr	sɔɔlɛɡwɪr
dadwreiddio	dadrɛi̯ðɔ
nghlywed	ŋ̊ləu̯ɛd
ce	keː
afanc	aːvaŋk
penfelen	penvɛlɛn
cyflafareddwr	kəvlavarɛðʊr
egwyddor	ɛɡʊi̯ðɔr
adfeiliadau	advei̯ljaːdai̯
rheol	r̥eːɔl
siwr	ʃuːr
gwybod	ɡuːbɔd
rhuthraf	r̥ɪθrav
adwaenit	adwei̯nɪt
potsio	pɔtʃɔ
trwyddedau	trʊi̯ðeːdɛ
nythfa	nəθva
troedfedd	trɔdvɛð
emrys	ɛmrɪs
mynegai	mənɛɡai̯
eangderau	ɛaŋdɛrɛ
geiriau	ɡei̯rjai̯
nghalan	ŋ̊aːlan
brenhines	brɛnhɪnɛs
sgrech	sɡreːχ
brynu	brəni
caerhirfryn	kai̯rhɪrvrɪn
mawl	mau̯l
ffin	fiːn
talon	talɔn
bwl	bʊl
aredig	areːdɪɡ
almaen	əralmai̯n
gimbill	ɡɪmbɪɬ
gronell	ɡrɔnɛɬ
nghadair	ŋ̊aːdɛr
drwg	druːɡ
gnau cyll	ɡnai̯kɪɬ
carais	karai̯s
iâ	jaː
ryddid	rəðɪd
pwys	pʊi̯s
cennin pedr	kɛnɪmpɛdr
tân	taːn
aillt	ai̯ɬd
eirinen ysgaw	ei̯riːnɛnəsɡau̯
camlwrw	kamluːru
coeden	kɔi̯dɛn
gorchmynnol	ɡɔrχmənɔl
cochyn	koːχɪn
chwrs	χʊrs
hirgron	hɪrɡrɔn
breuddwydion	brei̯ðʊi̯djɔn
chari	χaːri
atelid	ateːlɪd
llestr	ɬɛstr
bugail	biːɡɛl
iwerddon	ɪu̯ɛrðɔn
rhyd	r̥iːd
holi	hoːli
ceir	kei̯r
dere	deːrɛ
throed	θrɔi̯d
gais	ɡai̯s
coeden afalau	kɔi̯dɛnvalɛ
afraid	avrai̯d
adenydd	adɛnɪð
bwrw	buːru
meddiant	mɛðjant
dolïau	dɔliai̯
bant	bant
prawf	prau̯v
nghymorth	ŋ̊əmɔrθ
ganes	ɡaːnɛs
gyrraf	ɡərav
hafodydd	havoːdɪð
troid	trɔi̯d
mwyar y berwyn	mʊi̯arəbɛrwɪn
amnewid	annɛu̯ɪd
caeredin	kai̯reːdɪn
lesddeiliaid	leːsðei̯ljɛd
lleianaeth	ɬei̯aːnai̯θ
ffili	fɪli
haber	habɛr
sachell	saːχɛɬ
cydweithrediadau	kiːdwei̯θrɛdjadɛ
cyfrwngddarostyngedigaeth	kəvrʊŋðarɔsdəŋɛdiːɡɛθ
saith ar hugain	sai̯θarhiːɡɛn
gwympo	ɡwɪmpɔ
bysgod	bəsɡɔd
maen	mən
talu	tali
weddi'r arglwydd	wɛðirarɡlui̯ð
glo	ɡloː
gwŷdd	ɡwiːð
symudol	səmiːdɔl
mag	maːɡ
o blith	oːbliːθ
chlwb	χlʊb
elom	ɛlɔm
teisen radell	tiːʃɛnraːdɛɬ
gorchuddio	ɡɔrχɪðjɔ
siop	ʃɔp
èll	ɛɬ
drysu	drəsi
switshys	swɪtʃɪz
caffi	kafi
allwthio	aɬʊθjɔ
chwpwrdd	χʊpʊrð
ar draws	ardrau̯s
ichwi	ɪχwi
dei	dei̯
pharhau	farhai̯
ardaloedd	ardaːlɔð
tarw	taːru
cydweithrediadau	kiːdwei̯θrɛdjadai̯
dau	dɔi̯
cerbyd	kɛrbɪd
bysgodyn	bəsɡoːdɪn
chwarae	χwaːrɛ
iselderau	ɪsɛldɛrai̯
yn barod	əmbarɔd
nghylchgrawn	ŋ̊əlχɡrau̯n
dysgleidiau	dɪsɡlei̯djɛ
afalau cariad	avalai̯karjad
datod	datɔd
chythreuliaid	χəθrei̯ljai̯d
nghlust	ŋ̊lɪst
pisyn grôt	pɪsɪŋɡroːt
brwydr	brʊi̯dr
gwpwrdd	ɡʊpʊrð
naw ar hugain	nau̯arhɪɡai̯n
mhysgod	m̥əsɡɔd
gachen	ɡaːχɛn
mabwysiadu	mabʊi̯ʃaːdi
camgymeriad	kamɡəmɛrjad
hendrefa	hɛndrɛva
cyfrwngddarostyngedigaeth	kəvrʊŋðarɔsdəŋɛdɪɡɛθ
cymedrolwr	kəmɛdrɔlʊr
gweddol	ɡweːðɔl
olewydd	ɔlɛu̯ɪð
athrodi	aθrɔdi
herwhela	hɛrwheːla
groes	ɡrɔi̯s
cyntaf	kɪnta
actiaf	aktjav
rhynionyn	r̥ənjɔnɪn
esgyrn	ɛsɡɪrn
amgylchedd	amɡəlχɛð
talais	talɛs
amguedd	amɡiɛð
trafferthion	trafɛrθjɔn
ymeifl	əmei̯vl
murddunnod	mɪrðɪnɔd
adfywiadau	advɪu̯jadɛ
baban	baːban
chwerw	χweːru
brân	braːn
sgrin	sɡriːn
dw i angen dŵr	duiaŋɡɛnduːr
paith	pai̯θ
aur	ai̯r
gusanau	ɡɪsanai̯
rhiant	r̥iːant
catholig	kaθɔlɪɡ
llygad	ɬɪɡad
cloan	klɔan
mwydyn	mʊi̯dɪn
un ar hugain	iːnarhiːɡɛn
physgota	fəsɡɔta
garan	ɡaːran
cilfach	kɪlvaχ
talom	talɔm
cwtiar	kʊtjar
heb	heːb
gelli	ɡɛɬi
lerpwl	lɛrpʊl
mẁg	mʊɡ
o'r gloch	oːrɡloːχ
awn	au̯n
mhaned	m̥anɛd
cipio	kɪpjɔ
hunan	hiːnan
talaf	taːla
marus	maːrɪs
llwybr llaethog	əɬʊi̯bɪrɬei̯θɔɡ
deg	deːɡ
unedau	ɪneːdɛ
gyflym	ɡəvlɪm
trydydd	trədɪð
cwpaneidiau	kʊpanei̯djai̯
chwiorydd	χwiɔrɪð
llus america	ɬiːsamɛrɪka
focsio	vɔkʃɔ
nghefnau	ŋ̊ɛvnɛ
isod	ɪsɔd
gweddïau	ɡwɛðiːai̯
arswydus	arsʊi̯dɪs
bleiddiaid	blei̯ðjai̯d
cydweithwyr	kɪdwei̯θwɪr
deulu	diːli
gweedig	ɡwɛeːdiɡ
heol y gwynt	heːɔləɡwɪnt
copyn	kɔpɪn
maint	mai̯nt
gorfodog	ɡɔrvoːdɔɡ
pwy	pʊi̯
chwaer	waːr
merfenw	mɛrveːnu
cic adlam	kɪkadlam
neuadd	nei̯að
pinafal	piːnaːval
oman	ɔman
aderyn du	adɛrɪndiː
cachgi bwm	kaχɡibʊm
penillion	pɛnɪɬjɔn
cas beth	kaːsbeːθ
iselyddion	ɪsɛləðjɔn
ymddengys	əmðɛŋɡɪs
aelod o'r senedd	ei̯lɔdɔrseːnɛð
lydaw	lədau̯
mil	miːl
gwasanaeth	ɡwasanai̯θ
aethost	ei̯θɔsd
archseren	arχsɛrɛn
warysau	warəsɛ
jyngl	d͡ʒəŋɡl
hangen	haŋɛn
dw	dw
diamod	diːamɔd
pechadur	pɛχadɪr
shibwns	ʃiːbʊns
leision	lei̯ʃɔn
canai	kaːnɛ
efengylu	ɛvɛŋəli
ddoe	ðoː
trolïau	trɔliɛ
felyn	veːlɪn
dreisiwr	drei̯sjʊr
trigain	trɪɡɛn
thelynores	θɛlənɔrɛs
oherwydd	ɔhɛrʊi̯ð
taro	tarɔ
brochod	brɔχɔd
chi	χiː
masg	masɡ
lwyddo	lʊi̯ðɔ
gwlad	ɡwlaːd
rhinoseros	r̥ɪnɔsɛrɔs
harglwydd	harɡlʊi̯ð
bethau	bɛθɛ
neithiwr	nei̯θʊr
chwarae	χwarai̯
mhaith	m̥ai̯θ
cwsmeriaid	kʊsmɛrjɛd
llungopïo	ɬɪŋɔpiːɔ
talo	taːlɔ
traethodau	trei̯θɔdai̯
eangderau	ɛaŋdeːrɛ
achwynwr	aχʊi̯njʊr
barbeciwiau	barbɛkɪu̯jɛ
arwydd	arwɪð
cyfiawnhau	kəvjau̯nhai̯
marw	maːru
cystadleuwyr	kəsdadlei̯wɪr
gwregys	ɡrɛɡɪs
ffraegar	frei̯ɡar
lleugylch	ɬei̯ɡɪlχ
arthan	arθan
amrywedd	amrɪu̯jɛð
trymhau	trəmhai̯
arlwy	arlui̯
adar	aːdar
haber	haːbɛr
gwrthwynebiadau	ɡʊrθwɪnɛbjaːdai̯
llwythau	ɬʊi̯θɛ
cymharu	kəmhari
blodau	bloːdai̯
cerdded	kɛrðɛd
bron	brɔn
ganddo	ɡanðɔ
cansen	kansɛn
tawdd	tau̯ð
ar ôl	aroːl
cilwen	kɪlwɛn
nhîm	n̥iːm
peidio	peidɔ
anialwch	anjaːlʊχ
hychod	həχɔd
gwaredu	ɡwareːdi
holocost	hɔlɔkɔsd
croen	krɔi̯n
pencampwriaeth	pɛŋkampʊrjai̯θ
gwenwyn	ɡweːnʊi̯n
toddyf	toːðɪv
habadau	habaːdɛ
asgell fraith	asɡɛɬvrai̯θ
amanita	amanɪta
benyw	bɛnɪu̯
broga	broːɡa
moll	mɔɬ
cyflafar	kəvlavar
fyr	vɪr
baw	bau̯
bryniau	brənjɛ
rheolwr	r̥ɛɔlʊr
thu	θiː
offer	oːfɛr
habwydyn	habʊi̯dɪn
sudd	siːð
mabwysiadu	mabʊi̯sjaːdi
anweddu	anweːði
tyllau	təɬai̯
adwaenost	adwei̯nɔsd
blewyn	blɛu̯ɪn
nghwpwrdd	ŋ̊ʊpʊrð
cneua	knei̯a
pharatoi	faratɔi̯
blwch llwch	bluːχɬuːχ
argrafiadau	arɡrafjaːdai̯
doid	dɔi̯d
hwnnw	hʊnu
creder	kreːdɛr
baet	bai̯t
hwylbren	hʊi̯lbrɛn
nos wener	noːsweːnɛr
ddoe	ðɔi̯
magu	maːɡi
bwthyn	bʊθɪn
parhaol	parhau̯ɔl
coeden afalau	kɔi̯dɛnavaːlai̯
ionawr	joːnau̯r
nheisen	n̥ei̯ʃɛn
ymdreiddio	əmdreiðjɔ
adaryddion	adarəðjɔn
torlannau	tɔrlanɛ
geiriadurwr	ɡei̯rjadiːrʊr
elid	ɛlɪd
habadau	habadɛ
sgileffaith	sɡiːlɛfai̯θ
cangen	kaŋɛn
pabïau	pabiːai̯
gwenynen fêl	ɡwenənɛnveːl
bol	bɔl
deunyddiau	dei̯nəðjɛ
nos sadwrn	nɔsaːdʊn
babell	babɛɬ
firws	viːrʊs
croeniog	krɔi̯njɔɡ
canwyllbrennau	kanʊi̯ɬbrɛnai̯
cachan	kaːχan
gelai	ɡɛlai̯
pump ar hugain	pɪmparhiːɡai̯n
drwyddedau	drʊi̯ðeːdɛ
hetiwr	hɛtjʊr
lol	lɔl
gartre	ɡartrɛ
cyfrwng	kəvrʊŋ
ngwladfa	ŋwladva
gweinyddiadau	ɡwei̯nəðjaːdɛ
niweidio	nɪu̯ei̯djɔ
ddweud	ðwei̯d
gloan	ɡloːan
unwaith	ɪnwɛθ
pryfed	prəvɛd
fach	vaːχ
thalcen	θalkɛn
cariad	karjad
nghwrw	ŋ̊ʊru
habatai	habatai̯
rhentu	r̥ɛnti
hwylio	hʊi̯ljɔ
chwrw	χʊru
tanwydd	tanʊi̯ð
uchel	ɪχɛl
talit	taːlɪt
gwelen	ɡweːlɛn
ec	ɛk
cwlwm	kʊlʊm
well	weːɬ
pymthegfed	pəmθɛɡvɛd
habaty	habati
dydd iau	dɪjɔi̯
gu	ɡiː
arbedaf	arbɛdav
tiwlip	tɪu̯lɪp
hyn a'r llall	hɪnarɬaːɬ
lesddeiliad	leːsðei̯ljad
nos sadwrn	nɔssadʊrn
crempog	krɛmpɔɡ
cyn hyn	kɪnɪn
chwarel	χwarɛl
cot	kɔt
lleianaidd	ɬei̯anai̯ð
ngwallt	ŋwaɬd
dalom	dalɔm
undebau	ɪndeːbɛ
cydweithiad	kiːdwei̯θjad
creisionen	krei̯sjɔnɛn
llais	ɬai̯ʃ
clybiau	kləbjai̯
olwyn	ɔlʊi̯n
afalau	avaːlai̯
cryd	kriːd
dim	dɪm
bryd	briːd
fadfall	vadvaɬ
llysiau	ɬɪsjɛ
groes	ɡroːs
nudd	niːð
chawl	χau̯l
asesiadau	asɛʃadai̯
canai	kanai̯
chalennig	χalɛnɪɡ
corhedydd	kɔrhɛdɪð
gwlith	ɡwliːθ
thala	θala
tachwedd	taχwɛð
llaeth	ɬaːθ
deiliadaeth	dei̯ljaːdɛθ
bioleg	bjoːlɛɡ
darllen	darɬɛn
gobaith	ɡɔbaiθ
phethau	feːθai̯
abadau	abadɛ
uchelwr	ɪχɛlʊr
annherfynol	anhɛrvənɔl
goddef	ɡoːðɛv
troed	troːd
canet	kaːnɛt
cen pen	kɛnpɛn
rhisgl	r̥ɪsɡl
chacen	χakɛn
hymasiad	həmaʃad
win	wiːn
pỳg	pəɡ
credant	kreːdant
nghwpan	ŋ̊ʊpan
chwennych	χwɛnɪχ
glustdlws	ɡlɪsdlʊs
èg	ɛɡ
buddion	bɪðjɔn
tharw	θaːru
naw ar hugain	nau̯arhiːɡɛn
gwesgyr	ɡwɛsɡɪr
gwasanaethau	ɡwasanei̯θai̯
pum	pɪm
piau	piːɛ
ymrysonydd	əmrəsoːnɪð
ceubren	kei̯brɛn
cafwyd	kaːvʊi̯d
deledu	dɛleːdi
galennig	ɡalɛnɪɡ
briallu	briaɬi
cadno	kadnɔ
deg ar hugain	deːɡarhiːɡai̯n
haeddel fawr	hei̯ðɛlvau̯r
crŷn	kriːn
ffarm	farm
heisteddfodau	hei̯sdɛðvɔdai̯
contract	kɔntrakt
hudo	hɪdɔ
harall	haraɬ
disgyn	dɪʃɡɪn
nawfed	nau̯vɛd
trefynwy	trɛvənʊi̯
haul	hai̯l
ysgubell	əsɡiːbɛɬ
talaf	talav
pioden	piɔdɛn
cymhlethdodau	kəmlɛθdoːdɛ
gloi	ɡlɔi̯
troer	trɔi̯r
swyddogaeth	sʊi̯ðɔɡɛθ
cesar	kɛsar
caerliwelydd	kai̯rlɪu̯ɛlɪð
pawr	pau̯r
drygioni	drəɡjɔni
pys	piːs
gwyneth	ɡwɪnɛθ
rhwyfau	r̥ʊi̯vai̯
hendrefi	hɛndrɛvi
gwilym	ɡwɪlɪm
cymylau	kəməlɛ
hogyn	hɔɡɪn
undeg dwy	ɪndɛɡdʊi̯
sos coch	soːskoːχ
peithiau	pei̯θjai̯
hwntw	hʊntu
anobeithiau	anɔbei̯θjɛ
amau	amai̯
gwrando	ɡwrandɔ
talent	taːlɛnt
ymdraidd	əmdrai̯ð
achwyniadau	aχʊi̯njaːdai̯
rhanbarthau	r̥ambarθɛ
pump ar hugain	pɪmparhɪɡai̯n
diwethaf	dɪu̯ɛθav
nghlyw	ŋ̊lɪu̯
ystod	əsdɔd
mewn	mɛu̯n
amau	amɛ
melen	meːlɛn
asesiadau	asɛsjaːdɛ
asesiadau	asɛʃaːdɛ
hawdd	hau̯ð
adferwyr	advɛrwɪr
cryddion	krəðjɔn
helfen	hɛlvɛn
beicio	bei̯kɔ
esgid	ɛsɡɪd
eiddgar	ei̯ðɡar
dolffiniaid	dɔlfɪnjai̯d
unrhyw	ɪnrɪu̯
ffensiau	fɛnsjai̯
dau ar bymtheg	dai̯arbəmθɛɡ
frys	vriːs
arddelw	arðɛlw
wedi hyn	wɛdihɪn
gartref	ɡartrɛ
aet	ai̯t
aberth	aːbɛrθ
bedwar	bɛdwar
edau	eːdɛ
flodyn	vloːdɪn
cymell	kəmɛɬ
fflwcs	flʊks
affrica	afrɪka
technoleg gwybodaeth	tɛχnoːlɛɡɡʊi̯boːdai̯θ
mewnforiadwy	mɛu̯nvɔrjaːdʊi̯
gwallt	ɡwaɬd
fywyd	vəu̯ɪd
ffigys	fɪɡɪs
bardd	barð
iechyd da	jɛχɪddaː
mharod	m̥aːrɔd
syml	səmɪl
habades	habaːdɛs
blith	bliːθ
pobi	pɔbi
eirinen fair	ei̯rɪnɛnvai̯r
bechan	bɛχan
chinio	χɪnɔ
gweithredu	ɡwei̯θrɛdi
anghofrwydd	aŋhɔvrʊi̯ð
arhosaf	arhɔsav
phengwiniaid	fɛŋɡwɪnjɛd
allforiadwy	aɬvɔrjadʊi̯
siwgr	ʃuːɡɪr
mlaidd	mlai̯ð
mela	mɛla
i fyny	ɪvəni
lesddeiliaid	leːsðei̯ljai̯d
toesaidd	tɔi̯sai̯ð
drud	driːd
gwsberen	ɡʊsbeːrɛn
ieithydd	jei̯θɪð
gwar	ɡwar
pysgota	pəsɡɔta
pwl	pʊl
saith seren	sai̯θsɛrɛn
maent	mai̯nt
helaeth	heːlɛθ
geir	ɡei̯r
gas	ɡaːs
gohirio	ɡɔhɪrjɔ
papur newydd	papɪrnɛu̯ɪð
fel hyn	vəlɪn
gwŷn	ɡwiːn
gwnaeth	ɡwnai̯θ
gwiwerod	ɡwɪu̯eːrɔd
gylfinirod	ɡəlvɪniːrɔd
arian parod	arjampaːrɔd
aros	arɔs
câr	kaːr
llwgu	ɬuːɡi
chweched	ʍeːχɛd
milwr	miːlʊr
picl	pɪkl
rhagfyr	r̥aɡvɪr
nrama	nraːma
asen	asɛn
dolffiniaid	dɔlfɪnjɛd
siop goffi	ʃɔpɡɔfi
ngwiwerod	ŋwɪu̯ɛrɔd
utganu	ɪtɡaːni
neuddeg	nei̯ðɛɡ
canwr	kaːnʊr
gwlyb	ɡliːb
ngaeaf	ŋei̯a
trenau	treːnai̯
llyfrgell	ɬəvərɡɛɬ
etifeddu	ɛtɪvɛði
mantais	mantɛs
hadu	haːdi
telynau teires	tɛlənai̯tei̯rɛs
croesi	krɔi̯si
cosbau	kɔsbɛ
barod	baːrɔd
thrwydded	θrʊi̯ðɛd
cusanau	kɪsanai̯
weriniaeth	wɛrɪnjɛθ
saesneg	sei̯snɛɡ
ar gof a chadw	arɡoːvaχadu
dechrau	daχrɛ
unid	iːnɪd
erbyn	ɛrbɪn
coedwig	kɔi̯dwɪɡ
datgelu	datɡeːli
rhestr	r̥ɛsdr
anableddau	anablɛðɛ
cyfrinach	kəvrɪnaχ
cofnod	kɔvnɔd
cadach	kadaχ
rhwyllau	r̥ʊi̯ɬɛ
llun	ɬiːn
cyflafaredd	kəvlavaːrɛð
plethau	plɛθai̯
ngorsaf	ŋɔrsav
ardd	arð
to bach	toːbaːχ
wair	wai̯r
anrheg	anr̥ɛɡ
chychwyn	χəχwɪn
thalai	θalɛ
siomau	ʃɔmai̯
gafael	ɡaːvai̯l
mynd	mɪn
cyntedd	kəntɛð
amffibiad	amfɪbjad
phencampwriaeth	fɛŋkampʊrjai̯θ
hafodau	havoːdɛ
duwies	dɪu̯jɛs
charan	χaːran
taled	taːlɛd
gwaethaf	ɡwiθa
llech	ɬeːχ
atalfeydd	atalvei̯ð
pandemig	pandɛmɪɡ
calsiwm	kalsjʊm
llenyddiaeth	ɬɛnəðjɛθ
gwanwynau	ɡwanwənɛ
gwrthod	ɡʊrθɔd
cymharu	kəmaːri
fel hyn	vlɪn
hiraeth	hiːrai̯θ
recordiad	rɛkɔrdjad
mabwysiadu	mabʊi̯ʃadi
cusanau	kɪsaːnɛ
cwyno	kʊi̯nɔ
aent	ai̯nt
hen bryd	heːnbriːd
adegau	adeːɡai̯
sgriniau	sɡrɪnjɛ
thraed	θraːd
blwyddyn golau	blʊi̯ðɪnɡoːlai̯
gwympo	ɡʊmpɔ
archseren	arχseːrɛn
yma	əma
doeddwn	dɔi̯ðɛn
arbed	arbɛd
unet	iːnɛt
yw	ɪu̯
ŵyll	ʊi̯ɬ
mhyliau	m̥əljɛ
asesu	asɛsi
carafannau	karavanɛ
sâl	saːl
byddai	bəðai̯
chlybiau	χləbjai̯
bigan	biːɡan
ngwybodaeth	ŋʊi̯bɔdɛθ
afreolaidd	avrɛɔlɛð
deffro	dɛfrɔ
garo	ɡaːrɔ
tyngedfenyddiaeth	təŋɛdvɛnəðjai̯θ
bual	biːal
rhagrith	r̥aɡrɪθ
pabi	paːbi
tanbaid	tambai̯d
nhrydanwr	n̥rədanʊr
chwarae	ʍwarɛ
bleidleisio	blei̯dlei̯sjɔ
llwrw	ɬuːru
iach	jaːχ
ciciau adlam	kikjɛadlam
cystadlaethau	kəsdadlei̯θɛ
elli	ɛɬi
geri	ɡeːrɪ
lydan	lədan
taenu	tiːni
gerddoriaeth	ɡɛrðɔrjɛθ
mynachdai	mənaχdai̯
cofnodi	kɔvnoːdi
seren	seːrɛn
fore	vɔrɛ
timoedd	tiːmɔð
trywel	trəu̯ɛl
golosg	ɡɔlɔsɡ
nain	nai̯n
lloegr	ɬɔi̯ɡɛr
gari	ɡari
brwydrau	brʊi̯drai̯
more	moːrɛ
rew	rɛu̯
pheis	feiz
myrdd	mɪrð
ddaru	ðaːri
rhithweledigaeth	r̥ɪθwɛlɛdiːɡɛθ
troseddu	trɔsɛði
briallen	brjaɬɛn
gweithlu	ɡwei̯θli
cymru	kəmri
gennod	ɡɛnɔd
gwres	ɡwreːs
gwyllon	ɡwəɬɔn
taliadau	taljadɛ
lawn	lau̯n
defnyddiau	dɛvnəðjai̯
lleill	ɬei̯ɬ
mochyn daear	mɔχɪndei̯ar
gwchi	ɡʊχi
rhedyn	r̥eːdɪn
mathemateg	maθɛmatɛɡ
wng	ʊŋ
cymedr	kəmɛdr
garu	ɡaːri
chani	χaːni
mether	mɛθɛr
ganlyniad	ɡanlənjad
delo	deːlɔ
ymddiheuro	əmðɪhei̯rɔ
eler	ɛlɛr
credo	kreːdɔ
hunain	hɪnɛn
hefo	heːvɔ
aberdaugleddau	abɛrdai̯ɡleːðɛ
y	ə
gwdihŵ	ɡʊdɪhuː
coden	kɔdɛn
cyfryngiadau	kəvrəŋjaːdai̯
aderyn du	deːrɪndiː
phryf	friːv
sawdl	sau̯dl
clodydd	klɔdɪð
beirniaid	bei̯rnjai̯d
wahanol	wahaːnɔl
oren	ɔrɛn
pobol	poːbɔl
cansai	kansai̯
thad	θaːd
beidio	biːdɔ
mellten	mɛɬdɛn
cwestiynau	kwɛsdjʊnɛ
heraill	heːraiɬ
trydydd	trɪdɪð
pabïau	pabiːɛ
trywelion	trəu̯ɛljɔn
organig	ɔrɡaːnɪɡ
gofod	ɡɔvɔd
aethant	ei̯θant
mwgwd	mʊɡʊd
gallu	ɡaɬi
hosbisau	hɔsbɪsɛ
gweithio	ɡwei̯θjɔ
gan	ɡan
heraill	hɛraiɬ
olchi	ɔlχi
wybod	uːbɔd
ngwenoliaid	ŋwɛnɔljɛd
dyrysu	dərəsi
arwynebedd	arwɪnɛbɛð
megan	mɛɡan
gwestiwn	ɡwɛsdjʊn
glyn	ɡlɪn
cyfundrefnu	kəvɪndrɛvni
gwellta	ɡwɛɬda
tharw	θaru
mercwri	mɛrkʊri
elfed	ɛlvɛd
agosáu	aɡɔsai̯
rhannu	r̥ani
hyfed	həvɛd
goleudai	ɡɔlei̯dai̯
cweryla	kwɛrəla
dinas	diːnas
shwd	ʃʊd
uni	ɪni
arbedaf	arbeːdav
nghlybiau	ŋ̊ləbjɛ
unedau	ɪnɛdai̯
argrafiadau	arɡrafjaːdɛ
holl	hoːɬ
newyn	nɛu̯ɪn
ymwelwr	əmweːlʊr
llusa	ɬɪsa
gestyll	ɡɛsdɪɬ
gyrrwr	ɡərʊr
nghae	ŋ̊ai̯
chnau cyll	χnai̯kɪɬ
mynyddoedd	mənəðɔi̯ð
plant	plant
cadwyn	kaːdʊi̯n
milwyr	mɪlwɪr
gwybod	ɡʊbɔd
torran	tɔran
tafod	tavɔd
enghraifft	ɛŋ̊rai̯fd
gysgu	ɡəsɡi
preifat	prei̯vat
barbeciwio	barbɛkɪu̯ɔ
geri	ɡɛri
cared	karɛd
allforiwr	aɬvɔrjʊr
blas	blaːs
arni	arni
gawod	ɡau̯ɔd
nhaliadau	n̥aljaːdai̯
eleni	ɛleːni
rhydychen	r̥iːdəχɛn
adareg	adaːrɛɡ
symudliw	səmɪdlɪu̯
cyfatebol	kəvatɛbɔl
dâl	daːl
afocados	avɔkaːdɔz
trwynol	trʊi̯nɔl
mochyn coed	moːχɪnkoːd
byrddydd	bərðɪð
penbleth	pɛmblɛθ
anhawster	anhau̯sdɛr
corryn	kɔrɪn
geffyl	ɡɛfɪl
addysg	aːðɪsɡ
cyfarchol	kəvarχɔl
cacs bach	kaksbaːχ
men siarl	mɛnʃarl
grôt	ɡroːt
meysydd	mei̯sɪð
pandemigau	pandɛmɪɡai̯
mefusen	mɛvɪsɛn
llo	ɬoː
pafin	pavɪn
ladron	ladrɔn
garen	ɡarɛn
galeted	ɡalɛtɛd
amrwd	amrʊd
cwch	kʊχ
agerlong	aɡɛrlɔŋ
casach	kaːsaχ
golchi	ɡɔlχi
bendith	bɛndɪθ
melyn	meːlɪn
dyry	dəri
ar	ar
ffoniff	foːnɪf
mynachod	mənaːχɔd
gafr	ɡavr
oedd	ɔi̯ð
ffonau	fɔnɛ
nghinio	ŋ̊ɪnɔ
derw	deːru
gares	ɡarɛs
dylan	dəlan
caeth	kai̯θ
nadredd	nadrɛð
rhyfelwr	r̥əveːlʊr
beirniadaeth	bei̯rnjadɛθ
amodi	amoːdi
eirin gwlanog	ei̯rɪŋɡwlanɔɡ
thatws	θatʊs
lysiau	ləsjai̯
dolïau	dɔliːai̯
bioleg	bjɔlɛɡ
saesneg	sɪsnɛɡ
o flaen llaw	ɔvlaːnɬau̯
collnod	kɔɬnɔd
weithiau	wei̯θjai̯
sut	ʃʊt
cymylog	kəməlɔɡ
dyryslyd	dərəslɪd
unai	ɪnai̯
mapiau	mapjɛ
ffilm	fɪlm
pryder	prədɛr
dawnsio	dau̯nʃɔ
gor	ɡɔr
cyfanswm	kəvansʊm
griliau	ɡrɪljɛ
hirsgwarau	hɪrsɡwaːrai̯
straeon	sdrei̯ɔn
moes	mɔi̯s
fferm	fɛrm
cyfrifoldebau	kəvrɪvɔldɛbɛ
glaned	ɡlaːnɛd
torchi	tɔrχi
anelu	aneːli
im	ɪm
hybu	həbi
arhoswch	arhɔsʊχ
barfog	barvɔɡ
anfonaf	anvɔnav
galluog	ɡaɬiɔɡ
brydain	brədɛn
dynn	dɪn
adwaenai	adwei̯nai̯
adferadwy	advɛradʊi̯
cyflafar	kəvlaːvar
terfysgu	tɛrvəsɡi
telynau teires	tɛlənɛtei̯rɛs
bunt	bɪnt
capel	kapɛl
dala	daːla
gusan	ɡɪsan
twymynau	tʊi̯mənai̯
twyn	tʊi̯n
droid	drɔi̯d
nid	nɪd
lladin	ɬadɪn
hugain	hɪɡai̯n
cilio	kɪljɔ
cau	kɔi̯
trois	trɔi̯s
timoedd	tɪmɔi̯ð
deiliadaeth	dei̯ljadɛθ
rhydychen	r̥ɪdəχɛn
iarll	jarɬ
gobaith	ɡoːbaiθ
lluoedd	ɬiːɔi̯ð
ffoniwn	fɔnjʊn
trom	trɔm
swyno	sʊi̯nɔ
mhobl	m̥ɔbl
oed	oːd
addolwr	aðoːlʊr
carant	kaːrant
newynau	nɛu̯ənɛ
nhad	n̥aːd
bencampwriaeth	bɛŋkampʊrjai̯θ
sadwrn	sadʊrn
cyfaredd	kəvaːrɛð
turtur	tɪrtɪr
iddewiaeth	ɪðeu̯jai̯θ
helygen	hɛləɡɛn
trefedigaethau	trɛvɛdɪɡei̯θai̯
creisionen ŷd	krei̯ʃoːnɛniːd
palu	pali
technoleg gwybodaeth	tɛχnoːlɛɡɡwəboːdɛθ
atborth	atbɔrθ
wociau	wɔkjɛ
pydru	pədri
arnat	arnat
gwrando	ɡrandɔ
y tu ôl i	ətioːli
sudd afal	siːðaval
diddorol	dɪðɔrɔl
talai	taːlɛ
eangiadau	ɛaŋjadɛ
myfyriwr	məvərjʊr
erys	eːrɪs
trais	trai̯s
deffry	dɛfri
trwchus	trʊχɪs
hyn i gyd	hɪniɡiːd
gwyddon	ɡwəðɔn
rhych	r̥iːχ
arwerthwyr	arwɛrθwɪr
dosbarthiadau	dɔsbarθjaːdɛ
trwyddedau	trʊi̯ðɛdɛ
clust	klɪst
amrant	amrant
pawb	pau̯b
barbeciwiau	barbɛkɪu̯jai̯
llanw	ɬaːnu
droed	droːd
llythrennau	ɬəθrɛnai̯
lles	ɬeːs
nghot	ŋ̊ɔt
elit	eːlɪt
syfi	səvi
drwyn	drʊi̯n
pharc	fark
lloc	ɬɔk
gwrs	ɡʊrs
iselderau	ɪsɛldɛrɛ
barbeciw	barbɛkɪu̯
eisteddle	ei̯sdɛðlɛ
ton	tɔn
microsgopau	mei̯krɔsɡɔpɛ
buddugoliaeth	bɪðɪɡɔljai̯θ
animeiddwyr	anɪmei̯ðwɪr
gwragedd	ɡwraɡɛð
cadarn	kadarn
eang	eːaŋ
brëyr	breːɪr
reiat	rei̯at
cen coed	kɛnkɔi̯d
main	mai̯n
eiriadurwr	ei̯rjadɪrʊr
aredaf	arɛdav
celai	kɛlɛ
buddug	biːðɪɡ
peniadau	pɛnjaːdai̯
ych	əχ
chaf	χaː
mhryfed	m̥rəvɛd
hiraeth	hiːrɛθ
ddal	ðal
traphoethi	trafɔi̯θi
negesydd	nɛɡɛsɪð
personél	pɛrsɔnɛl
mywyd	məu̯ɪd
cyfamod	kəvamɔd
cwmws	kʊmʊs
cyflogwyr	kəvlɔɡwɪr
nhelynor	n̥ɛlənɔr
baban	baban
carit	karɪt
hais	hais
iseldiraidd	ɪsɛldiːrɛð
tenau	teːnai̯
llywelyn	ɬəu̯ɛlɪn
haen	hai̯n
gwyliedyddion	ɡʊi̯ljɛdəðjɔn
tyfu	təvi
castanwydd	kasdanwɪð
theledu	θɛlɛdi
cilbost	kɪlbɔst
meddygfeydd	mɛðəɡvei̯ð
chachi	χaːχi
paneidiau	panei̯djai̯
nghelyn	ŋ̊ɛlɪn
ennill	ɛnɪɬ
ladin	laːdɪn
nadolig	doːlɪɡ
nghut	ŋ̊ɪt
disgwyl	dɪʃɡʊl
canolbarth	kanɔlbarθ
anafai	anavai̯
sôn	soːn
deiliad	dei̯ljad
droednoeth	drɔi̯dnɔi̯θ
hoen	hɔi̯n
picau maen	pɪkai̯mai̯n
cana	kaːna
bencampwriaeth	bɛŋkampʊrjɛθ
babŵn	babuːn
gwenynen feirch	ɡwɛnənɛnvei̯rχ
addasu	aðasi
cynhadledd	kənhadlɛð
penblethau	pɛmblɛθai̯
oce	ɔkɛ
iwerddoneg	ɪu̯ɛrðoːnɛɡ
wedi	wɛdi
banana	banana
medi	meːdi
pheidio	feidɔ
nheyrnas	n̥ei̯rnas
nos lun	noːsliːn
elen	eːlɛn
cerais	keːrai̯s
cyfrifol	kəvrɪvɔl
weriniaethau	ɡwɛrɪnjei̯θai̯
carai	karɛ
academi	akadɛmi
cadwch	kadwʊχ
gelet	ɡɛlɛt
talu	taːli
galluogi	ɡaɬiɔɡi
mynachlogydd	mənaχlɔɡɪð
adfeiliedig	advei̯ljeːdɪɡ
eiriadurwyr	ei̯rjadɪrwɪr
thrwyddedau	θrʊi̯ðeːdɛ
rhwydo	r̥ʊi̯dɔ
aeddfed	ai̯ðvɛd
bras	braːs
llyw	ɬɪu̯
arwynebedd	arʊi̯nɛbɛð
menyw	mɛnɪu̯
cymhleth	kəmlɛθ
bryste	brɪstɛ
cait	kai̯t
yfory	əvɔri
pedolwr	pɛdoːlʊr
fwyd	vʊi̯d
awtistiaeth	au̯tɪsdjɛθ
masen	masɛn
byw	bɪu̯
dosbarthwr	dɔsbarθʊr
gwystl	ɡʊi̯sdɪl
canolwr	kanoːlʊr
adnabyddus	adnabəðɪs
chusanau	χɪsanai̯
dwyieithog	dʊi̯jei̯θɔɡ
croeshoelio	krɔi̯shɔi̯ljɔ
syndodau	səndɔdɛ
cic	kɪk
troed	trɔi̯d
tryferu	trəveːri
wybodaeth	wəbɔdɛθ
thebyg	θɛbɪɡ
gwylliaid	ɡʊi̯ɬjɛd
gael	ɡai̯l
gwelen	ɡwɛlɛn
streiciau	sdrei̯kjai̯
pic ar y maen	pɪkarəmaːn
tudalen we	tɪdalɛnweː
creda	krɛda
pendant	pɛndant
siani	ʃaːni
ddysgu	ðəsɡi
wddw	ʊðu
olifau	ɔlɪvai̯
cecren	kɛkrɛn
amrywiaeth	amrɪu̯jɛθ
adar o'r unlliw hedant i'r unlle	aːdarɔrɪnɬɪu̯heːdantɪrɪnɬɛ
adlais	adlai̯s
terfynol	tɛrvənɔl
adferaf	advɛra
chwith	χwiːθ
llinynnau	ɬɪnənɛ
neilen	nei̯lɛn
corff	kɔrf
corhwyaden	kɔrhʊi̯adɛn
sos	soːs
diobaith	diɔbai̯θ
ngwledydd	ŋwlɛdɪð
leicia	lɪka
doer	dɔi̯r
wrando	rɪndɔ
adleisio	adlei̯ʃɔ
cest	keːsd
addo	aðɔ
wybodaeth	wɪbɔdɛθ
creision	krei̯sjɔn
cyfrifol	kəvriːvɔl
llonydd	ɬɔnɪð
cyfodi	kəvoːdi
priodi	priɔdi
dydd mercher	dɪmɛrχɛr
profi	proːvi
rhun	r̥iːn
cased	kaːsɛd
mynachaidd	mənaːχai̯ð
afocado	avɔkaːdɔ
focsio	vɔksjɔ
chwigain	χwɪɡai̯n
dydd sadwrn	dɪsadʊn
wely	wɛli
llythrennol	ɬəθrɛnɔl
gut	ɡɪt
argraffwr	arɡrafʊr
ychwanegu	əχwaneːɡi
meddiannau	mɛðjanɛ
ab	ab
paradwys	paraːdʊi̯s
lle	ɬeː
taler	talɛr
obeutu	ɔbei̯ti
ysu	əsi
lanach	lanaχ
thrawant	θrau̯ant
oer	oːr
cloem	klɔi̯m
cecru	kɛkri
dew	dɛu̯
orsaf	ɔrsav
byddin	bəðɪn
cerrig	kɛrɪɡ
telyn deires	tɛlɪndei̯rɛs
achyddion	aχəðjɔn
berfenwau	bɛrvɛnwai̯
dyrysleoedd	dərəsleːɔi̯ð
trydan	trədan
cymraeg	kəmraːɡ
cyfreithiwr	kəvrei̯θjʊr
ngâl	ŋaːl
trenau	trɛnai̯
peiriannau	pei̯rjanɛ
brics	brɪks
cly	kliː
elain	ɛlai̯n
tolio	tɔljɔ
dadlau	dadlai̯
fawrth	vau̯rθ
torrai	tɔrai̯
faen	vai̯n
gwaeth	ɡwaːθ
chlywed	χləu̯ɛd
saith ar hugain	sai̯θarhiːɡai̯n
dois	dɔi̯s
peiriannau arian	pei̯rjanɛarjan
gari	ɡaːri
gymylog	ɡəməlɔɡ
bigwrn	bɪɡʊrn
gwybodaeth	ɡwəbɔdɛθ
iselderau	ɪsɛldeːrɛ
celai	keːlai̯
benderfynu	bɛndɛrvəni
gaffel	ɡafɛl
clywaf	kləwav
adferant	advɛrant
swllt	sʊɬd
ngolau	ŋoːlɛ
dibwys	dɪbʊi̯s
talen	taːlɛn
dyrnfedd	dərnvɛð
gwybodaeth	ɡwəboːdɛθ
ogystal	ɔɡəstal
cildroi	kɪldrɔi̯
nghenhinen	ŋ̊ɛnhiːnɛn
gorwel	ɡɔrwɛl
rhuthro	r̥ɪθrɔ
wfft	ʊfd
iselder	ɪsɛldɛr
twr	tʊr
nghalon	ŋ̊alɔn
serchog	sɛrχɔɡ
beudy	bei̯di
gronellau	ɡrɔnɛɬai̯
alban hefin	albanhɛvɪn
tryferu	trəvɛri
hadolygu	hadɔləɡi
llinynnau	ɬɪnənai̯
brodyr	broːdɪr
naw ar hugain	nau̯arhiːɡai̯n
thalent	θaːlɛnt
jaciau	dʒakjai̯
ffres	frɛʃ
cynghanedd	kəŋhaːnɛð
chaen	χai̯n
garais	ɡarɛs
posib	pɔsɪb
dysgleidiau	dɪsɡlei̯djai̯
tipyn	tɪpɪn
pidyn	piːdɪn
fag	vaːɡ
coleg	koːlɛɡ
cachai	kaχai̯
rhyfelwr	r̥əvɛlʊr
traethodau	trei̯θɔdɛ
chaeredin	χai̯reːdɪn
meibion	məi̯bjɔn
chwyrnu	χwərni
cad	kaːd
gaws	ɡau̯s
fodd bynnag	voːðbənaɡ
delen	dɛlɛn
creisionen ŷd	krei̯ʃɔnɛniːd
cnau	knai̯
ystyried	əsdərjɛd
cheir	χei̯r
nhelynores	n̥ɛlənoːrɛs
golwg	ɡɔlʊɡ
sawsiau	sau̯ʃɛ
dyr	dɪr
garai	ɡarɛ
doedd	dɔi̯ð
hydrefau	hədrɛvɛ
canrif	kanrɪv
caran	kaːran
bandiau	bandjai̯
nghlefyd	ŋ̊lɛvɪd
dolïau	dɔliːɛ
cachai	kaːχai̯
ddechrau	ðəχrɛ
garwr	ɡarʊr
canant	kanant
gweinyddiaeth	ɡwei̯nəðjai̯θ
dynnu	dəni
gwŷr	ɡwiːr
flodau	vloːdɛ
adarydda	adarəða
goddef	ɡɔðɛv
angof	aŋɔv
mhob	m̥oːb
ychwanegol	əχwanɛɡɔl
nghefnfor	ŋ̊ɛvɛnvɔr
fachgenyn	vaχɡɛnɪn
derwyddiaeth	dɛrwəðjai̯θ
oleuadau	ɔlei̯aːdɛ
affwys	afʊi̯s
carneddi	karnɛði
adeiladol	adei̯laːdɔl
llamhidydd	ɬamhiːdɪð
cred	kreːd
garen	ɡaːrɛn
gydbreswylwyr	ɡiːdbrɛsʊi̯lwɪr
hoff	hoːf
chwenychu	χwɛnəχi
chwyddo	χwiːðɔ
cyfarwys	kəvarʊi̯s
adra	adra
loc	lɔk
ydy	ɔdi
echddoe	ɛχðɔi̯
rhwystredigaeth	r̥ʊi̯sdrɛdiːɡai̯θ
dadlau	dadlɛ
hirsgwariau	hɪrsɡwarjai̯
rhyddhau	r̥əðhai̯
nghusanau	ŋ̊ɪsaːnai̯
galwes	ɡalwɛs
onnen	ɔnɛn
adlefau	adleːvɛ
ngwennol	ŋwɛnɔl
dafydd	davɪð
pymthegnos	pəmθɛɡnɔs
mwyn	mʊi̯n
canol	kaːnɔl
beibl	bei̯bl
pedwar ar hugain	pɛdwararhiːɡai̯n
gwerth	ɡwɛrθ
cynrychioli	kənrəχjoːli
tala	tala
bechan	beːχan
gâl	ɡaːl
gorfod	ɡɔfɔ
maen	man
myfyrio	məvərjɔ
aelod	ei̯lɔd
lemwn	lɛmʊn
ngwystl	ŋʊi̯sdɪl
wledydd	wleːdɪð
cenedl	kɛnɛdl
galwyn	ɡalʊi̯n
parchu	parχi
cynllunio	kənɬɪnjɔ
siocledi	ʃɔkleːdi
ysguthan	sɡɪθan
elet	ɛlɛt
wylio	ʊi̯ljɔ
daliff	dalɪf
feirws	vei̯rʊs
brwydr	brʊi̯dɪr
mai	mai̯
chusanau	χɪsaːnɛ
boneddiges	bɔnɛðiːɡɛs
menyn	mɛnɪn
safbwynt	savbʊi̯nt
talant	taːlant
ydfrain	ədvrai̯n
derbyn	dɛrbɪn
ddoe	duɛ
gnawn	ɡnau̯n
absennol	absɛnɔl
ginio	ɡɪnjɔ
mhortiwgal	m̥ɔrtjʊɡal
eistedd	ɪsdɛ
fwltur	vʊltɪr
cyfryngis	kəvrəŋiz
hadran	hadran
fynydd	vəni
nghalennig	ŋ̊alɛnɪɡ
chyfarfod	χəvarvɔd
nglanach	ŋlanaχ
ffensys	fɛnsɪz
myfyrwyr	məvərwɪr
marchgacynen	marχɡakənɛn
nharianau	n̥arjanɛ
cyfwelydd	kəvweːlɪð
ffrwd	fruːd
ellyll	ɛɬɪɬ
esgob	ɛsɡɔb
fochyn	vɔχɪn
caro	kaːrɔ
boneddiges	bɔnɛðɪɡɛs
anafais	anavɛs
aromatherapi	arɔmaθɛrapi
sallwyr	saɬʊi̯r
mhigwrn	m̥ɪɡʊrn
greda	ɡrɛda
mae	ma
bedol	beːdɔl
rhestr	r̥ɛsdɛr
ymedy	əmɛdi
chapel	χapɛl
cofio	kɔvjɔ
deugeiniau	dɪɡei̯njɛ
pydredd	pədrɛð
ngholli	ŋ̊ɔɬi
froch	vroːχ
cynyddu	kənəði
thaler	θalɛr
ias	jaːs
abathocroalaidd	abaθɔkrɔalai̯ð
coden	koːdɛn
pencampwyr	pɛŋkampwɪr
unigolyn	ɪnɪɡɔlɪn
terfysgwr	tɛrvəsɡʊr
trefedigaeth	trɛvɛdɪɡɛθ
saws	sau̯s
drawant	drau̯ant
mlewyn	mlɛu̯ɪn
gelai	ɡeːlɛ
pwy wyt ti	pʊi̯ʊi̯tiː
glasach	ɡlasaχ
arllwys	arɬʊs
mhrydain	m̥rədɛn
llamhidog	ɬamhɪdɔɡ
peiriant arian	pei̯rjantarjan
gwreiddiol	ɡwrei̯ðjɔl
cyfenw	kəveːnu
goeg	ɡɔi̯ɡ
anghofio	aŋhɔvjɔ
arolygwyr	arɔləɡwɪr
rhanbarth	r̥anbarθ
creto	krɛtɔ
chot	χɔt
athematig	aθɛmatɪɡ
gymedrolwyr	ɡəmɛdrɔlwɪr
mhopty	m̥ɔpti
cnau cyll	knai̯kɪɬ
gnwd	ɡnuːd
peniadau	pɛnjaːdɛ
uchelwydd	ɪχɛlwɪð
ogof	oːɡɔv
gweddïo	ɡwɛðiɔ
ffôn symudol	foːnsəmiːdɔl
gwawl	ɡwau̯l
wŷn	wiːn
arwerthwr	arwɛrθʊr
switsh	swɪt͡ʃ
lleiandy	ɬei̯andi
diolch yn fawr iawn	djɔlχənvau̯rjau̯n
soddi	sɔði
medro	mɛdrɔ
bara	bara
gerllaw	ɡɛrɬau̯
gariad	ɡarjad
macydelgi	makədɛlɡi
punt	pɪnt
paent	pai̯nt
degan	deːɡan
nenmarc	nɛnmark
ceg	keːɡ
cilydd	kɪlɪð
ffôn	foːn
chwedl	χweːdɛl
hachosi	haχɔsi
ata	ata
oedolyn	ɔi̯doːlɪn
ceni	keːni
weithio	wiːθɔ
llithro	ɬɪθrɔ
cantor	kantɔr
aredaf	arɛda
ailfeddiannu	ai̯lvɛðjani
elsit	ɛlsɪt
fodd	voːð
ewythr	ɛu̯ɪθr
addas	aːðas
hirsgwar	hɪrsɡwar
wedyn	weːdɪn
datgelu	datɡɛli
gwrthwynebiadau	ɡʊrθwɪnɛbjadai̯
taflen	tavlɛn
i	iːdɔt
goludog	ɡɔlɪdɔɡ
gweddïon	ɡwɛðiːɔn
hanes	hanɛs
tyndra	təndra
cadair	kaːdai̯r
twymo	tʊi̯mɔ
glosen	ɡlɔsɛn
cymhlethu	kəmhlɛθi
picau bach	pɪkai̯baːχ
gêm	ɡeːm
cachet	kaːχɛt
gelen	ɡeːlɛn
clywedog	kləu̯eːdɔɡ
gae	ɡaː
cristnogaeth	krɪsdnoːɡai̯θ
cyrhaeddwn	kərhai̯ðʊn
gefnau	ɡɛvnɛ
deall	diːaɬ
canmolwr	kanmoːlʊr
chrwth	χruːθ
adlam	adlam
aredaf	areːdav
chodi	χoːdi
niwlog	nɪu̯lɔɡ
crynu	krəni
afanc	avaŋk
garai	ɡarai̯
coeg	kɔi̯ɡ
neuaddau	nei̯aːðɛ
broga	brɔɡa
elyn	ɛlɪn
llosgfaen	ɬɔsɡvai̯n
regen	reːɡɛn
allweddell	aɬweːðɛɬ
caffai	kafai̯
cefnau	kɛvnɛ
cennad	kɛnad
caeredin	kai̯rɛdɪn
abl	abal
darlithydd	darlɪθɪð
lluwch	ɬɪu̯χ
dalen	daːlɛn
adroddaf	adroːða
ngwenoliaid	ŋwɛnɔljai̯d
galwad	ɡalwad
chwilio	wɪljɔ
rhwystredig	r̥ʊi̯sdreːdɪɡ
cryched	krəχɛd
cyllell	kɪɬɛɬ
unais	ɪnɛs
llafariad	ɬavarjad
go iawn	ɡɔjau̯n
lanc	laŋk
llyfr	ɬɪvr
gaeaf	ɡei̯av
gacha	ɡaχa
gweision	ɡwei̯sjɔn
hoed	hoːd
fenig	vɛnɪɡ
feddwl	veːðʊl
croesholi	krɔi̯shoːli
cwympo	kʊmpɔ
pharod	faːrɔd
anogaf	anɔɡa
pori	poːri
chwefror	χwɛvrɔr
gwelwch	ɡwɛlʊχ
berfau annherfynol	bɛrvai̯anhɛrvənɔl
ngwybod	ŋwɪbɔd
nghestyll	ŋ̊ɛsdɪɬ
sut	ʃʊd
nhro	n̥roː
seintiau	sei̯ntjai̯
nalen	nalɛn
can	kan
ngoleuadau	ŋɔlei̯aːdɛ
tharianau	θarjanɛ
mynaich	mənai̯χ
bugail	biːɡai̯l
ydw	ɔdu
decaf	dɛkav
chaffed	χafɛd
argraffiadaeth	arɡrafjaːdai̯θ
chelyn	χeːlɪn
lwybr	lʊi̯bɪr
cerais	kɛrai̯s
picau ar y maen	pɪkɛarəmai̯n
chusanau	χɪsaːnai̯
gwddwg	ɡʊðʊɡ
gwalch y nos	ɡwalχənoːs
ystafell	sdaːvɛɬ
achosaf	aχɔsav
trawant	trau̯ant
llurs	ɬɪrs
deisen	dei̯ʃɛn
deugain	dei̯ɡɛn
macamwn	makamʊn
nghyfarfod	ŋ̊warvɔd
fwy	vʊi̯
cofnodion	kɔvnɔdjɔn
brad	braːd
weddïo	wɛðiːɔ
yfory	voːri
gogleddol	ɡɔɡlɛðɔl
siwgr	ʃʊɡr
wael	wai̯l
plwm	plʊm
olifs	ɔlɪvz
mwgwd	muːɡʊd
unen	ɪnɛn
cacennau cri	kakɛnɛkriː
cymaint	kəmai̯nt
eirth	ei̯rθ
iet	jɛt
elent	eːlɛnt
torra	tɔra
llefarydd	ɬɛvaːrɪð
cafodd	kaːvɔð
ynys	ənɪs
arfeddog	arvɛðɔɡ
cledd	kleːð
go	ɡoː
phopty	fɔpti
rheiddiadur	r̥ei̯ðjaːdɪr
nhafarn	n̥avarn
nghael	ŋ̊ai̯l
nghwrs	ŋ̊ʊrs
gŵyll	ɡʊi̯ɬ
garais	ɡaːrai̯s
doeddech	dɔi̯ðɛχ
pabell	paːbɛɬ
medran	mɛdran
ganes	ɡanɛs
rhwystrau	r̥ʊi̯sdrɛ
tafodiaith	tavɔdjɛθ
sgil	sɡɪl
cystal	kɪsdɛl
galluogi	ɡaɬioːɡi
rwyt	rʊi̯t
thal	θal
picau ar y maen	pɪkai̯arəmai̯n
tenau	tɛnai̯
cymraeg	kəmrai̯ɡ
organig	ɔrɡanɪɡ
stori	sdoːri
allforwyr	aɬvɔrwɪr
nos sadwrn	noːssadʊn
abadesau	abadɛsɛ
fether	vɛθɛr
cen y cerrig	kɛnəkɛrɪɡ
mochyn coed	moːχɪnkɔi̯d
tradwy	tradʊi̯
switsio	swɪtʃɔ
gyrgoed	ɡɪrɡɔi̯d
acen grom	akɛnɡrɔm
bŵt	buːt
iddewesau	ɪðɛu̯ɛsɛ
cnawd	knau̯d
aeaf	ei̯a
nigon	nɪɡɔn
hirsgwarau	hɪrsɡwarɛ
cyfateb	kəvatɛb
bwrw hen wragedd â ffyn	buːruheːnwraːɡɛðafɪn
gaffent	ɡafɛnt
cyrch	kɪrχ
eirinen wlanog	ei̯rɪnɛŋwlanɔɡ
troan	troːan
technoleg gwybodaeth	tɛχnɔlɛɡɡʊi̯bɔdɛθ
fyned	vənɛd
randibŵ	randɪbuː
terydr	teːrɪdr
toesen	tɔi̯sɛn
grym	ɡrɪm
âl	aːl
dilyn	dɪlɪn
meddiannu	mɛðjani
bathdai	baθdai̯
achubol	aχɪbɔl
blwyddyn golau	blʊi̯ðɪnɡɔlai̯
atal	atal
pendrist	pɛndrɪsd
cwrdd	kʊrð
delom	dɛlɔm
biolegydd	bjɔlɛɡɪð
ngwiwer	ŋwɪu̯ɛr
croeso	krɔi̯sɔ
academyddion	akadɛməðjɔn
digalon	dɪɡalɔn
flynedd	vlənɛð
mab	maːb
seler	sɛlɛr
baith	bai̯θ
gwrthryfeloedd	ɡʊrθrəveːlɔi̯ð
macymwn	makəmʊn
ffwrn	fʊrn
genedigaeth	ɡɛnɛdɪɡai̯θ
deunyddiau	dei̯nəðjai̯
cyhyd	kəhɪd
caerlŷr	kai̯rliːr
bendithio	bɛndɪθjɔ
abad	abad
nosloyw	noːslɔi̯u
abad	aːbad
defnydd	dɛvnɪð
dalcen	dalkɛn
chwaer	χwai̯r
cato	katɔ
aberafan	abɛravan
ngwddf	ŋʊðu
afu	avi
gara	ɡara
corhwyad	kɔrhʊi̯ad
ymlaen	əmlai̯n
plastig	plasdɪɡ
pibgorn	pɪbɡɔrn
llyfu	ɬəvi
dyryslwyn	dərəslʊi̯n
babell	baːbɛɬ
rhithweledigaeth	r̥ɪθwɛlɛdiːɡai̯θ
cyffyloca	kəfəlɔka
anoddaf	anoːða
trafferthu	trafɛrθi
llamidyddion	ɬamɪdəðjɔn
chwilio	wɪlɔ
enillwyr	ɛnɪɬwɪr
arolygu	arɔləɡi
arholi	arhɔli
gani	ɡani
dal	dal
lledr	ɬɛdɛr
abladol	abladɔl
delit	dɛlɪt
pigau	pɪɡai̯
drws	druːs
rhufeiniwr	r̥ɪvei̯njʊr
gwers	ɡwɛrs
cyngerdd	kəŋɛrð
rech	reːχ
gwlanog	ɡwlanɔɡ
flodau	vlɔdai̯
technoleg gwybodaeth	tɛχnoːlɛɡɡwɪboːdai̯θ
leidr	lei̯dɪr
lladron	ɬadrɔn
ddolis	ðɔliz
dyddiadau	dəðjadai̯
carest	karɛsd
anghyflogaeth	aŋhəvloːɡɛθ
rhanddeiliaid	r̥anðei̯ljai̯d
anableddau	anableːðɛ
aberteifi	abɛrtei̯vi
dosbarthol	dɔsbarθɔl
cynnau	kɪni
amheuaeth	amhei̯ai̯θ
adenedigaeth	adɛnɛdɪɡai̯θ
hwch	huːχ
clefyd y gwair	klɛvɪdəɡwai̯r
hen galan	heːnɡalan
rhegfeydd	r̥ɛɡvei̯ð
rhyngrwyd pethau	r̥əŋrʊi̯dpɛθai̯
rhent	r̥ɛnt
caredig	karɛdɪɡ
crychion	krəχjɔn
agoret	aɡɔrɛt
deusaith	dei̯sai̯θ
syllu	səɬi
christ	χrɪst
unioni	ɪnjoːni
lundain	lɪndai̯n
dur	diːr
eisiau	iːsɛ
wylo	ʊi̯lɔ
ngwiwerod	ŋwɪu̯eːrɔd
golau	ɡɔlɛ
ysgawen	əsɡau̯ɛn
terfyniad	tɛrvənjad
arddangosfa	arðaŋɡɔsva
gusanu	ɡɪsaːni
crychydd	krəχɪð
brenhines	brɛnhiːnɛs
thrwyddedau	θrʊi̯ðeːdai̯
cacennau cri	kakɛnai̯kriː
dydd sadwrn	dɪsaːdʊn
chyfnither	χəvnɪθɛr
arbedaf	arbeːda
cudyn	kiːdɪn
iddo	ɪðɔ
mrecwast	mrɛkwast
ffôn clyfar	foːnkləvar
atborthion	atbɔrθjɔn
ewinfedd	ɛu̯ɪnvɛð
hogan	hɔɡan
rheoliad	r̥ɛɔljad
chut	χɪt
pedair	pɛdai̯r
nghefn	ŋ̊eːvɛn
u	iːɡʊpan
rheolaidd	r̥ɛɔlai̯ð
trenau	trɛnɛ
chroes	χrɔi̯s
brodyr	brɔdɪr
nwfr	nʊvr
leicio	lɪkjɔ
tre	treː
crych	kriːχ
credent	kreːdɛnt
sgrechian	sɡrɛχjan
leicio	lei̯kjɔ
erioed	ɛrjoːd
toc	tɔk
bocsio	bɔksjɔ
yn gwmws	əŋɡʊmʊs
h	ai̯tʃ
addurno	aðɪrnɔ
aderyn	dɛrɪn
cytseiniaid	kətsei̯njai̯d
arwerthiant	arwɛrθjant
gelai	ɡɛlɛ
cyrraedd	kərai̯ð
dillad	dɪɬad
ffa	faː
llynedd	ɬənɛð
ac	ak
sefyllfa	sɛvəɬva
söolegwyr	soːɔlɛɡwɪr
alaw	alau̯
ddigon	ðiːɡɔn
dichon	dɪχɔn
eiddew	ei̯ðɛu̯
nos sadwrn	nɔssaːdʊrn
abl	abl
iddyn	ɪðɪn
hwynt	hʊi̯nt
angladdau	aŋlaːðai̯
sodlau	sɔdlɛ
sychu	səχi
cyflafareddu	kəvlavareːði
bws	bʊs
dydd llun	dɪɬiːn
llyfrgell genedlaethol cymru	ɬəvrɡɛɬɡɛnɛdlei̯θɔlkəmri
angheuol	aŋhei̯ɔl
hamser	hamsɛr
habad	haːbad
traethodau	trei̯θoːdai̯
hunain	hiːnɛn
sy	siː
chwech	weːχ
bri	briː
cydgordio	kɪdɡɔrdjɔ
mamau	mamɛ
catholigiaeth	kaθɔlɪɡjai̯θ
gwallus	ɡwaɬɪs
arolygiaethau	arɔləɡjei̯θɛ
thafarnwr	θavarnʊr
galwyn	ɡaːlʊi̯n
abadaeth	abadai̯θ
cymysg	kəmɪsɡ
bual	bial
genedigaethau	ɡɛnɛdɪɡei̯θai̯
ymadael	əmadɛl
ngwybodaeth	ŋwəboːdɛθ
dychryniadau	dəχrənjaːdai̯
ngwlad belg	ŋwlaːdbɛlɡ
mhaned	m̥aːnɛd
arolygiadau	arɔləɡjadai̯
helbulon	hɛlbiːlɔn
flodau	vlɔdɛ
ngeiriadurwr	ŋei̯rjadiːrʊr
babis	baːbiz
mynachaidd	mənaːχɛð
hy	hiː
canolwr	kanɔlʊr
gwyno	ɡʊi̯nɔ
teimlad	tɪmlad
aethech	ei̯θɛχ
nghnau cyll	ŋ̊nai̯kɪɬ
nghaleted	ŋ̊alɛtɛd
ulyfai	ɪləvai̯
frawd	vrau̯d
pwll nofio	puːɬnɔvjɔ
darlledu	darɬeːdi
maen	mai̯n
rhaglenni	r̥aɡlɛni
bythynnod	bəθənɔd
bawdd	bau̯ð
pibonwy	pɪboːnui̯
huan	hian
cic gosb	kɪkɡɔsb
athrod	aθrɔd
rhegi	r̥ɛɡi
elo	ɛlɔ
gwyddor	ɡʊi̯ðɔr
swm	sʊm
conwydd	koːnʊi̯ð
twll	tʊɬ
casét	kasɛt
nghneuen ffrengig	ŋ̊nei̯ɛnfrɛŋɪɡ
thrannoeth	θranɔi̯θ
mygydau	məɡədɛ
dywyll	dəu̯ɪɬ
gafael	ɡaːvɛl
gweithredu	ɡwei̯θreːdi
gwagedd	ɡwaɡɛð
chymedrolwyr	χəmɛdrɔlwɪr
mis	miːʃ
bum	bɪm
coelio	kɔi̯ljɔ
treisiwr	trei̯ʃʊr
nudden	niːðɛn
deilen	dei̯lɛn
cyfraith	kəvrɛθ
doi	dɔi̯
peintiau	pei̯ntjai̯
gwrthryfelwr	ɡʊrθrəveːlʊr
chanes	χaːnɛs
sgerbwd	sɡɛrbʊd
thaw	θau̯
ynddo	ənðɔ
stryd	sdriːd
gad	ɡaːd
sillafu	sɪɬaːvi
teipiadur	tei̯paːdɪr
telir	tɛlɪr
codau	koːdɛ
pysgodyn	pəsɡoːdɪn
ddolur	ðoːlɪr
torso	tɔrsɔ
mêts	meːts
hydref	hədrɛ
ad	aːd
rhwyfau	r̥ʊi̯vɛ
las	laːs
heglwys	hɛɡlʊs
cystadlu	kəsdadli
harian	harjan
cotiau	kɔtɛ
pen	pɛn
gornestwr	ɡɔrnɛsdʊr
malwota	malwɔta
paffio	pafjɔ
morwennol	moːrwɛnɔl
afalau cariad	avalɛkarjad
abadau	abaːdɛ
troi	trɔi̯
gallan	ɡaɬan
thyrrau	θərai̯
seliau	sɛljɛ
caernarfon	kairnarvɔn
maharen	maharɛn
adborthion	adbɔrθjɔn
morio	mɔrjɔ
anghlod	aŋhlɔd
hwpo	ʊpɔ
côr	koːr
peniadau	pɛnjadɛ
rhwystrau	r̥ʊi̯sdrai̯
chwympo	χʊmpɔ
chae	χaː
ameba	ameːba
cenhedlu	kɛnhɛdli
paffiwr	pafjʊr
tâl	taːl
aberth	abɛrθ
pedolau	pɛdoːlɛ
esgobion	ɛsɡɔbjɔn
llysiau	ɬəʃɛ
diwydiant	dɪu̯ɪdjant
tala	taːla
llygod	ɬəɡɔd
henw	heːnu
diwrnod	dwərnɔd
aberthu	abɛrθi
ngeni	ŋeːni
caches	kaχɛs
galla	ɡaɬa
nos wener	nɔsweːnɛr
clefyd y galon	klɛvɪdəɡalɔn
crwn	krʊn
lygod	ləɡɔd
rhwystredig	r̥ʊi̯sdrɛdɪɡ
angladdau	aŋlaːðɛ
ngherdded	ŋ̊ɛrðɛd
tri ar ddeg	triːarðeːɡ
nos sul	noːssiːl
olau	oːlɛ
chanlyniad	χanlənjad
heraill	heːrɪɬ
theirw	θei̯ru
lech	leːχ
nghaeredin	ŋ̊ai̯rɛdɪn
ellyn	ɛɬɪn
glas	ɡlaːs
carneddi	karneːði
thwrci	θʊrki
tacluso	taklɪsɔ
absennu	absɛni
annwyl	anʊi̯l
troseddu	trɔseːði
cnau ffrengig	knai̯frɛŋɪɡ
gyfarfod	ɡəvarvɔd
chwannog	χwanɔɡ
tudalen we	tɪdaːlɛnweː
clown	klɔu̯n
ffindir	əfɪndɪr
ffrancwyr	fraŋkwɪr
nhalent	n̥alɛnt
elwyf	ɛlʊi̯v
deirw	dei̯ru
ceiliog	kiːlɔɡ
wy	wiː
deri	deːri
tudalennau gwe	tɪdalɛnai̯ɡweː
gwrthryfel	ɡʊrθrəvɛl
cytref	kətrɛv
carafáns	karavanz
yfed	əvɛd
adeiladwaith	adei̯ladwai̯θ
hil	hiːl
chylchgrawn	χɪlχɡrau̯n
elir	ɛlɪr
gwch	ɡʊχ
affwysedd	afʊi̯sɛð
rhwystredigaeth	r̥ʊi̯sdrɛdɪɡai̯θ
caerau	kei̯rai̯
deulu	dei̯li
gwisgo	ɡwɪsɡɔ
ferch	vɛrχ
garo	ɡarɔ
diobaith	dioːbai̯θ
smygu	sməɡi
pant	pant
mhethau	m̥ɛθai̯
letysen	lɛtəsɛn
sgiwen	sɡiu̯ɛn
nhadau	n̥adai̯
gwahân	ɡwahaːn
helyg	heːlɪɡ
rhyngrwyd y pethau	r̥əŋrʊi̯dəpeːθɛ
llwnc	ɬʊŋk
sil	siːl
bodd	boːð
gwrthryfeloedd	ɡʊrθrəvɛlɔi̯ð
cwestiynau	kwɛsdənɛ
ngwain	ŋwai̯n
anffodus	anfɔdɪs
coed afalau	koːdavalɛ
caf	kaː
aeronen	ei̯rɔnɛn
gyda	ɡəda
cynaeafu	kniavi
caffer	kafɛr
rhisgl	r̥ɪʃɡɪl
gadael	ɡadai̯l
cyflogaeth	kəvloːɡɛθ
nos fawrth	nɔsvau̯rθ
phapur	fapɪr
tafarnwr	tavarnʊr
annedd	anɛð
choeg	χɔi̯ɡ
toes	tɔi̯s
coffi	kɔfi
arwerthiannau	arwɛrθjanɛ
ehedydd	ɛheːdɪð
cusanau	kɪsanɛ
ydau	ədɛ
gwyach	ɡʊi̯aχ
cloch	kloːχ
rygbi	rəɡbi
dof	doːv
hymenyn	həmeːnɪn
wain	wai̯n
cryndod	krəndɔd
habadaeth	habadai̯θ
dechrau	dəχrɛ
glefyd	ɡleːvɪd
haros	haːrɔs
ddarlunio	ðarlɪnjɔ
rhagenw	r̥aɡɛnu
arall	aːraɬ
pabyddol	pabəðɔl
adroddaf	adrɔðav
mharod	m̥arɔd
canmolwr	kanmɔlʊr
hwy	hʊi̯
carnedd	karnɛð
adaryddiaeth	adarəðjɛθ
gwario	ɡwarjɔ
adwthio	adʊθjɔ
carem	kaːrɛm
adeg	adɛɡ
latfia	latvja
lanaf	laːna
rwmania	rʊmanja
ngweddi'r arglwydd	ŋweːðirarɡlui̯ð
meddu	mɛði
chwe	weː
tu	tiː
phasta	fasda
padell	paːdɛɬ
ofyn	oːvɪn
moch coed	moːχkɔi̯d
nhrwyddedau	n̥rʊi̯ðɛdai̯
thâl	θaːl
cofiem	kɔvjɛm
adferf	advɛrv
leician	lei̯kjan
dynleiddiad	diːnlei̯ðjad
adweithegydd	adwei̯θeːɡɪð
nos sadwrn	nɔssadʊn
lindysyn	lɪndəsɪn
ymyl	əmɪl
mên	meːn
elai	ɛlɛ
nhyrrau	n̥ərɛ
athrodwr	aθroːdʊr
moch	moːχ
gelet	ɡeːlɛt
heuldro'r haf	hei̯ldrɔrhaːv
croestorri	krɔi̯sdɔri
nos sul	nɔsiːl
garem	ɡaːrɛm
gwyddion	ɡwəðjɔn
chwech ar hugain	hweːχarhiːɡɛn
syndodau	səndoːdɛ
chloan	χloːan
heuliog	hei̯ljɔɡ
mynyddoedd	mənəðɛ
cyfnither	kəvnɪθɛr
taeog	tei̯ɔɡ
canghellor	kaŋhɛɬɔr
gafr	ɡaːvar
lanach	laːnaχ
mlwyddi	mlʊi̯ði
blwch	bluːχ
nhaliadau	n̥aljadai̯
mynachlog	mənaχlɔɡ
bocsiwr	bɔksjʊr
etholiad	ɛθɔljad
nhe	n̥eː
gwyfyn	ɡwəvɪn
cyffylog	kəfəlɔɡ
gleision	ɡlei̯ʃɔn
morwennol	mɔrwɛnɔl
wedi hyn	weːdihɪn
chodi	χɔdi
adferiadau	advɛrjaːdɛ
dân	daːn
lleianaeth	ɬei̯anɛθ
ngwybodaeth	ŋwɪboːdai̯θ
naw ar hugain	nau̯arhɪɡɛn
bandiau	bandjɛ
gystadlu	ɡəsdadli
ffyn	fɪn
ceiliog	kei̯ljɔɡ
weriniaethau	ɡwɛrɪnjei̯θɛ
chwyrnu	hʊrni
cledr	klɛdɛr
genedigaethau	ɡɛnɛdɪɡei̯θɛ
ngafr	ŋavar
deiliadaeth	dei̯ljadai̯θ
posibil	pɔsɪbɪl
aberthged	abɛrθɡɛd
pŵer	puɛr
tafwys	tavʊi̯s
mlwyddyn	mlʊi̯ðɪn
ffurfiol	fɪrvjɔl
epidemig	ɛpɪdɛmɪɡ
llus	ɬiːs
hoed	hɔi̯d
ricriwtiaid	rɪkrɪu̯tjɛd
ffraeo	frei̯ɔ
hystafell	həsdavɛɬ
clau	klai̯
dysgu	dəsɡi
torsen	tɔrsɛn
ymddiddan	əmðɪðan
wystl	ʊi̯sdɪl
y tu ôl i	tjoːli
colfen	kɔlvɛn
cyfrifiant	kəvrɪvjant
haethnenni	hei̯θnɛni
dysgwr	dəsɡʊr
hugain	hiːɡai̯n
pannas	panas
sgrechian	sɡreːχan
rhaeadr	r̥ei̯adr
tiroedd	tiːrɔð
ffair	fai̯r
gyda hyn	ɡədahɪn
academaidd	akadɛmɛð
aethai	ei̯θai̯
sylffwr	səlfʊr
cen	kɛn
ocr	ɔkr
technoleg gwybodaeth	tɛχnɔlɛɡɡwəbɔdɛθ
pandemigau	pandɛmiːɡɛ
teimlo	tei̯mlɔ
rybela	rəbɛla
gweithiwr	ɡwei̯θʊr
gwenyn	ɡwɛnɪn
gachais	ɡaχɛs
mrenin	mrɛnɪn
nghyfnither	ŋ̊əvnɪθɛr
cala	kala
wella	wɛɬa
teulu brenhinol	tiːlibrɛnhiːnɔl
cyfathrach	kəvaθraχ
isteitlo	iːsdei̯tlɔ
goludog	ɡɔliːdɔɡ
darw	daru
animeiddiadau	anɪmei̯ðjjaːdai̯
pheiriannwr	fei̯rjanʊr
moel	mɔi̯l
hefin	hɛvɪn
buddugwr	bɪðɪɡʊr
adferiadau	advɛrjadai̯
meddw	mɛðu
rhestri	r̥ɛsdri
lechi	lɛχi
bwytadwy	bʊi̯taːdʊi̯
mislifol	mɪslɪvɔl
lysenw	lɪsɛnu
ganwr	ɡanʊr
dalen	dalɛn
chared	χaːrɛd
caret	kaːrɛt
addef	aðɛv
unigrywiaeth	ɪnɪɡrɪu̯jai̯θ
gae	ɡai̯
cymylu	kəməli
ci	kiː
enghraifft	ɛŋ̊rɛfd
elech	ɛlɛχ
goleuni	ɡɔlei̯ni
anghyseinedd	aŋhəsei̯nɛð
tyrru	təri
abwyd	aːbʊi̯d
nghythraul	ŋ̊əθrɛl
act	akt
celynna	kɛləna
eisoes	iːʃʊs
gwlychu	ɡwləχi
mewnforyn	mɛu̯nvoːrɪn
sgrechian	sɡrɛχɛn
galan	ɡalan
panasen	panasɛn
gofyn	ɡoːvɪn
gylfinirod	ɡəlvɪnɪrɔd
cŷn	kiːn
cynghrair	kəŋr̥ai̯r
wddwg	ʊðʊɡ
rhwyllau	r̥ʊi̯ɬai̯
gwyched	ɡwəχɛd
ofer	oːvɛr
cyflogaeth	kəvloːɡai̯θ
blanced	blaŋkɛd
cwningen	kʊnɪŋɛn
cyfnod	kəvnɔd
roeddwn	rɔi̯ðʊn
adenedigaeth	adɛnɛdɪɡɛθ
haden	hadɛn
elsem	ɛlsɛm
gwybodaeth	ɡwɪboːdai̯θ
aethont	ei̯θɔnt
copog	kɔpɔɡ
thrydanwr	θrədaːnʊr
nghi	ŋ̊iː
gwobrwyon	ɡwɔbrʊi̯ɔn
egluro	ɛɡliːrɔ
mathau	maθɛ
ddelw	ðeːlu
aromatherapydd	arɔmaθɛrapɪð
ymladdwyr	əmlaðwɪr
alar	aːlar
man	man
chwympo	χwɪmpɔ
ferfenw	vɛrvɛnu
nos sul	nɔssiːl
gastell	ɡasdɛɬ
gosteg	ɡɔsdɛɡ
uno	iːnɔ
selerau	sɛlɛrai̯
clefyd y gwair	kleːvɪdəɡwai̯r
afalau	avaːlɛ
llinell	ɬiːnɛɬ
chwern	hwɛrn
barnu	barni
llwythi	ɬʊi̯θi
unig	iːnɪɡ
eisoes	ɪʃʊs
nghyfiawnder	ŋ̊əvjau̯ndɛr
dŷ	diː
allor	aɬɔr
eboles	ɛbɔlɛs
nghynnwrf	ŋ̊ənʊrv
goleuadau	ɡɔliaːdɛ
delynores	dɛlənɔrɛs
thrydanwr	θrədanʊr
pethach	peːθaχ
pigwrn	pɪɡʊrn
nid wrth ei big y mae prynu cyffylog	nɪdʊrθibiːɡəmaprənikəfəlɔɡ
ricriwtiaid	rɪkrɪu̯tjai̯d
tywodfaen gwyrdd	təu̯ɔdθvai̯nɡwɪrð
rhychau	r̥əχai̯
gylchgrawn	ɡɪlχɡrau̯n
paid	pai̯d
caiff	kai̯f
deuddeg	dei̯ðɛɡ
ecogyfeillgar	ɛkɔɡəvei̯ɬɡar
peidio	piːdɔ
cyntefin	kənteːvɪn
segur	sɛɡɪr
iolo	jɔlɔ
e	eː
blynyddoedd golau	blənəðɔi̯ðɡɔlɛ
egwyl	ɛɡʊl
dyrysfeydd	dərəsvei̯ð
berwi	bɛrwi
hiliaeth	hɪljai̯θ
gwrthryfelgar	ɡʊrθrəvɛlɡar
nghaffi	ŋ̊afi
shrwmsa	ʃrʊmsa
ngwybod	ŋuːbɔd
bur	biːr
digwyddaf	dɪɡwəðaf
llywelyn	ɬəu̯eːlɪn
lanhau	lanhai̯
corcyn	kɔrkɪn
neges	nɛɡɛs
goddrychol	ɡɔðrəχɔl
gwahodd	ɡwahɔð
ynglŷn â	əŋliːna
bocsiwr	bɔkʃʊr
ymlâdd	əmlaːð
caint	kai̯nt
fuan	vian
terfynu	tɛrvəni
elyn	eːlɪn
gyrraedd	ɡərað
ymdopi	əmdɔpi
gana	ɡaːna
adroddiad	adrɔðjad
ngwddf	ŋuːðu
hafod	haːvɔd
achlysurol	aχləsiːrɔl
ngwddf	ŋuːðuv
picau	pɪkai̯
adfeilio	advei̯ljɔ
fflŵr	fluːr
gwanwynau	ɡwanwənai̯
gwych	ɡwiːχ
denu	dɛni
glanach	ɡlanaχ
buddugol	bɪðiːɡɔl
cyfweld	kəvwɛld
pechod	pɛχɔd
dorrai	dɔrɛ
alban eilir	albanei̯lɪr
echlysur	ɛχləsɪr
goleuo	ɡɔlei̯ɔ
lawio	lau̯jɔ
barod	barɔd
aren	aːrɛn
pleidiol	plei̯djɔl
mynych	mənɪχ
pa	paː
macadelgi	makadɛlɡi
amddiffynnaf	amðɪfənav
hydrefau	hədrɛvai̯
ddim	ðɪm
feirysau	vei̯rəsɛ
brwyn	brʊi̯n
gweddïo	ɡwɛðiːɔ
thraed	θrai̯d
thyrrau	θərɛ
elin	eːlɪn
greda	ɡreːda
cachan	kaχan
pesychu	pɛsəχi
olwyn	ɔlwɪn
gwystl	ɡʊi̯sdl
fedi	vɛdi
trwyn	trʊi̯n
uned	ɪnɛd
adferant	adveːrant
cloan	kloːan
chylchgrawn	χəlχɡrau̯n
tegan meddal	teːɡanmeːðal
catholig	kaθoːlɪɡ
dolur	dɔlɪr
glasgoch	ɡlasɡɔχ
mri	mriː
cnud	kniːd
marnau	marnɛ
hifanc	hiːvaŋk
disgwyl	dɪsɡʊi̯l
chenhinen	χɛnhiːnɛn
chneuen	χnei̯ɛn
mron	mrɔn
erchi	ɛrχi
terfysgaidd	tɛrvəsɡai̯ð
sgert	sɡɛrt
swyn	sʊi̯n
gawl	ɡau̯l
welydd	wɛlɪð
ymhlith	əmhliːθ
mochyn coed	mɔχɪnkɔi̯d
caledu	kalɛdi
nos sadwrn	noːssadʊrn
lwybr	lʊi̯br
trigain	triːɡai̯n
unigryw	ɪnɪɡrɪu̯
tadau	tadɛ
bryngaer	brəŋɡai̯r
corn	kɔrn
mamoth gwlanog	mamɔθɡwlanɔɡ
gwerddonau	ɡwɛrðɔnɛ
cwestiynau	kwɛsdjənɛ
posteri	pɔsdɛri
choed	χɔi̯d
defnyddiau	dɛvnəðjɛ
gwybodaeth	ɡwɪbɔdɛθ
cigfran	kɪɡvran
dyngarol	dəŋɡarɔl
faet	vai̯t
tenantiaid	tɛnantjɛd
tiroedd	tɪrɔð
gadael	ɡaːdɛl
dagrau	daɡrai̯
arosfeydd	arɔsvei̯ð
chyfreithiwr	χəvrei̯θjʊr
garanod	ɡaranɔd
ffensiau	fɛnʃai̯
iaith	jai̯θ
tebyg	teːbɪɡ
dannoedd	danɔi̯ð
tebyg	tɛbɪɡ
marchog	marχɔɡ
nos sadwrn	nɔssaːdʊn
canolwyr	kanɔlwɪr
siarad	ʃarad
pic ar y maen	pɪkarəmai̯n
mlodau	mloːdai̯
gwenwyn	ɡwɛnwɪn
hyll	hɪɬ
arllwysaf	arɬʊi̯sav
heulwen	hei̯lwɛn
teyrnas	tei̯rnas
cala	kaːla
medra	mɛdra
arfau	arvai̯
eboles	ɛboːlɛs
methi	mɛθi
theigrod	θei̯ɡrɔd
caerliwelydd	kai̯rlɪu̯eːlɪð
diogel	djɔɡɛl
cyfarthiadau	kəvarθjaːdɛ
adferiad	advɛrjad
dynleiddiaid	diːnlei̯ðjɛd
pobl	poːbɔl
bleiddiau	blei̯ðjai̯
halibalŵ	halɪbaluː
theledu	θɛleːdi
cytseiniaid	kətsei̯njɛd
hynafol	hənaːvɔl
gwinoedd	ɡwiːnɔi̯ð
poblog	pɔblɔɡ
dod	doːd
chymylog	χəməlɔɡ
taen	tai̯n
phencampwr	fɛŋkampʊr
el	ɛl
gwledig	ɡwleːdɪɡ
gwybed	ɡwəbɛd
llaid	ɬai̯d
gwahaniaethu	ɡwanjei̯θi
gwerinwyr	ɡwɛrɪnwɪr
byliau	bəljai̯
iawn	jau̯n
ngwahanol	ŋwahaːnɔl
ffonio	fɔnjɔ
clof	kloːv
llydaw	ɬədau̯
chwythu	hʊθi
cadw	kadu
blasus	blaːsɪs
tanau gwyllt	taːnɛɡwɪɬd
caersallog	kai̯rsaɬɔɡ
alla	aɬa
nghanwr	ŋ̊aːnʊr
cneuen ffrengig	knei̯ɛnfrɛŋɪɡ
gylfinau	ɡəlviːnɛ
adfywiadau	advɪu̯jaːdai̯
garafán	ɡaravan
arna	arna
lludw	ɬɪdu
ddannoedd	ðanɔi̯ð
adleisio	adlei̯sjɔ
wario	warjɔ
anawsterau	anau̯sdɛrai̯
adeiladweithiau	adei̯ladwei̯θjai̯
torrai	tɔrɛ
pencampwriaeth	pɛŋkampʊrjɛθ
lanaf	lana
ceidw	kei̯du
arolygiad	arɔləɡjad
nico	nɪkɔ
magnelwr	maɡneːlʊr
ddechrau	ðaχrɛ
enfyn	ɛnvɪn
nghrist	ŋ̊rɪst
thalai	θalai̯
llyf gen	ɬəvɡɛn
copii	kɔpiːi
talwn	talʊn
rhian	r̥ian
fflapjac	flapdʒak
addurn	aðɪrn
ngadael	ŋaːdɛl
achwyn	aχʊi̯n
ffrancwr	fraŋkʊr
ynys môn	ənɪsmoːn
mhengwiniaid	m̥ɛŋɡwɪnjai̯d
heuldro'r gaeaf	hei̯ldrɔrɡei̯av
gân	ɡaːn
gog	ɡoːɡ
dadleuon	dadlei̯ɔn
taeru	tiːri
dadl	dadl
ddigon	ðɪɡɔn
eistedd	ɪʃdɛ
garw	ɡaru
agori	aɡoːri
canhwyllau	kanhʊi̯ɬai̯
arswydau	arsʊi̯dɛ
carom	karɔm
neithiwyr	nei̯θjʊi̯r
uniawn	ɪnjau̯n
gusanu	ɡɪsani
fyrdd	vɪrð
athrefig	aθreːvɪɡ
wybr	ʊi̯br
hagor	haɡɔr
mhunt	m̥ɪnt
dydd gwener	dɪðɡwɛnɛr
pob	poːb
cyfarch	kəvarχ
bys troed	biːstrɔi̯d
cobra	kɔbra
cyfryngiadau	kəvrəŋjaːdɛ
geifr	ɡei̯vr
cloc	klɔk
bwytadwy	bʊi̯tadʊi̯
thawel	θau̯ɛl
throi	θrɔi̯
teisennau	tɪsɛnɛ
hydrefau	hədreːvɛ
unig	ɪnɪɡ
nghusanau	ŋ̊ɪsanɛ
rheolau	r̥ɛoːlai̯
rhinart	r̥iːnart
parod	paːrɔd
beidr	bei̯dr
problem	prɔblɛm
carfil bach	karvɪlbaːχ
nadroedd	nadrɔi̯ð
cestyll	kɛsdɪɬ
chari	χari
ffugenwau	fɪɡɛnwɛ
gweddw	ɡweːðu
gwared	ɡwarɛd
cyfarfod	kəvarvɔd
talcen	talkɛn
pilipala	pɪlɪpala
trwbl	trʊbl
timau	tiːmɛ
cae	kaː
arddwrn	arðʊrn
crynhoad	krənhoːad
dalan	dalan
ân	aːn
llwyd	ɬʊi̯d
darlithio	darlɪθjɔ
cot law	kɔtlau̯
gwarthegydd	ɡwarθɛɡɪð
cwpwrdd	kʊpʊrð
llygru	ɬəɡri
cydweithredwr	kiːdwei̯θreːdʊr
boncyff	bɔŋkɪf
urdd	ɪrð
gwahanol	ɡwanɔl
mlodau	mlɔdai̯
tegan anwes	tɛɡananwɛs
celynnen	kɛlənɛn
taeogtref	tei̯ɔɡtrɛv
lloches	ɬoːχɛs
unir	ɪnɪr
crefydd	kreːvɪð
tarianau	tarjanai̯
iasau	jasai̯
anghydweld	aŋhɪdwɛld
rhwygo	r̥ʊi̯ɡɔ
nghosyn	ŋ̊ɔsɪn
weithiau	wiθjɛ
picwns	pɪkʊnz
blwyddi	blʊi̯ði
fo	voː
doir	dɔi̯r
leuen	lei̯ɛn
ambiwlans	ambɪu̯lans
hyn oll	hɪnoːɬ
hyd yn hyn	hiːdənhɪn
chwerthin	hwɛrθɪn
cyfrwy	kəvrʊi̯
plu	pliː
adlamu	adlami
maharen	mahaːrɛn
ta	ta
pibwr inc	piːbʊrɪŋk
amodi	amɔdi
eangiadau	ɛaŋjadai̯
sustem	sɪsdɛm
ginio	ɡɪnɔ
bricsen	brɪksɛn
arfau	arvɛ
mham	m̥am
tra	traː
chythraul	χəθrai̯l
i'r dim	ɪrdɪm
eogiaid	ɛɔɡjai̯d
mhrydain	m̥rədai̯n
absenoldeb	absɛnɔldɛb
mhencampwr	m̥ɛŋkampʊr
abertawe	abɛrtau̯ɛ
toeslyd	tɔi̯slɪd
eirlys	ei̯rlɪs
dychryniadau	dəχrənjaːdɛ
dihareb	dɪharɛb
glwb	ɡlʊb
threisiwr	θrei̯ʃʊr
neidio	niːdɔ
gweinyddol	ɡwei̯nəðɔl
cydweithrediadau	kiːdwei̯θrɛdjaːdɛ
flynyddoedd	vlənəðɔi̯ð
trwnc	trʊŋk
lleuen	ɬei̯ɛn
cotiau	kɔtjai̯
ati	ati
banjo	band͡ʒɔ
adeiladaeth	adei̯laːdɛθ
cramen	kramɛn
pigau	pɪɡɛ
cyfarwyddwr	kəvarʊi̯ðʊr
chawod	χau̯ɔd
mrenin	mreːnɪn
cyfrifeg	kəvriːvɛɡ
pilen	pɪlɛn
creision ŷd	krei̯ʃɔniːd
allanfa dân	aɬanvadaːn
mapio	mapɔ
adael	adɛl
gerir	ɡɛrɪr
alarch	alarχ
amrywiad	amrɪu̯jad
peli troed	pɛlitrɔi̯d
iselder ysbryd	ɪsɛldɛrəsbrɪd
golygfeydd	ɡɔləɡvei̯ð
dymuno	dəmiːnɔ
methu	mɛθi
curo	kiːrɔ
cyfarthiadau	kəvarθjadai̯
wahanol	wanɔl
adain	adɛn
chefn	χeːvɛn
carw llychlyn	karuɬəχlɪn
adeiladwyr	adei̯ladwɪr
echrydu	ɛχrədi
chwigain	χwiːɡai̯n
ychydig	əχədɪɡ
dales	dalɛs
do	doː
crefyddol	krɛvəðɔl
cromlech	krɔmlɛχ
elwn	eːlʊn
cristion	krɪsdjɔn
telynau	tɛlənai̯
fi	viː
unllygeidiog	iːnɬəɡei̯djɔɡ
ciwcymbrau	kɪu̯kəmbrai̯
derw	dɛru
claddu	klaði
gofyn	ɡɔvɪn
lyfr	lɪvɪr
unes	iːnɛs
sillafu	sɪɬavi
marchnad	marχnad
cyfoethog	kəvɔi̯θɔɡ
rhian	r̥iːan
mwyalchen	mui̯alχɛn
ansoddair	ansɔðai̯r
coed afalau	kɔi̯davaːlɛ
coeden afalau	kɔi̯dɛnavaːlɛ
adferiadydd	advɛrjadɪð
rhesi	r̥ɛsi
dychryniadau	dəχrənjadɛ
toiledau	tɔi̯lɛdai̯
amanita borffor	amanɪtabɔrfɔr
drwyddedau	drʊi̯ðeːdai̯
saif	sai̯v
adnabyddi	adnabəði
darian	darjan
chloch	χloːχ
olaf	ɔla
unigol	ɪniːɡɔl
traddodiadol	traðɔdjadɔl
lindys	lɪndɪs
gôl	ɡoːl
hiraeth	hɪrɛθ
nghell	ŋ̊ɛɬ
cloi	klɔi̯
dafarn	daːvarn
gweinyddiadau	ɡwei̯nəðjadɛ
clybiau	kləbjɛ
nghwestiwn	kwɛsdjʊn
efwr	eːvʊr
nydden	nəðɛn
gwenoliaid	ɡwɛnɔljɛd
gnau	ɡnai̯
wiwer	wɪu̯ɛr
pobloedd	pɔblɔi̯ð
nhwymyn	n̥ʊi̯mɪn
trodd	troːð
cachai	kaχɛ
mewnforiwr	mɛu̯nvɔrjʊr
alar	alar
adfent	advɛnt
brych	briːχ
weler	weːlɛr
flasus	vlaːsɪs
munudau	mɪnɪdai̯
cyll	kɪɬ
trefydd	treːvɪð
peintiau	pei̯ntjɛ
tali	tali
nghathod	ŋ̊aθɔd
brys	briːs
nhadau	n̥aːdɛ
i ffwrdd	ɪfʊrð
woc	wɔk
phencampwyr	fɛŋkampwɪr
mhont	m̥ɔnt
gwynnach	ɡwənaχ
cryn	krɪn
cyfrifwr	kəvrɪvʊr
cist	kɪsd
tuag	tiːaɡ
cynnwrf	kənʊrv
tonnau	tɔnɛ
thali	θali
gweriniaeth	ɡwɛrɪnjai̯θ
sioeau	ʃɔi̯ɛ
chwannog	ʍanɔɡ
ei	ei̯
trwyddedau	trʊi̯ðɛdai̯
osgoi	ɔsɡɔi̯
blorai	blɔrai̯
olew olewydd	ɔlɛu̯ɔlɛu̯ɪð
cyfrwngddarostyngedigaeth	kəvrʊŋðarɔsdəŋɛdɪɡai̯θ
taeru	tei̯ri
brwydrau	brʊi̯drɛ
brith	briːθ
torri	tɔri
leicia	lɪkja
pibwyr inc	pɪbwɪrɪŋk
llwyfan	ɬʊi̯van
finegr balsamig	vɪnɛɡrbalsamiɡ
animeiddio	anɪmei̯ðjɔ
amrywiol	amrɪu̯jɔl
gorsaf	ɡɔrsav
dryslwyni	drəslʊi̯ni
bendant	bɛndant
gwylanod	ɡʊi̯laːnɔd
sinsir	sɪnsɪr
cwmwl	kʊmʊl
allweddell	aɬwɛðɛɬ
abathocroalaidd	abaθɔkrɔaːlai̯ð
henghraifft	hɛŋ̊rai̯fd
gartref	ɡɪtrɛ
gefn	ɡɛvn
dywed	dəu̯ɛd
anabl	aːnabl
cwpanaid	kʊpanɛd
cherddoriaeth	χɛrðɔrjɛθ
chwech	χweːχ
gofio	ɡɔvjɔ
iddewes	ɪðɛu̯ɛs
gwelais	ɡweːlɛs
ymddiddan	əmðiːðan
gwefan	ɡwɛvan
llesteiriannau	ɬɛsdei̯rjanɛ
adferwr	adveːrʊr
grug	ɡriːɡ
gallen	ɡaɬɛn
eiriadurwr	ei̯rjadiːrʊr
chenhinen	χɛnhɪnɛn
gemau	ɡeːmɛ
pioden	pioːdɛn
ugain	ɪɡɛn
delyn	dɛlɪn
estron	ɛsdrɔn
nos fawrth	noːsvau̯rθ
dilledyn	dɪɬeːdɪn
dyngarol	dəŋɡaːrɔl
chymaint	χɪmɛnt
sofren	sɔvrɛn
sudd afal	siːðaːval
arweinydd	arwei̯nɪð
adnabod	adnaːbɔd
werthu	wɛrθi
coed	koːd
beirniadu	bei̯rnjadi
angylaidd	aŋəlai̯ð
cacennau	kakɛnɛ
achres	aχrɛs
sbaeneg	sbei̯nɛɡ
galar	ɡalar
canlynol	kanlənɔl
perfedd	pɛrvɛð
ganer	ɡaːnɛr
adargi	adarɡi
thŵr	θuːr
lemon	lɛmɔn
diolch yn fawr	diɔlχənvau̯r
di	diː
aethnen	ei̯θnɛn
trwblus	trʊblɪs
naen	nai̯n
gani	ɡaːni
achos	aːχɔs
grwpiau	ɡrʊpjai̯
nghegin	ŋ̊ɛɡɪn
nghlefyd	ŋ̊leːvɪd
darianau	darjaːnai̯
threisiwr	θrei̯sjʊr
unrhyw un	ɪnr̥ɪu̯ɪn
amcangyfrif	amkaŋɡəvrɪv
ffwciaf	fʊkjav
ganu	ɡaːni
pajamas	pad͡ʒamaz
hanodd	haːnɔð
mewnforyn	mɛu̯nvɔrɪn
shibwnsyn	ʃɪbʊnsɪn
adegau	adɛɡai̯
boneddigion	bɔnɛðɪɡjɔn
pair	pai̯r
pencampwriaethau	pɛŋkampʊrjei̯θai̯
chusan	χɪsan
dynleiddiaid	diːnlei̯ðjai̯d
rheolydd	r̥ɛɔlɪð
nhŵr	n̥uːr
canes	kaːnɛs
pryd	priːd
ffeindio	fɪndjɔ
archebion	arχɛbjɔn
adael	adai̯l
amserlenni	amsɛrlɛni
cacennau	kakɛnai̯
yna	əna
gril	ɡrɪl
beidio	beidɔ
charo	χaːrɔ
enillwr	ɛnɪɬʊr
tryweli	trəu̯eːli
deiliadaethau	dei̯ljadei̯θai̯
deall	dɪaɬ
ti	tiː
calenigion	kalɛnɪɡjɔn
dydd mawrth	dɪðmau̯rθ
penisel	pɛniːsɛl
ffatri	fatri
nentydd	nɛntɪð
un ar ddeg	iːnarðeːɡ
mafon	maːvɔn
math	maːθ
llesteiriau	ɬɛsdei̯rjai̯
henghraifft	hɛŋrɛfd
chwyth	hwiːθ
llath	ɬaːθ
afocado	avɔkadɔ
haros	harɔs
eddy	ɛði
annwyd	anʊi̯d
ymrafael	əmravai̯l
dw	dʊ
briciau	brikjɛ
mroch	mroːχ
mlodyn	mlɔdɪn
amhenodol	amhɛnoːdɔl
goleuedig	ɡɔlei̯eːdɪɡ
gardd	ɡarð
delais	dɛlai̯s
protestaniaid	prɔtɛsdanjai̯d
taten	tatɛn
golygu	ɡɔləɡi
lleianod	ɬei̯anɔd
flodyn	vlɔdɪn
ymherodr	əmhɛrɔdr
fory	vɔri
gweddi'r arglwydd	ɡweːðirarɡlui̯ð
gwawr	ɡwau̯r
prydain fawr	prədai̯nvau̯r
record	rɛkɔrd
prŷn	priːn
ir	iːr
braw	brau̯
ewin	ɛu̯ɪn
rhywle	rʊlɛ
wrth gwrs	ʊrθɡʊrs
ngwinoedd	ŋwiːnɔi̯ð
seren	sɛrɛn
clawdd	klau̯ð
cyfranddeiliaid	kəvranðei̯ljɛd
tryfer	trəvɛr
mlog	mlɔɡ
rhech	r̥eːχ
ieithyddiaeth	jei̯θəðjai̯θ
atalfa	atalva
yrru	əri
diryw	dɪrɪu̯
achles	aχlɛs
cwynion	kʊi̯njɔn
arolygon	arɔləɡɔn
amobr	amɔbr
chwith	ʍiːθ
nghorff	ŋ̊ɔrf
siwrnai	ʃʊrnai̯
teigr	tei̯ɡr
aem	ai̯m
lolfa	lɔlva
gogledd	ɡɔɡlɛð
chor	χɔr
pabydd	pabɪð
ddwylo	ðʊi̯lɔ
dadwisgo	dadwɪʃɡɔ
gwyddau	ɡʊi̯ðɛ
nhrefydd	n̥rɛvɪð
adlamau	adlamɛ
rhyfelwyr	r̥əvɛlwɪr
llwm	ɬʊm
anghyfartal	aŋhəvartal
bethau	bɛθai̯
aiff	ai̯f
cog	koːɡ
aberdâr	abɛrdaːr
chân	χaːn
prifddinas	priːvðɪnas
ymrafael	əmraːvai̯l
galar	ɡaːlar
castanwydden	kasdanwɪðɛn
cusanau	kɪsaːnai̯
sgil	sɡiːl
cwestau	kwɛsdai̯
boeni	bɔi̯ni
cacha	kaχa
aber	aːbɛr
llawn	ɬau̯n
atseiniau	atsei̯njai̯
llewod	ɬɛu̯ɔd
rhentwr	r̥ɛntʊr
jac a'i wagen	d͡ʒakai̯waɡɛn
heglwys	hɛɡlʊi̯s
goriad	ɡɔrjad
teisen radell	tiːʃɛnradɛɬ
fforest	foːrɛst
llythyrennau	ɬəθərɛnɛ
addo	aːðɔ
arwerthu	arwɛrθi
losinen	lɔʃiːnɛn
gwyddbwyll	ɡwɪðbʊi̯ɬ
asesiad	asɛʃad
olifau	ɔlɪvɛ
gydag	ɡɪdaɡ
siocled poeth	ʃɔklɛdpoːθ
melyn	mɛlɪn
gorfodtref	ɡɔrvɔtrɛv
bugail	bɪɡɛl
dydd mawrth	dɪmau̯rθ
gwyddeleg	ɡʊi̯ðɛlɛɡ
nawf	nau̯v
canen	kanɛn
ddeset	ðɛsɛt
gyrgoed	ɡərɡɔi̯d
digoni	dɪɡoːni
unedau	ɪnɛdɛ
america	amɛrɪka
mwng	mʊŋ
abatiroedd	abatɪrɔi̯ð
taw	tau̯
llochesau	ɬɔχɛsɛ
cyffredinol	kəfrɛdɪnɔl
chestyll	χɛsdɪɬ
una	ɪna
tharianau	θarjaːnɛ
dyd	diːd
mlodau	mloːdɛ
gynhadledd	ɡənhadlɛð
cherir	χeːrɪr
delet	dɛlɛt
stemar	sdɛmar
afanen	avanɛn
cangarŵod	kaŋɡaruːɔd
peiriannwr	pei̯rjanʊr
ganwr	ɡaːnʊr
helyglys hardd	hɛləɡlɪsharð
canit	kanɪt
testun	tɛstɪn
fel hyn	vɛlhɪn
ych	iːχ
nofiwr	nɔvjʊr
galed	ɡalɛd
olau	oːlai̯
gwyddau	ɡʊi̯ðai̯
grefi	ɡrɛvi
adargraffu	adarɡrafi
sbectol	sbɛktɔl
pibwr inc	pɪbʊrɪŋk
blino	blɪnɔ
clirio	klɪrjɔ
nghae	ŋ̊aː
bedwen	bɛdwɛn
cyfryngiad	kəvrəŋjad
doliau	dɔljai̯
copïo	kɔpiːɔ
masnachdy	masnaχdi
gwleidyddol	ɡwlei̯dəðɔl
amgylcheddol	amɡəlχɛðɔl
gwrthrychol	ɡʊrθrəχɔl
cyfarthiad	kəvarθjad
teitl	tei̯tl
ystafell	əsdaːvɛɬ
gwlân	ɡwlaːn
ofyn	ɔvɪn
cyfryngau	kəvrəŋɛ
bedol	bɛdɔl
bronwen	brɔnwɛn
mhobl	m̥ɔbɔl
anaf	anav
pedronglau	pɛdrɔŋlai̯
dwyrain	dʊi̯rɛn
gwybod	ɡʊi̯bɔd
troednoeth	trɔi̯dnɔi̯θ
niwl	nɪu̯l
timau	tiːmai̯
hefin	heːvɪn
mynyddoedd	mənəðɔð
taranau	taraːnai̯
saib	sai̯b
cynrychioli	kənrəχjɔli
pweru	puɛri
stampiau	stampjɛ
tew	tɛu̯
cell	kɛɬ
eli	ɛli
lleianaidd	ɬei̯anɛð
rhyddhaf	r̥əðhaːv
ngwella	ŋwɛɬa
adferaf	adveːrav
gwahaniaethu	ɡwahanjei̯θi
genhinen	ɡɛnhiːnɛn
hwrdd	hʊrð
deiliadaethau	dei̯ljadei̯θɛ
iwd	juːd
bagét	baɡɛt
cynnull	kənɪɬ
thor	θɔr
parhau	parhai̯
h	h
croesholi	krɔi̯shɔli
choch	χoːχ
rhwystredigaethau	r̥ʊi̯sdrɛdɪɡei̯θɛ
rasys	rasɪz
taleb	taːlɛb
technoleg gwybodaeth	tɛχnɔlɛɡɡʊi̯bɔdai̯θ
twf	tuːv
helaeth	hɛlai̯θ
adaregydd	adarɛɡɪð
chwrdd	χʊrð
gellygen	ɡɛɬəɡɛn
sosban	sɔsban
gwialen bysgota	ɡwialɛnbəsɡɔta
dadiol	dadjɔl
beirniad	bei̯rnjad
oherwydd	ɔhɛrwɪð
goes	ɡɔi̯s
chwedl	χwɛdɛl
oes	weːs
rhiw	r̥ɪu̯
gachai	ɡaːχai̯
bore da	bɔrɛdaː
corneli	kɔrnɛli
teulu	tiːli
ariannog	arjanɔɡ
elid	eːlɪd
pigau	piːɡai̯
streicio	sdrei̯kjɔ
araf	arav
aderyn du	dɛrɪndiː
eler	eːlɛr
echddoe	ɛχðɔ
pumongl	pɪmɔŋl
ail	ai̯l
adweithegwyr	adwei̯θɛɡwɪr
goddrych	ɡɔðrɪχ
cedor	keːdɔr
weithiau	wei̯θjɛ
ymlynu	əmləni
cenedl	keːnɛdl
picen	pɪkɛn
pyliau	pəljai̯
dirwy	diːrʊi̯
dyfarniadau	dəvarnjaːdai̯
pechadur	pɛχaːdɪr
aer	ai̯r
arwerthiannau	arwɛrθjanai̯
cnuchio	knɪχjɔ
deigr	dei̯ɡr
gweithiwr	ɡwei̯θjʊr
mwcws	mʊkʊs
gwynt	ɡwɪnt
amheuaf	amhei̯av
ewythr	ɛu̯ɪrθ
amaethyddiaeth	amei̯θəðjɛθ
delw	dɛlu
sylfaenol	səlvei̯nɔl
lledr	ɬeːdɛr
garest	ɡaːrɛst
nghoed	ŋ̊ɔi̯d
anabledd	anablɛð
nghroes	ŋ̊rɔi̯s
gwlad	ɡlaːd
poena	pɔi̯na
elom	eːlɔm
ffraeau	frei̯ɛ
mawrth	mau̯rθ
habatir	habatɪr
ffugenwau	fɪɡɛnwai̯
gerais	ɡeːrai̯s
tanbeidrwydd	tambei̯drʊi̯ð
tu ôl i	tioːli
ael	ai̯l
heuldro'r gaeaf	hei̯ldrɔrɡei̯a
eleni	ɛlɛni
ceiniog	kei̯njɔɡ
chwerw	ʍɛru
rwsia	rʊsja
chwyrnu	ʍərni
ddeiliaid	ðei̯ljɛd
na	na
cherddoriaeth	χɛrðɔrjai̯θ
chwech ar hugain	χweːχarhiːɡai̯n
gwagedd	ɡwaːɡɛð
tenantiaeth	tɛnantjɛθ
golau	ɡoːlɛ
iddyn	iːðɪn
picen ar y maen	pɪkɛnarəmai̯n
llafar	ɬaːvar
tafod	taːvɔd
niwlen	nɪu̯lɛn
riliau	rɪljɛ
felyn	vɛlɪn
dwfn	duːvʊn
ymaflyd	əmavlɪd
crëwr	krɛʊr
cyffredin	kəfreːdɪn
taliadau	taljadai̯
crefydd	krɛvɪð
harall	haːraɬ
pentref	pɛntrɛv
llefn	ɬɛvn
hieirll	hjei̯rɬ
weithiwr	wiːθʊr
deisen	dei̯sɛn
gŵyl	ɡʊi̯l
gwningen	ɡʊnɪŋɛn
gwyrddfaen	ɡwərðvai̯n
sylwi	səlwi
coronafeirysau	kɔrɔnavei̯rəsai̯
brawychus	brau̯əχɪs
lleoli	ɬɛɔli
cyhyd	kəhiːd
canu	kaːni
ddoi	ðɔi̯
barcud	barkɪd
moli	mɔli
glan	ɡlan
emrallt	ɛmraɬd
timoedd	tɪmɔð
cyrraedd	kərɛð
rheolydd	r̥ɛoːlɪð
ystafell	sdavɛɬ
mheis	m̥eiz
yno	ənɔ
nghefn	kɛvɛn
arfeddog	arveːðɔɡ
pysen	pəsɛn
segur	seːɡɪr
achan	aːχan
cara	kaːra
murddun	mɪrðɪn
teimlad	tʊmlad
llifogydd	ɬivɔɡɪð
huan	hiːan
taleb	talɛb
cydbreswylwyr	kiːdbrɛsʊi̯lwɪr
siopwr	ʃɔpʊr
argraffiad	arɡrafjad
cwympo	kwɪmpɔ
ateli	ateːli
felly	vɛɬi
basged	basɡɛd
had	haːd
nhraed	n̥rai̯d
peis	peiz
carsi	karsi
cynorthwyo	kənɔrθʊi̯ɔ
arwain	arwɛn
farnau	varnai̯
clodforedd	klɔdvɔrɛð
twrci	tʊrki
gyfnither	ɡəvniːθɛr
tebygol	tɛbəɡɔl
unem	iːnɛm
ŵyl	ʊi̯l
hynod	hənɔd
dofn	doːvɔn
arwynebedd	arʊi̯neːbɛð
creisionen	krei̯sjoːnɛn
clicio	klɪkɔ
dâr	daːr
drysni	drəsni
erchwyn	ɛrχwɪn
lifftiau	lɪfdjai̯
blynedd	blənɛð
twyllwyr duon	tʊi̯ɬwɪrdiɔn
eiliadau	ei̯ljadai̯
neu	nei̯
lliwio	ɬɪu̯jɔ
cydgordiol	kɪdɡɔrdjɔl
wel	wɛl
eirina	ei̯riːna
llysieua	ɬəʃei̯a
ngharwr	ŋ̊arʊr
harddach	harðaχ
maen	maːn
ar werth	arwɛrθ
cicio	kɪkjɔ
unit	iːnɪt
alban elfed	albanɛlvɛd
frân	vraːn
cyfatebiaeth	kəvatɛbjɛθ
bwlch	bʊlχ
hafodydd	havɔdɪð
daear	dei̯ar
ffon	fɔn
moyn	mɔi̯n
delynor	dɛlənɔr
prynu	prəni
wystl	wɪsdɪl
teyrn	tei̯rn
rhyfel	r̥əvɛl
dw i angen cyfreithiwr	duiaŋɡɛnkəvrəiθɪur
deisen	diːʃɛn
nant	nant
nghot law	ŋ̊ɔtlau̯
siân	ʃaːn
go lew	ɡɔlɛu̯
achyddiaeth	aχəðjai̯θ
llwy	ɬʊi̯
ffugenw	fɪɡɛnu
heuldro	hei̯ldrɔ
canolog	kanɔlɔɡ
pinafal	piːnaval
pedol	pɛdɔl
canmoliaethau	kanmɔljei̯θɛ
diamod	diamɔd
plygiau	pləɡjɛ
coeden afalau	kɔi̯dɛnvaːlɛ
aethnenni	ei̯θnɛni
antimoni	antɪmɔni
sw	zuː
haf	haːv
aber	abɛr
chwip	χwɪp
crëwr	kreːʊr
cristionogion	krɪsdjɔnɔɡjɔn
chadair	χaːdai̯r
anobeithio	anɔbei̯θjɔ
bwgan	buːɡan
bobloedd	bɔblɔi̯ð
plethu	plɛθi
cymysgedd	kəməsɡɛð
carreg galch	kɛrɪɡɡalχ
w	ʊ
tenantiaethau	tɛnantjei̯θai̯
phobl	foːbɔl
brwd	bruːd
cen y coed	kɛnəkɔi̯d
allwedd	aɬwɛð
diwerth	dɪu̯ɛrθ
sgrinio	sɡrinjɔ
peirianneg	pei̯rjanɛɡ
anghytuno	aŋətiːnɔ
gwrol	ɡʊrɔl
deddfu	dɛðvi
bàth	baθ
llesteiriannau	ɬɛsdei̯rjanai̯
fedra	vɛdra
fewn	vɪu̯n
paratoi	paratɔi̯
rywsut	rɪu̯sɪt
thebyg	θeːbɪɡ
swyddog	sʊi̯ðɔɡ
milwrol	mɪluːrɔl
cerddoriaeth	kɛrðɔrjɛθ
gerddoriaeth	ɡɛrðɔrjai̯θ
elych	eːlɪχ
pedwar	pɛdwar
piglas	pɪɡlas
fynydd	vɪni
erw	ɛru
chwerthin	wɛrθɪn
terfysgaeth	tɛrvəsɡai̯θ
telais	tɛlai̯s
gordd	ɡɔrð
fampir	vampɪr
ogystal	ɔɡəsdal
pobl	pɔbɔl
cyfarthiadau	kəvarθjadɛ
heisteddfodau	hei̯sdɛðvoːdɛ
adar duon	aːdardiːɔn
llinyn	ɬiːnɪn
chewch	χɛu̯χ
llyffant	ɬəfant
ngogledd	ŋɔɡlɛð
thaliadau	θaljadɛ
anelu	anɛli
utgorn	ɪtɡɔrn
marnwr	marnʊr
taenu	tei̯ni
torro	tɔrɔ
glythineb	ɡləθiːnɛb
uni	iːni
isel	iːsɛl
alannon	alanɔn
nghymaint	ŋ̊əmɛnt
agoriad	aɡɔrjad
rhyngrwyd pethau	r̥əŋrʊi̯dpeːθɛ
iddew	iːðɛu̯
ddringo	ðrɪŋɔ
troet	trɔi̯t
rydd	riːð
tri	triː
cadair	kaːdɛr
ymenyn	əmeːnɪn
senedd	seːnɛð
gwellt	ɡwɛɬd
anafes	anavɛs
nhroed	n̥rɔi̯d
gythreuliaid	ɡəθrei̯ljɛd
mewngofnodi	mɛu̯ŋɡɔvnoːdi
tenantiaeth	tɛnantjai̯θ
rhyngwladol	r̥əŋlaːdɔl
mewn chwinciad	mɛu̯nχwɪŋkjad
phunt	fɪnt
cymedrolwr	kəmɛdroːlʊr
dall	daɬ
hardaloedd	hardaːlɔi̯ð
fol	vɔl
sefydlogi	sɛvədlɔɡi
wyched	wəχɛd
twp	tʊp
gwenyn mêl	ɡweːnɪmmeːl
dial	dial
mara	maːra
meddyg	mɛðɪɡ
canon	kanɔn
llygaid	ɬɪɡɛd
ngafr	ŋavr
croenliw	krɔi̯nlɪu̯
achlysurol	aχləsɪrɔl
eliffant	ɛlɪfant
brecwast	brɛkwast
cystadleuol	kəsdadlei̯ɔl
adain	aːdai̯n
lliw	ɬɪu̯
cynorthwyydd	kənɔrθʊi̯ɪð
wal	wal
awstria	au̯strja
gylch	ɡɪlχ
cymhlethdodau	kəmhlɛθdɔdai̯
dadwreiddio	dadwrɛi̯ðjɔ
galed	ɡaːlɛd
clwb	klʊb
cwis	kwɪs
darparu	darpari
cyflogaeth	kəvlɔɡai̯θ
seithfed	sei̯θvɛd
thacluso	θaklɪsɔ
melltith	mɛɬdɪθ
dychwelyd	dəχwɛlɪd
rhyfela	r̥əvɛla
thalu	θaːli
weithio	wei̯θjɔ
parotach	parɔtaχ
penisel	pɛnɪsɛl
cyfnodol	kəvnɔdɔl
nghnau ffrengig	ŋ̊nai̯frɛŋɪɡ
drycin	drəkɪn
allt	aɬd
gofalus	ɡɔvaːlɪs
barf	barv
hosbis	hɔsbɪs
derbynneb	dɛrbənɛb
fri	vriː
adweini	adwei̯ni
allgofnodi	aɬɡɔvnoːdi
meteleg	mɛtɛlɛɡ
rŵan	ruːan
cyfeillion	kəvei̯ɬjɔn
gwrthwynebu	ɡʊrθwɪnɛbi
dyfeiswragedd	dəvei̯swraɡɛð
dadwisgo	dadwɪsɡɔ
clywed	kləu̯ɛd
cael	kai̯l
llwyddo	ɬʊi̯ðɔ
alwminiwm	alʊmɪnjʊm
tech gwyb	tɛχɡwɪb
gefeilles	ɡɛvei̯ɬɛs
thorrent	θɔrɛnt
rhedyna	r̥ɛdəna
iogwrt	joːɡʊrt
gwrthryfelwyr	ɡʊrθrəvɛlwɪr
drannoeth	dranɔi̯θ
dalan	daːlan
ciciau cosb	kɪkjɛɡɔsb
tyb	tiːb
byd	biːd
ffeindiaf	fei̯ndja
dyffryn	dəfrɪn
siafio	ʃaːvɔ
oleuadau	ɔlei̯adai̯
bethau	beːθai̯
llun yr haeddel	ɬiːnərhei̯ðɛl
cadnawes	kadnau̯ɛs
saint	sai̯nt
dirmyg	dɪrmɪɡ
brawd	brau̯d
adfeiliad	advei̯ljad
undeb	ɪndɛb
ceillgwd	keiɬɡʊd
ti'n iawn	tiːnjau̯n
cwffio	kʊfjɔ
gwyliedyddion	ɡwɪljɛdəðjɔn
ngleision	ŋlei̯ʃɔn
pedwerydd	pɛdweːrɪð
digon	dɪɡɔn
llungopïo	ɬiːŋɡɔpiːɔ
je	dʒeː
ugain	iːɡai̯n
cymorthion	kəmɔrθjɔn
yfory	vɔri
crwydr	krʊi̯dɪr
caredig	kareːdɪɡ
dysg	dɪsɡ
cyffredin	kəfrɛdɪn
abatai	abatai̯
titw tomos las	tɪtutɔmɔslaːs
mwyafrif	mʊi̯avrɪv
drygioni	drəɡjoːni
synthesis	sɪnθɛsɪs
aberystwyth	abɛrəstwɪθ
nag	naɡ
fôr	voːr
mynedadwy	mənɛdadʊi̯
arth	arθ
dadlwytho	dadlʊi̯θɔ
dyrchafu	dərχavi
trwsgl	trʊsɡl
olwg	ɔlʊɡ
cyfair	kəvɛr
gwneud	nei̯d
ngwlad	ŋwlaːd
cant	kant
echryd	ɛχrɪd
lywydd	ləu̯ɪð
alaw	aːlau̯
gobeithio	ɡɔbiːθɔ
torch	tɔrχ
gweithio	ɡwei̯θɔ
clodfori	klɔdvɔri
oeri	ɔi̯ri
yr euog a ffy heb neb yn ei erlid	ərei̯ɔɡafiːheːbneːbəneiɛrlɪd
rif	riːv
ddere	ðɛrɛ
almaeneg	almei̯nɛɡ
ulai	ɪlai̯
dyweddïo	dəwɛðiːɔ
ysbrydol	əsbrədɔl
tai	tai̯
llyfrau	ɬəvrai̯
bargeinio	barɡəi̯njɔ
caer	kai̯r
barus	baːrɪs
afalau cariad	avaːlai̯karjad
pinafal	pɪnaːval
drysfeydd	drəsvei̯ð
llethol	ɬɛθɔl
nhu	n̥iː
dynfarch	dənvarχ
groeg	ɡrɔi̯ɡ
sain	sai̯n
dwyrain	dʊi̯rain
nodwydd	nɔdʊi̯ð
yr	ər
ganer	ɡanɛr
adwaenom	adwei̯nɔm
pluen eira	pliːɛnei̯ra
tegan meddal	tɛɡanmɛðal
henw	hɛnu
corffluoedd	kɔrfliːɔi̯ð
heol	heːɔl
weddi	weːði
chaeredin	χai̯rɛdɪn
pwysig	pʊi̯sɪɡ
phur	fiːr
offeiriad	ɔfəi̯rjad
cylchgrawn	kəlχɡrau̯n
pump ar hugain	pɪmparhiːɡɛn
dyfeiswraig	dəvei̯swrai̯ɡ
cymry	kəmri
nghanwr	ŋ̊anʊr
cawod	kau̯ɔd
hunanladdwr	hiːnanɬaːðʊr
ddos	ðoːs
achos	aχɔs
nghoed	ŋ̊oːd
doeddwn	dɔi̯ðʊn
cenna	kɛna
gafas	ɡavas
adargraffiad	adarɡrafjad
peidio	peidjɔ
celli	kɛɬi
awdl	au̯dl
offer	ɔfɛr
helbulus	hɛlbiːlɪs
raff	raːf
ysgaw	əsɡau̯
cytrefi	kətrɛvi
phryfed	frəvɛd
datguddio	datɡɪðjɔ
trawstrefa	trau̯strɛva
llall	ɬaːɬ
cesail	kɛsɛl
deg ar hugain	deːɡarhiːɡɛn
daliadau	daljaːdɛ
deud	dei̯d
mlew	mlɛu̯
cydweithredu	kiːdwei̯θreːdi
galw	ɡalu
gwreiddio	ɡrɛi̯ðɔ
adarwyr	adarwɪr
pheth	feːθ
anghofus	aŋhɔvɪs
gwarthegydd	ɡwarθeːɡɪð
afalau	avalɛ
cytgord	kətɡɔrd
cwerylgar	kwɛrəlɡar
masgio	masɡjɔ
gwely	ɡweːli
gwisga	ɡwɪsɡa
megis	mɛɡɪs
closen	klɔsɛn
cares	kaːrɛs
syllta	səɬda
lladrad	ɬadrad
thaflu	θavli
nhrwyddedau	n̥rʊi̯ðɛdɛ
droi	drɔi̯
gryf	ɡriːv
gwalch glas	ɡwalχɡlaːs
deler	dɛlɛr
amgáu	amɡai̯
gwair	ɡwai̯r
gwerddonau	ɡwɛrðɔnai̯
nghythreuliaid	ŋ̊əθrei̯ljɛd
cwmwd	kʊmʊd
theyrnaddoliant	θei̯rnaðɔljant
palmant	palmant
lau	lai̯
gydag	ɡədaɡ
achydd	aχɪð
nheulu	n̥iːli
pedwerydd	pɛdwɛrɪð
cwerylon	kwɛrəlɔn
rhwyll	r̥ʊi̯ɬ
amguedd	amɡiːɛð
eled	ɛlɛd
aberdaugleddau	abɛrdai̯ɡlɛðai̯
rhegion	r̥ɛɡjɔn
papur	papɪr
awen	au̯ɛn
fynd	vɪnd
gwesteion	ɡwɛsdei̯ɔn
rhegen	r̥ɛɡɛn
cefn	kɛvɛn
ciciau	kikjɛ
tâp selo	taːpsɛlɔ
daler	dalɛr
fasen	vasɛn
gymorth	ɡəmɔrθ
llechi	ɬɛχi
pathewod	paθɛu̯ɔd
