medd	meːð
archangel	arχaŋal
anawsterau	anau̯sdɛraɨ̯
gwerthwr	ɡwɛrθʊr
corhwyaid	kɔrhʊɨ̯ai̯d
cyfyd	kəvɨ̞d
brain	brai̯n
cerais	kɛrai̯s
teisennau	tei̯ʃɛnaɨ̯
mhysgod	m̥əsɡɔd
charafán	χaravan
cronni	krɔni
ngoleuadau	ŋɔleɨ̯ada
goch	ɡoːχ
carw	karu
bandiau	bandjɛ
siwgr	ʃʊɡʊr
bawn	bau̯n
hechrydus	hɛχrədɨ̞s
basio	baʃɔ
coleg	kɔlɛɡ
llaswyr	ɬasʊɨ̯r
twyn	tuːɨ̯n
chymylog	χəməlɔɡ
cymreig	kəmrei̯ɡ
ciwcymbr	kɪu̯kəmbr
ngwddwg	ŋʊðʊɡ
ffoniwn	fɔnjʊn
thaliadau	θaljadaɨ̯
uchelwr	ɨ̞χɛlʊr
trymhau	trəmhaɨ̯
petryal	pɛtrɨːal
dweud	dweɨ̯d
canolwr	kanɔlʊr
nghylchgrawn	ŋ̊əlχɡrau̯n
edau	ɛdaɨ̯
aethoch	eɨ̯θɔχ
ffrwgwd	frʊɡʊd
protocol	prɔtɔkɔl
rhedyna	r̥ɛdəna
adnebydd	adnɛbɨ̞ð
mynachdai	mənaχdai̯
hogiau	hɔɡjaɨ̯
cynorthwyo	kənɔrθʊɨ̯ɔ
biti	bɪtɪ
chwpan	χʊpan
gwenynen feirch	ɡwɛnənɛnvei̯rχ
gwlad	ɡwlaːd
cyrsiau	kərʃɛ
dywyll	dəu̯ɨ̞ɬ
pedol	pɛdɔl
dydd sul	dɨ̞sɨːl
crychydd	krəχɨ̞ð
nghefn	ŋ̊ɛvn
daclus	daklɨ̞s
llawfeddygon	ɬau̯vɛðəɡɔn
bordydd	bɔrdɨ̞ð
pabyddion	pabəðjɔn
awchus	au̯χɨ̞s
anabl	anabl
cilio	kɪljɔ
tryferi	trəvɛrɪ
chwydd	χwɨːð
marchogaeth	marχɔɡaɨ̯θ
thŵr	θuːr
hetiwr	hɛtjʊr
slej	slɛd͡ʒ
meteleg	mɛtɛlɛɡ
carfil	karvɪl
dynfarch	dənvarχ
damweinio	damwei̯njɔ
pwyllgor	pʊɨ̯ɬɡɔr
pencampwriaeth	pɛŋkampʊrjɛθ
eira	ei̯ra
syndod	səndɔd
deyrnaddoliant	deɨ̯rnaðɔljant
abadesau	abadɛsa
toc	tɔk
haf	haː
senedd	sɛnɛð
ymwelwr	əmwɛlʊr
gellir	ɡɛɬɪr
canyddion	kanəðjɔn
torret	tɔrɛt
toes	toːɨ̯s
uwch	ɨ̞u̯χ
gesyd	ɡɛsɨ̞d
tai	tai̯
llesteiriannau	ɬɛsdei̯rjanɛ
dydd sadwrn	dɨ̞sadʊn
ddail	ðai̯l
adfeiliedig	advei̯ljɛdɪɡ
cnawdol	knau̯dɔl
allant	aɬant
hosbisau	hɔsbɪsɛ
llwybr llaethog	əɬʊɨ̯brɬeɨ̯θɔɡ
lanach	lanaχ
eiddew	ei̯ðɛu̯
rhywbeth	r̥ɪu̯bɛθ
nheisen	n̥ei̯ʃɛn
cacennau cri	kakɛnakriː
hawlio	hau̯ljɔ
picau maen	pɪkamaːɨ̯n
allgofnodi	aɬɡɔvnɔdi
allwthio	aɬʊθjɔ
tudalen	tɨ̞dalɛn
rheidrwydd	r̥ei̯drʊi̯ð
gwell	ɡwɛɬ
deisen	dei̯san
chae	χaːɨ̯
adwaenid	adweɨ̯nɪd
sant	sant
corgwn	kɔrɡʊn
ymhlith	əmhliːθ
enw	ɛnu
ebrill	ɛbrɪɬ
caerloyw	kaɨ̯rlɔɨ̯ʊ
thyrrau	θəra
chythreuliaid	χəθreɨ̯ljai̯d
pathewod	paθɛu̯ɔd
ehangiad	ɛhaŋjad
ryddhau	rəðhaɨ̯
bysgod	bəsɡɔd
ynglŷn	əŋlɨːn
char	χar
mhabell	m̥abɛɬ
adfero	advɛrɔ
cyfarfod	kwarvɔd
wyres	ʊɨ̯ras
halibalŵ	halɪbaluː
chu	χɨː
adre	adra
gylchgrawn	ɡɨ̞lχɡrau̯n
cano	kanɔ
rhywle	r̥ɪu̯lɛ
cydweithrediadau	kɨːdwei̯θrɛdjadɛ
olew olewydd	ɔlɛu̯ɔlɛu̯ɨ̞ð
unigol	ɨ̞nɪɡɔl
selog	sɛlɔɡ
aent	aːɨ̯nt
croeshoelio	krɔɨ̯shɔɨ̯ljɔ
tegan meddal	tɛɡanmɛðal
cymaint	kəmai̯nt
dydd gwener	dɨːðɡwɛnɛr
lundain	lɨ̞ndan
adrodd	adrɔð
hirgrynion	hɪrɡrənjɔn
canlyniad	kanlənjad
glybiau	ɡləbja
pluen eira	plɨ̞ɛnei̯ra
dwrgi	dʊrɡɪ
cwmwd	kʊmʊd
cynhenna	kənhɛna
llunio	ɬɨ̞njɔ
helwyr	hɛlwɨ̞r
wddf	ʊðu
porffor	pɔrfɔr
eith	ei̯θ
nhyrrau	n̥əra
hyfed	həvɛd
cynhaeaf	kənheːɨ̯av
abad	abad
denu	dɛnɨ
bol	bɔl
dichon	dɪχɔn
ar	ar
taled	talɛd
afocados	avɔkadɔs
pibonwy	pɪbɔnuɨ̯
bibgorn	bɪbɡɔrn
ffonau	fɔnɛ
carthen	karθan
cyrsiau	kərʃa
angylaidd	aŋəlai̯ð
crist	kriːst
ddechrau	ðɛχraɨ̯
teipio	tei̯pjɔ
cartref	kartrɛ
bae	baːɨ̯
hi	hiː
pencampwyr	pɛŋkampwɨ̞r
mai	ma
trwynol	trʊɨ̯nɔl
eng	ɛŋ
diolch yn fawr iawn	djɔlχənvau̯rjau̯n
llith	ɬiːθ
carsi	karsi
dyfi	dəvɪ
astrusi	asdrɨ̞si
gloi	ɡlɔi̯
ceni	kɛnɪ
cyngor	kəŋɔr
digon	dɪɡɔn
y	ə
farnau	varnaɨ̯
cesar	kɛsar
chneuen gyll	χneɨ̯ɛnɡɨ̞ɬ
bedwen	bɛdwɛn
caffel	kafɛl
yn	ən
anelu	anɛlɨ
cydsynio	kɨ̞dsənjɔ
saith seren	sai̯θsɛrɛn
alar	aːlar
dywedodd	dəu̯ɛdɔð
chaled	χalɛd
dolen	dɔlɛn
mroch	mroːχ
cneuen ffrengig	kneɨ̯ɛnfrɛŋɪɡ
paid	pai̯d
bengwiniaid	bɛŋɡwɪnjɛd
byddarol	bəðarɔl
dall	daɬ
oherwydd	ɔhɛrwɨ̞ð
pabïau	pabiːaɨ̯
camgymeriad	kamɡəmɛrjad
cachen	kaχɛn
eog	ɛɔɡ
ddigon	ðɪɡɔn
paned	panad
genedigaethau	ɡɛnɛdɪɡeɨ̯θɛ
bronrhuddyn y mynydd	brɔnr̥ɨ̞ðɨ̞nəmənɨ̞ð
cwest	kweːsd
angof	aŋɔv
llwrw	ɬʊru
rhag	r̥aɡ
chael	χaːl
cloem	kloːɨ̯m
fwlfa	vʊlva
catholigiaeth	kaθɔlɪɡjaɨ̯θ
nhrefydd	n̥rɛvɨ̞ð
i'r dim	iːrdɪm
lyfrau	ləvrɛ
fuan	vɨ̞an
morwyn	mɔrʊɨ̯n
golchi	ɡɔlχɪ
cystadlaethau	kəsdadleɨ̯θa
yrru	ərɨ
trais	trai̯s
ardal	ardal
rhwystrau	r̥ʊɨ̯sdrɛ
bwrw hen wragedd â ffyn	bʊrʊheːnwraɡɛðafɨ̞n
brenhines	brɛnhɪnas
lyfr	lɨ̞vr
blingo	blɪŋɔ
ngwylio	ŋwɪljɔ
amryw	amrɨu̯
wlad pwyl	wlaːdpuːɨ̯l
ithfaen	ɪθvaɨ̯n
ehedydd	ɛhɛdɨ̞ð
dyfrfarch	dəvrvarχ
waliau	waljɛ
acennu	akɛnɨ
dwyt	duːɨ̯t
achosaf	aχɔsav
atalnod	atalnɔd
thawel	θau̯ɛl
elwa	ɛlwa
troet	troːɨ̯t
barc	bark
rhinoseros	r̥ɪnɔsɛrɔs
gymylog	ɡəməlɔɡ
flynedd	vlənɛð
llywodraethu	ɬəu̯ɔdreɨ̯θɨ
deiliadaethau	dei̯ljadeɨ̯θɛ
gwiwer	ɡwɪu̯ar
lwc	lʊk
dew	deːu̯
garant	ɡarant
èf	ɛv
dagrau	daɡraɨ̯
dafydd	davɨ̞ð
tu ôl i	tɨ̞oːlɪ
pigwrn	pɪɡʊrn
cusanu	kɨ̞sanɨ
bapur	bapɨ̞r
delet	dɛlɛt
perthynas	pɛrθənas
cul	kɨːl
cen	kɛn
pasg	paːsɡ
piclau	pɪklɛ
un ar bymtheg	ɨːnarbəmθɛɡ
fleiddiau	vlei̯ðjɛ
taenu	teɨ̯nɨ
lladrad	ɬadrad
mhethau	m̥ɛθaɨ̯
pryf copyn	prɨːkɔpɨ̞n
pencampwriaethau	pɛŋkampʊrjeɨ̯θɛ
adaregydd	adarɛɡɨ̞ð
ford	vɔrd
rhwydo	r̥ʊɨ̯dɔ
edwyn	ɛdwɨ̞n
amnewid	annɛu̯ɪd
ngoleuadau	ŋɔleɨ̯adaɨ̯
aethem	eɨ̯θɛm
coed afalau	koːɨ̯davalɛ
pydredd	pədrɛð
gwyddau	ɡʊɨ̯ða
alfarch	alvarχ
elltydd	ɛɬdɨ̞ð
llysenw	ɬɨ̞sɛnu
cyfrifydd	kəvrɪvɨ̞ð
petryalau	pɛtrɨ̞ala
briallen	brjaɬɛn
cyfnodolion	kəvnɔdɔljɔn
glŷn	ɡlɨːn
dewi	dɛu̯i
piclo	pɪklɔ
cecren	kɛkrɛn
hoff	hoːf
egwyddor	ɛɡʊɨ̯ðɔr
gorfod	ɡɔrvɔd
tâl	taːl
academïau	akadɛmiːɛ
trigain	trɪɡɛn
aredaf	arɛdav
panasen	panasɛn
animeiddio	anɪmei̯ðjɔ
phobl	fɔbl
bwyta	bʊɨ̯ta
gwawl	ɡwau̯l
pured	pɨ̞rɛd
'i	i̯
y tu ôl i	tɨ̞oːlɪ
gweinydd	ɡwei̯nɨ̞ð
rywle	rɪu̯lɛ
ânt	aːnt
iet	jɛt
nharianau	n̥arjanɛ
wysg	uːɨ̯sɡ
addo	aðɔ
genhinen	ɡɛnhɪnɛn
tsimpansî	tʃɪmpansiː
haeddel	heɨ̯ðɛl
nhatws	n̥atʊs
gwarthegyddion	ɡwarθɛɡəðjɔn
conglfaen	kɔŋlvaɨ̯n
du	dɨː
ddwywaith	ðʊɨ̯wai̯θ
putain	pɨ̞tɛn
etyl	ɛtɨ̞l
habatir	habatɪr
byrddydd	bərðɨ̞ð
aseswr	asɛsʊr
na	na
porchell	pɔrχɛɬ
nghut	ŋ̊ɨ̞t
negfed	nɛɡvɛd
bardd	barð
parot	parɔt
hogyn	hɔɡɨ̯n
gostyngaidd	ɡɔsdəŋai̯ð
pei	pei̯
sodlau uchel	sɔdlɛɨ̞χɛl
achubiaeth	aχɨ̞bjaɨ̯θ
môn	moːn
nos iau	nɔʃaɨ̯
actio	aktjɔ
galler	ɡaɬɛr
gyrraedd	ɡəraɨ̯ð
gwahodd	ɡwahɔð
garem	ɡarɛm
gymedrolwyr	ɡəmɛdrɔlwɨ̞r
heraill	hɛrɪɬ
brython	brəθɔn
glyw	ɡlɨu̯
gwyliedydd	ɡwɨ̞ljɛdɨ̞ð
gaint	ɡai̯nt
penblethau	pɛmblɛθa
diffydd	dɪfɨ̞ð
nage ddim	naɡɛðɪm
garchar	ɡarχar
pyliau	pəlja
bochdew	bɔχdɛu̯
eisteddfodau	sdɛðvɔda
cymylau	kəməla
aethom	eɨ̯θɔm
cyflafareddiad	kəvlavarɛðjad
rheolwr	r̥ɛɔlʊr
swshi	suːʃi
mheth	m̥eːθ
gorasgellu	ɡɔrasɡɛɬɨ
caffis	kafɪs
cyflafareddu	kəvlavarɛðɨ
diffodd	dɪfɔð
ychen	əχɛn
feirysau	vei̯rəsaɨ̯
arglwydd	arɡlʊɨ̯ð
caerau	keɨ̯ra
unen	ɨ̞nɛn
chwain	χwai̯n
surdoes	sɨ̞rdɔɨ̯s
ffrygydau	frəɡədɛ
gwledydd	ɡwlɛdɨ̞ð
carchar	karχar
ael	aːɨ̯l
hiliaeth	hɪljaɨ̯θ
glanhau	ɡlanhaɨ̯
ystyried	əsdərjɛd
amgueddfa	amɡɨ̞ɛðva
piod	piːɔd
adawed	adau̯ɛd
trueni	triɛnɨ
brawychwyr	brau̯əχwɨ̞r
nodi	nɔdi
telynorion	tɛlənɔrjɔn
nos fercher	noːsvɛrχɛr
ata	ata
rywun	rɨu̯ɨ̞n
pont	pɔnt
enillwyr	ɛnɨ̞ɬwɨ̞r
pedolau	pɛdɔla
cân	kaːn
rywle	rɪu̯la
cacennau cri	kakɛnaɨ̯kriː
gynhadledd	ɡənhadlɛð
gweithwyr	ɡwei̯θwɨ̞r
gariad	ɡarjad
amrywio	amrɨu̯jɔ
canmoliaethau	kanmɔljeɨ̯θaɨ̯
amethyst	amɛθɨ̞sd
afreolaidd	avrɛɔlɛð
adferiedydd	advɛrjɛdɨ̞ð
terfysglyd	tɛrvəsɡlɨ̞d
gweddw	ɡwɛðu
o flaen llaw	ɔvlaːɨ̯nɬaːu̯
adweinaf	adwei̯nav
cared	karɛd
talais	talɪʃ
unais	ɨ̞nɛs
amrant	amrant
caniatáu	kanjataɨ̯
iddewesau	ɪðɛu̯ɛsɛ
cyrchu	kərχɨ
gryf	ɡrɨːv
chalenigion	χalɛnɪɡjɔn
sefyllfaoedd	sɛvəɬvaːɔɨ̯ð
tanbeidrwydd	tambei̯drʊɨ̯ð
dydd sadwrn	dɨːðsadʊn
amguedd	amɡɨ̞ɛð
lloegr newydd	ɬɔɨ̯ɡərnɛu̯ɨ̞ð
gwsberen	ɡʊsbɛran
thrwydded	θrʊɨ̯ðad
cad	kaːd
twrw	tʊru
piclau	pɪklaɨ̯
amanita benfelen	amanɪtabɛnvɛlɛn
nghacen	ŋ̊akan
talwn	talʊn
gwennol	ɡwɛnɔl
beicio	bei̯kɔ
gan	ɡɪn
iselder ysbryd	ɪsɛldarəsbrɨ̞d
aros	arɔs
ar gyfer	arɡəvɛr
cnuchio	knɨ̞χjɔ
brwydrwr	brʊɨ̯drʊr
charo	χarɔ
dwrci	dʊrki
unigryw	ɨ̞nɪɡrɪu̯
chwerwddwr	χwɛrwðʊr
echdoe	ɛχdɔɨ̯
nghwestiwn	kwɛsdjʊn
offeiriad	ɔfəi̯rjad
bwyty	bʊɨ̯tɨ̞
physgodyn	fəsɡɔdɨ̯n
hogiau	hɔɡjɛ
brëyr	breːɨ̞r
threisiwr	θrei̯ʃʊr
hiach	hjaːχ
cadernid	kadɛrnid
gacen	ɡakan
cyfrifoldebau	kəvrɪvɔldɛbɛ
braenu	brei̯ni
sgydau	sɡədaɨ̯
caeth	kaːɨ̯θ
llan	ɬan
peiriannau llungopïo	pei̯rjanaɨ̯ɬɨ̞ŋɡɔpiːɔ
golau	ɡɔlaɨ̯
achos	χɔs
seddi	sɛði
dynladdiad	dɨːnlaðjad
pafin	pavɪn
dyfarnwr	dəvarnʊr
cyfrol	kəvrɔl
nwylo	nʊɨ̯lɔ
llwnc	ɬʊŋk
afalau cariad	avalɛkarjad
peis	peis
ngoleuadau	ŋɔleɨ̯adɛ
adio	adjɔ
heuldro'r haf	heɨ̯ldrɔrhaːv
cont	kɔnt
iyrchod	jərχɔd
lemwn	lɛmʊn
ddefnyddio	ðɛvnəðjɔ
ogledd	ɔɡlɛð
cwpaneidiau	kʊpanei̯djaɨ̯
clicio	klɪkɔ
geisio	ɡei̯ʃɔ
nghyngor	ŋ̊əŋɔr
talen	talɛn
ffraegar	freɨ̯ɡar
picau bach	pɪkaɨ̯baːχ
ysbrydoli	əsbrədɔli
gwregys	ɡwrɛɡɨ̞s
sylwebu	səlwɛbɨ
hoffest	hɔfɛsd
adflasau	advlasa
eirinen wlanog	ei̯rɪnaŋwlanɔɡ
dyrnfedd	dərnvɛð
cot	kɔt
lesau	lɛsaɨ̯
sosban	sɔsban
arolygiaeth	arɔləɡjaɨ̯θ
creision ŷd	krei̯ʃɔnɨːd
nhŷ	n̥ɨː
alla	aɬa
coel	koːɨ̯l
geiriadurwyr	ɡei̯rjadɨ̞rwɨ̞r
tyllau	təɬa
terfyniad	tɛrvənjad
melen	mɛlɛn
teyrnas	teɨ̯rnas
gwyddau	ɡʊɨ̯ðaɨ̯
rhanddeiliaid	r̥anðei̯ljɛd
ymerodraeth	əmɛrɔdraɨ̯θ
rheolau	r̥ɛɔla
reis	rei̯s
masg	masɡ
rhwydwaith	r̥ʊɨ̯dwɛθ
brecwast	brɛkwast
gaffed	ɡafɛd
elent	ɛlɛnt
nos iau	noːʃaɨ̯
tir	tiːr
recriwtiaid	rɛkrɪu̯tjai̯d
lleuen	ɬeɨ̯an
troi	trɔi̯
cusanau	kɨ̞sanaɨ̯
tri ar ddeg	triːarðeːɡ
phethau	fɛθaɨ̯
pencampwriaeth	pɛŋkampʊrjaɨ̯θ
digalon	dɪɡalɔn
mamau	mama
celen	kɛlɛn
sgwd	sɡuːd
caer gwydion	kaːɨ̯rɡwədjɔn
cerdded	kɛrðɛd
chi	χiː
hynt san ialm	hɨ̞ntsanjalm
corhedydd	kɔrhɛdɨ̞ð
hoyw	hɔɨ̯u
helciaid	hɛlkjɛd
gylchgrawn	ɡəlχɡrau̯n
adweithegydd	adwei̯θɛɡɨ̞ð
cyfrifiant	kəvrɪvjant
elin	ɛlɪn
mynnu	məni
saethyddiaeth	seɨ̯θəðjaɨ̯θ
caergaint	kaɨ̯rɡai̯nt
tre	treː
car	kar
cod post	koːdpoːsd
dynion	dənjɔn
wfft	ʊfd
gusanau	ɡɨ̞sanɛ
bei	bei
olifs	ɔlɪvs
gyddfau	ɡəðva
toiledau	tɔi̯lɛdɛ
trodd	troːð
hugain	hɪɡai̯n
ffeindiaf	fɪndja
ymateb	əmatɛb
adaryddiaeth	adarəðjɛθ
blogiau	blɔɡja
cydweithredwr	kɨːdwei̯θrɛdʊr
cwestau	kwɛsda
gadawed	ɡadau̯ɛd
tâp masgio	taːpmasɡjɔ
diweddar	dɪu̯ɛðar
bedwen	bɛdwan
naet	naːi̯t
streiciau	sdrei̯kja
ffrancwr	fraŋkʊr
marchogaeth	marχɔɡɛθ
dyngarol	dəŋɡarɔl
hais	hais
pin	pɪn
dynn	dɨ̞n
teisen gri	tei̯sɛŋɡriː
dydd iau	dɨːðjaɨ̯
nos sul	nɔssɨːl
poenit	pɔɨ̯nɪt
ychydig	χədɨ̞ɡ
serch	sɛrχ
argraffydd	arɡrafɨ̞ð
fil	viːl
mlodau	mlɔda
cnau	knaɨ̯
cyfiawnhad	kəvjau̯nhaːd
allforwyr	aɬvɔrwɨ̞r
darlithio	darlɪθjɔ
cael	kaːɨ̯l
mwyar	mʊɨ̯ar
ngweriniaethau	ɡwɛrɪnjeɨ̯θa
wng	ʊŋ
bath	baːθ
pendrist	pɛndrɪsd
nythfeydd	nəθveɨ̯ð
cacwn meirch	kakʊmmei̯rχ
arwerthiannau	arwɛrθjanɛ
wyau	ʊi̯a
heulsaf	heɨ̯lsav
ngheir	ŋ̊ei̯r
condemnio	kɔndɛmnjɔ
adlynol	adlənɔl
daeth	daːɨ̯θ
cyfrwyo	kəvrʊɨ̯ɔ
enillion	ɛnɪɬjɔn
huawdl	hɨːau̯dl
cyfieithu	kəvjei̯θɨ
gorau	ɡɔraɨ̯
gwrthiselyddion	ɡʊrθɪsɛləðjɔn
ymherodr	əmhɛrɔdr
chwrdd	χʊrð
swllt	suːɬd
threfydd	θrɛvɨ̞ð
gellid	ɡɛɬɪd
ychydig	əχədɨ̞ɡ
cyhydnos yr hydref	kəhədnɔsərhədra
olwyn	ɔlwɨ̞n
terfynau	tɛrvənɛ
gedy	ɡɛdɨ
winoedd	wɪnɔɨ̯ð
mleiddiau	mlei̯ðja
terfysgoedd	tɛrvəsɡɔɨ̯ð
aberdaugleddau	abɛrdaɨ̯ɡlɛða
amod	amɔd
mwcws	mʊkʊs
dileu	dɪleɨ̯
mhant	m̥ant
drysfa	drəsva
dest	dɛsd
ddathlu	ðaθlɨ
gwerth	ɡwɛrθ
mrawd	mrau̯d
bu	bɨː
gweinyddwyr	ɡwei̯nəðwɨ̞r
cythraul	kəθral
gweriniaeth	ɡwɛrɪnjaɨ̯θ
bwced	bʊkɛd
drysni	drəsni
thali	θali
gwyched	ɡwəχɛd
oriau	ɔrjɛ
frain	vrai̯n
trydedd	trədɛð
ffrainc	frai̯ŋk
cysylltu	kəsəɬdɨ
anobeithiau	anɔbei̯θjaɨ̯
main	mai̯n
dibwys	dɪbʊɨ̯s
estron	ɛsdrɔn
erchi	ɛrχi
caerhirfryn	kaɨ̯rhɪrvrɨ̞n
colli	kɔɬi
cydseiniol	kɨːdsei̯jɔl
melynion	mɛlənjɔn
eangderau	ɛaŋdɛra
gafas	ɡavas
urddau	ɨ̞rðɛ
enghraifft	ɛŋ̊rai̯fd
cyrraedd	kəraɨ̯ð
cywyddau	kəwəðaɨ̯
ymladdfeydd	əmlaðveɨ̯ð
orsaf	ɔrsav
amrywio	amrɪu̯jɔ
dechrau	dɛχrɛ
tlodion	tlɔdjɔn
nos fercher	nɔsvɛrχɛr
peintiau	pei̯ntjaɨ̯
ngafr	ŋavr
archeb	arχɛb
mara	mara
nghanwr	ŋ̊anʊr
gelyn	ɡɛlɨ̞n
terfynau	tɛrvəna
morwennol	moːrwɛnɔl
telyn deires	tɛlɨndei̯rɛs
rhaith	r̥ai̯θ
telynor	tɛlənɔr
gwlanog	ɡwlanɔɡ
rywsut	rɨu̯sɨ̞t
mefus	mɛvɨ̞s
ystafell	sdavɛɬ
prydael	prədaɨ̯l
gythraul	ɡəθraɨ̯l
màs	mas
norwy	nɔrʊɨ̯
sawsiau	sau̯ʃaɨ̯
thrwyddedau	θrʊɨ̯ðɛdaɨ̯
lesddeiliaid	leːsðei̯ljɛd
anfon	anvɔn
hymenyn	həmɛnɨ̞n
to	toː
efallai	vaɬɛ
ras	raːs
dienw	diɛnʊ
gyfarfod	ɡwarvɔd
mynychu	mənəχɨ
buddugwyr	bɨ̞ðɨ̞ɡwɨ̞r
maestref	meɨsdrɛv
ydw	ədu
taflen	tavlɛn
chara	χara
posibil	pɔsɪbɪl
cofiem	kɔvjɛm
diwethaf	dɪu̯ɛθa
chly	χlɨː
cofnodi	kɔvnɔdi
nghanu	ŋ̊anɨ̞
nwyf	nuːɨ̯v
ticio	tɪkjɔ
'ma	ma
ffyn	fɨ̞n
ocsiynau	ɔkʃənaɨ̯
pa	paː
bryna	brəna
pedair	pɛdai̯r
cyhoeddus	kəhɔɨ̯ðɨ̞s
baidd	bai̯ð
peithiau	pei̯θjɛ
cangen	kaŋɛn
arolygwr	arɔləɡʊr
llesteiriannau	ɬɛsdei̯rjanaɨ̯
dadlau	dadlaɨ̯
picau maen	pɪkaɨ̯maːɨ̯n
sillafu	sɪɬavɨ
ffoniwch	fɔnjʊχ
wennol	wɛnɔl
had	haːd
aredig	arɛdɪɡ
fri	vriː
rhyddhaf	r̥əðhaːv
adargraffiadau	adarɡrafjadaɨ̯
ngogledd	ŋɔɡlɛð
macamwn	makamʊn
stafell	sdavaɬ
hwnnw	hʊnu
addoliad	aðɔljad
caergrawnt	kaɨ̯rɡrau̯nt
pwy	puːɨ̯
lanhau	lanhaɨ̯
meddiannu	mɛðjanɨ
allt	aːɬd
wychach	wəχaχ
gawn	ɡau̯n
dail	dai̯l
rhyngrwyd	r̥əŋrʊɨ̯d
cyfnodol	kəvnɔdɔl
silff	sɪlf
alban hefin	albanhɛvɪn
air	ai̯r
adfywiadau	advɨ̞u̯jadɛ
chastell	χasdaɬ
iesu grist	jɛsɨɡriːst
ble wyt ti'n byw	bleːuːɨ̯ttɨːnbɪu̯
droed	droːɨ̯d
cynnar	kənar
adfywiadau	advɨ̞u̯jada
nhelynor	n̥ɛlənɔr
nitrogen	nɪtrɔɡɛn
chwery	χwɛrɨ
mil	miːl
bual	bɨ̞al
tegan anwes	tɛɡananwɛs
cyfair	kəvai̯r
deildai	dei̯ldai̯
llinos	ɬɪnɔs
ymladdwyr	əmlaðwɨ̞r
syndodau	səndɔdɛ
cara	kara
wystl	wɨ̞sdl
murddun	mɨ̞rðɨ̞n
achyddiaeth	aχəðjɛθ
fleiddiaid	vlei̯ðjɛd
teitlau	tei̯tla
gwylogod	ɡʊɨ̯lɔɡɔd
thatws	θatʊs
nhelynores	n̥ɛlənɔras
angylesau	aŋəlɛsa
cyffylog	kəfəlɔɡ
iddynt	ɪðɨ̞nt
mhryfed	m̥rəvɛd
arwynebedd	arwɨ̞nɛbɛð
rhinart	r̥ɪnart
marchgacynen	marχɡakənɛn
wddf	ʊðʊv
thalent	θalɛnt
ehangach	ɛhaŋaχ
mercwri	mɛrkʊri
meddai	mɛðai̯
obeutu	ɔbeɨ̯tɨ̞
pêr	peːr
talais	talɛʃ
mefusen	mɛvɨ̞sɛn
delen	dɛlɛn
siocled poeth	ʃɔklɛdpoːɨ̯θ
pobol	pɔbɔl
dosbarthwr	dɔsbarθʊr
mefusa	mɛvɨ̞sa
chefn	χɛvn
afr	avr
bydd	bɨːð
economegydd	ɛkɔnɔmɛɡɨ̞ð
sychnentydd	səχnɛntɨ̞ð
chwip	χwɪp
pell	pɛɬ
addolgar	aðɔlɡar
asgwrn	asɡʊrn
busnes	bɨ̞snas
yr euog a ffy heb neb yn ei erlid	əreɨ̯ɔɡafɨːhɛbneːbəneiɛrlɪd
w	uː
taranu	taranɨ̞
nhu	n̥ɨː
garnau	ɡarnɛ
gwlad yr iâ	ɡwlaːdərjaː
mewngofnodi	mɛu̯ŋɡɔvnɔdi
ryddhaf	rəðhaːv
teifi	tei̯vi
dydw i ddim yn siarad y saesneg	dəduiðɪmənʃaradəsəisnɛɡ
briallu	brɪaɬɨ̞
organig	ɔrɡanɪɡ
paneidiau	panei̯dja
achwyniadau	aχʊɨ̯njada
mynachlog	mənaχlɔɡ
hardaloedd	hardalɔɨ̯ð
cyfansymiau	kəvansəmjaɨ̯
amanita	amanɪta
cyfiawnhau	kəvjau̯nhaɨ̯
flwyddi	vlʊɨ̯ði
campfa	kampva
pâr minimol	paːrmɪnɪmɔl
byr	bɨ̞r
sêls	seːls
cartref	kartra
pethau	pɛθɛ
boptai	bɔptai̯
beirniadaethau	bei̯rnjadeɨ̯θɛ
cynuta	kənɨ̞ta
gimbill	ɡɪmbɪɬ
hamod	hamɔd
cerwch	kɛrʊχ
adfeddiannu	advɛðjanɨ
ychwanegu	əχwanɛɡɨ
teimlad	tei̯mlad
nghroes	ŋ̊roːɨ̯s
chwech	χweːχ
adref	adrɛ
pawr	pau̯r
bras	braːs
habaty	habatɨ
technoleg gwybodaeth	tɛχnɔlɛɡɡwɨ̞bɔdaɨ̯θ
roeg	roːɨ̯ɡ
unfed ar ddeg	ɨ̞nvɛdarðeːɡ
trengholiadau	trɛŋhɔljadaɨ̯
ywen	ɨ̞u̯ɛn
bethau	bɛθa
eiddgar	ei̯ðɡar
dyfarniadau	dəvarnjada
dolffin	dɔlfɪn
ewythr	ɛu̯ɨ̞θr
colled	kɔɬɛd
nghapel	ŋ̊apɛl
cymysg	kəmɨ̞sɡ
planhigyn	planhɪɡɨ̞n
rhwygo	r̥ʊɨ̯ɡɔ
arddelw	arðɛl
cyngyd	kəŋɡɨ̞d
tudalen	tɨ̞dalan
echlysur	ɛχləsɨ̞r
cadach	kadaχ
hirgron	hɪrɡrɔn
latfia	latvja
saws	sau̯s
trenau	trɛnaɨ̯
goddef	ɡɔðɛ
undeg	ɨ̞ndɛɡ
garw	ɡaru
eirin mair	ei̯rɪmmai̯r
wybodaeth	wəbɔdaɨ̯θ
dorrent	dɔrɛnt
cafon	kavɔn
gweddïwr	ɡwɛðɪʊr
gwrthwynebiadau	ɡʊrθwɨ̞nɛbjadɛ
gorau	ɡɔra
llawn	ɬau̯n
pyliau	pəljɛ
achles	aχlɛs
bathdy	baθdɨ̞
chul	χɨːl
thelynores	θɛlənɔras
cenhinen	kɛnhɪnɛn
garej	ɡarɛdʒ
nyrs	nərs
marchgacwn	marχɡakʊn
gwiwer	ɡwɪu̯ɛr
merlod	mɛrlɔd
rhif	r̥iːv
dre	dreː
breuddwyd	breɨ̯ðʊɨ̯d
nghot	ŋ̊ɔt
adenedigaeth	adɛnɛdɪɡaɨ̯θ
lloegr	ɬɔɨ̯ɡr
trefydd	trɛvɨ̞ð
choeg	χoːɨ̯ɡ
baith	bai̯θ
telynau teires	tɛlənatei̯rɛs
digwyddaf	dɪɡwəðaf
crychau	krəχaɨ̯
brynu	brənɨ
ffrind	frɪnd
sychu	səχɨ
droet	droːɨ̯t
ellyn	ɛɬɨ̞n
ynys wyth	ənɨ̞suːɨ̯θ
magu	maɡɨ
buddugol	bɨ̞ðɨ̞ɡɔl
llesteirio	ɬɛsdei̯rjɔ
ufelai	ɨ̞vɛlai̯
ethrefig	ɛθrɛvɪɡ
ganwr	ɡanʊr
pumongl	pɨ̞mɔŋl
hiarll	hjarɬ
fo	voː
ganai	ɡanai̯
ceg	keːɡ
credant	krɛdant
siani	ʃanɪ
teisen radell	tei̯ʃɛnradɛɬ
henghraifft	hɛŋ̊rɛfd
cwyd	kuːɨ̯d
pandemig	pandɛmɪɡ
difetha	dɪvɛθa
banc	baŋk
pryfed genwair	prəvadɡɛnwar
unigrywiaeth	ɨ̞nɪɡrɨ̞u̯jɛθ
priod	priɔd
nghaint	ŋ̊ai̯nt
helpwr	hɛlpʊr
anafais	anavɪʃ
cipio	kɪpjɔ
cyfryngau	kəvrəŋaɨ̯
liwio	lɪu̯jɔ
bricsen	brɪksan
cwlwm	kʊlʊm
ymgloi	əmɡlɔi̯
ffurf	fɨ̞rv
ymddengys	əmðɛŋɨ̞s
ywen	ɪu̯ɛn
ngwystl	ŋwɨ̞sdl
sesiynau	sɛʃənɛ
clefyd y gwair	klɛvɨ̞dəɡwai̯r
cyflafaredd	kəvlavarɛð
abades	abadɛs
cansen	kansɛn
ysbrydol	əsbrədɔl
nghôt	ŋ̊oːt
gyda	da
ngeiriadurwr	ŋei̯rjadɨ̞rʊr
hen galan	heːnɡalan
nhraed	n̥raːɨ̯d
blwch	bluːχ
aberystwyth	abɛrəstwɨ̞θ
mynydda	mənəða
prifiau	prɪvjɛ
bendith	bɛndɪθ
gwyrddion	ɡwərðjɔn
frechdan	vrɛχdan
pioden	piɔdɛn
aillt	ai̯ɬd
nghaws	ŋ̊au̯s
rhwyfau	r̥ʊɨ̯vɛ
athrawes	aθrau̯as
seibiau	sei̯bjaɨ̯
blwyddyn golau	blʊɨ̯ðɨ̞nɡɔla
ffion	fɪɔn
gwrthryfeloedd	ɡʊrθrəvɛlɔɨ̯ð
sudd	sɨːð
hir	hiːr
ar daith	ardai̯θ
nghlybiau	ŋ̊ləbjaɨ̯
chlustdlws	χlɨ̞sdlʊs
ngharafán	ŋ̊aravan
cwblhau	kʊblhaɨ̯
gref	ɡreːv
carfilod bach	karvɪlɔdbaːχ
cynhesu	kənhɛsɨ
asid	asɪd
pasiaf	paʃav
mhyliau	m̥əljɛ
well	wɛɬ
canoli	kanɔli
yma	əma
ti'n iawn	tiːnjau̯n
lan	lan
swshi	sʊʃi
egwyl	ɛɡʊɨ̯l
peiriannau llungopïo	pei̯rjanaɨ̯ɬɨːŋɡɔpiːɔ
crëwr	krɛʊr
warysau	warəsaɨ̯
raced	rakɛd
gorchmynnol	ɡɔrχmənɔl
rhestrau	r̥ɛsdrɛ
niweidio	nɪu̯ei̯djɔ
basen	sɛn
rhwystredigaethau	r̥ʊɨ̯sdrɛdɨ̞ɡeɨ̯θaɨ̯
regen	rɛɡɛn
penderfynu	pɛndɛrvənɨ
iddi	ɪði
nentydd	nɛntɨ̞ð
briciau	brikjaɨ̯
gyrrwr	ɡərʊr
melltithion	mɛɬdɪθjɔn
bleiddiaid	blei̯ðjɛd
arth fwyaf	arθvʊɨ̯av
sos	soːs
ewythr	ɛu̯ɨ̞rθ
ngweriniaeth	ŋwɛrɪnjɛθ
cristionogion	krɪsdjɔnɔɡjɔn
trannoeth	tranɔɨ̯θ
fleiddiaid	vlei̯ðjai̯d
cwtsio	kʊtʃɔ
rydw i'n dy garu di	rədʊi̯ndəɡaridiː
nghath	ŋ̊aːθ
adfydau	advəda
annedd	anað
ffarm	farm
long	lɔŋ
anfantais	anvantɛs
corryn	kɔrɨ̞n
ieithoedd	jei̯θɔɨ̯ð
cyfan	kəva
buan	bɨ̞an
mellten	mɛɬdan
alban arthan	albanarθan
rywle	rʊlɛ
wyau	ʊɨ̯aɨ̯
am	am
bryngaer	brəŋɡaɨ̯r
lleoli	ɬɛɔli
cadwch	kadʊχ
llaered	ɬeɨ̯rɛd
hangen	haŋan
gweddïon	ɡwɛðɪɔn
huna	hɨ̞na
affwysedd	afʊɨ̯sɛð
cnud	knɨːd
deilen	dei̯lan
elir	ɛlɪr
adaregol	adarɛɡɔl
adferiad	advɛrjad
migwrn	mɪɡʊrn
merfenw	mɛrvɛnu
glywed	ɡləu̯ɛd
hyn i gyd	hɨ̞niɡiːd
rheiddiau	r̥ei̯ðjaɨ̯
hydref	hədra
ocr	ɔkr
finegr	vɪnɛɡr
gacha	ɡaχa
ni	niː
gwallt	ɡwaːɬd
llinell	ɬɪnɛɬ
brechdan	brɛχdan
angen	aŋɛn
glyn	ɡlɨ̞n
prif	priːv
cen y coed	kɛnəkoːɨ̯d
unllygeidiog	ɨːnɬəɡei̯djɔɡ
o flaen	ɔvlaːɨ̯n
cyhyd	kəhɨ̞d
cerir	kɛrɪr
yf	ɨːv
gwenynen	ɡwenənan
bychod	bəχɔd
anghlodwiw	aŋhlɔdwɪu̯
teisen radell	tei̯sɛnradɛɬ
pedolwyr	pɛdɔlwɨ̞r
dduw	ðɨu̯
aseswyr	asɛswɨ̞r
genweiriau	ɡɛnwei̯rjɛ
hadu	hadɨ̞
nghais	ŋ̊ai̯s
trefedigaethau	trɛvɛdɪɡeɨ̯θɛ
nodwydd	nɔdwɨ̞ð
llwchwr	ɬʊχʊr
grilio	ɡrɪljɔ
nheisen	n̥ei̯san
ambiwlans	ambɪu̯lans
llesteiriau	ɬɛsdei̯rjaɨ̯
hangen	haŋɛn
absenoldeb	absɛnɔldab
perthyn	pɛrθɨ̞n
ych	ɨːχ
dadiol	dadjɔl
canwr	kanʊr
allan	aɬan
ffenestr	fɛnɛsdr
melyn	mɛlɨ̞n
cynhennus	kənhɛnɨ̞s
twymo	tʊɨ̯mɔ
ges	ɡeːs
teithio	tei̯θjɔ
caerwrangon	kaɨ̯rwraŋɔn
wyth	uːɨ̯θ
gwanwynau	ɡwanwəna
ân	aːn
gythraul	ɡəθral
gaeafgysgu	ɡeɨ̯avɡəsɡɨ
galar	ɡalar
tâp selo	taːpsɛlɔ
gwlad pwyl	ɡwlaːdpuːɨ̯l
moes	moːɨ̯s
adref	adrɛv
melys	mɛlɨ̞s
synnu	sənɨ
corhwyad	kɔrhʊɨ̯ad
yfed	əvad
ymddiddan	əmðɪðan
pwll	pʊɬ
plentyn	plɛntɨ̞n
sbwriel	sbʊrjal
paentiau	peɨ̯ntjaɨ̯
cenedlaethol	kɛnɛdleɨ̯θɔl
sadwrn	sadʊrn
aeron	eɨ̯rɔn
phwl	fʊl
aller	aɬɛr
gweinyddiaethau	ɡwei̯nəðjeɨ̯θa
clust	klɨːst
delir	dɛlɪt
siocled	ʃɔklɛd
rhwystrau	r̥ʊɨ̯sdra
picwnen	pɪkuːnɛn
siôn corn	ʃoːŋkɔrn
ydau	əda
nghant	ŋ̊ant
dei	dei̯
gall	ɡaɬ
chyfarfod	χəvarvɔd
menig	mɛnɪɡ
sgrech	sɡreːχ
lygaid	lɨ̞ɡai̯d
ci	kiː
milwr	mɪlʊr
drôn	droːn
iäaidd	jaai̯ð
achwyniadau	aχʊɨ̯njadaɨ̯
canen	kanɛn
taen	taːɨ̯n
agosáu	aɡɔsaɨ̯
pentref	pɛntrɛv
chlywed	χləu̯ad
eilir	ei̯lɪr
allwedd	aɬwɛð
dathlu	daθlɨ
galwes	ɡalwɛs
cartre	kartra
madfallod dŵr	madvaɬɔdduːr
tafarn	tavarn
paham	paham
sero	sɛrɔ
barbeciwiau	barbɛkɪu̯ja
iytan	jətan
ar hyn o bryd	arhɨ̞nɔbrɨːd
ngwledydd	ŋwlɛdɨ̞ð
nghneuen gyll	ŋ̊neɨ̯anɡɨ̞ɬ
brawychus	brau̯əχɨ̞s
ffôi	foːi̯
thegan	θɛɡan
mêt	meːt
bôn	boːn
froch	vroːχ
amrywiaeth	amrɪu̯jɛθ
talo	talɔ
roeddet	rɔɨ̯ðat
ofnadwy	ɔvnadu
blodyn	blɔdɨ̞n
dydd gwener	dɨ̞ɡwɛnar
penillion	pɛnɪɬjɔn
modrwy	mɔdrʊɨ̯
symudliw	səmɨ̞dlɪu̯
nghefnau	ŋ̊ɛvna
throi	θrɔi̯
hawdd	hau̯ð
gŵyr	ɡuːɨ̯r
nghefnau	ŋ̊ɛvnaɨ̯
hyrddod	hərðɔd
gorsaf	ɡɔrsav
ngelli	ŋɛɬɪ
iselyddion	ɪsɛləðjɔn
achub	aχɨ̞b
cyfrifeg	kəvrɪvɛɡ
coma	kɔma
holl	hoːɬ
doliau	dɔlja
delynor	dɛlənɔr
digwydd	dɪɡwɨ̞ð
gruga	ɡrɨ̞ɡa
cotiau	kɔtjɛ
gwrando	ɡwrandɔ
tatŵ	tatuː
arfau	arva
rhuddwyn	r̥ɨ̞ðwɨ̞n
weithiau	wei̯θjɛ
marnau	marnɛ
cbac	kbak
eglwys	ɛɡlʊɨ̯s
barbeciwiau	barbɛkɪu̯jaɨ̯
êl	eːl
rhwystredigaethau	r̥ʊɨ̯sdrɛdɨ̞ɡeɨ̯θɛ
gormod	ɡɔrmɔd
rhywiol	r̥ɪu̯jɔl
pig	piːɡ
cwsmer	kʊsmar
animeiddiadau	anɪmei̯ðjjadɛ
mis	miːs
llydaw	ɬədau̯
dyfynnod	dəvənɔd
mellten	mɛɬdɛn
eid	ei̯d
penfras	pɛnvras
bencampwr	bɛŋkampʊr
chwningen	χʊnɪŋan
ddal	ðal
rhieni	r̥jɛni
ymasiad	əmaʃad
twr	tʊr
daliadaeth	daljadaɨ̯θ
acen	akɛn
rheolydd	r̥ɛɔlɨ̞ð
chlywed	χləu̯ɛd
safon	savɔn
dau ar bymtheg	daɨ̯arbəmθɛɡ
cherddoriaeth	χɛrðɔrjɛθ
plwm	plʊm
mron	mrɔn
cydgordio	kɨ̞dɡɔrdjɔ
cam	kam
elych	ɛlɨ̞χ
fforch	fɔrχ
carafáns	karavans
llanc	ɬaŋk
byth	bɨːθ
ofer	ɔvɛr
magnelau	maɡnɛlaɨ̯
jaciau	dʒakjɛ
düwch	dɨːʊχ
byddar	bəðar
gwrthrych	ɡʊrθrɨ̞χ
ydy	əndi
ansoddair	ansɔðai̯r
cwestiynau	kwɛsdjənɛ
wociau	wɔkja
geni	ɡɛnɪ
do'n	doːn
adeiladu	adei̯ladɨ̞
talan	talan
esgyll	ɛsɡɨ̯ɬ
toesen	tɔɨ̯sɛn
digoni	dɪɡɔni
mollt	moːɬd
sgrin	sɡriːn
unigryw	ɨ̞nɪɡrɨu̯
berfenwau	bɛrvɛnwɛ
welsh cêc	wɛlʃkeːk
chwinciad	χwɪŋkjad
cofbin	kɔvbɪn
punt	pɨ̞nt
mathemateg	maθɛmatɛɡ
teirw	tei̯ru
bleiddiaid	blei̯ðjai̯d
poster	pɔsdɛr
hunanynysu	hɨnanənəsɨ
rhofio	r̥ɔvjɔ
mhobl	m̥ɔbl
egni	ɛɡni
dringo	drɪŋɔ
dde	ðeː
fôn	voːn
tyrrau	təraɨ
ffurfio	fɨ̞rvjɔ
trydanwyr	trədanwɨ̞r
hynod	hənɔd
taw	ta
adwaenom	adweɨ̯nɔm
cyfamser	kəvamsɛr
cochlas	kɔχlas
tebygol	tɛbəɡɔl
gemau	ɡɛma
habadau	habada
thwymyn	θʊɨ̯mɨ̞n
faint o'r gloch	vai̯ntoːrɡloːχ
cylchu	kəlχɨ
rhyngrwyd pethau	r̥əŋrʊɨ̯dpɛθa
meddw	mɛðu
nal	nal
garen	ɡarɛn
camsefyll	kamsɛvɨ̞ɬ
nghlybiau	ŋ̊ləbja
pryf genwair	prɨːɡɛnwar
ofyn	ɔvɨ̞n
colur	kɔlɨ̞r
mwng	mʊŋ
lleua	ɬeɨ̯a
gordd	ɡɔrð
ieuenctid	jeɨɛŋktɪd
annedd	anɛð
llychlyn	ɬəχlɨ̞n
anffodus	anfɔdɨ̞s
gwybodaeth	ɡwɨ̞bɔdaɨ̯θ
dihuno	dɪhɨ̞nɔ
doeddet	dɔɨ̯ðat
hwngari	hʊŋɡri
prifddinas	priːvðɪnas
siaced	ʃakɛd
p'nawn	pnau̯n
timau	tɪma
terfysg	tɛrvɨ̞sɡ
niod	niːɔd
darian	darjan
ngŵydd	ŋuːɨ̯ð
anafes	anavɛs
arholi	arhɔlɪ
debyg	dɛbɨ̞ɡ
seithongl	sei̯θɔŋl
nghythraul	ŋ̊əθraɨ̯l
cwsmeriaid	kʊsmɛrjai̯d
mhopty	m̥ɔptɨ
cyfryngau	kəvrəŋɛ
rhoi	r̥ɔi̯
chweched	χwɛχɛd
dangos	daŋɔs
iolo	jɔlɔ
bryste	brɨ̞stɛ
bermo	əbɛrmɔ
allo	aɬɔ
siôn	ʃoːn
sbectol	sbɛktɔl
nghalon	ŋ̊alɔn
afonfeirch	avɔnvei̯rχ
rhaglen	r̥aɡlan
bysgota	bəsɡɔta
pair	pai̯r
aethon	eɨ̯θɔn
llithro	ɬɪθrɔ
doniol	dɔnjɔl
mamoth gwlanog	mamɔθɡwlanɔɡ
imi	ɪmi
ddwylo	ðʊɨ̯lɔ
peniadau	pɛnjada
bore	bɔra
hoffet	hɔfɛt
llywio	ɬɨu̯jɔ
ffwrcho	fʊrχɔ
yfory	vɔrɨ
protestaniaeth	prɔtɛsdanjɛθ
adra	adra
sudd afal	sɨːðaval
gwenithfaen	ɡwɛnɪθvaɨ̯n
cymro	kəmrɔ
problem	prɔblɛm
heol y gwynt	heːɔləɡwɨ̞nt
hych	hɨːχ
llungopïau	ɬɨ̞ŋɡɔpiːa
gar	ɡar
weriniaethau	ɡwɛrɪnjeɨ̯θaɨ̯
gwchi	ɡʊχi
cyfraith	kəvrai̯θ
oren	ɔrɛn
pasio	paʃɔ
rhanbarthau	r̥ambarθɛ
hechryd	hɛχrɨ̞d
byw	bɨu̯
bwyd	buːɨ̯d
weithiau	wei̯θja
ffonion	fɔnjɔn
tyngedfenyddiaeth	təŋɛdvɛnəðjaɨ̯θ
alban	alban
macydelgi	makədɛlɡi
rhynion	r̥ənjɔn
cŵn	kuːn
mys	miːs
negesydd	nɛɡɛsɨ̞ð
phapur	fapɨ̞r
medren	mɛdrɛn
trawstrefa	trau̯sdrɛva
byddai	bəðai̯
deiliad	dei̯ljad
swyddogaeth	sʊɨ̯ðɔɡaɨ̯θ
taliff	talɪf
adeiladwyr	adei̯ladwɨ̞r
saesneg	sɨ̞snɛɡ
flodau	vlɔda
cen pen	kɛnpɛn
eirinen ysgaw	ei̯rɪnanəsɡau̯
croeniog	krɔɨ̯njɔɡ
phaned	fanad
tywodfaen gwyrdd	təu̯ɔdθvaɨ̯nɡwɨ̞rð
mas	maːs
credet	krɛdɛt
dydd sadwrn	dɨ̞ðsadʊn
hanes	hanas
crog	kroːɡ
dŷ	dɨː
ogof	ɔɡɔv
lun	lɨːn
gwerddon	ɡwɛrðɔn
rhanddeiliad	r̥anðei̯ljad
arolygiadau	arɔləɡjada
fedra	vɛdra
seiclo	sei̯klɔ
gwybed	ɡwəbɛd
caniau	kanja
ymlacio	əmlakjɔ
harbwr	harbʊr
crwydr	krʊɨ̯dr
yr	ər
toiledau	tɔi̯lɛdaɨ̯
archseren	arχsɛrɛn
cof	koː
salm	salm
dirmygu	dɪrməɡɨ
phrif	friːv
cewri	kɛu̯ri
paith	pai̯θ
gael	ɡaːɨ̯l
dwylo	dʊɨ̯lɔ
pigau	pɪɡa
nghoch	ŋ̊oːχ
hudo	hɨ̞dɔ
rhaff	r̥aːf
ddiod	ðiːɔd
myfyrwyr	məvərwɨ̞r
basen	bəsan
blogiwr	blɔɡjʊr
iarll	jarɬ
mathau	maθa
pin	piːn
gostwng	ɡɔsdʊŋ
flog	vlɔɡ
anghymreigio	aŋhəmrei̯ɡjɔ
erchwyn	ɛrχwɨ̞n
deigr	dei̯ɡr
collen	kɔɬɛn
elw	ɛlu
caren	karɛn
meddai	mɛða
drwydded	drʊɨ̯ðad
methi	mɛθi
bancio	baŋkjɔ
nghynhadledd	ŋ̊ənhadlɛð
fersiwn	vɛrʃʊn
sw	suː
adfilwr	advɪlʊr
adardai	adardai̯
drwy	druːɨ̯
shrwmsa	ʃrʊmsa
sychin	səχɪn
gwaredu	ɡwarɛdɨ
record	rɛkɔrd
hendrefydd	hɛndrɛvɨ̞ð
abadaethau	abadeɨ̯θaɨ̯
llungopïau	ɬɨ̞ŋɡɔpiːaɨ̯
clywedog	kləu̯ɛdɔɡ
yno	ənɔ
mhapur	m̥apɨ̞r
adlefau	adlɛva
hufen	hɨ̞vɛn
ysgrifennu	sɡrɪvɛnɨ
arlwy	arluɨ̯
peiriannau arian parod	pei̯rjanaarjanparɔd
adael	adɛl
teisen gri	tei̯saŋɡriː
dales	dalɛs
'i	iː
pics	pɪks
golwr	ɡɔlʊr
ydfrain	ədvrai̯n
aderyn y bwn	adɛrɨ̞nəbʊn
sych	sɨːχ
rywbeth	rɪu̯bɛθ
pesto	pɛsdɔ
ngolau	ŋɔla
newynau	nɛu̯ənɛ
modd	moːð
torrai	tɔrai̯
dôn	doːn
anafa	anava
tocyn	tɔkɨ̞n
myned	mənɛd
gogledd	ɡɔɡlɛð
ffindir	əfɪndɪr
efwr	ɛvʊr
naen	naːi̯n
plethu	plɛθɨ
cylchoedd	kəlχɔɨ̯ð
allforyn	aɬvɔrɨ̞n
cari	karɪ
aeaf	eɨ̯av
grawnwin	ɡrau̯nwɪn
ffensiau	fɛnʃɛ
ffa	faː
geri	ɡɛrɪ
ciciau cosb	kɪkjɛɡoːsb
ydw	ndu
galla	ɡaɬa
labovaidd	labɔvai̯ð
rhwystr	r̥ʊɨ̯sdr
helpu	hɛlpɨ̞
warws	warʊs
pennau	pɛnaɨ̯
mhaned	m̥anɛd
gaeredin	ɡaɨ̯rɛdɨ̞n
copïwr	kɔpiːʊr
nghlyw	ŋ̊lɨu̯
pridd	priːð
dydd mercher	dɨːðmɛrχɛr
gylfinau	ɡəlvɪnɛ
gweplyfr	ɡwɛplɨ̞vr
cwyr	kuːɨ̯r
flodau	vlɔdɛ
dwyrain	dʊɨ̯rain
adardy	adardɨ̞
sgerbwd	sɡɛrbʊd
bwch	buːχ
gwylog	ɡʊɨ̯lɔɡ
harglwydd	harɡlʊɨ̯ð
arosfa	arɔsva
conwydden	kɔnwɨ̞ðɛn
ariannog	arjanɔɡ
derwyddiaeth	dɛrwəðjaɨ̯θ
tonau	tɔnaɨ̯
frith	vriːθ
nhalent	n̥alɛnt
llinynnau	ɬɪnənɛ
heirdd	hei̯rð
sylw	sɪlu
aethnenni	eɨ̯θnɛni
atseiniau	atsei̯njaɨ̯
trybedd	trəbɛð
ysgafnhad	əsɡavnhaːd
ugeiniau	ɪɡei̯njaɨ̯
aur	aɨ̯r
thal	θal
fwlgaria	vʊlɡarja
gelen	ɡɛlɛn
meddygfa	mɛðəɡva
habades	habadɛs
rasys	rasɨ̞s
nheisen	n̥ɪʃan
neiliaid	nei̯ljɛd
gemau	ɡɛmɛ
caen	kaːɨ̯n
wybodaeth	wəbɔdɛθ
plwyf	pluːɨ̯v
mygydau	məɡədɛ
mesa	mɛsa
hel	hɛl
emiw	ɛmɪu̯
symiau	səmja
ymladdfa	əmlaðva
gwrthgymdeithasol	ɡʊrθɡəmdei̯θasɔl
si	siː
pethach	pɛθaχ
nos sadwrn	nɔssadʊrn
awst	au̯sd
wddw	ʊðu
blwyddi	blʊɨ̯ði
sos coch	soːskoːχ
bryngaer	brɨ̞ŋɡaɨ̯r
trolïau	trɔlɪaɨ̯
ystradwel	əsdradwɛl
siomau	ʃɔma
nhewed	n̥ɛu̯ɛd
oddeutu	ɔðeɨ̯tɨ
chymaint	χəmai̯nt
defnyddiwr	dɛvnəðjʊr
chwaer	χwaːɨ̯r
rwsia	rʊsja
fenig	vɛnɪɡ
peiriannwr	pei̯rjanʊr
geilw	ɡei̯lu
ymesyd	əmɛsɨ̞d
faneg	vanɛɡ
edn	ɛdn
daflu	davlɨ
ddôn	ðoːn
llyfrgellwyr	ɬəvrɡɛɬwɨ̞r
daioni	dajɔni
prŷn	prɨːn
da	daː
flodau	vlɔdaɨ̯
golli	ɡɔɬi
dalet	dalɛt
âi	aːi̯
beirniadaeth	bei̯rnjadɛθ
gato	ɡatɔ
chewch	χɛu̯χ
anhawster	anhau̯sdɛr
tudalennau	tɨ̞dalɛnɛ
anffurfiol	anfɨ̞rvjɔl
sgil	sɡɪl
baw	baːu̯
bric	brɪk
adeg	adɛɡ
nglanaf	ŋlana
munud	mɨ̞nɨ̞d
echryd	ɛχrɨ̞d
canwyllbrennau	kanʊɨ̯ɬbrɛna
buwch	bɨu̯χ
deunyddiau	deɨ̯nəðjaɨ̯
drama	drama
nghlyw	ŋ̊lɪu̯
hysbys	həsbɨ̞s
wlad belg	wlaːdbɛlɡ
fodd	voːð
degau	dɛɡɛ
mlwyddi	mlʊɨ̯ði
nofiwr	nɔvjʊr
yn gymwys	əŋɡəmʊɨ̯s
diogel	djɔɡal
rhithweledigaeth	r̥ɪθwɛlɛdɪɡaɨ̯θ
goes	ɡoːɨ̯s
brasterog	brasdɛrɔɡ
mamoth	mamɔθ
eogiaid	ɛɔɡjɛd
cylchgrawn	kɨ̞lχɡrau̯n
doid	dɔi̯d
canlynol	kanlənɔl
cymorthion	kəmɔrθjɔn
cythreuliaid	kəθreɨ̯ljai̯d
ansawdd	ansau̯ð
malwota	malwɔta
llong foel	ɬɔŋvoːɨ̯l
nolis	nɔlɪs
caron	karɔn
gwrthwynebair	ɡʊrθwɨ̞nɛbai̯r
garan	ɡaran
gwrs	ɡʊrs
ambell	ambɛɬ
cyfiawn	kəvjau̯n
gwrdd	ɡʊrð
acw	aku
adfydau	advədɛ
oddf	ɔðv
ngherdded	ŋ̊ɛrðɛd
nglas	ŋlaːs
lloches	ɬɔχas
hil	hiːl
carreg	karɛɡ
llamhidog	ɬamhɪdɔɡ
mwgwd	mʊɡʊd
pobl	pɔbl
gobaith	ɡɔbɛθ
heibio	hei̯bjɔ
pabïau	pabiːa
lyfr	lɨ̞vɨ̞r
cyfatebiaethau	kəvatɛbjeɨ̯θa
cydweithrediadau	kɨːdwei̯θrɛdjadaɨ̯
o blith	oːbliːθ
trefor	trɛvɔr
letysen	lɛtəsɛn
leician	lei̯kjan
ddelo	ðɛlɔ
ffwrn	fʊrn
helbul	hɛlbɨ̞l
phobl	fɔbɔl
gwyrddsug	ɡwərðsɨ̞ɡ
mad	maːd
toiledi	tɔi̯lɛdi
gwybodaeth	ɡwəbɔdaɨ̯θ
saig	sai̯ɡ
deigryn	dei̯ɡrɨn
niwl	nɪu̯l
ap	ap
switsio	swɪtʃɔ
cheffyl	χɛfɨ̞l
fàs	vas
habadaeth	habadaɨ̯θ
emrallt	ɛmraɬd
oedd	oːɨ̯ð
swyddogaeth	sʊɨ̯ðɔɡɛθ
chneuen gyll	χneɨ̯anɡɨ̞ɬ
weld	wɛld
ngwys	ŋwɨːs
adleisiau	adlei̯ʃɛ
rhydychen	r̥ɨ̞dəχɛn
mygydau	məɡədaɨ̯
nico	nɪkɔ
dudno	dɨ̞dnɔ
physgod	fəsɡɔd
ergyd	ɛrɡɨ̞d
cydbreswylwyr	kɨːdbrɛsʊɨ̯lwɨ̞r
erbyn hyn	ɛrbɨ̞nhɨ̞n
epidemig	ɛpɪdɛmɪɡ
chei	χei̯
ateb	atɛb
stwrsiynod	sdʊrʃənɔd
nghwrdd	ŋ̊ʊrð
cocsa	kɔksa
gathod	ɡaθɔd
aiff	ai̯f
cydseiniol	kɨ̞dsei̯jɔl
hwythfed	hʊɨ̯θvad
trydanwr	trədanʊr
picau	pɪka
darianau	darjanɛ
garddwr	ɡarðʊr
grefi	ɡrɛvi
creda	krɛda
roeddwn	rɔɨ̯ðʊn
phenderfynu	fɛndɛrvənɨ
reiat	rei̯at
elont	ɛlɔnt
cosbau	kɔsba
meddiant	mɛðjant
phencampwriaeth	fɛŋkampʊrjaɨ̯θ
dydd sul	dɨːðsɨːl
llinell	ɬɪnaɬ
gwyrddfaen	ɡwərðvaɨ̯n
wedi hyn	wɛdihɨ̞n
teyrnged	teɨ̯rnɡɛd
basen	basan
gastell	ɡasdaɬ
llygaid	ɬəɡɛd
llyn	ɬɨ̞n
nghylchgrawn	ŋ̊ɨ̞lχɡrau̯n
perthi	pɛrθi
daliaf	daljav
banana	banana
gwahaniaeth	ɡwanjaθ
genedigaethau	ɡɛnɛdɪɡeɨ̯θa
ngwddw	ŋʊðu
nid wrth ei big y mae mesur cyffylog	nɪdʊrθei̯biːɡəmaːɨ̯mɛsɨ̞rkəfəlɔɡ
dyfarniadau	dəvarnjadaɨ̯
caint	kai̯nt
torrai	tɔrɛ
atalfeydd	atalveɨ̯ð
ffensiau	fɛnʃaɨ̯
rhod	r̥oːd
nyrsys	nərsɨ̞s
gachai	ɡaχɛ
haul	haɨ̯l
camu	kamɨ
mlwydd	mluːɨ̯ð
adeiladaeth	adei̯ladaɨ̯θ
tost	tɔst
teli	tɛli
glew	ɡlɛu̯
isteitl	iːsdei̯tl
defnyddiau	dɛvnəðjɛ
gweinyddiadau	ɡwei̯nəðjada
peiriant llungopïo	pei̯rjantɬɨ̞ŋɡɔpiːɔ
piau	piːaɨ̯
tewi	tɛu̯i
uchel	əχɛl
llyfu	ɬəvɨ
aden	adɛn
coeden afalau	kɔɨ̯danvala
pery	pɛrɨ
armenia	armɛnja
adlefau	adlɛvaɨ̯
llygaid	ɬɨ̞ɡai̯d
rhwng	r̥ʊŋ
blogiau	blɔɡjɛ
caro	karɔ
cactws	kaktʊs
fasen	vəsan
amaethyddiaeth	ameɨ̯θəðjɛθ
anghyflawn	aŋhəvlau̯n
genedigaethau	ɡɛnɛdɪɡeɨ̯θaɨ̯
cymylu	kəməlɨ
hofran	hɔvran
trywel	trəu̯ɛl
angharad	aŋharad
glasgoch	ɡlasɡɔχ
fadfall	vadvaɬ
ffeindio	fɪndjɔ
ydfran	ədvran
cannydd	kanɨ̞ð
disgybl	dɪsɡɨ̞bl
leidr	lei̯dr
chdi	χdiː
doeddet	dɔɨ̯ðɛt
caffi	kafi
benderfynu	bɛndɛrvənɨ
heddwch	hɛðʊχ
raser	rasɛr
hyd yn hyn	hɨːdənhɨ̞n
abertawe	abɛrtau̯ɛ
ricríwt	rikrɪu̯t
lyfrau	ləvraɨ̯
cryddiaeth	krəðjaɨ̯θ
chydbreswylwyr	χɨːdbrɛsʊɨ̯lwɨ̞r
ffilm	fɪlm
sut wyt ti	sɪtʊi̯ttiː
clwb	klʊb
dryslwyni	drəslʊɨ̯ni
ymrysonydd	əmrəsɔnɨ̞ð
neuddegfed	neɨ̯ðɛɡvad
hamerica	hamɛrɪka
argraffiad	arɡrafjad
plannu	plani
sir frycheiniog	siːrvrəχəi̯njɔɡ
phont	fɔnt
ngwanwyn	ŋwanwɨ̞n
mantais	mantɛs
chyrraedd	χərɛð
pymtheg	pəmθɛɡ
rhanddeiliaid	r̥anðei̯ljai̯d
halen	halɛn
amgyffred	amɡəfrɛd
eiriadurwyr	ei̯rjadɨ̞rwɨ̞r
mhibgorn	m̥ɪbɡɔrn
lle	ɬeː
mewn chwinciad	mɛu̯nχwɪŋkjad
fory	vɔrɨ
cofio	kɔvjɔ
rhestrau	r̥ɛsdra
ei	ei̯
gorfodtref	ɡɔrvɔtrɛv
llundain	ɬɨ̞ndai̯n
gweithluoedd	ɡwei̯θlɨːɔɨ̯ð
neiliaid	nei̯ljai̯d
conwy	kɔnʊɨ̯
bachan	baχan
christ	χriːst
rho	r̥oː
nos sadwrn	nɔsadʊrn
y gofid mawr	əɡɔvɪdmau̯r
gydag	ɡɨ̞daɡ
lestr	lɛstr
peiriant arian parod	pei̯rjantarjamparɔd
telynoresau	tɛlənɔrɛsaɨ̯
celwydd	kɛlwɨ̞ð
gorchudd	ɡɔrχɨ̞ð
nhadau	n̥adɛ
theisen	θei̯sɛn
amrywiaeth	amrɪu̯jaɨ̯ð
plethau	plɛθɛ
gâl	ɡaːl
undebau	ɨ̞ndɛba
heno	hɛnɔ
rhudd	r̥ɨːð
aelwyd	eɨ̯lʊɨ̯d
torchau	tɔrχa
chares	χarɛs
teulu brenhinol	teɨ̯lɨbrɛnhɪnɔl
nerth	nɛrθ
anafais	anavai̯s
tudno	tɨ̞dnɔ
stemars	sdɛmars
peren	pɛrɛn
allforiwr	aɬvɔrjʊr
angylesau	aŋəlɛsɛ
paffio	pafjɔ
hunain	hɨ̞nai̯n
croen	kroːɨ̯n
mynachdy	mənaχdɨ
union	ɪnjɔn
niwlog	nɪu̯lɔɡ
ebol	ɛbɔl
garest	ɡarɛst
tŷ bwyta	tɨːbʊɨ̯ta
megis	mɛɡɪs
terfynu	tɛrvənɨ
metelegwr	mɛtɛlɛɡʊr
deuddeg	deɨ̯ðaɡ
defnyddio	dɛvnəðjɔ
recordiad	rɛkɔrdjad
rhestr	r̥ɛsdr
o	oː
llysieuyn	ɬəʃeɨ̯ɨ̞n
trist	triːst
amffibiad	amfɪbjad
conyn	kɔnɨ̞n
dihareb	dɪharɛb
oleuadau	ɔleɨ̯adaɨ̯
pheiriannwr	fei̯rjanʊr
strach	sdraːχ
lleianaidd	ɬei̯anai̯ð
h	aːɨ̯tʃ
thân	θaːn
cath	kaːθ
bocsiwr	bɔkʃʊr
cywydd	kəu̯ɨ̞ð
ffwng	fʊŋ
chyfforddus	χəfɔrðɨ̞s
goleuedig	ɡɔleɨ̯ɛdɪɡ
dyn	dɨːn
teisennau	tei̯sɛnɛ
letys	lɛtɨs
croesffordd	krɔɨ̯sfɔrð
ceisio	kei̯ʃɔ
amrywiol	amrɨu̯jɔl
frenin	vrɛnɪn
ngwybod	ŋʊbɔd
faen	vaːɨ̯n
cynllunio	kənɬɨ̞njɔ
eraill	ɛrɪɬ
dw	dʊ
cyfeirio	kəvei̯rjɔ
chyfoethog	χəvɔɨ̯θɔɡ
myfyriwr	məvərjʊr
cyhydnos y gwanwyn	kəhədnɔsəɡwanwɨ̞n
cydymdeimlad	kɨːdəmdei̯mlad
fôr	voːr
llanelli	ɬanɛɬi
reit	rei̯t
gelai	ɡɛlai̯
bwrw	bʊru
ffeindiaf	fei̯ndjav
mynachod	mənaχɔd
cymdeithasol	kəmdei̯θasɔl
caer	kaːɨ̯r
trôi	troːi̯
banjo	band͡ʒɔ
benthyg	bɛnθɨ̞ɡ
cynnydd	kənɨ̞ð
eisoes	ei̯ʃɔɨ̯s
diwethaf	dwɛθa
golygu	ɡɔləɡɨ̞
gweinyddesau	ɡwei̯nəðɛsa
daled	dalɛd
gwylliaid	ɡʊɨ̯ɬjai̯d
bawdd	bau̯ð
drawant	drau̯ant
pîn	piːn
alannon	alanɔn
hadwaenent	hadweɨ̯nɛnt
meddiannau	mɛðjana
galed	ɡalɛd
cacennau cri	kakɛnɛkriː
pathew	paθɛu̯
hydrefau	hədrɛvaɨ̯
estrys	ɛsdrɨ̞s
gwddwg	ɡʊðʊɡ
fflworin	flʊɔrɪn
uniongyrchol	ɨ̞njɔŋɡərχɔl
syflyd	səvlɨ̞d
geiriau	ɡei̯rjaɨ̯
ddegfed	ðɛɡvɛd
allai	aɬɛ
ysbrydion	əsbrədjɔn
clwb te	klʊbteː
ngelyn	ŋɛlɨ̞n
adwaenant	adweɨ̯nant
llungopïwr	ɬɨːŋɡɔpiːʊr
tharianau	θarjanaɨ̯
gystadlu	ɡəsdadlɨ
chopa	χɔpa
nheledu	n̥ɛlɛdɨ
ngwylio	ŋwɨ̞ljɔ
harth	harθ
papaia	papai̯a
barbeciwio	barbɛkɪu̯jɔ
taith	tai̯θ
anoddaf	anɔðav
dydd mercher	dɨ̞ðmɛrχar
brysur	brəsɨ̞r
men siarl	mɛnʃarl
gweriniaethau	ɡwɛrɪnjeɨ̯θa
gornestwr	ɡɔrnɛsdʊr
thematig	θɛmatɪɡ
marnwr	marnʊr
carfil bach	karvɪlbaːχ
cyfamser	kəvamsar
posteri	pɔsdɛri
gwaith	ɡwai̯θ
credu	krɛdɨ
adflasau	advlasaɨ̯
pert	pɛrt
rhy	r̥ɨː
adwaenem	adweɨ̯nɛm
glöyn	ɡlɔɨ̞n
wŷn	wɨːn
clwb	kluːb
pioden	piɔdan
cymhleth	kəmlaθ
anifail	anɪvai̯l
llosg	ɬɔsɡ
agweddi	aɡwɛðɪ
dau ar hugain	daɨ̯arhɪɡai̯n
ŵyl	uːɨ̯l
asesiadau	asɛʃadɛ
celynna	kɛləna
bongorff	bɔŋɡɔrf
abwydyn	abʊɨ̯dɨ̞n
achwyniad	aχʊɨ̯njad
chana	χana
canais	kanɛs
gerddoriaeth	ɡɛrðɔrjɛθ
buddug	bɨ̞ðɨ̞ɡ
achwyn	aχʊɨ̯n
saesneg	seɨ̯snaɡ
peiriannau arian	pei̯rjanɛarjan
croes	kroːɨ̯s
cennin sifi	kɛnhɪnɛnsɪvɪ
tor	tɔr
neng	neːŋ
rhos	r̥oːs
rywun	rɪu̯ɨ̞n
ngharwr	ŋ̊arʊr
mhont	m̥ɔnt
agerlong	aɡɛrlɔŋ
doedden	dɔɨ̯ðɛn
nythfa	nəθva
peth	peːθ
cyfrifiadur	kəvrɪvjadɨ̞r
chwarae	χwarɛ
wedyn	wɛdɨ̞n
ngweriniaeth	ŋwɛrɪnjaɨ̯θ
lladin	ɬadɪn
habwydyn	habʊɨ̯dɨ̞n
nghathod	ŋ̊aθɔd
llursod	ɬɨ̞rsɔd
yn achlysurol	ənaχləsɨ̞rɔl
aberteifi	abɛrtei̯vi
fynyddoedd	vənəðɔɨ̯ð
terfysgwr	tɛrvəsɡʊr
cerwyn	kɛruɨ̯n
nhrydanwr	n̥rədanʊr
dosbarthiadau	dɔsbarθjada
rhestri	r̥ɛsdri
ieithydd	jei̯θɨ̞ð
taliadau	taljada
dychmygu	dəχməɡɨ
ar dân	ardaːn
cafodd	kavɔð
gwella	ɡwɛɬa
berf	bɛrv
delent	dɛlɛnt
sarhad	sarhaːd
felyn	vɛlɨ̞n
wythfed	ʊɨ̯θvad
gwall	ɡwaɬ
plaid	plai̯d
nadolig	nadɔlɪɡ
gweithio	ɡwei̯θjɔ
eistedd	ei̯sdɛð
fferm	fɛrm
coch	koːχ
rydw	rədu
mhrif	m̥riːv
chwarren	χwarɛn
adferol	advɛrɔl
argoelion	arɡɔi̯ljɔn
chaeredin	χaɨ̯rɛdɨ̞n
banllawr	banɬau̯r
cysgaf	kəsɡav
dafad	davad
wys	wɨːs
hirsgwariau	hɪrsɡwarja
amodi	amɔdi
deri	dɛri
gwŷl	ɡwɨːl
gwddf	ɡʊðu
men siarlmaen	mɛnʃarlmaɨ̯n
bûm	bɨːm
ciwcymbrau	kɪu̯kəmbra
ffens	fɛns
cywir	kəu̯ɪr
mewnblyg	mɛu̯nblɨ̞ɡ
boncyff	bɔŋkɨ̞f
nghanlyniad	ŋ̊anlənjad
chaffer	χafɛr
huno	hɨ̞nɔ
eangderau	ɛaŋdɛraɨ̯
cotiau	kɔtja
gachais	ɡaχai̯s
twyllwr du	tʊɨ̯ɬʊrdɨː
ffroenuchel	frɔɨ̯nɨ̞χɛl
wyth deg	uɨ̯θdɛɡ
gemau	ɡɛmaɨ̯
gwin newydd	ɡwiːnnɛu̯ɨ̞ð
eirinen fair	ei̯rɪnanvai̯r
nest	nɛsd
nes	neːs
ciwcymbrau	kɪu̯kəmbraɨ̯
olau	ɔla
barf	barv
delem	dɛlɛm
baned	banad
aflafar	avlavar
caersallog	kaɨ̯rsaɬɔɡ
pentref	pɛntra
chant	χant
tarianau	tarjanaɨ̯
heisteddfodau	hei̯sdɛðvɔda
dyddio	dəðjɔ
agerddlong	aɡɛrðlɔŋ
ffilmiau	fɪlmjɛ
padell	padaɬ
nheyrnas	n̥eɨ̯rnas
mwyd	muːɨ̯d
pysen	pəsɛn
marnau	marna
golosg	ɡɔlɔsɡ
gorff	ɡɔrf
drysleoedd	drəsleːɔɨ̯ð
penfelyn	pɛnvɛlɨ̞n
peiriannau arian	pei̯rjanaɨ̯arjan
arddangosfeydd	arðaŋɡɔsveɨ̯ð
be'	beː
clefyd y galon	klɛvɨ̞dəɡalɔn
nhaliadau	n̥aljadɛ
cannwyll	kanʊɨ̯ɬ
chychwyn	χəχwɨ̞n
cenhedlu	kɛnhɛdlɨ̞
bore da	bɔrɛdaː
crychau	krəχɛ
mri	mriː
dolur	dɔlɨ̞r
hwylbren	hʊɨ̯lbrɛn
weddïo	wɛðɪɔ
bleidleisio	blei̯dlei̯ʃɔ
llyfrgell genedlaethol cymru	ɬəvrɡɛɬɡɛnɛdleɨ̯θɔlkəmrɨ
feirysau	vei̯rəsa
mewnol	mɛu̯nɔl
barotach	barɔtaχ
teiar	tei̯ar
peintiau	pei̯ntjɛ
rith	riːθ
taten	tatan
allanol	aɬanɔl
dawnsio	dau̯nʃɔ
cryched	krəχɛd
annwyl	anʊɨ̯l
llawlyfr	ɬau̯lɨ̞vɨ̞r
carwr	karʊr
arhoswch	arhɔsʊχ
brwydro	brʊɨ̯drɔ
rasel	rasɛl
gweriniaethau	ɡwɛrɪnjeɨ̯θaɨ̯
copa	kɔpa
chwerwddwr	χwɛrðʊr
penbleth	pɛmblɛθ
pryd	prɨːd
cyfrwng	kəvrʊŋ
golygfeydd	ɡɔləɡveɨ̯ð
côd	koːd
cathau	kaθɛ
gosteg	ɡɔsdɛɡ
cwsmeriaid	kʊsmɛrjɛd
breifat	brei̯vat
animeiddiad	anɪmei̯ðjad
ogystal	ɔɡəstal
llundain	ɬɨ̞ndɛn
wiwer	wɪu̯ɛr
meddwl	mɛðʊl
deuddegfed	deɨ̯ðɛɡvɛd
gwanwynau	ɡwanwənɛ
swyn	suːɨ̯n
colfen	kɔlvɛn
loc	lɔk
goleuo	ɡɔleɨ̯ɔ
dirmygus	dɪrməɡɨ̞s
sychnant	səχnant
gneuen	ɡneɨ̯ɛn
cadarn	kadarn
peiriannau	pei̯rjanaɨ̯
gweinyddesau	ɡwei̯nəðɛsaɨ̯
talem	talɛm
sìl	sɪl
copyn	kɔpɨ̞n
mhen	m̥ɛn
cwar	kwar
rhufeiniwr	r̥ɨ̞vei̯njʊr
ofergoel	ɔvɛrɡɔi̯l
cwpla	kʊpla
toiled	tɔi̯lad
rhychau	r̥əχaɨ̯
seliau	sɛljaɨ̯
phinc	fɪŋk
aem	aːɨ̯m
golau	ɡɔlɛ
rhwystredigaeth	r̥ʊɨ̯sdrɛdɨ̞ɡaθ
llygru	ɬəɡrɨ
er	ɛr
rhwyllau	r̥ʊɨ̯ɬaɨ̯
chwarae	χwara
cymhleth	kəmlɛθ
pentis	pɛntɪs
adargraffiad	adarɡrafjad
mynych	mənɨ̞χ
nghoed	ŋ̊oːɨ̯d
ymrafael	əmravaɨ̯l
deses	dɛsɛs
adolygu	adɔləɡɨ̞
treisio	trei̯ʃɔ
gwisga	ɡwɪsɡa
plethedig	plɛθɛdɪɡ
anfanteision	anvantei̯ʃɔn
gwahodd	ɡwahoːð
blynyddoedd	blənəðɔɨ̯ð
gymru	ɡəmrɨ̞
tri	triː
gymaint	ɡəmɛnt
gweles	ɡwɛlɛs
ceri	kɛrɪ
ngwychach	ŋwəχaχ
corneli	kɔrnɛli
bws	bʊs
helygen	hɛləɡan
sglodion	sɡlɔdjɔn
calchfaen	kalχvaɨ̯n
trigeiniau	trɪɡei̯njaɨ̯
tynnu	tənɨ
dewed	dɛu̯ɛd
adnabod	adnabɔd
cecraeth	kɛkraɨ̯θ
deusaith	deɨ̯sai̯θ
barus	barɨ̞s
rhwystro	r̥ʊɨ̯sdrɔ
carthenni	karθɛnɪ
wythnos	ʊsnɔs
gydbreswylwyr	ɡɨːdbrɛsʊɨ̯lwɨ̞r
croglen	krɔɡlɛn
arwerthwr	arwɛrθʊr
pedwar	pɛdwar
caeir	keɨ̯ɪr
ddweud	ðweɨ̯d
gorchaw	ɡɔrχau̯
llasen	ɬasɛn
dewr	dɛu̯r
craf y geifr	kraːvəɡei̯vr
awen	au̯ɛn
cedor	kɛdɔr
lyf	lɨːv
cerddor	kɛrðɔr
biau	biːɛ
bodd	boːð
cobra	kɔbra
coeden afalau	kɔɨ̯dɛnavalaɨ̯
tadau	tadaɨ̯
deisen	dei̯sɛn
hadeilad	hadei̯lad
twrf	tʊrv
rhin	r̥iːn
dysglaid	dɨ̞sɡlɛd
asesiadau	asɛʃadaɨ̯
glynu	ɡlənɨ̞
cenhinen	kɛnhɪnan
gylch	ɡɨ̞lχ
casnewydd	kaːsnɛu̯ɨ̞ð
epidemigau	ɛpɪdɛmɪɡɛ
meddai	mɛðɛ
tôn	toːn
nwfr	nʊvr
pỳg	pəɡ
iddo	ɪðɔ
nabod	nabɔd
undebau	ɨ̞ndɛbɛ
absen	absɛn
yn hyn o beth	ənhɨ̞nɔbeːθ
gwahaniaeth	ɡwanjɛθ
llwybr	ɬʊɨ̯br
llafariaid	ɬavarjɛd
moliant	mɔljant
cwerylau	kwɛrəla
llatai	ɬatai̯
llungopïau	ɬɨːŋɡɔpiːaɨ̯
llid	ɬiːd
ynysoedd dedwydd	ənəsɔɨ̯ðdɛdwɨ̞ð
taliadau	taljadaɨ̯
celai	kɛlai̯
treigladau	treiɡladaɨ̯
sallwyr	saɬʊɨ̯r
gwylio	ɡwɪljɔ
sgert	sɡɛrt
cysylltair	kəsəɬdai̯r
nghymaint	ŋ̊əmai̯nt
ngwrando	ŋwrandɔ
cacynen feirch	kakənanvei̯rχ
anghyfreithlon	aŋhəvrei̯θlɔn
gweithdy	ɡwəi̯θdɨ
nudd	nɨːð
cyfnodolyn	kəvnɔdɔlɨ̞n
doet	doːɨ̯t
deiliadaethau	dei̯ljadeɨ̯θaɨ̯
nheisen	n̥ei̯ʃan
arhosaf	arhɔsav
maneg	manaɡ
amrywedd	amrɪu̯jɛð
ffôn	foːn
cyfrif	kəvrɪv
nghastell	ŋ̊asdɛɬ
nheyrnaddoliant	n̥eɨ̯rnaðɔljant
frawd	vrau̯d
elfed	ɛlvɛd
genweiriau	ɡɛnwei̯rjaɨ̯
gwenynen wyllt	ɡwenənaŋwɨːɬd
chlyw	χlɪu̯
nathlu	naθlɨ
unedau	ɨ̞nɛda
cregynna	krɛɡəna
ngroeg	ŋroːɨ̯ɡ
ddeud	ðeɨ̯d
gano	ɡanɔ
pryder	prədar
talon	talɔn
cyfandir	kəvandɪr
troseddu	trɔsɛðɨ
uchel	əχal
gweinyddwr	ɡwei̯nəðʊr
ciw	kɪu̯
cwsg	kuːsɡ
hosbisau	hɔsbɪsa
rwyd	ruːɨ̯d
teitlau	tei̯tlaɨ̯
animeiddiadau	anɪmei̯ðjjada
gôt	ɡoːt
flaidd	vlai̯ð
go iawn	ɡɔjau̯n
deiliadaethau	dei̯ljadeɨ̯θa
pori	pɔri
gythraul	ɡəθrɛl
gwelen	ɡwɛlɛn
gwared	ɡwarɛd
dolis	dɔlɪs
lygod	ləɡɔd
snwcer	snʊkar
dolïau	dɔlɪaɨ̯
lliw	ɬɪu̯
phengwiniaid	fɛŋɡwɪnjai̯d
gwastraff	ɡwasdraf
diod	diːɔd
tryferu	trəvɛrɨ̞
tarian	tarjan
gwarchod	ɡwarχɔd
allforion	aɬvɔrjɔn
cyfrifoldebau	kəvrɪvɔldɛbaɨ̯
deuddegfed	deɨ̯ðɛɡvad
gorchymyn	ɡɔrχəmɨ̞n
magnelau	maɡnɛlɛ
mrân	mraːn
brexit	brɛksɪt
fychan	fəχan
pisyn grôt	pɪsɨ̞ŋɡroːt
cais	kai̯s
lydan	lədan
roedden	rɔɨ̯ðan
teisen	tei̯ʃɛn
deugeiniau	dei̯ɡei̯njaɨ̯
mhortiwgal	m̥ɔrtjʊɡal
caernarfon	kaɨ̞rnarvɔn
corn	kɔrn
leicio	lei̯kjɔ
pinc	pɪŋk
ysguthan	əsɡɨ̞θan
adfydus	advədɨ̞s
rhywle	r̥ɨu̯la
arolygon	arɔləɡɔn
dau ar bymtheg	daɨ̯arbəmθaɡ
cacen gri	kakɛŋɡriː
diobaith	diɔbai̯θ
sidan	sɪdan
wele	wɛlɛ
help llaw	hɛlpɬau̯
mawr	mau̯r
masgau	masɡa
cynt	kɨ̞nt
cymysgedd	kəməsɡɛð
phencampwriaeth	fɛŋkampʊrjɛθ
chnwd	χnuːd
torres	tɔrɛs
tîm	tiːm
mwyalchen	muɨ̯alχɛn
nghosyn	ŋ̊ɔsɨ̞n
mwydyn	mʊɨ̯dɨ̞n
gweld	ɡwɛld
blychau llwch	bləχaɬuːχ
theyrnas	θeɨ̯rnas
ciwdod	kɪu̯dɔd
gof	ɡoːv
gwaethaf	ɡweɨ̯θav
cil	kiːl
tywyll	təu̯ɨ̞ɬ
llythrennau	ɬəθrɛnɛ
athrawesau	aθrau̯ɛsɛ
ddim	ðɪm
teisen radell	tei̯sanradɛɬ
bengwin	bɛŋɡwɪn
hwngari	hʊŋɡari
nghell	ŋ̊ɛɬ
atalfa	atalva
cacennau	kakɛnaɨ̯
weled	wɛlɛd
yw	ɪu̯
addysg	aðɨ̞sɡ
darllen	darɬan
canslo	kanslɔ
lol	lɔl
telais	tɛlai̯s
iorwg	jɔrʊɡ
sy	sɨː
deyrnas	deɨ̯rnas
ffionau	fɪɔnaɨ̯
gwerinwr	ɡwɛrɪnʊr
nghythreuliaid	ŋ̊əθreɨ̯ljai̯d
helfen	hɛlvɛn
cas	kaːs
newyn	nɛu̯ɨ̞n
cryddion	krəðjɔn
picen ar y maen	pɪkɛnarəmaːɨ̯n
deiliaid	dei̯ljɛd
euro	eɨ̯rɔ
big	biːɡ
trefedigaeth	trɛvɛdɪɡɛθ
chythreuliaid	χəθreɨ̯ljɛd
daeargryn	deɨ̯arɡrɨ̞n
telynau	tɛlənaɨ̯
bleiddiau	blei̯ðjɛ
rhywsut	r̥ɨu̯sɨ̞t
chalan	χalan
offer	ɔfɛr
adar y bwn	adarəbʊn
eleni	lɛnɪ
plethdorch	plɛθdɔrχ
datod	datɔd
afiach	avjaχ
nghlywed	ŋ̊ləu̯ad
anweddu	anwɛðɨ
arhosfa	arhɔsva
moliannau	mɔljanaɨ̯
hedyn	hɛdɨ̞n
gegin	ɡɛɡɪn
phei	fei
aelod seneddol	eɨ̯lɔdsɛnɛðɔl
sefyll	sɛvɨ̞ɬ
mlodau	mlɔdɛ
rhyngrwyd pethau	r̥əŋrʊɨ̯dpɛθɛ
cafas	kavas
almaenwr	almeɨ̯nʊr
thewed	θɛu̯ɛd
chacha	χaχa
hirsgwarau	hɪrsɡwaraɨ̯
paent	paːɨ̯nt
neuaddau	neɨ̯aða
llwythau	ɬʊɨ̯θa
olaf	ɔla
sgriau	sɡriːaɨ̯
haeddel fawr	heɨ̯ðɛlvau̯r
fasen	san
aromatherapydd	arɔmaθɛrapɨ̞ð
aeronen	eɨ̯rɔnɛn
academïau	akadɛmiːaɨ̯
caf	kaːv
gwlad belg	ɡwlaːdbɛlɡ
gofalus	ɡɔvalɨ̞s
torlannau	tɔrlanɛ
hynny	hənɨ
gelli	ɡɛɬɪ
clwt	klʊt
cynghori	kəŋhɔri
oer	oːɨ̯r
cyn	kɨn
cwbl	kʊbl
aethant	eɨ̯θant
gornestwyr	ɡɔrnɛsdwɨ̞r
sinc	sɪŋk
mae	maːɨ̯
heog	hɛɔɡ
jaciau	dʒakja
doedd	doːɨ̯ð
traed	traːɨ̯d
gwyddon	ɡwəðɔn
drud	drɨːd
rod	roːd
pumdegau	pɨ̞mdɛɡa
lliwyddion	ɬɪu̯əðjɔn
pandai	pandai̯
coeg	koːɨ̯ɡ
ngwario	ŋwarjɔ
llusen america	ɬɨ̞sanamɛrɪka
coeden afalau	kɔɨ̯dɛnvalɛ
cwta	kʊta
tybaco	təbakɔ
nghwrw	ŋ̊ʊru
pasteiod	pasdei̯ɔd
wybodaeth	wɨ̞bɔdɛθ
caem	kaːɨ̯m
ymdeimlad	əmdei̯mlad
tadau	tadɛ
homan	hɔman
llenyddol	ɬɛnəðɔl
ymyl	əmɨ̞l
bob	boːb
ymwneud	əmneɨ̯d
tywod	təu̯ɔd
corfflunio	kɔrflɨ̞njɔ
lesau	lɛsɛ
cysgu fel clawdd	kəsɡɨ̞vɛlklau̯ð
cyfddydd	kəvðɨ̞ð
dydd iau	dɨ̞ðjaɨ̯
un ar ddeg	ɨːnarðeːɡ
fach	vaːχ
chyfiawnder	χəvjau̯ndɛr
gwyryf	ɡwərɨv
trigeiniau	trɪɡei̯njɛ
tanwydd	tanwɨ̞ð
cneuen ffrengig	kneɨ̯anfrɛŋɪɡ
nheisen	n̥ei̯sɛn
cangarŵ	kaŋɡaruː
medro	mɛdrɔ
llynedd	ɬənɛð
yn sgil	ənsɡiːl
mrenin	mrɛnɪn
gwefan	ɡwɛvan
munudau	mɨ̞nɨ̞daɨ̯
symud	səmɨ̞d
afalau	avalaɨ̯
gwenllian	ɡwɛnɬiːan
adwaenynt	adweɨ̯nɨ̞nt
dyddiad	dəðjad
gwledd	ɡwleːð
atborth	atbɔrθ
atebaf	atɛbav
cref	kreː
dalfa	dalva
safbwynt	savbʊɨ̯nt
rhwydd	r̥uːɨ̯ð
sylfaen	səlvaɨ̯n
nawn	nau̯n
tenau	tɛnaɨ̯
america	amɛrɪka
mewn	mɨ̞u̯n
rhodiwch	r̥ɔdjʊχ
ardaloedd	ardalɔɨ̯ð
cynhorthwy	kənhɔrθʊɨ̯
sut	sɨ̞d
fflwcs	flʊks
amgylch	amɡɨ̞lχ
baths	baθs
cael	kaːl
lysiau	ləʃɛ
gallant	ɡaɬant
biolegydd	bjɔlɛɡɨð
adferaf	advɛra
rhwydwaith	r̥ʊɨ̯dwai̯θ
hoen	hoːɨ̯n
gwlân	ɡwlaːn
ffoniaf	fɔnjav
seintiau	sei̯ntjɛ
pymthegfed	pəmθɛɡvad
llinynnau	ɬɪnənaɨ̯
iti	ɪti
rhegen	r̥ɛɡɛn
cwstardiau	kʊsdardjaɨ̯
mynachaeth	mənaχaɨ̯θ
ffon gof	fɔŋɡoːv
ffraeau	freɨ̯a
cyhyd	kəhɨːd
nage	naɡɛ
gynnwrf	ɡənʊrv
llandudno	ɬandɨ̞dnɔ
heddlu	hɛðlɨ
ocsiwn	ɔkʃʊn
pleidleisio	plei̯dlei̯ʃɔ
fab	vaːb
daliadaethau	daljadeɨ̯θa
dynfeirch	dənvei̯rχ
gorllewin	ɡɔrɬɛu̯ɪn
chestyll	χɛsdɨ̞ɬ
rhentu	r̥ɛntɨ
sbwriel	sbʊrjɛl
ffionau	fɪɔna
gylfinir	ɡəlvɪnɪr
cwerylau	kwɛrəlaɨ̯
ugain	ɪɡai̯n
lygad	lɨ̞ɡad
carneddi	karnɛði
urddau	ɨ̞rða
ailosod	ai̯lɔsɔd
fforc	fɔrk
ymddwyn	əmðʊɨ̯n
gwerdd	ɡwɛrð
deffry	dɛfrɨ
poptai	pɔptai̯
gweinyddol	ɡwei̯nəðɔl
clywed	kləu̯ad
eurgylch	eɨ̯rɡɨ̞lχ
eidal	ei̯dal
melltith	mɛɬdɪθ
diogel	dɪɔɡɛl
tudalen we	tɨ̞dalanweː
nghadair	ŋ̊adɛr
cystadleuol	kəsdadleɨ̯ɔl
ffoniodd	fɔnjɔð
saib	sai̯b
pharotach	farɔtaχ
ariannin	ərarjanɪn
selotep	sɛlɔtɛp
hyrwyddo	hərʊɨ̯ðɔ
teisen gri	tei̯ʃaŋɡriː
pryf copyn	prɨːvkɔpɨ̞n
ngwain	ŋwai̯n
genedlaethol	ɡɛnɛdleɨ̯θɔl
pedair	pɛdɛr
geir	ɡei̯r
oni	ɔni
baet	baːɨ̯t
berthynas	bɛrθənas
rhodri	r̥ɔdri
tair ar ddeg	tai̯rarðeːɡ
phortiwgal	fɔrtɪu̯ɡal
gwrthwynebwyr	ɡʊrθwɨ̞nɛbwɨ̞r
gysgu	ɡəsɡɨ
prifiau	prɪvja
gên	ɡeːn
tyndra	təndra
godi	ɡɔdɪ
chaint	χai̯nt
alltud	aɬdɨ̞d
ffugenwau	fɨ̞ɡɛnwɛ
arwerthiannau	arwɛrθjana
wddf	ʊðv
dylan	dəlan
derwydd	dɛrwɨ̞ð
copii	kɔpiːi
thaclus	θaklɨ̞s
ngheffyl	ŋ̊ɛfɨ̞l
tato	tatɔ
cenhinen bedr	kɛnhɪnɛmbɛdr
ngaeaf	ŋeɨ̯av
chlyw	χlɨu̯
triongl	triːɔŋl
cofiais	kɔvjai̯s
nhyrrau	n̥əraɨ
mi	miː
nwy	nuːɨ̯
clefyd y sul	klɛvɨ̞dəsɨːl
brochion	brɔχjɔn
santesau	santɛsa
fwg	vuːɡ
hirddydd haf	hɪrðɨ̞ðhaː
sgarff	sɡarf
anghyflogaeth	aŋhəvlɔɡɛθ
siop	ʃɔp
rheoliad	r̥ɛɔljad
iasoer	jasɔɨ̯r
all	aɬ
bur	bɨːr
aberafan	abɛravan
adeiladwr	adei̯ladʊr
deledu	dɛlɛdɨ
rywbeth	rʊbaθ
cyfforddus	kəfɔrðɨ̞s
gwŷn	ɡwɨːn
munudau	mɨ̞nɨ̞da
parth	parθ
chweugain	χwei̯ɡai̯n
ystiflogod	əsdɪflɔɡɔd
awydd	au̯ɨ̞ð
nos iau	nɔsjaɨ̯
afocado	avɔkadɔ
welsh cêcs	wɛlʃkeːks
leihau	lei̯haɨ̯
apêl	apeːl
gorfod	ɡɔrɔd
cofiais	kɔvɪʃ
heddluoedd	hɛðlɨ̞ɔɨð
elfen	ɛlvɛn
iddewig	ɪðɛu̯ɪɡ
heliwm	hɛljʊm
ngwddf	ŋʊðʊv
cymhleth	kəmhlɛθ
llysiau	ɬəʃa
rhyfelwyr	r̥əvɛlwɨ̞r
ywen	əu̯ɛn
lemon	lɛmɔn
ailwampio	ai̯lwampjɔ
cyfathrach	kəvaθraχ
lleihau	ɬei̯haɨ̯
arolygiadau	arɔləɡjadaɨ̯
beichiog	bei̯χjɔɡ
coedwig	kɔɨ̯dwɪɡ
cymaint	kəmɛnt
eirinen wlanog	ei̯rɪnɛŋwlanɔɡ
sut	sɨ̞t
cana	kana
argraffwyr	arɡrafwɨ̞r
math	maːθ
pwy wyt ti	puːɨ̯uːɨ̯tiː
pengwiniaid	pɛŋɡwɪnjɛd
archebion	arχɛbjɔn
dosbarthiadau	dɔsbarθjadɛ
mefusen	mɛvɨ̞san
raff	raːf
argoelion	arɡɔɨ̯ljɔn
llên	ɬeːn
creisionllyd	krei̯ʃɔnɬɨ̞d
picen	pɪkɛn
cyfatebol	kəvatɛbɔl
ymlaen	mlaːɨ̯n
sgîl	sɡiːl
gwasanaeth	ɡwasanaɨ̯θ
system	sɨ̞sdɛm
dagrau	daɡra
gwybodaeth	ɡwɨ̞bɔdɛθ
peithiau	pei̯θja
iwd	ɪu̯d
arolygiaethau	arɔləɡjeɨ̯θɛ
goleuadau	ɡɔleɨ̯ada
palmant	palmant
blaidd	blai̯ð
trwyddedau	trʊɨ̯ðɛda
brwmstan	brʊmsdan
olwg	ɔlʊɡ
arolygol	arɔləɡɔl
fasen	sɛn
dry	drɨː
sefydlu	sɛvədlɨ
ngweithiwr	ŋwei̯θjʊr
genedigaeth	ɡɛnɛdɪɡɛθ
gwêl	ɡweːl
esgidiau	sɡɪdjɛ
chymedrolwr	χəmɛdrɔlʊr
peiriannau arian parod	pei̯rjanaɨ̯arjanparɔd
paffiwr	pafjʊr
cryd	krɨːd
gwynnu	ɡwənɨ
trydar	trədar
deiliadaeth	dei̯ljadaɨ̯θ
olewydd	ɔlɛu̯ɨ̞ð
heuldro'r haf	heɨ̯ldrɔrhaː
talai	talɛ
cymysglyd	kəməsɡlɨ̞d
gefeilles	ɡɛvei̯ɬɛs
iasau	jasɛ
anghytuno	aŋhətɨnɔ
pleth	pleːθ
ceredigion	kɛrɛdɪɡjɔn
dalia	dalja
wŷdd	wɨːð
copog	kɔpɔɡ
cloent	kloːɨ̯nt
gloan	ɡlɔan
dyrys	dərɨ̞s
adlaw	adlau̯
masgau	masɡaɨ̯
delw	dɛlu
arfedd	arvɛð
dagrau	daɡrɛ
èch	ɛχ
nhîm	n̥iːm
ngwlad pwyl	ŋwlaːdpuːɨ̯l
haelwyd	heɨ̯lʊɨ̯d
cachlwyth	kaχlʊɨ̯θ
cyntaf	kənta
animeiddiwr	anɪmei̯ðjʊr
garai	ɡarai̯
unllygeidiog	ɨ̞nɬəɡei̯djɔɡ
adlamau	adlamɛ
garafán	ɡaravan
rhannu	r̥anɨ
âl	aːl
traethodau	treɨ̯θɔdɛ
pwyll	puːɨ̯ɬ
magnelwyr	maɡnɛlʊr
tarianau	tarjana
arfedd	arvað
mrechdan	mrɛχdan
adweinid	adwei̯nɪd
cloan	klɔan
rhith	r̥iːθ
phedol	fɛdɔl
geifr	ɡei̯vr
disgyblion	dɪsɡəbljɔn
cen coed	kɛnkoːɨ̯d
moel	moːɨ̯l
chwi	χwiː
mewnforiwr	mɛu̯nvɔrjʊr
corffluoedd	kɔrflɨːɔɨ̯ð
fwthyn	vʊθɨ̞n
asesiad	asɛʃad
angladdau	aŋlaðaɨ̯
gaf	ɡaːv
undeb	ɨ̞ndɛb
llawen	ɬau̯an
llawen	ɬau̯ɛn
nghaeredin	ŋ̊aɨ̯rɛdɨ̞n
garu	ɡarɨ̞
taw	tə
ddoi	ðɔi̯
afalau	valɛ
anghydsynio	aŋhɨ̞dsənjɔ
gwayw	ɡweɨ̯u
gorlifaf	ɡɔrlɪvav
phobloedd	fɔblɔɨ̯ð
bopty	bɔptɨ
gwenith	ɡwɛnɪθ
blodau	blɔdaɨ̯
dynnu	dənɨ
caniau	kanjɛ
ffraeo	freɨ̯ɔ
lwyth	lʊɨ̯θ
chadair	χadar
welydd	wɛlɨ̞ð
tyb	tɨːb
storïau	sdɔriːa
pobloedd	pɔblɔɨ̯ð
cydweithredwyr	kɨːdwei̯θrɛdwɨ̞r
thala	θala
flynedd	vlənað
melfaréd	mɛlvarɛd
rhwystrau	r̥ʊɨ̯sdraɨ̯
mhysgodyn	m̥əsɡɔdɨ̯n
dyfarnu	dəvarnɨ
dydy	dədɨ̞
nawf	nau̯v
chinio	χɪnjɔ
gwylanod	ɡʊɨ̯lanɔd
corhwyaid	kɔrhʊɨ̯ɛd
pump	pɨ̞mp
cyfarwys	kəvarʊɨ̯s
cut	kɨ̞t
cyhydnos yr hydref	kəhədnɔsərhədrɛv
teimlo	tei̯mlɔ
tun te	tɨ̞nteː
nadroedd	nadrɔɨ̯ð
torso	tɔrsɔ
mharod	m̥arɔd
cefnog	kɛvnɔɡ
argraffiadwyr	arɡrafjadwɨ̞r
dwywaith	dʊɨ̯wɛθ
potsio	pɔtʃɔ
byth	bɨ̞θ
almanac	almanak
edliw	ɛdlɪu̯
plygiau	pləɡjaɨ̯
galed	ɡalad
cymryd	kəmrɨ̞d
origami	ɔrɪɡami
afalau	vala
ngwely	ŋwɛlɨ
nghar	ŋ̊ar
terfysgwyr	tɛrvəsɡwɨ̞r
ffroenuchel	frɔɨ̯nɨ̞χal
nghnwd	ŋ̊nuːd
ffres	frɛʃ
anrhydeddu	anr̥ədɛðɨ
canghellor	kaŋhɛɬɔr
diodydd	djɔdɨ̞ð
chastell	χasdɛɬ
adferiadau	advɛrjada
phyliau	fəljɛ
canhwyllau	kanhʊi̯ɬa
adre	adrɛ
efo	ɛvɔ
gachen	ɡaχɛn
ystad	əsdad
wyneb	wɨnab
pasiaf	paʃa
heddferch	hɛðvɛrχ
nadlwytho	nadlʊɨ̯θɔ
gaffi	ɡafi
fasen	vasan
isteitlau	iːsdei̯tlɛ
lliwio	ɬɪu̯jɔ
fflwcsyn	flʊksɨ̞n
cledd	kleːð
gana	ɡana
ffesant	fɛsant
ffordd	fɔrð
brics	brɪks
achubiaeth	aχɨ̞bjɛθ
barnau	barna
saltring	saltrɪŋ
chymorth	χəmɔrθ
tyllau	təɬɛ
gwanwyn	ɡwanwɨ̞n
sbaen	sbaːɨ̯n
fwyaf	vʊɨ̯av
dannoedd	danɔɨ̯ð
rhewi	r̥ɛu̯i
rhegfa	r̥ɛɡva
cymedrolwr	kəmɛdrɔlʊr
broga	brɔɡa
rhad	r̥aːd
eirinen ysgaw	ei̯rɪnɛnəsɡau̯
cymraesau	kəmreɨ̯sa
asyn	asɨ̞n
unais	ɨ̞nɛʃ
ysgawen	əsɡau̯an
ysgub	əsɡɨ̞b
gwilym	ɡwɪlɨ̞m
cachgi bwm	kaχɡɪbʊm
ciciau cosb	kɪkjaɨ̯koːsb
phrydain	frədɛn
brawychwr	brau̯əχʊr
ysgaw	əsɡau̯
adfent	advɛnt
cyfle	kəvla
cristnogol	krɪsdnɔɡɔl
pengwin	pɛŋɡwɪn
seithfed	sei̯θvad
adfywiol	advɨ̞u̯jɔl
carest	karɛsd
lygaid	lɨ̞ɡɛd
llinyn	ɬɪnɨ̞n
iddewesau	ɪðɛu̯ɛsaɨ̯
nghenhinen	ŋ̊ɛnhɪnan
masgio	masɡjɔ
elsem	ɛlsɛm
ymdopi	əmdɔpi
thelynores	θɛlənɔrɛs
ddim	m
deisen	dei̯ʃɛn
amrantiad	amrantjad
adleisiau	adlei̯ʃa
plethwaith	plɛθwai̯θ
fwltur	vʊltɨ̞r
ysmygu	əsməɡɨ
drennydd	drɛnɨ̞ð
pandemigau	pandɛmɪɡɛ
absenoldeb	absɛnɔldɛb
nghlywed	ŋ̊ləu̯ɛd
malwod	malwɔd
cydweithiad	kɨːdwei̯θjad
tenantiaethau	tɛnantjeɨ̯θɛ
mathau	maθaɨ̯
llond	ɬɔnd
disgybl	dɪsɡɪbl
daliadaeth	daljadɛθ
picau ar y maen	pɪkaarəmaːɨ̯n
milwrol	mɪlʊrɔl
ysbryd	əsbrɨ̞d
dyrysni	dərəsni
busnes	bɨ̞snɛs
protestaniaid	prɔtɛsdanjai̯d
ffrwydro	frʊɨ̯drɔ
gweud	ɡweɨ̯d
bryfed	brəvad
canmoliaethau	kanmɔljeɨ̯θɛ
chroes	χroːɨ̯s
siomau	ʃɔmaɨ̯
anghydweld	aŋhɨ̞dwɛld
swyno	sʊɨ̯nɔ
ers	ɛrs
glawio	ɡlau̯jɔ
olewydden	ɔlɛu̯əðɛn
bresychen	brɛsəχan
mỳg	məɡ
habadaethau	habadeɨ̯θɛ
ugain	ɪɡjan
weddi'r arglwydd	wɛðɪrarɡluɨ̯ð
gorfodog	ɡɔrvɔdɔɡ
ddigwydd	ðɪɡwɨ̞ð
synnwyr	sənwɨ̞r
siomedig	ʃɔmɛdɪɡ
nghythraul	ŋ̊əθral
brawychdod	brau̯əχdɔd
nghân	ŋ̊aːn
gredo	ɡrɛdɔ
cyfryngiadau	kəvrəŋjadaɨ̯
cyfartalog	kəvartalɔɡ
mag	maɡ
degfed	dɛɡvad
mlaidd	mlai̯ð
blew	bleːu̯
unigolyn	ɨ̞nɪɡɔlɨ̞n
chnau ffrengig	χnaɨ̯frɛŋɪɡ
eto	ɛtɔ
unai	ɨ̞nai̯
gefn	ɡɛvn
sgriau	sɡriːɛ
moll	mɔɬ
llosgfaen	ɬɔsɡvaɨ̯n
nghelyn	ŋ̊ɛlɨ̞n
aethid	eɨ̯θɪd
pencampwr	pɛŋkampʊr
llanw	ɬanu
bysell	bəsɛɬ
rhanbarthau	r̥ambarθa
ocsiynau	ɔkʃənɛ
deuparth	deɨ̯parθ
esgyn	ɛsɡɨ̞n
conwydd	kɔnwɨ̯ð
w	w
clawdd	klaːu̯ð
nharianau	n̥arjana
torri	tɔri
gwaeth	ɡwaːɨ̯θ
adar o'r unlliw hedant i'r unlle	adarɔrɨ̞nɬɨ̞u̯hɛdantɪrɨ̞nɬɛ
caill	kai̯ɬ
chwisgi	wɪsɡi
gwningen	ɡʊnɪŋɛn
deisen	dei̯ʃan
dydd iau	dɨ̞jaɨ̯
ficer	vɪkar
o dan	ɔdan
mantais	mantai̯s
aderyn	adɛrɨ̞n
clywaf	kləwav
thaflu	θavlɨ
egyr	ɛɡɨ̞r
chwisgi	χwɪsɡi
deddfu	dɛðvɨ
hwylio	hʊɨ̯ljɔ
bywgraffiadur	bɨu̯ɡrafjadɨ̞r
ferch	vɛrχ
argrafiadau	arɡrafjada
gael	ɡaːl
treigladau	treiɡljadɛ
cachais	kaχai̯s
fywyd	vəu̯ɨ̞d
band llydan	bandɬədan
cwd	kuːd
bysellfwrdd	bəsɛɬvʊrð
unit	ɨ̞nɪt
corhwyaden	kɔrhʊɨ̯adɛn
ceulo	keɨ̯lɔ
ngogledd	ŋɔɡlað
dewch	dɛu̯χ
rhuthraf	r̥ɨ̞θra
edrydd	ɛdrɨ̞ð
oedi	ɔɨ̯di
synio	sənjɔ
awyren	au̯ərɛn
lloc	ɬɔk
cwm	kʊm
neuadd	neɨ̯að
ysgrifennu	sɡwɛnɨ
piau	piːɛ
adwaen	adwaɨ̯n
tenau	tɛnɛ
conwydden	kɔnwɨ̞ðan
llygod	ɬəɡɔd
cyfoethog	kəvɔɨ̯θɔɡ
crydiau	krədja
crychach	krəχaχ
brecsit	brɛksɪt
golau	ɡɔla
picau ar y maen	pɪkɛarəmaːɨ̯n
niwclear	nɪu̯klɛar
chael	χaːɨ̯l
cyngyd	kəŋɨ̞d
gardd	ɡarð
thalu	θalɨ
anghofus	aŋhɔvɨ̞s
nghychwyn	ŋ̊əχwɨ̞n
tyrrau	təra
nhân	n̥aːn
angylaidd	aŋəlɛð
mwnt	mʊnt
sgythia	sɡəθja
gwrthrychol	ɡʊrθrəχɔl
chwyldro	χwɨ̞ldrɔ
thaw	θau̯
dudalen	dɨ̞dalan
helc	hɛlk
glaw	ɡlaːu̯
gweinyddiaeth	ɡwei̯nəðjaɨ̯θ
ngolau	ŋɔlɛ
crwst	krʊsd
caer arianrhod	kaːɨ̯rarjanr̥ɔd
neilen	nei̯lan
doeddech	dɔɨ̯ðɛχ
cloriau	klɔrjɛ
fod	voːd
barnau	barnaɨ̯
dryswch	drəsʊχ
cymylau	kəməlaɨ̯
nghymorth	ŋ̊əmɔrθ
asgell	asɡaɬ
gaffel	ɡafɛl
thrennydd	θrɛnɨ̞ð
boch	boːχ
ar ôl	aroːl
gellyg	ɡɛɬɨ̞ɡ
llyf	ɬɨːv
cristion	krɪsdjɔn
rhydau	r̥ədɛ
llu	ɬɨː
crydiau	krədjɛ
wyau	ʊi̯ɛ
brawychiadau	brau̯əχjadaɨ̯
peirianwaith	pei̯rjanwɛθ
iawn	jau̯n
bin	bɪn
meddiannol	mɛðjanɔl
bi	biː
hwyaid	hʊɨ̯ai̯d
rhyfedd	r̥əvɛð
ceillgwd	keiɬɡʊd
gân	ɡaːn
blodau	blɔda
ardderchog	arðɛrχɔɡ
cofiwn	kɔvjʊn
adlamu	adlamɨ̞
pymthegfed	pəmθɛɡvɛd
gwenynen fêl	ɡwenənɛnveːl
elai	ɛlai̯
wair	wai̯r
adar duon	adardɨːɔn
barnu	barnɨ
arholiadau	arɔljadɛ
ar gau	arɡaɨ̯
siocled	ʃɔklad
taclus	taklɨ̞s
nghlybiau	ŋ̊ləbjɛ
adargi	adarɡɪ
lundain	lɨ̞ndai̯n
cafiâr	kavjaːr
wythnos	ʊθnɔs
genwair	ɡɛnwar
llong	ɬɔŋ
cerpyn	kɛrpɨ̞n
lesau	lɛsa
adweinir	adwei̯nɪr
dilyn	dɪlɨ̞n
cytseiniaid	kətsei̯njai̯d
barbeciws	barbɛkɪu̯s
eiliad	ei̯ljad
iâ	jaː
lysiau	ləʃaɨ̯
chyflym	χəvlɨ̞m
onnen	ɔnan
chwardd	χwarð
cwbl	kʊbʊl
dadwisgo	dadwɪsɡɔ
byddwn	bəðʊn
fas	vaːs
pinafal	piːnaval
nghwch	ŋ̊ʊχ
athro	aθrɔ
nos sul	noːssɨːl
nhew	n̥eːu̯
cares	karɛs
darllen	darɬɛn
corgi	kɔrɡi
thŷ	θɨː
nos lun	noːslɨːn
portiwgal	pɔrtɪu̯ɡal
lolfa	lɔlva
neges	nɛɡɛs
argraffyddion	arɡrafəðjɔn
taler	talɛr
throednoeth	θrɔɨ̯dnɔɨ̯θ
cymharu	kəmharɨ
cacs	kaks
mwthyn	mʊθɨ̞n
leicio	lɪkjɔ
undebau	ɨ̞ndɛbaɨ̯
torlannau	tɔrlanaɨ̯
gyngor	ɡəŋɔr
mamau	mamɛ
basen	bəsɛn
adenydd	adɛnɨ̞ð
nghydbreswylwyr	ŋ̊ɨːdbrɛsʊɨ̯lwɨ̞r
drygioni	drəɡjɔni
wybr	ʊɨ̯br
throed	θroːɨ̯d
nhwymyn	n̥ʊɨ̯mɨ̞n
melltithio	mɛɬdɪθjɔ
bagét	baɡɛt
eirinen	ei̯rɪnɛn
adlamau	adlamaɨ̯
uno	ɨ̞nɔ
dylai	dəlai̯
fag	vaːɡ
torlan	tɔrlan
gweithiwr	ɡwei̯θjʊr
cadno	kadnɔ
affwys	afʊɨ̯s
ambell	ambaɬ
ohirio	ɔhɪrjɔ
dydy	dədi
lleiandai	ɬei̯andai̯
gweddïau	ɡwɛðiːa
ar draws	ardrau̯s
dâl	daːl
chwythaf	χwəθav
eler	ɛlɛr
cantores	kantɔrɛs
ciledrych	kɪlɛdrɨχ
cyfryngiad	kəvrəŋjad
palu	palɨ
men siarlys	mɛnʃarlɨ̞s
ciciau adlam	kikjaɨ̯adlam
llefarydd	ɬɛvarɨ̞ð
nghôt law	ŋ̊oːtlaːu̯
arolwg	arɔlʊɡ
dychryniadau	dəχrənjadɛ
cyllell	kəɬaɬ
rhwyfau	r̥ʊɨ̯vaɨ
chathod	χaθɔd
hefin	hɛvɪn
thud	θɨːd
erthygl	ɛrθɨ̞ɡl
pob	poːb
deirw	dei̯ru
alan	alan
caeaf	keɨ̯a
drwyddedau	drʊɨ̯ðɛdɛ
ladin	ladɪn
poblog	pɔblɔɡ
tryweli	trəu̯ɛli
yw	ɨ̞u̯
dolïau	dɔlɪa
mehefin	mɛhɛvɪn
chlefyd	χlɛvɨ̞d
tharianau	θarjanɛ
argraffiadydd	arɡrafjadɨ̞ð
fuwch	vɨu̯χ
daearfoch	deɨ̯arvɔχ
wario	warjɔ
fi	viː
gwerinwyr	ɡwɛrɪnwɨ̞r
ŷd	ɨːd
adferiadydd	advɛrjadɨ̞ð
caeredin	kaɨ̯rɛdɨ̞n
mwyaren	mʊɨ̯arɛn
bleiddiau	blei̯ðjaɨ̯
chlybiau	χləbja
llungopïwyr	ɬɨːŋɡɔpɪwɨ̞r
chwennych	χwɛnɨ̞χ
oriau	ɔrjaɨ̯
rondefŵ	rɔndɛvuː
siwrnai	ʃʊrna
seshys	sɛʃɨ̞s
gloyw	ɡlɔɨ̯u
adarwyr	adarwɨ̞r
daler	dalɛr
arweinyddion	arwei̯nəðjɔn
cadwyn	kadʊɨ̯n
dyrrau	dərɛ
doen	doːɨ̯n
gylfin	ɡəlvɪn
arddwrn	arðʊrn
ysglodyn	sɡlɔdɨ̞n
mewnforio	mɛu̯nvɔrjɔ
wylo	ʊɨ̯lɔ
puramid	pɨ̞ramɪd
abadesau	abadɛsaɨ̯
tybed	təbɛd
hyblyg	həblɨ̞ɡ
mynydd	mənɨ̞ð
cyfan	kəvan
adnabyddi	adnabəðɪ
bryf	brɨːv
rhych	r̥ɨːχ
rhwystredigaeth	r̥ʊɨ̯sdrɛdɨ̞ɡaɨ̯θ
petryalau	pɛtrɨ̞alɛ
adarydd	adarɨ̞ð
cau	kaɨ̯
pendant	pɛndant
rhesymol	r̥ɛsəmɔl
cwmws	kʊmʊs
gwobrwyon	ɡwɔbrʊɨ̯ɔn
glasach	ɡlasaχ
blanced	blaŋkɛd
elem	ɛlɛm
amlach	amlaχ
gwialen bysgota	ɡwialɛnbəsɡɔta
ad	aːd
hanner	hanar
ysguthan	sɡɨ̞θan
closed	klɔsɛd
chysgu	χəsɡɨ
cyfle	kəvlɛ
cloriau	klɔrja
nghusanau	ŋ̊ɨ̞sanaɨ̯
yng	əŋ
glythineb	ɡləθɪnɛb
lifftiau	lɪfdjɛ
arolygwyr	arɔləɡwɨ̞r
dorrai	dɔrɛ
ganer	ɡanɛr
croth	kroːθ
ambeutu	ambeɨ̯tɨ̞
man	man
cyfrifoldebau	kəvrɪvɔldɛba
hysgi	həsɡi
gorffennol	ɡɔrfɛnɔl
adleisio	adlei̯ʃɔ
bandiau	bandja
jyngl	d͡ʒəŋɡl
closen	klɔsɛn
cholli	χɔɬi
mhasta	m̥asda
camlwrw	kamlʊrʊ
sgil	sɡiːl
swnt	sʊnt
talais	talɛs
picwnen goch	pɪkʊnɛŋɡoːχ
prydain fawr	prədai̯nvau̯r
neb	neːb
moliannau	mɔljanɛ
profi	prɔvi
waliau	walja
di	diː
arholiadau	arhɔljadaɨ̯
adfywiadau	advɨ̞u̯jadaɨ̯
esgaladur	ɛsɡaladɨ̞r
baned	banɛd
cyffwrdd	kəfʊrð
fel hyn	vɛlhɨ̞n
treisiwr	trei̯ʃʊr
llyfr	ɬɨ̞vr
coeden	kɔɨ̯dan
u	ɨː
chansen	χansɛn
offeren	ɔfɛrɛn
af	aːv
ocsigenu	ɔksɪɡɛnɨ
neidio	nei̯djɔ
tyrrau	tərɛ
ennill	ɛnɪɬ
ysbyty	sbətɨ
ddegfed	ðɛɡvad
ngwenoliaid	ŋwɛnɔljɛd
wiwer	wɪu̯ar
ffermio	fɛrmjɔ
tŷ	tɨː
terfyn	tɛrvɨn
effaith	ɛfɛθ
llam	ɬam
amau	ama
elsech	ɛlsɛχ
torchau	tɔrχɛ
gwnaeth	naːθ
gwybodaeth	ɡwəbɔdɛθ
mygydau	məɡəda
llamidyddion	ɬamɪdəðjɔn
elwn	ɛlʊn
adferf	advɛrv
cefnau	kɛvnaɨ̯
teitlau	tei̯tlɛ
bastai	basdai̯
pabi	pabɪ
cristnogaeth	krɪsdnɔɡɛθ
loegr newydd	lɔɨ̯ɡərnɛu̯ɨ̞ð
cwmpas	kʊmpas
crydd	krɨːð
cnawd	knau̯d
efallai	ɛvaɬɛ
nghyfnither	ŋ̊əvnɪθɛr
denfyn	dɛnvɨ̞n
chut	χɨ̞t
ehangu	ɛhaŋɨ̞
mlynyddoedd	mlənəðɔɨ̯ð
syfi	səvi
ffilmiau	fɪlmjaɨ̯
bencampwriaeth	bɛŋkampʊrjaɨ̯θ
mhabell	m̥abaɬ
ysboncio	əsbɔŋkjɔ
gadd	ɡaːð
agoraf	aɡɔra
cesail	kɛsai̯l
thafarnwr	θavarnʊr
dalcen	dalkan
unet	ɨ̞nɛt
brwyna	brʊɨ̯na
milwyr	mɪlwɨ̞r
nghloch	ŋ̊loːχ
cwrs	kʊrs
rhosyn	r̥ɔsɨ̞n
canes	kanɛs
mhum	m̥ɨ̞m
aethit	eɨ̯θɪt
culdir	kɨ̞ldɪr
gneuen gyll	ɡneɨ̯anɡɨ̞ɬ
cweryl	kwɛrɨ̞l
dydd llun	dɨːðɬɨːn
rheoliadau	r̥ɛɔljadɛ
nhre	n̥reː
nhyrrau	n̥ərɛ
llochesau	ɬɔχɛsa
dechrau	dɛχraɨ̯
nghlefyd	ŋ̊lɛvɨ̞d
gweddi'r arglwydd	ɡwɛðɪrarɡluɨ̯ð
anrheg	anr̥ɛɡ
bancio	baŋkɔ
basta	basda
llyfn	ɬɨ̞vn
gwesgyr	ɡwɛsɡɨ̞r
tau	taɨ̯
lygad	ləɡad
dyblu	dəblɨ
ffrygydau	frəɡəda
garais	ɡarɛʃ
dyrysfa	dərəsva
taeogtref	teɨ̯ɔɡtrɛv
creisionen	krei̯ʃɔnɛn
trom	trɔm
canolbarth	kanɔlbarθ
baratoi	baratɔi̯
curo	kɨ̞rɔ
technoleg gwybodaeth	tɛχnɔlɛɡɡwəbɔdaɨ̯θ
llungopi	ɬɨ̞ŋɡɔpi
cherdded	χɛrðɛd
hwyaden	hʊɨ̯adɛn
try	trɨː
ymweld	əmwɛld
beirniadaeth	bei̯rnjadaɨ̯θ
gestyll	ɡɛsdɨ̞ɬ
hyll	hɨ̞ɬ
blwyddyn golau	blʊɨ̯ðɨ̞nɡɔlaɨ̯
cacennau	kakɛna
hechrydu	hɛχrədɨ
orffen	ɔrfan
gloset	ɡlɔsɛt
neidiau	nei̯djɛ
carew	karɛu̯
cathau	kaθa
nos sadwrn	noːssadʊrn
elli	ɛɬɪ
cosyn	kɔsɨ̞n
swm	sʊm
gweithgaredd	ɡwei̯θɡarɛð
sêr	seːr
llyfrgellydd	ɬəvrɡɛɬɨ̞ð
cait	kai̯t
un ar hugain	ɨːnarhɪɡai̯n
bigwrn	bɪɡʊrn
twymyn	tʊɨ̯mɨ̞n
nghrwth	ŋ̊ruːθ
tebyg	tɛbɨ̞ɡ
blwydd	bluːɨ̯ð
roi	rɔi̯
nos	noːs
celynnen	kɛlənɛn
cneuen	kneɨ̯ɛn
gwalch marth	ɡwalχmarθ
siwmper	ʃʊmpɛr
march	marχ
tân gwyllt	taːŋɡwɨːɬd
berfenwau	bɛrvɛnwa
bethau	bɛθɛ
abwyd	abʊɨ̯d
hyn a'r llall	hɨ̞narɬaɬ
deall	dɨ̞aɬ
cansai	kansɛ
padell	padɛɬ
ffrengig	frɛŋɪɡ
w	ʊ
syndodau	səndɔda
hy	hɨː
dydd gwener	dɨ̞ðɡwɛnar
caws	kau̯s
lasen	lasɛn
cwmpawd	kʊmpau̯d
manceinion	maŋkei̯njɔn
harian	harjan
lasach	lasaχ
orffen	ɔrfɛn
fyrdd	vɨ̞rð
teisennau	tɪʃɛna
cledr	klɛdr
mapiau	mapjaɨ̯
isteitlau	iːsdei̯tlaɨ̯
piws	pɪu̯s
pìn	pɪn
brawiau	brau̯jɛ
canrif	kanrɪv
cystadleuaeth	kəsdadleɨ̯ɛθ
lifft	lɪfd
gwinoedd	ɡwɪnɔɨ̯ð
nghawl	ŋ̊au̯l
cyfrinach	kəvrɪnaχ
gweriniaethau	ɡwɛrɪnjeɨ̯θɛ
maes awyr	maːɨ̯sau̯ɨ̞r
adferant	advɛrant
caffai	kafai̯
braw	braːu̯
doeddwn	dɔɨ̯ðʊn
ellyll	ɛɬɨ̞ɬ
gwelais	ɡwɛlɛs
agerlongau	aɡɛrlɔŋɛ
braich	brai̯χ
argraffiadol	arɡrafjadɔl
syrthio	sərθjɔ
sgìl	sɡɪl
safle	savlɛ
croeshoeliad	krɔɨ̯shɔɨ̯ljad
ymlaen llaw	əmlaːɨ̯nɬaːu̯
amgylcheddol	amɡəlχɛðɔl
nghymru	ŋ̊əmrɨ̞
droid	drɔi̯d
mhengwiniaid	m̥ɛŋɡwɪnjɛd
mam	mam
ystifflog	əsdɪflɔɡ
beirniadol	bei̯rnjadɔl
clodwiw	klɔdwɪu̯
agos	aɡɔs
gampfa	ɡampva
cyfarch	kəvarχ
eisiau	ei̯ʃaɨ̯
teisen	tei̯sɛn
tradwy	tradʊɨ̯
derbynneb	dɛrbənɛb
redeg	rɛdɛɡ
hedd	heːð
wybod	ʊbɔd
ffydd	fɨːð
anobaith	anɔbaiθ
gradd	ɡraːð
leision	lei̯ʃɔn
sgriau	sɡriːa
cydweithrediad	kɨːdwei̯θrɛdjad
aredaf	arɛda
lawio	lau̯jɔ
brawiau	brau̯ja
diolchgarwch	dɪɔlχɡarʊχ
garet	ɡarɛt
gweddïo	ɡwɛðɪɔ
eirin	ei̯rɪn
garwr	ɡarʊr
crwt	krʊt
caiff	kai̯f
araf	arav
gares	ɡarɛs
werthu	wɛrθɨ
dorsen	dɔrsɛn
efyrnwy	ɛvərnʊɨ̯
cytgord	kətɡɔrd
el	ɛl
drannoeth	dranɔɨ̯θ
pedoli	pɛdɔlɪ
llaith	ɬai̯θ
uned	ɨ̞nɛd
llenyddiaeth	ɬɛnəðjaɨ̯θ
canmoladwy	kanmɔladʊɨ̯
glustdlws	ɡlɨ̞sdlʊs
nhwrci	n̥ʊrki
derbyniad	dɛrbənjad
lleianaeth	ɬei̯anɛθ
pib	piːb
trefi	trɛvi
taranau	taranaɨ̯
cildwrn	kɪldʊrn
unid	ɨ̞nɪd
blwyddyn golau	blʊɨ̯ðɨ̞nɡɔlɛ
cacynen	kakənan
adegau	adɛɡɛ
briciau	brikjɛ
ffêr	feːr
dydd gwener	dɨ̞ɡwɛnɛr
nghefnau	ŋ̊ɛvnɛ
nydden	nəðɛn
cest	kɛsd
talom	talɔm
afonfarch	avɔnvarχ
abergofiant	abɛrɡɔvjant
buddion	bɨ̞ðjɔn
buddsoddi	bɨ̞ðsɔðɪ
gweision	ɡwei̯ʃɔn
taf	taːv
cryddiaeth	krəðjɛθ
hefyd	hɛvɨ̞d
sianis	ʃanɪs
derwen	dɛrwɛn
telynores	tɛlənɔrɛs
in	ɪn
iwan	ɪu̯an
enfys	ɛnvɨ̞s
canit	kanɪt
hoed	hoːɨ̯d
recordio	rɛkɔrdjɔ
eli	ɛli
llai	ɬai̯
awr	au̯r
gwlithlaw	ɡwlɪθlau̯
elsit	ɛlsɪt
tros	trɔs
cenhinen sifi	kɛnhɪnɛnsɪvɪ
dorra	dɔra
cloc	klɔk
trefynwy	trɛvənʊɨ̯
aton	atɔn
ai	ai̯
achubwr	aχɨ̞bʊr
asgellog	asɡɛɬɔɡ
faint o'r gloch	vai̯ntɔrɡloːχ
cyfnos	kəvnɔs
söolegwr	sɔɔlɛɡʊr
chneuen	χneɨ̯ɛn
achyddiaeth	aχəðjaɨ̯θ
caeaf	keɨ̯av
rhagfyr	r̥aɡvɨ̞r
amheuaeth	amheɨ̯ɛθ
ceinach	kei̯naχ
fawr	vau̯r
dy	də
gwch	ɡʊχ
rhyd	r̥ɨːd
theisen	θei̯san
llawer	ɬau̯ɛr
goleuadau	ɡɔleɨ̯adaɨ̯
brech	breːχ
darlunio	darlɨ̞njɔ
preifatrwydd	prei̯vatrʊɨ̯ð
gymedrolwr	ɡəmɛdrɔlʊr
rheolaidd	r̥ɛɔlai̯ð
byrddydd gaeaf	bərðɨ̞ðɡeɨ̯av
berfau	bɛrva
heol	heːɔl
seleri	sɛlɛri
dueg	dɨːɛɡ
cen cerrig	kɛnkɛrɪɡ
copïo	kɔpiːɔ
hwnna	hʊna
llwyddo	ɬʊɨ̯ðɔ
diwedd	dɪu̯ɛð
harall	haraɬ
allforio	aɬvɔrjɔ
tew	teːu̯
trengholiadau	trɛŋhɔljada
fe	veː
cerddoriaeth	kɛrðɔrjaɨ̯θ
syllta	səɬda
trwblus	trʊblɨ̞s
gnau ffrengig	ɡnaɨ̯frɛŋɪɡ
mwyara	mʊɨ̯ara
ffordd wen	əfɔrðwɛn
nghwningen	ŋ̊ʊnɪŋan
prawf	prau̯v
habadaethau	habadeɨ̯θaɨ̯
economegwyr	ɛkɔnɔmɛɡwɨ̞r
sgwâr	sɡwaːr
llungopïau	ɬɨ̞ŋɡɔpiːɛ
peintwyr	pei̯ntwɨ̞r
ymddiheuro	əmðɪheɨ̯rɔ
gusanu	ɡɨ̞sanɨ̞
eiliadau	ei̯ljadɛ
nos sadwrn	nɔsadʊn
fwyd	vuːɨ̯d
regi	rɛɡi
alarch	alarχ
stampiau	stampja
ymlaen	əmlaːɨ̯n
cromfach	krɔmvaχ
gwobrau	ɡwɔbra
mathau	maθɛ
eirth	ei̯rθ
pi	piː
dychryn	dəχrɨ̞n
titw tomos las	tɪtutɔmɔslaːs
rhaglenni	r̥aɡlɛni
ysgafnhau	əsɡavnhaɨ̯
arswydus	arsʊɨ̯dɨ̞s
cestyll	kɛsdɨ̞ɬ
ach	aχ
babi	babɪ
sesh	sɛʃ
digalonni	dɪɡalɔni
aradr	arad
mhengwiniaid	m̥ɛŋɡwɪnjai̯d
munudau	mɨ̞nɨ̞dɛ
chefnau	χɛvnaɨ̯
mlynedd	mlənɛð
casét	kasɛt
mamau	mamaɨ̯
sillgoll	sɪɬɡɔɬ
dyr	dɨ̞r
rhwyllau	r̥ʊɨ̯ɬɛ
cofia	kɔvja
im	ɪm
ugeiniau	ɪɡei̯nja
bedr	bɛdr
mhedwar	m̥ɛdwar
culdiroedd	kɨ̞ldɪrɔɨ̯ð
ceirios	kei̯rjɔs
adweitheg	adwei̯θɛɡ
neuaddau	neɨ̯aðaɨ̯
bron	brɔn
parcio	parkɔ
tudalennau gwe	tɨdalɛnaɡweː
adlef	adlɛv
rheoliadau	r̥ɛɔljadaɨ̯
hwyad	hʊɨ̯ad
gofod	ɡɔvɔd
coelio	kɔɨ̯ljɔ
rhyfelwr	r̥əvɛlʊr
thaler	θalɛr
cyfernod	kəvɛrnɔd
gweinyddiad	ɡwei̯nəðjad
traethodau	treɨ̯θɔda
gweinyddiadau	ɡwei̯nəðjadaɨ̯
alban elfed	albanɛlvɛd
mhengwin	m̥ɛŋɡwɪn
brochod	brɔχɔd
athrawes	aθrau̯ɛs
caerwysg	kaɨ̯ruːɨ̯sɡ
phethau	fɛθa
storïau	sdɔriːaɨ̯
focsio	vɔkʃɔ
anafu	anavɨ
ngwych	ŋwɨːχ
dyfeiswraig	dəvei̯swrai̯ɡ
aberthged	abɛrθɡɛd
gini	ɡɪnɪ
aberth	abɛrθ
do'ch	doːχ
cyfweliad	kəvwɛljad
ffonioch	fɔnjɔχ
tad	taːd
terydr	tɛrɨ̞dr
cyfarwyddo	kəvarwɨðɔ
phryf	frɨːv
carent	karɛnt
castanwydd	kasdanwɨ̞ð
mwyaf	mʊɨ̯a
drwg	druːɡ
nythu	nəθɨ̞
laeth	laːɨ̯θ
lleidr	ɬei̯dr
teiars	tei̯ars
pyjamas	pəd͡ʒamas
hydrefau	hədrɛvɛ
gwan	ɡwan
barnau	barnɛ
telynau teires	tɛlənaɨ̯tei̯rɛs
protestaniaeth	prɔtɛsdanjaɨ̯θ
gwario	ɡwarjɔ
adfilwyr	advɪlwɨ̞r
dyrysleoedd	dərəsleːɔɨ̯ð
catholigion	kaθɔlɪɡjɔn
'n	n
beirniad	bei̯rnjad
datguddio	datɡɨ̞ðjɔ
siwt	sɪu̯t
be'	bɛ
boddi	bɔði
rhywle	r̥ɪu̯la
cythraul	kəθrɛl
bangor	baŋɡɔr
dyrysfeydd	dərəsveɨ̯ð
gwerthwyr	ɡwɛrθwɨ̞r
dŵr	duːr
siwrnai	ʃʊrnai̯
bondigrybwyll	bɔndɪɡrəbʊɨ̯ɬ
ecogyfeillgar	ɛkɔɡəvei̯ɬɡar
dylanwad	dəlanwad
dreisiwr	drei̯ʃʊr
sebon	sɛbɔn
cyfundrefn	kəvɨ̞ndrɛvn
codau	kɔda
trefgordd	trɛvɡɔrð
blychau llwch	bləχɛɬuːχ
gofyn	ɡɔvɨ̞n
rydw i'n dy garu di	rədwɪndəɡarɨ̞diː
phethau	fɛθɛ
hybu	həbɨ
cloriau	klɔrjaɨ̯
gwraig	ɡwrai̯ɡ
nôl	noːl
thîm	θiːm
dryw	drɪu̯
epidemigau	ɛpɪdɛmɪɡa
sofren	sɔvrɛn
wedi	wɛdi
thrawant	θrau̯ant
microsgopau	mei̯krɔsɡɔpɛ
meddal	mɛðal
milddail	milðai̯l
fwyaf	vʊɨ̯a
addurn	aðɨ̞rn
dyna	dənɛ
mynediad	mənɛdjad
sawdd	sau̯ð
clyw	klɪu̯
iwd	juːd
anobeithiau	anɔbei̯θjɛ
gwasanaeth	ɡwasanɛθ
cytseiniaid	kətsei̯njɛd
chôt law	χoːtlaːu̯
sinsir	sɪnsɪr
gwenyn mêl	ɡwɛnɨ̞mmeːl
ngardd	ŋarð
anghyfartal	aŋhəvartal
ynddo	ənðɔ
gwrthryfel	ɡʊrθrəvɛl
farnau	varna
rheiddiau	r̥ei̯ðja
parotach	parɔtaχ
cryn	krɨ̞n
wella	wɛɬa
efallai	ɛvaɬa
egluro	ɛɡlɨrɔ
terfysgaeth	tɛrvəsɡaɨ̯θ
animeiddiadau	anɪmei̯ðjjadaɨ̯
hunarddeg	hɨːnarðeːɡ
eisteddfodau	ei̯sdɛðvɔdaɨ̯
droi	drɔi̯
abermaw	abɛrmau̯
ab	ab
gyfnither	ɡəvnɪθɛr
rhent	r̥ɛnt
dydd sadwrn	dɨ̞ðsadʊrn
dw i'n iawn	duinjaun
rhwyg	r̥uːɨ̯ɡ
cusanau	kɨ̞sana
ngherddoriaeth	ŋ̊ɛrðɔrjɛθ
plethau	plɛθaɨ̯
phum	fɨ̞m
cyfrin	kəvrɪn
jôc	d͡ʒoːk
tua thref	tɨaθreːv
cyfwelydd	kəvwɛlɨ̞ð
llusg	ɬɨːsɡ
pethau	pɛθa
gwyddion	ɡwəðjɔn
crefydd	krɛvɨ̞ð
ar agor	araɡɔr
rheolaidd	r̥ɛɔlɛð
porfa	pɔrva
leicia	lei̯kja
canhwyllbren	kanhʊɨ̯ɬbrɛn
peintiwr	pei̯ntjʊr
gobeithiol	ɡɔbei̯θjɔl
becws	bɛkʊs
chnau cyll	χnaɨ̯kɨ̞ɬ
canmoliaethau	kanmɔljeɨ̯θa
bwydydd	bʊɨ̯dɨ̞ð
redeg	rɛdaɡ
cachi	kaχɪ
rydw i'n dy garu di	rədʊi̯ndəɡaːridiː
sunthesis	sɨ̞nθɛsɪs
nghneuen ffrengig	ŋ̊neɨ̯anfrɛŋɪɡ
castell	kasdɛɬ
contractau	kɔntraktaɨ̯
delit	dɛlɪt
elciaid	ɛlkjɛd
economeg	ɛkɔnɔmɛɡ
iselydd	ɪsɛlɨ̞ð
cain	kai̯n
mag	maːɡ
canmol	kanmɔl
cerddoriaeth	kɛrðɔrjɛθ
bandiau	bandjaɨ̯
thad	θaːd
athrod	aθrɔd
cefn	kɛvn
gyll	ɡɨ̞ɬ
leician	lɪkjan
gwerddonau	ɡwɛrðɔnaɨ̯
siwmperi	ʃʊmpɛri
cyfer	kəvɛr
brith	briːθ
sosys	sɔsɨ̯s
tenantiaid	tɛnantjai̯d
cilydd	kɪlɨ̞ð
sglodyn	sɡlɔdɨ̞n
hirsgwariau	hɪrsɡwarjɛ
nes	nɛs
delynores	dɛlənɔrɛs
nos lun	nɔslɨːn
tyle	təlɛ
archebu	arχɛbɨ
pioden	pjɔdɛn
brawd	brau̯d
adleisiau	adlei̯ʃaɨ̯
diryw	dɪrɨ̞u̯
blasus	blasɨ̞s
blinedig	blɪnɛdɪɡ
pannas	panas
gwpan	ɡʊpan
caerdydd	kərdɨːð
athrawesau	aθrau̯ɛsaɨ̯
leuen	leɨ̯ɛn
aidd	ai̯ð
tydy	tədi
dalan	dalan
rhentwyr	r̥ɛntwɨ̞r
yn gwmws	əŋɡʊmʊs
ocê	ɔkeː
picau bach	pɪkabaːχ
thrwyddedau	θrʊɨ̯ðɛdɛ
saesneg	seɨ̯snɛɡ
unwaith	ɨ̞nwɛθ
cig	kiːɡ
cylion	kəljɔn
mên	meːn
eisiau	ɪʃɔ
gefnau	ɡɛvna
aifft	ai̯ft
dros dro	droːsdroː
cryf	krɨːv
ddoe	ðoːɨ̯
gŵyl	ɡuːɨ̯l
hanner	hanɛr
dòl	dɔl
canmoliaeth	kanmɔljɛθ
chythraul	χəθral
mherthynas	m̥ɛrθənas
gelet	ɡɛlɛt
angen	aŋan
gweddïau	ɡwɛðiːɛ
anabledd	anablɛð
muchudd	mɨ̞χɨ̞ð
nag	naɡ
chyfnither	χəvnɪθar
chwilio	χwɪljɔ
cwynion	kʊɨ̯njɔn
gair	ɡai̯r
garanod	ɡaranɔd
bobl	bɔbl
derbynfa	dɛrbənva
ffenestr	fɛnasd
bellach	bɛɬaχ
teigr	tei̯ɡr
acha	aχa
lleill	ɬei̯ɬ
mhryfed	m̥rəvad
nhreisiwr	n̥rei̯ʃʊr
ryseitiau	rəsei̯tja
meiddion	mei̯ðjɔn
caerfaddon	kaɨ̯rvaðɔn
amrywiaeth	amrɨu̯jaɨ̯ð
pyliau	pəljaɨ̯
troedfedd	trɔɨ̯dvɛð
fochyn	vɔχɨ̞n
tafarnwr	tavarnʊr
cymer	kəmɛr
grymus	ɡrəmɨ̞s
ymdreiddio	əmdreiðjɔ
adferiadwyr	advɛrjadəðwɨ̞r
lwyddo	lʊɨ̯ðɔ
poster	pɔsdar
achlesu	aχlɛsɨ̞
chest	χɛst
trwyddedau	trʊɨ̯ðɛdaɨ̯
nghymaint	ŋ̊əmɛnt
go lew	ɡɔleːu̯
unais	ɨ̞nɪʃ
tywodfaen	təu̯ɔdvaɨ̯n
ieuan	jeɨ̯an
dychwelyd	dəχwɛlɨ̞d
trywelion	trəu̯ɛljɔn
torchi	tɔrχi
llwydo	ɬʊɨ̯dɔ
rheolau	r̥ɛɔlɛ
hanes	hanɛs
gwobrau	ɡwɔbraɨ̯
ngŵyr	ŋuːɨ̯r
sicr	sɪkɪr
nail	nai̯l
clybiau	kləbja
nghalennig	ŋ̊alɛnɪɡ
mwst	mʊsd
amhenodol	amhɛnɔdɔl
nglased	ŋlasɛd
ddangos	ðaŋɔs
anafais	anavɛs
cachan	kaχan
dydd gwener	dɨ̞ðɡwɛnɛr
rywle	rʊla
dysgleidiau	dɨ̞sɡlei̯djaɨ̯
clyfar	kləvar
poeth	poːɨ̯θ
llawfeddyg	ɬau̯vɛðɪɡ
cloch	kloːχ
fawn	vau̯n
cyfreithiwr	kəvrei̯θjʊr
daliadaethau	daljadeɨ̯θɛ
rywle	rɨu̯lɛ
sylfaenol	səlveɨ̯nɔl
olddodiad	oːlðɔdjad
pumed	pɨ̞mɛd
ro	roː
uwd	ɨ̞u̯d
sgrechian	sɡrɛχjan
habadesau	habadɛsaɨ̯
carem	karɛm
priodi	priɔdi
un	ɨːn
piso	pɪsɔ
buddugoliaeth	bɨ̞ðɨ̞ɡɔljɛθ
fawrth	vau̯rθ
gwlana	ɡwlana
lygaid	ləɡai̯d
athref	aθrɛv
gath	ɡaːθ
carthennau	karθɛnɛ
cyfundrefnu	kəvɨ̞ndrɛvnɨ
swper	sʊpɛr
piglas	pɪɡlas
ddim	əm
cernyw	kɛrnɨ̞u̯
fydd	vɨːð
maes	maːɨ̯s
soddi	sɔði
adferiadau	advɛrjadɛ
oedolion	ɔɨ̯dɔljɔn
unir	ɨ̞nɪr
pibwr inc	pɪbʊrɪŋk
cosb	koːsb
caran	karan
parchu	parχɨ
paneidiau	panei̯djɛ
ŵyll	uːɨ̯ɬ
aethpwyd	eɨ̯θpʊɨ̯d
cynaeafu	kəneɨ̯avɨ
hywel	həu̯ɛl
nghnau ffrengig	ŋ̊naɨ̯frɛŋɪɡ
oriau	ɔrja
gwên	ɡweːn
ysaf	əsav
elsai	ɛlsai̯
dirwy	dɪrʊɨ̯
echnos	ɛχnɔs
mhastai	m̥asdai̯
mhaith	m̥ai̯θ
eirlys	ei̯rlɨ̞s
cwpaneidiau	kʊpanei̯dja
dad	daːd
lys	lɨːs
casglu	kasɡlɨ
cic adlam	kɪkadlam
nhrwyddedau	n̥rʊɨ̯ðɛdaɨ̯
mheis	m̥eis
deles	dɛlɛs
hirsgwariau	hɪrsɡwarjaɨ̯
lliwydd	ɬɪu̯ɨ̞ð
clywed	kləu̯ɛd
hunllef	hɨ̞nɬɛv
gallan	ɡaɬan
cyflawni	kəvlau̯ni
cyfatebiaeth	kəvatɛbjaɨ̯θ
llwch	ɬuːχ
brwydrau	brʊɨ̯dra
teisen	tɪʃan
dacluso	daklɨ̞sɔ
haros	harɔs
ceiniog	kei̯njɔɡ
chlust	χlɨːst
dydd mercher	dɨ̞mɛrχɛr
crech	kreːχ
trwchus	trʊχɨ̞s
cotiau	kɔtjaɨ̯
gwenynen	ɡwenənɛn
rheol	r̥eːɔl
conwydden	kɔnwəðan
griliau	ɡrɪlja
calon	kalɔn
amgylchedd	amɡəlχɛð
gerir	ɡɛrɪr
gwlychu	ɡləχi
portiwgal	pɔrtjʊɡal
hirsgwarau	hɪrsɡwara
coeden	kɔɨ̯dɛn
academydd	akadɛmɨ̞ð
carai	karɛ
ngweld	ŋwɛld
ffili	fɪlɪ
ymadael	əmadɛl
haden	hadɛn
achwyn	aχwɨ̞n
cyfweld	kəvwɛld
olifau	ɔlɪva
nyth	nɨːθ
tarw	taru
ffôn clyfar	foːnkləvar
dalcen	dalkɛn
perllan	pɛrɬan
teithi	tei̯θi
gwych	ɡwɨːχ
adaryddion	adarəðjɔn
gwely	ɡwɛlɨ
rhywiol	r̥ɨu̯jɔl
nghwningen	ŋ̊ʊnɪŋɛn
letysen	lɛtəsan
tafod	tavɔd
shibwns	ʃɪbʊns
ddod	ðoːd
rysáit	rəsai̯t
cymedrol	kəmɛdrɔl
lleianaeth	ɬei̯anaɨ̯θ
pedolau	pɛdɔlaɨ̯
wael	waːɨ̯l
afalau cariad	avalakarjad
adain	adɛn
coronafeirysau	kɔrɔnavei̯rəsa
dân	daːn
rheidrwydd	r̥ei̯drʊɨ̯ð
chegin	χɛɡɪn
gwsberis	ɡʊsbɛrɪs
albanau	albanɛ
nawr	nau̯r
clo	kloː
meheryn	mɛhɛrɨ̞n
catholigiaeth	kaθɔlɪɡjɛθ
hirgrwn	hɪrɡrʊn
mynd	mɨ̞n
dynleiddiaid	dɨːnlei̯ðjɛd
gweinyddiadau	ɡwei̯nəðjadɛ
cewch	kɛu̯χ
anghydraddoldeb	aŋhədraðɔldɛb
iselder	ɪsɛldar
datgelu	datɡɛlɨ
nghwpan	ŋ̊ʊpan
mhencampwyr	m̥ɛŋkampwɨ̞r
llansamlet	ɬansamlɛt
sashimi	saʃɪmɪ
capel	kapɛl
wyn	wɨ̞n
gadael	ɡadal
taro	tarɔ
ymedy	əmɛdɨ
benywaidd	bɛnɨ̞u̯ai̯ð
gwlych	ɡwlɨːχ
masgau	masɡɛ
deulo	deɨ̯lɔ
maen	maːɨ̯n
sgwrs	sɡʊrs
fu	vɨː
picwnen goch	pɪkuːnɛŋɡoːχ
dosbarthiadau	dɔsbarθjadaɨ̯
muwch	mɨu̯χ
gwyliedyddion	ɡwɨ̞ljɛdəðjɔn
gwasgaru	ɡwasɡarɨ
brân gernyw	braːnɡɛrnɨu̯
sêl	seːl
cyẅres	kəʊrɛs
maen	man
gallai	ɡaɬɛ
trefedigaethau	trɛvɛdɪɡeɨ̯θaɨ̯
hyn	hɨ̞n
annherfynol	anhɛrvənɔl
amau	amɛ
cwrw	kʊru
cystadleuydd	kəsdadleɨ̯ɨ̞ð
siocledi	ʃɔklɛdi
rhaid	r̥ai̯d
lleugylch	ɬeɨ̯ɡɨ̞lχ
contractau	kɔntrakta
cachu	kaχɨ̞
gweinidog	ɡwei̯nɨ̞dɔɡ
hafota	havɔta
anghofio	aŋhɔvjɔ
hydref	hədrɛ
canmolwr	kanmɔlʊr
tanbaid	tambai̯d
llythrennol	ɬəθrɛnɔl
ngolchi	ŋɔlχɪ
chwch	χʊχ
cyflwyno	kəvlʊɨ̯nɔ
ifanc	ɪvaŋk
na	naː
cyfryngiadau	kəvrəŋjadɛ
isteitlo	iːsdei̯tlɔ
pibonwyen	pɪbɔnuɨ̯ɛn
siop goffi	ʃɔpɡɔfi
canolaf	kanɔlav
ledled	lɛdlɛd
mafon	mavɔn
gwybed ffwng	ɡwəbɛdfʊŋ
cennad	kɛnad
deugeiniau	dei̯ɡei̯nja
grug	ɡrɨːɡ
cafwyd	kavʊɨ̯d
elc	ɛlk
phigwrn	fɪɡʊrn
trois	trɔi̯s
llwybr y gwynt	ɬʊɨ̯brəɡwɨ̞nt
cof	koːv
wyf	uːɨ̯v
poenen	pɔɨ̯nɛn
nghyfreithiwr	ŋ̊əvrei̯θjʊr
byddi	bəðɪ
nglân	ŋlaːn
thalo	θalɔ
gwrthiselder	ɡʊrθɪsɛldɛr
talcen	talkan
cyfarfod	kəvarvɔd
crymu	krəmɨ
bychan	bəχan
beis	beis
cic gosb	kɪkɡoːsb
pilen	pɪlɛn
hugain	hɪɡjan
adnabyddwch	adnabəðʊχ
argrafiadau	arɡrafjadɛ
chneuen ffrengig	χneɨ̯anfrɛŋɪɡ
awgrymu	au̯ɡrəmɨ
mhortiwgal	m̥ɔrtɪu̯ɡal
gerais	ɡɛrai̯s
helyglys	hɛləɡlɨ̞s
eithaf	əi̯θav
mywyd	məu̯ɨ̞d
phant	fant
ddolis	ðɔlɪs
menyn	mɛnɨ̞n
megan	mɛɡan
dynes	dənɛs
asen	asɛn
sefyllfa	sɛvəɬva
abadaeth	abadɛθ
mari	marɪ
wenoliaid	wɛnɔljɛd
cristnogaeth	krɪsdnɔɡaɨ̯θ
asesiadau	asɛʃada
gronellau	ɡrɔnɛɬɛ
esgobion	ɛsɡɔbjɔn
harlwy	harluɨ̯
tolio	tɔljɔ
beiddio	beiðjɔ
swydd	suːɨ̯ð
torlannau	tɔrlana
bywyd	bəu̯ɨ̞d
gyfiawnder	ɡəvjau̯ndɛr
h	haːɨ̯tʃ
phen	fɛn
wŷr	wɨːr
cornel	kɔrnal
ddoli	ðɔli
ydy	ndi
ngâl	ŋaːl
crychion	krəχjɔn
ymrysonwyr	əmrəsɔnwɨ̞r
ngwiwerod	ŋwɪu̯ɛrɔd
coginio	kɔɡɪnjɔ
deigrod	dei̯ɡrɔd
amrwd	amrʊd
achwyniadau	aχʊɨ̯njadɛ
preswyl	prɛsʊɨ̯l
rheoliaduron	r̥ɛɔljadɨ̞rɔn
canwyllbrennau	kanʊɨ̯ɬbrɛnaɨ̯
arfau	arvɛ
esgob	ɛsɡɔb
bys troed	bɨːstroːɨ̯d
dyrrau	dəra
planhigion	planhɪɡjɔn
mewnfudo	mɛu̯nvɨ̞dɔ
adwthio	adʊθjɔ
pry'r gannwyll	prɨːrɡanʊɨ̯ɬ
papur	papɨ̞r
ofergoel	ɔvɛrɡɔɨ̯l
ban	ban
llys	ɬɨːs
utgorn	ɨ̞tɡɔrn
bioleg	bjɔlɛɡ
mwyn	muːɨ̯n
hail	hai̯l
byddai	bəða
gythreuliaid	ɡəθreɨ̯ljai̯d
credes	krɛdɛs
dyryslyd	dərəslɨ̞d
cas beth	kaːsbeːθ
chato	χatɔ
ŵyn	uːɨ̯n
celet	kɛlɛt
haberdâr	habɛrdaːr
beirniadaethau	bei̯rnjadeɨ̯θaɨ̯
angyles	aŋəlɛs
cydwelediad	kɨ̞dwɛlɛdjad
diddordeb	dɪðɔrdab
santesau	santɛsaɨ̯
theisen	θɪʃan
dolffiniaid	dɔlfɪnjɛd
feddwl	vɛðʊl
isod	ɪsɔd
abadesau	abadɛsɛ
llost	ɬɔsd
nghariad	ŋ̊arjad
ngwella	ŋwɛɬa
murddunnod	mɨ̞rðɨ̞nɔd
gwalch y nos	ɡwalχənoːs
llyf gen	ɬəvɡɛn
wydraid	wədrai̯d
effaith	ɛfai̯θ
cymar	kəmar
picau	pɪkaɨ̯
euog	eɨ̯ɔɡ
crac	krak
cneua	kneɨ̯a
adfyd	advɨ̞d
glân	ɡlaːn
adeilad	adei̯lad
habadesau	habadɛsa
brawychiadau	brau̯əχjadɛ
affwysol	afʊɨ̯sɔl
llysg	ɬɨːsɡ
llungopïwyr	ɬɨ̞ŋɡɔpɪwɨ̞r
rhychau	r̥əχa
siwrnai	ʃʊrnɛ
chystadlu	χəsdadlɨ
wythnos	ʊsɔs
cu	kɨː
dengys	dɛŋɡɨ̞s
henghraifft	hɛŋ̊rai̯fd
aflwyddiannus	avlʊɨ̯ðjanɨ̞s
gwenhwyfar	ɡwɛnhʊɨ̯var
aberdaugleddau	abɛrdaɨ̯ɡlɛðaɨ̯
gorffen	ɡɔrfɛn
carais	karɛs
deg ar hugain	deːɡarhɪɡai̯n
nghneuen ffrengig	ŋ̊neɨ̯ɛnfrɛŋɪɡ
eangiadau	ɛaŋjada
trenau	trɛna
rhaidd	r̥ai̯ð
gwynnach	ɡwənaχ
o hyn allan	ɔhɨ̞naɬan
drwydded	drʊɨ̯ðɛd
gyrraedd	ɡərað
teires	tei̯rɛs
chwiorydd	χwiɔrɨ̞ð
adferwyr	advɛrwɨ̞r
rydw	rədw
barhau	barhaɨ̯
thro	θroː
phiws	fɪu̯s
trwyn	truːɨ̯n
blanced	blaŋkad
ffugenw	fɨ̞ɡɛnʊ
syth	sɨːθ
gleision	ɡlei̯ʃɔn
mwg	muːɡ
rhydychen	r̥ɨːdəχɛn
syndodau	səndɔdaɨ̯
rhwyd	r̥uːɨ̯d
galon	ɡalɔn
thyn	θɨ̞n
yfed	əvɛd
lwy	luːɨ̯
nos sadwrn	nɔssadʊn
amheuaeth	amheɨ̯aɨ̯θ
mynwy	mənʊɨ̯
hunain	hɨ̞nɛn
ymdraidd	əmdrai̯ð
cyfrwngddarostyngedigaeth	kəvrʊŋðarɔsdəŋɛdɪɡɛθ
baedd	baːɨ̯ð
heulog	heɨ̯lɔɡ
gwladgarol	ɡwladɡarɔl
hwrdd	hʊrð
ysgol	əsɡɔl
lech	leːχ
rywsut	rɪu̯sɨ̞t
gara	ɡara
pabell	pabɛɬ
diamod	diamɔd
chwestiwn	kwɛsdjʊn
cwpanaid	kʊpanɛd
absennu	absɛnɨ
olif	ɔlɪv
chapel	χapɛl
cangarŵod	kaŋɡaruːɔd
glaned	ɡlanɛd
gwydr	ɡwɨ̞dr
tenant	tɛnant
ngardd	ŋaːrð
drefydd	drɛvɨ̞ð
rhesi	r̥ɛsi
chaf	χaːv
llyw	ɬɨ̞u̯
cymraeg	kəmraːɡ
chymaint	χəmɛnt
aeddfed	aɨ̯ðvɛd
hyllt	hɨːɬd
cwerylgar	kwɛrəlɡar
newynau	nɛu̯ənaɨ̯
gwobr	ɡwɔbr
fflŵr	fluːr
cawl	kau̯l
chythraul	χəθrɛl
adwaenwn	adweɨ̯nʊn
iddew	ɪðɛu̯
glanaf	ɡlanav
ngwŷr	ŋwɨːr
hon	hɔn
nhaliadau	n̥aljadaɨ̯
thu	θɨː
nofwraig	nɔvwrai̯ɡ
nhudalen	n̥ɨ̞dalan
gadael	ɡadaɨ̯l
arolygiad	arɔləɡjad
deunaw	deɨ̯nau̯
briallu	brjaɬɨ̞
brathu	braθɨ̞
nghusanau	ŋ̊ɨ̞sana
trengholiad	trɛŋhɔljad
jac	dʒak
echddoe	ɛχðɔɨ̯
dyma	dəma
blwch llwch	bluːχɬuːχ
daliadau	daljada
efallai	ɛɬa
tenantiaeth	tɛnantjɛθ
rwyt	ruːɨ̯t
canwyllbrennau	kanʊɨ̯ɬbrɛnɛ
chachi	χaχɪ
doli	dɔli
doliau	dɔljaɨ̯
hwntws	hʊntus
ulyfai	ɨ̞ləvai̯
nghneuen gyll	ŋ̊neɨ̯ɛnɡɨ̞ɬ
gwahaniaethu	ɡwahanjeɨ̯θɨ
gweryd	ɡwɛrɨ̞d
eloch	ɛlɔχ
chodi	χɔdɪ
dydd sadwrn	dɨ̞sadʊrn
afraid	avrai̯d
arwerthiant	arwɛrθjant
cachgwn bwm	kaχɡʊmbʊm
tawn	tau̯n
urdd	ɨ̞rð
datws	datʊs
masgiau	masɡjɛ
clodfori	klɔdvɔri
rywbeth	rɨu̯bɛθ
turtur	tɨ̞rtɨ̞r
streicio	sdrei̯kjɔ
nadredd	nadrɛð
berfau annherfynol	bɛrvɛanhɛrvənɔl
addawa	aðau̯a
achlysurol	aχləsɨ̞rɔl
plismon	plismɔn
cacen gri	kakaŋɡriː
ganes	ɡanɛs
darianau	darjana
dyfrdwy	dəvrdʊɨ̯
hardded	harðɛd
nghain	ŋ̊ai̯n
phengwin	fɛŋɡwɪn
enwog	ɛnwɔɡ
arswydo	arsʊɨ̯dɔ
chochlas	χɔχlas
cyfrifoldeb	kəvrɪvɔldɛb
atseiniau	atsei̯nja
elech	ɛlɛχ
gorlifo	ɡɔrlɪvɔ
ril	riːl
cyfenw	kəvɛnu
dwy	duːɨ̯
dwfn	dɨ̞vn
ych	əχ
alar	alar
graff	ɡraːf
mabwysiadu	mabʊɨ̯ʃadɨ
tyfu	təvɨ
benthycion	bɛnθəkjɔn
ceith	kəi̯θ
i'w	ɪu̯
negeseua	nɛɡɛseɨ̯a
gwympo	ɡwɨmpɔ
talaf	tala
ystod	əsdɔd
chenhinen	χɛnhɪnɛn
cyntefin	kəntɛvɪn
mewnforiadwy	mɛu̯nvɔrjadʊɨ̯
adaryddiaeth	adarəðjaɨ̯θ
pluf	plɨːv
una	ɨ̞na
hances	hankas
arfeddog	arvɛðɔɡ
ffawydd	fau̯ɨ̞ð
cawn	kau̯n
daliad	daljad
chari	χarɪ
rhys	r̥ɨːs
cneuen	kneɨ̯an
adegau	adɛɡa
gwrthwynebydd	ɡʊrθwɨ̞nɛbɨ̞ð
crwn	krʊn
gwrendy	ɡwrɛndɨ
rhagddodiad	r̥aɡðɔdjad
cyfartal	kəvartal
dosbarthol	dɔsbarθɔl
canhwyllau	kanhʊi̯ɬɛ
gwrthryfela	ɡʊrθrəvɛla
archfarchnad	arχvarχnad
gusanau	ɡɨ̞sanaɨ̯
menyw	mɛnɨ̞u̯
cyntedd	kəntɛð
gorfod	ɡɔrɔ
charai	χarai̯
choch	χoːχ
thywyll	θəu̯ɨ̞ɬ
dymuno	dəmɨ̞nɔ
tyllau yn y wal	təɬaɨ̯ənəwal
mynyddoedd	mənəðɔɨ̯ð
nghyfiawnder	ŋ̊əvjau̯ndɛr
ehangder	ɛhaŋdɛr
ar bwys	arbuːɨ̯s
salamandr	salamandr
gwylliaid	ɡwɨ̞ɬjɛd
crynwyr	krənwɨ̞r
dadlwytho	dadlʊɨ̯θɔ
hamser	hamsɛr
merch	mɛrχ
bigan	bɪɡan
fur	vɨːr
tâp	taːp
gaffer	ɡafɛr
nglanaf	ŋlanav
datys	datɨ̞s
dala	dala
gwrthwynebiad	ɡʊrθwɨ̞nɛbjad
ysbyty	əsbətɨ
babell	babɛɬ
mleiddiaid	mlei̯ðjai̯d
ymlynu	əmlənɨ̞
caffent	kafɛnt
fynydd	vənɨ̞ð
dyfarniad	dəvarnjad
diddorol	dɪðɔrɔl
cyrhaeddwch	kərhaɨ̯ðʊχ
galluogi	ɡaɬɨɔɡi
ble	bleː
amheuaf	amheɨ̯av
tonau	tɔnɛ
doliau	dɔljɛ
blynyddoedd golau	blənəðɔɨ̯ðɡɔlɛ
prydain	prədɛn
eliffant	ɛlɪfant
dolen	dɔlan
nacáu	nakaɨ̯
throes	θroːɨ̯s
rhwydwaith	r̥ʊi̯dwɛθ
baban	baban
pedwar ar ddeg	pɛdwararðeːɡ
grym	ɡrɨ̞m
digalondid	dɪɡalɔndɪd
mapio	mapɔ
hirddydd haf	hɪrðɨ̞ðhaːv
adfeiliadau	advei̯ljada
nghael	ŋ̊aːl
ryseitiau	rəsei̯tjaɨ̯
chusanau	χɨ̞sanaɨ̯
dw i angen condom	duiaŋɡɛnkɔndɔm
cusanau	kɨ̞sanɛ
gyflym	ɡəvlɨ̞m
cyrhaeddaf	kərhaɨ̯ðav
dyddiadau	dəðjadɛ
flynyddoedd	vlənəðɔɨ̯ð
oce	ɔkɛ
ymdrech	əmdrɛχ
ryfelwyr	rəvɛlwɨ̞r
arholiadau	arhɔljada
gwasanaeth	ɡwasanaθ
bwl	bʊl
dyrchafu	dərχavɨ
gynnar	ɡənar
gymorth	ɡəmɔrθ
ry	rɨː
hendrefa	hɛndrɛva
phryfed	frəvɛd
briallen	brɪaɬɛn
trafferthion	trafɛrθjɔn
cyfun	kəvɨ̞n
gwyddbwyll	ɡwɨ̞ðbʊɨ̯ɬ
nhaith	n̥ai̯θ
plygiau	pləɡjɛ
iddewiaeth	ɪðeu̯jɛθ
eiliadau	ei̯ljada
aromatherapyddion	arɔmaθɛrapəðjɔn
gefnau	ɡɛvnɛ
gwyllon	ɡwəɬɔn
sir	siːr
glo	ɡloː
ager	aɡɛr
do	doː
tyllau	təɬaɨ̯
gweinyddiaethau	ɡwei̯nəðjeɨ̯θɛ
wely	wɛlɨ
cyflafar	kəvlavar
gwg	ɡuːɡ
cwestiwn	kwɛsdjʊn
iddewesau	ɪðɛu̯ɛsa
nhro	n̥roː
ymuno	əmɨ̞nɔ
pigau	pɪɡɛ
trafferth	trafarθ
sylw	səlu
adenedigaethau	adɛnɛdɪɡeɨ̯θaɨ̯
maneg	manɛɡ
adara	adara
gest	ɡɛst
wrando	wrandɔ
rhiniart	r̥ɪnjart
chain	χai̯n
hedfan	hɛdvan
cryf	krɨː
tymor	təmɔr
geiriog	ɡei̯rjɔɡ
adeiladwaith	adei̯ladwai̯θ
dyd	dɨːd
awtistiaeth	au̯tɪsdjɛθ
wylio	wɨ̞ljɔ
fewn	vɨ̞u̯n
ddeset	ðɛsɛt
cwtiar	kʊtjar
picl	pɪkl
caffîn	kafiːn
cantor	kantɔr
dyfeiswragedd	dəvei̯swraɡɛð
gwyneth	ɡwɨ̞nɛθ
pedwar ar bymtheg	pɛdwararbəmθaɡ
tra	traː
arfer	arvar
utgyrn	ɨ̞tɡɨ̞rn
gwahanu	ɡwahanɨ
derwyddiaeth	dɛrwəðjɛθ
mae'n ddrwg gen i	maːɨ̯nðruːɡɡɛnɪ
eirin gwlanog	ei̯rɪŋɡwlanɔɡ
gafr	ɡavr
shibwnsyn	ʃɪbʊnsɨ̞n
goddrych	ɡɔðrɨ̞χ
tafodiaith	tavɔdjɛθ
gneuen ffrengig	ɡneɨ̯ɛnfrɛŋɪɡ
sefydlogi	sɛvədlɔɡi
cansai	kansai̯
sach	saːχ
gansai	ɡansai̯
ddolur	ðɔlɨ̞r
cangen	kaŋan
pleidiol	plei̯djɔl
pentref	pɛntrɛ
athrefi	aθrɛvɪ
genwair	ɡɛnwai̯r
clas	klaːs
gwenynen feirch	ɡwɛnənanvei̯rχ
chusanu	χɨ̞sanɨ̞
llenyddiaeth	ɬɛnəðjɛθ
pwnc	pʊŋk
sut dach chi	sɨ̞tdaχχiː
ticio	tɪkɔ
llychlynnaidd	ɬəχlənai̯ð
arth fach	arθvaːχ
habatai	habataɨ̯
brwyn	bruːɨ̯n
nofio	nɔvjɔ
abadau	abadɛ
amodiad	amɔdjad
sioeau	ʃɔɨ̯aɨ̯
picil	pɪkɪl
laned	lanɛd
riliau	rɪljɛ
cyfarthiadau	kəvarθjadɛ
dawns	dau̯ns
pharatoi	faratɔi̯
mlynedd	mlənað
cyfieithydd	kəvjei̯θɨ̞ð
lles	ɬeːs
em	ɛm
traidd	trai̯ð
rhaglen	r̥aɡlɛn
amrywiaeth	amrɨu̯jɛθ
neidiau	nei̯dja
cred	kreːd
lluddias	ɬɨ̞ðjas
ysgrifen	sɡrɪvan
nhroed	n̥roːɨ̯d
gwâl	ɡwaːl
adfer	advɛr
coronafirws	kɔrɔnavɪrʊs
i lawr	ɪlau̯r
ddeuddegfed	ðeɨ̯ðɛɡvad
carai	karai̯
siafio	ʃavjɔ
es	eːs
ail	ai̯l
smwddio	smʊðjɔ
flew	vleːu̯
adenedigaethau	adɛnɛdɪɡeɨ̯θɛ
nghusan	ŋ̊ɨ̞san
picau maen	pɪkɛmaːɨ̯n
peniadau	pɛnjadaɨ̯
adar	adar
cwstard	kʊsdard
trawsenw	trau̯sɛnu
dydw	dədʊ
llygad	ɬɨ̞ɡad
cic	kɪk
ryddid	rəðɪd
llochesau	ɬɔχɛsɛ
atborthion	atbɔrθjɔn
gloch	ɡloːχ
lloegr	ɬɔɨ̯ɡar
ffraeon	freɨ̯ɔn
sawsiau	sau̯ʃɛ
byliau	bəljɛ
blorai	blɔrai̯
ngwyched	ŋwəχɛd
gwelwch	ɡwɛlʊχ
mislif	mɪslɪv
criw	krɪu̯
nghnau cyll	ŋ̊naɨ̯kɨ̞ɬ
adfeilio	advei̯ljɔ
mawl	mau̯l
nheisen	n̥ɪʃɛn
haf	haːv
adlamau	adlama
pydru	pədrɨ
bach	baːχ
drydanwr	drədanʊr
rheiddyn	r̥ei̯ðɨ̞n
echrydu	ɛχrədɨ
llus	ɬɨːs
biau	biːaɨ̯
tharw	θaru
tryfer	trəvɛr
cyflogi	kəvlɔɡi
sylwi	səlwi
argoel	arɡɔɨ̯l
gnau cyll	ɡnaɨ̯kɨ̞ɬ
rhydau	r̥əda
seintiau	sei̯ntja
datblygiad	datbləɡjad
adlefau	adlɛvɛ
sgwariau	sɡwarja
cymedroli	kəmɛdrɔli
llythrennau	ɬəθrɛnaɨ̯
ichwi	ɪχwi
canhwyllau	kanhʊɨ̯ɬaɨ̯
adferiadyddion	advɛrjadəðjɔn
blynedd	blənað
ystlum	əsdlɨ̞m
credit	krɛdɪt
arno	arnɔ
dawn	dau̯n
bwyta	bəta
losinen	lɔʃɪnɛn
cytref	kətrɛv
eleni	ɛlɛnɪ
chaf	χaː
nghynnwrf	ŋ̊ənʊrv
cadair	kadɛr
berf annherfynol	bɛrvanhɛrvənɔl
deg	deːɡ
èll	ɛɬ
trin	triːn
caret	karɛt
achwynydd	aχʊɨ̯njɨ̞ð
adroddiad	adrɔðjad
pryfed	prəvad
desen	dɛsɛn
hosbisau	hɔsbɪsaɨ̯
ynglŷn â	əŋlɨːna
eryri	ɛrəri
daliadau	daljadɛ
beibl	bei̯bl
feirws	vei̯rʊs
arholiad	arhɔljad
saffari	safari
gwyneira	ɡwɨ̞nei̯ra
aromatherapi	arɔmaθɛrapi
cystadlaethau	kəsdadleɨ̯θaɨ̯
agorai	aɡɔrai̯
metelegol	mɛtɛlɛɡɔl
nheigr	n̥ei̯ɡr
talet	talɛt
dosbarthiad	dɔsbarθjad
wain	wai̯n
arna	arna
ngadael	ŋadal
amserlen	amsɛrlɛn
llusen	ɬɨ̞sɛn
ymeifl	əmei̯vl
parhau	parhaɨ̯
feirysau	vei̯rəsɛ
hychod	həχɔd
doir	dɔi̯r
llwgu	ɬʊɡɨ
milcant	milkant
te	teː
hwyaid	hʊɨ̯ɛd
mynachaidd	mənaχai̯ð
thudalen	θɨ̞dalan
tewyn	tɛu̯ɨ̞n
carthen	karθɛn
trafferthu	trafɛrθɨ
heuliog	heɨ̯ljɔɡ
tyst	tɨːsd
hadar	hadar
amrywiol	amrɪu̯jɔl
cymhlethdod	kəmhlɛθdɔd
rhiant	r̥iant
switsh	swɪt͡ʃ
cwb	kʊb
arthan	arθan
dyrysu	dərəsɨ
cathau	kaθaɨ̯
rhisgl	r̥ɪsɡl
paentiau	peɨ̯ntja
olau	ɔlaɨ̯
problem	prɔblam
fyned	vənɛd
rhywbeth	r̥ʊbaθ
thi	θiː
torran	tɔran
eangderau	ɛaŋdɛrɛ
gwynedd	ɡuɨ̯nɛð
dwymyn	dʊɨ̯mɨ̞n
mewnforwyr	mɛu̯nvɔrwɨ̞r
â	a
pryf cop	prɨːkɔp
pwysig	pʊɨ̯sɪɡ
cyfateb	kəvatab
treigladau	treiɡladɛ
llesteiriannau	ɬɛsdei̯rjana
seland newydd	sɛlandnɛu̯ɨ̞ð
ddarlunio	ðarlɨ̞njɔ
allanfa dân	aɬanvadaːn
gwrthryfelwr	ɡʊrθrəvɛlʊr
llesteiriant	ɬɛsdei̯rjant
sodlau	sɔdla
rhwyf	r̥uːɨ̯v
crydiau	krədjaɨ̯
phrysur	frəsɨ̞r
esgidiau	ɛsɡɪdjaɨ̯
dengys	dɛŋɨ̞s
gwialen bysgota	ɡwjalambəsɡɔta
garent	ɡarɛnt
mhencampwriaeth	m̥ɛŋkampʊrjaɨ̯θ
credaf	krɛda
ymrysongar	əmrəsɔŋɡar
degau	dɛɡa
gwernen	ɡwɛrnɛn
glaswellt	ɡlaswɛɬd
ngadael	ŋadaɨ̯l
noli	nɔli
modfedd	mɔdvað
cyfryngwyr	kəvrəŋwɨ̞r
adref	adra
foes	voːɨ̯s
dyna	dɛnɛ
arolygu	arɔləɡɨ
crëyr	krɛɨ̞r
haddo	haðɔ
iasol	jasɔl
cofnod	kɔvnɔd
nghymedrolwyr	ŋ̊əmɛdrɔlwɨ̞r
picwns	pɪkʊns
rai	rai̯
defnyddiau	dɛvnəðjaɨ̯
osgoi	ɔsɡɔi̯
mhrydain	m̥rədai̯n
anghywir	aŋhəu̯ɪr
drysu	drəsɨ
dolïau	dɔlɪɛ
gachai	ɡaχai̯
cowyll	kɔu̯ɨ̞ɬ
goeg	ɡoːɨ̯ɡ
neuaddau	neɨ̯aðɛ
ysgrifennu	əsɡrɪvɛnɨ
gwaedu	ɡweɨ̯dɨ
hesg	heːsɡ
oen	oːɨ̯n
nghorff	ŋ̊ɔrf
claddu	klaðɨ̞
goriad	ɡɔrjad
iselderau	ɪsɛldɛrɛ
gwybodaeth	ɡʊbɔdaɨ̯θ
hatyr	hatɨ̞r
tafwys	tavʊɨ̯s
llungopïwr	ɬɨ̞ŋɡɔpiːʊr
cusan	kɨ̞san
pymtheg	pəmθaɡ
wyt ti'n iawn	uːɨ̯ttiːnjau̯n
gwiwerod	ɡwɪu̯ɛrɔd
llawfeddyg	ɬau̯vɛðɨ̞ɡ
dewis	dɛu̯is
huddygl	hɨ̞ðɨ̞ɡl
adferwr	advɛrʊr
tery	tɛrɨ
cacs bach	kaksbaːχ
nant	nant
llawr	ɬau̯r
drycin	drəkɪn
ngeni	ŋɛnɪ
thalai	θalɛ
wladfa	wladva
adferaf	advɛrav
ffy	fɨː
ysgubor	əsɡɨ̞bɔr
elyn	ɛlɨ̞n
anobeithio	anɔbei̯θjɔ
cymwys	kəmʊɨ̯s
trof	troːv
ffrwyth	fruːɨ̯θ
ngwenoliaid	ŋwɛnɔljai̯d
tri ar hugain	triːarhɪɡai̯n
drwyddedau	drʊɨ̯ðɛda
brawychiaeth	brau̯əχjaɨ̯θ
seren	sɛrɛn
adennill	adɛnɪɬ
gwesty	ɡwɛsdɨ̞
coed afalau	koːɨ̯davalaɨ̯
sgrinio	sɡrinjɔ
gwialen bysgota	ɡwjalɛmbəsɡɔta
llyfrau	ɬəvra
pan	pan
calan	kalan
eled	ɛlɛd
denmarc	dɛnmark
anobaith	anɔbɛθ
thalai	θalai̯
llestr	ɬɛstr
ocsiynau	ɔkʃəna
mango	maŋɡɔ
uchel	ɨ̞χɛl
gronellau	ɡrɔnɛɬa
ffonia	fɔnja
mod	moːd
canais	kanai̯s
boneddigesau	bɔnɛðɪɡɛsaɨ̯
nghestyll	ŋ̊ɛsdɨ̞ɬ
glynol	ɡlənɔl
doer	doːɨ̯r
llefn	ɬɛvn
cynhennu	kənhɛnɨ
canais	kanɛʃ
nos wener	nɔswɛnar
aet	aːɨ̯t
gwres	ɡwreːs
synthesis	sɨ̞nθɛsɪs
diwyd	dɪu̯ɨ̞d
fflamgwr	flamɡʊr
yn union	ənɪnjɔn
sodlau uchel	sɔdlaɨ̞χal
peiriannau llungopïo	pei̯rjanɛɬɨ̞ŋɡɔpiːɔ
afal cariad	avalkarjad
rhywbeth	r̥ɪu̯baθ
nad	nad
nhyn	n̥ɨ̞n
plygio	pləɡjɔ
tachwedd	taχwɛð
nadolig	dɔlɪɡ
thyrrau	θərɛ
adnabyddant	adnabəðant
peidio	peidjɔ
ebargofiant	ɛbarɡɔvjant
llyffant	ɬəfant
llygad	ɬəɡad
mwnci	mʊŋki
canon	kanɔn
peiriannau	pei̯rjanɛ
hiraeth	hɪrɛθ
wyll	wɨ̞ɬ
gwasanaethau	ɡwasaneɨ̯θa
dw i angen meddyg	duiaŋɡɛnmɛðɨ̞ɡ
grwpiau	ɡrʊpjaɨ̯
geffyl	ɡɛfɨ̞l
chawod	χau̯ɔd
gwerddonau	ɡwɛrðɔnɛ
geiriogrwydd	ɡei̯rjɔɡrʊɨ̯ð
felly	ɬɨ̞
gorau	ɡɔrɛ
llythyren	ɬəθərɛn
noeth	noːɨ̯θ
het	hɛt
blawd	blau̯d
gwneud	ɡwneɨ̯d
gwyddau	ɡʊɨ̯ðɛ
phibgorn	fɪbɡɔrn
gwirfoddol	ɡwɪrvɔðɔl
hadolygu	hadɔləɡɨ̞
cyfyng	kəvɨ̞ŋ
canmolwyr	kanmɔlwɨ̞r
eogiaid	ɛɔɡjai̯d
gweled	ɡwɛlɛd
almaeneg	almeɨ̯nɛɡ
felly	vɛɬɨ̞
gafael	ɡavaɨ̯l
torrent	tɔrɛnt
weriniaeth	wɛrɪnjaɨ̯θ
blas	blaːs
nghneuen	ŋ̊neɨ̯an
finegr balsamig	vɪnɛɡrbalsamiɡ
syfl	sɨ̞vl
bachau	baχa
gorchudd	ɡɔrχɪð
cyrhaeddwn	kərhaɨ̯ðʊn
adfyw	advɨ̞u̯
llo	ɬoː
cyfatebiaethau	kəvatɛbjeɨ̯θaɨ̯
ehöeg	ɛhoːɛɡ
ffyrnau	fərnɛ
sothach	sɔθaχ
drwyddedau	drʊɨ̯ðɛdaɨ̯
magnel	maɡnɛl
galan	ɡalan
marus	marɨ̞s
gornest	ɡɔrnɛsd
wnsach	ʊnsaχ
chwedl	χwɛdl
closet	klɔsɛt
sedd	seːð
wrth	ʊrθ
ymadael	əmadal
torch	tɔrχ
hosbis	hɔsbɪs
helynt	hɛlɨ̞nt
boneddigesau	bɔnɛðɪɡɛsɛ
bryniau	brənjɛ
côt	koːt
deler	dɛlɛr
blith	bliːθ
digwyddiad	dɪɡʊi̯ðjad
brydain	brədɛn
degfed	dɛɡvɛd
afan	avan
caredig	karɛdɪɡ
sef	seːv
madfall	madvaɬ
peiriant	pei̯rjant
cwestau	kwɛsdaɨ̯
agor	aɡɔr
glas	ɡlaːs
aelod cynulliad	eɨ̯lɔdkənɨ̞ɬjad
crwth	kruːθ
mrain	mrai̯n
seler	sɛlar
chyrraedd	χəraɨ̯ð
offer	ɔfar
birmingham	bərmɪŋham
brwydrwyr	brʊɨ̯drwɨ̞r
gerllaw	ɡɛrɬau̯
nudden	nɨ̞ðɛn
deulu	deɨ̯lɨ
mercher	mɛrχɛr
holocost	hɔlɔkɔsd
thrwyn	θruːɨ̯n
mach	maːχ
carco	karkɔ
cyrch	kɨ̞rχ
anhawster	anhau̯sdar
gwŷdd	ɡwɨːð
macadelgi	makadɛlɡi
myrddiwn	mərðjʊn
llun y llong	ɬɨːnəɬɔŋ
ameba	amɛba
bin	biːn
i blith	iːbliːθ
gwelais	ɡwɛlɛʃ
talu	talɨ
cloit	klɔi̯t
adeiladweithiau	adei̯ladwei̯θjaɨ̯
ôl	oːl
chaleted	χalɛtɛd
siomau	ʃɔmɛ
dâr	daːr
tonnau	tɔnaɨ̯
cwsmer	kʊsmɛr
gwddf	ɡʊðʊv
acen ddisgynedig	akɛnðɪsɡənɛdɪɡ
dro	droː
deli	dɛlɨ̞
lawn	lau̯n
nghawod	ŋ̊au̯ɔd
chell	χɛɬ
dreidl	drei̯dl
dug	dɨːɡ
motél	mɔtɛl
tewach	tɛu̯aχ
pedwaredd	pɛdwarað
arswydau	arsʊɨ̯dɛ
gofid	ɡɔvɪd
mewn	mɛu̯n
meddiannau	mɛðjanaɨ̯
cor	kɔr
bricsen	brɪksɛn
inni	ɪni
arolygiaethau	arɔləɡjeɨ̯θa
ddeuddeg	ðeɨ̯ðaɡ
rasel	rasal
cneuen gyll	kneɨ̯anɡɨ̞ɬ
brwydrau	brʊɨ̯draɨ̯
dynleiddiad	dɨːnlei̯ðjad
wociau	wɔkjɛ
mewnforyn	mɛu̯nvɔrɨ̞n
gaeaf	ɡeɨ̯av
canaf	kanav
ffionau	fɪɔnɛ
doit	dɔi̯t
lloegr newydd	ɬɔɨ̯ɡrnɛu̯ɨ̞ð
mesur	mɛsɨ̞r
lindys	lɪndɨ̞s
efengylu	ɛvɛŋəlɨ
diwydiant	dɪu̯ɨ̞djant
rewi	rɛu̯i
ddeuddegfed	ðeɨ̯ðɛɡvɛd
chad	χaːd
loegr newydd	lɔɨ̯ɡrnɛu̯ɨ̞ð
mhob	m̥oːb
wiciadur	wɪkjadɨ̞r
cannu	kanɨ̞
symiau	səmjaɨ̯
bôm	boːm
cacha	kaχa
gwyno	ɡʊɨ̯nɔ
breuddwydion	breɨ̯ðʊɨ̯djɔn
agoraf	aɡɔrav
wylio	wɪljɔ
droen	droːɨ̯n
carit	karɪt
gwin	ɡwiːn
aethech	eɨ̯θɛχ
protestant	prɔtɛsdant
geiriau	ɡei̯rja
bant	bant
chrwth	χruːθ
gwyrdd	ɡwɨ̞rð
adlŷn	adlɨːn
braen	braːɨ̯n
glefyd	ɡlɛvɨ̞d
blodfresych	blɔdvrɛsɨ̞χ
arf	arv
heisteddfodau	hei̯sdɛðvɔdɛ
seibiau	sei̯bja
dylid	dəlid
chlybiau	χləbjɛ
chyfarfod	χwarvɔd
jacs	dʒaks
ches	χeːs
band eang	bandeːaŋ
iwerddon	ɪu̯ɛrðɔn
gwen	ɡwɛn
ryseitiau	rəsei̯tjɛ
niwliog	nɪu̯ljɔɡ
amser	amsɛr
cysgiff	kəsɡɪf
eangiadau	ɛaŋjadaɨ̯
waliau	waljaɨ̯
cynorthwywyr	kənɔrθʊɨ̯wɨ̞r
pandemigau	pandɛmɪɡaɨ̯
wyneb	wɨnɛb
stori	sdɔri
drws	druːs
llun	ɬɨːn
ysgwydd	əsɡwɨ̞ð
dillad	dɪɬad
garais	ɡarɛs
bwlgaria	bʊlɡarja
gwylliaid	ɡwɨ̞ɬjai̯d
hyll	hɪɬ
mordydd	mɔrdɨ̞ð
gwystl	ɡwɨ̞sdl
mhethau	m̥ɛθa
ias	jaːs
ymladd	əmlað
gwas	ɡwaːs
ce	keː
plwg	plʊɡ
rhyngwladol	r̥əŋwladɔl
codau	kɔdɛ
tŷ bach	tɨːbaːχ
llethol	ɬɛθɔl
hunion	hɪnjɔn
llamhidydd	ɬamhɪdɨ̞ð
biolegol	bjɔlɛɡɔl
chwyno	χʊɨ̯nɔ
hangharad	haŋharad
alaw	alau̯
chaffi	χafi
sgriniau	sɡrɪnja
loegr	lɔɨ̯ɡr
ychwanegol	əχwanɛɡɔl
ar gof a chadw	arɡoːvaχadu
paneidiau	panei̯djaɨ̯
ynys	ənɨ̞s
metelegwyr	mɛtɛlɛɡwɨ̞r
rhegion	r̥ɛɡjɔn
ugeiniau	ɪɡei̯njɛ
pechadur	pɛχadɨ̞r
mhyliau	m̥əlja
lywydd	ləu̯ɨ̞ð
fforest	fɔrɛst
arolygiadau	arɔləɡjadɛ
gwrthryfelgar	ɡʊrθrəvɛlɡar
eir	ei̯r
crwban	krʊban
benyw	bɛnɨ̞u̯
rhiw	r̥ɪu̯
gneuen gyll	ɡneɨ̯ɛnɡɨ̞ɬ
hyn a hyn	hɨ̞nahɨ̞n
gadael	ɡadɛl
uchaf	əχa
carafannau	karavanaɨ̯
achwynwr	aχʊɨ̯njʊr
gwneud	neɨ̯d
loyw	lɔɨ̯u
braint	brai̯nt
afancod	avaŋkɔd
ynys manaw	ənɨ̞smanau̯
anobeithiol	anɔbei̯θjɔl
her	hɛr
draed	draːɨ̯d
gyfarfod	ɡəvarvɔd
cenhinen bedr	kɛnhɪnambɛdr
cyd	kɨːd
caed	kaːɨ̯d
torren	tɔrɛn
diwedd	dɪu̯að
gwnaeth	ɡwnaːɨ̯θ
deuddeg	deɨ̯ðɛɡ
trwbl	trʊbʊl
i fyny	ɪvənɨ
cant	kant
berw	bɛru
dwywaith	dʊɨ̯wai̯θ
iddyn	ɪðɨ̞n
barnwr	barnʊr
medru	mɛdrɨ
peint	pei̯nt
saint	sai̯nt
thaliadau	θaljadɛ
theyrnaddoliant	θeɨ̯rnaðɔljant
timau	tɪmɛ
yr amwythig	əramʊɨ̯θɪɡ
trwnc	trʊŋk
crynwr	krənʊr
llygota	ɬəɡɔta
diddordeb	dɪðɔrdɛb
aeled	eɨ̯lɛd
troed	troːɨ̯d
i ffwrdd	ɪfʊrð
creder	krɛdɛr
hafodau	havɔda
lased	lasɛd
nhadau	n̥adaɨ̯
gwladfa	ɡwladva
torsen	tɔrsɛn
èdd	ɛð
wiwerod	wɪu̯ɛrɔd
cyngaws	kəŋau̯s
meddiannau	mɛðjanɛ
dod	doːd
cyfrifon	kəvrɪvɔn
est	ɛsd
conwydden	kɔnwəðɛn
blodfresychen	blɔdvrɛsəχan
awgrymog	au̯ɡrəmɔɡ
glust	ɡlɨːst
gwylio	ɡwɨ̞ljɔ
blynyddoedd golau	blənəðɔɨ̯ðɡɔla
melyngoch	mɛləŋɡɔχ
theisen	θei̯ʃɛn
thelyn	θɛlɨn
greda	ɡrɛda
mhaned	m̥anad
mab	maːb
rw	rʊ
i ffwrdd	fʊrð
deugeiniau	dei̯ɡei̯njɛ
trwydded	trʊɨ̯ðɛd
dydd mercher	dɨ̞ðmɛrχɛr
braf	braːv
masgiau	masɡja
chwern	χwɛrn
calsiwm	kalsjʊm
merlyn	mɛrlɨ̞n
h	h
wythongl	ʊɨ̯θɔŋl
flewyn	vlɛu̯ɨ̞n
ffin	fiːn
hwyaden	χwadan
trydydd	trədɨ̞ð
bythynnod	bəθənɔd
ben	bɛn
more	mɔrɛ
mewnrwyd	mɛu̯nrʊɨ̯d
brawychiaeth	brau̯əχjɛθ
darlledu	darɬɛdɨ
acen ddyrchafedig	akɛnðərχavɛdɪɡ
nos fercher	nɔsvɛrχar
aethai	eɨ̯θai̯
aelod o'r senedd	eɨ̯lɔdɔrsɛnɛð
dybarth	dəbarθ
pur	pɨːr
bord	bɔrd
gofio	ɡɔvjɔ
nghlustdlws	ŋ̊lɨ̞sdlʊs
eisteddle	ei̯sdɛðlɛ
brawychiad	brau̯əχjad
bambŵ	bambuː
agerlongau	aɡɛrlɔŋa
cecru	kɛkrɨ
achydd	aχɨ̞ð
technoleg gwybodaeth	tɛχnɔlɛɡɡwɨ̞bɔdɛθ
medru	mɛdri
bendant	bɛndant
grwth	ɡruːθ
chwigain	χwɪɡai̯n
gwymona	ɡwɨ̞mɔna
athrawon	aθrau̯ɔn
merlotwr	mɛrlɔtʊr
twng	tʊŋ
habadaethau	habadeɨ̯θa
sioned	ʃɔnɛd
ricriwtiaid	rɪkrɪu̯tjai̯d
adeiniog	adei̯njɔɡ
ddrama	ðrama
thyrrau	θəraɨ
fẁg	vʊɡ
gwragedd	ɡwraɡað
troid	trɔi̯d
pasta	pasda
ngweriniaethau	ɡwɛrɪnjeɨ̯θaɨ̯
pabyddol	pabəðɔl
gaffai	ɡafai̯
côr y cewri	koːrəkɛu̯ri
parth rhynglanw	parθr̥əŋlanu
athrodi	aθrɔdɨ
annog	anɔɡ
crych	krɨːχ
ffedog	fɛdɔɡ
symudol	səmɨdɔl
brenhines	brɛnhɪnɛs
dryw	drɨu̯
habadaeth	habadɛθ
tales	talɛs
unais	ɨ̞nai̯s
iechyd	jɛχɨ̞d
myfanwy	məvanʊɨ̯
cacynen	kakənɛn
gwâr	ɡwaːr
hiasoer	hjasɔɨ̯r
fys	vɨːs
lu	lɨː
rhywbeth	r̥ɨu̯bɛθ
diwethaf	dɪu̯ɛθav
nerf	nɛrv
fel hyn	vəlɨ̞n
weriniaethau	ɡwɛrɪnjeɨ̯θɛ
oddi	ɔði
faint	vai̯nt
gwylan	ɡʊɨ̯lan
agoret	aɡɔrɛt
arwydd	arwɨ̞ð
ffrwd	fruːd
meddu	mɛðɨ
chusan	χɨ̞san
acti	akti
credo	krɛdɔ
elwyf	ɛlʊɨ̯v
wybodaeth	wɨ̞bɔdaɨ̯θ
bàth	baθ
clicio	klɪkjɔ
cyfrifwr	kəvrɪvʊr
cynyddu	kənəðɨ
chweched	χwɛχad
llonydd	ɬɔnɨ̞ð
galled	ɡaɬɛd
glywed	ɡləu̯ad
chani	χanɪ
lundain	lɨ̞ndɛn
losin	lɔʃɪn
prydain fawr	prədɛnvau̯r
rhywun	r̥ɪu̯ɨ̞n
ionawr	jɔnau̯r
post	poːsd
ddeuddeg	ðeɨ̯ðɛɡ
garais	ɡarɪʃ
mynachaeth	mənaχɛθ
taflu	tavlɨ
heuldro'r gaeaf	heɨ̯ldrɔrɡeɨ̯av
oed	oːɨ̯d
gwlychu	ɡwləχɨ
llwythau	ɬʊɨ̯θaɨ̯
adwaenir	adweɨ̯nɪr
sawsiau	sau̯ʃa
glybiau	ɡləbjɛ
petryalau	pɛtrɨ̞alaɨ̯
dor	dɔr
ceubren	keɨ̯brɛn
dorrid	dɔrɪd
nghadair	ŋ̊adar
gornestau	ɡɔrnɛsdɛ
iasau	jasaɨ̯
hoelio	hɔɨ̯ljɔ
clyw	klɨu̯
stopio	sdɔpjɔ
llurs	ɬɨ̞rs
meiddio	meiðjɔ
llaid	ɬai̯d
peniad	pɛnjad
lechi	lɛχi
neithiwyr	nei̯θjʊɨ̯r
gychwyn	ɡəχwɨ̞n
plygiau	pləɡja
adfeilion	advei̯ljɔn
sesiynau	sɛʃənaɨ̯
ychwanegiad	əχwanɛɡjad
nenmarc	nɛnmark
heuldro'r gaeaf	heɨ̯ldrɔrɡeɨ̯a
tybio	təbjɔ
cydweithiwr	kɨːdwei̯θjʊr
caffed	kafɛd
haen	haːɨ̯n
picls	pɪkls
animeiddwyr	anɪmei̯ðwɨ̞r
ddysgu	ðəsɡɨ̞
pellweledydd	pɛɬwɛlɛdɨ̞ð
arwerthiannau	arwɛrθjanaɨ̯
hirddydd	hɪrðɨ̞ð
adargraffiadau	adarɡrafjada
ar werth	arwɛrθ
deugain	dei̯ɡai̯n
cwstardiau	kʊsdardjɛ
cyfarthiad	kəvarθjad
phrynu	frənɨ
tiroedd	tɪrɔɨ̯ð
ngwin	ŋwiːn
brwydr	brʊɨ̯dr
ngwres	ŋwreːs
trois	trɔi̯ʃ
drysfeydd	drəsveɨ̯ð
mhethau	m̥ɛθɛ
thaliadau	θaljada
peirianneg	pei̯rjanɛɡ
cymhlethdodau	kəmhlɛθdɔdaɨ̯
elet	ɛlɛt
cyfranddeiliaid	kəvranðei̯ljai̯d
gyrru	ɡərɨ
masen	masan
gwaed	ɡwaːi̯d
awstria	au̯strja
dyryslwyn	dərəslʊɨ̯n
cudyn	kɨ̞dɨ̞n
weriniaethau	ɡwɛrɪnjeɨ̯θa
caer gwydion	kaːɨ̯rɡwɨ̞djɔn
cigfran	kɪɡvran
hawl	hau̯l
dyfarnu	dəvarni
fron	vrɔn
diwethaf	dwɪθa
rhacs	r̥aks
gwenwyn	ɡwɛnwɨ̞n
clodforedd	klɔdvɔrɛð
ebychnod	ɛbəχnɔd
adfywiad	advɨ̞u̯jad
llefrith	ɬɛvrɪθ
trafferthus	trafɛrθɨ̞s
aelod	eɨ̯lɔd
cefnau	kɛvna
ès	ɛs
llaeth	ɬaːɨ̯θ
adlyn	adlɨ̞n
siocled poeth	ʃɔkladpoːɨ̯θ
gafael	ɡavɛl
penfelen	penvɛlɛn
thewi	θɛu̯i
ieithyddiaeth	jei̯θəðjɛθ
ffugenwau	fɨ̞ɡɛnwaɨ̯
cynnud	kənɨ̞d
adwaenoch	adweɨ̯nɔχ
cymorth	kəmɔrθ
allweddell	aɬwɛðɛɬ
celli	kɛɬɪ
berfau annherfynol	bɛrvaɨ̯anhɛrvənɔl
boi	bɔi̯
cynaeafu	kneɨ̯avɨ
cofiais	kɔvjɛs
gât	ɡaːt
gachais	ɡaχɛs
dychrynllyd	dəχrənɬɨ̞d
dwyrain	dʊɨ̯rɛn
teisennau	tei̯sɛna
thorrid	θɔrɪd
rhyfela	r̥əvɛla
gylfinirod	ɡəlvɪnɪrɔd
rhwyfo	r̥ʊɨ̯vɔ
urddau	ɨ̞rðaɨ̯
hannwyd	hanʊɨ̯d
basged	basɡɛd
cyfraith	kəvrɛθ
bas	baːs
af	aː
ystafell	sdavaɬ
cwymp	kwɨ̯mp
brwd	bruːd
bwced	bʊkad
rhan	r̥an
rhai	r̥ai̯
peiriannol	pei̯rjanɔl
cyfeillion	kəvei̯ɬjɔn
moliannau	mɔljana
cochyn	kɔχɨ̞n
gweddi	ɡwɛðɪ
albwm	albʊm
macymwn	makəmʊn
gwybod	ɡʊbɔ
cymhlethu	kəmhlɛθɨ
olchi	ɔlχɪ
cyhydnos	kəhədnɔs
gog	ɡɔɡ
amwythig	amʊɨ̯θɪɡ
angylesau	aŋəlɛsaɨ̯
gwaywffyn	ɡweɨ̯wfɨ̞n
ymgecru	əmɡɛkrɨ
lasgoch	lasɡɔχ
gan	ɡan
tatŵs	tatuːs
bynnag	bənaɡ
'na	na
casáu	kasaɨ̯
coch y berllan	koːχəbɛrɬan
daliadaethau	daljadeɨ̯θaɨ̯
decaf	dɛkav
gell	ɡɛɬ
rhwyfau	r̥ʊɨ̯va
telynoresau	tɛlənɔrɛsɛ
carais	karai̯s
pedwar ar bymtheg	pɛdwararbəmθɛɡ
anafai	anavai̯
caffer	kafɛr
penblethau	pɛmblɛθɛ
erys	ɛrɨ̞s
lin	liːn
ngyrru	ŋərɨ
e	eː
cysylltnod	kəsəɬdnɔd
angladdau	aŋlaða
hunllef	hɨ̞nɬa
iwch	ɪu̯χ
huw	hɨ̞u̯
gymaint	ɡəmai̯nt
wddwg	ʊðʊɡ
myr	mɨ̞r
bore da	bɔradaː
cynnyrch	kənɨ̞rχ
huw	hɪu̯
mhryf	m̥rɨːv
bod	boːd
hiddewiaeth	hɪðeu̯jaɨθ
hyd	hɨːd
aeaf	eɨ̯a
cyllell	kəɬɛɬ
brân gernyw	braːnɡɛrnɪu̯
aeth	aːɨ̯θ
gna	ɡnaː
mynd	mɨ̞nd
llysiau	ɬəʃaɨ̯
thelynor	θɛlənɔr
argraffiadaeth	arɡrafjadaɨ̯θ
llafariaid	ɬavarjai̯d
oeri	ɔɨ̯ri
chlybiau	χləbjaɨ̯
defnyddiau	dɛvnəðja
trwyth	truːɨ̯θ
i ffwrdd	fʊr
syllu	səɬɨ
ffensio	fɛnʃɔ
arni	arnɪ
cwtshys	kʊtʃɨ̞s
unedau	ɨ̞nɛdaɨ̯
cyngerdd	kəŋɛrð
heb	hɛb
jam	d͡ʒam
rygbi	rəɡbi
nhrwyn	n̥ruːɨ̯n
goleudai	ɡɔleɨ̯dai̯
byrddydd gaeaf	bərðɨ̞ðɡeɨ̯a
ysgrifbin	əsɡrɪvbɪn
calenigion	kalɛnɪɡjɔn
codau	kɔdaɨ̯
cacynen feirch	kakənɛnvei̯rχ
lau	laɨ̯
torrid	tɔrɪd
carnedd	karnɛð
graff	ɡraf
adfydau	advədaɨ̯
ysu	əsɨ
segur	sɛɡɨ̞r
gŵyth	ɡuːɨ̯θ
ffonian	fɔnjan
genhinen	ɡɛnhɪnan
llusen	ɬɨ̞san
pryf	prɨː
llwy	ɬuːɨ̯
ar amrantiad	aramrantjad
eisoes	ei̯sɔɨ̯s
èth	ɛθ
crefyddol	krɛvəðɔl
carafán	karavan
heraill	hɛraiɬ
dydd mercher	dɨ̞mɛrχar
cwningen	kʊnɪŋan
ngweddïo	ŋwɛðɪɔ
pibwyr inc	pɪbwɨ̞rɪŋk
gennod	ɡɛnɔd
awgrymiad	au̯ɡrəmjad
cosbau	kɔsbaɨ̯
pŵer	pʊar
sgydau	sɡəda
fynd	vɨ̞nd
ngwiwer	ŋwɪu̯ar
siân	ʃaːn
ehanged	ɛhaŋɛd
corff	kɔrf
ysgubell	əsɡɨ̞bɛɬ
canant	kanant
arfer	arvɛr
pendrwm	pɛndrʊm
fûm	vɨːm
cynddrwg	kənðrʊɡ
tiwb	tɪu̯b
helaeth	hɛlaɨ̞θ
beirniaid	bei̯rnjai̯d
ddeiliaid	ðei̯ljai̯d
ddalen	ðalɛn
byddaru	bəðarɨ
pengwiniaid	pɛŋɡwɪnjai̯d
bag	baɡ
byddai	bəðɛ
pharoted	farɔtɛd
cachai	kaχɛ
rydw i'n dy garu di	rədwindəɡaridiː
gril	ɡrɪl
platfform	platfɔrm
tharian	θarjan
chyngor	χəŋɔr
nhelyn	n̥ɛlɨn
eirinen	ei̯rɪnan
annwyd	anʊɨ̯d
charan	χaran
cyhyrog	kəhərɔɡ
talcen	talkɛn
sbaeneg	sbeɨ̯nɛɡ
anghydradd	aŋhədrað
amrywedd	amrɨu̯jɛð
ton	tɔn
morfil	mɔrvɪl
methan	mɛθan
adborth	adbɔrθ
phaith	fai̯θ
oman	ɔman
amcangyfrif	amkaŋɡəvrɪv
phabell	fabɛɬ
taradr	taradr
croesi	krɔɨ̯si
ardd	aːrð
cenhinen sifi	kɛnhɪnansɪvɪ
beidio	beidjɔ
elom	ɛlɔm
profiad	prɔvjad
tyllau yn y wal	təɬaənəwal
gwychach	ɡwəχaχ
coeden afalau	kɔɨ̯danavala
twmffat	tʊmfat
i	iː
aceniad	akɛnjad
cathod	kaθɔd
dair	dai̯r
switshys	swɪtʃɨ̞s
pibgorn	pɪbɡɔrn
wlad	wlaːd
tawe	tau̯ɛ
brwdfrydedd	brʊdvrədɛð
maent	maɨ̯nt
ysgrifen	əsɡrɪvɛn
streiciau	sdrei̯kjaɨ̯
glan	ɡlan
adlynu	adlənɨ̞
lindysyn	lɪndəsɨ̞n
gylfinau	ɡəlvɪnaɨ̯
twll	tʊɬ
elen	ɛlɛn
fflapjac	flapdʒak
habad	habad
torrem	tɔrɛm
twll yn y wal	tʊɬənəwal
ymrafael	əmravɛl
pabyddiaeth	pabəðjaɨ̯θ
mhwl	m̥ʊl
pïod	piːɔd
llwytho	ɬʊɨ̯θɔ
dyrnu	dərnɨ
ceiliog	kei̯ljɔɡ
chwys	χwɨːs
ffrancwyr	fraŋkwɨ̞r
gwddf	ɡʊðv
gwellta	ɡwɛɬda
helpwyr	hɛlpwɨ̞r
helbulus	hɛlbɨ̞lɨ̞s
blodau	blɔdɛ
cychwyn	kəχwɨ̞n
brig	briːɡ
plethau	plɛθa
dysgleidiau	dɨ̞sɡlei̯dja
gyrraedd	ɡərɛð
llysiau	ɬəʃɛ
atseinio	atsei̯njɔ
saith ar hugain	sai̯θarhɪɡai̯n
twymynau	tʊɨ̯mənaɨ̯
gyfnither	ɡəvnɪθar
derbynnydd	dɛrbənɨ̞ð
fedi	vɛdɪ
nabl	nabl
prifiau	prɪvjaɨ̯
rheiddio	r̥eiðjɔ
pymthegnos	pəmθɛɡnɔs
cydweithiwr	kɨ̞dwei̯θjʊr
sgandinafia	sɡandɪnavja
troa	trɔa
mhencampwriaeth	m̥ɛŋkampʊrjɛθ
dyddiadau	dəðjadaɨ̯
croestorri	krɔɨ̯sdɔrɪ
sesiynau	sɛʃəna
microsgopau	mei̯krɔsɡɔpa
ffugenwau	fɨ̞ɡɛnwa
dyfrgi	dəvrɡɪ
ferwi	vɛrwi
awdl	au̯dl
gwyddeleg	ɡʊɨ̯ðɛlɛɡ
caf	kaː
goludog	ɡɔlɨ̞dɔɡ
halen	halan
arth fwyaf	arθvʊɨ̯a
moch	moːχ
thrydanwr	θrədanʊr
gwaethaf	ɡweɨ̯θa
dadleuon	dadleɨ̯ɔn
galenigion	ɡalɛnɪɡjɔn
flodyn	vlɔdɨ̞n
elsid	ɛlsɪd
chwarel	χwarɛl
ddrud	ðrɨːd
eirinen fair	ei̯rɪnɛnvai̯r
gwyfyn	ɡwəvɨ̞n
damweiniau	damwei̯njaɨ̯
unwaith	ɨ̞nwai̯θ
traethodau	treɨ̯θɔdaɨ̯
trawant	trau̯ant
cyfnewid	kəvnɛu̯ɪd
wenoliaid	wɛnɔljai̯d
pheth	feːθ
caredigrwydd	karɛdɪɡrʊɨ̯ð
amddiffyn	amðɪfɨ̞n
tu	tɨː
daear	deɨ̯ar
doem	doːɨ̯m
hieirll	hjei̯rɬ
adfer	advar
dorrai	dɔrai̯
chwerthin	χwɛrθɨ̞n
sodlau	sɔdlaɨ̯
sioeau	ʃɔɨ̯a
eang	eːaŋ
eboles	ɛbɔlɛs
cyffredinol	kəfrɛdɪnɔl
madfall ddŵr	madvaɬðuːr
gwladgarwyr	ɡwladɡarwɨ̞r
adargwn	adarɡʊn
tro	troː
mlew	mleːu̯
ymwneud	əmwneɨ̯d
phedwar	fɛdwar
gwael	ɡwaːɨ̯l
wyched	wəχɛd
pawb	pau̯b
mol	mɔl
gartref	ɡartrɛ
tywydd	təu̯ɨ̞ð
gwir	ɡwiːr
cawna	kau̯na
bresych	brɛsɨ̞χ
rywbeth	rɨu̯baθ
gofodoldeb	ɡɔvɔdɔldɛb
phasta	fasda
lloches	ɬɔχɛs
albanau	albana
ddau	ðaɨ̯
dalom	dalɔm
cly	klɨː
fa's	vaːs
adaregwyr	adarɛɡwɨ̞r
chafas	χavas
gwydden	ɡwɨ̞ðɛn
ac	ak
lwnc	lʊŋk
gẃraidd	ɡʊrai̯ð
iseldiraidd	ɪsɛldɪrɛð
ngaeaf	ŋeɨ̯a
neuddeg	neɨ̯ðaɡ
barn	barn
ffrwchnedd	frʊχnɛð
coegog	kɔɨ̯ɡɔɡ
ffensiau	fɛnʃa
erioed	rjoːɨ̯d
chwannog	χwanɔɡ
gronellau	ɡrɔnɛɬaɨ̯
llath	ɬaːθ
gwarthegydd	ɡwarθɛɡɨ̞ð
hesgen	hɛsɡɛn
ait	ai̯t
anghyseinedd	aŋhəsei̯nɛð
merlota	mɛrlɔta
gogleddol	ɡɔɡlɛðɔl
eangiadau	ɛaŋjadɛ
physgota	fəsɡɔta
nid	nɪd
cwestau	kwɛsdɛ
tawel	tau̯ɛl
cneuen gyll	kneɨ̯ɛnɡɨ̞ɬ
clof	kloːv
gaen	ɡai̯n
gwau	ɡwaɨ̯
trwbl	trʊbl
sbageti	sbaɡɛti
pryf genwair	prɨːvɡɛnwai̯r
gosyn	ɡɔsɨ̞n
glased	ɡlasɛd
adwaenai	adweɨ̯nai̯
sgileffaith	sɡiːlɛfai̯θ
cwestiynau	kwɛsdjəna
taleb	talɛb
llusa	ɬɨ̞sa
marchgacynen	marχɡakənan
carreg	karaɡ
straeon	sdreɨ̯ɔn
dwg	duːɡ
berwi	bɛrwi
siort	ʃɔrt
gwrw	ɡʊru
titr	tɪtr
chaled	χalad
emrys	ɛmrɨ̞s
adwen	adwɛn
brys	brɨːs
chor	χɔr
mercher	mɛrχar
achosi	aχɔsi
timau	tɪmaɨ̯
fasen	vəsɛn
teyrn	teɨ̯rn
mur	mɨːr
ymladdgar	əmlaðɡar
gusanau	ɡɨ̞sana
hudlath	hɨ̞dlaθ
chwarel	χwaral
maen	mən
picau ar y maen	pɪkaɨ̯arəmaːɨ̯n
basen	basɛn
terfynau	tɛrvənaɨ̯
nghaled	ŋ̊alad
theledu	θɛlɛdɨ
ffurfiol	fɨ̞rvjɔl
theigrod	θei̯ɡrɔd
deunyddiau	deɨ̯nəðjɛ
achan	aχan
rhiffio	r̥ɪfjɔ
arbed	arbɛd
nghaffi	ŋ̊afi
groeg	ɡroːɨ̯ɡ
dial	dɪal
afalau cariad	avalaɨ̯karjad
brythoneg	brəθɔnɛɡ
cyfryngwr	kəvrəŋʊr
adeiladweithiau	adei̯ladwei̯θja
ddeiliad	ðei̯ljad
'r	r
rhithweledigaeth	r̥ɪθwɛlɛdɪɡɛθ
llus america	ɬɨːsamɛrɪka
celyn	kɛlɨ̞n
geiriadur	ɡei̯rjadɨ̞r
nos fawrth	noːsvau̯rθ
parod	parɔd
beirniadaethau	bei̯rnjadeɨ̯θa
ffonau	fɔnaɨ
pedrsill	pɛdrsɪɬ
allor	aɬɔr
llysieua	ɬəʃeɨ̯a
newynau	nɛu̯əna
adael	adal
medi	mɛdi
thalcen	θalkɛn
clefyd	klɛvɨ̞d
cwtsh	kʊtʃ
undeb	ɨ̞ndab
rhenti	r̥ɛnti
gani	ɡanɪ
enghraifft	ɛŋ̊rɛfd
gwahân	ɡwahaːn
erbyn	ɛrbɨ̞n
cyfranddeiliad	kəvranðei̯ljad
geiriadurwr	ɡei̯rjadɨ̞rʊr
trolïau	trɔlɪɛ
at	at
iesu	jɛsɨ̞
h	hə
sgydau	sɡədɛ
caled	kalɛd
gordderch	ɡɔrðɛrχ
mwydod	mʊɨ̯dɔd
bedol	bɛdɔl
nei	nei̯
ddeilen	ðei̯lɛn
tybiwyd	təbjʊɨ̯d
arhosan	arhɔsan
lifftiau	lɪfdja
cae	kaːɨ̯
blin	bliːn
dost	dɔst
athrodus	aθrɔdɨ̞s
iselderau	ɪsɛldɛra
ewinfedd	ɛu̯ɪnvɛð
cymru	kəmrɨ̞
manteision	mantei̯ʃɔn
cwerylwyr	kwɛrəlwɨ̞r
llun yr haeddel	ɬɨːnərheɨ̯ðɛl
cwmwl	kʊmʊl
awstralia	au̯sdralja
gwe	ɡweː
acer	akɛr
dyryslwyni	dərəslʊɨ̯ni
mwyafrif	mʊɨ̯avrɪv
twndish	tʊndɪʃ
teyrnaddoliant	teɨ̯rnaðɔljant
chwarae	χwaraɨ̯
peiriant llungopïo	pei̯rjantɬɨːŋɡɔpiːɔ
nithio	nɪθjɔ
nglanach	ŋlanaχ
siopwyr	ʃɔpwɨ̞r
saethwr	seɨ̯θʊr
anawsterau	anau̯sdɛra
erioed	ɛrjoːɨ̯d
oleuadau	ɔleɨ̯ada
lân	laːn
cachai	kaχai̯
wyth ar hugain	uːɨ̯θarhɪɡai̯n
unfed	ɨ̞nvɛd
rheoli	r̥ɛɔli
sgriniau	sɡrɪnjɛ
thudalen	θɨ̞dalɛn
protestannaidd	prɔtɛsdanai̯ð
pabydd	pabɨ̞ð
dros	drɔs
gwyach	ɡʊɨ̯aχ
ffyrc	fɨ̞rk
addasu	aðasɨ̞
bobl	bɔbɔl
alban eilir	albanei̯lɪr
anodded	anɔðɛd
colomen	kɔlɔmɛn
gwybod	ɡwɨ̞bɔd
ngwladfa	ŋwladva
gwenynen wyllt	ɡwenənɛŋwɨːɬd
iaith	jai̯θ
agerlongau	aɡɛrlɔŋaɨ̯
swistir	əswɪsdɪr
trwy	truːɨ̯
ngwybodaeth	ŋwəbɔdɛθ
garnau	ɡarnaɨ̯
ulai	ɨ̞lai̯
blogiau	blɔɡjaɨ̯
ngwybod	ŋwɨ̞bɔd
holi	hɔli
ffenest	fɛnɛsd
ciwcymber	kɪu̯kəmbar
ffeindiaf	fei̯ndja
os	ɔs
gorffennaf	ɡɔrfɛnav
ginio	ɡɪnjɔ
gastell	ɡasdɛɬ
ladron	ladrɔn
flin	vliːn
gut	ɡɨ̞t
hwyr	huːɨ̯r
gweinyddiaeth	ɡwei̯nəðjɛθ
cwerylwr	kwɛrəlʊr
cyfarwyddwr	kəvarʊɨ̯ðʊr
gyd	ɡiːd
hogen	hɔɡɛn
dolffiniaid	dɔlfɪnjai̯d
anawsterau	anau̯sdɛrɛ
llythrennog	ɬəθrɛnɔɡ
nheigrod	n̥ei̯ɡrɔd
marchnad	marχnad
cyfrwy	kəvrʊɨ̯
naid	nai̯d
cilfach	kɪlvaχ
tarianau	tarjanɛ
weriniaeth	wɛrɪnjɛθ
gweiriau	ɡwei̯rjaɨ̯
pentyrru	pɛntərɨ
griliau	ɡrɪljɛ
cacen	kakan
cylchgrawn	kəlχɡrau̯n
delent	deːlɛnt
ymryson	əmrəsɔn
bore	bɔrɛ
ŵydd	uːɨ̯ð
diwrnod	dɪu̯rnɔd
bryniau	brənjaɨ̯
rhentwr	r̥ɛntʊr
cyfryngis	kəvrəŋis
meysydd awyr	meɨ̯sɨ̞ðau̯ɨ̞r
swynol	sʊɨ̯nɔl
ambiti	ambɪtɪ
taw	taːu̯
olwyn	ɔlʊɨ̯n
gwair	ɡwai̯r
sesiwn	sɛʃʊn
anodd	anɔð
gweiriau	ɡwei̯rja
symiau	səmjɛ
angladd	aŋlað
amrywiad	amrɨu̯jad
arad	arad
gorffen	ɡɔrfan
aweddwr	au̯ɛðʊr
talai	talai̯
taranau	tarana
cyfarwydd	kəvarwɨ̞ð
cyll	kɨ̞ɬ
helyg	hɛlɨ̞ɡ
gyfoethog	ɡəvɔɨ̯θɔɡ
symbol	sɨ̞mbɔl
cywyddau	kəwəða
llwyfandir	ɬʊɨ̯vandɪr
paned	panɛd
sgiwen	sɡiu̯ɛn
cwpan	kʊpan
brodyr	brɔdɨ̞r
theisen	θɪʃɛn
rhew	r̥eːu̯
gwys	ɡwɨːs
rywbeth	rɪu̯baθ
hanodd	hanɔð
cynhadledd	kənhadlɛð
ymbarél	əmbarɛl
hynt	hɨ̞nt
arllwys	arɬʊɨ̯s
gweddol	ɡwɛðɔl
neud	neɨ̯d
rhyfel	r̥əval
gwahardd	ɡwaharð
it	ɪt
pharc	fark
rhyfedd	r̥əvað
aethent	eɨ̯θɛnt
cylch	kɨ̞lχ
troli	trɔli
chaen	χaːɨ̯n
chelyn	χɛlɨ̞n
beicio	bei̯kjɔ
awyrgylchoedd	au̯ərɡəlχɔɨ̯ð
canolig	kanɔlɪɡ
côr	koːr
ble wyt ti'n byw	bleːuːɨ̯ttɨːnbɨu̯
gwenoliaid	ɡwɛnɔljai̯d
dalen	dalɛn
deisen	dɪʃɛn
drudwen	drɨ̞dwɛn
chath	χaːθ
gyfreithiwr	ɡəvrei̯θjʊr
eiriadurwr	ei̯rjadɨ̞rʊr
coronafeirysau	kɔrɔnavei̯rəsɛ
prudd	prɨːð
ngherddoriaeth	ŋ̊ɛrðɔrjaɨ̯θ
anfonaf	anvɔnav
chadair	χadɛr
pres	prɛs
gwybedyn	ɡwəbɛdɨ̞n
pigau	pɪɡaɨ̯
damweiniau	damwei̯nja
gartre	ɡartrɛ
aethont	eɨ̯θɔnt
nharw	n̥aru
prydain	prədai̯n
cyfryngu	kəvrəŋɨ
ffensys	fɛnsɨ̞s
cydgordiol	kɨ̞dɡɔrdjɔl
gweithlu	ɡwei̯θlɨ
aethwn	eɨ̯θʊn
unigrywiaeth	ɨ̞nɪɡrɪu̯jɛθ
ewro	ɛu̯rɔ
posib	pɔsɪb
crair	krai̯r
peiriannau arian	pei̯rjanaarjan
timoedd	tɪmɔɨ̯ð
phastai	fasdai̯
traddodiadol	traðɔdjadɔl
gari	ɡarɪ
masen	masɛn
dosbarthu	dɔsbarθɨ
rhywun	r̥ɨu̯ɨ̞n
buddugoliaeth	bɨ̞ðɨ̞ɡɔljaɨ̯θ
llenydda	ɬɛnəða
aran	aran
mislifol	mɪslɪvɔl
nos fercher	noːsvɛrχar
argraffu	arɡrafɨ
carw llychlyn	karuɬəχlɨ̞n
odl	ɔdl
prysglwyn	prəsɡlʊɨ̯n
thei	θei̯
nhaliadau	n̥aljada
gait	ɡai̯t
gwal	ɡwal
bachwr	baːχʊr
gyrgoed	ɡərɡoːɨ̯d
prysur	prəsɨ̞r
gwasanaethau	ɡwasaneɨ̯θaɨ̯
abatir	abatɪr
bŵt	buːt
llawysgrif	ɬau̯əsɡrɪv
gwenyn gwyllt	ɡwɛnɨ̞ŋɡwɨːɬd
trwyddedau	trʊɨ̯ðɛdɛ
gwyar	ɡʊɨ̯ar
rhun	r̥ɨːn
roeddet	rɔɨ̯ðɛt
nhrwyddedau	n̥rʊɨ̯ðɛdɛ
llifogydd	ɬivɔɡɨ̞ð
dylu	dəlɨ̞
mair	mai̯r
cyn‌gyd	kəŋɨ̞d
oleuadau	ɔleɨ̯adɛ
yna	əna
cawr	kau̯r
pioden	pjɔdan
croesholi	krɔɨ̯shɔlɪ
mawrth	mau̯rθ
prifion	prɪvjɔn
ddyn	ðɨːn
hystafell	həsdavɛɬ
doeddech	dɔɨ̯ðaχ
nos sul	nɔsɨːl
o'r gloch	oːrɡloːχ
gwar	ɡwar
nhâl	n̥aːl
pweru	pʊɛrɨ
cucumer	kɨ̞kɨ̞mɛr
paentiau	peɨ̯ntjɛ
nghyfarfod	ŋ̊əvarvɔd
gwahaniaethu	ɡwanjeɨ̯θɨ
madfallod	madvaɬɔd
aech	aːɨ̯χ
penddu	pɛnðɨ
ffordd laethwen	əfɔrðɬeɨ̯θwɛn
briw	brɪu̯
bryniau	brənja
bachau	baχaɨ̯
gwestiwn	ɡwɛsdjʊn
pwynt	puːɨ̯nt
frecwast	vrɛkwast
ddaear	ðeɨ̯ar
syniad	sənjad
helygen	hɛləɡɛn
lleuad	ɬeɨ̯ad
bywgraffiadur	bɪu̯ɡrafjadɨ̞r
roedd	roːɨ̯ð
achres	aχrɛs
tylluan	təɬɨ̞an
contract	kɔntrakt
niwlen	nɪu̯lɛn
anghydfod	aŋhədvɔd
wanwyn	wanwɨ̞n
ganlyniad	ɡanlənjad
utganu	ɨ̞tɡanɨ
meysydd	meɨ̯sɨ̞ð
gweriniaeth	ɡwɛrɪnjɛθ
adenedigaethau	adɛnɛdɪɡeɨ̯θa
twrci	tʊrki
lesddeiliaid	leːsðei̯ljai̯d
mynnu	mənɨ
hiraeth	hɪraɨ̯θ
sêr llong	seːrɬɔŋ
lefrith	lɛvrɪθ
meddyg	mɛðɪɡ
stŵr	sduːr
maharen	maharɛn
gwaelod	ɡweɨ̯lɔd
awgrym	au̯ɡrɨ̞m
thebyg	θɛbɪɡ
cynnes	kənɛs
cyfartaledd	kəvartalɛð
taflod	tavlɔd
ddeiliaid	ðei̯ljɛd
teipiadur	tei̯pjadɨ̞r
delfryd	dɛlvrɨ̞d
trydan	trədan
aildrefnu	ai̯ldrevnɨ̞
chwythaf	χwəθa
camau	kamɛ
cystadleuwr	kəsdadleɨ̯ʊr
adarwr	adarʊr
chythraul	χəθraɨ̯l
argraffwr	arɡrafʊr
torchog	tɔrχɔɡ
cawod	kau̯ɔd
pen y fan	pɛnəvan
nhalcen	n̥alkɛn
duwies	dɨ̞u̯jas
rhafnwydd	r̥avnwɨ̞ð
siwgr	ʃʊɡr
didranc	dɪdraŋk
athrawesau	aθrau̯ɛsa
galw	ɡalu
mwyaf	mʊɨ̯av
pam	pam
mochyn coed	mɔχɨ̞nkoːɨ̯d
chaws	χau̯s
bwa	buːa
stopi	sdɔpi
help	hɛlp
arholiadau	arhɔljadɛ
dydd	dɨːð
telyn	tɛlɨn
afalau	avala
ardd	arð
treiddio	treiðjɔ
dechrau	dɛχra
terfysgaeth	tɛrvəsɡɛθ
neidr	nei̯dr
ysglodyn	əsɡlɔdɨ̞n
os gweli di'n dda	ɔsɡwɛlidiːnðaː
braenu	breɨ̯nɨ̞
engyl	ɛŋɨ̞l
rils	riːls
pobi	pɔbi
ioan	jɔan
aberdaugleddau	abɛrdaɨ̯ɡlɛðɛ
chaffed	χafɛd
phyliau	fəlja
babell	babaɬ
fath	vaːθ
nghadair	ŋ̊adai̯r
aethnen	eɨ̯θnɛn
coed	koːɨ̯d
cynnau	kənɛ
adferfol	advɛrvɔl
dois	dɔi̯s
ddannoedd	ðanɔɨ̯ð
arestio	arɛstjɔ
llythrennedd	ɬəθrɛnɛð
campwr	kampʊr
neidit	nei̯dɪt
trwm	trʊm
achubol	aχɨ̞bɔl
iddewes	ɪðɛu̯ɛs
deunyddiau	deɨ̯nəðja
mhoptai	m̥ɔptai̯
amddiffynnaf	amðɪfənav
saethwyr	seɨ̯θwɨ̞r
adferent	advɛrɛnt
llau	ɬaɨ̯
cyffyloca	kəfəlɔka
taliadau	taljadɛ
acen grom	akɛnɡrɔm
gartre	ɡartra
methu	mɛθɨ
gartref	ɡartra
undeg dwy	ɨ̞ndɛɡduːɨ̯
teisen gri	tei̯ʃɛŋɡriː
parcio	parkjɔ
hinon	hɪnɔn
heisteddfod	hei̯sdɛðvɔd
cadnawes	kadnau̯ɛs
ymddangos	əmðaŋɔs
bargen	barɡɛn
eirlithrad	eirlɪθrad
pabyddiaeth	pabəðjɛθ
heboca	hɛbɔka
cysylltiad	kəsəɬdjad
anoddaf	anɔða
casnewydd	kasnɛu̯ɨ̞ð
ffyrnau	fərnaɨ̯
ffonio	fɔnjɔ
galwad	ɡalwad
adargraffiadau	adarɡrafjadɛ
theisen	θei̯ʃan
pharod	farɔd
llafariad thematig	ɬavarjadθɛmatɪɡ
gweddwon	ɡwɛðwɔn
ta	ta
gwlyb	ɡwlɨːb
cato	katɔ
phencampwyr	fɛŋkampwɨ̞r
chanwr	χanʊr
cwffio	kʊfjɔ
ydy	ədi
cenna	kɛna
tafodiaith	tavɔdjai̯θ
gnwd	ɡnuːd
yfory	əvɔrɨ
cafiar	kavjar
anifail	anɪvɛl
siwan	ʃʊan
gu	ɡɨː
brân	braːn
creto	krɛtɔ
craf	kraːv
addysgu	aðəsɡɨ̞
seler	sɛlɛr
carthennau	karθɛnaɨ̯
garnau	ɡarna
sièd	ʃɛd
dos	doːs
radio	radjɔ
diolch yn fawr	diɔlχənvau̯r
chwech ar hugain	χweːχarhɪɡai̯n
chwyrn	χwɨ̞rn
gweinyddu	ɡwei̯nəðɨ
ffôn symudol	foːnsəmɨdɔl
garo	ɡarɔ
delo	dɛlɔ
ymadael	əmadaɨ̯l
llusgo	ɬɨ̞sɡɔ
bwytadwy	bʊɨ̯tadʊɨ̯
merlen	mɛrlɛn
hoffen	hɔfɛn
dalit	dalɪt
coronafeirws	kɔrɔnavei̯rʊs
cyflym	kəvlɨ̞m
contractau	kɔntraktɛ
nhelynores	n̥ɛlənɔrɛs
beic	bei̯k
tonnau	tɔna
cyn‌gyd	kəŋɡɨ̞d
thor	θɔr
tala	tala
blynedd	blənɛð
crwyn	kruːɨ̯n
ferdis	vɛrdɪs
serchog	sɛrχɔɡ
mlewyn	mlɛu̯ɨ̞n
gog	ɡoːɡ
adwaenit	adweɨ̯nɪt
nhrwydded	n̥rʊɨ̯ðɛd
iesin	jɛsɪn
bum	bɨ̞m
adeiladwaith	adei̯ladwɛθ
deugain	dei̯ɡɛn
gwerddonau	ɡwɛrðɔna
ymdrafferthu	əmdrafɛrθɨ
nos wener	noːswɛnar
ecs	ɛks
aer	aːɨ̯r
sawl	sau̯l
siwan	sɪu̯an
y tu ôl i	ətɨ̞oːlɪ
anghyflogaeth	aŋhəvlɔɡaɨ̯θ
mheiriannwr	m̥ei̯rjanʊr
syrpréis	sərprei̯s
genweiriau	ɡɛnwei̯rja
nharianau	n̥arjanaɨ̯
chwyrnu	χwərnɨ
dadl	dadl
dois	dɔi̯ʃ
nigon	nɪɡɔn
amlen	amlɛn
abathocroalaidd	abaθɔkrɔalai̯ð
lloegr	ɬɔɨ̯ɡər
llungopïau	ɬɨːŋɡɔpiːa
söolegwyr	sɔɔlɛɡwɨ̞r
gadair	ɡadar
neuddeg	neɨ̯ðɛɡ
chyfnither	χəvnɪθɛr
gwarthal	ɡwarθal
chefnau	χɛvnɛ
naear	neɨ̯ar
ateb	atab
nghrist	ŋ̊riːst
bwthyn	bʊθɨ̞n
academïau	akadɛmiːa
nhadau	n̥ada
magnelau	maɡnɛla
toesaidd	tɔɨ̯sai̯ð
cwis	kwɪs
crychau	krəχa
troedfedd	trɔɨ̯dvað
catholig	kaθɔlɪɡ
pyramid	pɨ̞ramɪd
stopiem	sdɔpjɛm
aderyn du	dɛrɨ̞ndɨː
pedolwr	pɛdɔlʊr
llais	ɬai̯s
hwn	hʊn
farnwr	varnʊr
anghofrwydd	aŋhɔvrʊɨ̯ð
asesu	asɛsɨ
deng	deːŋ
ar gyfer	arɡəvar
daw	daːu̯
hiddewiaeth	hɪðeu̯jɛθ
rhes	r̥eːs
cyfodi	kəvɔdi
adnabyddus	adnabəðɨ̞s
adael	adaɨ̯l
chymedrolwyr	χəmɛdrɔlwɨ̞r
arweinydd	arwei̯nɨ̞ð
mrecwast	mrɛkwast
gwain	ɡwai̯n
tân	taːn
ffordd laethog	əfɔrðɬeɨ̯θɔɡ
te gwyrdd	teːɡwɨ̞rð
sydd	sɨːð
nain	nai̯n
penblethau	pɛmblɛθaɨ̯
beiriannwr	bei̯rjanʊr
swnllyd	sʊnɬɨ̞d
bugail	bɪɡai̯l
rheg	r̥eːɡ
rhyfel	r̥əvɛl
thacluso	θaklɨ̞sɔ
crempog	krɛmpɔɡ
trosi	trɔsi
cyff	kɨːf
gwesteion	ɡwɛsdei̯ɔn
elciaid	ɛlkjai̯d
gylfinau	ɡəlvɪna
iechyd da	jɛχɨ̞ddaː
chloch	χloːχ
braster	brastɛr
gapel	ɡapɛl
herwhela	hɛrwhɛla
haethnen	heɨ̯θnɛn
ymlâdd	əmlaːð
habatiroedd	habatɪrɔɨ̯ð
ffrygydau	frəɡədaɨ̯
hygyrch	həɡɨ̞rχ
tyred	tərɛd
bathdai	baθdai̯
nerthoedd	nɛrθɔɨ̯ð
gaches	ɡaχɛs
bwlch	bʊlχ
chas	χaːs
gwyddor	ɡʊɨ̯ðɔr
goddef	ɡɔðɛv
llungopïo	ɬɨːŋɡɔpiːɔ
actor	aktɔr
croeso	krɔɨ̯sɔ
moresg	mɔrɛsɡ
chariad	χarjad
chacen	χakan
tebyg	tɛbɪɡ
mapiau	mapjɛ
wyddion	wəðjɔn
gwenyn meirch	ɡwɛnɨ̞mmei̯rχ
adeiladaeth	adei̯ladɛθ
wrth hyn	ʊrθhɨ̞n
naw	naːu̯
theigr	θei̯ɡr
fleiddiau	vlei̯ðja
pŵer	pʊɛr
dryslwyn	drəslʊɨ̯n
gwelet	ɡwɛlɛt
cyfrifoldeb	kəvrɪvɔldab
lanaf	lana
rhodia	r̥ɔdja
ogledd	ɔɡlað
cwyn	kuːɨ̯n
gwraidd	ɡwrai̯ð
cymraesau	kəmreɨ̯sɛ
pentwr	pɛntʊr
awyddus	au̯əðɨ̞s
cyfnod	kəvnɔd
addurno	aðɨ̞rnɔ
trigain	trɪɡai̯n
nhrwydded	n̥rʊɨ̯ðad
cyfarthiadau	kəvarθjadaɨ̯
llech	ɬeːχ
gafael	ɡaval
dîm	diːm
olau	ɔlɛ
crynu	krənɨ̞
chwyddiant	χwəðjant
tyrru	tərɨ
lesddeiliad	leːsðei̯ljad
negesfwrdd	nɛɡɛsvʊrð
ngwallt	ŋwaːɬd
helciaid	hɛlkjai̯d
cyfryngi	kəvrəŋi
arch	arχ
blogwyr	blɔɡwɨ̞r
adanedd	adanɛð
euthum	eɨ̯θɨ̞m
sumbol	sɨ̞mbɔl
boeni	bɔɨ̯nɨ
gwrthod	ɡʊrθɔd
neiliad	nei̯ljad
wyres	ʊɨ̯rɛs
adweini	adwei̯ni
gwahanol	ɡwahanɔl
cwstardiau	kʊsdardja
hach	aːχ
pheis	feis
cynffon	kənfɔn
adeg	adaɡ
hawlfraint	hau̯lvrai̯nt
gwddw	ɡʊðu
cymraesau	kəmreɨ̯saɨ̯
fampir	vampɪr
rhaw	r̥aːu̯
mewnforion	mɛu̯nvɔrjɔn
picwns coch	pɪkʊnskoːχ
pryfed genwair	prəvɛdɡɛnwɛr
mhedol	m̥ɛdɔl
ciciau	kikjaɨ̯
cymhlethdodau	kəmhlɛθdɔda
plant	plant
ysgafnder	əsɡavndɛr
cyfatebiaethau	kəvatɛbjeɨ̯θɛ
cristnogion	krɪsdnɔɡjɔn
nhudalen	n̥ɨ̞dalɛn
hun	hɨːn
grŵp	ɡruːp
chyrraedd	χərað
tlawd	tlau̯d
cheri	χɛrɪ
adfeiliadau	advei̯ljadɛ
toeslyd	tɔɨ̯slɨ̞d
gordderchadon	ɡɔrðɛrχadɔn
gor	ɡɔr
aberaeron	abɛreɨ̯rɔn
talais	talai̯s
cyhyr	kəhɨ̞r
cymraeg	kʊmraːɡ
tonnau	tɔnɛ
myfyrio	məvərjɔ
dysgu	dəsɡɨ̞
teg	teːɡ
rif	riːv
diweithdra	dɪwei̯θdra
diwrnod	dʊrnɔd
chofio	χɔvjɔ
pharhau	farhaɨ̯
pobl	pɔbɔl
thre	θreː
amser	amsar
chnau	χnaɨ̯
croenliw	krɔɨ̯nlɪu̯
bortiwgal	bɔrtjʊɡal
mellt	meːɬd
aen	aːɨ̯n
parc	park
selerau	sɛlɛra
rhagrith	r̥aɡrɪθ
camau	kamaɨ̯
mynegai	mənɛɡai̯
heisteddfodau	hei̯sdɛðvɔdaɨ̯
cyrraedd	kərað
chwydd	χuːɨ̯ð
toiledau	tɔi̯lɛda
grôt	ɡroːt
pant	pant
asgell fraith	asɡɛɬvrai̯θ
bargeinio	barɡəi̯njɔ
arwydd	arʊɨ̯ð
danfon	danvɔn
paentio	peɨ̯ntjɔ
dadleuol	dadleɨ̯ɔl
cynaniad	kənanjad
pumdeg	pɨ̞mdɛɡ
phryfed	frəvad
cilwen	kɪlwɛn
gain	ɡai̯n
mwsogla	mʊsɔɡla
gwenoliaid	ɡwɛnɔljɛd
ymrafaelgar	əmraveɨ̯lɡar
tud	tɨːd
pydredd	pədrað
pennau	pɛnɛ
thafarn	θavarn
gwahaniaeth	ɡwahanjɛθ
stemar	sdɛmar
cyhydnos yr hydref	kəhədnɔsərhədrɛ
taeog	teɨ̯ɔɡ
chymru	χəmrɨ̞
santes	santɛs
allanfa	aɬanva
medra	mɛdra
cymedroldeb	kəmɛdrɔldɛb
chared	χarɛd
cachet	kaχɛt
canet	kanɛt
map	map
adeiladol	adei̯ladɔl
deildy	dei̯ldɨ
adain	adai̯n
llall	ɬaɬ
efallai	vaɬa
woc	wɔk
aed	aːɨ̯d
rhanbarth	r̥anbarθ
gwellt	ɡweːɬd
ceidw	kei̯du
daliadau	daljadaɨ̯
adfeiliadau	advei̯ljadaɨ̯
canu	kanɨ̞
je	dʒeː
dal	dal
pedronglau	pɛdrɔŋlɛ
dydd llun	dɨ̞ɬɨːn
masgiau	masɡjaɨ̯
hofrennydd	hɔvrɛnɨ̞ð
heulwen	heɨ̯lwɛn
cnau cyll	knaɨ̯kɨ̞ɬ
hynafol	hənavɔl
rheiddiau	r̥ei̯ðjɛ
angel	aŋɛl
nghastell	ŋ̊asdaɬ
arddaf	arðav
gwobrau	ɡwɔbrɛ
gogs	ɡɔɡs
biws	bɪu̯s
rybela	rəbɛla
onnen	ɔnɛn
arosfeydd	arɔsveɨ̯ð
tenantiaethau	tɛnantjeɨ̯θaɨ̯
arddelw	arðɛlw
abadaeth	abadaɨ̯θ
dull	dɨ̞ɬ
llydan	ɬədan
utganaf	ɨ̞tɡanav
ngwlad	ŋwlaːd
anghofuster	aŋhɔvɨ̞sdɛr
unrhyw un	ɨ̞nr̥ɨ̞u̯ɨ̞n
affrica	afrɪka
brig y nos	briːɡənoːs
moli	mɔli
griliau	ɡrɪljaɨ̯
newydd	nɛu̯ɨ̞ð
ati	ati
ffi	fiː
rywbeth	rʊbɛθ
gallu	ɡaɬɨ
gornestu	ɡɔrnɛsdɨ̯
arllwysaf	arɬʊɨ̯sa
mwyaren	mʊɨ̯aran
ynys môn	ənɨ̞smoːn
afalau	avalɛ
dau	daɨ̯
pabell	pabaɬ
tonau	tɔna
piau	piːa
clirio	klɪrjɔ
chwpwrdd	χʊpʊrð
corwg	kɔrʊɡ
agori	aɡɔri
gwrthiselydd	ɡʊrθɪsɛlɨ̞ð
academi	akadɛmi
nos wener	nɔswɛnɛr
farn	varn
gwern	ɡwɛrn
olifau	ɔlɪvaɨ̯
peiriannau arian parod	pei̯rjanɛarjanparɔd
neidiau	nei̯djaɨ̯
bocsio	bɔkʃɔ
melon	mɛlɔn
llesteiriau	ɬɛsdei̯rja
esgyrn	ɛsɡɨ̞rn
rhaeadr	r̥eɨ̯adr
côt law	koːtlaːu̯
cacwn	kakʊn
pedolau	pɛdɔlɛ
bengwiniaid	bɛŋɡwɪnjai̯d
aeth	aːθ
lydaw	lədau̯
cnau ffrengig	knaɨ̯frɛŋɪɡ
byddwch	bəðʊχ
enfyn	ɛnvɨ̞n
goleuni	ɡɔleɨ̯nɨ
printio	prɪntjɔ
cymedr	kəmɛdr
pigan	pɪɡan
peniadau	pɛnjadɛ
sŵn	suːn
goddrychol	ɡɔðrəχɔl
diodydd	diɔdɨ̞ð
gwelais	ɡwɛlai̯s
thorrent	θɔrɛnt
cerrig	kɛrɪɡ
cadd	kaːð
ymateb	əmatab
lluoedd	ɬɨːɔɨ̯ð
hifanc	hɪvaŋk
iseldiraidd	ɪsɛldɪrai̯ð
llenwi	ɬɛnwi
ffigys	fɨ̞ɡɨ̞s
peintiau	pei̯ntja
bethau	bɛθaɨ̯
nai	nai̯
ganddo	ɡanðɔ
creisionen ŷd	krei̯ʃɔnɛn
helyntion	hɛləntjɔn
las	laːs
canolwyr	kanɔlwɨ̞r
mether	mɛθɛr
isel	ɪsɛl
seliau	sɛljɛ
cyfaredd	kəvarɛð
ngwyddion	ŋwəðjɔn
traddodiad	traðɔdjad
afon	avɔn
flwyddyn	vlʊɨ̯ðɨ̞n
bunt	bɨ̞nt
cymylau	kəməlɛ
iselderau	ɪsɛldɛraɨ̯
cilgant	kɪlɡant
hwch	huːχ
dan	dan
llechi	ɬɛχi
pilipala	pɪlɪpala
pethau	pɛθaɨ̯
dydd mercher	dɨːðmɛrχar
telynau	tɛləna
gwadd	ɡwaːð
nghi	ŋ̊iː
heglwys	hɛɡlʊɨ̯s
ddarllen	ðarɬan
telynau teires	tɛlənɛtei̯rɛs
celynnen	kɛlənan
llwm	ɬʊm
hwyl	huːɨ̯l
ffeindio	fei̯ndjɔ
mhrynu	m̥rənɨ
clwyd	kluːɨ̯d
awch	au̯χ
cystadlu	kəsdadlɨ
storïau	sdɔriːɛ
afanen	avanɛn
llosgi	ɬɔsɡi
cynnwys	kənʊɨ̯s
sustem	sɨ̞sdɛm
tomatos	tɔmatɔs
llafariad	ɬavarjad
abladol	abladɔl
sgandinafaidd	sɡandɪnavai̯ð
cerdd	kɛrð
awyr	au̯ɨ̞r
taid	tai̯d
elit	ɛlɪt
adargraffu	adarɡrafɨ̞
doedden	dɔɨ̯ðan
baroted	barɔtɛd
ir	iːr
athrefig	aθrɛvɪɡ
gwregys llaethol	əɡwrɛɡɨ̞sɬeɨ̯θɔl
addaweb	aðau̯ɛb
gwalch y penwaig	ɡwalχəpɛnwai̯ɡ
gefell	ɡɛvɛɬ
bresychen	brɛsəχɛn
nhe	n̥eː
helbulon	hɛlbɨ̞lɔn
amcangyfrif	amkaŋɡəvrɪ
tadau	tada
marchog	marχɔɡ
angel	aŋal
anfantais	anvantai̯s
clybiau	kləbjɛ
albaneg	albanɛɡ
siopwr	ʃɔpʊr
ŵyr	uːɨ̯r
cymhlethdodau	kəmlɛθdɔdɛ
canais	kanɪʃ
carant	karant
cofiais	kɔvjɛʃ
nhain	n̥ai̯n
fechan	vɛχan
ag	aɡ
frys	vrɨːs
llawer	ɬau̯ar
ieuanc	jeɨ̯aŋk
heddwas	hɛðwas
plentynnaidd	plɛntənai̯ð
golygfa	ɡɔləɡva
ieithadur	jeiθadɨ̞r
ymladdwr	əmlaðʊr
trefedigaethau	trɛvɛdɪɡeɨ̯θa
nghlust	ŋ̊lɨːst
fleiddiau	vlei̯ðjaɨ̯
dysgwr	dəsɡʊr
cwningen	kʊnɪŋɛn
rhywbeth	r̥ʊbɛθ
ngeiriadurwyr	ŋei̯rjadɨ̞rwɨ̞r
onn	ɔn
hunan	hɨ̞nan
ddringo	ðrɪŋɔ
sgriniau	sɡrɪnjaɨ̯
dali	dali
siaced	ʃakad
aethost	eɨ̯θɔsd
rhuthraf	r̥ɨ̞θrav
riliau	jrɪla
gaen	ɡaːɨ̯n
ffyrnau	fərna
mynedadwy	mənɛdadʊɨ̯
chweina	χwei̯na
abadau	abadaɨ̯
etifeddu	ɛtɪvɛðɨ
amgáu	amɡaɨ̯
morwennol	mɔrwɛnɔl
gweiriau	ɡwei̯rjɛ
creision	krei̯ʃɔn
selerau	sɛlɛrɛ
ddafydd	ðavɨ̞ð
trolïau	trɔlɪa
cer	kɛr
coronafeirysau	kɔrɔnavei̯rəsaɨ̯
iasau	jasa
dodi	dɔdɪ
gwrthwynebu	ɡʊrθwɨ̞nɛbɨ
gweinyddes	ɡwei̯nəðɛs
delem	deːlɛm
gornestau	ɡɔrnɛsdaɨ̯
hendrefi	hɛndrɛvi
blodfresychen	blɔdvrɛsəχɛn
damwain	damwai̯n
cydweithwyr	kɨːdwei̯θwɨ̞r
pellter	pɛɬdɛr
ymenyn	əmɛnɨ̞n
mlog	mlɔɡ
darw	daru
gusan	ɡɨ̞san
uni	ɨ̞ni
cyfrif	kəvrɪ
cyflwr	kəvlʊr
bechan	bɛχan
gwreiddiol	ɡwrei̯ðjɔl
telynoresau	tɛlənɔrɛsa
pabïau	pabiːɛ
traphoethi	trafɔɨ̯θɨ
gweinyddiaethau	ɡwei̯nəðjeɨ̯θaɨ̯
sioe	ʃoːɨ̯
ca	kaː
nghacen	ŋ̊akɛn
cyffredin	kəfrɛdɪn
bwm y gors	bʊməɡɔrs
farnau	varnɛ
chalon	χalɔn
ciwcymber	kɪu̯kəmbɛr
pedronglau	pɛdrɔŋla
gwrthwynebiadau	ɡʊrθwɨ̞nɛbjada
hollti	hɔɬdi
phengwiniaid	fɛŋɡwɪnjɛd
chalennig	χalɛnɪɡ
rydych	rədɨ̞χ
cyflogwr	kəvlɔɡʊr
bronwen	brɔnwɛn
chusanau	χɨ̞sanɛ
anghytgord	aŋhətɡɔrd
arian parod	arjamparɔd
cei	kei̯
ganen	ɡanɛn
rhanbarthau	r̥anbarθaɨ̯
ngair	ŋai̯r
mhencampwr	m̥ɛŋkampʊr
gôt law	ɡoːtlaːu̯
cynhyrchu	kənhərχɨ
peithiau	pei̯θjaɨ̯
llwythi	ɬʊɨ̯θi
blychau llwch	bləχaɨ̯ɬuːχ
rhywsut	r̥ɪu̯sɨ̞t
thew	θeːu̯
gwalch y pysgod	ɡwalχəpəsɡɔd
paratoi	paratɔi̯
dydd mawrth	dɨːðmau̯rθ
cynnig	kənɪɡ
ddechrau	ðɛχra
hoelio	hɔi̯ljɔ
flwydd	vluːɨ̯ð
chneuen	χneɨ̯an
galar	ɡaːlar
arswydau	arsʊɨ̯daɨ̯
pryfed	prəvɛd
chwyrnaf	χwərnav
gwalch glas	ɡwalχɡlaːs
chân	χaːn
aber	abɛr
bysgodyn	bəsɡɔdɨ̯n
cesail	kɛsɛl
mapiau	mapja
gyddfau	ɡəðvɛ
pelydr x	pɛlɨ̞drɛks
naw ar hugain	naːu̯arhɪɡai̯n
fflyd	flɨːd
corffluniwr	kɔrflɨ̞njʊr
garit	ɡarɪt
amobr	amɔbr
hunllef	hɨ̞nɬɛ
gais	ɡai̯s
arolygiaethau	arɔləɡjeɨ̯θaɨ̯
rhi	r̥iː
jaciau	dʒakjaɨ̯
wyt	uːɨ̯t
nghaleted	ŋ̊alɛtɛd
dafarn	davarn
perseiniol	pɛrsei̯njɔl
trwydded	trʊɨ̯ðad
fara	vara
droednoeth	drɔɨ̯dnɔɨ̯θ
awd	au̯d
alli	aɬi
pren	prɛn
delynores	dɛlənɔras
wych	wɨːχ
gyda	ɡɨ̞da
ffatri	fatri
neilen	nei̯lɛn
glyw	ɡlɪu̯
fyfyriwr	vəvərjʊr
atelid	atɛlɪd
lloer	ɬoːɨ̯r
oes	oːɨ̯s
nhad	n̥aːd
nhŵr	n̥uːr
technoleg gwybodaeth	tɛχnɔlɛɡɡʊbɔdaɨ̯θ
dalu	dalɨ̞
amanita'r gwybed	amanɪtarɡwəbɛd
goed	ɡoːɨ̯d
llyfrgell	ɬəvrɡɛɬ
bwa'r gwynt	buːarɡwɨ̞nt
cwympo	kwɨmpɔ
rhagenw	r̥aɡɛnu
anner	anɛr
galli	ɡaɬɪ
cyflafareddwr	kəvlavarɛðʊr
dydd sul	dɨ̞ðsɨːl
blaen	blaːɨ̯n
dw	dw
gwawr	ɡwau̯r
abadaethau	abadeɨ̯θɛ
cnwd	knuːd
cymell	kəmɛɬ
barfog	barvɔɡ
ofnadwy	ɔvnadʊɨ̯
ngwybodaeth	ŋwɨ̞bɔdaɨ̯θ
adferadwy	advɛradʊɨ̯
miliwn	mɪljʊn
medran	mɛdran
eistedd	ɪsda
lladron	ɬadrɔn
ddwfr	ðʊvr
smygu	sməɡɨ
cilwg	kɪlʊɡ
microsgopau	mɪkrɔsɡɔpaɨ̯
nghusanu	ŋ̊ɨ̞sanɨ̞
nglawio	ŋlau̯jɔ
enillwr	ɛnɨ̞ɬʊr
gwpwrdd	ɡʊpʊrð
nysgu	nəsɡɨ̞
brwdfrydedd	brʊdvrədað
tacluso	taklɨ̞sɔ
grwpiau	ɡrʊpjɛ
de	deː
mai	mai̯
lleuen	ɬeɨ̯ɛn
ffenest	fɛnasd
seithfed	sei̯θvɛd
preifat	prei̯vat
dydd mawrth	dɨ̞mau̯rθ
nghwpwrdd	ŋ̊ʊpʊrð
alban cyntefin	albankəntɛvɪn
pres	preːs
afallen	avaɬɛn
dysgleidiau	dɨ̞sɡlei̯djɛ
prynu	prənɨ
cynnau	kənaɨ̯
mewnfodol	mɛu̯nvɔdɔl
degan	dɛɡan
gaws	ɡau̯s
mo	mɔ
cefnau	kɛvnɛ
taranau	taranɛ
sylffwr	səlfʊr
prifddinas	prɪvðɪnas
rhwystredigaeth	r̥ʊɨ̯sdrɛdɨ̞ɡɛθ
pryf cop	prɨːvkɔp
pennill	pɛnɪɬ
ciciau	kikjɛ
mws	muːs
arth fawr	arθvau̯r
adwaenent	adweɨ̯nɛnt
cynrychioli	kənrəχjɔli
mleiddiaid	mlei̯ðjɛd
chylchgrawn	χəlχɡrau̯n
gwag	ɡwaːɡ
ateli	atɛli
esgid	ɛsɡɪd
dyfnion	dəvnjɔn
anaf	anav
cicio	kɪkjɔ
ffraeau	freɨ̯ɛ
carafannau	karavana
thrannoeth	θranɔɨ̯θ
dilyn	dɪlin
amanita droednoeth	amanɪtadrɔɨ̯dnɔɨ̯θ
briciau	brikja
neithiwr	nei̯θjʊr
thalcen	θalkan
barbeciw	barbɛkɪu̯
dydd llun	dɨ̞ðɬɨːn
ffwcio	fʊkjɔ
pajamas	pad͡ʒamas
gwladgarwr	ɡwladɡarʊr
unrhyw	ɨ̞nr̥ɨ̞u̯
glwth	ɡluːθ
hefo	hɛvɔ
chwith	χwiːθ
delom	dɛlɔm
carreg galch	kɛrɪɡɡalχ
pencampwriaethau	pɛŋkampʊrjeɨ̯θaɨ̯
genidol	ɡɛnɪdɔl
rhedyn	r̥ɛdɨ̞n
cydweithwyr	kɨ̞dwei̯θwɨ̞r
lanaf	lanav
nos wener	noːswɛnɛr
pwyso	pʊɨ̯sɔ
abatiroedd	abatɪrɔɨ̯ð
cenedl	kɛnɛdl
siarad	ʃarad
nyddu	nəðɨ
hen bryd	heːnbrɨːd
seintiau	sei̯ntjaɨ̯
meibion	məi̯bjɔn
cilddant	kɪlðant
gaed	ɡaːɨ̯d
llythyren	ɬəθəran
habadesau	habadɛsɛ
seibiau	sei̯bjɛ
daeargrynfeydd	deɨ̯arɡrənveɨ̯ð
gwsberen	ɡʊsbɛrɛn
elid	ɛlɪd
cilbren	kɪlbrɛn
mwll	mʊɬ
dydd gwener	dɨːðɡwɛnar
tal	tal
breuddwydio	breɨ̯ðʊɨ̯djɔ
echrydus	ɛχrədɨ̞s
nghlwb	ŋ̊lʊb
basen	san
beirniadu	bei̯rnjadɨ
tudalennau gwe	tɨ̞dalɛnɛɡweː
tyr	tɨ̞r
diwerth	dɪu̯ɛrθ
gorchuddio	ɡɔrχɨ̞ðjɔ
dalo	dalɔ
trên	treːn
disgwyl	dɪsɡʊɨ̯l
teisen radell	tei̯ʃanradɛɬ
streiciau	sdrei̯kjɛ
gwleidydd	ɡwlei̯dɨ̞ð
cymylog	kəməlɔɡ
nghael	ŋ̊aːɨ̯l
masnachdy	masnaχdɨ
duwies	dɨ̞u̯jɛs
castanwydden	kasdanwɨ̞ðan
rhewi'n gorn	r̥ɛu̯iŋɡɔrn
nghythraul	ŋ̊əθrɛl
nghalenigion	ŋ̊alɛnɪɡjɔn
groes	ɡroːɨ̯s
unigrywiaeth	ɨ̞nɪɡrɪu̯jaɨ̯θ
ngwddf	ŋʊðv
ferfenw	vɛrvɛnu
llamidogion	ɬamɪdɔɡjɔn
lled	ɬeːd
gwaywffon	ɡweɨ̯wfɔn
saith	sai̯θ
greto	ɡrɛtɔ
amcan	amkan
ciciau	kikja
glin	ɡliːn
pryf	prɨːv
ymlŷn	əmlɨːn
beudy	beɨ̯dɨ
ngŵr	ŋuːr
croesair	krɔɨ̯sai̯r
erfyn	ɛrvɨn
cystadleuaeth	kəsdadleɨ̯aɨ̯θ
sodlau	sɔdlɛ
caleted	kalɛtɛd
mwynhau	mʊɨ̯nhaɨ̯
cariad	karjad
llwyth	ɬʊɨ̯θ
adweithegwyr	adwei̯θɛɡwɨ̞r
eiliadau	ei̯ljadaɨ̯
charwr	χarʊr
paffwyr	pafwɨ̞r
brif	briːv
pwrpas	pʊrpas
brawiau	brau̯jaɨ̯
drysgoed	drəsɡɔɨ̯d
gobeithio	ɡɔbei̯θjɔ
amaethyddiaeth	ameɨ̯θəðjaɨ̯θ
cildroi	kɪldrɔi̯
academaidd	akadɛmai̯ð
eraill	ɛrai̯ɬ
chwyth	χwɨːθ
buddugwr	bɨ̞ðɨ̞ɡʊr
go	ɡoː
bencampwyr	bɛŋkampwɨ̞r
cystadleuwyr	kəsdadleɨ̯wɨ̞r
albanau	albanaɨ̯
cythreuliaid	kəθreɨ̯ljɛd
iwrch	jʊrχ
sain	sai̯n
testun	tɛstɨ̞n
anogaf	anɔɡav
corcyn	kɔrkɨ̞n
enfawr	ɛnvau̯r
coden	kɔdɛn
rhyngrwyd pethau	r̥əŋrʊɨ̯dpɛθaɨ̯
lysiau	ləʃa
anogaf	anɔɡa
arwerthwyr	arwɛrθwɨ̞r
deunydd	deɨ̯nɨ̞ð
adflasau	advlasɛ
saesneg	sɨ̞snaɡ
golwg	ɡɔlʊɡ
delyn	dɛlɨn
bedwar	bɛdwar
peiriannau llungopïo	pei̯rjanaɬɨ̞ŋɡɔpiːɔ
caledu	kalɛdɨ
corhwyaden	kɔrhʊɨ̯adan
blewyn	blɛu̯ɨ̞n
canent	kanɛnt
troer	troːɨ̯r
arian	arjan
basged	basɡad
heddiw	hɛðɪu̯
mêts	meːts
bricyll	brɪkɨ̞ɬ
arllwysaf	arɬʊɨ̯sav
pumed	pɨ̞mad
berfau	bɛrvɛ
rhedeg	r̥ɛdɛɡ
marw	maru
ymaflyd	əmavlɨ̞d
riliau	rɪljaɨ̯
agoriad	aɡɔrjad
meddyg	mɛðɨ̞ɡ
gyda hyn	ɡɨ̞dahɨ̞n
tgau	tɡaɨ̯
gwŷr	ɡwɨːr
ffon	fɔn
atseiniau	atsei̯njɛ
ffilmiau	fɪlmja
pennau	pɛna
gaeaf	ɡeɨ̯a
byw	bɪu̯
iach	jaːχ
delysg	dɛlɨ̞sɡ
lluwch	ɬɨu̯χ
chais	χai̯s
lesoedd	lɛsɔɨ̯ð
siom	ʃɔm
duw	dɨu̯
hogiau	hɔɡja
cased	kasɛd
actores	aktɔrɛs
llywyddion	ɬəu̯əðjɔn
llafariaid thematig	ɬavarjɛdθɛmatɪɡ
trengholiadau	trɛŋhɔljadɛ
neu	neɨ̯
adlam	adlam
cloi	klɔi̯
gwerthiant	ɡwɛrθjant
addolwr	aðɔlʊr
gerddoriaeth	ɡɛrðɔrjaɨ̯θ
môr	moːr
uchaf	ɨ̞χav
frân	vraːn
prysglwyni	prəsɡlʊɨ̯nɪ
annerch	anɛrχ
wy	uːɨ̯
collen	kɔɬan
hanfon	hanvɔn
arth	arθ
protestaniaid	prɔtɛsdanjɛd
oferedd	ɔvɛrɛð
glwb	ɡlʊb
llong noa	ɬɔŋnoːa
lleiandy	ɬei̯andɨ
phaned	fanɛd
awn	au̯n
gŵyll	ɡuːɨ̯ɬ
theirw	θei̯ru
chorff	χɔrf
cen y cerrig	kɛnəkɛrɪɡ
galanas	ɡalanas
nos iau	noːsjaɨ̯
gwenu	ɡwɛnɨ̞
dudalen	dɨ̞dalɛn
cyswllt	kəsʊɬd
tenantiaeth	tɛnantjaɨ̯θ
faet	vaːɨ̯t
goginio	ɡɔɡɪnjɔ
damweiniau	damwei̯njɛ
llnau	ɬnaɨ̯
mynaich	mənai̯χ
gogledd	ɡɔɡlað
chot	χɔt
tŵr	tuːr
addas	aðas
datblygu	datbləɡɨ
lladd	ɬaːð
tenantiaethau	tɛnantjeɨ̯θa
ffonau	fɔna
llen	ɬɛn
dwfr	dʊvr
deilen	dei̯lɛn
brad	braːd
caled	kalad
weithiwr	wei̯θjʊr
rhian	r̥ian
eirin ysgaw	ei̯rɪnəsɡau̯
pechod	pɛχɔd
ngolwg	ŋɔlʊɡ
cyfareddol	kəvarɛðɔl
perth	pɛrθ
darlithydd	darlɪθɨ̞ð
blwyddyn	blʊɨ̯ðɨ̞n
gôl	ɡoːl
deset	ðɛsɛt
dogfen	dɔɡvɛn
peli troed	pɛlitroːɨ̯d
twitter	twɪtər
aberthu	abɛrθɨ̞
edfryd	ɛdvrɨ̞d
gwerthu	ɡwɛrθɨ
babŵn	babuːn
lyfrau	ləvra
cyfarthiadau	kəvarθjada
cyfansymiau	kəvansəmja
mae	mə
llwyn	ɬuːɨ̯n
bryd	brɨːd
boneddigesau	bɔnɛðɪɡɛsa
mharc	m̥ark
nhrwyddedau	n̥rʊɨ̯ðɛda
allforiadwy	aɬvɔrjadʊɨ̯
cŷn	kɨːn
credent	krɛdɛnt
nhewi	n̥ɛu̯i
galeted	ɡalɛtɛd
thebyg	θɛbɨ̞ɡ
habadau	habadɛ
edau	ɛdɛ
wythfed	ʊɨ̯θvɛd
troednoeth	trɔɨ̯dnɔɨ̯θ
ber	bɛr
eni	ɛnɪ
adfywio	advɨ̞u̯jɔ
ger	ɡɛr
codi	kɔdɪ
brwysg	bruːɨ̯sk
tali	tali
tyn	tɨ̞n
elsent	ɛlsɛnt
phabell	fabaɬ
mynachaidd	mənaχɛð
cref	kreːv
iâr	jaːr
gwydraid	ɡwədrai̯d
cynorthwyydd	kənɔrθʊɨ̯ɨ̞ð
sawdl	sau̯dl
ydau	ədɛ
llestair	ɬɛsdai̯r
person	pɛrsɔn
sodlau uchel	sɔdlaɨ̯ɨ̞χɛl
yn barod	əmbarɔd
broch	broːχ
anableddau	anablɛðɛ
mhunt	m̥ɨ̞nt
unig	ɨ̞nɪɡ
anghytuno	aŋətɨnɔ
chwrw	χʊru
cnewyllyn	knɛu̯əɬɨ̞n
gwrthwynebiadau	ɡʊrθwɨ̞nɛbjadaɨ̯
unioni	ɨ̞njɔni
saethyddiaeth	seɨ̯θəðjɛθ
mwlgaria	mʊlɡarja
gallo	ɡaɬɔ
rhwystredig	r̥ʊɨ̯sdrɛdɨ̞ɡ
llwythau	ɬʊɨ̯θɛ
allen	aɬɛn
mlodau	mlɔdaɨ̯
awyrgylch	au̯ərɡɨ̞lχ
cynulleidfa	kənɨ̞ɬei̯dva
radwla	radʊla
charai	χarɛ
ti	tiː
nhalcen	n̥alkan
nid wrth ei big y mae prynu cyffylog	nɪdʊrθei̯biːɡəmaːɨ̯prənɨkəfəlɔɡ
tewed	tɛu̯ɛd
chantor	χantɔr
cerbyd	kɛrbɨ̞d
mochyn daear	mɔχɨ̞ndeɨ̯ar
sgri	sɡriː
ngwair	ŋwai̯r
derw	dɛru
coffi	kɔfi
dysglaid	dɨ̞sɡlai̯d
cystal	kəsdal
fag	vaɡ
piclau	pɪkla
dosbarthwyr	dɔsbarθwɨ̞r
roedden	rɔɨ̯ðɛn
ach	aːχ
hafod	havɔd
talit	talɪt
dydd sadwrn	dɨːðsadʊrn
hardal	hardal
pencampwriaethau	pɛŋkampʊrjeɨ̯θa
chwerw	χwɛru
detyd	dɛtɨ̞d
gae	ɡaːɨ̯
lwybr	lʊɨ̯br
gwybod	ɡʊbɔd
cerdd dant	kɛrðdant
dw i angen cyfreithiwr	duiaŋɡɛnkəvrəiθɪur
darparu	darparɨ
crŷn	krɨːn
cyfrwngddarostyngedigaeth	kəvrʊŋðarɔsdəŋɛdɪɡaɨ̯θ
gwelwn	ɡwɛlʊn
rywle	rɨu̯la
dwys	duːɨ̯s
ymennydd	əmɛnɨ̞ð
ngweddi	ŋwɛði
iselder	ɪsɛldɛr
tyllau yn y wal	təɬɛənəwal
dyfarniadau	dəvarnjadɛ
amau	amaɨ̯
bendithio	bɛndɪθjɔ
arbedaf	arbɛdav
can	kan
argraffiadaeth	arɡrafjadɛθ
panasen	panasan
melin	mɛlɪn
brwydrau	brʊɨ̯drɛ
drwyn	druːɨ̯n
belffast	bɛlfasd
galluog	ɡaɬɨɔɡ
cyfiawnder	kəvjau̯ndar
crynhoad	krənhɔad
dirmyg	dɪrmɨ̞ɡ
achyddion	aχəðjɔn
chwe	χweː
rhyngrwyd y pethau	r̥əŋrʊɨ̯dəpɛθaɨ̯
hafodau	havɔdaɨ̯
laith	lai̯θ
act	akt
iogwrt	jɔɡʊrt
hirsgwar	hɪrsɡwar
deall	dɛaɬ
caerau	keɨ̯raɨ̯
wrth gwrs	ʊrθɡʊrs
ciciau adlam	kikjɛadlam
gefnau	ɡɛvnaɨ̯
carbon	karbɔn
eangfrydig	ɛaŋvrədɪɡ
hwynt	hʊɨ̯nt
caerliwelydd	kaɨ̯rlɪu̯ɛlɨ̞ð
castell	kasdaɬ
rhegfeydd	r̥ɛɡveɨ̯ð
pwl	pʊl
allblyg	aɬblɨ̞ɡ
clawr	klau̯r
cyflogwyr	kəvlɔɡwɨ̞r
mhrydain	m̥rədɛn
ifan	ɪvan
cwerylau	kwɛrəlɛ
bencampwriaeth	bɛŋkampʊrjɛθ
byliau	bəljaɨ̯
gardd	ɡaːrð
garejys	ɡarɛd͡ʒɨ̞s
cytrefi	kətrɛvɪ
dyry	dərɨ
arall	araɬ
agora	aɡɔra
pum	pɨ̞m
almaen	əralmaɨ̯n
cyfeillgar	kəvei̯ɬɡar
blog	blɔɡ
adarydda	adarəða
mhobloedd	m̥ɔblɔɨ̯ð
taten	tatɛn
cyfair	kəvɛr
ymlaen	laːɨ̯n
sadwrn	sadʊn
habadau	habadaɨ̯
ddaw	ðaːu̯
twyllwyr duon	tʊɨ̯ɬwɨ̞rdɨ̞ɔn
academaidd	akadɛmɛð
abatai	abataɨ̯
fodd bynnag	voːðbənaɡ
datrys	datrɨ̞s
weddi	wɛði
ngleision	ŋlei̯ʃɔn
toddf	tɔðv
nghalan	ŋ̊alan
ieirll	jei̯rɬ
cyfryngiadau	kəvrəŋjada
nghaled	ŋ̊alɛd
gwestai	ɡwɛsdai̯
hagor	haɡɔr
iwerddoneg	ɪu̯ɛrðɔnɛɡ
talaf	talav
rhyngrwyd y pethau	r̥əŋrʊɨ̯dəpɛθa
peirianwaith	pei̯rjanwai̯θ
atgoffa	atɡɔfa
geiriau	ɡei̯rjɛ
gwenyn	ɡwɛnɨ̞n
absennol	absɛnɔl
hud	hɨːd
phib	fiːb
debyg	dɛbɪɡ
ysgawen	əsɡau̯ɛn
caerdydd	kaɨ̯rdɨːð
gwahaniaeth	ɡwahanjaɨ̯θ
gemwaith	ɡɛmwai̯θ
bortiwgal	bɔrtɪu̯ɡal
cyfrifol	kəvrɪvɔl
biliwn	bɪljʊn
sèd	sɛd
nid wrth ei big y mae prynu cyffylog	nɪdʊrθibiːɡəmaprənɨkəfəlɔɡ
trafferth	trafɛrθ
cadair	kadai̯r
abergwaun	abɛrɡwaɨ̯n
poeni	pɔɨ̯nɨ
aberhonddu	abɛrhɔnðɨ
atal	atal
dydw i ddim yn siarad cymraeg	dəduiðɪmənʃaradkəmraɪɡ
pherthynas	fɛrθənas
cadair	kadar
nalen	nalɛn
collnod	kɔɬnɔd
talant	talant
budd	bɨːð
hafren	havrɛn
ngorsaf	ŋɔrsav
chusanau	χɨ̞sana
canem	kanɛm
gweler	ɡwɛlɛr
anwybyddu	anwɨ̞bəðɨ
clymu	kləmɨ̞
lysenw	lɨ̞sɛnu
gwylliaid	ɡʊɨ̯ɬjɛd
llyfr	ɬɨ̞vɨ̞r
betws	bɛtʊs
gwahaniaeth	ɡwahanjaθ
clog	kloːɡ
chwŷl	χwɨːl
ngwlad belg	ŋwlaːdbɛlɡ
jac a'i wagen	d͡ʒakai̯waɡɛn
addef	aðɛv
adlais	adlai̯s
wyt	uːt
llesteiriau	ɬɛsdei̯rjɛ
fenyn	vɛnɨ̞n
nghnau	ŋ̊naɨ̯
diwyr	dɪʊɨ̯r
glas bach y wal	ɡlaːsbaːχəwal
dyddiadau	dəðjada
oedolyn	ɔɨ̯dɔlɨ̞n
cwerylon	kwɛrəlɔn
rhech	r̥eːχ
hylif	həlɪv
rheoliadur	r̥ɛɔljadɨ̞r
technoleg gwybodaeth	tɛχnɔlɛɡɡwəbɔdɛθ
llungopïo	ɬɨ̞ŋɡɔpiːɔ
torro	tɔrɔ
nerfus	nɛrvɨ̞s
bryfed	brəvɛd
claf	klaːv
ddos	ðoːs
terfynol	tɛrvənɔl
chanu	χanɨ̞
pwy	pʊ
adfail	advai̯l
brych	brɨːχ
loegr	lɔɨ̯ɡər
rhyddhau	r̥əðhaɨ̯
cecrus	kɛkrɨ̞s
nhi	n̥iː
goleuad	ɡɔleɨ̯ad
myth	mɨːθ
bedw	bɛdu
rhwystredigaethau	r̥ʊɨ̯sdrɛdɨ̞ɡeɨ̯θa
darpar	darpar
anghlod	aŋhlɔd
diamod	diːamɔd
saethu	seɨ̯θɨ
moch coed	moːχkoːɨ̯d
anuniongyrchol	anɨ̞njɔŋɡərχɔl
phur	fɨːr
dadlau	dadla
ailfeddiannu	ai̯lvɛðjanɨ̞
tudalen we	tɨ̞dalɛnweː
dafarnwr	davarnʊr
telir	tɛlɪr
chadair	χadai̯r
glanach	ɡlanaχ
phopty	fɔptɨ
cachais	kaχɛs
gwagedd	ɡwaɡɛð
ngweddi'r arglwydd	ŋwɛðirarɡluɨ̯ð
ngwinoedd	ŋwɪnɔɨ̯ð
cythraul	kəθraɨ̯l
aderyn du	adɛrɨ̞ndɨː
rhywle	r̥ɨu̯lɛ
derbyn	dɛrbɨ̞n
gyrraf	ɡərav
llaw	ɬaːu̯
rhaid	hai̯d
angylion	aŋəljɔn
chwningen	χʊnɪŋɛn
plyg	plɨːɡ
tomato	tɔmatɔ
clun	klɨːn
goleuadau	ɡɔleɨ̯adɛ
cromlech	krɔmlɛχ
cloddfa	klɔðva
glybiau	ɡləbjaɨ̯
berfau	bɛrvaɨ̯
llythyrennau	ɬəθərɛnɛ
efallai	ɛvaɬai̯
llwyd	ɬuːɨ̯d
mynachlogydd	mənaχlɔɡɨ̞ð
mlodyn	mlɔdɨ̞n
adladd	adlað
helyglys hardd	hɛləɡlɨ̞sharð
putain	pɨ̞tai̯n
trennydd	trɛnɨ̞ð
tanau gwyllt	tanaɡwɨːɬd
dryslyd	drəslɨ̞d
actiaf	aktjav
mynach	mənaχ
nymff	nɨ̞mf
canai	kanɛ
roeddech	rɔɨ̯ðɛχ
fforest	fɔrast
tudalennau	tɨdalɛna
galwyn	ɡalʊɨ̯n
cwpanaid	kʊpanai̯d
grwpiau	ɡrʊpja
fel	vɛl
iro	ɪrɔ
wel	wɛl
nghusanau	ŋ̊ɨ̞sanɛ
cyfaill	kəvai̯ɬ
sgôr	sɡoːr
berllan	bɛrɬan
ganu	ɡanɨ̞
gwningen	ɡʊnɪŋan
amserlenni	amsɛrlɛni
hwy	huːɨ̯
gronell	ɡrɔnɛɬ
thwrci	θʊrki
teisen	tei̯ʃan
llwyfan	ɬʊɨ̯van
caniatâd	kanjataːd
gwalch	ɡwalχ
talent	talɛnt
blino	blɪnɔ
unes	ɨ̞nɛs
troan	trɔan
rhywle	r̥ʊlɛ
archangylion	arχaŋəljɔn
weithiau	wei̯θjaɨ̯
barcud	barkɨ̞d
enillydd	ɛnɨ̞ɬɨ̞ð
dur	dɨːr
gwanwynau	ɡwanwənaɨ̯
teisennau	tei̯sɛnaɨ̯
dywed	dəu̯ɛd
adroddaf	adrɔða
personél	pɛrsɔnɛl
galennig	ɡalɛnɪɡ
gochlas	ɡɔχlas
cyrraedd	kərɛð
gweinyddion	ɡwei̯nəðjɔn
charet	χarɛt
haber	habɛr
castanwydden	kasdanwɨ̞ðɛn
addoldy	aðɔldɨ̞
bildar	bɪldar
ddelw	ðɛlu
rhywle	r̥ʊla
flasus	vlasɨ̞s
arolygiaeth	arɔləɡjɛθ
arddangosfa	arðaŋɡɔsva
ffraeau	freɨ̯aɨ̯
llyfrau	ɬəvrɛ
gweedig	ɡwɛɛdiɡ
hirion	hɪrjɔn
petris	pɛtrɪs
defnydd	dɛvnɨ̞ð
haethnenni	heɨ̯θnɛni
bri	briː
gnau	ɡnaɨ̯
fewn	vɛu̯n
cennin pedr	kɛnɪmpɛdr
antimoni	antɪmɔni
abl	abl
maharen	maharan
teigrod	tei̯ɡrɔd
pysgod	pəsɡɔd
afu	avɨ̞
telid	tɛlɪd
anialwch	anjalʊχ
adnodd	adnɔð
boneddigion	bɔnɛðɪɡjɔn
hydrefau	hədrɛva
plu eira	plɨːei̯ra
academyddion	akadɛməðjɔn
dawel	dau̯ɛl
nrama	nrama
adnabyddwn	adnabəðʊn
mhobl	m̥ɔbɔl
bedd	beːð
am byth	ambɨːθ
aetsh	aːɨ̯tʃ
llwyddiannus	lʊɨ̯ðjanɨ̞s
ddaru	ðarɨ̞
thraed	θraːɨ̯d
huan	hɨan
condemni	kɔndɛmnɪ
papur newydd	papɨ̞rnɛu̯ɨ̞ð
rhedeg	r̥ɛdaɡ
cheisio	χei̯ʃɔ
teisennau	tɪʃɛnɛ
chwythu	χwəθɨ̞
araf	ara
ieithyddiaeth	jei̯θəðjaɨ̯θ
picau	pɪkɛ
doi	dɔi̯
hydref	hədrɛv
cydweithio	kɨːdwei̯θjɔ
tlws	tluːs
hymasiad	həmaʃad
band	band
anableddau	anablɛðaɨ̯
eistedd	ɪsdɛ
paroted	parɔtɛd
cwyno	kʊɨ̯nɔ
teitl	tei̯tl
pyg	pɨːɡ
farchnad	varχnad
cyrsiau	kərʃaɨ̯
pafán	pavan
gobaith	ɡɔbaiθ
etholiad	ɛθɔljad
glosen	ɡlɔsɛn
bwrdd	bʊrð
habwyd	habʊɨ̯d
sil	siːl
gacen	ɡakɛn
llygaid	ɬəɡai̯d
nhafarn	n̥avarn
helyntoedd	hɛləntɔɨ̯ð
adran	adran
bleiddiau	blei̯ðja
ngwiwer	ŋwɪu̯ɛr
ladd	laːð
pedwar ar hugain	pɛdwararhɪɡai̯n
tharianau	θarjana
rhingyll	r̥ɨnɡɨɬ
trydedd	trədað
plastig	plasdɪɡ
les	leːs
cydweithrediadau	kɨːdwei̯θrɛdjada
gyddfau	ɡəðvaɨ̯
popeth	pɔpɛθ
gorwel	ɡɔrwɛl
moch daear	moːχdeɨ̯ar
colledion	kɔɬɛdjɔn
cog	koːɡ
mai	mə
nghyfarfod	ŋ̊warvɔd
mwynach	mʊɨ̯naχ
gallai	ɡaɬai̯
genedigaeth	ɡɛnɛdɪɡaɨ̯θ
teifl	tei̯vl
siopa	ʃɔpa
pythefnos	pəθɛvnɔs
ymrafaelion	əmraveɨ̯ljɔn
i'r dim	ɪrdɪm
cyfrannog	kəvranɔɡ
cyfundrefnol	kəvɨ̞ndrɛvnɔl
cyn hyn	kɨ̞nhɨ̞n
fore	vɔrɛ
trydedd	trɪdɛð
rydd	rɨːð
cadlas	kadlas
anghymdeithasol	aŋhəmdei̯θasɔl
cacen	kakɛn
rhyngrwyd y pethau	r̥əŋrʊɨ̯dəpɛθɛ
gwyll	ɡwɨ̞ɬ
byd	bɨːd
ais	ai̯s
rhyddid	r̥əðɪd
toddyf	tɔðɨ̞v
gnei	ɡnei̯
dw i angen dŵr	duiaŋɡɛnduːr
telynores	tɛlənɔras
grêt	ɡreːt
mys	mɨːs
sut wyt ti	sɨ̞tuːɨ̯ttiː
argraff	arɡraf
mlwyddyn	mlʊɨ̯ðɨ̞n
berfau annherfynol	bɛrvaanhɛrvənɔl
arfau	arvaɨ̯
caeth	kaːθ
pastai	pasdai̯
siwr	ʃuːr
mordwy	mɔrdʊɨ̯
cwestiynau	kwɛsdjənaɨ̯
gwladfeydd	ɡwladveɨ̯ð
cyfateb	kəvatɛb
ddenmarc	ðɛnmark
cofiai	kɔvjai̯
gwrol	ɡʊrɔl
dylwn	dəlʊn
clodydd	klɔdɨ̞ð
olaf	ɔlav
fathemateg	vaθɛmatɛɡ
chanlyniad	χanlənjad
hachosi	haχɔsi
mleiddiau	mlei̯ðjaɨ̯
chynhadledd	χənhadlɛð
pedwaredd	pɛdwarɛð
trefedigaeth	trɛvɛdɪɡaɨ̯θ
hyn oll	hɨ̞noːɬ
drysle	drəslɛ
cyfarchol	kəvarχɔl
telynau	tɛlənɛ
puteindy	pɨ̞tei̯ndɨ
epidemigau	ɛpɪdɛmɪɡaɨ̯
rhyw	r̥ɨ̞u̯
beth	beːθ
phortiwgal	fɔrtjʊɡal
allfudo	aɬvɨ̞dɔ
canolog	kanɔlɔɡ
gwlith	ɡwliːθ
ceffyl	kɛfɨ̞l
seiclwr	sei̯klʊr
llygaid	ɬɨ̞ɡɛd
gnawn	ɡnau̯n
clod	kloːd
to bach	toːbaːχ
rhuthro	r̥ɨ̞θrɔ
randibŵ	randɪbuː
nhywyll	n̥əu̯ɨ̞ɬ
fair	vai̯r
loncian	lɔŋkjan
cod	koːd
boneddiges	bɔnɛðɪɡɛs
cysgu	kəsɡɨ
cathbysgod	kaθbəsɡɔd
lludw	ɬɨ̞du
llythrennu	ɬəθrɛnɨ
cyfatebiaeth	kəvatɛbjɛθ
ngwybodaeth	ŋwəbɔdaɨ̯θ
traethawd	treɨ̯θau̯d
mhyliau	m̥əljaɨ̯
gwers	ɡwɛrs
tyngu	təŋɨ
adflas	advlas
picau bach	pɪkɛbaːχ
abadau	abada
tenau	tɛna
rhyfeddu	r̥əvɛðɨ
llinynnau	ɬɪnəna
rwmania	rʊmanja
beidr	bei̯dr
pyglyd	pəɡlɨ̞d
i gyd	ɪɡiːd
afreolaidd	avrɛɔlai̯ð
chwympo	χwɨmpɔ
athematig	aθɛmatɪɡ
wybod	wɨ̞bɔd
clybiau	kləbjaɨ̯
iau	jaɨ̯
nghad	ŋ̊aːd
roeddech	rɔɨ̯ðaχ
erchyll	ɛrχɨ̞ɬ
adferiadau	advɛrjadaɨ̯
treigladau	treiɡljada
tanau gwyllt	tanɛɡwɨːɬd
mhigwrn	m̥ɪɡʊrn
nos sadwrn	noːssadʊn
cyflogaeth	kəvlɔɡɛθ
cilbost	kɪlbɔst
cheir	χei̯r
rhywbeth	r̥ɨu̯baθ
nharian	n̥arjan
barbeciwiau	barbɛkɪu̯jɛ
wres	wreːs
mynegi	mənɛɡi
adroddaf	adrɔðav
pau	paɨ̯
wythnos	ʊɨ̯θnɔs
nghenhinen	ŋ̊ɛnhɪnɛn
morio	mɔrjɔ
mhei	m̥ei
torchau	tɔrχaɨ̯
barod	barɔd
rheiddiadur	r̥ei̯ðjadɨ̞r
aneiriol	anei̯rjɔl
brenin	brɛnɪn
anableddau	anablɛða
tegan	tɛɡan
pheidio	feidjɔ
wledydd	wlɛdɨ̞ð
sâl	saːl
stwrsiwn	sdʊrʃʊn
teisen	tei̯san
atebaf	atɛba
maint	mai̯nt
adborthion	adbɔrθjɔn
derbynnydd	dɛrbənɪð
achwynwyr	aχʊɨ̯nwɨ̞r
nid wrth ei big y mae mesur cyffylog	nɪdʊrθibiːɡəmamɛsɨ̞rkəfəlɔɡ
olifau	ɔlɪvɛ
gwyddel	ɡʊɨ̯ðɛl
cyfamodi	kəvamɔdi
cyfrifiad	kəvrɪvjad
mae	ma
pedrongl	pɛdrɔŋl
cwpwrdd	kʊpʊrð
arwain	arwɛn
achlod	aχlɔd
cytuno	kətɨ̞nɔ
unedau	ɨ̞nɛdɛ
pwy dach chi	puːɨ̯daχiː
unan	ɨ̞nan
cop	kɔp
gawl	ɡau̯l
pesychu	pɛsəχɨ
chwefror	χwɛvrɔr
llwynog	ɬʊɨ̯nɔɡ
cnoi	knɔi̯
bwgan	bʊɡan
le	leː
cywyddau	kəwəðɛ
cyfanswm	kəvansʊm
choed	χoːɨ̯d
iddewon	ɪðɛu̯ɔn
achyddol	aχəðɔl
deiliadaeth	dei̯ljadɛθ
pinafal	pɪnaval
anghydwelediad	aŋhɨ̞dwɛlɛdjad
gweithredu	ɡwei̯θrɛdɨ
ngolau	ŋɔlaɨ̯
'th	θ
edrych	ɛdraχ
un ar bymtheg	ɨːnarbəmθaɡ
tawl	tau̯l
ddwywaith	ðʊɨ̯wɛθ
èg	ɛɡ
selerau	sɛlɛraɨ̯
fore	vɔra
llythyr	ɬəθɨ̞r
nghneuen	ŋ̊neɨ̯ɛn
hirsgwarau	hɪrsɡwarɛ
prys	prɨːs
chawl	χau̯l
ciciau adlam	kikjaadlam
teisen	tɪʃɛn
cartref	kartrɛv
peiriannau llungopïo	pei̯rjanaɬɨːŋɡɔpiːɔ
disgyn	dɪsɡɪn
dyffryn	dəfrɨ̞n
llundain	ɬɨ̞ndan
ogwr	ɔɡʊr
ieithyddion	jei̯θəðjɔn
dynleiddiaid	dɨːnlei̯ðjai̯d
marnau	marnaɨ̯
unigrywiaeth	ɨ̞nɪɡrɨ̞u̯jaɨ̯θ
helwr	hɛlʊr
gŵr	ɡuːr
cach	kaːχ
delais	dɛlai̯s
rŵan	ruːan
eddy	ɛðɨ̞
gach	ɡaːχ
casgen	kasɡɛn
tuag	tɨːaɡ
camau	kama
ngwŷdd	ŋwɨːð
ysgrifen	sɡrɪvɛn
chefnau	χɛvna
canol	kanɔl
gwisg	ɡwiːsɡ
brydain	brədai̯n
blogio	blɔɡjɔ
wal	wal
daliff	dalɪf
thrwydded	θrʊɨ̯ðɛd
atsain	atsai̯n
llungopïau	ɬɨːŋɡɔpiːɛ
mhib	m̥iːb
sefydlog	sɛvədlɔɡ
corfflu	kɔrflɨ
brawychiadau	brau̯əχjada
gaffent	ɡafɛnt
garais	ɡarai̯s
cyflogaeth	kəvlɔɡaɨ̯θ
dyrchaif	dərχai̯v
boenen	bɔɨ̯nɛn
chyfreithiwr	χəvrei̯θjʊr
rydw i'n dy garu di	rədwindəɡaːridiː
cynghrair	kəŋr̥ɛr
ffwciaf	fʊkjav
coelcerth	kɔɨ̯lkɛrθ
dadlau	dadlɛ
syml	sɨ̞ml
nglaned	ŋlanɛd
nghegin	ŋ̊ɛɡɪn
fol	vɔl
mwy	muːɨ̯
gwyn	ɡwɨ̞n
recríwt	rɛkrɪu̯t
mwyeilch	muɨ̯ei̯lχ
tawdd	tau̯ð
chacen	χakɛn
biau	biːa
ddeng	ðeːŋ
plismones	plismɔnɛs
