ও	oː
এই	ˌei
এর	ˌeɾ
এ	e
এক	ˈek
পর	pˈɔɾ
একজন	ækɟˈɔn
বছর	bˈɔt͡ʃʰɔɾ
হল	hˈɔl
উপর	ˌupɔɾ
জন	ɟˈɔn
আর	ˌaɾ
তখন	tˈɔkʰɔn
একই	ˈekɔˌi
যখন	d͡ʒˈɔkʰɔn
আরও	ˈaɾɔˌoː
দল	dˈɔl
এরপর	ˈeɾɔpˌɔɾ
হন	hˈɔn
মত	mˈɔto
এমন	ˈemɔn
সকল	ʃˈɔkɔl
অফ	ˈɔf
সহ	ʃˈɔho
কম	kˈɔm
অব	ˈɔb
ঐ	ˈoj
শহর	ʃˈɔhɔɾ
সব	ʃˈɔb
গঠন	ɡˈɔʈʰɔn
আইন	ˈain
এখন	ˈekʰɔn
ওপর	ˈoːpɔɾ
দখল	dˈɔkʰɔl
বই	bˈoi
একক	ˈekɔk
সদর	ʃˈɔdɔɾ
র	ɾˈɔ
কখনও	kˈɔkʰɔnˌɔoː
এম	ˈem
হত	hˈɔto
সফল	ʃˈɔfɔl
আল	ˈal
বল	bˈɔl
অবসর	ˈɔbɔʃˌɔɾ
এখনও	ˈekʰɔnˌɔoː
পথ	pˈɔtʰ
আরব	ˈaɾɔb
ভবন	bʰˈɔbɔn
উৎস	ˈutʃɔ
এসব	ˈeʃɔb
ওই	ˈoːi
জল	ɟˈɔl
of	(͡e͡n)ɒv(͡b͡n)
আসন	ˈaʃɔn
বহন	bˈɔhɔn
আহত	ˈahɔtˌo
রঙ	ɾˈɔŋ
এস	ˈeʃ
দশ	dˈɔʃ
পদক	pˈɔdɔk
পদ	pˈɔd
অপর	ˈɔpɔɾ
ই	hɾˌɔʃʃoˈi
ইন	ˈin
একর	ˈekɔɾ
তম	tˈɔm
দশক	dˈɔʃɔk
ফল	fˈɔl
ঘন	ɡʰˈɔn
ফর	fˈɔɾ
উৎসব	ˈutʃɔb
গমন	ɡˈɔmɔn
আট	ˈaʈ
রকম	ɾˈokɔm
করত	kˈɔɾɔtˌo
নগর	nˈɔɡɔɾ
আজ	ˈaɟ
হক	hˈɔk
আই	ˈai
সহজ	ʃˈɔhɔɟ
খরচ	kʰˈɔɾɔt͡ʃ
খবর	kʰˈɔbɔɾ
আচরণ	ˈat͡ʃɔɾˌɔn
তরল	tˈɔɾɔl
এল	ˈel
সফর	ʃˈɔfɔɾ
ঘর	ɡʰˈɔɾ
ওজন	ˈoːɟɔn
আসল	ˈaʃɔl
and	(͡e͡n)and(͡b͡n)
কর	kˈɔɾ
আগ	ˈaɡ
The	(͡e͡n)ðə(͡b͡n)
আউট	ˈauʈ
এরকম	ˈeɾɔkˌɔm
বন	bˈɔn
ভর	bʰˈɔɾ
the	(͡e͡n)ðə(͡b͡n)
টন	ʈˈɔn
শত	ʃˈɔto
আহমদ	ˈahɔmˌɔd
আদম	ˈadɔm
গত	ɡˈɔto
পতন	pˈɔtɔn
মন	mˈɔn
দশম	dˈɔʃɔm
জনগণ	ɟˈɔnɔɡˌɔn
গরম	ɡˈɔɾɔm
ধরন	dʰˈɔɾɔn
আ	ˈa
শপথ	ʃˈɔpɔtʰ
এত	ˈæto
সমতল	ʃˈɔmɔtˌɔl
খনন	kʰˈɔnɔn
শতক	ʃˈɔtɔk
আগত	ˈaɡɔtˌo
ইউ	ˈiu
নবম	nˈɔbɔm
আজও	ˈaɟɔˌoː
এন	ˈen
পল	pˈɔl
এইচ	ˈeit͡ʃ
আগমন	ˈaɡɔmˌɔn
দমন	dˈɔmɔn
একদল	ˈekɔdˌɔl
ফসল	fˈɔʃɔl
অন	ˈɔn
হযরত	hˈɔd͡ʒɔɾˌɔto
ঔষধ	ˈowʃɔdʰ
রক	ɾˈɔk
নজর	nˈɔɟɔɾ
সরল	ʃˈɔɾɔl
লস	lˈɔʃ
কমই	kˈɔmɔˌi
আটক	ˈaʈɔk
চরম	t͡ʃˈɔɾɔm
যত	d͡ʒˈɔto
রস	ɾˈɔʃ
ঋণ	ɾˈin
পরপরই	pˈɔɾɔpˌɔɾɔˌi
পরই	pˈɔɾɔˌi
তখনই	tˈɔkʰɔnˌɔi
পরও	pˈɔɾɔˌoː
তখনও	tˈɔkʰɔnˌɔoː
in	(͡e͡n)ˈɪn(͡b͡n)
অবতরণ	ˈɔbɔtˌɔɾɔn
ইউএস	ˈiuˌeʃ
এইসব	ˈeiʃˌɔb
এরও	ˈeɾɔˌoː
ইট	ˈiʈ
এফ	ˈef
আলম	ˈalɔm
উপকরণ	ˈupɔkˌɔɾɔn
লবণ	lˈɔbɔn
বছরই	bˈɔt͡ʃʰɔɾˌɔi
বরফ	bˈɔɾɔf
পরম	pˈɔɾɔm
অল	ˈɔl
A	(͡e͡n)ˈe͡ɪ(͡b͡n)
দফতর	dˈɔfɔtˌɔɾ
মতই	mˈɔtɔˌi
পরপর	pˈɔɾɔpˌɔɾ
নরম	nˈɔɾɔm
অসম	ˈɔʃɔm
সৎ	ʃˈɔt
বৎসর	bˈɔtʃɔɾ
এরই	ˈeɾɔˌi
আপ	ˈap
ইবন	ˈibɔn
গণ	ɡˈɔn
বরণ	bˈɔɾɔn
কবর	kˈɔbɔɾ
কল	kˈɔl
একমত	ˈekɔmˌɔto
জনক	ɟˈɔnɔk
অথচ	ˈɔːtʰocˌo
অপহরণ	ˈɔpɔhˌɔɾɔn
নকল	nˈɔkɔl
কত	kˈɔto
এসকল	ˈeʃɔkˌɔl
আকবর	ˈakɔbˌɔɾ
ভন	bʰˈɔn
কখনই	kˈɔkʰɔnˌɔi
ডন	ɖˈɔn
টম	ʈˈɔm
জগৎ	ɟˈɔɡɔt
মঠ	mˈɔʈʰ
সবই	ʃˈɔbɔˌi
সনদ	ʃˈɔnɔd
এমএ	ˈemɔˌe
উমর	ˈumɔɾ
জনসন	ɟˈɔnɔʃˌɔn
নন	nˈɔn
অমর	ˈɔmɔɾ
একদম	ˈekɔdˌɔm
এও	ˈeoː
ল	lˈɔ
এসআর	ˈeʃɔˌaɾ
অতএব	ˈɔtɔˌeb
তত	tˈɔto
ফন	fˈɔn
মদ	mˈɔd
বকর	bˈɔkɔɾ
বর	bˈɔɾ
আম	ˈam
চর	t͡ʃˈɔɾ
de	(͡e͡n)də(͡b͡n)
আসর	ˈaʃɔɾ
তল	tˈɔl
ওমর	ˈoːmɔɾ
জলজ	ɟˈɔlɔɟ
গম	ɡˈɔm
বব	bˈɔb
আহরণ	ˈahɔɾˌɔn
নগদ	nˈɔɡɔd
উইথ	ˈuitʰ
করল	kˈɔɾɔl
৷	
পপ	pˈɔp
ক	kˈɔ
to	(͡e͡n)tuː(͡b͡n)
যমজ	d͡ʒˈɔmɔɟ
শট	ʃˈɔʈ
আপন	ˈapɔn
a	(͡e͡n)ˈe͡ɪ(͡b͡n)
অবগত	ˈɔbɔɡˌɔto
করণ	kˈɔɾɔn
সফররত	ʃˈɔfɔɾˌɔɾɔtˌo
x	(͡e͡n)ˈɛks(͡b͡n)
কমন	kˈɔmɔn
আরএনএ	ˈaɾɔˌenɔˌe
বদল	bˈɔdɔl
শ	tˌaleboʃʃˈɔ
সন	ʃˈɔn
সচল	ʃˈɔt͡ʃɔl
গজ	ɡˈɔɟ
নল	nˈɔl
Retrieved	(͡e͡n)ɹɪtɹˈiːvd(͡b͡n)
কখন	kˌɔkʰɔn
জজ	ɟˈɔɟ
ফলক	fˈɔlɔk
আবরণ	ˈabɔɾˌɔn
আজম	ˈaɟɔm
Press	(͡e͡n)pɹˈɛs(͡b͡n)
অভ	ˈɔbʰ
হট	hˈɔʈ
খ	kʰˈɔ
বধ	bˈɔdʰ
আইনগত	ˈainˌɔɡɔtˌo
উইলসন	ˈuilˌɔʃɔn
n	(͡e͡n)ˈɛn(͡b͡n)
ইজ	ˈiɟ
এজ	ˈeɟ
এমএস	ˈemɔˌeʃ
নব	nˈɔb
টক	ʈˈɔk
উইল	ˈuil
X	(͡e͡n)ˈɛks(͡b͡n)
আইস	ˈaiʃ
H	(͡e͡n)ˈe͡ɪt͡ʃ(͡b͡n)
New	(͡e͡n)njˈuː(͡b͡n)
on	(͡e͡n)ˈɒn(͡b͡n)
সফলতম	ʃˈɔfɔlˌɔtɔm
তরফ	tˈɔɾɔf
History	(͡e͡n)hˈɪstəɹi(͡b͡n)
আটজন	ˈaʈɔɟˌɔn
কলম	kˈɔlɔm
টপ	ʈˈɔp
টহল	ʈˈɔhɔl
দলগত	dˈɔlɔɡˌɔto
University	(͡e͡n)jˌuːnɪvˈɜːsɪti(͡b͡n)
উল	ˈul
এতই	ˈetɔˌi
pp	(͡e͡n)pˌiːpˈiː(͡b͡n)
মল	mˈɔl
by	(͡e͡n)bˈa͡ɪ(͡b͡n)
উপ	ˈup
আব	ˈab
আমর	ˈamɔɾ
মহল	mˈɔhɔl
India	(͡e͡n)ˈɪndiə(͡b͡n)
সহজতর	ʃˈɔhɔɟˌɔtɔɾ
ডট	ɖˈɔʈ
ফলন	fˈɔlɔn
যখনই	d͡ʒˈɔkʰɔnˌɔi
O	(͡e͡n)ˈə͡ʊ(͡b͡n)
for	(͡e͡n)fɔː(͡b͡n)
ডজন	ɖˈɔɟɔn
লক	lˈɔk
অর	ˈɔɾ
রসদ	ɾˈoʃɔd
কমল	kˈɔmɔl
এট	ˈeʈ
চল	t͡ʃˈɔl
এইডস	ˈeiɖˌɔʃ
I	(͡e͡n)ˈa͡ɪ(͡b͡n)
ডক	ɖˈɔk
মতন	mˈɔtɔn
page	(͡e͡n)pˈe͡ɪd͡ʒ(͡b͡n)
শন	ʃˈɔn
নট	nˈɔʈ
জনমত	ɟˈɔnɔmˌɔto
আস	ˈaʃ
জনপদ	ɟˈɔnɔpˌɔd
এফএম	ˈefɔˌem
C	(͡e͡n)sˈiː(͡b͡n)
দলই	dˈɔlɔˌi
একরকম	ˈekɔɾˌɔkɔm
রথ	ɾˈɔtʰ
মদন	mˈɔdɔn
রব	ɾˈɔb
অ	ˈɔː
একইরকম	ˈekɔˌiɾɔkˌɔm
রতন	ɾˈotɔn
ম	mˈɔ
II	(͡e͡n)ɹˌə͡ʊmən tˈuː(͡b͡n)
নদ	nˈɔd
পলল	pˈɔlɔl
কনডম	kˈɔnɔɖˌɔm
আমল	ˈamɔl
একশত	ˈekɔʃˌɔto
মহৎ	mˈɔhɔt
শরৎ	ʃˈɔɾɔt
আইনত	ˈainˌɔto
আচরণগত	ˈat͡ʃɔɾˌɔnɔɡˌɔto
চলক	t͡ʃˈɔlɔk
পশম	pˈɔʃɔm
বস	bˈɔʃ
রন	ɾˈɔn
B	(͡e͡n)bˈiː(͡b͡n)
এরপরই	ˈeɾɔpˌɔɾɔˌi
গজল	ɡˈɔɟɔl
নখ	nˈɔkʰ
N	(͡e͡n)ˈɛn(͡b͡n)
উই	ˈui
ড	ɖˈɔ
ইউএসএস	ˈiuˌeʃɔˌeʃ
বদর	bˈɔdɔɾ
Page	(͡e͡n)pˈe͡ɪd͡ʒ(͡b͡n)
আবহ	ˈabɔhˌo
কটন	kˈɔʈɔn
জগত	ɟˈɔɡɔtˌo
রড	ɾˈɔɖ
নটর	nˈɔʈɔɾ
আন	ˈan
উড	ˈuɖ
London	(͡e͡n)lˈʌndən(͡b͡n)
p	(͡e͡n)pˈiː(͡b͡n)
এমনই	ˈemɔnˌɔi
জলপথ	ɟˈɔlɔpˌɔtʰ
যশ	d͡ʒˈɔʃ
এড	ˈeɖ
দই	dˈoi
ফজল	fˈɔɟɔl
John	(͡e͡n)d͡ʒˈɒn(͡b͡n)
অনশন	ˈɔnɔʃˌɔn
আইএসও	ˈaiˌeʃɔˌoː
বলল	bˈɔlɔl
বহর	bˈɔhɔɾ
সস	ʃˈɔʃ
উট	ˈuʈ
করব	kˈɔɾɔb
সই	ʃˈoi
V	(͡e͡n)vˈiː(͡b͡n)
উপরও	ˈupɔɾˌɔoː
ডগ	ɖˈɔɡ
নকআউট	nˈɔkɔˌauʈ
ফটক	fˈɔʈɔk
হজম	hˈɔɟɔm
হজরত	hˈɔɟɔɾˌɔto
উভচর	ˈubʰɔt͡ʃˌɔɾ
এইরকম	ˈeiɾˌɔkɔm
তৎপর	tˈɔtpɔɾ
স	dˌonteʃʃˈɔ
আইকন	ˈaikˌɔn
এফএ	ˈefɔˌe
ওক	ˈoːk
রওশন	ɾˈooːʃˌɔn
আখ	ˈakʰ
ঈদ	ˈid
কদর	kˈɔdɔɾ
ততই	tˈɔtɔˌi
গ	ɡˈɔ
সহচর	ʃˈɔhɔt͡ʃˌɔɾ
অবনমন	ˈɔbɔnˌɔmɔn
কট	kˈɔʈ
ধন	dʰˈɔn
রদ	ɾˈɔd
শওকত	ʃˈɔoːkˌɔto
R	(͡e͡n)ˈɑː(͡b͡n)
or	(͡e͡n)ɔː(͡b͡n)
উ	hɾˌɔʃʃoˈu
জ	ɟˈɔ
মতলব	mˈɔtɔlˌɔb
হরর	hˈɔɾɔɾ
ওর	ˌoːɾ
গলফ	ɡˈɔlɔf
যতই	d͡ʒˈɔtɔˌi
Indian	(͡e͡n)ˈɪndi͡ən(͡b͡n)
National	(͡e͡n)nˈaʃənə͡l(͡b͡n)
আইএনএস	ˈaiˌenɔˌeʃ
আইল	ˈail
চরণ	t͡ʃˈɔɾɔn
শক	ʃˈɔk
Oxford	(͡e͡n)ˈɒksfəd(͡b͡n)
ছক	t͡ʃʰˈɔk
বলবৎ	bˈɔlɔbˌɔt
ঈগল	ˈiɡɔl
উদর	ˈudɔɾ
বউ	bˈou
World	(͡e͡n)wˈɜːld(͡b͡n)
et	(͡e͡n)ˈɛt(͡b͡n)
আইওএস	ˈaiˌoːeʃ
গড	ɡˈɔɖ
চক	t͡ʃˈɔk
থমসন	tʰˈɔmɔʃˌɔn
III	(͡e͡n)ɹˌə͡ʊmən θɹˈiː(͡b͡n)
এরপরও	ˈeɾɔpˌɔɾɔˌoː
দহন	dˈɔhɔn
সরণ	ʃˈɔɾɔn
অচল	ˈɔt͡ʃɔl
তপন	tˈɔpɔn
লন	lˈɔn
উঠল	ˈuʈʰɔl
উপরই	ˈupɔɾˌɔi
একশ	ˈekɔʃ
বপন	bˈɔpɔn
E	(͡e͡n)ˈiː(͡b͡n)
আসত	ˈaʃɔtˌo
CO	(͡e͡n)kˈə͡ʊ(͡b͡n)
চলন	t͡ʃˈɔlɔn
দশজন	dˈɔʃɔɟˌɔn
অসফল	ˈɔʃɔfˌɔl
ওম	ˈoːm
গঠনগত	ɡˈɔʈʰɔnˌɔɡɔtˌo
জনবল	ɟˈɔnɔbˌɔl
রউফ	ɾˈouf
P	(͡e͡n)pˈiː(͡b͡n)
S	(͡e͡n)ˈɛs(͡b͡n)
ইইউ	ˈiiˌu
একবছর	ˈekɔbˌɔt͡ʃʰɔɾ
ন	dˌontennˈɔ
মগ	mˈɔɡ
Dictionary	(͡e͡n)dˈɪkʃənəɹi(͡b͡n)
জখম	ɟˈɔkʰɔm
মৎস	mˈɔtʃɔ
রত	ɾˈoto
রহমত	ɾˈohɔmˌɔto
এডউইন	ˈeɖɔˌuin
ভরত	bʰˈɔɾɔtˌo
সবল	ʃˈɔbɔl
অলস	ˈɔlɔʃ
ওএস	ˈoːeʃ
জনন	ɟˈɔnɔn
ধর	dʰˈɔɾ
নরক	nˈɔɾɔk
পট	pˈɔʈ
সম	ʃˈɔm
অমল	ˈɔmɔl
ঐসব	ˈojʃɔb
করন	kˈɔɾɔn
খল	kʰˈɔl
ঝলক	ɟʰˈɔlɔk
হরণ	hˈɔɾɔn
Journal	(͡e͡n)d͡ʒˈɜːnə͡l(͡b͡n)
অনবরত	ˈɔnɔbˌɔɾɔtˌo
বচন	bˈɔt͡ʃɔn
বসত	bˈɔʃɔtˌo
লখনউ	lˈɔkʰɔnˌɔu
লবন	lˈɔbɔn
International	(͡e͡n)ˌɪntənˈaʃənə͡l(͡b͡n)
K	(͡e͡n)kˈe͡ɪ(͡b͡n)
la	(͡e͡n)lˌa(͡b͡n)
মটর	mˈɔʈɔɾ
ইনক	ˈinɔk
Volume	(͡e͡n)vˈɒljuːm(͡b͡n)
ইভ	ˈibʰ
উইক	ˈuik
এনএইচ	ˈenɔˌeit͡ʃ
Life	(͡e͡n)lˈa͡ɪf(͡b͡n)
War	(͡e͡n)wˈɔː(͡b͡n)
York	(͡e͡n)jˈɔːk(͡b͡n)
অবতল	ˈɔbɔtˌɔl
দর	dˈɔɾ
D	(͡e͡n)dˈiː(͡b͡n)
David	(͡e͡n)dˈe͡ɪvɪd(͡b͡n)
is	(͡e͡n)ɪz(͡b͡n)
m	(͡e͡n)ˈɛm(͡b͡n)
গল	ɡˈɔl
হরফ	hˈɔɾɔf
August	(͡e͡n)ˈɔːɡəst(͡b͡n)
M	(͡e͡n)ˈɛm(͡b͡n)
See	(͡e͡n)sˈiː(͡b͡n)
জব	ɟˈɔb
তলব	tˈɔlɔb
দলও	dˈɔlɔˌoː
সমর	ʃˈɔmɔɾ
English	(͡e͡n)ˈɪŋɡlɪʃ(͡b͡n)
r	(͡e͡n)ˈɑː(͡b͡n)
s	(͡e͡n)ˈɛs(͡b͡n)
ইউএসএ	ˈiuˌeʃɔˌe
দম	dˈɔm
বইও	bˈoiˌoː
বনজ	bˈɔnɔɟ
শপ	ʃˈɔp
হজ	hˈɔɟ
at	(͡e͡n)at(͡b͡n)
des	(͡e͡n)dˈɛs(͡b͡n)
অসৎ	ˈɔʃɔt
আদর	ˈadɔɾ
টড	ʈˈɔɖ
রহ	ɾˈoho
শখ	ʃˈɔkʰ
সরব	ʃˈɔɾɔb
অটল	ˈɔʈɔl
American	(͡e͡n)ɐmˈɛɹɪkən(͡b͡n)
k	(͡e͡n)kˈe͡ɪ(͡b͡n)
ইউএসএসআর	ˈiuˌeʃɔˌeʃɔˌaɾ
ইএমইউ	ˈiemˌɔiˌu
জপ	ɟˈɔp
ডবল	ɖˈɔbɔl
হর	hˈɔɾ
L	(͡e͡n)ˈɛl(͡b͡n)
as	(͡e͡n)az(͡b͡n)
q	(͡e͡n)kjˈuː(͡b͡n)
ঈষৎ	ˈiʃɔt
এমনও	ˈemɔnˌɔoː
ধরণ	dʰˈɔɾɔn
বট	bˈɔʈ
ভজন	bʰˈɔɟɔn
লগ	lˈɔɡ
Society	(͡e͡n)səsˈa͡ɪ͡əti(͡b͡n)
T	(͡e͡n)tˈiː(͡b͡n)
y	(͡e͡n)wˈa͡ɪ(͡b͡n)
উপশম	ˈupɔʃˌɔm
এইসকল	ˈeiʃˌɔkɔl
পণ	pˈɔn
রজব	ɾˈoɟɔb
রমন	ɾˈomɔn
শততম	ʃˈɔtɔtˌɔm
from	(͡e͡n)fɹɒm(͡b͡n)
ইউএন	ˈiuˌen
এমএলএ	ˈemɔˌelɔˌe
এসআই	ˈeʃɔˌai
বলত	bˈɔlɔtˌo
Islam	(͡e͡n)ɪslˈɑːm(͡b͡n)
January	(͡e͡n)d͡ʒˈanjuːəɹi(͡b͡n)
U	(͡e͡n)jˈuː(͡b͡n)
b	(͡e͡n)bˈiː(͡b͡n)
ইউর	ˈiuɾ
ইল	ˈil
একবচন	ˈekɔbˌɔt͡ʃɔn
দমদম	dˈɔmɔdˌɔm
Act	(͡e͡n)ˈakt(͡b͡n)
Book	(͡e͡n)bˈʊk(͡b͡n)
CH	(͡e͡n)sˌiːˈe͡ɪt͡ʃ(͡b͡n)
F	(͡e͡n)ˈɛf(͡b͡n)
অতপর	ˈɔtɔpˌɔɾ
এমআরএনএ	ˈemɔˌaɾɔˌenɔˌe
নক	nˈɔk
Bengal	(͡e͡n)bˌɛŋɡˈɔːl(͡b͡n)
De	(͡e͡n)də(͡b͡n)
June	(͡e͡n)d͡ʒˈuːn(͡b͡n)
Robert	(͡e͡n)ɹˈɒbət(͡b͡n)
c	(͡e͡n)sˈiː(͡b͡n)
এইচএমএস	ˈeit͡ʃˌɔemˌɔeʃ
লজ	lˈɔɟ
Great	(͡e͡n)ɡɹˈe͡ɪt(͡b͡n)
with	(͡e͡n)wɪð(͡b͡n)
ইমন	ˈimɔn
এসএস	ˈeʃɔˌeʃ
কথক	kˈɔtʰɔk
কনক	kˈɔnɔk
ফলস	fˈɔlɔʃ
Bangladesh	(͡e͡n)bˌaŋɡlɐdˈɛʃ(͡b͡n)
Times	(͡e͡n)tˈa͡ɪmz(͡b͡n)
আইডল	ˈaiɖˌɔl
উইচ	ˈuit͡ʃ
করম	kˈɔɾɔm
জনই	ɟˈɔnɔˌi
জন৷	ɟˈɔn
টস	ʈˈɔʃ
মথ	mˈɔtʰ
হও	hˈɔoː
William	(͡e͡n)wˈɪli͡əm(͡b͡n)
f	(͡e͡n)ˈɛf(͡b͡n)
এমএনএ	ˈemɔˌenɔˌe
কদম	kˈɔdɔm
করদ	kˈɔɾɔd
চলত	t͡ʃˈɔlɔtˌo
জমজ	ɟˈɔmɔɟ
পচন	pˈɔt͡ʃɔn
Cambridge	(͡e͡n)kˈe͡ɪmbɹɪd͡ʒ(͡b͡n)
November	(͡e͡n)nə͡ʊvˈɛmbə(͡b͡n)
আইএ	ˈaiˌe
এইড	ˈeiɖ
এসএএস	ˈeʃɔˌeeʃ
জলচর	ɟˈɔlɔt͡ʃˌɔɾ
থর	tʰˈɔɾ
নর	nˈɔɾ
পবন	pˈɔbɔn
বরন	bˈɔɾɔn
Books	(͡e͡n)bˈʊks(͡b͡n)
Encyclopedia	(͡e͡n)ɛnsˌa͡ɪklə͡ʊpˈiːdi͡ə(͡b͡n)
e	(͡e͡n)ˈiː(͡b͡n)
pH	(͡e͡n)pˈiː ˈe͡ɪt͡ʃ(͡b͡n)
ইষদ	ˈiʃɔd
উইন	ˈuin
ফলত	fˈɔlɔtˌo
সহগ	ʃˈɔhɔɡ
ইটন	ˈiʈɔn
উডস	ˈuɖɔʃ
এআই	ˈeaˌi
কবল	kˈɔbɔl
ডস	ɖˈɔʃ
ফরজ	fˈɔɾɔɟ
বরকত	bˈɔɾɔkˌɔto
April	(͡e͡n)ˈe͡ɪpɹə͡l(͡b͡n)
Research	(͡e͡n)ɹɪsˈɜːt͡ʃ(͡b͡n)
State	(͡e͡n)stˈe͡ɪt(͡b͡n)
অউর	ˈouɾ
আমন	ˈamɔn
জনস	ɟˈɔnɔʃ
ডম	ɖˈɔm
হপ	hˈɔp
July	(͡e͡n)d͡ʒuːlˈa͡ɪ(͡b͡n)
On	(͡e͡n)ˈɒn(͡b͡n)
Q	(͡e͡n)kjˈuː(͡b͡n)
আরউইন	ˈaɾɔˌuin
আরএসএস	ˈaɾɔˌeʃɔˌeʃ
আশ	ˈaʃ
এএম	ˈeem
এখনই	ˈekʰɔnˌɔi
কসম	kˈɔʃɔm
গন	ɡˈɔn
গলন	ɡˈɔlɔn
দশরথ	dˈɔʃɔɾˌɔtʰ
লট	lˈɔʈ
সবরকম	ʃˈɔːbɾˌɔːkom
হলও	hˈɔlɔˌoː
G	(͡e͡n)d͡ʒˈiː(͡b͡n)
Paul	(͡e͡n)pˈɔːl(͡b͡n)
Z	(͡e͡n)zˈɛd(͡b͡n)
আরএসএ	ˈaɾɔˌeʃɔˌe
ইওর	ˈioːɾ
দমকল	dˈɔmɔkˌɔl
বজবজ	bˈɔɟɔbˌɔɟ
Ancient	(͡e͡n)ˈe͡ɪnʃənt(͡b͡n)
December	(͡e͡n)dɪsˈɛmbə(͡b͡n)
In	(͡e͡n)ˈɪn(͡b͡n)
La	(͡e͡n)lˌa(͡b͡n)
May	(͡e͡n)mˈe͡ɪ(͡b͡n)
অপশন	ˈɔpɔʃˌɔn
আযম	ˈad͡ʒɔm
আরএএফ	ˈaɾɔˌeef
উপশহর	ˈupɔʃˌɔhɔɾ
এইট	ˈeiʈ
একশন	ˈekɔʃˌɔn
এমএমএ	ˈemɔˌemɔˌe
নখর	nˈɔkʰɔɾ
মই	mˈoi
মণ	mˈɔn
সফট	ʃˈɔfɔʈ
হবস	hˈɔbɔʃ
Association	(͡e͡n)ɐsˌə͡ʊsɪˈe͡ɪʃən(͡b͡n)
der	(͡e͡n)dˈe͡ə(͡b͡n)
আজমল	ˈaɟɔmˌɔl
উপদল	ˈupɔdˌɔl
কড	kˈɔɖ
জওহর	ɟˈɔoːhˌɔɾ
জবস	ɟˈɔbɔʃ
নই	nˈoi
রজত	ɾˈoɟɔtˌo
শবনম	ʃˈɔbɔnˌɔm
James	(͡e͡n)d͡ʒˈe͡ɪmz(͡b͡n)
Richard	(͡e͡n)ɹˈɪt͡ʃəd(͡b͡n)
United	(͡e͡n)juːnˈa͡ɪtɪd(͡b͡n)
du	(͡e͡n)dˈuː(͡b͡n)
এসএমএস	ˈeʃɔˌemɔˌeʃ
ককবরক	kˈɔkɔbˌɔɾɔk
ঘটক	ɡʰˈɔʈɔk
Delhi	(͡e͡n)dˈɛli(͡b͡n)
Institute	(͡e͡n)ˈɪnstɪtjˌuːt(͡b͡n)
d	(͡e͡n)dˈiː(͡b͡n)
i	(͡e͡n)ˈa͡ɪ(͡b͡n)
আবদ	ˈabɔd
একদমই	ˈekɔdˌɔmɔˌi
কলস	kˈɔlɔʃ
ঘনঘন	ɡʰˈɔnɔɡʰˌɔn
চ	t͡ʃˈɔ
ব	bˈɔ
বক	bˈɔk
যম	d͡ʒˈɔm
হই	hˈoi
Le	(͡e͡n)lə(͡b͡n)
School	(͡e͡n)skˈuːl(͡b͡n)
an	(͡e͡n)an(͡b͡n)
edition	(͡e͡n)ɪdˈɪʃən(͡b͡n)
t	(͡e͡n)tˈiː(͡b͡n)
u	(͡e͡n)jˈuː(͡b͡n)
অই	ˈoi
আইআইএম	ˈaiˌaiˌem
আজব	ˈaɟɔb
ইশক	ˈiʃɔk
কতজন	kˈɔtɔɟˌɔn
চমক	t͡ʃˈɔmɔk
মম	mˈɔm
মহরত	mˈɔhɔɾˌɔto
শহরও	ʃˈɔhɔɾˌɔoː
October	(͡e͡n)ɒktˈə͡ʊbə(͡b͡n)
System	(͡e͡n)sˈɪstəm(͡b͡n)
Vol	(͡e͡n)vˈɒl(͡b͡n)
আচরন	ˈat͡ʃɔɾˌɔn
উন	ˈun
এরকমই	ˈeɾɔkˌɔmɔˌi
ত	tˈɔ
দলসহ	dˈɔlɔʃˌɔho
ধস	dʰˈɔʃ
মগধ	mˈɔɡɔdʰ
মস	mˈɔʃ
যব	d͡ʒˈɔb
লব	lˈɔb
Art	(͡e͡n)ˈɑːt(͡b͡n)
Chapter	(͡e͡n)t͡ʃˈaptə(͡b͡n)
DNA	(͡e͡n)dˌiːˌɛnˈe͡ɪ(͡b͡n)
Empire	(͡e͡n)ˈɛmpa͡ɪ͡ə(͡b͡n)
J	(͡e͡n)d͡ʒˈe͡ɪ(͡b͡n)
Law	(͡e͡n)lˈɔː(͡b͡n)
Lemmon	(͡e͡n)lˈɛmən(͡b͡n)
March	(͡e͡n)mˈɑːt͡ʃ(͡b͡n)
Y	(͡e͡n)wˈa͡ɪ(͡b͡n)
see	(͡e͡n)sˈiː(͡b͡n)
অবতরন	ˈɔbɔtˌɔɾɔn
আগম	ˈaɡɔm
আদল	ˈadɔl
আধ	ˈadʰ
আপস	ˈapɔʃ
একট	ˈekɔʈ
ওন	ˈoːn
গদর	ɡˈɔdɔɾ
টলন	ʈˈɔlɔn
নত	nˈɔto
হইল	hˈoil
Language	(͡e͡n)lˈaŋɡwɪd͡ʒ(͡b͡n)
My	(͡e͡n)mˈa͡ɪ(͡b͡n)
Theory	(͡e͡n)θˈi͡əɹi(͡b͡n)
WHO	(͡e͡n)hˈuː(͡b͡n)
West	(͡e͡n)wˈɛst(͡b͡n)
Women	(͡e͡n)wˈɪmɪn(͡b͡n)
h	(͡e͡n)ˈe͡ɪt͡ʃ(͡b͡n)
system	(͡e͡n)sˈɪstəm(͡b͡n)
আওস	ˈaoːʃ
ইলম	ˈilɔm
উৎকল	ˈutkɔl
এনএ	ˈenɔˌe
এসএ	ˈeʃɔˌe
তৎসম	tˈɔtʃɔm
মকর	mˈɔkɔɾ
শতশত	ʃˈɔtɔʃˌɔto
শরবত	ʃˈɔɾɔbˌɔto
সল	ʃˈɔl
An	(͡e͡n)an(͡b͡n)
Charles	(͡e͡n)t͡ʃˈɑːlz(͡b͡n)
Group	(͡e͡n)ɡɹˈuːp(͡b͡n)
Michael	(͡e͡n)mˈa͡ɪkə͡l(͡b͡n)
No	(͡e͡n)nˈə͡ʊ(͡b͡n)
PNG	(͡e͡n)pˌiːˌɛnd͡ʒˈiː(͡b͡n)
Royal	(͡e͡n)ɹˈɔ͡ɪə͡l(͡b͡n)
States	(͡e͡n)stˈe͡ɪts(͡b͡n)
Streeton	(͡e͡n)stɹˈiːtən(͡b͡n)
al	(͡e͡n)ˈal(͡b͡n)
g	(͡e͡n)d͡ʒˈiː(͡b͡n)
অদলবদল	ˈɔdɔlˌɔbɔdˌɔl
আগমণ	ˈaɡɔmˌɔn
আনত	ˈanɔtˌo
উলফ	ˈulɔf
এনএফএল	ˈenɔˌefɔˌel
ওহ	ˈoːho
কসরত	kˈɔʃɔɾˌɔto
বৎ	bˈɔt
রইল	ɾˈoil
College	(͡e͡n)kˈɒlɪd͡ʒ(͡b͡n)
George	(͡e͡n)d͡ʒˈɔːd͡ʒ(͡b͡n)
Muslim	(͡e͡n)mˈʊzlɪm(͡b͡n)
W	(͡e͡n)dˈʌbə͡ljˌuː(͡b͡n)
pages	(͡e͡n)pˈe͡ɪd͡ʒɪz(͡b͡n)
আইএএফ	ˈaiˌeef
আসফ	ˈaʃɔf
এএসআই	ˈeeʃˌɔaˌi
প	pˈɔ
ভগত	bʰˈɔɡɔtˌo
Calcutta	(͡e͡n)kalkˈʌtə(͡b͡n)
Cricket	(͡e͡n)kɹˈɪkɪt(͡b͡n)
From	(͡e͡n)fɹɒm(͡b͡n)
Haigh	(͡e͡n)hˈe͡ɪɡ(͡b͡n)
IV	(͡e͡n)ɹˌə͡ʊmən fˈɔː(͡b͡n)
Modern	(͡e͡n)mˈɒdən(͡b͡n)
Penguin	(͡e͡n)pˈɛŋɡwɪn(͡b͡n)
Publishing	(͡e͡n)pˈʌblɪʃɪŋ(͡b͡n)
SO	(͡e͡n)sˈə͡ʊ(͡b͡n)
Science	(͡e͡n)sˈa͡ɪ͡əns(͡b͡n)
September	(͡e͡n)sɛptˈɛmbə(͡b͡n)
White	(͡e͡n)wˈa͡ɪt(͡b͡n)
theory	(͡e͡n)θˈi͡əɹi(͡b͡n)
z	(͡e͡n)zˈɛd(͡b͡n)
আইইইই	ˈaiˌiiˌi
আইএসএসএন	ˈaiˌeʃɔˌeʃɔˌen
উৎপল	ˈutpɔl
এরর	ˈeɾɔɾ
ওপরও	ˈoːpɔɾˌɔoː
গণকবর	ɡˈɔnɔkˌɔbɔɾ
ধরম	dʰˈɔɾɔm
রইস	ɾˈoiʃ
রজন	ɾˈoɟɔn
হ	hˈɔ
হকসহ	hˈɔkɔʃˌɔho
Asia	(͡e͡n)ˈe͡ɪʃə(͡b͡n)
British	(͡e͡n)bɹˈɪtɪʃ(͡b͡n)
By	(͡e͡n)bˈa͡ɪ(͡b͡n)
Council	(͡e͡n)kˈa͡ʊnsə͡l(͡b͡n)
Die	(͡e͡n)dˈa͡ɪ(͡b͡n)
East	(͡e͡n)ˈiːst(͡b͡n)
Historical	(͡e͡n)hɪstˈɒɹɪkə͡l(͡b͡n)
আউশ	ˈauʃ
আবরন	ˈabɔɾˌɔn
আলবদর	ˈalɔbˌɔdɔɾ
উঠত	ˈuʈʰɔtˌo
উর	ˈuɾ
এএস	ˈeeʃ
এটন	ˈeʈɔn
এব	ˈeb
কই	kˈoi
ঘ	ɡʰˈɔ
ঘট	ɡʰˈɔʈ
ঘনক	ɡʰˈɔnɔk
দ	dˈɔ
দলবল	dˈɔlɔbˌɔl
পঠন	pˈɔʈʰɔn
বছরও	bˈɔt͡ʃʰɔɾˌɔoː
সহজতম	ʃˈɔhɔɟˌɔtɔm
Accessed	(͡e͡n)ˈaksɛst(͡b͡n)
Army	(͡e͡n)ˈɑːmi(͡b͡n)
City	(͡e͡n)sˈɪti(͡b͡n)
Cl	(͡e͡n)sˌiːˈɛl(͡b͡n)
Cobb	(͡e͡n)kˈɒb(͡b͡n)
General	(͡e͡n)d͡ʒˈɛnəɹə͡l(͡b͡n)
Human	(͡e͡n)hjˈuːmən(͡b͡n)
Osprey	(͡e͡n)ˈɒspɹi(͡b͡n)
Peter	(͡e͡n)pˈiːtə(͡b͡n)
no	(͡e͡n)nˈə͡ʊ(͡b͡n)
v	(͡e͡n)vˈiː(͡b͡n)
van	(͡e͡n)vˈan(͡b͡n)
β	(͡e͡l)vˈita(͡b͡n)
π	(͡e͡l)pˈi(͡b͡n)
আইএনএ	ˈaiˌenɔˌe
ইএমআই	ˈiemˌɔaˌi
ইস	ˈiʃ
এইস	ˈeiʃ
এমএম	ˈemɔˌem
এমএল	ˈemɔˌel
এসএম	ˈeʃɔˌem
কন	kˈɔn
ঙ	ˈuŋɡɔ̃
জমজম	ɟˈɔmɔɟˌɔm
জহর	ɟˈɔhɔɾ
ডটকম	ɖˈɔʈɔkˌɔm
পলস	pˈɔlɔʃ
রণ	ɾˈɔn
রদবদল	ɾˈodɔbˌɔdɔl
রম	ɾˈɔm
সজল	ʃˈɔɟɔl
Assam	(͡e͡n)ɑːsˈɑːm(͡b͡n)
Company	(͡e͡n)kˈʌmpəni(͡b͡n)
House	(͡e͡n)hˈa͡ʊs(͡b͡n)
Louis	(͡e͡n)lˈuːi(͡b͡n)
NH	(͡e͡n)ˌɛnˈe͡ɪt͡ʃ(͡b͡n)
Na	(͡e͡n)nˈɑː(͡b͡n)
Nature	(͡e͡n)nˈe͡ɪt͡ʃə(͡b͡n)
Routledge	(͡e͡n)ɹˈa͡ʊtə͡ld͡ʒ(͡b͡n)
South	(͡e͡n)sˈa͡ʊθ(͡b͡n)
Thomas	(͡e͡n)tˈɒməs(͡b͡n)
ed	(͡e͡n)ˈɛd(͡b͡n)
pg	(͡e͡n)pˌiːd͡ʒˈiː(͡b͡n)
আইআর	ˈaiˌaɾ
আইএএএফ	ˈaiˌeeˌef
আইএমএফ	ˈaiˌemɔˌef
আইএসএসএফ	ˈaiˌeʃɔˌeʃɔˌef
ইউএফও	ˈiuˌefɔˌoː
উইলস	ˈuilˌɔʃ
ঊষর	ˈuʃɔɾ
এএআই	ˈeeˌai
এমআরআই	ˈemɔˌaɾɔˌai
ওপরই	ˈoːpɔɾˌɔi
কক	kˈɔk
কখনওই	kˈɔkʰɔnˌɔoːˌi
কতক	kˈɔtɔk
টমসন	ʈˈɔmɔʃˌɔn
ঢপ	ɖʰˈɔp
ধলই	dʰˈɔlɔˌi
নও	nˈɔoː
নফল	nˈɔfɔl
ফরম	fˈɔɾɔm
বদন	bˈɔdɔn
বম	bˈɔm
সরস	ʃˈɔɾɔʃ
Green	(͡e͡n)ɡɹˈiːn(͡b͡n)
Man	(͡e͡n)mˈan(͡b͡n)
Martin	(͡e͡n)mˈɑːtɪn(͡b͡n)
One	(͡e͡n)wˈɒn(͡b͡n)
Pakistan	(͡e͡n)pˌakɪstˈɑːn(͡b͡n)
Political	(͡e͡n)pəlˈɪtɪkə͡l(͡b͡n)
Publications	(͡e͡n)pˌʌblɪkˈe͡ɪʃənz(͡b͡n)
Story	(͡e͡n)stˈɔːɹi(͡b͡n)
base	(͡e͡n)bˈe͡ɪs(͡b͡n)
α	(͡e͡l)ˈalfa(͡b͡n)
অজ	ˈɔɟ
আইএস	ˈaiˌeʃ
আদ	ˈad
উইশ	ˈuiʃ
এইমস	ˈeimˌɔʃ
এডলফ	ˈeɖɔlˌɔf
এমএলএম	ˈemɔˌelɔˌem
কলহ	kˈɔlɔhˌo
জট	ɟˈɔʈ
টর	ʈˈɔɾ
শরণ	ʃˈɔɾɔn
সনম	ʃˈɔnɔm
সরফ	ʃˈɔɾɔf
Education	(͡e͡n)ˌɛd͡ʒuːkˈe͡ɪʃən(͡b͡n)
Encyclopaedia	(͡e͡n)ɛnsˌa͡ɪkləpˈiːdi͡ə(͡b͡n)
February	(͡e͡n)fˈɛbɹuːəɹi(͡b͡n)
High	(͡e͡n)hˈa͡ɪ(͡b͡n)
Introduction	(͡e͡n)ˌɪntɹədˈʌkʃən(͡b͡n)
Islamic	(͡e͡n)ɪslˈɑːmɪk(͡b͡n)
LDL	(͡e͡n)ˌɛldˌiːˈɛl(͡b͡n)
Muhammad	(͡e͡n)məhˈamɪd(͡b͡n)
Power	(͡e͡n)pˈa͡ʊə(͡b͡n)
San	(͡e͡n)sˌan(͡b͡n)
Social	(͡e͡n)sˈə͡ʊʃə͡l(͡b͡n)
culture	(͡e͡n)kˈʌlt͡ʃə(͡b͡n)
অত	ˈɔto
অবনত	ˈɔbɔnˌɔto
আউস	ˈauʃ
আমরণ	ˈamɔɾˌɔn
উপকরন	ˈupɔkˌɔɾɔn
উৎখনন	ˈutkʰɔnˌɔn
এআরএম	ˈeaɾˌɔem
এলএল	ˈelɔˌel
কজন	kˈɔɟɔn
গগন	ɡˈɔɡɔn
চমচম	t͡ʃˈɔmɔt͡ʃˌɔm
জক	ɟˈɔk
জশ	ɟˈɔʃ
থম	tʰˈɔm
ফজর	fˈɔɟɔɾ
বশ	bˈɔʃ
লসন	lˈɔʃɔn
শহরই	ʃˈɔhɔɾˌɔi
সমতট	ʃˈɔmɔtˌɔʈ
সহমত	ʃˈɔhɔmˌɔto
Altekar	(͡e͡n)ˈɔːltɪkˌɑː(͡b͡n)
California	(͡e͡n)kˌalɪfˈɔːni͡ə(͡b͡n)
Co	(͡e͡n)kˈə͡ʊ(͡b͡n)
Dr	(͡e͡n)dˈɒktə(͡b͡n)
EHG	(͡e͡n)ˈe͡ɪɡ(͡b͡n)
Early	(͡e͡n)ˈɜːlɪ(͡b͡n)
Google	(͡e͡n)ɡˈuːɡə͡l(͡b͡n)
Grand	(͡e͡n)ɡɹˈand(͡b͡n)
Hill	(͡e͡n)hˈɪl(͡b͡n)
Ibn	(͡e͡n)ˈɪbən(͡b͡n)
Les	(͡e͡n)lˈɛs(͡b͡n)
Love	(͡e͡n)lˈʌv(͡b͡n)
OH	(͡e͡n)ˈə͡ʊ(͡b͡n)
Radio	(͡e͡n)ɹˈe͡ɪdɪˌə͡ʊ(͡b͡n)
Sciences	(͡e͡n)sˈa͡ɪ͡ənsɪz(͡b͡n)
Sir	(͡e͡n)sˌɜː(͡b͡n)
US	(͡e͡n)jˌuːˈɛs(͡b͡n)
en	(͡e͡n)ˈɛn(͡b͡n)
অরটন	ˈɔɾɔʈˌɔn
আইএএস	ˈaiˌeeʃ
আনলক	ˈanɔlˌɔk
আরআর	ˈaɾɔˌaɾ
আসগর	ˈaʃɔɡˌɔɾ
ইউথ	ˈiutʰ
ইগর	ˈiɡɔɾ
এমএফএ	ˈemɔˌefɔˌe
কপ	kˈɔp
কফ	kˈɔf
কমর	kˈɔmɔɾ
ঘটল	ɡʰˈɔʈɔl
পটল	pˈɔʈɔl
পদকসহ	pˈɔdɔkˌɔʃɔhˌo
ভগৎ	bʰˈɔɡɔt
মঈন	mˈoin
শব	ʃˈɔb
হয	hˈɔd͡ʒ
Age	(͡e͡n)ˈe͡ɪd͡ʒ(͡b͡n)
Bengali	(͡e͡n)bɛŋɡˈɑːli(͡b͡n)
Brown	(͡e͡n)bɹˈa͡ʊn(͡b͡n)
Economic	(͡e͡n)ˌiːkənˈɒmɪk(͡b͡n)
IP	(͡e͡n)ˌa͡ɪpˈiː(͡b͡n)
ISBN	(͡e͡n)ˌa͡ɪˌɛsbˌiːˈɛn(͡b͡n)
Lee	(͡e͡n)lˈiː(͡b͡n)
Medical	(͡e͡n)mˈɛdɪkə͡l(͡b͡n)
Public	(͡e͡n)pˈʌblɪk(͡b͡n)
Service	(͡e͡n)sˈɜːvɪs(͡b͡n)
Smith	(͡e͡n)smˈɪθ(͡b͡n)
Studies	(͡e͡n)stˈʌdiz(͡b͡n)
also	(͡e͡n)ˈɔːlsə͡ʊ(͡b͡n)
sp	(͡e͡n)ˌɛspˈiː(͡b͡n)
und	(͡e͡n)ˈʌnd(͡b͡n)
আইএসআইএল	ˈaiˌeʃɔˌaiˌel
আতর	ˈatɔɾ
আপতন	ˈapɔtˌɔn
আরএমএস	ˈaɾɔˌemɔˌeʃ
আরওএইচ	ˈaɾɔˌoːeˌit͡ʃ
ইএ	ˈie
ইসমত	ˈiʃɔmˌɔto
এএইচ	ˈeeˌit͡ʃ
এএএ	ˈeeˌe
এনএইচএল	ˈenɔˌeit͡ʃˌɔel
এসওএস	ˈeʃɔˌoːeʃ
এসবই	ˈeʃɔbˌɔi
কজ	kˈɔɟ
খতম	kʰˈɔtɔm
খরচও	kʰˈɔɾɔt͡ʃˌɔoː
গট	ɡˈɔʈ
জনম	ɟˈɔnɔm
তরণ	tˈɔɾɔn
নজদ	nˈɔɟɔd
পদও	pˈɔdɔˌoː
পরশ	pˈɔɾɔʃ
ফলও	fˈɔlɔˌoː
বখশ	bˈɔkʰɔʃ
ভবণ	bʰˈɔbɔn
ভবনসহ	bʰˈɔbɔnˌɔʃɔhˌo
সদন	ʃˈɔdɔn
সরলতম	ʃˈɔɾɔlˌɔtɔm
All	(͡e͡n)ˈɔːl(͡b͡n)
Allen	(͡e͡n)ˈalən(͡b͡n)
America	(͡e͡n)ɐmˈɛɹɪkə(͡b͡n)
Analysis	(͡e͡n)ɐnˈaləsˌɪs(͡b͡n)
Black	(͡e͡n)blˈak(͡b͡n)
Central	(͡e͡n)sˈɛntɹə͡l(͡b͡n)
Cultural	(͡e͡n)kˈʌlt͡ʃəɹə͡l(͡b͡n)
Day	(͡e͡n)dˈe͡ɪ(͡b͡n)
Development	(͡e͡n)dɪvˈɛləpmənt(͡b͡n)
Edition	(͡e͡n)ɪdˈɪʃən(͡b͡n)
Fe	(͡e͡n)fˈiː(͡b͡n)
First	(͡e͡n)fˈɜːst(͡b͡n)
Health	(͡e͡n)hˈɛlθ(͡b͡n)
Henry	(͡e͡n)hˈɛnɹi(͡b͡n)
NAIRU	(͡e͡n)nˈe͡əɹuː(͡b͡n)
People	(͡e͡n)pˈiːpə͡l(͡b͡n)
Policy	(͡e͡n)pˈɒlɪsi(͡b͡n)
Principles	(͡e͡n)pɹˈɪnsɪpə͡lz(͡b͡n)
Robinson	(͡e͡n)ɹˈɒbɪnsən(͡b͡n)
Roy	(͡e͡n)ɹˈɔ͡ɪ(͡b͡n)
SVG	(͡e͡n)ˌɛsvˌiːd͡ʒˈiː(͡b͡n)
Se	(͡e͡n)sˈiː(͡b͡n)
Secret	(͡e͡n)sˈiːkɹɪt(͡b͡n)
Study	(͡e͡n)stˈʌdi(͡b͡n)
Time	(͡e͡n)tˈa͡ɪm(͡b͡n)
not	(͡e͡n)nˈɒt(͡b͡n)
o	(͡e͡n)ˈə͡ʊ(͡b͡n)
vol	(͡e͡n)vˈɒl(͡b͡n)
অপরজন	ˈɔpɔɾˌɔɟɔn
আইচ	ˈait͡ʃ
আপটন	ˈapɔʈˌɔn
আরজ	ˈaɾɔɟ
ইউআরএল	ˈiuˌaɾɔˌel
ইপ	ˈip
উইদ	ˈuid
উৎসবও	ˈutʃɔbˌɔoː
এসএমই	ˈeʃɔˌemɔˌi
এসএসএইচ	ˈeʃɔˌeʃɔˌeit͡ʃ
ওইসব	ˈoːiʃˌɔb
কটক	kˈɔʈɔk
কথন	kˈɔtʰɔn
কষ	kˈɔʃ
ঘটত	ɡʰˈɔʈɔtˌo
ফ	fˈɔ
ফখর	fˈɔkʰɔɾ
ভগবত	bʰˈɔɡɔbˌɔto
মইন	mˈoin
মরণ	mˈɔɾɔn
শশধর	ʃˈɔʃɔdʰˌɔɾ
Al	(͡e͡n)ˈal(͡b͡n)
Commission	(͡e͡n)kəmˈɪʃən(͡b͡n)
Committee	(͡e͡n)kəmˈɪti(͡b͡n)
Cu	(͡e͡n)kˈuː(͡b͡n)
Gibson	(͡e͡n)ɡˈɪbsən(͡b͡n)
Global	(͡e͡n)ɡlˈə͡ʊbə͡l(͡b͡n)
Joseph	(͡e͡n)d͡ʒˈə͡ʊsəf(͡b͡n)
Khan	(͡e͡n)kˈɑːn(͡b͡n)
Literature	(͡e͡n)lˈɪtɹɪt͡ʃə(͡b͡n)
Mark	(͡e͡n)mˈɑːk(͡b͡n)
Museum	(͡e͡n)mjuːzˈi͡əm(͡b͡n)
News	(͡e͡n)njˈuːz(͡b͡n)
Of	(͡e͡n)ɒv(͡b͡n)
Order	(͡e͡n)ˈɔːdə(͡b͡n)
Perry	(͡e͡n)pˈɛɹi(͡b͡n)
Philosophy	(͡e͡n)fɪlˈɒsəfi(͡b͡n)
Republic	(͡e͡n)ɹɪpˈʌblɪk(͡b͡n)
Singh	(͡e͡n)sˈɪŋ(͡b͡n)
Williams	(͡e͡n)wˈɪli͡əmz(͡b͡n)
cell	(͡e͡n)sˈɛl(͡b͡n)
l	(͡e͡n)ˈɛl(͡b͡n)
language	(͡e͡n)lˈaŋɡwɪd͡ʒ(͡b͡n)
state	(͡e͡n)stˈe͡ɪt(͡b͡n)
von	(͡e͡n)vˈɒn(͡b͡n)
w	(͡e͡n)dˈʌbə͡ljˌuː(͡b͡n)
θ	(͡e͡l)θˈita(͡b͡n)
আইপড	ˈaipˌɔɖ
আও	ˈaoː
আত	ˈato
ইউই	ˈiuˌi
ঈগলস	ˈiɡɔlˌɔʃ
উইকস	ˈuikˌɔʃ
উইট	ˈuiʈ
এইউ	ˈeiˌu
এইচআর	ˈeit͡ʃˌɔaɾ
এবছর	ˈebɔt͡ʃʰˌɔɾ
এমএসএস	ˈemɔˌeʃɔˌeʃ
এলএ	ˈelɔˌe
এসএসআর	ˈeʃɔˌeʃɔˌaɾ
গণভবন	ɡˈɔnɔbʰˌɔbɔn
ডসন	ɖˈɔʃɔn
ণ	mˌoddʰeɳɳˈɔ
ননদ	nˈɔnɔd
পথও	pˈɔtʰɔˌoː
পরখ	pˈɔɾɔkʰ
ফরয	fˈɔɾɔd͡ʒ
বটম	bˈɔʈɔm
বরকল	bˈɔɾɔkˌɔl
মনন	mˈɔnɔn
রঙও	ɾˈoŋɔˌoː
সর	ʃˈɔɾ
হব	hˈɔb
হলঘর	hˈɔlɔɡʰˌɔɾ
Alfred	(͡e͡n)ˈalfɹɪd(͡b͡n)
For	(͡e͡n)fɔː(͡b͡n)
Government	(͡e͡n)ɡˈʌvənmənt(͡b͡n)
How	(͡e͡n)hˈa͡ʊ(͡b͡n)
Jones	(͡e͡n)d͡ʒˈə͡ʊnz(͡b͡n)
Kamath	(͡e͡n)kˈamaθ(͡b͡n)
List	(͡e͡n)lˈɪst(͡b͡n)
Politics	(͡e͡n)pˈɒlətˌɪks(͡b͡n)
Project	(͡e͡n)pɹˈɒd͡ʒɛkt(͡b͡n)
Publishers	(͡e͡n)pˈʌblɪʃəz(͡b͡n)
RNA	(͡e͡n)ˌɑːɹˌɛnˈe͡ɪ(͡b͡n)
Revolution	(͡e͡n)ɹˌɛvəlˈuːʃən(͡b͡n)
Saint	(͡e͡n)sˈe͡ɪnt(͡b͡n)
Space	(͡e͡n)spˈe͡ɪs(͡b͡n)
This	(͡e͡n)ðˈɪs(͡b͡n)
To	(͡e͡n)tuː(͡b͡n)
acid	(͡e͡n)ˈasɪd(͡b͡n)
effect	(͡e͡n)ɪfˈɛkt(͡b͡n)
অঘটন	ˈɔɡʰɔʈˌɔn
অলআউট	ˈɔlɔˌauʈ
অসমতল	ˈɔʃɔmˌɔtɔl
আউল	ˈaul
ইউকন	ˈiukˌɔn
ইউজ	ˈiuɟ
ইটস	ˈiʈɔʃ
এআর	ˈeaɾ
এইজ	ˈeiɟ
এএফআই	ˈeefˌɔaˌi
এমআই	ˈemɔˌai
এলএলএম	ˈelɔˌelɔˌem
ওলসন	ˈoːlɔʃˌɔn
কচ	kˈɔt͡ʃ
কনর	kˈɔnɔɾ
কসমস	kˈɔʃɔmˌɔʃ
খই	kʰˈoi
গওহর	ɡˈɔoːhˌɔɾ
গডস	ɡˈɔɖɔʃ
জনপথ	ɟˈɔnɔpˌɔtʰ
ডল	ɖˈɔl
তছনছ	tˈɔt͡ʃʰɔnˌɔt͡ʃʰ
ধবন	dʰˈɔbɔn
নসর	nˈɔʃɔɾ
পদকও	pˈɔdɔkˌɔoː
পরব	pˈɔɾɔb
মতও	mˈɔtɔˌoː
মরমন	mˈɔɾɔmˌɔn
য	ˌontosted͡ʒˈɔ
রবসন	ɾˈobɔʃˌɔn
ﷺ	lˈetəˈefdˈiːˈefˈeːj
Ali	(͡e͡n)ˈɑːli(͡b͡n)
Arab	(͡e͡n)ˈaɹəb(͡b͡n)
Article	(͡e͡n)ˈɑːtɪkə͡l(͡b͡n)
Asiatic	(͡e͡n)ˌe͡ɪʒɪˈatɪk(͡b͡n)
Award	(͡e͡n)ɐwˈɔːd(͡b͡n)
BC	(͡e͡n)bˌiːsˈiː(͡b͡n)
BMI	(͡e͡n)bˌiːˌɛmˈa͡ɪ(͡b͡n)
Britain	(͡e͡n)bɹˈɪtən(͡b͡n)
Center	(͡e͡n)sˈɛntə(͡b͡n)
Centre	(͡e͡n)sˈɛntə(͡b͡n)
Century	(͡e͡n)sˈɛnt͡ʃəɹi(͡b͡n)
District	(͡e͡n)dˈɪstɹɪkt(͡b͡n)
Foreign	(͡e͡n)fˈɒɹən(͡b͡n)
Greek	(͡e͡n)ɡɹˈiːk(͡b͡n)
Jean	(͡e͡n)d͡ʒˈiːn(͡b͡n)
Limited	(͡e͡n)lˈɪmɪtɪd(͡b͡n)
Ltd	(͡e͡n)lˈɪmɪtɪd(͡b͡n)
Middle	(͡e͡n)mˈɪdə͡l(͡b͡n)
Party	(͡e͡n)pˈɑːti(͡b͡n)
Pimlott	(͡e͡n)pˈɪmlɒt(͡b͡n)
Red	(͡e͡n)ɹˈɛd(͡b͡n)
Russian	(͡e͡n)ɹˈʌʃən(͡b͡n)
Second	(͡e͡n)sˈɛkənd(͡b͡n)
Short	(͡e͡n)ʃˈɔːt(͡b͡n)
Swanton	(͡e͡n)swˈantən(͡b͡n)
apex	(͡e͡n)ˈe͡ɪpɛks(͡b͡n)
film	(͡e͡n)fˈɪlm(͡b͡n)
his	(͡e͡n)hˈɪz(͡b͡n)
ibn	(͡e͡n)ˈɪbən(͡b͡n)
law	(͡e͡n)lˈɔː(͡b͡n)
আইএসআই	ˈaiˌeʃɔˌai
আইও	ˈaiˌoː
আইজ	ˈaiɟ
ইউল	ˈiul
ঋষভ	ɾˈiʃɔbʰ
এগ	ˈeɡ
এনএম	ˈenɔˌem
এনএমআর	ˈenɔˌemɔˌaɾ
এপ	ˈep
এলটন	ˈelɔʈˌɔn
এসএইচ	ˈeʃɔˌeit͡ʃ
ওফ	ˈoːf
ওরশ	ˈoːɾɔʃ
জগ	ɟˈɔɡ
জনগণই	ɟˈɔnɔɡˌɔnɔˌi
পলক	pˈɔlɔk
বখত	bˈɔkʰɔtˌo
বরই	bˈɔɾɔˌi
বলও	bˈɔlɔˌoː
বলদ	bˈɔlɔd
ভবনও	bʰˈɔbɔnˌɔoː
মলম	mˈɔlɔm
সগর	ʃˈɔɡɔɾ
সরগন	ʃˈɔɾɔɡˌɔn
AND	(͡e͡n)and(͡b͡n)
Academy	(͡e͡n)ɐkˈadəmi(͡b͡n)
Arts	(͡e͡n)ˈɑːts(͡b͡n)
Classical	(͡e͡n)klˈasɪkə͡l(͡b͡n)
Companion	(͡e͡n)kəmpˈani͡ən(͡b͡n)
Conference	(͡e͡n)kˈɒnfɹəns(͡b͡n)
Department	(͡e͡n)dɪpˈɑːtmənt(͡b͡n)
Der	(͡e͡n)dˈe͡ə(͡b͡n)
Europe	(͡e͡n)jˈʊ͡əɹəp(͡b͡n)
Francis	(͡e͡n)fɹˈansɪs(͡b͡n)
God	(͡e͡n)ɡˈɒd(͡b͡n)
Guide	(͡e͡n)ɡˈa͡ɪd(͡b͡n)
Handbook	(͡e͡n)hˈandbʊk(͡b͡n)
Harry	(͡e͡n)hˈaɹi(͡b͡n)
Hart	(͡e͡n)hˈɑːt(͡b͡n)
Information	(͡e͡n)ˌɪnfəmˈe͡ɪʃən(͡b͡n)
Kolkata	(͡e͡n)kɒlkˈɑːtə(͡b͡n)
Last	(͡e͡n)lˈast(͡b͡n)
Little	(͡e͡n)lˈɪtə͡l(͡b͡n)
Mal	(͡e͡n)mˈal(͡b͡n)
MnO	(͡e͡n)ˌɛmˈɛn ˈə͡ʊ(͡b͡n)
Murphy	(͡e͡n)mˈɜːfi(͡b͡n)
Natural	(͡e͡n)nˈat͡ʃəɹə͡l(͡b͡n)
Office	(͡e͡n)ˈɒfɪs(͡b͡n)
Organization	(͡e͡n)ˌɔːɡɐna͡ɪzˈe͡ɪʃən(͡b͡n)
Oriental	(͡e͡n)ˌɔːɹɪˈɛntə͡l(͡b͡n)
Prize	(͡e͡n)pɹˈa͡ɪz(͡b͡n)
RETScreen	(͡e͡n)ˈɑːɹ ˈiː tˈiː skɹˈiːn(͡b͡n)
Religious	(͡e͡n)ɹɪlˈɪd͡ʒəs(͡b͡n)
Scientific	(͡e͡n)sa͡ɪ͡əntˈɪfɪk(͡b͡n)
Sydney	(͡e͡n)sˈɪdni(͡b͡n)
Tom	(͡e͡n)tˈɒm(͡b͡n)
Top	(͡e͡n)tˈɒp(͡b͡n)
Water	(͡e͡n)wˈɔːtə(͡b͡n)
Wisden	(͡e͡n)wˈɪsdən(͡b͡n)
Years	(͡e͡n)jˈi͡əz(͡b͡n)
blue	(͡e͡n)blˈuː(͡b͡n)
death	(͡e͡n)dˈɛθ(͡b͡n)
district	(͡e͡n)dˈɪstɹɪkt(͡b͡n)
group	(͡e͡n)ɡɹˈuːp(͡b͡n)
model	(͡e͡n)mˈɒdə͡l(͡b͡n)
out	(͡e͡n)ˈa͡ʊt(͡b͡n)
power	(͡e͡n)pˈa͡ʊə(͡b͡n)
thorax	(͡e͡n)θˈɔːɹaks(͡b͡n)
অহরহ	ˈɔhɔɾˌɔho
আইনও	ˈainˌɔoː
আকর	ˈakɔɾ
আগর	ˈaɡɔɾ
আফজল	ˈafɔɟˌɔl
আরশ	ˈaɾɔʃ
আহল	ˈahɔl
ইআর	ˈiaɾ
ইফ	ˈif
ইম	ˈim
এইচএম	ˈeit͡ʃˌɔem
একন	ˈekɔn
এফআইআর	ˈefɔˌaiˌaɾ
এমনসব	ˈemɔnˌɔʃɔb
এসইও	ˈeʃɔˌioː
এসএসএল	ˈeʃɔˌeʃɔˌel
কনট	kˈɔnɔʈ
কম৷	kˈɔm
জলও	ɟˈɔlɔˌoː
জলতল	ɟˈɔlɔtˌɔl
জস	ɟˈɔʃ
ঢল	ɖʰˈɔl
বলব	bˈɔlɔb
বলবত	bˈɔlɔbˌɔto
বশত	bˈɔʃɔtˌo
রকমই	ɾˈokɔmˌɔi
লগইন	lˈɔɡɔˌin
Adams	(͡e͡n)ˈadəmz(͡b͡n)
Area	(͡e͡n)ˈe͡əɹi͡ə(͡b͡n)
Assembly	(͡e͡n)ɐsˈɛmblɪ(͡b͡n)
Bank	(͡e͡n)bˈaŋk(͡b͡n)
Big	(͡e͡n)bˈɪɡ(͡b͡n)
Ca	(͡e͡n)kˈɑː(͡b͡n)
Chandra	(͡e͡n)t͡ʃˈʌndɹə(͡b͡n)
Cohen	(͡e͡n)kˈə͡ʊən(͡b͡n)
Color	(͡e͡n)kˈʌlə(͡b͡n)
Cotton	(͡e͡n)kˈɒtən(͡b͡n)
Culture	(͡e͡n)kˈʌlt͡ʃə(͡b͡n)
DQ	(͡e͡n)dˌiːkjˈuː(͡b͡n)
Down	(͡e͡n)dˈa͡ʊn(͡b͡n)
El	(͡e͡n)ˌɛl(͡b͡n)
Energy	(͡e͡n)ˈɛnəd͡ʒi(͡b͡n)
Engineering	(͡e͡n)ˌɛnd͡ʒɪnˈi͡əɹɪŋ(͡b͡n)
Family	(͡e͡n)fˈamɪli(͡b͡n)
Frith	(͡e͡n)fɹˈɪθ(͡b͡n)
Geographic	(͡e͡n)d͡ʒˌɪəɡɹˈafɪk(͡b͡n)
Golden	(͡e͡n)ɡˈə͡ʊldən(͡b͡n)
Hall	(͡e͡n)hˈɔːl(͡b͡n)
Hardy	(͡e͡n)hˈɑːdi(͡b͡n)
Japanese	(͡e͡n)d͡ʒˌapənˈiːz(͡b͡n)
King	(͡e͡n)kˈɪŋ(͡b͡n)
Land	(͡e͡n)lˈand(͡b͡n)
Lord	(͡e͡n)lˈɔːd(͡b͡n)
Magazine	(͡e͡n)mˌaɡɐzˈiːn(͡b͡n)
Mind	(͡e͡n)mˈa͡ɪnd(͡b͡n)
Muslims	(͡e͡n)mˈʊzlɪmz(͡b͡n)
NO	(͡e͡n)nˈə͡ʊ(͡b͡n)
Naja	(͡e͡n)nˈɑːd͡ʒə(͡b͡n)
Norman	(͡e͡n)nˈɔːmən(͡b͡n)
Old	(͡e͡n)ˈə͡ʊld(͡b͡n)
Palace	(͡e͡n)pˈalɪs(͡b͡n)
Paris	(͡e͡n)pˈaɹɪs(͡b͡n)
Part	(͡e͡n)pˈɑːt(͡b͡n)
Phelps	(͡e͡n)fˈɛlps(͡b͡n)
Pope	(͡e͡n)pˈə͡ʊp(͡b͡n)
Post	(͡e͡n)pˈə͡ʊst(͡b͡n)
Report	(͡e͡n)ɹɪpˈɔːt(͡b͡n)
Revolt	(͡e͡n)ɹɪvˈə͡ʊlt(͡b͡n)
Series	(͡e͡n)sˈi͡əɹiz(͡b͡n)
Sexual	(͡e͡n)sˈɛkʃuːə͡l(͡b͡n)
Star	(͡e͡n)stˈɑː(͡b͡n)
Stephen	(͡e͡n)stˈiːvən(͡b͡n)
Surface	(͡e͡n)sˈɜːfɪs(͡b͡n)
Survey	(͡e͡n)sˈɜːve͡ɪ(͡b͡n)
Technology	(͡e͡n)tɛknˈɒləd͡ʒi(͡b͡n)
USA	(͡e͡n)jˌuːˌɛsˈe͡ɪ(͡b͡n)
Western	(͡e͡n)wˈɛstən(͡b͡n)
Year	(͡e͡n)jˈi͡ə(͡b͡n)
are	(͡e͡n)ɑː(͡b͡n)
del	(͡e͡n)dˈɛl(͡b͡n)
development	(͡e͡n)dɪvˈɛləpmənt(͡b͡n)
gray	(͡e͡n)ɡɹˈe͡ɪ(͡b͡n)
le	(͡e͡n)lə(͡b͡n)
love	(͡e͡n)lˈʌv(͡b͡n)
my	(͡e͡n)mˈa͡ɪ(͡b͡n)
was	(͡e͡n)wɒz(͡b͡n)
École	(͡e͡n)ɪkˈə͡ʊl(͡b͡n)
à	(͡e͡n)a(͡b͡n)
مسجد	(͡e͡n)ˈaɹəbɪkmˈiːm ˈaɹəbɪksˈiːn ˈaɹəbɪkd͡ʒˈiːm ˈaɹəbɪkdˈal1(͡b͡n)
আইআরএ	ˈaiˌaɾɔˌe
আইএইএ	ˈaiˌeiˌe
আইএলও	ˈaiˌelɔˌoː
আইজল	ˈaiɟˌɔl
আকরম	ˈakɔɾˌɔm
আদব	ˈadɔb
আরএনএর	ˈaɾɔˌenɔˌeɾ
ইউএইচএফ	ˈiuˌeit͡ʃˌɔef
ইউন	ˈiun
ইএফএল	ˈiefˌɔel
ইক	ˈik
উওর	ˈuoːɾ
উরস	ˈuɾɔʃ
একজনই	ˈekɔɟˌɔnɔˌi
এসইউ	ˈeʃɔˌiu
এসএফ	ˈeʃɔˌef
ওল	ˈoːl
কও	kˈɔoː
কখ	kˈɔkʰ
কবচ	kˈɔbɔt͡ʃ
খবরও	kʰˈɔbɔɾˌɔoː
ছল	t͡ʃʰˈɔl
জগন	ɟˈɔɡɔn
জনসহ	ɟˈɔnɔʃˌɔho
ডলস	ɖˈɔlɔʃ
ধমক	dʰˈɔmɔk
ধরনও	dʰˈɔɾɔnˌɔoː
নটস	nˈɔʈɔʃ
ফলজ	fˈɔlɔɟ
বলবন	bˈɔlɔbˌɔn
শবর	ʃˈɔbɔɾ
শমথ	ʃˈɔmɔtʰ
শর	ʃˈɔɾ
সমন	ʃˈɔmɔn
হকস	hˈɔkɔʃ
ANE	(͡e͡n)ˈe͡ɪn(͡b͡n)
Alessi	(͡e͡n)ɐlˈɛsi(͡b͡n)
And	(͡e͡n)and(͡b͡n)
Arthur	(͡e͡n)ˈɑːθə(͡b͡n)
Berkeley	(͡e͡n)bˈɜːkli(͡b͡n)
Biography	(͡e͡n)ba͡ɪˈɒɡɹəfi(͡b͡n)
Blue	(͡e͡n)blˈuː(͡b͡n)
Bond	(͡e͡n)bˈɒnd(͡b͡n)
Bose	(͡e͡n)bˈə͡ʊs(͡b͡n)
Bowden	(͡e͡n)bˈə͡ʊdən(͡b͡n)
Carl	(͡e͡n)kˈɑːl(͡b͡n)
Chinese	(͡e͡n)t͡ʃa͡ɪnˈiːz(͡b͡n)
Chittagong	(͡e͡n)t͡ʃˈɪtaɡəŋɡ(͡b͡n)
Cricketer	(͡e͡n)kɹˈɪkɛtə(͡b͡n)
DC	(͡e͡n)dˌiːsˈiː(͡b͡n)
Daily	(͡e͡n)dˈe͡ɪli(͡b͡n)
Dark	(͡e͡n)dˈɑːk(͡b͡n)
Eastern	(͡e͡n)ˈiːstən(͡b͡n)
European	(͡e͡n)jˌʊ͡əɹəpˈi͡ən(͡b͡n)
French	(͡e͡n)fɹˈɛnt͡ʃ(͡b͡n)
Horse	(͡e͡n)hˈɔːs(͡b͡n)
Iran	(͡e͡n)ɪɹˈan(͡b͡n)
JPEG	(͡e͡n)d͡ʒˈe͡ɪpˈɛɡ(͡b͡n)
Jerusalem	(͡e͡n)d͡ʒəɹˈuːsələm(͡b͡n)
Lawrence	(͡e͡n)lˈɒɹəns(͡b͡n)
Lewis	(͡e͡n)lˈuːɪs(͡b͡n)
Management	(͡e͡n)mˈanɪd͡ʒmənt(͡b͡n)
Master	(͡e͡n)mˈastə(͡b͡n)
Mehta	(͡e͡n)mˈe͡ɪtə(͡b͡n)
Military	(͡e͡n)mˈɪlɪtəɹi(͡b͡n)
Nb	(͡e͡n)ˌɛnbˈiː(͡b͡n)
Review	(͡e͡n)ɹɪvjˈuː(͡b͡n)
River	(͡e͡n)ɹˈɪvə(͡b͡n)
Rome	(͡e͡n)ɹˈə͡ʊm(͡b͡n)
Sastri	(͡e͡n)sˈastɹi(͡b͡n)
Simon	(͡e͡n)sˈa͡ɪmən(͡b͡n)
Special	(͡e͡n)spˈɛʃə͡l(͡b͡n)
Sr	(͡e͡n)ˌɛsˈɑː(͡b͡n)
Statistical	(͡e͡n)stɐtˈɪstɪkə͡l(͡b͡n)
TV	(͡e͡n)tˌiːvˈiː(͡b͡n)
Third	(͡e͡n)θˈɜːd(͡b͡n)
Thompson	(͡e͡n)tˈɒmpsən(͡b͡n)
UFO	(͡e͡n)jˌuːˌɛfˈə͡ʊ(͡b͡n)
Walter	(͡e͡n)wˈɒltə(͡b͡n)
XX	(͡e͡n)ɹˌə͡ʊmən twˈɛnti(͡b͡n)
analysis	(͡e͡n)ɐnˈaləsˌɪs(͡b͡n)
history	(͡e͡n)hˈɪstəɹi(͡b͡n)
knowledge	(͡e͡n)nˈɒlɪd͡ʒ(͡b͡n)
née	(͡e͡n)nˈe͡ɪ(͡b͡n)
sin	(͡e͡n)sˈɪn(͡b͡n)
that	(͡e͡n)ðˈat(͡b͡n)
μ	(͡e͡l)mˈi(͡b͡n)
অবশ	ˈɔbɔʃ
আইএফএ	ˈaiˌefɔˌe
আইনই	ˈainˌɔi
আছ	ˈat͡ʃʰ
আতপ	ˈatɔp
আরএম	ˈaɾɔˌem
ইউএমএনও	ˈiuˌemɔˌenɔˌoː
ইও	ˈioː
ইসকন	ˈiʃɔkˌɔn
ঈষদ	ˈiʃɔd
এইচএএল	ˈeit͡ʃˌɔeˌel
এটম	ˈeʈɔm
এপস	ˈepɔʃ
এফআরএস	ˈefɔˌaɾɔˌeʃ
এফএফ	ˈefɔˌef
এবন	ˈebɔn
এরল	ˈeɾɔl
এসএন	ˈeʃɔˌen
ওট	ˈoːʈ
ঔ	ˈow
কলন	kˈɔlɔn
চরন	t͡ʃˈɔɾɔn
তসর	tˈɔʃɔɾ
ধকল	dʰˈɔkɔl
নঈম	nˈoim
নবতর	nˈɔbɔtˌɔɾ
নম	nˈɔm
নরউইচ	nˈɔɾɔˌuit͡ʃ
নসরত	nˈɔʃɔɾˌɔto
পথই	pˈɔtʰɔˌi
পন	pˈɔn
বকশ	bˈɔkɔʃ
মগজ	mˈɔɡɔɟ
মব	mˈɔb
রওনক	ɾˈooːnˌɔk
শতদল	ʃˈɔtɔdˌɔl
হউক	hˈouk
হগ	hˈɔɡ
AD	(͡e͡n)ˈad(͡b͡n)
Ahmad	(͡e͡n)ˈɑːmad(͡b͡n)
Air	(͡e͡n)ˈe͡ə(͡b͡n)
Australia	(͡e͡n)ɒstɹˈe͡ɪli͡ə(͡b͡n)
Australian	(͡e͡n)ɒstɹˈe͡ɪli͡ən(͡b͡n)
Basic	(͡e͡n)bˈe͡ɪsɪk(͡b͡n)
Battle	(͡e͡n)bˈatə͡l(͡b͡n)
Bi	(͡e͡n)bˈa͡ɪ(͡b͡n)
Canada	(͡e͡n)kˈanədə(͡b͡n)
Chemical	(͡e͡n)kˈɛmɪkə͡l(͡b͡n)
Church	(͡e͡n)t͡ʃˈɜːt͡ʃ(͡b͡n)
Don	(͡e͡n)dˈɒn(͡b͡n)
Douglas	(͡e͡n)dˈʌɡləz(͡b͡n)
Edward	(͡e͡n)ˈɛdwəd(͡b͡n)
Film	(͡e͡n)fˈɪlm(͡b͡n)
France	(͡e͡n)fɹˈans(͡b͡n)
Gandhi	(͡e͡n)ɡˈɑːndi(͡b͡n)
Geographical	(͡e͡n)d͡ʒˌɪəɡɹˈafɪkə͡l(͡b͡n)
Grammar	(͡e͡n)ɡɹˈamə(͡b͡n)
Ian	(͡e͡n)ˈiːən(͡b͡n)
Island	(͡e͡n)ˈa͡ɪlənd(͡b͡n)
LED	(͡e͡n)lˈɛd(͡b͡n)
LR	(͡e͡n)ˌɛlˈɑː(͡b͡n)
Ludwig	(͡e͡n)lˈʌdwɪɡ(͡b͡n)
Magic	(͡e͡n)mˈad͡ʒɪk(͡b͡n)
Medieval	(͡e͡n)mˈɛdɪˌiːvə͡l(͡b͡n)
Peace	(͡e͡n)pˈiːs(͡b͡n)
Physics	(͡e͡n)fˈɪzɪks(͡b͡n)
Princeton	(͡e͡n)pɹˈɪnstən(͡b͡n)
Professor	(͡e͡n)pɹəfˈɛsə(͡b͡n)
Programme	(͡e͡n)pɹˈə͡ʊɡɹam(͡b͡n)
Quran	(͡e͡n)kwəɹˈan(͡b͡n)
REM	(͡e͡n)ɹˈɛm(͡b͡n)
Ray	(͡e͡n)ɹˈe͡ɪ(͡b͡n)
Reu	(͡e͡n)ɹˈuː(͡b͡n)
Roman	(͡e͡n)ɹˈə͡ʊmən(͡b͡n)
Rose	(͡e͡n)ɹˈə͡ʊz(͡b͡n)
Russia	(͡e͡n)ɹˈʌʃə(͡b͡n)
Schaller	(͡e͡n)ʃˈɔːlə(͡b͡n)
Sea	(͡e͡n)sˈiː(͡b͡n)
Section	(͡e͡n)sˈɛkʃən(͡b͡n)
Sri	(͡e͡n)sɹˌiː(͡b͡n)
St	(͡e͡n)sənt(͡b͡n)
Steinhardt	(͡e͡n)stˈa͡ɪnhɑːt(͡b͡n)
Systems	(͡e͡n)sˈɪstəmz(͡b͡n)
Three	(͡e͡n)θɹˈiː(͡b͡n)
Tibet	(͡e͡n)tɪbˈɛt(͡b͡n)
Trade	(͡e͡n)tɹˈe͡ɪd(͡b͡n)
VI	(͡e͡n)vˌiːˈa͡ɪ(͡b͡n)
WHG	(͡e͡n)dˌʌbə͡ljˌuːˌe͡ɪt͡ʃd͡ʒˈiː(͡b͡n)
What	(͡e͡n)wˌɒt(͡b͡n)
Woodhouse	(͡e͡n)wˈʊdha͡ʊs(͡b͡n)
Work	(͡e͡n)wˈɜːk(͡b͡n)
Young	(͡e͡n)jˈʌŋ(͡b͡n)
Zn	(͡e͡n)zˌɛdˈɛn(͡b͡n)
coli	(͡e͡n)kˈə͡ʊli(͡b͡n)
common	(͡e͡n)kˈɒmən(͡b͡n)
data	(͡e͡n)dˈe͡ɪtə(͡b͡n)
family	(͡e͡n)fˈamɪli(͡b͡n)
its	(͡e͡n)ɪts(͡b͡n)
life	(͡e͡n)lˈa͡ɪf(͡b͡n)
light	(͡e͡n)lˈa͡ɪt(͡b͡n)
man	(͡e͡n)mˈan(͡b͡n)
people	(͡e͡n)pˈiːpə͡l(͡b͡n)
second	(͡e͡n)sˈɛkənd(͡b͡n)
series	(͡e͡n)sˈi͡əɹiz(͡b͡n)
social	(͡e͡n)sˈə͡ʊʃə͡l(͡b͡n)
space	(͡e͡n)spˈe͡ɪs(͡b͡n)
syndrome	(͡e͡n)sˈɪndɹə͡ʊm(͡b͡n)
up	(͡e͡n)ˈʌp(͡b͡n)
zooxanthellae	(͡e͡n)zˈuːksanθˌɛliː(͡b͡n)
λ	(͡e͡l)lˈamða(͡b͡n)
ρ	(͡e͡l)rˈo(͡b͡n)
অক	ˈɔk
অবকলন	ˈɔbɔkˌɔlɔn
অমন	ˈɔmɔn
আইআরএস	ˈaiˌaɾɔˌeʃ
আইএসআইএস	ˈaiˌeʃɔˌaiˌeʃ
আইরন	ˈaiɾˌɔn
আওর	ˈaoːɾ
আপদ	ˈapɔd
আরএল	ˈaɾɔˌel
আসনই	ˈaʃɔnˌɔi
আহ	ˈaho
ইইই	ˈiiˌi
ইএসএ	ˈieʃˌɔe
উইলমট	ˈuilˌɔmɔʈ
উদগত	ˈudɔɡˌɔto
উপনগর	ˈupɔnˌɔɡɔɾ
উৎকট	ˈutkɔʈ
এএফএম	ˈeefˌɔem
এএফএল	ˈeefˌɔel
এএসএন	ˈeeʃˌɔen
একল	ˈekɔl
এনএসএ	ˈenɔˌeʃɔˌe
এনএসএস	ˈenɔˌeʃɔˌeʃ
এমআরএনএর	ˈemɔˌaɾɔˌenɔˌeɾ
এমই	ˈemɔˌi
এররস	ˈeɾɔɾˌɔʃ
এসএসআই	ˈeʃɔˌeʃɔˌai
ওউ	ˈoːu
ওজ	ˈoːɟ
ওজনও	ˈoːɟɔnˌɔoː
ওলফ	ˈoːlɔf
ওহম	ˈoːhɔm
কব	kˈɔb
কমলনগর	kˈɔmɔlˌɔnɔɡˌɔɾ
গথ	ɡˈɔtʰ
গমণ	ɡˈɔmɔn
চপ	t͡ʃˈɔp
চলল	t͡ʃˈɔlɔl
ছ	t͡ʃhˈɔ
ছট	t͡ʃʰˈɔʈ
জনগণও	ɟˈɔnɔɡˌɔnɔˌoː
জলকদর	ɟˈɔlɔkˌɔdɔɾ
ঝলমল	ɟʰˈɔlɔmˌɔl
ঞ	ˈiŋɔ̃
ট	ʈˈɔ
টগর	ʈˈɔɡɔɾ
টল	ʈˈɔl
তখত	tˈɔkʰɔtˌo
তব	tˈɔb
পড	pˈɔɖ
পরত	pˈɔɾɔtˌo
ফগ	fˈɔɡ
বইই	bˈoiˌi
মতনই	mˈɔtɔnˌɔi
লকড	lˈɔkɔɖ
শরদ	ʃˈɔɾɔd
সক	ʃˈɔk
সকলই	ʃˈɔkɔlˌɔi
সতত	ʃˈɔtɔtˌo
সফলও	ʃˈɔfɔlˌɔoː
হইচই	hˈoit͡ʃˌɔi
হফ	hˈɔf
