ঘরর	ɡhˈəɾɾ
এগত	ˈeɡto
গ	ɡˈɔ
র	ɾˈo
USA	(͡e͡n)jˌuːˌɛsˈe͡ɪ(͡b͡p͡y)
বসর	bˈɔsɾ
লহঙ	lˈəhəŋɡ
ঘর	ɡhˈəɾ
বসরর	bˈɔsəɾˌəɾ
শহর	ʃˈəhɾ
উচ	ˈucə
এগর	ˈeɡɾ
দশ	dˈɔʃə
নগর	nˈɔɡɾ
চর	cˈəɾ
সদর	sˈadɔɾ
ও	ˈoː
এ	ˈe
এই	ˈei
আর	ˈaːɾ
এক	ˈekə
আগ	ˈaːɡə
অর	ˈəɾ
এর	ˈeɾ
বছর	bˈɔchɔɾ
আগর	ˈaːɡɾ
গর	ɡˈəɾ
সদরর	sˈadɔɾˌəɾ
জরম	ɟˈəɾəmˌə
অফ	ˈəfɔ
এগ	ˈeɡə
আইএনএ	ˈaːiˌenɔˌe
ঔ	ˈow
কম	kˈɔmə
আগন	ˈaːɡnɔ
এককর	ˈekɔkˌɔɾ
এল	ˈel
শহরর	ʃˈəhəɾˌəɾ
