тата	tˈata
кĕрет	k (͡e͡n)ˌiːbɹˈiːv(͡c͡v) r jˈɛ t
юхса	jˈʊxsa
юханшыв	juxˈanʃɯv
территоринчи	tˌɛrritoɾˈɪnt͡ʃɪ
Юханшыв	juxˈanʃɯv
те	tˈɛ
км	km
та	tˈa
Раççей	r ˈa (͡e͡n)sˌiːsədˈɪlɐ sˌiːsədˈɪlɐ(͡c͡v) jˈɛ j
юханшывăн	jˈʊ x ˈa n ʃ ˈɯ v (͡e͡n)ˌe͡ɪbɹˈiːv(͡c͡v) n
вăрринчен	v (͡e͡n)ˌe͡ɪbɹˈiːv(͡c͡v) r r ˈɪ n t͡ʃ jˈæ n
пулнă	p ˈʊ l n (͡e͡n)ˌe͡ɪbɹˈiːv(͡c͡v)
çыранĕпе	(͡e͡n)sˌiːsədˈɪlɐ(͡c͡v) ˈɯ r ˈa n (͡e͡n)ˌiːbɹˈiːv(͡c͡v) p jˈɛ
юханшыва	jˌuxanʃˈɯva
вăл	v (͡e͡n)ˌe͡ɪbɹˈiːv(͡c͡v) l
сулахай	sulˈaxaj
пулса	pˈʊlsa
сылтăм	s ˈɯ l t (͡e͡n)ˌe͡ɪbɹˈiːv(͡c͡v) m
кочĕ	k ˈɔ t͡ʃ (͡e͡n)ˌiːbɹˈiːv(͡c͡v)
индексĕ	ˈɪ n d jˈɛ k s (͡e͡n)ˌiːbɹˈiːv(͡c͡v)
Почтă	p ˈɔ t͡ʃ t (͡e͡n)ˌe͡ɪbɹˈiːv(͡c͡v)
ОКАТО	okˈatɔ
çын	(͡e͡n)sˌiːsədˈɪlɐ(͡c͡v) ˈɯ n
пур	pˈʊr
вырнаçнă	v ˈɯ r n ˈa (͡e͡n)sˌiːsədˈɪlɐ(͡c͡v) n (͡e͡n)ˌe͡ɪbɹˈiːv(͡c͡v)
пулать	pˈulat
илнĕ	ˈɪ l n (͡e͡n)ˌiːbɹˈiːv(͡c͡v)
лаптăкĕ	l ˈa p t (͡e͡n)ˌe͡ɪbɹˈiːv(͡c͡v) k (͡e͡n)ˌiːbɹˈiːv(͡c͡v)
е	jˈɛ
мар	mˈar
ăна	(͡e͡n)ˌe͡ɪbɹˈiːv(͡c͡v) n ˈa
чи	t͡ʃˈɪ
пĕр	p (͡e͡n)ˌiːbɹˈiːv(͡c͡v) r
çул	(͡e͡n)sˌiːsədˈɪlɐ(͡c͡v) ˈʊ l
Германи	ɡɛrmˈanɪ
вара	vˈaɾa
вăхăтра	v (͡e͡n)ˌe͡ɪbɹˈiːv(͡c͡v) x (͡e͡n)ˌe͡ɪbɹˈiːv(͡c͡v) t r ˈa
Чăваш	t͡ʃ (͡e͡n)ˌe͡ɪbɹˈiːv(͡c͡v) v ˈa ʃ
усă	ˈʊ s (͡e͡n)ˌe͡ɪbɹˈiːv(͡c͡v)
çулта	(͡e͡n)sˌiːsədˈɪlɐ(͡c͡v) ˈʊ l t ˈa
ял	jˈal
чухне	t͡ʃˈʊxnɛ
хыççăн	x ˈɯ (͡e͡n)sˌiːsədˈɪlɐ sˌiːsədˈɪlɐ ˌe͡ɪbɹˈiːv(͡c͡v) n
паллă	p ˈa l l (͡e͡n)ˌe͡ɪbɹˈiːv(͡c͡v)
унăн	ˈʊ n (͡e͡n)ˌe͡ɪbɹˈiːv(͡c͡v) n
км²	km (͡e͡n)tˈuː(͡c͡v)
çине	(͡e͡n)sˌiːsədˈɪlɐ(͡c͡v) ˈɪ n jˈɛ
пек	pˈɛk
пин	pˈɪn
чăваш	t͡ʃ (͡e͡n)ˌe͡ɪbɹˈiːv(͡c͡v) v ˈa ʃ
тесе	tˈɛsɛ
Совет	sˈovɛt
хăйĕн	x (͡e͡n)ˌe͡ɪbɹˈiːv(͡c͡v) j (͡e͡n)ˌiːbɹˈiːv(͡c͡v) n
пысăк	p ˈɯ s (͡e͡n)ˌe͡ɪbɹˈiːv(͡c͡v) k
Çак	(͡e͡n)sˌiːsədˈɪlɐ(͡c͡v) ˈa k
çак	(͡e͡n)sˌiːsədˈɪlɐ(͡c͡v) ˈa k
пекех	pˈɛkɛx
пирки	pˈɪrkɪ
çинче	(͡e͡n)sˌiːsədˈɪlɐ(͡c͡v) ˈɪ n t͡ʃ jˈɛ
Мăн	m (͡e͡n)ˌe͡ɪbɹˈiːv(͡c͡v) n
нумай	nˈumaj
Кӳлĕ	k ˈø l (͡e͡n)ˌiːbɹˈiːv(͡c͡v)
тăршшĕ	t (͡e͡n)ˌe͡ɪbɹˈiːv(͡c͡v) r ʃ ʃ (͡e͡n)ˌiːbɹˈiːv(͡c͡v)
тĕп	t (͡e͡n)ˌiːbɹˈiːv(͡c͡v) p
Ку	kˈʊ
Вăл	v (͡e͡n)ˌe͡ɪbɹˈiːv(͡c͡v) l
тухнă	t ˈʊ x n (͡e͡n)ˌe͡ɪbɹˈiːv(͡c͡v)
тăрать	t (͡e͡n)ˌe͡ɪbɹˈiːv(͡c͡v) r ˈa t
кӳлĕ	k ˈø l (͡e͡n)ˌiːbɹˈiːv(͡c͡v)
Союзĕн	s ˈɔ jˈʊ z (͡e͡n)ˌiːbɹˈiːv(͡c͡v) n
гварди	ɡvˈardɪ
анчах	ˈant͡ʃax
питĕ	p ˈɪ t (͡e͡n)ˌiːbɹˈiːv(͡c͡v)
ку	kˈʊ
халăх	x ˈa l (͡e͡n)ˌe͡ɪbɹˈiːv(͡c͡v) x
икĕ	ˈɪ k (͡e͡n)ˌiːbɹˈiːv(͡c͡v)
чысне	t͡ʃˈɯsnɛ
туса	tˈusa
Паттăрĕн	p ˈa t t (͡e͡n)ˌe͡ɪbɹˈiːv(͡c͡v) r (͡e͡n)ˌiːbɹˈiːv(͡c͡v) n
патшалăх	p ˈa t ʃ ˈa l (͡e͡n)ˌe͡ɪbɹˈiːv(͡c͡v) x
çулхи	(͡e͡n)sˌiːsədˈɪlɐ(͡c͡v) ˈʊ l x ˈɪ
хушшинче	xʊʃʃˈɪnt͡ʃɛ
шутланать	ʃʊtlˈanat
çĕр	(͡e͡n)sˌiːsədˈɪlɐ ˌiːbɹˈiːv(͡c͡v) r
тĕрлĕ	t (͡e͡n)ˌiːbɹˈiːv(͡c͡v) r l (͡e͡n)ˌiːbɹˈiːv(͡c͡v)
çав	(͡e͡n)sˌiːsədˈɪlɐ(͡c͡v) ˈa v
Анчах	ˈant͡ʃax
тухать	tˈuxat
хăй	x (͡e͡n)ˌe͡ɪbɹˈiːv(͡c͡v) j
çеç	(͡e͡n)sˌiːsədˈɪlɐ(͡c͡v) jˈɛ (͡e͡n)sˌiːsədˈɪlɐ(͡c͡v)
пĕрремĕш	p (͡e͡n)ˌiːbɹˈiːv(͡c͡v) r r jˈæ m (͡e͡n)ˌiːbɹˈiːv(͡c͡v) ʃ
шыв	ʃˈɯv
шутне	ʃˈʊtnɛ
ĕçленĕ	(͡e͡n)ˌiːbɹˈiːv sˌiːsədˈɪlɐ(͡c͡v) l jˈæ n (͡e͡n)ˌiːbɹˈiːv(͡c͡v)
кайнă	k ˈa j n (͡e͡n)ˌe͡ɪbɹˈiːv(͡c͡v)
май	mˈaj
тăрăх	t (͡e͡n)ˌe͡ɪbɹˈiːv(͡c͡v) r (͡e͡n)ˌe͡ɪbɹˈiːv(͡c͡v) x
ытти	ˈɯttɪ
панă	p ˈa n (͡e͡n)ˌe͡ɪbɹˈiːv(͡c͡v)
тăнă	t (͡e͡n)ˌe͡ɪbɹˈiːv(͡c͡v) n (͡e͡n)ˌe͡ɪbɹˈiːv(͡c͡v)
хули	xˈulɪ
Унăн	ˈʊ n (͡e͡n)ˌe͡ɪbɹˈiːv(͡c͡v) n
йышĕ	j ˈɯ ʃ (͡e͡n)ˌiːbɹˈiːv(͡c͡v)
вĕсем	v (͡e͡n)ˌiːbɹˈiːv(͡c͡v) s jˈæ m
хула	xˈula
чылай	t͡ʃˈɯlaj
çырнă	(͡e͡n)sˌiːsədˈɪlɐ(͡c͡v) ˈɯ r n (͡e͡n)ˌe͡ɪbɹˈiːv(͡c͡v)
хунă	x ˈʊ n (͡e͡n)ˌe͡ɪbɹˈiːv(͡c͡v)
валли	vˈallɪ
çук	(͡e͡n)sˌiːsədˈɪlɐ(͡c͡v) ˈʊ k
пурăнать	p ˈʊ r (͡e͡n)ˌe͡ɪbɹˈiːv(͡c͡v) n ˈa t
çарĕн	(͡e͡n)sˌiːsədˈɪlɐ(͡c͡v) ˈa r (͡e͡n)ˌiːbɹˈiːv(͡c͡v) n
Аслă	ˈa s l (͡e͡n)ˌe͡ɪbɹˈiːv(͡c͡v)
çыранпе	(͡e͡n)sˌiːsədˈɪlɐ(͡c͡v) ˈɯ r ˈa n p jˈɛ
çуралнă	(͡e͡n)sˌiːsədˈɪlɐ(͡c͡v) ˈʊ r ˈa l n (͡e͡n)ˌe͡ɪbɹˈiːv(͡c͡v)
ытла	ˈɯtla
ытларах	ɯtlˈaɾax
кĕнĕ	k (͡e͡n)ˌiːbɹˈiːv(͡c͡v) n (͡e͡n)ˌiːbɹˈiːv(͡c͡v)
ячĕ	jˈa t͡ʃ (͡e͡n)ˌiːbɹˈiːv(͡c͡v)
перевçĕсен	p jˈɛ r jˈɛ v (͡e͡n)sˌiːsədˈɪlɐ ˌiːbɹˈiːv(͡c͡v) s jˈæ n
пынă	p ˈɯ n (͡e͡n)ˌe͡ɪbɹˈiːv(͡c͡v)
тунă	t ˈʊ n (͡e͡n)ˌe͡ɪbɹˈiːv(͡c͡v)
теççĕ	t jˈɛ (͡e͡n)sˌiːsədˈɪlɐ sˌiːsədˈɪlɐ ˌiːbɹˈiːv(͡c͡v)
яхăн	jˈa x (͡e͡n)ˌe͡ɪbɹˈiːv(͡c͡v) n
ертсе	jˈɛrtsɛ
полкĕн	p ˈɔ l k (͡e͡n)ˌiːbɹˈiːv(͡c͡v) n
ятлă	jˈa t l (͡e͡n)ˌe͡ɪbɹˈiːv(͡c͡v)
темиçе	t jˈæ m ˈɪ (͡e͡n)sˌiːsədˈɪlɐ(͡c͡v) jˈɛ
Çав	(͡e͡n)sˌiːsədˈɪlɐ(͡c͡v) ˈa v
авалхи	avˈalxɪ
пулсан	pˈʊlsan
командирĕ	k ˈɔ m ˈa n d ˈɪ r (͡e͡n)ˌiːbɹˈiːv(͡c͡v)
ун	ˈʊn
аслă	ˈa s l (͡e͡n)ˌe͡ɪbɹˈiːv(͡c͡v)
кураççĕ	k ˈʊ r ˈa (͡e͡n)sˌiːsədˈɪlɐ sˌiːsədˈɪlɐ ˌiːbɹˈiːv(͡c͡v)
кăна	k (͡e͡n)ˌe͡ɪbɹˈiːv(͡c͡v) n ˈa
хут	xˈʊt
енчен	jˈænt͡ʃɛn
вырăс	v ˈɯ r (͡e͡n)ˌe͡ɪbɹˈiːv(͡c͡v) s
кунта	kˈʊnta
дивизин	divˈizɪn
унта	ˈʊnta
илсе	ˈɪlsɛ
Тĕп	t (͡e͡n)ˌiːbɹˈiːv(͡c͡v) p
Халăх	x ˈa l (͡e͡n)ˌe͡ɪbɹˈiːv(͡c͡v) x
авиаци	ˌaviˈat͡sɪ
патне	pˈatnɛ
тенĕ	t jˈæ n (͡e͡n)ˌiːbɹˈiːv(͡c͡v)
вĕсен	v (͡e͡n)ˌiːbɹˈiːv(͡c͡v) s jˈæ n
вĕсене	v (͡e͡n)ˌiːbɹˈiːv(͡c͡v) s jˈæ n jˈɛ
тĕл	t (͡e͡n)ˌiːbɹˈiːv(͡c͡v) l
пуçланă	p ˈʊ (͡e͡n)sˌiːsədˈɪlɐ(͡c͡v) l ˈa n (͡e͡n)ˌe͡ɪbɹˈiːv(͡c͡v)
пĕрле	p (͡e͡n)ˌiːbɹˈiːv(͡c͡v) r l jˈɛ
çар	(͡e͡n)sˌiːsədˈɪlɐ(͡c͡v) ˈa r
чĕлхи	t͡ʃ (͡e͡n)ˌiːbɹˈiːv(͡c͡v) l x ˈɪ
çинчен	(͡e͡n)sˌiːsədˈɪlɐ(͡c͡v) ˈɪ n t͡ʃ jˈæ n
пĕри	p (͡e͡n)ˌiːbɹˈiːv(͡c͡v) r ˈɪ
тытса	tˈɯtsa
ятне	jˈatnɛ
вăтам	v (͡e͡n)ˌe͡ɪbɹˈiːv(͡c͡v) t ˈa m
урăх	ˈʊ r (͡e͡n)ˌe͡ɪbɹˈiːv(͡c͡v) x
вырăн	v ˈɯ r (͡e͡n)ˌe͡ɪbɹˈiːv(͡c͡v) n
пултарать	pʊltˈaɾat
пĕтĕм	p (͡e͡n)ˌiːbɹˈiːv(͡c͡v) t (͡e͡n)ˌiːbɹˈiːv(͡c͡v) m
пырать	pˈɯɾat
уйрăм	ˈʊ j r (͡e͡n)ˌe͡ɪbɹˈiːv(͡c͡v) m
юхать	jˈuxat
кун	kˈʊn
Кĕçĕн	k (͡e͡n)ˌiːbɹˈiːv sˌiːsədˈɪlɐ ˌiːbɹˈiːv(͡c͡v) n
ĕç	(͡e͡n)ˌiːbɹˈiːv sˌiːsədˈɪlɐ(͡c͡v)
вĕреннĕ	v (͡e͡n)ˌiːbɹˈiːv(͡c͡v) r jˈæ n n (͡e͡n)ˌiːbɹˈiːv(͡c͡v)
пурăннă	p ˈʊ r (͡e͡n)ˌe͡ɪbɹˈiːv(͡c͡v) n n (͡e͡n)ˌe͡ɪbɹˈiːv(͡c͡v)
Çавăн	(͡e͡n)sˌiːsədˈɪlɐ(͡c͡v) ˈa v (͡e͡n)ˌe͡ɪbɹˈiːv(͡c͡v) n
пуçне	p ˈʊ (͡e͡n)sˌiːsədˈɪlɐ(͡c͡v) n jˈɛ
пула	pˈula
патĕнче	p ˈa t (͡e͡n)ˌiːbɹˈiːv(͡c͡v) n t͡ʃ jˈɛ
Ăна	(͡e͡n)ˌe͡ɪbɹˈiːv(͡c͡v) n ˈa
тепĕр	t jˈɛ p (͡e͡n)ˌiːbɹˈiːv(͡c͡v) r
хирĕç	x ˈɪ r (͡e͡n)ˌiːbɹˈiːv sˌiːsədˈɪlɐ(͡c͡v)
хулинче	xulˈɪnt͡ʃɛ
Çĕнĕ	(͡e͡n)sˌiːsədˈɪlɐ ˌiːbɹˈiːv(͡c͡v) n (͡e͡n)ˌiːbɹˈiːv(͡c͡v)
вырăнне	v ˈɯ r (͡e͡n)ˌe͡ɪbɹˈiːv(͡c͡v) n n jˈɛ
пулма	pˈʊlma
халĕ	x ˈa l (͡e͡n)ˌiːbɹˈiːv(͡c͡v)
пĕчĕк	p (͡e͡n)ˌiːbɹˈiːv(͡c͡v) t͡ʃ (͡e͡n)ˌiːbɹˈiːv(͡c͡v) k
Ун	ˈʊn
кăларнă	k (͡e͡n)ˌe͡ɪbɹˈiːv(͡c͡v) l ˈa r n (͡e͡n)ˌe͡ɪbɹˈiːv(͡c͡v)
пайĕ	p ˈa j (͡e͡n)ˌiːbɹˈiːv(͡c͡v)
юппинчен	jʊppˈɪnt͡ʃɛn
тума	tˈuma
Пĕрремĕш	p (͡e͡n)ˌiːbɹˈiːv(͡c͡v) r r jˈæ m (͡e͡n)ˌiːbɹˈiːv(͡c͡v) ʃ
бассейн	bˈassɛjn
тинĕс	t ˈɪ n (͡e͡n)ˌiːbɹˈiːv(͡c͡v) s
малтан	mˈaltan
çаплах	(͡e͡n)sˌiːsədˈɪlɐ(͡c͡v) ˈa p l ˈa x
фрончĕн	f r ˈɔ n t͡ʃ (͡e͡n)ˌiːbɹˈiːv(͡c͡v) n
Хальхи	xˈalxɪ
виçĕ	v ˈɪ (͡e͡n)sˌiːsədˈɪlɐ ˌiːbɹˈiːv(͡c͡v)
вăрçă	v (͡e͡n)ˌe͡ɪbɹˈiːv(͡c͡v) r (͡e͡n)sˌiːsədˈɪlɐ ˌe͡ɪbɹˈiːv(͡c͡v)
юлнă	jˈʊ l n (͡e͡n)ˌe͡ɪbɹˈiːv(͡c͡v)
ячĕллĕ	jˈa t͡ʃ (͡e͡n)ˌiːbɹˈiːv(͡c͡v) l l (͡e͡n)ˌiːbɹˈiːv(͡c͡v)
çынсем	(͡e͡n)sˌiːsədˈɪlɐ(͡c͡v) ˈɯ n s jˈæ m
Беларуç	b jˈæ l ˈa r ˈʊ (͡e͡n)sˌiːsədˈɪlɐ(͡c͡v)
янă	jˈa n (͡e͡n)ˌe͡ɪbɹˈiːv(͡c͡v)
Чи	t͡ʃˈɪ
лартнă	l ˈa r t n (͡e͡n)ˌe͡ɪbɹˈiːv(͡c͡v)
ят	jˈat
çавăн	(͡e͡n)sˌiːsədˈɪlɐ(͡c͡v) ˈa v (͡e͡n)ˌe͡ɪbɹˈiːv(͡c͡v) n
çинчи	(͡e͡n)sˌiːsədˈɪlɐ(͡c͡v) ˈɪ n t͡ʃ ˈɪ
Халĕ	x ˈa l (͡e͡n)ˌiːbɹˈiːv(͡c͡v)
хальхи	xˈalxɪ
çĕнĕ	(͡e͡n)sˌiːsədˈɪlɐ ˌiːbɹˈiːv(͡c͡v) n (͡e͡n)ˌiːbɹˈiːv(͡c͡v)
пулин	pˈulɪn
çапла	(͡e͡n)sˌiːsədˈɪlɐ(͡c͡v) ˈa p l ˈa
пулаççĕ	p ˈʊ l ˈa (͡e͡n)sˌiːsədˈɪlɐ sˌiːsədˈɪlɐ ˌiːbɹˈiːv(͡c͡v)
хăйсен	x (͡e͡n)ˌe͡ɪbɹˈiːv(͡c͡v) j s jˈæ n
ĕнтĕ	(͡e͡n)ˌiːbɹˈiːv(͡c͡v) n t (͡e͡n)ˌiːbɹˈiːv(͡c͡v)
енĕпе	jˈæ n (͡e͡n)ˌiːbɹˈiːv(͡c͡v) p jˈɛ
енче	jˈænt͡ʃɛ
хăйне	x (͡e͡n)ˌe͡ɪbɹˈiːv(͡c͡v) j n jˈɛ
кĕреççĕ	k (͡e͡n)ˌiːbɹˈiːv(͡c͡v) r jˈɛ (͡e͡n)sˌiːsədˈɪlɐ sˌiːsədˈɪlɐ ˌiːbɹˈiːv(͡c͡v)
шкул	ʃkˈʊl
Районта	rajˈɔnta
курма	kˈʊrma
тухса	tˈʊxsa
чух	t͡ʃˈʊx
Çурçĕр	(͡e͡n)sˌiːsədˈɪlɐ(͡c͡v) ˈʊ r (͡e͡n)sˌiːsədˈɪlɐ ˌiːbɹˈiːv(͡c͡v) r
ĕçлет	(͡e͡n)ˌiːbɹˈiːv sˌiːsədˈɪlɐ(͡c͡v) l jˈɛ t
каять	kˈajat
сахал	sˈaxal
кашни	kˈaʃnɪ
Вĕсем	v (͡e͡n)ˌiːbɹˈiːv(͡c͡v) s jˈæ m
Кунта	kˈʊnta
урлă	ˈʊ r l (͡e͡n)ˌe͡ɪbɹˈiːv(͡c͡v)
шучĕ	ʃ ˈʊ t͡ʃ (͡e͡n)ˌiːbɹˈiːv(͡c͡v)
ялĕ	jˈa l (͡e͡n)ˌiːbɹˈiːv(͡c͡v)
Александр	alˈɛksandr
тесен	tˈɛsɛn
Ял	jˈal
Николай	nikˈolaj
тĕслĕ	t (͡e͡n)ˌiːbɹˈiːv(͡c͡v) s l (͡e͡n)ˌiːbɹˈiːv(͡c͡v)
Республикин	rˌɛspʊblˈikɪn
пĕлӳ	p (͡e͡n)ˌiːbɹˈiːv(͡c͡v) l ˈø
пирĕн	p ˈɪ r (͡e͡n)ˌiːbɹˈiːv(͡c͡v) n
Çапла	(͡e͡n)sˌiːsədˈɪlɐ(͡c͡v) ˈa p l ˈa
кĕртнĕ	k (͡e͡n)ˌiːbɹˈiːv(͡c͡v) r t n (͡e͡n)ˌiːbɹˈiːv(͡c͡v)
кирлĕ	k ˈɪ r l (͡e͡n)ˌiːbɹˈiːv(͡c͡v)
Район	rˈajɔn
евĕр	jˈɛ v (͡e͡n)ˌiːbɹˈiːv(͡c͡v) r
ĕçе	(͡e͡n)ˌiːbɹˈiːv sˌiːsədˈɪlɐ(͡c͡v) jˈɛ
вырăнта	v ˈɯ r (͡e͡n)ˌe͡ɪbɹˈiːv(͡c͡v) n t ˈa
килнĕ	k ˈɪ l n (͡e͡n)ˌiːbɹˈiːv(͡c͡v)
млн	mln
районĕнчи	r ˈa j ˈɔ n (͡e͡n)ˌiːbɹˈiːv(͡c͡v) n t͡ʃ ˈɪ
тăван	t (͡e͡n)ˌe͡ɪbɹˈiːv(͡c͡v) v ˈa n
таран	tˈaɾan
СССР	sssr
вилнĕ	v ˈɪ l n (͡e͡n)ˌiːbɹˈiːv(͡c͡v)
тивĕçлĕ	t ˈɪ v (͡e͡n)ˌiːbɹˈiːv sˌiːsədˈɪlɐ(͡c͡v) l (͡e͡n)ˌiːbɹˈiːv(͡c͡v)
курнă	k ˈʊ r n (͡e͡n)ˌe͡ɪbɹˈiːv(͡c͡v)
илме	ˈɪlmɛ
лайăх	l ˈa j (͡e͡n)ˌe͡ɪbɹˈiːv(͡c͡v) x
сăмах	s (͡e͡n)ˌe͡ɪbɹˈiːv(͡c͡v) m ˈa x
çырса	(͡e͡n)sˌiːsədˈɪlɐ(͡c͡v) ˈɯ r s ˈa
тăваççĕ	t (͡e͡n)ˌe͡ɪbɹˈiːv(͡c͡v) v ˈa (͡e͡n)sˌiːsədˈɪlɐ sˌiːsədˈɪlɐ ˌiːbɹˈiːv(͡c͡v)
çулсенче	(͡e͡n)sˌiːsədˈɪlɐ(͡c͡v) ˈʊ l s jˈæ n t͡ʃ jˈɛ
кăтартнă	k (͡e͡n)ˌe͡ɪbɹˈiːv(͡c͡v) t ˈa r t n (͡e͡n)ˌe͡ɪbɹˈiːv(͡c͡v)
çухрăм	(͡e͡n)sˌiːsədˈɪlɐ(͡c͡v) ˈʊ x r (͡e͡n)ˌe͡ɪbɹˈiːv(͡c͡v) m
куçса	k ˈʊ (͡e͡n)sˌiːsədˈɪlɐ(͡c͡v) s ˈa
культура	kʊltˈuɾa
палăртнă	p ˈa l (͡e͡n)ˌe͡ɪbɹˈiːv(͡c͡v) r t n (͡e͡n)ˌe͡ɪbɹˈiːv(͡c͡v)
чукун	t͡ʃˈukʊn
вăхăтĕнче	v (͡e͡n)ˌe͡ɪbɹˈiːv(͡c͡v) x (͡e͡n)ˌe͡ɪbɹˈiːv(͡c͡v) t (͡e͡n)ˌiːbɹˈiːv(͡c͡v) n t͡ʃ jˈɛ
вĕренсе	v (͡e͡n)ˌiːbɹˈiːv(͡c͡v) r jˈæ n s jˈɛ
ятарлă	jˈa t ˈa r l (͡e͡n)ˌe͡ɪbɹˈiːv(͡c͡v)
Çĕр	(͡e͡n)sˌiːsədˈɪlɐ ˌiːbɹˈiːv(͡c͡v) r
Кăнтăр	k (͡e͡n)ˌe͡ɪbɹˈiːv(͡c͡v) n t (͡e͡n)ˌe͡ɪbɹˈiːv(͡c͡v) r
кайран	kˈajran
совет	sˈovɛt
теме	tˈɛmɛ
йышăннă	j ˈɯ ʃ (͡e͡n)ˌe͡ɪbɹˈiːv(͡c͡v) n n (͡e͡n)ˌe͡ɪbɹˈiːv(͡c͡v)
парать	pˈaɾat
тĕнче	t (͡e͡n)ˌiːbɹˈiːv(͡c͡v) n t͡ʃ jˈɛ
тытăннă	t ˈɯ t (͡e͡n)ˌe͡ɪbɹˈiːv(͡c͡v) n n (͡e͡n)ˌe͡ɪbɹˈiːv(͡c͡v)
хутшăннă	x ˈʊ t ʃ (͡e͡n)ˌe͡ɪbɹˈiːv(͡c͡v) n n (͡e͡n)ˌe͡ɪbɹˈiːv(͡c͡v)
çыхăннă	(͡e͡n)sˌiːsədˈɪlɐ(͡c͡v) ˈɯ x (͡e͡n)ˌe͡ɪbɹˈiːv(͡c͡v) n n (͡e͡n)ˌe͡ɪbɹˈiːv(͡c͡v)
ĕçне	(͡e͡n)ˌiːbɹˈiːv sˌiːsədˈɪlɐ(͡c͡v) n jˈɛ
Авалхи	avˈalxɪ
хушшинчи	xʊʃʃˈɪnt͡ʃɪ
АПШ	ˈapʃ
пуçлăхĕ	p ˈʊ (͡e͡n)sˌiːsədˈɪlɐ(͡c͡v) l (͡e͡n)ˌe͡ɪbɹˈiːv(͡c͡v) x (͡e͡n)ˌiːbɹˈiːv(͡c͡v)
хĕрринче	x (͡e͡n)ˌiːbɹˈiːv(͡c͡v) r r ˈɪ n t͡ʃ jˈɛ
ятпа	jˈatpa
çавăнпа	(͡e͡n)sˌiːsədˈɪlɐ(͡c͡v) ˈa v (͡e͡n)ˌe͡ɪbɹˈiːv(͡c͡v) n p ˈa
Франци	frˈant͡sɪ
вăй	v (͡e͡n)ˌe͡ɪbɹˈiːv(͡c͡v) j
пурĕ	p ˈʊ r (͡e͡n)ˌiːbɹˈiːv(͡c͡v)
çм	(͡e͡n)sˌiːsədˈɪlɐ(͡c͡v) m
Департамент	dˌɛpartˈamɛnt
Мускав	mˈʊskav
чăвашла	t͡ʃ (͡e͡n)ˌe͡ɪbɹˈiːv(͡c͡v) v ˈa ʃ l ˈa
Хĕрлĕ	x (͡e͡n)ˌiːbɹˈiːv(͡c͡v) r l (͡e͡n)ˌiːbɹˈiːv(͡c͡v)
каярах	kajˈaɾax
патша	pˈatʃa
хăвăрт	x (͡e͡n)ˌe͡ɪbɹˈiːv(͡c͡v) v (͡e͡n)ˌe͡ɪbɹˈiːv(͡c͡v) r t
Хула	xˈula
ашшĕ	ˈa ʃ ʃ (͡e͡n)ˌiːbɹˈiːv(͡c͡v)
малтанхи	maltˈanxɪ
наци	nˈat͡sɪ
хушши	xˈʊʃʃɪ
вăхăт	v (͡e͡n)ˌe͡ɪbɹˈiːv(͡c͡v) x (͡e͡n)ˌe͡ɪbɹˈiːv(͡c͡v) t
м	m
каялла	kajˈalla
литература	lˌitɛɾatˈuɾa
тăрăхĕ	t (͡e͡n)ˌe͡ɪbɹˈiːv(͡c͡v) r (͡e͡n)ˌe͡ɪbɹˈiːv(͡c͡v) x (͡e͡n)ˌiːbɹˈiːv(͡c͡v)
ярса	jˈarsa
ĕмĕр	(͡e͡n)ˌiːbɹˈiːv(͡c͡v) m (͡e͡n)ˌiːbɹˈiːv(͡c͡v) r
Пирĕн	p ˈɪ r (͡e͡n)ˌiːbɹˈiːv(͡c͡v) n
кĕнеке	k (͡e͡n)ˌiːbɹˈiːv(͡c͡v) n jˈɛ k jˈɛ
пĕтернĕ	p (͡e͡n)ˌiːbɹˈiːv(͡c͡v) t jˈɛ r n (͡e͡n)ˌiːbɹˈiːv(͡c͡v)
пуçласа	p ˈʊ (͡e͡n)sˌiːsədˈɪlɐ(͡c͡v) l ˈa s ˈa
пулман	pˈʊlman
тĕнчери	t (͡e͡n)ˌiːbɹˈiːv(͡c͡v) n t͡ʃ jˈɛ r ˈɪ
юлашки	julˈaʃkɪ
ача	ˈat͡ʃa
районĕ	r ˈa j ˈɔ n (͡e͡n)ˌiːbɹˈiːv(͡c͡v)
тава	tˈava
танк	tˈank
шурă	ʃ ˈʊ r (͡e͡n)ˌe͡ɪbɹˈiːv(͡c͡v)
шутланнă	ʃ ˈʊ t l ˈa n n (͡e͡n)ˌe͡ɪbɹˈiːv(͡c͡v)
ялĕнче	jˈa l (͡e͡n)ˌiːbɹˈiːv(͡c͡v) n t͡ʃ jˈɛ
иккĕмĕш	ˈɪ k k (͡e͡n)ˌiːbɹˈiːv(͡c͡v) m (͡e͡n)ˌiːbɹˈiːv(͡c͡v) ʃ
кăнтăр	k (͡e͡n)ˌe͡ɪbɹˈiːv(͡c͡v) n t (͡e͡n)ˌe͡ɪbɹˈiːv(͡c͡v) r
тăвакан	t (͡e͡n)ˌe͡ɪbɹˈiːv(͡c͡v) v ˈa k ˈa n
хатĕрленĕ	x ˈa t (͡e͡n)ˌiːbɹˈiːv(͡c͡v) r l jˈæ n (͡e͡n)ˌiːbɹˈiːv(͡c͡v)
чĕлхе	t͡ʃ (͡e͡n)ˌiːbɹˈiːv(͡c͡v) l x jˈɛ
шутра	ʃˈʊtra
ĕçĕ	(͡e͡n)ˌiːbɹˈiːv sˌiːsədˈɪlɐ ˌiːbɹˈiːv(͡c͡v)
Унта	ˈʊnta
вăхăтрах	v (͡e͡n)ˌe͡ɪbɹˈiːv(͡c͡v) x (͡e͡n)ˌe͡ɪbɹˈiːv(͡c͡v) t r ˈa x
илет	ˈilɛt
уйăхĕн	ˈʊ j (͡e͡n)ˌe͡ɪbɹˈiːv(͡c͡v) x (͡e͡n)ˌiːbɹˈiːv(͡c͡v) n
юнашар	junˈaʃar
Хулара	xulˈaɾa
анлă	ˈa n l (͡e͡n)ˌe͡ɪbɹˈiːv(͡c͡v)
йывăр	j ˈɯ v (͡e͡n)ˌe͡ɪbɹˈiːv(͡c͡v) r
хĕрлĕ	x (͡e͡n)ˌiːbɹˈiːv(͡c͡v) r l (͡e͡n)ˌiːbɹˈiːv(͡c͡v)
Çапах	(͡e͡n)sˌiːsədˈɪlɐ(͡c͡v) ˈa p ˈa x
çурçĕр	(͡e͡n)sˌiːsədˈɪlɐ(͡c͡v) ˈʊ r (͡e͡n)sˌiːsədˈɪlɐ ˌiːbɹˈiːv(͡c͡v) r
Анăç	ˈa n (͡e͡n)ˌe͡ɪbɹˈiːv sˌiːsədˈɪlɐ(͡c͡v)
Иван	ˈivan
Ялта	jˈalta
вырăнти	v ˈɯ r (͡e͡n)ˌe͡ɪbɹˈiːv(͡c͡v) n t ˈɪ
уйрăлса	ˈʊ j r (͡e͡n)ˌe͡ɪbɹˈiːv(͡c͡v) l s ˈa
хăш	x (͡e͡n)ˌe͡ɪbɹˈiːv(͡c͡v) ʃ
Иванович	ˌivanˈovɪt͡ʃ
вырăнĕнче	v ˈɯ r (͡e͡n)ˌe͡ɪbɹˈiːv(͡c͡v) n (͡e͡n)ˌiːbɹˈiːv(͡c͡v) n t͡ʃ jˈɛ
йышне	jˈɯʃnɛ
кĕрекен	k (͡e͡n)ˌiːbɹˈiːv(͡c͡v) r jˈɛ k jˈæ n
мĕнле	m (͡e͡n)ˌiːbɹˈiːv(͡c͡v) n l jˈɛ
сарăлнă	s ˈa r (͡e͡n)ˌe͡ɪbɹˈiːv(͡c͡v) l n (͡e͡n)ˌe͡ɪbɹˈiːv(͡c͡v)
тăракан	t (͡e͡n)ˌe͡ɪbɹˈiːv(͡c͡v) r ˈa k ˈa n
Атăл	ˈa t (͡e͡n)ˌe͡ɪbɹˈiːv(͡c͡v) l
Пĕр	p (͡e͡n)ˌiːbɹˈiːv(͡c͡v) r
иртнĕ	ˈɪ r t n (͡e͡n)ˌiːbɹˈiːv(͡c͡v)
никĕсленĕ	n ˈɪ k (͡e͡n)ˌiːbɹˈiːv(͡c͡v) s l jˈæ n (͡e͡n)ˌiːbɹˈiːv(͡c͡v)
тăраççĕ	t (͡e͡n)ˌe͡ɪbɹˈiːv(͡c͡v) r ˈa (͡e͡n)sˌiːsədˈɪlɐ sˌiːsədˈɪlɐ ˌiːbɹˈiːv(͡c͡v)
çитнĕ	(͡e͡n)sˌiːsədˈɪlɐ(͡c͡v) ˈɪ t n (͡e͡n)ˌiːbɹˈiːv(͡c͡v)
ĕçĕсене	(͡e͡n)ˌiːbɹˈiːv sˌiːsədˈɪlɐ ˌiːbɹˈiːv(͡c͡v) s jˈæ n jˈɛ
Вырăс	v ˈɯ r (͡e͡n)ˌe͡ɪbɹˈiːv(͡c͡v) s
Малтан	mˈaltan
вăрман	v (͡e͡n)ˌe͡ɪbɹˈiːv(͡c͡v) r m ˈa n
пулас	pˈulas
эрăччен	ˈɛ r (͡e͡n)ˌe͡ɪbɹˈiːv(͡c͡v) t͡ʃ t͡ʃ jˈæ n
Тăван	t (͡e͡n)ˌe͡ɪbɹˈiːv(͡c͡v) v ˈa n
метр	mˈɛtr
пĕлтерет	p (͡e͡n)ˌiːbɹˈiːv(͡c͡v) l t jˈɛ r jˈɛ t
пыракан	pɯɾˈakan
чĕлхине	t͡ʃ (͡e͡n)ˌiːbɹˈiːv(͡c͡v) l x ˈɪ n jˈɛ
Китай	kˈitaj
Тепĕр	t jˈɛ p (͡e͡n)ˌiːbɹˈiːv(͡c͡v) r
Хăйĕн	x (͡e͡n)ˌe͡ɪbɹˈiːv(͡c͡v) j (͡e͡n)ˌiːbɹˈiːv(͡c͡v) n
пурăнаççĕ	p ˈʊ r (͡e͡n)ˌe͡ɪbɹˈiːv(͡c͡v) n ˈa (͡e͡n)sˌiːsədˈɪlɐ sˌiːsədˈɪlɐ ˌiːbɹˈiːv(͡c͡v)
тени	tˈɛnɪ
Канада	kanˈada
куçарнă	k ˈʊ (͡e͡n)sˌiːsədˈɪlɐ(͡c͡v) ˈa r n (͡e͡n)ˌe͡ɪbɹˈiːv(͡c͡v)
ӳнер	ˈynɛr
çити	(͡e͡n)sˌiːsədˈɪlɐ(͡c͡v) ˈɪ t ˈɪ
ĕмĕрĕн	(͡e͡n)ˌiːbɹˈiːv(͡c͡v) m (͡e͡n)ˌiːbɹˈiːv(͡c͡v) r (͡e͡n)ˌiːbɹˈiːv(͡c͡v) n
йышăнать	j ˈɯ ʃ (͡e͡n)ˌe͡ɪbɹˈiːv(͡c͡v) n ˈa t
нимĕç	n ˈɪ m (͡e͡n)ˌiːbɹˈiːv sˌiːsədˈɪlɐ(͡c͡v)
территорипе	tˌɛrritoɾˈipɛ
фронтăн	f r ˈɔ n t (͡e͡n)ˌe͡ɪbɹˈiːv(͡c͡v) n
хуçалăх	x ˈʊ (͡e͡n)sˌiːsədˈɪlɐ(͡c͡v) ˈa l (͡e͡n)ˌe͡ɪbɹˈiːv(͡c͡v) x
Çаплах	(͡e͡n)sˌiːsədˈɪlɐ(͡c͡v) ˈa p l ˈa x
амăшĕ	ˈa m (͡e͡n)ˌe͡ɪbɹˈiːv(͡c͡v) ʃ (͡e͡n)ˌiːbɹˈiːv(͡c͡v)
каланă	k ˈa l ˈa n (͡e͡n)ˌe͡ɪbɹˈiːv(͡c͡v)
каласа	kalˈasa
облаçĕн	ˈɔ b l ˈa (͡e͡n)sˌiːsədˈɪlɐ ˌiːbɹˈiːv(͡c͡v) n
Вĕсен	v (͡e͡n)ˌiːbɹˈiːv(͡c͡v) s jˈæ n
Владимир	vladˈimɪr
вĕренме	v (͡e͡n)ˌiːbɹˈiːv(͡c͡v) r jˈæ n m jˈɛ
пулнӑ	pˈʊlnɯ
пултарнă	p ˈʊ l t ˈa r n (͡e͡n)ˌe͡ɪbɹˈiːv(͡c͡v)
ывăлĕ	ˈɯ v (͡e͡n)ˌe͡ɪbɹˈiːv(͡c͡v) l (͡e͡n)ˌiːbɹˈiːv(͡c͡v)
артиллери	ˌartɪllˈɛɾɪ
вырăнĕ	v ˈɯ r (͡e͡n)ˌe͡ɪbɹˈiːv(͡c͡v) n (͡e͡n)ˌiːbɹˈiːv(͡c͡v)
иккĕ	ˈɪ k k (͡e͡n)ˌiːbɹˈiːv(͡c͡v)
йĕркеленĕ	j (͡e͡n)ˌiːbɹˈiːv(͡c͡v) r k jˈæ l jˈæ n (͡e͡n)ˌiːbɹˈiːv(͡c͡v)
пайташĕ	p ˈa j t ˈa ʃ (͡e͡n)ˌiːbɹˈiːv(͡c͡v)
пама	pˈama
пуçланса	p ˈʊ (͡e͡n)sˌiːsədˈɪlɐ(͡c͡v) l ˈa n s ˈa
хутчен	xˈʊtt͡ʃɛn
çитет	(͡e͡n)sˌiːsədˈɪlɐ(͡c͡v) ˈɪ t jˈɛ t
Вăтам	v (͡e͡n)ˌe͡ɪbɹˈiːv(͡c͡v) t ˈa m
Итали	itˈalɪ
урамĕ	ˈʊ r ˈa m (͡e͡n)ˌiːbɹˈiːv(͡c͡v)
чăвашсем	t͡ʃ (͡e͡n)ˌe͡ɪbɹˈiːv(͡c͡v) v ˈa ʃ s jˈæ m
çапах	(͡e͡n)sˌiːsədˈɪlɐ(͡c͡v) ˈa p ˈa x
Вăта	v (͡e͡n)ˌe͡ɪbɹˈiːv(͡c͡v) t ˈa
кура	kˈuɾa
уйăхĕнче	ˈʊ j (͡e͡n)ˌe͡ɪbɹˈiːv(͡c͡v) x (͡e͡n)ˌiːbɹˈiːv(͡c͡v) n t͡ʃ jˈɛ
япала	japˈala
Çавăнпа	(͡e͡n)sˌiːsədˈɪlɐ(͡c͡v) ˈa v (͡e͡n)ˌe͡ɪbɹˈiːv(͡c͡v) n p ˈa
Çакăн	(͡e͡n)sˌiːsədˈɪlɐ(͡c͡v) ˈa k (͡e͡n)ˌe͡ɪbɹˈiːv(͡c͡v) n
кĕрсе	k (͡e͡n)ˌiːbɹˈiːv(͡c͡v) r s jˈɛ
мĕн	m (͡e͡n)ˌiːbɹˈiːv(͡c͡v) n
тĕпĕ	t (͡e͡n)ˌiːbɹˈiːv(͡c͡v) p (͡e͡n)ˌiːbɹˈiːv(͡c͡v)
çакăн	(͡e͡n)sˌiːsədˈɪlɐ(͡c͡v) ˈa k (͡e͡n)ˌe͡ɪbɹˈiːv(͡c͡v) n
çулĕ	(͡e͡n)sˌiːsədˈɪlɐ(͡c͡v) ˈʊ l (͡e͡n)ˌiːbɹˈiːv(͡c͡v)
Хура	xˈuɾa
кĕçĕн	k (͡e͡n)ˌiːbɹˈiːv sˌiːsədˈɪlɐ ˌiːbɹˈiːv(͡c͡v) n
тери	tˈɛɾɪ
хăшпĕр	x (͡e͡n)ˌe͡ɪbɹˈiːv(͡c͡v) ʃ p (͡e͡n)ˌiːbɹˈiːv(͡c͡v) r
вырăсла	v ˈɯ r (͡e͡n)ˌe͡ɪbɹˈiːv(͡c͡v) s l ˈa
илеççĕ	ˈɪ l jˈɛ (͡e͡n)sˌiːsədˈɪlɐ sˌiːsədˈɪlɐ ˌiːbɹˈiːv(͡c͡v)
корпусĕн	k ˈɔ r p ˈʊ s (͡e͡n)ˌiːbɹˈiːv(͡c͡v) n
тухăç	t ˈʊ x (͡e͡n)ˌe͡ɪbɹˈiːv sˌiːsədˈɪlɐ(͡c͡v)
шкулĕнче	ʃ k ˈʊ l (͡e͡n)ˌiːbɹˈiːv(͡c͡v) n t͡ʃ jˈɛ
çапса	(͡e͡n)sˌiːsədˈɪlɐ(͡c͡v) ˈa p s ˈa
çултан	(͡e͡n)sˌiːsədˈɪlɐ(͡c͡v) ˈʊ l t ˈa n
Шупашкар	ʃupˈaʃkar
анăç	ˈa n (͡e͡n)ˌe͡ɪbɹˈiːv sˌiːsədˈɪlɐ(͡c͡v)
вĕçĕнче	v (͡e͡n)ˌiːbɹˈiːv sˌiːsədˈɪlɐ ˌiːbɹˈiːv(͡c͡v) n t͡ʃ jˈɛ
иртет	ˈɪrtɛt
лейтенант	lɛjtˈɛnant
мĕншĕн	m (͡e͡n)ˌiːbɹˈiːv(͡c͡v) n ʃ (͡e͡n)ˌiːbɹˈiːv(͡c͡v) n
официаллă	ˈɔ f ˈɪ t͡s ˈɪ ˈa l l (͡e͡n)ˌe͡ɪbɹˈiːv(͡c͡v)
пайне	pˈajnɛ
центрĕ	t͡s jˈæ n t r (͡e͡n)ˌiːbɹˈiːv(͡c͡v)
чĕлхипе	t͡ʃ (͡e͡n)ˌiːbɹˈiːv(͡c͡v) l x ˈɪ p jˈɛ
çĕре	(͡e͡n)sˌiːsədˈɪlɐ ˌiːbɹˈiːv(͡c͡v) r jˈɛ
ĕçĕсем	(͡e͡n)ˌiːbɹˈiːv sˌiːsədˈɪlɐ ˌiːbɹˈiːv(͡c͡v) s jˈæ m
Вăрçă	v (͡e͡n)ˌe͡ɪbɹˈiːv(͡c͡v) r (͡e͡n)sˌiːsədˈɪlɐ ˌe͡ɪbɹˈiːv(͡c͡v)
Василий	vasˈilɪj
Васильевич	vˌasɪlʲˈɛvɪt͡ʃ
майлă	m ˈa j l (͡e͡n)ˌe͡ɪbɹˈiːv(͡c͡v)
районĕн	r ˈa j ˈɔ n (͡e͡n)ˌiːbɹˈiːv(͡c͡v) n
Кашни	kˈaʃnɪ
кăтартать	k (͡e͡n)ˌe͡ɪbɹˈiːv(͡c͡v) t ˈa r t ˈa t
пурăнакан	p ˈʊ r (͡e͡n)ˌe͡ɪbɹˈiːv(͡c͡v) n ˈa k ˈa n
тупнă	t ˈʊ p n (͡e͡n)ˌe͡ɪbɹˈiːv(͡c͡v)
тӗп	tˈɵp
ĕçлеме	(͡e͡n)ˌiːbɹˈiːv sˌiːsədˈɪlɐ(͡c͡v) l jˈæ m jˈɛ
ĕçченĕ	(͡e͡n)ˌiːbɹˈiːv sˌiːsədˈɪlɐ(͡c͡v) t͡ʃ jˈæ n (͡e͡n)ˌiːbɹˈiːv(͡c͡v)
Икĕ	ˈɪ k (͡e͡n)ˌiːbɹˈiːv(͡c͡v)
Кайран	kˈajran
Рим	rˈɪm
вăйлă	v (͡e͡n)ˌe͡ɪbɹˈiːv(͡c͡v) j l (͡e͡n)ˌe͡ɪbɹˈiːv(͡c͡v)
илсен	ˈɪlsɛn
каллех	kˈallɛx
пурăнма	p ˈʊ r (͡e͡n)ˌe͡ɪbɹˈiːv(͡c͡v) n m ˈa
сывлăш	s ˈɯ v l (͡e͡n)ˌe͡ɪbɹˈiːv(͡c͡v) ʃ
тĕсĕ	t (͡e͡n)ˌiːbɹˈiːv(͡c͡v) s (͡e͡n)ˌiːbɹˈiːv(͡c͡v)
ту	tˈʊ
хулана	xulˈana
чăн	t͡ʃ (͡e͡n)ˌe͡ɪbɹˈiːv(͡c͡v) n
çарĕсем	(͡e͡n)sˌiːsədˈɪlɐ(͡c͡v) ˈa r (͡e͡n)ˌiːbɹˈiːv(͡c͡v) s jˈæ m
çурчĕ	(͡e͡n)sˌiːsədˈɪlɐ(͡c͡v) ˈʊ r t͡ʃ (͡e͡n)ˌiːbɹˈiːv(͡c͡v)
асăннă	ˈa s (͡e͡n)ˌe͡ɪbɹˈiːv(͡c͡v) n n (͡e͡n)ˌe͡ɪbɹˈiːv(͡c͡v)
педагогика	pˌɛdaɡoɡˈika
пултараççĕ	p ˈʊ l t ˈa r ˈa (͡e͡n)sˌiːsədˈɪlɐ sˌiːsədˈɪlɐ ˌiːbɹˈiːv(͡c͡v)
шкулта	ʃkˈʊlta
вĕсенчен	v (͡e͡n)ˌiːbɹˈiːv(͡c͡v) s jˈæ n t͡ʃ jˈæ n
курăнать	k ˈʊ r (͡e͡n)ˌe͡ɪbɹˈiːv(͡c͡v) n ˈa t
патши	pˈatʃɪ
паха	pˈaxa
политика	pˌolitˈika
сăмахран	s (͡e͡n)ˌe͡ɪbɹˈiːv(͡c͡v) m ˈa x r ˈa n
танлашать	tanlˈaʃat
ĕмĕрте	(͡e͡n)ˌiːbɹˈiːv(͡c͡v) m (͡e͡n)ˌiːbɹˈiːv(͡c͡v) r t jˈɛ
Шыв	ʃˈɯv
ертӳçи	jˈɛ r t ˈø (͡e͡n)sˌiːsədˈɪlɐ(͡c͡v) ˈɪ
тăрăшнă	t (͡e͡n)ˌe͡ɪbɹˈiːv(͡c͡v) r (͡e͡n)ˌe͡ɪbɹˈiːv(͡c͡v) ʃ n (͡e͡n)ˌe͡ɪbɹˈiːv(͡c͡v)
шутласа	ʃʊtlˈasa
çула	(͡e͡n)sˌiːsədˈɪlɐ(͡c͡v) ˈʊ l ˈa
çумĕнчи	(͡e͡n)sˌiːsədˈɪlɐ(͡c͡v) ˈʊ m (͡e͡n)ˌiːbɹˈiːv(͡c͡v) n t͡ʃ ˈɪ
çывăх	(͡e͡n)sˌiːsədˈɪlɐ(͡c͡v) ˈɯ v (͡e͡n)ˌe͡ɪbɹˈiːv(͡c͡v) x
Иккĕмĕш	ˈɪ k k (͡e͡n)ˌiːbɹˈiːv(͡c͡v) m (͡e͡n)ˌiːbɹˈiːv(͡c͡v) ʃ
Ленин	lˈɛnɪn
Шупашкарти	ʃˌupaʃkˈartɪ
варринче	varrˈɪnt͡ʃɛ
епле	jˈɛplɛ
пуян	pˈujan
уçнă	ˈʊ (͡e͡n)sˌiːsədˈɪlɐ(͡c͡v) n (͡e͡n)ˌe͡ɪbɹˈiːv(͡c͡v)
чаплă	t͡ʃ ˈa p l (͡e͡n)ˌe͡ɪbɹˈiːv(͡c͡v)
юппи	jˈʊppɪ
ялта	jˈalta
II	(͡e͡n)ˈa͡ɪ ˈa͡ɪ(͡c͡v)
çамрăк	(͡e͡n)sˌiːsədˈɪlɐ(͡c͡v) ˈa m r (͡e͡n)ˌe͡ɪbɹˈiːv(͡c͡v) k
çумне	(͡e͡n)sˌiːsədˈɪlɐ(͡c͡v) ˈʊ m n jˈɛ
Нумай	nˈumaj
Пĕтĕм	p (͡e͡n)ˌiːbɹˈiːv(͡c͡v) t (͡e͡n)ˌiːbɹˈiːv(͡c͡v) m
Тури	tˈuɾɪ
Тухăç	t ˈʊ x (͡e͡n)ˌe͡ɪbɹˈiːv sˌiːsədˈɪlɐ(͡c͡v)
вырăна	v ˈɯ r (͡e͡n)ˌe͡ɪbɹˈiːv(͡c͡v) n ˈa
енне	jˈænnɛ
облаçĕ	ˈɔ b l ˈa (͡e͡n)sˌiːsədˈɪlɐ ˌiːbɹˈiːv(͡c͡v)
пине	pˈinɛ
тивĕçнĕ	t ˈɪ v (͡e͡n)ˌiːbɹˈiːv sˌiːsədˈɪlɐ(͡c͡v) n (͡e͡n)ˌiːbɹˈiːv(͡c͡v)
çумĕнче	(͡e͡n)sˌiːsədˈɪlɐ(͡c͡v) ˈʊ m (͡e͡n)ˌiːbɹˈiːv(͡c͡v) n t͡ʃ jˈɛ
Патшалăх	p ˈa t ʃ ˈa l (͡e͡n)ˌe͡ɪbɹˈiːv(͡c͡v) x
ларнă	l ˈa r n (͡e͡n)ˌe͡ɪbɹˈiːv(͡c͡v)
малалла	malˈalla
пулнине	pʊlnˈinɛ
пулнипе	pʊlnˈipɛ
уйрăмах	ˈʊ j r (͡e͡n)ˌe͡ɪbɹˈiːv(͡c͡v) m ˈa x
хулара	xulˈaɾa
вӑл	vˈɯl
килет	kˈilɛt
пĕлтерĕшлĕ	p (͡e͡n)ˌiːbɹˈiːv(͡c͡v) l t jˈɛ r (͡e͡n)ˌiːbɹˈiːv(͡c͡v) ʃ l (͡e͡n)ˌiːbɹˈiːv(͡c͡v)
пайĕнче	p ˈa j (͡e͡n)ˌiːbɹˈiːv(͡c͡v) n t͡ʃ jˈɛ
палли	pˈallɪ
район	rˈajɔn
тапхăрĕнче	t ˈa p x (͡e͡n)ˌe͡ɪbɹˈiːv(͡c͡v) r (͡e͡n)ˌiːbɹˈiːv(͡c͡v) n t͡ʃ jˈɛ
тулли	tˈʊllɪ
хайланă	x ˈa j l ˈa n (͡e͡n)ˌe͡ɪbɹˈiːv(͡c͡v)
хастар	xˈastar
ячĕпе	jˈa t͡ʃ (͡e͡n)ˌiːbɹˈiːv(͡c͡v) p jˈɛ
çумĕ	(͡e͡n)sˌiːsədˈɪlɐ(͡c͡v) ˈʊ m (͡e͡n)ˌiːbɹˈiːv(͡c͡v)
çынна	(͡e͡n)sˌiːsədˈɪlɐ(͡c͡v) ˈɯ n n ˈa
çыннисем	(͡e͡n)sˌiːsədˈɪlɐ(͡c͡v) ˈɯ n n ˈɪ s jˈæ m
çынсене	(͡e͡n)sˌiːsədˈɪlɐ(͡c͡v) ˈɯ n s jˈæ n jˈɛ
Ашшĕ	ˈa ʃ ʃ (͡e͡n)ˌiːbɹˈiːv(͡c͡v)
пулни	pˈʊlnɪ
пырса	pˈɯrsa
тытăнать	t ˈɯ t (͡e͡n)ˌe͡ɪbɹˈiːv(͡c͡v) n ˈa t
ушкăнĕ	ˈʊ ʃ k (͡e͡n)ˌe͡ɪbɹˈiːv(͡c͡v) n (͡e͡n)ˌiːbɹˈiːv(͡c͡v)
хура	xˈuɾa
шутланă	ʃ ˈʊ t l ˈa n (͡e͡n)ˌe͡ɪbɹˈiːv(͡c͡v)
çирĕплетнĕ	(͡e͡n)sˌiːsədˈɪlɐ(͡c͡v) ˈɪ r (͡e͡n)ˌiːbɹˈiːv(͡c͡v) p l jˈɛ t n (͡e͡n)ˌiːbɹˈiːv(͡c͡v)
çм²	(͡e͡n)sˌiːsədˈɪlɐ(͡c͡v) m (͡e͡n)tˈuː(͡c͡v)
Вĕсене	v (͡e͡n)ˌiːbɹˈiːv(͡c͡v) s jˈæ n jˈɛ
Каярах	kajˈaɾax
и	ˈɪ
кăларса	k (͡e͡n)ˌe͡ɪbɹˈiːv(͡c͡v) l ˈa r s ˈa
ларать	lˈaɾat
пĕтерекен	p (͡e͡n)ˌiːbɹˈiːv(͡c͡v) t jˈɛ r jˈɛ k jˈæ n
таса	tˈasa
усӑ	ˈusɯ
ярать	jˈaɾat
çитме	(͡e͡n)sˌiːsədˈɪlɐ(͡c͡v) ˈɪ t m jˈɛ
Лаптăкĕ	l ˈa p t (͡e͡n)ˌe͡ɪbɹˈiːv(͡c͡v) k (͡e͡n)ˌiːbɹˈiːv(͡c͡v)
институтĕнче	ˈɪ n s t ˈɪ t ˈʊ t (͡e͡n)ˌiːbɹˈiːv(͡c͡v) n t͡ʃ jˈɛ
параççĕ	p ˈa r ˈa (͡e͡n)sˌiːsədˈɪlɐ sˌiːsədˈɪlɐ ˌiːbɹˈiːv(͡c͡v)
патнелле	patnˈɛllɛ
пурнăç	p ˈʊ r n (͡e͡n)ˌe͡ɪbɹˈiːv sˌiːsədˈɪlɐ(͡c͡v)
см	sm
тытăнса	t ˈɯ t (͡e͡n)ˌe͡ɪbɹˈiːv(͡c͡v) n s ˈa
чул	t͡ʃˈʊl
çакна	(͡e͡n)sˌiːsədˈɪlɐ(͡c͡v) ˈa k n ˈa
çарĕ	(͡e͡n)sˌiːsədˈɪlɐ(͡c͡v) ˈa r (͡e͡n)ˌiːbɹˈiːv(͡c͡v)
çырма	(͡e͡n)sˌiːsədˈɪlɐ(͡c͡v) ˈɯ r m ˈa
Шурă	ʃ ˈʊ r (͡e͡n)ˌe͡ɪbɹˈiːv(͡c͡v)
алă	ˈa l (͡e͡n)ˌe͡ɪbɹˈiːv(͡c͡v)
евĕрлĕ	jˈɛ v (͡e͡n)ˌiːbɹˈiːv(͡c͡v) r l (͡e͡n)ˌiːbɹˈiːv(͡c͡v)
куçнă	k ˈʊ (͡e͡n)sˌiːsədˈɪlɐ(͡c͡v) n (͡e͡n)ˌe͡ɪbɹˈiːv(͡c͡v)
мĕнпур	m (͡e͡n)ˌiːbɹˈiːv(͡c͡v) n p ˈʊ r
палăртаççĕ	p ˈa l (͡e͡n)ˌe͡ɪbɹˈiːv(͡c͡v) r t ˈa (͡e͡n)sˌiːsədˈɪlɐ sˌiːsədˈɪlɐ ˌiːbɹˈiːv(͡c͡v)
пуçламăшĕнче	p ˈʊ (͡e͡n)sˌiːsədˈɪlɐ(͡c͡v) l ˈa m (͡e͡n)ˌe͡ɪbɹˈiːv(͡c͡v) ʃ (͡e͡n)ˌiːbɹˈiːv(͡c͡v) n t͡ʃ jˈɛ
тăватă	t (͡e͡n)ˌe͡ɪbɹˈiːv(͡c͡v) v ˈa t (͡e͡n)ˌe͡ɪbɹˈiːv(͡c͡v)
хăварнă	x (͡e͡n)ˌe͡ɪbɹˈiːv(͡c͡v) v ˈa r n (͡e͡n)ˌe͡ɪbɹˈiːv(͡c͡v)
хытă	x ˈɯ t (͡e͡n)ˌe͡ɪbɹˈiːv(͡c͡v)
çăмăл	(͡e͡n)sˌiːsədˈɪlɐ ˌe͡ɪbɹˈiːv(͡c͡v) m (͡e͡n)ˌe͡ɪbɹˈiːv(͡c͡v) l
Николаевич	nˌikolaˈɛvɪt͡ʃ
Пурĕ	p ˈʊ r (͡e͡n)ˌiːbɹˈiːv(͡c͡v)
вĕлернĕ	v (͡e͡n)ˌiːbɹˈiːv(͡c͡v) l jˈɛ r n (͡e͡n)ˌiːbɹˈiːv(͡c͡v)
енчи	jˈænt͡ʃɪ
ирттернĕ	ˈɪ r t t jˈɛ r n (͡e͡n)ˌiːbɹˈiːv(͡c͡v)
качча	kˈat͡ʃt͡ʃa
каяççĕ	k ˈa jˈa (͡e͡n)sˌiːsədˈɪlɐ sˌiːsədˈɪlɐ ˌiːbɹˈiːv(͡c͡v)
коммуна	kɔmmˈuna
театр	tˈɛatr
тинĕсĕ	t ˈɪ n (͡e͡n)ˌiːbɹˈiːv(͡c͡v) s (͡e͡n)ˌiːbɹˈiːv(͡c͡v)
халăхĕ	x ˈa l (͡e͡n)ˌe͡ɪbɹˈiːv(͡c͡v) x (͡e͡n)ˌiːbɹˈiːv(͡c͡v)
I	(͡e͡n)ˈa͡ɪ(͡c͡v)
çĕрĕсем	(͡e͡n)sˌiːsədˈɪlɐ ˌiːbɹˈiːv(͡c͡v) r (͡e͡n)ˌiːbɹˈiːv(͡c͡v) s jˈæ m
çӳллĕ	(͡e͡n)sˌiːsədˈɪlɐ(͡c͡v) ˈø l l (͡e͡n)ˌiːbɹˈiːv(͡c͡v)
Ытларах	ɯtlˈaɾax
вылянă	v ˈɯ l jˈa n (͡e͡n)ˌe͡ɪbɹˈiːv(͡c͡v)
тутар	tˈutar
унпа	ˈʊnpa
чĕлхин	t͡ʃ (͡e͡n)ˌiːbɹˈiːv(͡c͡v) l x ˈɪ n
ялсем	jˈalsɛm
III	(͡e͡n)ˈa͡ɪ ˈa͡ɪ ˈa͡ɪ(͡c͡v)
çăлкуçĕ	(͡e͡n)sˌiːsədˈɪlɐ ˌe͡ɪbɹˈiːv(͡c͡v) l k ˈʊ (͡e͡n)sˌiːsədˈɪlɐ ˌiːbɹˈiːv(͡c͡v)
çурт	(͡e͡n)sˌiːsədˈɪlɐ(͡c͡v) ˈʊ r t
çӳренĕ	(͡e͡n)sˌiːsədˈɪlɐ(͡c͡v) ˈø r jˈæ n (͡e͡n)ˌiːbɹˈiːv(͡c͡v)
Михаил	mixˈaɪl
РФ	rf
Раççейĕн	r ˈa (͡e͡n)sˌiːsədˈɪlɐ sˌiːsədˈɪlɐ(͡c͡v) jˈɛ j (͡e͡n)ˌiːbɹˈiːv(͡c͡v) n
Хăшпĕр	x (͡e͡n)ˌe͡ɪbɹˈiːv(͡c͡v) ʃ p (͡e͡n)ˌiːbɹˈiːv(͡c͡v) r
в	v
курса	kˈʊrsa
лекнĕ	l jˈɛ k n (͡e͡n)ˌiːbɹˈiːv(͡c͡v)
пăхса	p (͡e͡n)ˌe͡ɪbɹˈiːv(͡c͡v) x s ˈa
пулмалла	pʊlmˈalla
редакторĕ	r jˈɛ d ˈa k t ˈɔ r (͡e͡n)ˌiːbɹˈiːv(͡c͡v)
укçа	ˈʊ k (͡e͡n)sˌiːsədˈɪlɐ(͡c͡v) ˈa
урамĕсем	ˈʊ r ˈa m (͡e͡n)ˌiːbɹˈiːv(͡c͡v) s jˈæ m
хăйсем	x (͡e͡n)ˌe͡ɪbɹˈiːv(͡c͡v) j s jˈæ m
хĕрарăм	x (͡e͡n)ˌiːbɹˈiːv(͡c͡v) r ˈa r (͡e͡n)ˌe͡ɪbɹˈiːv(͡c͡v) m
чиркӳ	t͡ʃˈɪrkø
юппин	jˈʊppɪn
яла	jˈala
АССР	ˈassr
Пысăк	p ˈɯ s (͡e͡n)ˌe͡ɪbɹˈiːv(͡c͡v) k
Чылай	t͡ʃˈɯlaj
мусăк	m ˈʊ s (͡e͡n)ˌe͡ɪbɹˈiːv(͡c͡v) k
пыраççĕ	p ˈɯ r ˈa (͡e͡n)sˌiːsədˈɪlɐ sˌiːsədˈɪlɐ ˌiːbɹˈiːv(͡c͡v)
Администраци	ˌadminɪstrˈat͡sɪ
Пăлхар	p (͡e͡n)ˌe͡ɪbɹˈiːv(͡c͡v) l x ˈa r
ахаль	ˈaxal
бригадин	briɡˈadɪn
вăрçи	v (͡e͡n)ˌe͡ɪbɹˈiːv(͡c͡v) r (͡e͡n)sˌiːsədˈɪlɐ(͡c͡v) ˈɪ
пĕлтернĕ	p (͡e͡n)ˌiːbɹˈiːv(͡c͡v) l t jˈɛ r n (͡e͡n)ˌiːbɹˈiːv(͡c͡v)
пушă	p ˈʊ ʃ (͡e͡n)ˌe͡ɪbɹˈiːv(͡c͡v)
пытарнă	p ˈɯ t ˈa r n (͡e͡n)ˌe͡ɪbɹˈiːv(͡c͡v)
урам	ˈuɾam
хулине	xulˈinɛ
экономика	ˌekonomˈika
этем	ˈetɛm
ĕмĕрсенче	(͡e͡n)ˌiːbɹˈiːv(͡c͡v) m (͡e͡n)ˌiːbɹˈiːv(͡c͡v) r s jˈæ n t͡ʃ jˈɛ
Британи	britˈanɪ
Иванов	ivˈanɔv
Кивĕ	k ˈɪ v (͡e͡n)ˌiːbɹˈiːv(͡c͡v)
Мускаври	mʊskˈavrɪ
аркатнă	ˈa r k ˈa t n (͡e͡n)ˌe͡ɪbɹˈiːv(͡c͡v)
истори	ɪstˈoɾɪ
кĕске	k (͡e͡n)ˌiːbɹˈiːv(͡c͡v) s k jˈɛ
паракан	paɾˈakan
пичетленĕ	p ˈɪ t͡ʃ jˈɛ t l jˈæ n (͡e͡n)ˌiːbɹˈiːv(͡c͡v)
пурнăçа	p ˈʊ r n (͡e͡n)ˌe͡ɪbɹˈiːv sˌiːsədˈɪlɐ(͡c͡v) ˈa
сасă	s ˈa s (͡e͡n)ˌe͡ɪbɹˈiːv(͡c͡v)
тăвать	t (͡e͡n)ˌe͡ɪbɹˈiːv(͡c͡v) v ˈa t
тан	tˈan
тухма	tˈʊxma
тытăнаççĕ	t ˈɯ t (͡e͡n)ˌe͡ɪbɹˈiːv(͡c͡v) n ˈa (͡e͡n)sˌiːsədˈɪlɐ sˌiːsədˈɪlɐ ˌiːbɹˈiːv(͡c͡v)
хăйсене	x (͡e͡n)ˌe͡ɪbɹˈiːv(͡c͡v) j s jˈæ n jˈɛ
хĕр	x (͡e͡n)ˌiːbɹˈiːv(͡c͡v) r
шута	ʃˈuta
çутçанталăк	(͡e͡n)sˌiːsədˈɪlɐ(͡c͡v) ˈʊ t (͡e͡n)sˌiːsədˈɪlɐ(͡c͡v) ˈa n t ˈa l (͡e͡n)ˌe͡ɪbɹˈiːv(͡c͡v) k
Михайлович	mˌixajlˈovɪt͡ʃ
Раççейри	r ˈa (͡e͡n)sˌiːsədˈɪlɐ sˌiːsədˈɪlɐ(͡c͡v) jˈɛ j r ˈɪ
айĕнче	ˈa j (͡e͡n)ˌiːbɹˈiːv(͡c͡v) n t͡ʃ jˈɛ
апат	ˈapat
витĕр	v ˈɪ t (͡e͡n)ˌiːbɹˈiːv(͡c͡v) r
кайса	kˈajsa
капитан	kapˈitan
раççей	r ˈa (͡e͡n)sˌiːsədˈɪlɐ sˌiːsədˈɪlɐ(͡c͡v) jˈɛ j
районĕнче	r ˈa j ˈɔ n (͡e͡n)ˌiːbɹˈiːv(͡c͡v) n t͡ʃ jˈɛ
тăрăхĕнче	t (͡e͡n)ˌe͡ɪbɹˈiːv(͡c͡v) r (͡e͡n)ˌe͡ɪbɹˈiːv(͡c͡v) x (͡e͡n)ˌiːbɹˈiːv(͡c͡v) n t͡ʃ jˈɛ
туртса	tˈʊrtsa
университечĕн	ˈʊ n ˈɪ v jˈɛ r s ˈɪ t jˈɛ t͡ʃ (͡e͡n)ˌiːbɹˈiːv(͡c͡v) n
унтан	ˈʊntan
яланах	jalˈanax
çĕнтерсе	(͡e͡n)sˌiːsədˈɪlɐ ˌiːbɹˈiːv(͡c͡v) n t jˈɛ r s jˈɛ
çĕрĕ	(͡e͡n)sˌiːsədˈɪlɐ ˌiːbɹˈiːv(͡c͡v) r (͡e͡n)ˌiːbɹˈiːv(͡c͡v)
çынсен	(͡e͡n)sˌiːsədˈɪlɐ(͡c͡v) ˈɯ n s jˈæ n
Анат	ˈanat
Кун	kˈʊn
Хусан	xˈusan
аталаннă	ˈa t ˈa l ˈa n n (͡e͡n)ˌe͡ɪbɹˈiːv(͡c͡v)
иртсен	ˈɪrtsɛn
йывăç	j ˈɯ v (͡e͡n)ˌe͡ɪbɹˈiːv sˌiːsədˈɪlɐ(͡c͡v)
кайăк	k ˈa j (͡e͡n)ˌe͡ɪbɹˈiːv(͡c͡v) k
пуçланать	p ˈʊ (͡e͡n)sˌiːsədˈɪlɐ(͡c͡v) l ˈa n ˈa t
пухнă	p ˈʊ x n (͡e͡n)ˌe͡ɪbɹˈiːv(͡c͡v)
тĕрлĕрен	t (͡e͡n)ˌiːbɹˈiːv(͡c͡v) r l (͡e͡n)ˌiːbɹˈiːv(͡c͡v) r jˈæ n
тапхăрта	t ˈa p x (͡e͡n)ˌe͡ɪbɹˈiːv(͡c͡v) r t ˈa
тытнă	t ˈɯ t n (͡e͡n)ˌe͡ɪbɹˈiːv(͡c͡v)
хими	xˈimɪ
хурать	xˈuɾat
чăвашсен	t͡ʃ (͡e͡n)ˌe͡ɪbɹˈiːv(͡c͡v) v ˈa ʃ s jˈæ n
шутĕнче	ʃ ˈʊ t (͡e͡n)ˌiːbɹˈiːv(͡c͡v) n t͡ʃ jˈɛ
ята	jˈata
Çавна	(͡e͡n)sˌiːsədˈɪlɐ(͡c͡v) ˈa v n ˈa
çĕрте	(͡e͡n)sˌiːsədˈɪlɐ ˌiːbɹˈiːv(͡c͡v) r t jˈɛ
çапăçура	(͡e͡n)sˌiːsədˈɪlɐ(͡c͡v) ˈa p (͡e͡n)ˌe͡ɪbɹˈiːv sˌiːsədˈɪlɐ(͡c͡v) ˈʊ r ˈa
çемьинче	(͡e͡n)sˌiːsədˈɪlɐ(͡c͡v) jˈæ m ʲ ˈɪ n t͡ʃ jˈɛ
çыранпа	(͡e͡n)sˌiːsədˈɪlɐ(͡c͡v) ˈɯ r ˈa n p ˈa
çыхăну	(͡e͡n)sˌiːsədˈɪlɐ(͡c͡v) ˈɯ x (͡e͡n)ˌe͡ɪbɹˈiːv(͡c͡v) n ˈʊ
ăслăх	(͡e͡n)ˌe͡ɪbɹˈiːv(͡c͡v) s l (͡e͡n)ˌe͡ɪbɹˈiːv(͡c͡v) x
Раççейре	r ˈa (͡e͡n)sˌiːsədˈɪlɐ sˌiːsədˈɪlɐ(͡c͡v) jˈɛ j r jˈɛ
Хĕвел	x (͡e͡n)ˌiːbɹˈiːv(͡c͡v) v jˈæ l
акăлчан	ˈa k (͡e͡n)ˌe͡ɪbɹˈiːv(͡c͡v) l t͡ʃ ˈa n
ирĕклĕ	ˈɪ r (͡e͡n)ˌiːbɹˈiːv(͡c͡v) k l (͡e͡n)ˌiːbɹˈiːv(͡c͡v)
лауреачĕ	l ˈa ˈʊ r jˈɛ ˈa t͡ʃ (͡e͡n)ˌiːbɹˈiːv(͡c͡v)
паянхи	pajˈanxɪ
сайра	sˈajra
тăвас	t (͡e͡n)ˌe͡ɪbɹˈiːv(͡c͡v) v ˈa s
тĕнчере	t (͡e͡n)ˌiːbɹˈiːv(͡c͡v) n t͡ʃ jˈɛ r jˈɛ
юрă	jˈʊ r (͡e͡n)ˌe͡ɪbɹˈiːv(͡c͡v)
яраççĕ	jˈa r ˈa (͡e͡n)sˌiːsədˈɪlɐ sˌiːsədˈɪlɐ ˌiːbɹˈiːv(͡c͡v)
XIX	(͡e͡n)ˈɛks ˈa͡ɪ ˈɛks(͡c͡v)
çурçĕрелле	(͡e͡n)sˌiːsədˈɪlɐ(͡c͡v) ˈʊ r (͡e͡n)sˌiːsədˈɪlɐ ˌiːbɹˈiːv(͡c͡v) r jˈæ l l jˈɛ
ÿнер	(͡e͡n)wˌa͡ɪˈʊmla͡ʊt(͡c͡v) n jˈɛ r
ĕçлекен	(͡e͡n)ˌiːbɹˈiːv sˌiːsədˈɪlɐ(͡c͡v) l jˈɛ k jˈæ n
Алексей	alˈɛksɛj
Юлашки	julˈaʃkɪ
арçын	ˈa r (͡e͡n)sˌiːsədˈɪlɐ(͡c͡v) ˈɯ n
вăрттăн	v (͡e͡n)ˌe͡ɪbɹˈiːv(͡c͡v) r t t (͡e͡n)ˌe͡ɪbɹˈiːv(͡c͡v) n
илемлĕ	ˈɪ l jˈæ m l (͡e͡n)ˌiːbɹˈiːv(͡c͡v)
кăнтăралла	k (͡e͡n)ˌe͡ɪbɹˈiːv(͡c͡v) n t (͡e͡n)ˌe͡ɪbɹˈiːv(͡c͡v) r ˈa l l ˈa
кĕвĕ	k (͡e͡n)ˌiːbɹˈiːv(͡c͡v) v (͡e͡n)ˌiːbɹˈiːv(͡c͡v)
калаççĕ	k ˈa l ˈa (͡e͡n)sˌiːsədˈɪlɐ sˌiːsədˈɪlɐ ˌiːbɹˈiːv(͡c͡v)
каласан	kalˈasan
пĕтĕмпех	p (͡e͡n)ˌiːbɹˈiːv(͡c͡v) t (͡e͡n)ˌiːbɹˈiːv(͡c͡v) m p jˈɛ x
пуçлать	p ˈʊ (͡e͡n)sˌiːsədˈɪlɐ(͡c͡v) l ˈa t
суйласа	sʊjlˈasa
тăшман	t (͡e͡n)ˌe͡ɪbɹˈiːv(͡c͡v) ʃ m ˈa n
тĕлĕшпе	t (͡e͡n)ˌiːbɹˈiːv(͡c͡v) l (͡e͡n)ˌiːbɹˈiːv(͡c͡v) ʃ p jˈɛ
тĕс	t (͡e͡n)ˌiːbɹˈiːv(͡c͡v) s
тӑрӑх	tˈɯɾɯx
ушкăнне	ˈʊ ʃ k (͡e͡n)ˌe͡ɪbɹˈiːv(͡c͡v) n n jˈɛ
хушамачĕ	x ˈʊ ʃ ˈa m ˈa t͡ʃ (͡e͡n)ˌiːbɹˈiːv(͡c͡v)
чухнех	t͡ʃˈʊxnɛx
шутлаççĕ	ʃ ˈʊ t l ˈa (͡e͡n)sˌiːsədˈɪlɐ sˌiːsədˈɪlɐ ˌiːbɹˈiːv(͡c͡v)
ылтăн	ˈɯ l t (͡e͡n)ˌe͡ɪbɹˈiːv(͡c͡v) n
ют	jˈʊt
çырать	(͡e͡n)sˌiːsədˈɪlɐ(͡c͡v) ˈɯ r ˈa t
ăшă	(͡e͡n)ˌe͡ɪbɹˈiːv(͡c͡v) ʃ (͡e͡n)ˌe͡ɪbɹˈiːv(͡c͡v)
бассейнĕ	b ˈa s s jˈɛ j n (͡e͡n)ˌiːbɹˈiːv(͡c͡v)
вĕренӳ	v (͡e͡n)ˌiːbɹˈiːv(͡c͡v) r jˈæ n ˈø
грек	ɡrˈɛk
ирĕк	ˈɪ r (͡e͡n)ˌiːbɹˈiːv(͡c͡v) k
малтанах	maltˈanax
пайланать	pajlˈanat
пурăнан	p ˈʊ r (͡e͡n)ˌe͡ɪbɹˈiːv(͡c͡v) n ˈa n
тенине	tɛnˈinɛ
халăхĕн	x ˈa l (͡e͡n)ˌe͡ɪbɹˈiːv(͡c͡v) x (͡e͡n)ˌiːbɹˈiːv(͡c͡v) n
хушă	x ˈʊ ʃ (͡e͡n)ˌe͡ɪbɹˈiːv(͡c͡v)
ыттисем	ɯttˈisɛm
ӳснĕ	ˈø s n (͡e͡n)ˌiːbɹˈiːv(͡c͡v)
çу	(͡e͡n)sˌiːsədˈɪlɐ(͡c͡v) ˈʊ
Вара	vˈaɾa
Канаш	kˈanaʃ
Мускавра	mʊskˈavra
Петрович	pɛtrˈovɪt͡ʃ
Тĕнче	t (͡e͡n)ˌiːbɹˈiːv(͡c͡v) n t͡ʃ jˈɛ
Унсăр	ˈʊ n s (͡e͡n)ˌe͡ɪbɹˈiːv(͡c͡v) r
Ытти	ˈɯttɪ
Юрий	jˈuɾɪj
авторĕ	ˈa v t ˈɔ r (͡e͡n)ˌiːbɹˈiːv(͡c͡v)
иçĕм	ˈɪ (͡e͡n)sˌiːsədˈɪlɐ ˌiːbɹˈiːv(͡c͡v) m
йышлă	j ˈɯ ʃ l (͡e͡n)ˌe͡ɪbɹˈiːv(͡c͡v)
пачах	pˈat͡ʃax
статья	stˈatja
тăрăхне	t (͡e͡n)ˌe͡ɪbɹˈiːv(͡c͡v) r (͡e͡n)ˌe͡ɪbɹˈiːv(͡c͡v) x n jˈɛ
тарăн	t ˈa r (͡e͡n)ˌe͡ɪbɹˈiːv(͡c͡v) n
уйрăмĕ	ˈʊ j r (͡e͡n)ˌe͡ɪbɹˈiːv(͡c͡v) m (͡e͡n)ˌiːbɹˈiːv(͡c͡v)
хирĕçле	x ˈɪ r (͡e͡n)ˌiːbɹˈiːv sˌiːsədˈɪlɐ(͡c͡v) l jˈɛ
ӳсет	ˈysɛt
çапăçнă	(͡e͡n)sˌiːsədˈɪlɐ(͡c͡v) ˈa p (͡e͡n)ˌe͡ɪbɹˈiːv sˌiːsədˈɪlɐ(͡c͡v) n (͡e͡n)ˌe͡ɪbɹˈiːv(͡c͡v)
çапăçу	(͡e͡n)sˌiːsədˈɪlɐ(͡c͡v) ˈa p (͡e͡n)ˌe͡ɪbɹˈiːv sˌiːsədˈɪlɐ(͡c͡v) ˈʊ
çирĕп	(͡e͡n)sˌiːsədˈɪlɐ(͡c͡v) ˈɪ r (͡e͡n)ˌiːbɹˈiːv(͡c͡v) p
Республики	rˌɛspʊblˈikɪ
Сергей	sˈɛrɡɛj
Хăй	x (͡e͡n)ˌe͡ɪbɹˈiːv(͡c͡v) j
аса	ˈasa
институчĕн	ˈɪ n s t ˈɪ t ˈʊ t͡ʃ (͡e͡n)ˌiːbɹˈiːv(͡c͡v) n
килсе	kˈɪlsɛ
никам	nˈikam
пăрахнă	p (͡e͡n)ˌe͡ɪbɹˈiːv(͡c͡v) r ˈa x n (͡e͡n)ˌe͡ɪbɹˈiːv(͡c͡v)
пĕтнĕ	p (͡e͡n)ˌiːbɹˈiːv(͡c͡v) t n (͡e͡n)ˌiːbɹˈiːv(͡c͡v)
патшалăхĕ	p ˈa t ʃ ˈa l (͡e͡n)ˌe͡ɪbɹˈiːv(͡c͡v) x (͡e͡n)ˌiːbɹˈiːv(͡c͡v)
пысӑк	pˈɯsɯk
пӗр	pˈɵr
тăрăхĕн	t (͡e͡n)ˌe͡ɪbɹˈiːv(͡c͡v) r (͡e͡n)ˌe͡ɪbɹˈiːv(͡c͡v) x (͡e͡n)ˌiːbɹˈiːv(͡c͡v) n
тапхăрĕ	t ˈa p x (͡e͡n)ˌe͡ɪbɹˈiːv(͡c͡v) r (͡e͡n)ˌiːbɹˈiːv(͡c͡v)
унӑн	ˈunɯn
франци	frˈant͡sɪ
хĕрĕ	x (͡e͡n)ˌiːbɹˈiːv(͡c͡v) r (͡e͡n)ˌiːbɹˈiːv(͡c͡v)
хыпарĕпе	x ˈɯ p ˈa r (͡e͡n)ˌiːbɹˈiːv(͡c͡v) p jˈɛ
çĕрĕсене	(͡e͡n)sˌiːsədˈɪlɐ ˌiːbɹˈiːv(͡c͡v) r (͡e͡n)ˌiːbɹˈiːv(͡c͡v) s jˈæ n jˈɛ
Александрович	ˌalɛksandrˈovɪt͡ʃ
Анатолий	ˌanatˈolɪj
Атăлçи	ˈa t (͡e͡n)ˌe͡ɪbɹˈiːv(͡c͡v) l (͡e͡n)sˌiːsədˈɪlɐ(͡c͡v) ˈɪ
Канашĕн	k ˈa n ˈa ʃ (͡e͡n)ˌiːbɹˈiːv(͡c͡v) n
Хусанти	xusˈantɪ
Чĕмпĕр	t͡ʃ (͡e͡n)ˌiːbɹˈiːv(͡c͡v) m p (͡e͡n)ˌiːbɹˈiːv(͡c͡v) r
Шупашкара	ʃˌupaʃkˈaɾa
арăмĕ	ˈa r (͡e͡n)ˌe͡ɪbɹˈiːv(͡c͡v) m (͡e͡n)ˌiːbɹˈiːv(͡c͡v)
виççĕ	v ˈɪ (͡e͡n)sˌiːsədˈɪlɐ sˌiːsədˈɪlɐ ˌiːbɹˈiːv(͡c͡v)
виççĕмĕш	v ˈɪ (͡e͡n)sˌiːsədˈɪlɐ sˌiːsədˈɪlɐ ˌiːbɹˈiːv(͡c͡v) m (͡e͡n)ˌiːbɹˈiːv(͡c͡v) ʃ
драма	drˈama
медицина	mˌɛdit͡sˈina
пĕтĕмĕшле	p (͡e͡n)ˌiːbɹˈiːv(͡c͡v) t (͡e͡n)ˌiːbɹˈiːv(͡c͡v) m (͡e͡n)ˌiːbɹˈiːv(͡c͡v) ʃ l jˈɛ
пункчĕ	p ˈʊ n k t͡ʃ (͡e͡n)ˌiːbɹˈiːv(͡c͡v)
пурнăçĕ	p ˈʊ r n (͡e͡n)ˌe͡ɪbɹˈiːv sˌiːsədˈɪlɐ ˌiːbɹˈiːv(͡c͡v)
пуш	pˈʊʃ
реестрĕн	r jˈɛ jˈɛ s t r (͡e͡n)ˌiːbɹˈiːv(͡c͡v) n
тĕлне	t (͡e͡n)ˌiːbɹˈiːv(͡c͡v) l n jˈɛ
тĕпчев	t (͡e͡n)ˌiːbɹˈiːv(͡c͡v) p t͡ʃ jˈɛ v
тĕрĕк	t (͡e͡n)ˌiːbɹˈiːv(͡c͡v) r (͡e͡n)ˌiːbɹˈiːv(͡c͡v) k
тĕрĕс	t (͡e͡n)ˌiːbɹˈiːv(͡c͡v) r (͡e͡n)ˌiːbɹˈiːv(͡c͡v) s
уйăрса	ˈʊ j (͡e͡n)ˌe͡ɪbɹˈiːv(͡c͡v) r s ˈa
упранса	ʊprˈansa
флочĕн	f l ˈɔ t͡ʃ (͡e͡n)ˌiːbɹˈiːv(͡c͡v) n
халăха	x ˈa l (͡e͡n)ˌe͡ɪbɹˈiːv(͡c͡v) x ˈa
хурса	xˈʊrsa
чĕлхинче	t͡ʃ (͡e͡n)ˌiːbɹˈiːv(͡c͡v) l x ˈɪ n t͡ʃ jˈɛ
эрех	ˈeɾɛx
эскадрилья	ˌɛskadrˈɪlja
Çакна	(͡e͡n)sˌiːsədˈɪlɐ(͡c͡v) ˈa k n ˈa
ăнăçлă	(͡e͡n)ˌe͡ɪbɹˈiːv(͡c͡v) n (͡e͡n)ˌe͡ɪbɹˈiːv sˌiːsədˈɪlɐ(͡c͡v) l (͡e͡n)ˌe͡ɪbɹˈiːv(͡c͡v)
Европа	jɛvrˈopa
Урал	ˈuɾal
Уса	ˈusa
Хăш	x (͡e͡n)ˌe͡ɪbɹˈiːv(͡c͡v) ʃ
вĕрентнĕ	v (͡e͡n)ˌiːbɹˈiːv(͡c͡v) r jˈæ n t n (͡e͡n)ˌiːbɹˈiːv(͡c͡v)
йĕркеленнĕ	j (͡e͡n)ˌiːbɹˈiːv(͡c͡v) r k jˈæ l jˈæ n n (͡e͡n)ˌiːbɹˈiːv(͡c͡v)
кантон	kˈantɔn
каярахпа	kˌajaɾˈaxpa
лартаççĕ	l ˈa r t ˈa (͡e͡n)sˌiːsədˈɪlɐ sˌiːsədˈɪlɐ ˌiːbɹˈiːv(͡c͡v)
патĕнчи	p ˈa t (͡e͡n)ˌiːbɹˈiːv(͡c͡v) n t͡ʃ ˈɪ
тăма	t (͡e͡n)ˌe͡ɪbɹˈiːv(͡c͡v) m ˈa
тĕллевпе	t (͡e͡n)ˌiːbɹˈiːv(͡c͡v) l l jˈɛ v p jˈɛ
тивнĕ	t ˈɪ v n (͡e͡n)ˌiːbɹˈiːv(͡c͡v)
тухакан	tuxˈakan
хыпар	xˈɯpar
чикĕ	t͡ʃ ˈɪ k (͡e͡n)ˌiːbɹˈiːv(͡c͡v)
XVIII	(͡e͡n)ˈɛks vˈiː ˈa͡ɪ ˈa͡ɪ ˈa͡ɪ(͡c͡v)
Çар	(͡e͡n)sˌiːsədˈɪlɐ(͡c͡v) ˈa r
çĕнĕрен	(͡e͡n)sˌiːsədˈɪlɐ ˌiːbɹˈiːv(͡c͡v) n (͡e͡n)ˌiːbɹˈiːv(͡c͡v) r jˈæ n
Тата	tˈata
Ылтăн	ˈɯ l t (͡e͡n)ˌe͡ɪbɹˈiːv(͡c͡v) n
алла	ˈalla
аллине	allˈinɛ
га	ɡˈa
де	dˈɛ
пулă	p ˈʊ l (͡e͡n)ˌe͡ɪbɹˈiːv(͡c͡v)
тăрăхра	t (͡e͡n)ˌe͡ɪbɹˈiːv(͡c͡v) r (͡e͡n)ˌe͡ɪbɹˈiːv(͡c͡v) x r ˈa
тапăнса	t ˈa p (͡e͡n)ˌe͡ɪbɹˈiːv(͡c͡v) n s ˈa
температура	tˌɛmpɛɾatˈuɾa
уçă	ˈʊ (͡e͡n)sˌiːsədˈɪlɐ ˌe͡ɪbɹˈiːv(͡c͡v)
умĕн	ˈʊ m (͡e͡n)ˌiːbɹˈiːv(͡c͡v) n
хушнă	x ˈʊ ʃ n (͡e͡n)ˌe͡ɪbɹˈiːv(͡c͡v)
чĕлхепе	t͡ʃ (͡e͡n)ˌiːbɹˈiːv(͡c͡v) l x jˈɛ p jˈɛ
ялти	jˈaltɪ
ятарласа	jˌatarlˈasa
ҫине	çˈinɛ
XX	(͡e͡n)ˈɛks ˈɛks(͡c͡v)
çĕрсене	(͡e͡n)sˌiːsədˈɪlɐ ˌiːbɹˈiːv(͡c͡v) r s jˈæ n jˈɛ
ĕçре	(͡e͡n)ˌiːbɹˈiːv sˌiːsədˈɪlɐ(͡c͡v) r jˈɛ
Вĕсенчен	v (͡e͡n)ˌiːbɹˈiːv(͡c͡v) s jˈæ n t͡ʃ jˈæ n
Малтанхи	maltˈanxɪ
Пётр	pjˈɔtr
Шкул	ʃkˈʊl
ан	ˈan
бомблакан	bɔmblˈakan
взвочĕн	v z v ˈɔ t͡ʃ (͡e͡n)ˌiːbɹˈiːv(͡c͡v) n
вулăсне	v ˈʊ l (͡e͡n)ˌe͡ɪbɹˈiːv(͡c͡v) s n jˈɛ
кăштах	k (͡e͡n)ˌe͡ɪbɹˈiːv(͡c͡v) ʃ t ˈa x
кĕме	k (͡e͡n)ˌiːbɹˈiːv(͡c͡v) m jˈɛ
кĕртеççĕ	k (͡e͡n)ˌiːbɹˈiːv(͡c͡v) r t jˈɛ (͡e͡n)sˌiːsədˈɪlɐ sˌiːsədˈɪlɐ ˌiːbɹˈiːv(͡c͡v)
кил	kˈɪl
куçать	k ˈʊ (͡e͡n)sˌiːsədˈɪlɐ(͡c͡v) ˈa t
куракан	kuɾˈakan
пăхсан	p (͡e͡n)ˌe͡ɪbɹˈiːv(͡c͡v) x s ˈa n
пĕрре	p (͡e͡n)ˌiːbɹˈiːv(͡c͡v) r r jˈɛ
панӑ	pˈanɯ
пуç	p ˈʊ (͡e͡n)sˌiːsədˈɪlɐ(͡c͡v)
сĕннĕ	s (͡e͡n)ˌiːbɹˈiːv(͡c͡v) n n (͡e͡n)ˌiːbɹˈiːv(͡c͡v)
сыхланса	sɯxlˈansa
текен	tˈɛkɛn
темелле	tɛmˈɛllɛ
тухаççĕ	t ˈʊ x ˈa (͡e͡n)sˌiːsədˈɪlɐ sˌiːsədˈɪlɐ ˌiːbɹˈiːv(͡c͡v)
уйăх	ˈʊ j (͡e͡n)ˌe͡ɪbɹˈiːv(͡c͡v) x
хураççĕ	x ˈʊ r ˈa (͡e͡n)sˌiːsədˈɪlɐ sˌiːsədˈɪlɐ ˌiːbɹˈiːv(͡c͡v)
чĕлхисен	t͡ʃ (͡e͡n)ˌiːbɹˈiːv(͡c͡v) l x ˈɪ s jˈæ n
юрать	jˈuɾat
ятĕнчен	jˈa t (͡e͡n)ˌiːbɹˈiːv(͡c͡v) n t͡ʃ jˈæ n
çарĕсен	(͡e͡n)sˌiːsədˈɪlɐ(͡c͡v) ˈa r (͡e͡n)ˌiːbɹˈiːv(͡c͡v) s jˈæ n
çӳреме	(͡e͡n)sˌiːsədˈɪlɐ(͡c͡v) ˈø r jˈæ m jˈɛ
Енĕн	jˈæ n (͡e͡n)ˌiːbɹˈiːv(͡c͡v) n
Казахстан	kazˈaxstan
Каярахпа	kˌajaɾˈaxpa
Константин	kɔnstˈantɪn
Темиçе	t jˈæ m ˈɪ (͡e͡n)sˌiːsədˈɪlɐ(͡c͡v) jˈɛ
Тинĕс	t ˈɪ n (͡e͡n)ˌiːbɹˈiːv(͡c͡v) s
ачасене	ˌat͡ʃasˈɛnɛ
ватă	v ˈa t (͡e͡n)ˌe͡ɪbɹˈiːv(͡c͡v)
кайма	kˈajma
касса	kˈassa
китай	kˈitaj
маларах	malˈaɾax
миллион	mɪllˈiɔn
персе	pˈɛrsɛ
самай	sˈamaj
симĕс	s ˈɪ m (͡e͡n)ˌiːbɹˈiːv(͡c͡v) s
тĕнне	t (͡e͡n)ˌiːbɹˈiːv(͡c͡v) n n jˈɛ
тӳрех	tˈyɾɛx
хаçат	x ˈa (͡e͡n)sˌiːsədˈɪlɐ(͡c͡v) ˈa t
харпăр	x ˈa r p (͡e͡n)ˌe͡ɪbɹˈiːv(͡c͡v) r
чĕрĕ	t͡ʃ (͡e͡n)ˌiːbɹˈiːv(͡c͡v) r (͡e͡n)ˌiːbɹˈiːv(͡c͡v)
шайне	ʃˈajnɛ
шалти	ʃˈaltɪ
юпа	jˈupa
юханшывĕ	jˈʊ x ˈa n ʃ ˈɯ v (͡e͡n)ˌiːbɹˈiːv(͡c͡v)
ялтан	jˈaltan
ăслăлăх	(͡e͡n)ˌe͡ɪbɹˈiːv(͡c͡v) s l (͡e͡n)ˌe͡ɪbɹˈiːv(͡c͡v) l (͡e͡n)ˌe͡ɪbɹˈiːv(͡c͡v) x
ĕçсем	(͡e͡n)ˌiːbɹˈiːv sˌiːsədˈɪlɐ(͡c͡v) s jˈæ m
Наци	nˈat͡sɪ
Федерацин	fˌɛdɛɾˈat͡sɪn
артисчĕ	ˈa r t ˈɪ s t͡ʃ (͡e͡n)ˌiːbɹˈiːv(͡c͡v)
батальонĕн	b ˈa t ˈa l ʲ ˈɔ n (͡e͡n)ˌiːbɹˈiːv(͡c͡v) n
кăтартаççĕ	k (͡e͡n)ˌe͡ɪbɹˈiːv(͡c͡v) t ˈa r t ˈa (͡e͡n)sˌiːsədˈɪlɐ sˌiːsədˈɪlɐ ˌiːbɹˈiːv(͡c͡v)
кăшт	k (͡e͡n)ˌe͡ɪbɹˈiːv(͡c͡v) ʃ t
кӳлли	kˈøllɪ
лекет	lˈɛkɛt
мм	mm
округ	ˈɔkrʊɡ
палăртма	p ˈa l (͡e͡n)ˌe͡ɪbɹˈiːv(͡c͡v) r t m ˈa
пиллĕк	p ˈɪ l l (͡e͡n)ˌiːbɹˈiːv(͡c͡v) k
провинцин	provˈɪnt͡sɪn
пуçланнă	p ˈʊ (͡e͡n)sˌiːsədˈɪlɐ(͡c͡v) l ˈa n n (͡e͡n)ˌe͡ɪbɹˈiːv(͡c͡v)
секретарĕ	s jˈɛ k r jˈɛ t ˈa r (͡e͡n)ˌiːbɹˈiːv(͡c͡v)
сивĕ	s ˈɪ v (͡e͡n)ˌiːbɹˈiːv(͡c͡v)
тăтăшах	t (͡e͡n)ˌe͡ɪbɹˈiːv(͡c͡v) t (͡e͡n)ˌe͡ɪbɹˈiːv(͡c͡v) ʃ ˈa x
тĕллĕн	t (͡e͡n)ˌiːbɹˈiːv(͡c͡v) l l (͡e͡n)ˌiːbɹˈiːv(͡c͡v) n
тĕслĕхрен	t (͡e͡n)ˌiːbɹˈiːv(͡c͡v) s l (͡e͡n)ˌiːbɹˈiːv(͡c͡v) x r jˈæ n
танлаштарсан	tˌanlaʃtˈarsan
тет	tˈɛt
тивет	tˈivɛt
хаклă	x ˈa k l (͡e͡n)ˌe͡ɪbɹˈiːv(͡c͡v)
хутшăнать	x ˈʊ t ʃ (͡e͡n)ˌe͡ɪbɹˈiːv(͡c͡v) n ˈa t
хушса	xˈʊʃsa
шкулĕ	ʃ k ˈʊ l (͡e͡n)ˌiːbɹˈiːv(͡c͡v)
шкулне	ʃkˈʊlnɛ
шучĕпе	ʃ ˈʊ t͡ʃ (͡e͡n)ˌiːbɹˈiːv(͡c͡v) p jˈɛ
шывĕ	ʃ ˈɯ v (͡e͡n)ˌiːbɹˈiːv(͡c͡v)
ҫулта	çˈʊlta
çарне	(͡e͡n)sˌiːsədˈɪlɐ(͡c͡v) ˈa r n jˈɛ
çулах	(͡e͡n)sˌiːsədˈɪlɐ(͡c͡v) ˈʊ l ˈa x
çыравçă	(͡e͡n)sˌiːsədˈɪlɐ(͡c͡v) ˈɯ r ˈa v (͡e͡n)sˌiːsədˈɪlɐ ˌe͡ɪbɹˈiːv(͡c͡v)
ăслăхĕсен	(͡e͡n)ˌe͡ɪbɹˈiːv(͡c͡v) s l (͡e͡n)ˌe͡ɪbɹˈiːv(͡c͡v) x (͡e͡n)ˌiːbɹˈiːv(͡c͡v) s jˈæ n
Виçĕ	v ˈɪ (͡e͡n)sˌiːsədˈɪlɐ ˌiːbɹˈiːv(͡c͡v)
Ен	jˈæn
Пурĕпе	p ˈʊ r (͡e͡n)ˌiːbɹˈiːv(͡c͡v) p jˈɛ
Тĕрлĕ	t (͡e͡n)ˌiːbɹˈiːv(͡c͡v) r l (͡e͡n)ˌiːbɹˈiːv(͡c͡v)
айне	ˈajnɛ
ака	ˈaka
вăрăм	v (͡e͡n)ˌe͡ɪbɹˈiːv(͡c͡v) r (͡e͡n)ˌe͡ɪbɹˈiːv(͡c͡v) m
вырнаçтарнă	v ˈɯ r n ˈa (͡e͡n)sˌiːsədˈɪlɐ(͡c͡v) t ˈa r n (͡e͡n)ˌe͡ɪbɹˈiːv(͡c͡v)
йĕркипе	j (͡e͡n)ˌiːbɹˈiːv(͡c͡v) r k ˈɪ p jˈɛ
карап	kˈaɾap
кӳлмекĕ	k ˈø l m jˈɛ k (͡e͡n)ˌiːbɹˈiːv(͡c͡v)
пайĕпе	p ˈa j (͡e͡n)ˌiːbɹˈiːv(͡c͡v) p jˈɛ
патшалăхăн	p ˈa t ʃ ˈa l (͡e͡n)ˌe͡ɪbɹˈiːv(͡c͡v) x (͡e͡n)ˌe͡ɪbɹˈiːv(͡c͡v) n
пултарулăх	p ˈʊ l t ˈa r ˈʊ l (͡e͡n)ˌe͡ɪbɹˈiːv(͡c͡v) x
пурăну	p ˈʊ r (͡e͡n)ˌe͡ɪbɹˈiːv(͡c͡v) n ˈʊ
пурте	pˈʊrtɛ
сăмаха	s (͡e͡n)ˌe͡ɪbɹˈiːv(͡c͡v) m ˈa x ˈa
сас	sˈas
сержант	sˈɛrʒant
спорт	spˈɔrt
тĕн	t (͡e͡n)ˌiːbɹˈiːv(͡c͡v) n
тавра	tˈavra
тивĕçтернĕ	t ˈɪ v (͡e͡n)ˌiːbɹˈiːv sˌiːsədˈɪlɐ(͡c͡v) t jˈɛ r n (͡e͡n)ˌiːbɹˈiːv(͡c͡v)
ушкăнĕн	ˈʊ ʃ k (͡e͡n)ˌe͡ɪbɹˈiːv(͡c͡v) n (͡e͡n)ˌiːbɹˈiːv(͡c͡v) n
фильм	fˈɪlm
хисеп	xˈisɛp
чун	t͡ʃˈʊn
юр	jˈʊr
ҫул	çˈʊl
çăлтăр	(͡e͡n)sˌiːsədˈɪlɐ ˌe͡ɪbɹˈiːv(͡c͡v) l t (͡e͡n)ˌe͡ɪbɹˈiːv(͡c͡v) r
çĕршыв	(͡e͡n)sˌiːsədˈɪlɐ ˌiːbɹˈiːv(͡c͡v) r ʃ ˈɯ v
çарĕсене	(͡e͡n)sˌiːsədˈɪlɐ(͡c͡v) ˈa r (͡e͡n)ˌiːbɹˈiːv(͡c͡v) s jˈæ n jˈɛ
çуралса	(͡e͡n)sˌiːsədˈɪlɐ(͡c͡v) ˈʊ r ˈa l s ˈa
çутă	(͡e͡n)sˌiːsədˈɪlɐ(͡c͡v) ˈʊ t (͡e͡n)ˌe͡ɪbɹˈiːv(͡c͡v)
çывăхĕнче	(͡e͡n)sˌiːsədˈɪlɐ(͡c͡v) ˈɯ v (͡e͡n)ˌe͡ɪbɹˈiːv(͡c͡v) x (͡e͡n)ˌiːbɹˈiːv(͡c͡v) n t͡ʃ jˈɛ
çыран	(͡e͡n)sˌiːsədˈɪlɐ(͡c͡v) ˈɯ r ˈa n
çӳлти	(͡e͡n)sˌiːsədˈɪlɐ(͡c͡v) ˈø l t ˈɪ
Андрей	ˈandrɛj
Октябрь	ˈɔktjabr
Тĕнчери	t (͡e͡n)ˌiːbɹˈiːv(͡c͡v) n t͡ʃ jˈɛ r ˈɪ
автор	ˈavtɔr
американ	ˌamɛɾˈikan
ансат	ˈansat
аталанса	ˌatalˈansa
вăтамран	v (͡e͡n)ˌe͡ɪbɹˈiːv(͡c͡v) t ˈa m r ˈa n
вăхăта	v (͡e͡n)ˌe͡ɪbɹˈiːv(͡c͡v) x (͡e͡n)ˌe͡ɪbɹˈiːv(͡c͡v) t ˈa
йăхĕсем	j (͡e͡n)ˌe͡ɪbɹˈiːv(͡c͡v) x (͡e͡n)ˌiːbɹˈiːv(͡c͡v) s jˈæ m
кăларать	k (͡e͡n)ˌe͡ɪbɹˈiːv(͡c͡v) l ˈa r ˈa t
калама	kalˈama
нумайрах	numˈajrax
пилĕк	p ˈɪ l (͡e͡n)ˌiːbɹˈiːv(͡c͡v) k
пынипе	pɯnˈipɛ
пысăккисем	p ˈɯ s (͡e͡n)ˌe͡ɪbɹˈiːv(͡c͡v) k k ˈɪ s jˈæ m
рим	rˈɪm
сăрă	s (͡e͡n)ˌe͡ɪbɹˈiːv(͡c͡v) r (͡e͡n)ˌe͡ɪbɹˈiːv(͡c͡v)
сиксе	sˈɪksɛ
сорчĕ	s ˈɔ r t͡ʃ (͡e͡n)ˌiːbɹˈiːv(͡c͡v)
татах	tˈatax
тунӑ	tˈunɯ
тупса	tˈʊpsa
тухсан	tˈʊxsan
урăхла	ˈʊ r (͡e͡n)ˌe͡ɪbɹˈiːv(͡c͡v) x l ˈa
утă	ˈʊ t (͡e͡n)ˌe͡ɪbɹˈiːv(͡c͡v)
утрав	ˈʊtrav
шухăш	ʃ ˈʊ x (͡e͡n)ˌe͡ɪbɹˈiːv(͡c͡v) ʃ
ҫав	çˈav
ҫын	çˈɯn
ӑна	ˈɯna
Çул	(͡e͡n)sˌiːsədˈɪlɐ(͡c͡v) ˈʊ l
çарпуçĕ	(͡e͡n)sˌiːsədˈɪlɐ(͡c͡v) ˈa r p ˈʊ (͡e͡n)sˌiːsədˈɪlɐ ˌiːbɹˈiːv(͡c͡v)
çӳрет	(͡e͡n)sˌiːsədˈɪlɐ(͡c͡v) ˈø r jˈɛ t
ĕçĕпе	(͡e͡n)ˌiːbɹˈiːv sˌiːsədˈɪlɐ ˌiːbɹˈiːv(͡c͡v) p jˈɛ
ĕçсене	(͡e͡n)ˌiːbɹˈiːv sˌiːsədˈɪlɐ(͡c͡v) s jˈæ n jˈɛ
Амăшĕ	ˈa m (͡e͡n)ˌe͡ɪbɹˈiːv(͡c͡v) ʃ (͡e͡n)ˌiːbɹˈiːv(͡c͡v)
Анна	ˈanna
РСФСР	rsfsr
Яковлев	jakˈɔvlɛv
енĕ	jˈæ n (͡e͡n)ˌiːbɹˈiːv(͡c͡v)
еннелле	jænnˈɛllɛ
ирĕке	ˈɪ r (͡e͡n)ˌiːbɹˈiːv(͡c͡v) k jˈɛ
кăткăс	k (͡e͡n)ˌe͡ɪbɹˈiːv(͡c͡v) t k (͡e͡n)ˌe͡ɪbɹˈiːv(͡c͡v) s
кĕнеки	k (͡e͡n)ˌiːbɹˈiːv(͡c͡v) n jˈɛ k ˈɪ
кавалери	kˌavalˈɛɾɪ
кирек	kˈiɾɛk
клуб	klˈʊb
леш	lˈɛʃ
майпа	mˈajpa
музейĕ	m ˈʊ z jˈɛ j (͡e͡n)ˌiːbɹˈiːv(͡c͡v)
облаçĕнчи	ˈɔ b l ˈa (͡e͡n)sˌiːsədˈɪlɐ ˌiːbɹˈiːv(͡c͡v) n t͡ʃ ˈɪ
пĕрлĕх	p (͡e͡n)ˌiːbɹˈiːv(͡c͡v) r l (͡e͡n)ˌiːbɹˈiːv(͡c͡v) x
паллах	pˈallax
пысăкрах	p ˈɯ s (͡e͡n)ˌe͡ɪbɹˈiːv(͡c͡v) k r ˈa x
республика	rˌɛspʊblˈika
сăвă	s (͡e͡n)ˌe͡ɪbɹˈiːv(͡c͡v) v (͡e͡n)ˌe͡ɪbɹˈiːv(͡c͡v)
тăрса	t (͡e͡n)ˌe͡ɪbɹˈiːv(͡c͡v) r s ˈa
тачă	t ˈa t͡ʃ (͡e͡n)ˌe͡ɪbɹˈiːv(͡c͡v)
территорине	tˌɛrritoɾˈinɛ
территоринче	tˌɛrritoɾˈɪnt͡ʃɛ
ултă	ˈʊ l t (͡e͡n)ˌe͡ɪbɹˈiːv(͡c͡v)
чикки	t͡ʃˈɪkkɪ
шутланаççĕ	ʃ ˈʊ t l ˈa n ˈa (͡e͡n)sˌiːsədˈɪlɐ sˌiːsədˈɪlɐ ˌiːbɹˈiːv(͡c͡v)
юлать	jˈulat
юханшывăнн	jˈʊ x ˈa n ʃ ˈɯ v (͡e͡n)ˌe͡ɪbɹˈiːv(͡c͡v) n n
ӳкернĕ	ˈø k jˈɛ r n (͡e͡n)ˌiːbɹˈiːv(͡c͡v)
Çамрăк	(͡e͡n)sˌiːsədˈɪlɐ(͡c͡v) ˈa m r (͡e͡n)ˌe͡ɪbɹˈiːv(͡c͡v) k
Çамрăксен	(͡e͡n)sˌiːsədˈɪlɐ(͡c͡v) ˈa m r (͡e͡n)ˌe͡ɪbɹˈiːv(͡c͡v) k s jˈæ n
çĕрсем	(͡e͡n)sˌiːsədˈɪlɐ ˌiːbɹˈiːv(͡c͡v) r s jˈæ m
çакă	(͡e͡n)sˌiːsədˈɪlɐ(͡c͡v) ˈa k (͡e͡n)ˌe͡ɪbɹˈiːv(͡c͡v)
çултах	(͡e͡n)sˌiːsədˈɪlɐ(͡c͡v) ˈʊ l t ˈa x
çур	(͡e͡n)sˌiːsədˈɪlɐ(͡c͡v) ˈʊ r
ÿнерçĕ	(͡e͡n)wˌa͡ɪˈʊmla͡ʊt(͡c͡v) n jˈɛ r (͡e͡n)sˌiːsədˈɪlɐ ˌiːbɹˈiːv(͡c͡v)
Дмитрий	dmˈɪtrɪj
Европăри	jˈɛ v r ˈɔ p (͡e͡n)ˌe͡ɪbɹˈiːv(͡c͡v) r ˈɪ
Инди	ˈɪndɪ
Карл	kˈarl
Ленинград	lɛnˈɪnɡrad
Сăмахран	s (͡e͡n)ˌe͡ɪbɹˈiːv(͡c͡v) m ˈa x r ˈa n
Цезарь	t͡sˈɛzar
Ячĕ	jˈa t͡ʃ (͡e͡n)ˌiːbɹˈiːv(͡c͡v)
ачасем	at͡ʃˈasɛm
вăйĕсен	v (͡e͡n)ˌe͡ɪbɹˈiːv(͡c͡v) j (͡e͡n)ˌiːbɹˈiːv(͡c͡v) s jˈæ n
вырнаҫнӑ	vɯrnˈaçnɯ
директорĕ	d ˈɪ r jˈɛ k t ˈɔ r (͡e͡n)ˌiːbɹˈiːv(͡c͡v)
йĕркелесе	j (͡e͡n)ˌiːbɹˈiːv(͡c͡v) r k jˈæ l jˈɛ s jˈɛ
кăлараççĕ	k (͡e͡n)ˌe͡ɪbɹˈiːv(͡c͡v) l ˈa r ˈa (͡e͡n)sˌiːsədˈɪlɐ sˌiːsədˈɪlɐ ˌiːbɹˈiːv(͡c͡v)
кăларма	k (͡e͡n)ˌe͡ɪbɹˈiːv(͡c͡v) l ˈa r m ˈa
кăтартакан	k (͡e͡n)ˌe͡ɪbɹˈiːv(͡c͡v) t ˈa r t ˈa k ˈa n
кг	kɡ
патшалăхĕн	p ˈa t ʃ ˈa l (͡e͡n)ˌe͡ɪbɹˈiːv(͡c͡v) x (͡e͡n)ˌiːbɹˈiːv(͡c͡v) n
профессор	profˈɛssɔr
районне	rajˈɔnnɛ
режиссёр	rɛʒˈɪssjɔr
сали	sˈalɪ
тӗрлӗ	tˈɵrlɵ
хĕсметре	x (͡e͡n)ˌiːbɹˈiːv(͡c͡v) s m jˈɛ t r jˈɛ
хушма	xˈʊʃma
чĕннĕ	t͡ʃ (͡e͡n)ˌiːbɹˈiːv(͡c͡v) n n (͡e͡n)ˌiːbɹˈiːv(͡c͡v)
чӳк	t͡ʃˈøk
эпир	ˈepɪr
ячĕсем	jˈa t͡ʃ (͡e͡n)ˌiːbɹˈiːv(͡c͡v) s jˈæ m
Çĕршывăн	(͡e͡n)sˌiːsədˈɪlɐ ˌiːbɹˈiːv(͡c͡v) r ʃ ˈɯ v (͡e͡n)ˌe͡ɪbɹˈiːv(͡c͡v) n
Çут	(͡e͡n)sˌiːsədˈɪlɐ(͡c͡v) ˈʊ t
çурма	(͡e͡n)sˌiːsədˈɪlɐ(͡c͡v) ˈʊ r m ˈa
çухрăмра	(͡e͡n)sˌiːsədˈɪlɐ(͡c͡v) ˈʊ x r (͡e͡n)ˌe͡ɪbɹˈiːv(͡c͡v) m r ˈa
çыравçи	(͡e͡n)sˌiːsədˈɪlɐ(͡c͡v) ˈɯ r ˈa v (͡e͡n)sˌiːsədˈɪlɐ(͡c͡v) ˈɪ
çыранĕнче	(͡e͡n)sˌiːsədˈɪlɐ(͡c͡v) ˈɯ r ˈa n (͡e͡n)ˌiːbɹˈiːv(͡c͡v) n t͡ʃ jˈɛ
Европăра	jˈɛ v r ˈɔ p (͡e͡n)ˌe͡ɪbɹˈiːv(͡c͡v) r ˈa
Малтанах	maltˈanax
Паянхи	pajˈanxɪ
Пур	pˈʊr
Самар	sˈamar
айĕнчи	ˈa j (͡e͡n)ˌiːbɹˈiːv(͡c͡v) n t͡ʃ ˈɪ
актриса	aktrˈisa
выляса	vɯljˈasa
йышăнаççĕ	j ˈɯ ʃ (͡e͡n)ˌe͡ɪbɹˈiːv(͡c͡v) n ˈa (͡e͡n)sˌiːsədˈɪlɐ sˌiːsədˈɪlɐ ˌiːbɹˈiːv(͡c͡v)
кандидачĕ	k ˈa n d ˈɪ d ˈa t͡ʃ (͡e͡n)ˌiːbɹˈiːv(͡c͡v)
кунĕ	k ˈʊ n (͡e͡n)ˌiːbɹˈiːv(͡c͡v)
курăк	k ˈʊ r (͡e͡n)ˌe͡ɪbɹˈiːv(͡c͡v) k
ним	nˈɪm
пĕрлĕхĕн	p (͡e͡n)ˌiːbɹˈiːv(͡c͡v) r l (͡e͡n)ˌiːbɹˈiːv(͡c͡v) x (͡e͡n)ˌiːbɹˈiːv(͡c͡v) n
пĕрлешĕвĕ	p (͡e͡n)ˌiːbɹˈiːv(͡c͡v) r l jˈɛ ʃ (͡e͡n)ˌiːbɹˈiːv(͡c͡v) v (͡e͡n)ˌiːbɹˈiːv(͡c͡v)
пĕрмаях	p (͡e͡n)ˌiːbɹˈiːv(͡c͡v) r m ˈa jˈa x
паллисем	pallˈisɛm
патшалăхне	p ˈa t ʃ ˈa l (͡e͡n)ˌe͡ɪbɹˈiːv(͡c͡v) x n jˈɛ
президенчĕ	p r jˈɛ z ˈɪ d jˈæ n t͡ʃ (͡e͡n)ˌiːbɹˈiːv(͡c͡v)
пуçламăш	p ˈʊ (͡e͡n)sˌiːsədˈɪlɐ(͡c͡v) l ˈa m (͡e͡n)ˌe͡ɪbɹˈiːv(͡c͡v) ʃ
пулăшнă	p ˈʊ l (͡e͡n)ˌe͡ɪbɹˈiːv(͡c͡v) ʃ n (͡e͡n)ˌe͡ɪbɹˈiːv(͡c͡v)
пулмасть	pˈʊlmast
роман	rˈoman
суйланă	s ˈʊ j l ˈa n (͡e͡n)ˌe͡ɪbɹˈiːv(͡c͡v)
типĕ	t ˈɪ p (͡e͡n)ˌiːbɹˈiːv(͡c͡v)
тыткăна	t ˈɯ t k (͡e͡n)ˌe͡ɪbɹˈiːv(͡c͡v) n ˈa
умĕнче	ˈʊ m (͡e͡n)ˌiːbɹˈiːv(͡c͡v) n t͡ʃ jˈɛ
хисеплĕ	x ˈɪ s jˈɛ p l (͡e͡n)ˌiːbɹˈiːv(͡c͡v)
хулин	xˈulɪn
хушать	xˈuʃat
часах	t͡ʃˈasax
чиркĕвĕ	t͡ʃ ˈɪ r k (͡e͡n)ˌiːbɹˈiːv(͡c͡v) v (͡e͡n)ˌiːbɹˈiːv(͡c͡v)
чухлĕ	t͡ʃ ˈʊ x l (͡e͡n)ˌiːbɹˈiːv(͡c͡v)
шкула	ʃkˈula
ялĕсем	jˈa l (͡e͡n)ˌiːbɹˈiːv(͡c͡v) s jˈæ m
çавна	(͡e͡n)sˌiːsədˈɪlɐ(͡c͡v) ˈa v n ˈa
çулне	(͡e͡n)sˌiːsədˈɪlɐ(͡c͡v) ˈʊ l n jˈɛ
çурла	(͡e͡n)sˌiːsədˈɪlɐ(͡c͡v) ˈʊ r l ˈa
Борис	bˈoɾɪs
Виктор	vˈɪktɔr
Елена	jelˈɛna
Илте	ˈɪltɛ
Испани	ɪspˈanɪ
Павлович	pavlˈovɪt͡ʃ
академин	ˌakadˈɛmɪn
ал	ˈal
император	ˌɪmpɛɾˈatɔr
кĕтсе	k (͡e͡n)ˌiːbɹˈiːv(͡c͡v) t s jˈɛ
коммуни	kɔmmˈunɪ
красноармеец	krˌasnoarmˈɛɛt͡s
облаçĕнче	ˈɔ b l ˈa (͡e͡n)sˌiːsədˈɪlɐ ˌiːbɹˈiːv(͡c͡v) n t͡ʃ jˈɛ
пĕрлешĕвĕн	p (͡e͡n)ˌiːbɹˈiːv(͡c͡v) r l jˈɛ ʃ (͡e͡n)ˌiːbɹˈiːv(͡c͡v) v (͡e͡n)ˌiːbɹˈiːv(͡c͡v) n
палăртать	p ˈa l (͡e͡n)ˌe͡ɪbɹˈiːv(͡c͡v) r t ˈa t
пулăшу	p ˈʊ l (͡e͡n)ˌe͡ɪbɹˈiːv(͡c͡v) ʃ ˈʊ
пулĕ	p ˈʊ l (͡e͡n)ˌiːbɹˈiːv(͡c͡v)
пыма	pˈɯma
пысăках	p ˈɯ s (͡e͡n)ˌe͡ɪbɹˈiːv(͡c͡v) k ˈa x
тĕпчесе	t (͡e͡n)ˌiːbɹˈiːv(͡c͡v) p t͡ʃ jˈɛ s jˈɛ
таврăннă	t ˈa v r (͡e͡n)ˌe͡ɪbɹˈiːv(͡c͡v) n n (͡e͡n)ˌe͡ɪbɹˈiːv(͡c͡v)
тухтăрĕ	t ˈʊ x t (͡e͡n)ˌe͡ɪbɹˈiːv(͡c͡v) r (͡e͡n)ˌiːbɹˈiːv(͡c͡v)
тытма	tˈɯtma
тӑрать	tˈɯɾat
утравĕ	ˈʊ t r ˈa v (͡e͡n)ˌiːbɹˈiːv(͡c͡v)
ушкăн	ˈʊ ʃ k (͡e͡n)ˌe͡ɪbɹˈiːv(͡c͡v) n
хĕçпăшаллă	x (͡e͡n)ˌiːbɹˈiːv sˌiːsədˈɪlɐ(͡c͡v) p (͡e͡n)ˌe͡ɪbɹˈiːv(͡c͡v) ʃ ˈa l l (͡e͡n)ˌe͡ɪbɹˈiːv(͡c͡v)
хатĕр	x ˈa t (͡e͡n)ˌiːbɹˈiːv(͡c͡v) r
чĕлхене	t͡ʃ (͡e͡n)ˌiːbɹˈiːv(͡c͡v) l x jˈæ n jˈɛ
шыва	ʃˈɯva
ыйтнă	ˈɯ j t n (͡e͡n)ˌe͡ɪbɹˈiːv(͡c͡v)
элемент	elˈɛmɛnt
юханшывсем	jˌuxanʃˈɯvsɛm
çыннисен	(͡e͡n)sˌiːsədˈɪlɐ(͡c͡v) ˈɯ n n ˈɪ s jˈæ n
çӳрекен	(͡e͡n)sˌiːsədˈɪlɐ(͡c͡v) ˈø r jˈɛ k jˈæ n
Америка	ˌamɛɾˈika
Балтиçум	b ˈa l t ˈɪ (͡e͡n)sˌiːsədˈɪlɐ(͡c͡v) ˈʊ m
Мария	maɾˈija
Мезень	mˈɛzɛn
Элĕк	ˈæ l (͡e͡n)ˌiːbɹˈiːv(͡c͡v) k
Яла	jˈala
аван	ˈavan
административлӑ	ˌadminˌɪstratˈɪvlɯ
вăрçине	v (͡e͡n)ˌe͡ɪbɹˈiːv(͡c͡v) r (͡e͡n)sˌiːsədˈɪlɐ(͡c͡v) ˈɪ n jˈɛ
йышши	jˈɯʃʃɪ
кăвак	k (͡e͡n)ˌe͡ɪbɹˈiːv(͡c͡v) v ˈa k
мăн	m (͡e͡n)ˌe͡ɪbɹˈiːv(͡c͡v) n
нимĕçсем	n ˈɪ m (͡e͡n)ˌiːbɹˈiːv sˌiːsədˈɪlɐ(͡c͡v) s jˈæ m
пĕлтерĕшĕ	p (͡e͡n)ˌiːbɹˈiːv(͡c͡v) l t jˈɛ r (͡e͡n)ˌiːbɹˈiːv(͡c͡v) ʃ (͡e͡n)ˌiːbɹˈiːv(͡c͡v)
пайĕсене	p ˈa j (͡e͡n)ˌiːbɹˈiːv(͡c͡v) s jˈæ n jˈɛ
паллӑ	pˈallɯ
председателĕ	p r jˈɛ d s jˈɛ d ˈa t jˈæ l (͡e͡n)ˌiːbɹˈiːv(͡c͡v)
рольне	rˈɔlnɛ
сарă	s ˈa r (͡e͡n)ˌe͡ɪbɹˈiːv(͡c͡v)
сасси	sˈassɪ
сехет	sˈɛxɛt
системине	sˌɪstɛmˈinɛ
тивĕç	t ˈɪ v (͡e͡n)ˌiːbɹˈiːv sˌiːsədˈɪlɐ(͡c͡v)
тумалли	tumˈallɪ
участокĕ	ˈʊ t͡ʃ ˈa s t ˈɔ k (͡e͡n)ˌiːbɹˈiːv(͡c͡v)
хăваласа	x (͡e͡n)ˌe͡ɪbɹˈiːv(͡c͡v) v ˈa l ˈa s ˈa
хаяр	xˈajar
хута	xˈuta
хушăрах	x ˈʊ ʃ (͡e͡n)ˌe͡ɪbɹˈiːv(͡c͡v) r ˈa x
шайĕнче	ʃ ˈa j (͡e͡n)ˌiːbɹˈiːv(͡c͡v) n t͡ʃ jˈɛ
штурмлакан	ʃtʊrmlˈakan
ялавĕ	jˈa l ˈa v (͡e͡n)ˌiːbɹˈiːv(͡c͡v)
XVII	(͡e͡n)ˈɛks vˈiː ˈa͡ɪ ˈa͡ɪ(͡c͡v)
Çăмартисем	(͡e͡n)sˌiːsədˈɪlɐ ˌe͡ɪbɹˈiːv(͡c͡v) m ˈa r t ˈɪ s jˈæ m
Çĕпĕр	(͡e͡n)sˌiːsədˈɪlɐ ˌiːbɹˈiːv(͡c͡v) p (͡e͡n)ˌiːbɹˈiːv(͡c͡v) r
çç	(͡e͡n)sˌiːsədˈɪlɐ sˌiːsədˈɪlɐ(͡c͡v)
çĕрĕнче	(͡e͡n)sˌiːsədˈɪlɐ ˌiːbɹˈiːv(͡c͡v) r (͡e͡n)ˌiːbɹˈiːv(͡c͡v) n t͡ʃ jˈɛ
çĕрсенче	(͡e͡n)sˌiːsədˈɪlɐ ˌiːbɹˈiːv(͡c͡v) r s jˈæ n t͡ʃ jˈɛ
çулĕсенче	(͡e͡n)sˌiːsədˈɪlɐ(͡c͡v) ˈʊ l (͡e͡n)ˌiːbɹˈiːv(͡c͡v) s jˈæ n t͡ʃ jˈɛ
çултанпа	(͡e͡n)sˌiːsədˈɪlɐ(͡c͡v) ˈʊ l t ˈa n p ˈa
çуртне	(͡e͡n)sˌiːsədˈɪlɐ(͡c͡v) ˈʊ r t n jˈɛ
çухрăма	(͡e͡n)sˌiːsədˈɪlɐ(͡c͡v) ˈʊ x r (͡e͡n)ˌe͡ɪbɹˈiːv(͡c͡v) m ˈa
ĕçлеççĕ	(͡e͡n)ˌiːbɹˈiːv sˌiːsədˈɪlɐ(͡c͡v) l jˈɛ (͡e͡n)sˌiːsədˈɪlɐ sˌiːsədˈɪlɐ ˌiːbɹˈiːv(͡c͡v)
Алтай	ˈaltaj
Вашка	vˈaʃka
Владимирович	vlˌadimiɾˈovɪt͡ʃ
Мĕншĕн	m (͡e͡n)ˌiːbɹˈiːv(͡c͡v) n ʃ (͡e͡n)ˌiːbɹˈiːv(͡c͡v) n
Пĕчĕк	p (͡e͡n)ˌiːbɹˈiːv(͡c͡v) t͡ʃ (͡e͡n)ˌiːbɹˈiːv(͡c͡v) k
Павел	pˈavɛl
Тан	tˈan
Туçи	t ˈʊ (͡e͡n)sˌiːsədˈɪlɐ(͡c͡v) ˈɪ
Турă	t ˈʊ r (͡e͡n)ˌe͡ɪbɹˈiːv(͡c͡v)
Тутар	tˈutar
Халах	xˈalax
администрацийĕ	ˈa d m ˈɪ n ˈɪ s t r ˈa t͡s ˈɪ j (͡e͡n)ˌiːbɹˈiːv(͡c͡v)
арап	ˈaɾap
асăнаççĕ	ˈa s (͡e͡n)ˌe͡ɪbɹˈiːv(͡c͡v) n ˈa (͡e͡n)sˌiːsədˈɪlɐ sˌiːsədˈɪlɐ ˌiːbɹˈiːv(͡c͡v)
йĕр	j (͡e͡n)ˌiːbɹˈiːv(͡c͡v) r
кăларакан	k (͡e͡n)ˌe͡ɪbɹˈiːv(͡c͡v) l ˈa r ˈa k ˈa n
кĕнекинче	k (͡e͡n)ˌiːbɹˈiːv(͡c͡v) n jˈɛ k ˈɪ n t͡ʃ jˈɛ
килĕшӳ	k ˈɪ l (͡e͡n)ˌiːbɹˈiːv(͡c͡v) ʃ ˈø
начар	nˈat͡ʃar
пайăр	p ˈa j (͡e͡n)ˌe͡ɪbɹˈiːv(͡c͡v) r
пани	pˈanɪ
пуçлаççĕ	p ˈʊ (͡e͡n)sˌiːsədˈɪlɐ(͡c͡v) l ˈa (͡e͡n)sˌiːsədˈɪlɐ sˌiːsədˈɪlɐ ˌiːbɹˈiːv(͡c͡v)
пулакан	pulˈakan
пурне	pˈʊrnɛ
тăвăм	t (͡e͡n)ˌe͡ɪbɹˈiːv(͡c͡v) v (͡e͡n)ˌe͡ɪbɹˈiːv(͡c͡v) m
тĕплĕн	t (͡e͡n)ˌiːbɹˈiːv(͡c͡v) p l (͡e͡n)ˌiːbɹˈiːv(͡c͡v) n
тĕпченĕ	t (͡e͡n)ˌiːbɹˈiːv(͡c͡v) p t͡ʃ jˈæ n (͡e͡n)ˌiːbɹˈiːv(͡c͡v)
таврашĕнче	t ˈa v r ˈa ʃ (͡e͡n)ˌiːbɹˈiːv(͡c͡v) n t͡ʃ jˈɛ
театрĕ	t jˈɛ ˈa t r (͡e͡n)ˌiːbɹˈiːv(͡c͡v)
техника	tɛxnˈika
тимĕр	t ˈɪ m (͡e͡n)ˌiːbɹˈiːv(͡c͡v) r
транспорт	trˈanspɔrt
уçса	ˈʊ (͡e͡n)sˌiːsədˈɪlɐ(͡c͡v) s ˈa
училищинче	ˌut͡ʃiliççˈɪnt͡ʃɛ
фельдшер	fˈɛldʃɛr
хăмăр	x (͡e͡n)ˌe͡ɪbɹˈiːv(͡c͡v) m (͡e͡n)ˌe͡ɪbɹˈiːv(͡c͡v) r
хĕрринчи	x (͡e͡n)ˌiːbɹˈiːv(͡c͡v) r r ˈɪ n t͡ʃ ˈɪ
халӑх	xˈalɯx
хӑйӗн	xˈɯjɵn
хӳтĕленĕ	x ˈø t (͡e͡n)ˌiːbɹˈiːv(͡c͡v) l jˈæ n (͡e͡n)ˌiːbɹˈiːv(͡c͡v)
чĕлхисем	t͡ʃ (͡e͡n)ˌiːbɹˈiːv(͡c͡v) l x ˈɪ s jˈæ m
юн	jˈʊn
ялан	jˈalan
ялне	jˈalnɛ
ҫулхи	çˈʊlxɪ
çĕршывăн	(͡e͡n)sˌiːsədˈɪlɐ ˌiːbɹˈiːv(͡c͡v) r ʃ ˈɯ v (͡e͡n)ˌe͡ɪbɹˈiːv(͡c͡v) n
çех	(͡e͡n)sˌiːsədˈɪlɐ(͡c͡v) jˈɛ x
çут	(͡e͡n)sˌiːsədˈɪlɐ(͡c͡v) ˈʊ t
çухатнă	(͡e͡n)sˌiːsədˈɪlɐ(͡c͡v) ˈʊ x ˈa t n (͡e͡n)ˌe͡ɪbɹˈiːv(͡c͡v)
ăçта	(͡e͡n)ˌe͡ɪbɹˈiːv sˌiːsədˈɪlɐ(͡c͡v) t ˈa
ăслăлăхĕсен	(͡e͡n)ˌe͡ɪbɹˈiːv(͡c͡v) s l (͡e͡n)ˌe͡ɪbɹˈiːv(͡c͡v) l (͡e͡n)ˌe͡ɪbɹˈiːv(͡c͡v) x (͡e͡n)ˌiːbɹˈiːv(͡c͡v) s jˈæ n
Австрали	avstrˈalɪ
Англи	ˈanɡlɪ
Асăннă	ˈa s (͡e͡n)ˌe͡ɪbɹˈiːv(͡c͡v) n n (͡e͡n)ˌe͡ɪbɹˈiːv(͡c͡v)
Джон	dʒˈɔn
Колва	kˈɔlva
Лăпкă	l (͡e͡n)ˌe͡ɪbɹˈiːv(͡c͡v) p k (͡e͡n)ˌe͡ɪbɹˈiːv(͡c͡v)
Мари	mˈaɾɪ
Обь	ˈɔb
Олег	ˈolɛɡ
Официаллă	ˈɔ f ˈɪ t͡s ˈɪ ˈa l l (͡e͡n)ˌe͡ɪbɹˈiːv(͡c͡v)
Паллă	p ˈa l l (͡e͡n)ˌe͡ɪbɹˈiːv(͡c͡v)
Париж	pˈaɾɪʒ
Тĕслĕхрен	t (͡e͡n)ˌiːbɹˈiːv(͡c͡v) s l (͡e͡n)ˌiːbɹˈiːv(͡c͡v) x r jˈæ n
Украина	ˌʊkraˈina
Францири	frant͡sˈiɾɪ
авăн	ˈa v (͡e͡n)ˌe͡ɪbɹˈiːv(͡c͡v) n
аманнă	ˈa m ˈa n n (͡e͡n)ˌe͡ɪbɹˈiːv(͡c͡v)
вырăссем	v ˈɯ r (͡e͡n)ˌe͡ɪbɹˈiːv(͡c͡v) s s jˈæ m
вӑхӑтра	vɯxˈɯtra
герман	ɡˈɛrman
граждан	ɡrˈaʒdan
ен	jˈæn
илес	ˈilɛs
итал	ˈital
кăрлачăн	k (͡e͡n)ˌe͡ɪbɹˈiːv(͡c͡v) r l ˈa t͡ʃ (͡e͡n)ˌe͡ɪbɹˈiːv(͡c͡v) n
кулленхи	kʊllˈɛnxɪ
курнӑ	kˈʊrnɯ
лейтенанчĕ	l jˈɛ j t jˈæ n ˈa n t͡ʃ (͡e͡n)ˌiːbɹˈiːv(͡c͡v)
нимĕçсен	n ˈɪ m (͡e͡n)ˌiːbɹˈiːv sˌiːsədˈɪlɐ(͡c͡v) s jˈæ n
пĕрлĕ	p (͡e͡n)ˌiːbɹˈiːv(͡c͡v) r l (͡e͡n)ˌiːbɹˈiːv(͡c͡v)
пĕрри	p (͡e͡n)ˌiːbɹˈiːv(͡c͡v) r r ˈɪ
палăкĕ	p ˈa l (͡e͡n)ˌe͡ɪbɹˈiːv(͡c͡v) k (͡e͡n)ˌiːbɹˈiːv(͡c͡v)
парса	pˈarsa
промăçлăх	p r ˈɔ m (͡e͡n)ˌe͡ɪbɹˈiːv sˌiːsədˈɪlɐ(͡c͡v) l (͡e͡n)ˌe͡ɪbɹˈiːv(͡c͡v) x
пуçтарнă	p ˈʊ (͡e͡n)sˌiːsədˈɪlɐ(͡c͡v) t ˈa r n (͡e͡n)ˌe͡ɪbɹˈiːv(͡c͡v)
пысăкки	p ˈɯ s (͡e͡n)ˌe͡ɪbɹˈiːv(͡c͡v) k k ˈɪ
сăнарланă	s (͡e͡n)ˌe͡ɪbɹˈiːv(͡c͡v) n ˈa r l ˈa n (͡e͡n)ˌe͡ɪbɹˈiːv(͡c͡v)
сĕт	s (͡e͡n)ˌiːbɹˈiːv(͡c͡v) t
самаях	samˈajax
системи	sɪstˈɛmɪ
тăрăшать	t (͡e͡n)ˌe͡ɪbɹˈiːv(͡c͡v) r (͡e͡n)ˌe͡ɪbɹˈiːv(͡c͡v) ʃ ˈa t
таврăнсан	t ˈa v r (͡e͡n)ˌe͡ɪbɹˈiːv(͡c͡v) n s ˈa n
тутарсем	tutˈarsɛm
тытăмĕ	t ˈɯ t (͡e͡n)ˌe͡ɪbɹˈiːv(͡c͡v) m (͡e͡n)ˌiːbɹˈiːv(͡c͡v)
тытать	tˈɯtat
упранать	ʊprˈanat
фильмĕ	f ˈɪ l m (͡e͡n)ˌiːbɹˈiːv(͡c͡v)
хăватлă	x (͡e͡n)ˌe͡ɪbɹˈiːv(͡c͡v) v ˈa t l (͡e͡n)ˌe͡ɪbɹˈiːv(͡c͡v)
халăхсен	x ˈa l (͡e͡n)ˌe͡ɪbɹˈiːv(͡c͡v) x s jˈæ n
чăнах	t͡ʃ (͡e͡n)ˌe͡ɪbɹˈiːv(͡c͡v) n ˈa x
чухнехи	t͡ʃʊxnˈɛxɪ
чысланă	t͡ʃ ˈɯ s l ˈa n (͡e͡n)ˌe͡ɪbɹˈiːv(͡c͡v)
чӳкĕн	t͡ʃ ˈø k (͡e͡n)ˌiːbɹˈiːv(͡c͡v) n
шайĕнчен	ʃ ˈa j (͡e͡n)ˌiːbɹˈiːv(͡c͡v) n t͡ʃ jˈæ n
шывай	ʃˈɯvaj
шывпа	ʃˈɯvpa
шыраса	ʃɯɾˈasa
ывăлне	ˈɯ v (͡e͡n)ˌe͡ɪbɹˈiːv(͡c͡v) l n jˈɛ
юпписен	jʊppˈisɛn
ялĕнчен	jˈa l (͡e͡n)ˌiːbɹˈiːv(͡c͡v) n t͡ʃ jˈæ n
çулĕпе	(͡e͡n)sˌiːsədˈɪlɐ(͡c͡v) ˈʊ l (͡e͡n)ˌiːbɹˈiːv(͡c͡v) p jˈɛ
çунтарса	(͡e͡n)sˌiːsədˈɪlɐ(͡c͡v) ˈʊ n t ˈa r s ˈa
çх	(͡e͡n)sˌiːsədˈɪlɐ(͡c͡v) x
çынни	(͡e͡n)sˌiːsədˈɪlɐ(͡c͡v) ˈɯ n n ˈɪ
ĕçĕнче	(͡e͡n)ˌiːbɹˈiːv sˌiːsədˈɪlɐ ˌiːbɹˈiːv(͡c͡v) n t͡ʃ jˈɛ
ĕмĕрти	(͡e͡n)ˌiːbɹˈiːv(͡c͡v) m (͡e͡n)ˌiːbɹˈiːv(͡c͡v) r t ˈɪ
Геннадий	ɡɛnnˈadɪj
Норвеги	nɔrvˈɛɡɪ
Чĕлхе	t͡ʃ (͡e͡n)ˌiːbɹˈiːv(͡c͡v) l x jˈɛ
административлă	ˈa d m ˈɪ n ˈɪ s t r ˈa t ˈɪ v l (͡e͡n)ˌe͡ɪbɹˈiːv(͡c͡v)
влаçа	v l ˈa (͡e͡n)sˌiːsədˈɪlɐ(͡c͡v) ˈa
вунă	v ˈʊ n (͡e͡n)ˌe͡ɪbɹˈiːv(͡c͡v)
вуннă	v ˈʊ n n (͡e͡n)ˌe͡ɪbɹˈiːv(͡c͡v)
выльăх	v ˈɯ l (͡e͡n)ˌe͡ɪbɹˈiːv(͡c͡v) x
вылять	vˈɯljat
выр	vˈɯr
вырăнсенче	v ˈɯ r (͡e͡n)ˌe͡ɪbɹˈiːv(͡c͡v) n s jˈæ n t͡ʃ jˈɛ
институчĕ	ˈɪ n s t ˈɪ t ˈʊ t͡ʃ (͡e͡n)ˌiːbɹˈiːv(͡c͡v)
иртсе	ˈɪrtsɛ
кăтартма	k (͡e͡n)ˌe͡ɪbɹˈiːv(͡c͡v) t ˈa r t m ˈa
кайсан	kˈajsan
кивĕ	k ˈɪ v (͡e͡n)ˌiːbɹˈiːv(͡c͡v)
командирĕн	k ˈɔ m ˈa n d ˈɪ r (͡e͡n)ˌiːbɹˈiːv(͡c͡v) n
майор	mˈajɔr
математика	mˌatɛmatˈika
млрд	mlrd
океан	okˈɛan
пăлхар	p (͡e͡n)ˌe͡ɪbɹˈiːv(͡c͡v) l x ˈa r
парти	pˈartɪ
пултарулăхне	p ˈʊ l t ˈa r ˈʊ l (͡e͡n)ˌe͡ɪbɹˈiːv(͡c͡v) x n jˈɛ
редактор	rɛdˈaktɔr
таврăнать	t ˈa v r (͡e͡n)ˌe͡ɪbɹˈiːv(͡c͡v) n ˈa t
тарса	tˈarsa
тенӗ	tˈɛnɵ
техникумĕнче	t jˈɛ x n ˈɪ k ˈʊ m (͡e͡n)ˌiːbɹˈiːv(͡c͡v) n t͡ʃ jˈɛ
улăштарнă	ˈʊ l (͡e͡n)ˌe͡ɪbɹˈiːv(͡c͡v) ʃ t ˈa r n (͡e͡n)ˌe͡ɪbɹˈiːv(͡c͡v)
ура	ˈuɾa
утравĕсем	ˈʊ t r ˈa v (͡e͡n)ˌiːbɹˈiːv(͡c͡v) s jˈæ m
факультетне	fˌakʊltˈɛtnɛ
форми	fˈɔrmɪ
хăпартнă	x (͡e͡n)ˌe͡ɪbɹˈiːv(͡c͡v) p ˈa r t n (͡e͡n)ˌe͡ɪbɹˈiːv(͡c͡v)
халлĕхе	x ˈa l l (͡e͡n)ˌiːbɹˈiːv(͡c͡v) x jˈɛ
хулинчен	xulˈɪnt͡ʃɛn
ялĕн	jˈa l (͡e͡n)ˌiːbɹˈiːv(͡c͡v) n
ӳнерленĕ	ˈø n jˈɛ r l jˈæ n (͡e͡n)ˌiːbɹˈiːv(͡c͡v)
ӳссе	ˈøssɛ
The	(͡e͡n)tˈiː ˈe͡ɪt͡ʃ ˈiː(͡c͡v)
VI	(͡e͡n)vˈiː ˈa͡ɪ(͡c͡v)
Çакă	(͡e͡n)sˌiːsədˈɪlɐ(͡c͡v) ˈa k (͡e͡n)ˌe͡ɪbɹˈiːv(͡c͡v)
çĕнтернĕ	(͡e͡n)sˌiːsədˈɪlɐ ˌiːbɹˈiːv(͡c͡v) n t jˈɛ r n (͡e͡n)ˌiːbɹˈiːv(͡c͡v)
çемье	(͡e͡n)sˌiːsədˈɪlɐ(͡c͡v) jˈæ m jˈɛ
çиме	(͡e͡n)sˌiːsədˈɪlɐ(͡c͡v) ˈɪ m jˈɛ
çыру	(͡e͡n)sˌiːsədˈɪlɐ(͡c͡v) ˈɯ r ˈʊ
ĕçĕн	(͡e͡n)ˌiːbɹˈiːv sˌiːsədˈɪlɐ ˌiːbɹˈiːv(͡c͡v) n
Алексеевич	ˌalɛksɛˈɛvɪt͡ʃ
Балти	bˈaltɪ
Вӑл	vˈɯl
Григорий	ɡriɡˈoɾɪj
Етĕрне	jˈɛ t (͡e͡n)ˌiːbɹˈiːv(͡c͡v) r n jˈɛ
Кострома	kɔstrˈoma
Луза	lˈuza
Патша	pˈatʃa
Сăваплă	s (͡e͡n)ˌe͡ɪbɹˈiːv(͡c͡v) v ˈa p l (͡e͡n)ˌe͡ɪbɹˈiːv(͡c͡v)
Сулахай	sulˈaxaj
Тым	tˈɯm
вырăнсене	v ˈɯ r (͡e͡n)ˌe͡ɪbɹˈiːv(͡c͡v) n s jˈæ n jˈɛ
журнал	ʒˈʊrnal
икӗ	ˈikɵ
историйĕ	ˈɪ s t ˈɔ r ˈɪ j (͡e͡n)ˌiːbɹˈiːv(͡c͡v)
калани	kalˈanɪ
культури	kʊltˈuɾɪ
культурин	kʊltˈuɾɪn
литературине	lˌitɛɾˌatuɾˈinɛ
нимĕнле	n ˈɪ m (͡e͡n)ˌiːbɹˈiːv(͡c͡v) n l jˈɛ
операци	ˌopɛɾˈat͡sɪ
пăлхав	p (͡e͡n)ˌe͡ɪbɹˈiːv(͡c͡v) l x ˈa v
пĕлнĕ	p (͡e͡n)ˌiːbɹˈiːv(͡c͡v) l n (͡e͡n)ˌiːbɹˈiːv(͡c͡v)
патшалăха	p ˈa t ʃ ˈa l (͡e͡n)ˌe͡ɪbɹˈiːv(͡c͡v) x ˈa
сăмахпа	s (͡e͡n)ˌe͡ɪbɹˈiːv(͡c͡v) m ˈa x p ˈa
сăрт	s (͡e͡n)ˌe͡ɪbɹˈiːv(͡c͡v) r t
социаллă	s ˈɔ t͡s ˈɪ ˈa l l (͡e͡n)ˌe͡ɪbɹˈiːv(͡c͡v)
тăвĕ	t (͡e͡n)ˌe͡ɪbɹˈiːv(͡c͡v) v (͡e͡n)ˌiːbɹˈiːv(͡c͡v)
тăвасси	t (͡e͡n)ˌe͡ɪbɹˈiːv(͡c͡v) v ˈa s s ˈɪ
тăсăлать	t (͡e͡n)ˌe͡ɪbɹˈiːv(͡c͡v) s (͡e͡n)ˌe͡ɪbɹˈiːv(͡c͡v) l ˈa t
тенкĕ	t jˈæ n k (͡e͡n)ˌiːbɹˈiːv(͡c͡v)
территорийĕ	t jˈɛ r r ˈɪ t ˈɔ r ˈɪ j (͡e͡n)ˌiːbɹˈiːv(͡c͡v)
тинĕсĕн	t ˈɪ n (͡e͡n)ˌiːbɹˈiːv(͡c͡v) s (͡e͡n)ˌiːbɹˈiːv(͡c͡v) n
тулаш	tˈulaʃ
туни	tˈunɪ
тухнӑ	tˈʊxnɯ
тӑнӑ	tˈɯnɯ
улăштарма	ˈʊ l (͡e͡n)ˌe͡ɪbɹˈiːv(͡c͡v) ʃ t ˈa r m ˈa
хĕлле	x (͡e͡n)ˌiːbɹˈiːv(͡c͡v) l l jˈɛ
халăхăн	x ˈa l (͡e͡n)ˌe͡ɪbɹˈiːv(͡c͡v) x (͡e͡n)ˌe͡ɪbɹˈiːv(͡c͡v) n
чылайăшĕ	t͡ʃ ˈɯ l ˈa j (͡e͡n)ˌe͡ɪbɹˈiːv(͡c͡v) ʃ (͡e͡n)ˌiːbɹˈiːv(͡c͡v)
шайĕ	ʃ ˈa j (͡e͡n)ˌiːbɹˈiːv(͡c͡v)
ырă	ˈɯ r (͡e͡n)ˌe͡ɪbɹˈiːv(͡c͡v)
ыт	ˈɯt
эрăчченхи	ˈɛ r (͡e͡n)ˌe͡ɪbɹˈiːv(͡c͡v) t͡ʃ t͡ʃ jˈæ n x ˈɪ
эрехсем	eɾˈɛxsɛm
юрланă	jˈʊ r l ˈa n (͡e͡n)ˌe͡ɪbɹˈiːv(͡c͡v)
яма	jˈama
япаласем	jˌapalˈasɛm
ячĕсене	jˈa t͡ʃ (͡e͡n)ˌiːbɹˈiːv(͡c͡v) s jˈæ n jˈɛ
ҫавӑн	çˈavɯn
ISO	(͡e͡n)ˈa͡ɪ ˈɛs ˈə͡ʊ(͡c͡v)
çара	(͡e͡n)sˌiːsədˈɪlɐ(͡c͡v) ˈa r ˈa
çивĕч	(͡e͡n)sˌiːsədˈɪlɐ(͡c͡v) ˈɪ v (͡e͡n)ˌiːbɹˈiːv(͡c͡v) t͡ʃ
çулсем	(͡e͡n)sˌiːsədˈɪlɐ(͡c͡v) ˈʊ l s jˈæ m
çуралать	(͡e͡n)sˌiːsədˈɪlɐ(͡c͡v) ˈʊ r ˈa l ˈa t
çыраççĕ	(͡e͡n)sˌiːsədˈɪlɐ(͡c͡v) ˈɯ r ˈa (͡e͡n)sˌiːsədˈɪlɐ sˌiːsədˈɪlɐ ˌiːbɹˈiːv(͡c͡v)
çыравçисен	(͡e͡n)sˌiːsədˈɪlɐ(͡c͡v) ˈɯ r ˈa v (͡e͡n)sˌiːsədˈɪlɐ(͡c͡v) ˈɪ s jˈæ n
çӳллĕшĕ	(͡e͡n)sˌiːsədˈɪlɐ(͡c͡v) ˈø l l (͡e͡n)ˌiːbɹˈiːv(͡c͡v) ʃ (͡e͡n)ˌiːbɹˈiːv(͡c͡v)
ăсталăхне	(͡e͡n)ˌe͡ɪbɹˈiːv(͡c͡v) s t ˈa l (͡e͡n)ˌe͡ɪbɹˈiːv(͡c͡v) x n jˈɛ
ĕçĕсен	(͡e͡n)ˌiːbɹˈiːv sˌiːsədˈɪlɐ ˌiːbɹˈiːv(͡c͡v) s jˈæ n
ĕçĕсенче	(͡e͡n)ˌiːbɹˈiːv sˌiːsədˈɪlɐ ˌiːbɹˈiːv(͡c͡v) s jˈæ n t͡ʃ jˈɛ
Австри	ˈavstrɪ
Апла	ˈapla
Вăрман	v (͡e͡n)ˌe͡ɪbɹˈiːv(͡c͡v) r m ˈa n
Кĕçтен	k (͡e͡n)ˌiːbɹˈiːv sˌiːsədˈɪlɐ(͡c͡v) t jˈæ n
Литература	lˌitɛɾatˈuɾa
Оскар	ˈɔskar
Павлов	pˈavlɔv
Тутарстан	tutˈarstan
Унтан	ˈʊntan
Утрав	ˈʊtrav
Францин	frˈant͡sɪn
Христос	xrˈɪstɔs
Хулан	xˈulan
Чĕмпĕрти	t͡ʃ (͡e͡n)ˌiːbɹˈiːv(͡c͡v) m p (͡e͡n)ˌiːbɹˈiːv(͡c͡v) r t ˈɪ
Юган	jˈuɡan
автомобиль	ˌavtomˈobɪl
аннă	ˈa n n (͡e͡n)ˌe͡ɪbɹˈiːv(͡c͡v)
аталантарас	ˌatalantˈaɾas
ачасен	at͡ʃˈasɛn
вăйă	v (͡e͡n)ˌe͡ɪbɹˈiːv(͡c͡v) j (͡e͡n)ˌe͡ɪbɹˈiːv(͡c͡v)
вăхăтри	v (͡e͡n)ˌe͡ɪbɹˈiːv(͡c͡v) x (͡e͡n)ˌe͡ɪbɹˈiːv(͡c͡v) t r ˈɪ
вĕçленĕ	v (͡e͡n)ˌiːbɹˈiːv sˌiːsədˈɪlɐ(͡c͡v) l jˈæ n (͡e͡n)ˌiːbɹˈiːv(͡c͡v)
вак	vˈak
вырăнсем	v ˈɯ r (͡e͡n)ˌe͡ɪbɹˈiːv(͡c͡v) n s jˈæ m
газ	ɡˈaz
еврей	jˈɛvrɛj
ислам	ˈɪslam
историллĕ	ˈɪ s t ˈɔ r ˈɪ l l (͡e͡n)ˌiːbɹˈiːv(͡c͡v)
кăрлач	k (͡e͡n)ˌe͡ɪbɹˈiːv(͡c͡v) r l ˈa t͡ʃ
кĕртме	k (͡e͡n)ˌiːbɹˈiːv(͡c͡v) r t m jˈɛ
канашĕн	k ˈa n ˈa ʃ (͡e͡n)ˌiːbɹˈiːv(͡c͡v) n
килеççĕ	k ˈɪ l jˈɛ (͡e͡n)sˌiːsədˈɪlɐ sˌiːsədˈɪlɐ ˌiːbɹˈiːv(͡c͡v)
колхоз	kˈɔlxɔz
куçма	k ˈʊ (͡e͡n)sˌiːsədˈɪlɐ(͡c͡v) m ˈa
лаша	lˈaʃa
малти	mˈaltɪ
музей	mˈuzɛj
пăхма	p (͡e͡n)ˌe͡ɪbɹˈiːv(͡c͡v) x m ˈa
пĕрлешнĕ	p (͡e͡n)ˌiːbɹˈiːv(͡c͡v) r l jˈɛ ʃ n (͡e͡n)ˌiːbɹˈiːv(͡c͡v)
парне	pˈarnɛ
парни	pˈarnɪ
пуçарса	p ˈʊ (͡e͡n)sˌiːsədˈɪlɐ(͡c͡v) ˈa r s ˈa
пулăшать	p ˈʊ l (͡e͡n)ˌe͡ɪbɹˈiːv(͡c͡v) ʃ ˈa t
пурнăçне	p ˈʊ r n (͡e͡n)ˌe͡ɪbɹˈiːv sˌiːsədˈɪlɐ(͡c͡v) n jˈɛ
пурнăçра	p ˈʊ r n (͡e͡n)ˌe͡ɪbɹˈiːv sˌiːsədˈɪlɐ(͡c͡v) r ˈa
пӗрремӗш	pɵrrˈɛmɵʃ
разведка	razvˈɛdka
раштавăн	r ˈa ʃ t ˈa v (͡e͡n)ˌe͡ɪbɹˈiːv(͡c͡v) n
сăввисене	s (͡e͡n)ˌe͡ɪbɹˈiːv(͡c͡v) v v ˈɪ s jˈæ n jˈɛ
сарлака	sarlˈaka
терминпа	tɛrmˈɪnpa
турă	t ˈʊ r (͡e͡n)ˌe͡ɪbɹˈiːv(͡c͡v)
тытаççĕ	t ˈɯ t ˈa (͡e͡n)sˌiːsədˈɪlɐ sˌiːsədˈɪlɐ ˌiːbɹˈiːv(͡c͡v)
уйăраççĕ	ˈʊ j (͡e͡n)ˌe͡ɪbɹˈiːv(͡c͡v) r ˈa (͡e͡n)sˌiːsədˈɪlɐ sˌiːsədˈɪlɐ ˌiːbɹˈiːv(͡c͡v)
университетĕнче	ˈʊ n ˈɪ v jˈɛ r s ˈɪ t jˈɛ t (͡e͡n)ˌiːbɹˈiːv(͡c͡v) n t͡ʃ jˈɛ
футбол	fˈʊtbɔl
хĕвел	x (͡e͡n)ˌiːbɹˈiːv(͡c͡v) v jˈæ l
халалланă	x ˈa l ˈa l l ˈa n (͡e͡n)ˌe͡ɪbɹˈiːv(͡c͡v)
хуласем	xulˈasɛm
хулисем	xulˈisɛm
хывнă	x ˈɯ v n (͡e͡n)ˌe͡ɪbɹˈiːv(͡c͡v)
юратнă	jˈʊ r ˈa t n (͡e͡n)ˌe͡ɪbɹˈiːv(͡c͡v)
ÇП	(͡e͡n)sˌiːsədˈɪlɐ(͡c͡v) p
Çу	(͡e͡n)sˌiːsədˈɪlɐ(͡c͡v) ˈʊ
çĕрне	(͡e͡n)sˌiːsədˈɪlɐ ˌiːbɹˈiːv(͡c͡v) r n jˈɛ
çĕртмен	(͡e͡n)sˌiːsədˈɪlɐ ˌiːbɹˈiːv(͡c͡v) r t m jˈæ n
çĕршывра	(͡e͡n)sˌiːsədˈɪlɐ ˌiːbɹˈiːv(͡c͡v) r ʃ ˈɯ v r ˈa
çитсе	(͡e͡n)sˌiːsədˈɪlɐ(͡c͡v) ˈɪ t s jˈɛ
çичĕ	(͡e͡n)sˌiːsədˈɪlɐ(͡c͡v) ˈɪ t͡ʃ (͡e͡n)ˌiːbɹˈiːv(͡c͡v)
çулсен	(͡e͡n)sˌiːsədˈɪlɐ(͡c͡v) ˈʊ l s jˈæ n
çуртсем	(͡e͡n)sˌiːsədˈɪlɐ(͡c͡v) ˈʊ r t s jˈæ m
çыранĕ	(͡e͡n)sˌiːsədˈɪlɐ(͡c͡v) ˈɯ r ˈa n (͡e͡n)ˌiːbɹˈiːv(͡c͡v)
çӳреççĕ	(͡e͡n)sˌiːsədˈɪlɐ(͡c͡v) ˈø r jˈɛ (͡e͡n)sˌiːsədˈɪlɐ sˌiːsədˈɪlɐ ˌiːbɹˈiːv(͡c͡v)
ăсталанă	(͡e͡n)ˌe͡ɪbɹˈiːv(͡c͡v) s t ˈa l ˈa n (͡e͡n)ˌe͡ɪbɹˈiːv(͡c͡v)
ĕçĕсемпе	(͡e͡n)ˌiːbɹˈiːv sˌiːsədˈɪlɐ ˌiːbɹˈiːv(͡c͡v) s jˈæ m p jˈɛ
Вырăнти	v ˈɯ r (͡e͡n)ˌe͡ɪbɹˈiːv(͡c͡v) n t ˈɪ
Григорьевич	ɡrˌiɡɔrʲˈɛvɪt͡ʃ
Енчен	jˈænt͡ʃɛn
Кара	kˈaɾa
Лев	lˈɛv
Монголи	mɔnɡˈolɪ
Николаев	nˌikolˈaɛv
Ольга	ˈɔlɡa
Паян	pˈajan
Чăн	t͡ʃ (͡e͡n)ˌe͡ɪbɹˈiːv(͡c͡v) n
Чулхула	t͡ʃʊlxˈula
анлăшĕ	ˈa n l (͡e͡n)ˌe͡ɪbɹˈiːv(͡c͡v) ʃ (͡e͡n)ˌiːbɹˈiːv(͡c͡v)
вĕçсе	v (͡e͡n)ˌiːbɹˈiːv sˌiːsədˈɪlɐ(͡c͡v) s jˈɛ
вĕренет	v (͡e͡n)ˌiːbɹˈiːv(͡c͡v) r jˈæ n jˈɛ t
вĕрентекен	v (͡e͡n)ˌiːbɹˈiːv(͡c͡v) r jˈæ n t jˈɛ k jˈæ n
вилет	vˈilɛt
вилсе	vˈɪlsɛ
вилсен	vˈɪlsɛn
вулавăшĕ	v ˈʊ l ˈa v (͡e͡n)ˌe͡ɪbɹˈiːv(͡c͡v) ʃ (͡e͡n)ˌiːbɹˈiːv(͡c͡v)
выртать	vˈɯrtat
империйĕ	ˈɪ m p jˈɛ r ˈɪ j (͡e͡n)ˌiːbɹˈiːv(͡c͡v)
информаци	ˌɪnfɔrmˈat͡sɪ
иртеççĕ	ˈɪ r t jˈɛ (͡e͡n)sˌiːsədˈɪlɐ sˌiːsədˈɪlɐ ˌiːbɹˈiːv(͡c͡v)
йышăнма	j ˈɯ ʃ (͡e͡n)ˌe͡ɪbɹˈiːv(͡c͡v) n m ˈa
йышĕнче	j ˈɯ ʃ (͡e͡n)ˌiːbɹˈiːv(͡c͡v) n t͡ʃ jˈɛ
кĕртсе	k (͡e͡n)ˌiːbɹˈiːv(͡c͡v) r t s jˈɛ
кĕскен	k (͡e͡n)ˌiːbɹˈiːv(͡c͡v) s k jˈæ n
килĕшмен	k ˈɪ l (͡e͡n)ˌiːbɹˈiːv(͡c͡v) ʃ m jˈæ n
киле	kˈilɛ
килте	kˈɪltɛ
куçараççĕ	k ˈʊ (͡e͡n)sˌiːsədˈɪlɐ(͡c͡v) ˈa r ˈa (͡e͡n)sˌiːsədˈɪlɐ sˌiːsədˈɪlɐ ˌiːbɹˈiːv(͡c͡v)
кунне	kˈʊnnɛ
курать	kˈuɾat
лайăхрах	l ˈa j (͡e͡n)ˌe͡ɪbɹˈiːv(͡c͡v) x r ˈa x
лартма	lˈartma
лат	lˈat
мĕш	m (͡e͡n)ˌiːbɹˈiːv(͡c͡v) ʃ
на	nˈa
нӳрĕк	n ˈø r (͡e͡n)ˌiːbɹˈiːv(͡c͡v) k
отделени	ˌɔtdɛlˈɛnɪ
пĕлме	p (͡e͡n)ˌiːbɹˈiːv(͡c͡v) l m jˈɛ
пайланă	p ˈa j l ˈa n (͡e͡n)ˌe͡ɪbɹˈiːv(͡c͡v)
паян	pˈajan
пичетленсе	pˌit͡ʃɛtlˈɛnsɛ
пичетлесе	pˌit͡ʃɛtlˈɛsɛ
премине	prɛmˈinɛ
пурĕпе	p ˈʊ r (͡e͡n)ˌiːbɹˈiːv(͡c͡v) p jˈɛ
пуррине	pʊrrˈinɛ
пухса	pˈʊxsa
самолёт	samˈɔljɔt
статусне	statˈʊsnɛ
сумлă	s ˈʊ m l (͡e͡n)ˌe͡ɪbɹˈiːv(͡c͡v)
тăваттă	t (͡e͡n)ˌe͡ɪbɹˈiːv(͡c͡v) v ˈa t t (͡e͡n)ˌe͡ɪbɹˈiːv(͡c͡v)
тăрăхĕнчи	t (͡e͡n)ˌe͡ɪbɹˈiːv(͡c͡v) r (͡e͡n)ˌe͡ɪbɹˈiːv(͡c͡v) x (͡e͡n)ˌiːbɹˈiːv(͡c͡v) n t͡ʃ ˈɪ
тăратнă	t (͡e͡n)ˌe͡ɪbɹˈiːv(͡c͡v) r ˈa t n (͡e͡n)ˌe͡ɪbɹˈiːv(͡c͡v)
тапхăр	t ˈa p x (͡e͡n)ˌe͡ɪbɹˈiːv(͡c͡v) r
тарнă	t ˈa r n (͡e͡n)ˌe͡ɪbɹˈiːv(͡c͡v)
татса	tˈatsa
теорийĕ	t jˈɛ ˈɔ r ˈɪ j (͡e͡n)ˌiːbɹˈiːv(͡c͡v)
тискер	tˈɪskɛr
тупма	tˈʊpma
тырă	t ˈɯ r (͡e͡n)ˌe͡ɪbɹˈiːv(͡c͡v)
унашкал	unˈaʃkal
унран	ˈʊnran
филологи	fˌilolˈoɡɪ
хуларан	xulˈaɾan
хулинчи	xulˈɪnt͡ʃɪ
хушамат	xuʃˈamat
хыҫҫӑн	xˈɯççɯn
чĕлхинчен	t͡ʃ (͡e͡n)ˌiːbɹˈiːv(͡c͡v) l x ˈɪ n t͡ʃ jˈæ n
чĕрчун	t͡ʃ (͡e͡n)ˌiːbɹˈiːv(͡c͡v) r t͡ʃ ˈʊ n
чарнă	t͡ʃ ˈa r n (͡e͡n)ˌe͡ɪbɹˈiːv(͡c͡v)
чуллă	t͡ʃ ˈʊ l l (͡e͡n)ˌe͡ɪbɹˈiːv(͡c͡v)
чысласа	t͡ʃɯslˈasa
эпĕ	ˈɛ p (͡e͡n)ˌiːbɹˈiːv(͡c͡v)
ҫинче	çˈɪnt͡ʃɛ
ӳкет	ˈykɛt
Çеçпĕл	(͡e͡n)sˌiːsədˈɪlɐ(͡c͡v) jˈɛ (͡e͡n)sˌiːsədˈɪlɐ(͡c͡v) p (͡e͡n)ˌiːbɹˈiːv(͡c͡v) l
çитеççĕ	(͡e͡n)sˌiːsədˈɪlɐ(͡c͡v) ˈɪ t jˈɛ (͡e͡n)sˌiːsədˈɪlɐ sˌiːsədˈɪlɐ ˌiːbɹˈiːv(͡c͡v)
çитсен	(͡e͡n)sˌiːsədˈɪlɐ(͡c͡v) ˈɪ t s jˈæ n
çӳллĕшĕнче	(͡e͡n)sˌiːsədˈɪlɐ(͡c͡v) ˈø l l (͡e͡n)ˌiːbɹˈiːv(͡c͡v) ʃ (͡e͡n)ˌiːbɹˈiːv(͡c͡v) n t͡ʃ jˈɛ
ăста	(͡e͡n)ˌe͡ɪbɹˈiːv(͡c͡v) s t ˈa
Атлантика	ˌatlantˈika
В	v
Васильев	vasˈɪlʲɛv
Георгий	ɡɛˈɔrɡɪj
Иçĕм	ˈɪ (͡e͡n)sˌiːsədˈɪlɐ ˌiːbɹˈiːv(͡c͡v) m
Ивановна	ˌivanˈɔvna
Иран	ˈiɾan
Ирина	iɾˈina
Кĕçех	k (͡e͡n)ˌiːbɹˈiːv sˌiːsədˈɪlɐ(͡c͡v) jˈɛ x
Красноармейски	krˌasnoarmˈɛjskɪ
Ли	lˈɪ
Малалла	malˈalla
Марк	mˈark
Паттăрĕ	p ˈa t t (͡e͡n)ˌe͡ɪbɹˈiːv(͡c͡v) r (͡e͡n)ˌiːbɹˈiːv(͡c͡v)
Районăн	r ˈa j ˈɔ n (͡e͡n)ˌe͡ɪbɹˈiːv(͡c͡v) n
Республика	rˌɛspʊblˈika
Театр	tˈɛatr
Францире	frant͡sˈiɾɛ
Фёдор	fjˈodɔr
Чăвашла	t͡ʃ (͡e͡n)ˌe͡ɪbɹˈiːv(͡c͡v) v ˈa ʃ l ˈa
Юханшывăн	jˈʊ x ˈa n ʃ ˈɯ v (͡e͡n)ˌe͡ɪbɹˈiːv(͡c͡v) n
Ялти	jˈaltɪ
администраци	ˌadminɪstrˈat͡sɪ
анлăн	ˈa n l (͡e͡n)ˌe͡ɪbɹˈiːv(͡c͡v) n
ачи	ˈat͡ʃɪ
вĕçен	v (͡e͡n)ˌiːbɹˈiːv sˌiːsədˈɪlɐ(͡c͡v) jˈæ n
влаçне	v l ˈa (͡e͡n)sˌiːsədˈɪlɐ(͡c͡v) n jˈɛ
доцент	dˈot͡sɛnt
европа	jɛvrˈopa
завочĕ	z ˈa v ˈɔ t͡ʃ (͡e͡n)ˌiːbɹˈiːv(͡c͡v)
изотоп	izˈotɔp
институтне	ˌɪnstitˈʊtnɛ
ирттерме	ɪrttˈɛrmɛ
йывăрăшĕ	j ˈɯ v (͡e͡n)ˌe͡ɪbɹˈiːv(͡c͡v) r (͡e͡n)ˌe͡ɪbɹˈiːv(͡c͡v) ʃ (͡e͡n)ˌiːbɹˈiːv(͡c͡v)
йышăнса	j ˈɯ ʃ (͡e͡n)ˌe͡ɪbɹˈiːv(͡c͡v) n s ˈa
кăмăлланă	k (͡e͡n)ˌe͡ɪbɹˈiːv(͡c͡v) m (͡e͡n)ˌe͡ɪbɹˈiːv(͡c͡v) l l ˈa n (͡e͡n)ˌe͡ɪbɹˈiːv(͡c͡v)
кĕрешме	k (͡e͡n)ˌiːbɹˈiːv(͡c͡v) r jˈɛ ʃ m jˈɛ
кĕртет	k (͡e͡n)ˌiːbɹˈiːv(͡c͡v) r t jˈɛ t
кайни	kˈajnɪ
каланипе	kˌalanˈipɛ
керменĕ	k jˈɛ r m jˈæ n (͡e͡n)ˌiːbɹˈiːv(͡c͡v)
килĕшӳллĕ	k ˈɪ l (͡e͡n)ˌiːbɹˈiːv(͡c͡v) ʃ ˈø l l (͡e͡n)ˌiːbɹˈiːv(͡c͡v)
куна	kˈuna
материал	mˌatɛɾˈial
никĕсĕпе	n ˈɪ k (͡e͡n)ˌiːbɹˈiːv(͡c͡v) s (͡e͡n)ˌiːbɹˈiːv(͡c͡v) p jˈɛ
опера	opˈɛɾa
пĕрлĕхне	p (͡e͡n)ˌiːbɹˈiːv(͡c͡v) r l (͡e͡n)ˌiːbɹˈiːv(͡c͡v) x n jˈɛ
пĕтĕмпе	p (͡e͡n)ˌiːbɹˈiːv(͡c͡v) t (͡e͡n)ˌiːbɹˈiːv(͡c͡v) m p jˈɛ
пĕчĕкрех	p (͡e͡n)ˌiːbɹˈiːv(͡c͡v) t͡ʃ (͡e͡n)ˌiːbɹˈiːv(͡c͡v) k r jˈɛ x
паллашать	pallˈaʃat
паман	pˈaman
паттăр	p ˈa t t (͡e͡n)ˌe͡ɪbɹˈiːv(͡c͡v) r
пахалăхĕ	p ˈa x ˈa l (͡e͡n)ˌe͡ɪbɹˈiːv(͡c͡v) x (͡e͡n)ˌiːbɹˈiːv(͡c͡v)
пикеннĕ	p ˈɪ k jˈæ n n (͡e͡n)ˌiːbɹˈiːv(͡c͡v)
пит	pˈɪt
провинци	provˈɪnt͡sɪ
пултаруллă	p ˈʊ l t ˈa r ˈʊ l l (͡e͡n)ˌe͡ɪbɹˈiːv(͡c͡v)
пусса	pˈʊssa
райцентра	rajt͡sˈɛntra
революцийĕ	r jˈɛ v ˈɔ l jˈʊ t͡s ˈɪ j (͡e͡n)ˌiːbɹˈiːv(͡c͡v)
республикин	rˌɛspʊblˈikɪn
сăвăç	s (͡e͡n)ˌe͡ɪbɹˈiːv(͡c͡v) v (͡e͡n)ˌe͡ɪbɹˈiːv sˌiːsədˈɪlɐ(͡c͡v)
сĕм	s (͡e͡n)ˌiːbɹˈiːv(͡c͡v) m
сĕмĕ	s (͡e͡n)ˌiːbɹˈiːv(͡c͡v) m (͡e͡n)ˌiːbɹˈiːv(͡c͡v)
саралнă	s ˈa r ˈa l n (͡e͡n)ˌe͡ɪbɹˈiːv(͡c͡v)
тăм	t (͡e͡n)ˌe͡ɪbɹˈiːv(͡c͡v) m
тĕне	t (͡e͡n)ˌiːbɹˈiːv(͡c͡v) n jˈɛ
тĕнчерен	t (͡e͡n)ˌiːbɹˈiːv(͡c͡v) n t͡ʃ jˈɛ r jˈæ n
тĕплĕ	t (͡e͡n)ˌiːbɹˈiːv(͡c͡v) p l (͡e͡n)ˌiːbɹˈiːv(͡c͡v)
тĕпчет	t (͡e͡n)ˌiːbɹˈiːv(͡c͡v) p t͡ʃ jˈɛ t
танксене	tanksˈɛnɛ
тв	tv
театрĕн	t jˈɛ ˈa t r (͡e͡n)ˌiːbɹˈiːv(͡c͡v) n
театрĕнче	t jˈɛ ˈa t r (͡e͡n)ˌiːbɹˈiːv(͡c͡v) n t͡ʃ jˈɛ
тин	tˈɪn
уйăрма	ˈʊ j (͡e͡n)ˌe͡ɪbɹˈiːv(͡c͡v) r m ˈa
умне	ˈʊmnɛ
физика	fizˈika
хĕвеланăçнелле	x (͡e͡n)ˌiːbɹˈiːv(͡c͡v) v jˈæ l ˈa n (͡e͡n)ˌe͡ɪbɹˈiːv sˌiːsədˈɪlɐ(͡c͡v) n jˈæ l l jˈɛ
хĕвелтухăç	x (͡e͡n)ˌiːbɹˈiːv(͡c͡v) v jˈæ l t ˈʊ x (͡e͡n)ˌe͡ɪbɹˈiːv sˌiːsədˈɪlɐ(͡c͡v)
хан	xˈan
хатĕрлеççĕ	x ˈa t (͡e͡n)ˌiːbɹˈiːv(͡c͡v) r l jˈɛ (͡e͡n)sˌiːsədˈɪlɐ sˌiːsədˈɪlɐ ˌiːbɹˈiːv(͡c͡v)
хресчен	xrˈɛst͡ʃɛn
хутăш	x ˈʊ t (͡e͡n)ˌe͡ɪbɹˈiːv(͡c͡v) ʃ
чапа	t͡ʃˈapa
шутпа	ʃˈʊtpa
ывăл	ˈɯ v (͡e͡n)ˌe͡ɪbɹˈiːv(͡c͡v) l
этеплĕх	ˈɛ t jˈɛ p l (͡e͡n)ˌiːbɹˈiːv(͡c͡v) x
юпписем	jʊppˈisɛm
ялĕнчи	jˈa l (͡e͡n)ˌiːbɹˈiːv(͡c͡v) n t͡ʃ ˈɪ
XVI	(͡e͡n)ˈɛks vˈiː ˈa͡ɪ(͡c͡v)
çĕрĕсенче	(͡e͡n)sˌiːsədˈɪlɐ ˌiːbɹˈiːv(͡c͡v) r (͡e͡n)ˌiːbɹˈiːv(͡c͡v) s jˈæ n t͡ʃ jˈɛ
çĕртре	(͡e͡n)sˌiːsədˈɪlɐ ˌiːbɹˈiːv(͡c͡v) r t r jˈɛ
çĕршыва	(͡e͡n)sˌiːsədˈɪlɐ ˌiːbɹˈiːv(͡c͡v) r ʃ ˈɯ v ˈa
çамрăксен	(͡e͡n)sˌiːsədˈɪlɐ(͡c͡v) ˈa m r (͡e͡n)ˌe͡ɪbɹˈiːv(͡c͡v) k s jˈæ n
çанталăк	(͡e͡n)sˌiːsədˈɪlɐ(͡c͡v) ˈa n t ˈa l (͡e͡n)ˌe͡ɪbɹˈiːv(͡c͡v) k
çутта	(͡e͡n)sˌiːsədˈɪlɐ(͡c͡v) ˈʊ t t ˈa
çухалнă	(͡e͡n)sˌiːsədˈɪlɐ(͡c͡v) ˈʊ x ˈa l n (͡e͡n)ˌe͡ɪbɹˈiːv(͡c͡v)
ăсти	(͡e͡n)ˌe͡ɪbɹˈiːv(͡c͡v) s t ˈɪ
ĕçлесе	(͡e͡n)ˌiːbɹˈiːv sˌiːsədˈɪlɐ(͡c͡v) l jˈɛ s jˈɛ
ĕçтешĕ	(͡e͡n)ˌiːbɹˈiːv sˌiːsədˈɪlɐ(͡c͡v) t jˈɛ ʃ (͡e͡n)ˌiːbɹˈiːv(͡c͡v)
Азире	azˈiɾɛ
Андреевич	ˌandrɛˈɛvɪt͡ʃ
Ватă	v ˈa t (͡e͡n)ˌe͡ɪbɹˈiːv(͡c͡v)
Золотов	zolˈotɔv
Израиль	ɪzrˈaɪl
Красноярск	krasnˈojarsk
Литва	lˈɪtva
Маларах	malˈaɾax
Николаевна	nˌikolaˈɛvna
Нимĕç	n ˈɪ m (͡e͡n)ˌiːbɹˈiːv sˌiːsədˈɪlɐ(͡c͡v)
Пĕтĕмĕшле	p (͡e͡n)ˌiːbɹˈiːv(͡c͡v) t (͡e͡n)ˌiːbɹˈiːv(͡c͡v) m (͡e͡n)ˌiːbɹˈiːv(͡c͡v) ʃ l jˈɛ
Патăрьел	p ˈa t (͡e͡n)ˌe͡ɪbɹˈiːv(͡c͡v) r jˈæ l
Питĕ	p ˈɪ t (͡e͡n)ˌiːbɹˈiːv(͡c͡v)
Польша	pˈɔlʃa
Таса	tˈasa
Унпа	ˈʊnpa
Федераци	fˌɛdɛɾˈat͡sɪ
Филипп	fˈilɪpp
Хĕвелтухăç	x (͡e͡n)ˌiːbɹˈiːv(͡c͡v) v jˈæ l t ˈʊ x (͡e͡n)ˌe͡ɪbɹˈiːv sˌiːsədˈɪlɐ(͡c͡v)
Хулана	xulˈana
Чăвашсем	t͡ʃ (͡e͡n)ˌe͡ɪbɹˈiːv(͡c͡v) v ˈa ʃ s jˈæ m
Шкулта	ʃkˈʊlta
Ялав	jˈalav
авăнăн	ˈa v (͡e͡n)ˌe͡ɪbɹˈiːv(͡c͡v) n (͡e͡n)ˌe͡ɪbɹˈiːv(͡c͡v) n
айăпласа	ˈa j (͡e͡n)ˌe͡ɪbɹˈiːv(͡c͡v) p l ˈa s ˈa
аллинче	allˈɪnt͡ʃɛ
анăçалла	ˈa n (͡e͡n)ˌe͡ɪbɹˈiːv sˌiːsədˈɪlɐ(͡c͡v) ˈa l l ˈa
аталанма	ˌatalˈanma
аякри	ajˈakrɪ
вăйĕсем	v (͡e͡n)ˌe͡ɪbɹˈiːv(͡c͡v) j (͡e͡n)ˌiːbɹˈiːv(͡c͡v) s jˈæ m
вăрçа	v (͡e͡n)ˌe͡ɪbɹˈiːv(͡c͡v) r (͡e͡n)sˌiːsədˈɪlɐ(͡c͡v) ˈa
вăхăтĕнчи	v (͡e͡n)ˌe͡ɪbɹˈiːv(͡c͡v) x (͡e͡n)ˌe͡ɪbɹˈiːv(͡c͡v) t (͡e͡n)ˌiːbɹˈiːv(͡c͡v) n t͡ʃ ˈɪ
виçи	v ˈɪ (͡e͡n)sˌiːsədˈɪlɐ(͡c͡v) ˈɪ
вырăссен	v ˈɯ r (͡e͡n)ˌe͡ɪbɹˈiːv(͡c͡v) s s jˈæ n
департаменчӗн	dˌɛpartamˈɛnt͡ʃɵn
илнӗ	ˈɪlnɵ
кăтартса	k (͡e͡n)ˌe͡ɪbɹˈiːv(͡c͡v) t ˈa r t s ˈa
каçма	k ˈa (͡e͡n)sˌiːsədˈɪlɐ(͡c͡v) m ˈa
каçнă	k ˈa (͡e͡n)sˌiːsədˈɪlɐ(͡c͡v) n (͡e͡n)ˌe͡ɪbɹˈiːv(͡c͡v)
калаçать	k ˈa l ˈa (͡e͡n)sˌiːsədˈɪlɐ(͡c͡v) ˈa t
кану	kˈanʊ
карапсем	kaɾˈapsɛm
кафедрин	kafˈɛdrɪn
килĕшнĕ	k ˈɪ l (͡e͡n)ˌiːbɹˈiːv(͡c͡v) ʃ n (͡e͡n)ˌiːbɹˈiːv(͡c͡v)
килти	kˈɪltɪ
компани	kɔmpˈanɪ
компьютер	kɔmpjˈutɛr
ларса	lˈarsa
малашне	malˈaʃnɛ
номерĕ	n ˈɔ m jˈɛ r (͡e͡n)ˌiːbɹˈiːv(͡c͡v)
округĕне	ˈɔ k r ˈʊ ɡ (͡e͡n)ˌiːbɹˈiːv(͡c͡v) n jˈɛ
пăлхава	p (͡e͡n)ˌe͡ɪbɹˈiːv(͡c͡v) l x ˈa v ˈa
пăр	p (͡e͡n)ˌe͡ɪbɹˈiːv(͡c͡v) r
пăрахса	p (͡e͡n)ˌe͡ɪbɹˈiːv(͡c͡v) r ˈa x s ˈa
пĕрлехи	p (͡e͡n)ˌiːbɹˈiːv(͡c͡v) r l jˈɛ x ˈɪ
пайĕсем	p ˈa j (͡e͡n)ˌiːbɹˈiːv(͡c͡v) s jˈæ m
палăртса	p ˈa l (͡e͡n)ˌe͡ɪbɹˈiːv(͡c͡v) r t s ˈa
пиччĕшĕ	p ˈɪ t͡ʃ t͡ʃ (͡e͡n)ˌiːbɹˈiːv(͡c͡v) ʃ (͡e͡n)ˌiːbɹˈiːv(͡c͡v)
пулăшаканĕ	p ˈʊ l (͡e͡n)ˌe͡ɪbɹˈiːv(͡c͡v) ʃ ˈa k ˈa n (͡e͡n)ˌiːbɹˈiːv(͡c͡v)
пулăшма	p ˈʊ l (͡e͡n)ˌe͡ɪbɹˈiːv(͡c͡v) ʃ m ˈa
пурри	pˈʊrrɪ
пусма	pˈʊsma
пуснă	p ˈʊ s n (͡e͡n)ˌe͡ɪbɹˈiːv(͡c͡v)
пуххи	pˈʊxxɪ
пылак	pˈɯlak
пӗри	pˈɵɾɪ
радиохастар	rˌadioxˈastar
районта	rajˈɔnta
революци	rˌɛvɔljˈut͡sɪ
сачĕ	s ˈa t͡ʃ (͡e͡n)ˌiːbɹˈiːv(͡c͡v)
сиен	sˈiɛn
станцине	stant͡sˈinɛ
тăшмана	t (͡e͡n)ˌe͡ɪbɹˈiːv(͡c͡v) ʃ m ˈa n ˈa
тĕнĕ	t (͡e͡n)ˌiːbɹˈiːv(͡c͡v) n (͡e͡n)ˌiːbɹˈiːv(͡c͡v)
тĕпчеме	t (͡e͡n)ˌiːbɹˈiːv(͡c͡v) p t͡ʃ jˈæ m jˈɛ
таврашĕнчи	t ˈa v r ˈa ʃ (͡e͡n)ˌiːbɹˈiːv(͡c͡v) n t͡ʃ ˈɪ
термин	tˈɛrmɪn
тусем	tˈusɛm
уншăн	ˈʊ n ʃ (͡e͡n)ˌe͡ɪbɹˈiːv(͡c͡v) n
усал	ˈusal
ушкăна	ˈʊ ʃ k (͡e͡n)ˌe͡ɪbɹˈiːv(͡c͡v) n ˈa
философи	fˌilosˈofɪ
хăпарать	x (͡e͡n)ˌe͡ɪbɹˈiːv(͡c͡v) p ˈa r ˈa t
халăхĕсен	x ˈa l (͡e͡n)ˌe͡ɪbɹˈiːv(͡c͡v) x (͡e͡n)ˌiːbɹˈiːv(͡c͡v) s jˈæ n
хатĕрлесе	x ˈa t (͡e͡n)ˌiːbɹˈiːv(͡c͡v) r l jˈɛ s jˈɛ
хума	xˈuma
хӳтĕлев	x ˈø t (͡e͡n)ˌiːbɹˈiːv(͡c͡v) l jˈɛ v
шупка	ʃˈʊpka
шутĕнчи	ʃ ˈʊ t (͡e͡n)ˌiːbɹˈiːv(͡c͡v) n t͡ʃ ˈɪ
ыйтать	ˈɯjtat
юппийĕсем	jˈʊ p p ˈɪ j (͡e͡n)ˌiːbɹˈiːv(͡c͡v) s jˈæ m
юрри	jˈʊrrɪ
япаласене	jˌapalasˈɛnɛ
ятлӑ	jˈatlɯ
ятсăр	jˈa t s (͡e͡n)ˌe͡ɪbɹˈiːv(͡c͡v) r
Çӳлти	(͡e͡n)sˌiːsədˈɪlɐ(͡c͡v) ˈø l t ˈɪ
çĕмĕрсе	(͡e͡n)sˌiːsədˈɪlɐ ˌiːbɹˈiːv(͡c͡v) m (͡e͡n)ˌiːbɹˈiːv(͡c͡v) r s jˈɛ
çавăрса	(͡e͡n)sˌiːsədˈɪlɐ(͡c͡v) ˈa v (͡e͡n)ˌe͡ɪbɹˈiːv(͡c͡v) r s ˈa
çинçе	(͡e͡n)sˌiːsədˈɪlɐ(͡c͡v) ˈɪ n (͡e͡n)sˌiːsədˈɪlɐ(͡c͡v) jˈɛ
çулăн	(͡e͡n)sˌiːsədˈɪlɐ(͡c͡v) ˈʊ l (͡e͡n)ˌe͡ɪbɹˈiːv(͡c͡v) n
çулла	(͡e͡n)sˌiːsədˈɪlɐ(͡c͡v) ˈʊ l l ˈa
çулсенчи	(͡e͡n)sˌiːsədˈɪlɐ(͡c͡v) ˈʊ l s jˈæ n t͡ʃ ˈɪ
çурăм	(͡e͡n)sˌiːsədˈɪlɐ(͡c͡v) ˈʊ r (͡e͡n)ˌe͡ɪbɹˈiːv(͡c͡v) m
çыннисене	(͡e͡n)sˌiːsədˈɪlɐ(͡c͡v) ˈɯ n n ˈɪ s jˈæ n jˈɛ
ăнлантарса	(͡e͡n)ˌe͡ɪbɹˈiːv(͡c͡v) n l ˈa n t ˈa r s ˈa
ĕçпе	(͡e͡n)ˌiːbɹˈiːv sˌiːsədˈɪlɐ(͡c͡v) p jˈɛ
ĕлĕк	(͡e͡n)ˌiːbɹˈiːv(͡c͡v) l (͡e͡n)ˌiːbɹˈiːv(͡c͡v) k
ĕлĕххи	(͡e͡n)ˌiːbɹˈiːv(͡c͡v) l (͡e͡n)ˌiːbɹˈiːv(͡c͡v) x x ˈɪ
Бердь	bˈɛrd
Венгри	vˈɛnɡrɪ
Википедийĕ	v ˈɪ k ˈɪ p jˈɛ d ˈɪ j (͡e͡n)ˌiːbɹˈiːv(͡c͡v)
Император	ˌɪmpɛɾˈatɔr
Исланди	ɪslˈandɪ
Калинин	kalˈinɪn
Киев	kˈiɛv
Ленинградри	lˌɛnɪnɡrˈadrɪ
Мускава	mʊskˈava
Петĕр	p jˈɛ t (͡e͡n)ˌiːbɹˈiːv(͡c͡v) r
Петров	pˈɛtrɔv
ССКП	sskp
Сергеевич	sˌɛrɡɛˈɛvɪt͡ʃ
Таяпа	tajˈapa
Тепĕртакран	t jˈɛ p (͡e͡n)ˌiːbɹˈiːv(͡c͡v) r t ˈa k r ˈa n
Ту	tˈʊ
Урăх	ˈʊ r (͡e͡n)ˌe͡ɪbɹˈiːv(͡c͡v) x
Федерацийĕн	f jˈɛ d jˈɛ r ˈa t͡s ˈɪ j (͡e͡n)ˌiːbɹˈiːv(͡c͡v) n
Хисеп	xˈisɛp
Чăвашсен	t͡ʃ (͡e͡n)ˌe͡ɪbɹˈiːv(͡c͡v) v ˈa ʃ s jˈæ n
ЧР	t͡ʃr
Эпĕ	ˈɛ p (͡e͡n)ˌiːbɹˈiːv(͡c͡v)
авиацин	ˌaviˈat͡sɪn
автоматчиксен	ˌavtomatt͡ʃˈɪksɛn
автономи	ˌavtonˈomɪ
апла	ˈapla
асăнса	ˈa s (͡e͡n)ˌe͡ɪbɹˈiːv(͡c͡v) n s ˈa
ачисем	at͡ʃˈisɛm
аялти	ajˈaltɪ
вăйне	v (͡e͡n)ˌe͡ɪbɹˈiːv(͡c͡v) j n jˈɛ
виçеллĕ	v ˈɪ (͡e͡n)sˌiːsədˈɪlɐ(͡c͡v) jˈæ l l (͡e͡n)ˌiːbɹˈiːv(͡c͡v)
вилтăпри	v ˈɪ l t (͡e͡n)ˌe͡ɪbɹˈiːv(͡c͡v) p r ˈɪ
влаç	v l ˈa (͡e͡n)sˌiːsədˈɪlɐ(͡c͡v)
вулама	vulˈama
выляма	vɯljˈama
вӗсен	vˈɵsɛn
вӗсене	vɵsˈɛnɛ
енлĕ	jˈæ n l (͡e͡n)ˌiːbɹˈiːv(͡c͡v)
иккĕшĕ	ˈɪ k k (͡e͡n)ˌiːbɹˈiːv(͡c͡v) ʃ (͡e͡n)ˌiːbɹˈiːv(͡c͡v)
институчĕнче	ˈɪ n s t ˈɪ t ˈʊ t͡ʃ (͡e͡n)ˌiːbɹˈiːv(͡c͡v) n t͡ʃ jˈɛ
кăмăллă	k (͡e͡n)ˌe͡ɪbɹˈiːv(͡c͡v) m (͡e͡n)ˌe͡ɪbɹˈiːv(͡c͡v) l l (͡e͡n)ˌe͡ɪbɹˈiːv(͡c͡v)
кăнтăрта	k (͡e͡n)ˌe͡ɪbɹˈiːv(͡c͡v) n t (͡e͡n)ˌe͡ɪbɹˈiːv(͡c͡v) r t ˈa
кĕнекине	k (͡e͡n)ˌiːbɹˈiːv(͡c͡v) n jˈɛ k ˈɪ n jˈɛ
кĕпер	k (͡e͡n)ˌiːbɹˈiːv(͡c͡v) p jˈɛ r
кĕрешнĕ	k (͡e͡n)ˌiːbɹˈiːv(͡c͡v) r jˈɛ ʃ n (͡e͡n)ˌiːbɹˈiːv(͡c͡v)
кая	kˈaja
космос	kˈɔsmɔs
куç	k ˈʊ (͡e͡n)sˌiːsədˈɪlɐ(͡c͡v)
куçарса	k ˈʊ (͡e͡n)sˌiːsədˈɪlɐ(͡c͡v) ˈa r s ˈa
лартса	lˈartsa
малта	mˈalta
меллĕ	m jˈæ l l (͡e͡n)ˌiːbɹˈiːv(͡c͡v)
никĕсĕ	n ˈɪ k (͡e͡n)ˌiːbɹˈiːv(͡c͡v) s (͡e͡n)ˌiːbɹˈiːv(͡c͡v)
никĕсленнĕ	n ˈɪ k (͡e͡n)ˌiːbɹˈiːv(͡c͡v) s l jˈæ n n (͡e͡n)ˌiːbɹˈiːv(͡c͡v)
никĕсне	n ˈɪ k (͡e͡n)ˌiːbɹˈiːv(͡c͡v) s n jˈɛ
океанăн	ˈɔ k jˈɛ ˈa n (͡e͡n)ˌe͡ɪbɹˈiːv(͡c͡v) n
пăлхарсем	p (͡e͡n)ˌe͡ɪbɹˈiːv(͡c͡v) l x ˈa r s jˈæ m
пăхмасăр	p (͡e͡n)ˌe͡ɪbɹˈiːv(͡c͡v) x m ˈa s (͡e͡n)ˌe͡ɪbɹˈiːv(͡c͡v) r
пĕçернĕ	p (͡e͡n)ˌiːbɹˈiːv sˌiːsədˈɪlɐ(͡c͡v) jˈɛ r n (͡e͡n)ˌiːbɹˈiːv(͡c͡v)
пĕрлех	p (͡e͡n)ˌiːbɹˈiːv(͡c͡v) r l jˈɛ x
пайĕн	p ˈa j (͡e͡n)ˌiːbɹˈiːv(͡c͡v) n
палăрса	p ˈa l (͡e͡n)ˌe͡ɪbɹˈiːv(͡c͡v) r s ˈa
пичет	pˈit͡ʃɛt
правительстви	prˌavitˈɛlstvɪ
пуçтарăннă	p ˈʊ (͡e͡n)sˌiːsədˈɪlɐ(͡c͡v) t ˈa r (͡e͡n)ˌe͡ɪbɹˈiːv(͡c͡v) n n (͡e͡n)ˌe͡ɪbɹˈiːv(͡c͡v)
пуçтарса	p ˈʊ (͡e͡n)sˌiːsədˈɪlɐ(͡c͡v) t ˈa r s ˈa
пултăр	p ˈʊ l t (͡e͡n)ˌe͡ɪbɹˈiːv(͡c͡v) r
пултарулăхĕ	p ˈʊ l t ˈa r ˈʊ l (͡e͡n)ˌe͡ɪbɹˈiːv(͡c͡v) x (͡e͡n)ˌiːbɹˈiːv(͡c͡v)
пырĕ	p ˈɯ r (͡e͡n)ˌiːbɹˈiːv(͡c͡v)
пӳрт	pˈørt
ротин	rˈotɪn
сăвăсем	s (͡e͡n)ˌe͡ɪbɹˈiːv(͡c͡v) v (͡e͡n)ˌe͡ɪbɹˈiːv(͡c͡v) s jˈæ m
сарăлса	s ˈa r (͡e͡n)ˌe͡ɪbɹˈiːv(͡c͡v) l s ˈa
славян	slˈavjan
суя	sˈuja
сыхласа	sɯxlˈasa
тĕллевĕ	t (͡e͡n)ˌiːbɹˈiːv(͡c͡v) l l jˈɛ v (͡e͡n)ˌiːbɹˈiːv(͡c͡v)
тĕсĕсем	t (͡e͡n)ˌiːbɹˈiːv(͡c͡v) s (͡e͡n)ˌiːbɹˈiːv(͡c͡v) s jˈæ m
тарăнăшĕ	t ˈa r (͡e͡n)ˌe͡ɪbɹˈiːv(͡c͡v) n (͡e͡n)ˌe͡ɪbɹˈiːv(͡c͡v) ʃ (͡e͡n)ˌiːbɹˈiːv(͡c͡v)
тутарла	tutˈarla
уйрăмĕн	ˈʊ j r (͡e͡n)ˌe͡ɪbɹˈiːv(͡c͡v) m (͡e͡n)ˌiːbɹˈiːv(͡c͡v) n
уйрăмне	ˈʊ j r (͡e͡n)ˌe͡ɪbɹˈiːv(͡c͡v) m n jˈɛ
улшăнса	ˈʊ l ʃ (͡e͡n)ˌe͡ɪbɹˈiːv(͡c͡v) n s ˈa
усравĕ	ˈʊ s r ˈa v (͡e͡n)ˌiːbɹˈiːv(͡c͡v)
фильмра	fˈɪlmra
хĕвеланăç	x (͡e͡n)ˌiːbɹˈiːv(͡c͡v) v jˈæ l ˈa n (͡e͡n)ˌe͡ɪbɹˈiːv sˌiːsədˈɪlɐ(͡c͡v)
хĕрача	x (͡e͡n)ˌiːbɹˈiːv(͡c͡v) r ˈa t͡ʃ ˈa
хаçачĕн	x ˈa (͡e͡n)sˌiːsədˈɪlɐ(͡c͡v) ˈa t͡ʃ (͡e͡n)ˌiːbɹˈiːv(͡c͡v) n
халăхсем	x ˈa l (͡e͡n)ˌe͡ɪbɹˈiːv(͡c͡v) x s jˈæ m
халь	xˈal
хулан	xˈulan
хулари	xulˈaɾɪ
хупă	x ˈʊ p (͡e͡n)ˌe͡ɪbɹˈiːv(͡c͡v)
хушнипе	xʊʃnˈipɛ
хыççăнхи	x ˈɯ (͡e͡n)sˌiːsədˈɪlɐ sˌiːsədˈɪlɐ ˌe͡ɪbɹˈiːv(͡c͡v) n x ˈɪ
чăннипе	t͡ʃ (͡e͡n)ˌe͡ɪbɹˈiːv(͡c͡v) n n ˈɪ p jˈɛ
чĕлхесем	t͡ʃ (͡e͡n)ˌiːbɹˈiːv(͡c͡v) l x jˈɛ s jˈæ m
чĕлхесен	t͡ʃ (͡e͡n)ˌiːbɹˈiːv(͡c͡v) l x jˈɛ s jˈæ n
чĕнсе	t͡ʃ (͡e͡n)ˌiːbɹˈiːv(͡c͡v) n s jˈɛ
чĕр	t͡ʃ (͡e͡n)ˌiːbɹˈiːv(͡c͡v) r
шкулĕн	ʃ k ˈʊ l (͡e͡n)ˌiːbɹˈiːv(͡c͡v) n
юррисене	jˌʊrrisˈɛnɛ
юханшывĕсем	jˈʊ x ˈa n ʃ ˈɯ v (͡e͡n)ˌiːbɹˈiːv(͡c͡v) s jˈæ m
çăкăр	(͡e͡n)sˌiːsədˈɪlɐ ˌe͡ɪbɹˈiːv(͡c͡v) k (͡e͡n)ˌe͡ɪbɹˈiːv(͡c͡v) r
çĕртме	(͡e͡n)sˌiːsədˈɪlɐ ˌiːbɹˈiːv(͡c͡v) r t m jˈɛ
çапăçусем	(͡e͡n)sˌiːsədˈɪlɐ(͡c͡v) ˈa p (͡e͡n)ˌe͡ɪbɹˈiːv sˌiːsədˈɪlɐ(͡c͡v) ˈʊ s jˈæ m
çарсем	(͡e͡n)sˌiːsədˈɪlɐ(͡c͡v) ˈa r s jˈæ m
çемçе	(͡e͡n)sˌiːsədˈɪlɐ(͡c͡v) jˈæ m (͡e͡n)sˌiːsədˈɪlɐ(͡c͡v) jˈɛ
çирĕплетсе	(͡e͡n)sˌiːsədˈɪlɐ(͡c͡v) ˈɪ r (͡e͡n)ˌiːbɹˈiːv(͡c͡v) p l jˈɛ t s jˈɛ
çуркунне	(͡e͡n)sˌiːsədˈɪlɐ(͡c͡v) ˈʊ r k ˈʊ n n jˈɛ
çынран	(͡e͡n)sˌiːsədˈɪlɐ(͡c͡v) ˈɯ n r ˈa n
çырнипе	(͡e͡n)sˌiːsədˈɪlɐ(͡c͡v) ˈɯ r n ˈɪ p jˈɛ
ăнăçу	(͡e͡n)ˌe͡ɪbɹˈiːv(͡c͡v) n (͡e͡n)ˌe͡ɪbɹˈiːv sˌiːsədˈɪlɐ(͡c͡v) ˈʊ
ăшĕнче	(͡e͡n)ˌe͡ɪbɹˈiːv(͡c͡v) ʃ (͡e͡n)ˌiːbɹˈiːv(͡c͡v) n t͡ʃ jˈɛ
Аякри	ajˈakrɪ
Валерий	valˈɛɾɪj
Виталий	vitˈalɪj
Грузи	ɡrˈuzɪ
Еган	jˈeɡan
Кондома	kɔndˈoma
Крым	krˈɯm
Мĕнпур	m (͡e͡n)ˌiːbɹˈiːv(͡c͡v) n p ˈʊ r
Максим	mˈaksɪm
Олимп	ˈolɪmp
Паллах	pˈallax
Петровна	pɛtrˈɔvna
Под	pˈɔd
Сĕве	s (͡e͡n)ˌiːbɹˈiːv(͡c͡v) v jˈɛ
Симĕс	s ˈɪ m (͡e͡n)ˌiːbɹˈiːv(͡c͡v) s
Степанович	stˌɛpanˈovɪt͡ʃ
Сылтăм	s ˈɯ l t (͡e͡n)ˌe͡ɪbɹˈiːv(͡c͡v) m
Уйăх	ˈʊ j (͡e͡n)ˌe͡ɪbɹˈiːv(͡c͡v) x
Уйрăмах	ˈʊ j r (͡e͡n)ˌe͡ɪbɹˈiːv(͡c͡v) m ˈa x
Унӑн	ˈunɯn
Чăннипе	t͡ʃ (͡e͡n)ˌe͡ɪbɹˈiːv(͡c͡v) n n ˈɪ p jˈɛ
Чӑваш	t͡ʃˈɯvaʃ
Шупашкарта	ʃˌupaʃkˈarta
Юрибей	juɾˈibɛj
авал	ˈaval
айлăмĕнче	ˈa j l (͡e͡n)ˌe͡ɪbɹˈiːv(͡c͡v) m (͡e͡n)ˌiːbɹˈiːv(͡c͡v) n t͡ʃ jˈɛ
актёр	ˈaktjɔr
апата	apˈata
ар	ˈar
аталану	ˌatalˈanʊ
атом	ˈatɔm
ачана	at͡ʃˈana
ашшĕпе	ˈa ʃ ʃ (͡e͡n)ˌiːbɹˈiːv(͡c͡v) p jˈɛ
библиотека	bˌɪbliotˈɛka
биологи	bˌiolˈoɡɪ
вăрманĕ	v (͡e͡n)ˌe͡ɪbɹˈiːv(͡c͡v) r m ˈa n (͡e͡n)ˌiːbɹˈiːv(͡c͡v)
вĕри	v (͡e͡n)ˌiːbɹˈiːv(͡c͡v) r ˈɪ
вĕсенче	v (͡e͡n)ˌiːbɹˈiːv(͡c͡v) s jˈæ n t͡ʃ jˈɛ
варринчи	varrˈɪnt͡ʃɪ
генерал	ɡɛnˈɛɾal
географи	ɡˌɛɔɡrˈafɪ
диалект	diˈalɛkt
кăмăлне	k (͡e͡n)ˌe͡ɪbɹˈiːv(͡c͡v) m (͡e͡n)ˌe͡ɪbɹˈiːv(͡c͡v) l n jˈɛ
кĕмĕл	k (͡e͡n)ˌiːbɹˈiːv(͡c͡v) m (͡e͡n)ˌiːbɹˈiːv(͡c͡v) l
калаçнă	k ˈa l ˈa (͡e͡n)sˌiːsədˈɪlɐ(͡c͡v) n (͡e͡n)ˌe͡ɪbɹˈiːv(͡c͡v)
капитанĕ	k ˈa p ˈɪ t ˈa n (͡e͡n)ˌiːbɹˈiːv(͡c͡v)
килекен	kilˈɛkɛn
килсен	kˈɪlsɛn
клубĕ	k l ˈʊ b (͡e͡n)ˌiːbɹˈiːv(͡c͡v)
кӗрет	kˈɵɾɛt
кӳлмек	kˈølmɛk
кӳршĕ	k ˈø r ʃ (͡e͡n)ˌiːbɹˈiːv(͡c͡v)
лартать	lˈartat
латин	lˈatɪn
мари	mˈaɾɪ
метра	mˈɛtra
монгол	mˈɔnɡɔl
нефть	nˈɛft
орденĕ	ˈɔ r d jˈæ n (͡e͡n)ˌiːbɹˈiːv(͡c͡v)
пăхăнса	p (͡e͡n)ˌe͡ɪbɹˈiːv(͡c͡v) x (͡e͡n)ˌe͡ɪbɹˈiːv(͡c͡v) n s ˈa
пĕрлĕхĕ	p (͡e͡n)ˌiːbɹˈiːv(͡c͡v) r l (͡e͡n)ˌiːbɹˈiːv(͡c͡v) x (͡e͡n)ˌiːbɹˈiːv(͡c͡v)
пĕтсе	p (͡e͡n)ˌiːbɹˈiːv(͡c͡v) t s jˈɛ
партин	pˈartɪn
питӗ	pˈitɵ
пичетленнĕ	p ˈɪ t͡ʃ jˈɛ t l jˈæ n n (͡e͡n)ˌiːbɹˈiːv(͡c͡v)
профессорĕ	p r ˈɔ f jˈɛ s s ˈɔ r (͡e͡n)ˌiːbɹˈiːv(͡c͡v)
пулнăран	p ˈʊ l n (͡e͡n)ˌe͡ɪbɹˈiːv(͡c͡v) r ˈa n
пуррипе	pʊrrˈipɛ
пылаксăр	p ˈɯ l ˈa k s (͡e͡n)ˌe͡ɪbɹˈiːv(͡c͡v) r
сăвăçи	s (͡e͡n)ˌe͡ɪbɹˈiːv(͡c͡v) v (͡e͡n)ˌe͡ɪbɹˈiːv sˌiːsədˈɪlɐ(͡c͡v) ˈɪ
сăмахсем	s (͡e͡n)ˌe͡ɪbɹˈiːv(͡c͡v) m ˈa x s jˈæ m
сарнă	s ˈa r n (͡e͡n)ˌe͡ɪbɹˈiːv(͡c͡v)
символĕ	s ˈɪ m v ˈɔ l (͡e͡n)ˌiːbɹˈiːv(͡c͡v)
системин	sɪstˈɛmɪn
старшина	starʃˈina
тăвĕсем	t (͡e͡n)ˌe͡ɪbɹˈiːv(͡c͡v) v (͡e͡n)ˌiːbɹˈiːv(͡c͡v) s jˈæ m
тăни	t (͡e͡n)ˌe͡ɪbɹˈiːv(͡c͡v) n ˈɪ
тĕлĕнче	t (͡e͡n)ˌiːbɹˈiːv(͡c͡v) l (͡e͡n)ˌiːbɹˈiːv(͡c͡v) n t͡ʃ jˈɛ
тĕлте	t (͡e͡n)ˌiːbɹˈiːv(͡c͡v) l t jˈɛ
тĕпчекен	t (͡e͡n)ˌiːbɹˈiːv(͡c͡v) p t͡ʃ jˈɛ k jˈæ n
танка	tˈanka
тапхăрĕнчи	t ˈa p x (͡e͡n)ˌe͡ɪbɹˈiːv(͡c͡v) r (͡e͡n)ˌiːbɹˈiːv(͡c͡v) n t͡ʃ ˈɪ
ташă	t ˈa ʃ (͡e͡n)ˌe͡ɪbɹˈiːv(͡c͡v)
тем	tˈɛm
туçи	t ˈʊ (͡e͡n)sˌiːsədˈɪlɐ(͡c͡v) ˈɪ
тупать	tˈupat
тухни	tˈʊxnɪ
тӗл	tˈɵl
уесĕн	ˈʊ jˈɛ s (͡e͡n)ˌiːbɹˈiːv(͡c͡v) n
уйрăмĕнче	ˈʊ j r (͡e͡n)ˌe͡ɪbɹˈiːv(͡c͡v) m (͡e͡n)ˌiːbɹˈiːv(͡c͡v) n t͡ʃ jˈɛ
уйрăмлăхĕ	ˈʊ j r (͡e͡n)ˌe͡ɪbɹˈiːv(͡c͡v) m l (͡e͡n)ˌe͡ɪbɹˈiːv(͡c͡v) x (͡e͡n)ˌiːbɹˈiːv(͡c͡v)
университечĕ	ˈʊ n ˈɪ v jˈɛ r s ˈɪ t jˈɛ t͡ʃ (͡e͡n)ˌiːbɹˈiːv(͡c͡v)
упраса	ʊprˈasa
франс	frˈans
хăçан	x (͡e͡n)ˌe͡ɪbɹˈiːv sˌiːsədˈɪlɐ(͡c͡v) ˈa n
хĕрне	x (͡e͡n)ˌiːbɹˈiːv(͡c͡v) r n jˈɛ
хатĕрлеме	x ˈa t (͡e͡n)ˌiːbɹˈiːv(͡c͡v) r l jˈæ m jˈɛ
хуçалăхĕ	x ˈʊ (͡e͡n)sˌiːsədˈɪlɐ(͡c͡v) ˈa l (͡e͡n)ˌe͡ɪbɹˈiːv(͡c͡v) x (͡e͡n)ˌiːbɹˈiːv(͡c͡v)
хуласене	xˌulasˈɛnɛ
хутлă	x ˈʊ t l (͡e͡n)ˌe͡ɪbɹˈiːv(͡c͡v)
чылаях	t͡ʃɯlˈajax
чӑваш	t͡ʃˈɯvaʃ
шăмми	ʃ (͡e͡n)ˌe͡ɪbɹˈiːv(͡c͡v) m m ˈɪ
шĕвек	ʃ (͡e͡n)ˌiːbɹˈiːv(͡c͡v) v jˈɛ k
шурлăхлă	ʃ ˈʊ r l (͡e͡n)ˌe͡ɪbɹˈiːv(͡c͡v) x l (͡e͡n)ˌe͡ɪbɹˈiːv(͡c͡v)
шухăшĕпе	ʃ ˈʊ x (͡e͡n)ˌe͡ɪbɹˈiːv(͡c͡v) ʃ (͡e͡n)ˌiːbɹˈiːv(͡c͡v) p jˈɛ
шывĕпе	ʃ ˈɯ v (͡e͡n)ˌiːbɹˈiːv(͡c͡v) p jˈɛ
энциклопедия	ˌænt͡sɪklˌopɛdˈija
юрăхлă	jˈʊ r (͡e͡n)ˌe͡ɪbɹˈiːv(͡c͡v) x l (͡e͡n)ˌe͡ɪbɹˈiːv(͡c͡v)
ютçĕр	jˈʊ t (͡e͡n)sˌiːsədˈɪlɐ ˌiːbɹˈiːv(͡c͡v) r
юханшывĕн	jˈʊ x ˈa n ʃ ˈɯ v (͡e͡n)ˌiːbɹˈiːv(͡c͡v) n
ялхуçалăх	jˈa l x ˈʊ (͡e͡n)sˌiːsədˈɪlɐ(͡c͡v) ˈa l (͡e͡n)ˌe͡ɪbɹˈiːv(͡c͡v) x
ӳкнĕ	ˈø k n (͡e͡n)ˌiːbɹˈiːv(͡c͡v)
Çырма	(͡e͡n)sˌiːsədˈɪlɐ(͡c͡v) ˈɯ r m ˈa
çĕрĕн	(͡e͡n)sˌiːsədˈɪlɐ ˌiːbɹˈiːv(͡c͡v) r (͡e͡n)ˌiːbɹˈiːv(͡c͡v) n
çирĕм	(͡e͡n)sˌiːsədˈɪlɐ(͡c͡v) ˈɪ r (͡e͡n)ˌiːbɹˈiːv(͡c͡v) m
çирĕплетме	(͡e͡n)sˌiːsədˈɪlɐ(͡c͡v) ˈɪ r (͡e͡n)ˌiːbɹˈiːv(͡c͡v) p l jˈɛ t m jˈɛ
çулĕсем	(͡e͡n)sˌiːsədˈɪlɐ(͡c͡v) ˈʊ l (͡e͡n)ˌiːbɹˈiːv(͡c͡v) s jˈæ m
çуртĕнче	(͡e͡n)sˌiːsədˈɪlɐ(͡c͡v) ˈʊ r t (͡e͡n)ˌiːbɹˈiːv(͡c͡v) n t͡ʃ jˈɛ
çути	(͡e͡n)sˌiːsədˈɪlɐ(͡c͡v) ˈʊ t ˈɪ
çынăн	(͡e͡n)sˌiːsədˈɪlɐ(͡c͡v) ˈɯ n (͡e͡n)ˌe͡ɪbɹˈiːv(͡c͡v) n
çырми	(͡e͡n)sˌiːsədˈɪlɐ(͡c͡v) ˈɯ r m ˈɪ
çырни	(͡e͡n)sˌiːsədˈɪlɐ(͡c͡v) ˈɯ r n ˈɪ
ĕмĕрсенчи	(͡e͡n)ˌiːbɹˈiːv(͡c͡v) m (͡e͡n)ˌiːbɹˈiːv(͡c͡v) r s jˈæ n t͡ʃ ˈɪ
Атăлăн	ˈa t (͡e͡n)ˌe͡ɪbɹˈiːv(͡c͡v) l (͡e͡n)ˌe͡ɪbɹˈiːv(͡c͡v) n
Висанти	visˈantɪ
Волков	vˈɔlkɔv
Германире	ɡˌɛrmanˈiɾɛ
Граждан	ɡrˈaʒdan
Греци	ɡrˈɛt͡sɪ
Дмитриевич	dmˌɪtriˈɛvɪt͡ʃ
Египет	jeɡˈipɛt
Игорь	ˈiɡɔr
Иосиф	iˈosɪf
Конда	kˈɔnda
Латви	lˈatvɪ
Надежда	nadˈɛʒda
Одесса	odˈɛssa
Роберт	rˈobɛrt
Сад	sˈad
Салым	sˈalɯm
Сталин	stˈalɪn
Тăршшĕ	t (͡e͡n)ˌe͡ɪbɹˈiːv(͡c͡v) r ʃ ʃ (͡e͡n)ˌiːbɹˈiːv(͡c͡v)
Уильям	uˈɪljam
Унтах	ˈʊntax
Чапаев	t͡ʃapˈaɛv
Япони	japˈonɪ
арăмĕпе	ˈa r (͡e͡n)ˌe͡ɪbɹˈiːv(͡c͡v) m (͡e͡n)ˌiːbɹˈiːv(͡c͡v) p jˈɛ
аресленĕ	ˈa r jˈɛ s l jˈæ n (͡e͡n)ˌiːbɹˈiːv(͡c͡v)
ашшĕн	ˈa ʃ ʃ (͡e͡n)ˌiːbɹˈiːv(͡c͡v) n
балет	bˈalɛt
вăрçин	v (͡e͡n)ˌe͡ɪbɹˈiːv(͡c͡v) r (͡e͡n)sˌiːsədˈɪlɐ(͡c͡v) ˈɪ n
вĕлерме	v (͡e͡n)ˌiːbɹˈiːv(͡c͡v) l jˈɛ r m jˈɛ
вĕрентме	v (͡e͡n)ˌiːbɹˈiːv(͡c͡v) r jˈæ n t m jˈɛ
вĕрентӳ	v (͡e͡n)ˌiːbɹˈiːv(͡c͡v) r jˈæ n t ˈø
вĕтĕ	v (͡e͡n)ˌiːbɹˈiːv(͡c͡v) t (͡e͡n)ˌiːbɹˈiːv(͡c͡v)
вулавăш	v ˈʊ l ˈa v (͡e͡n)ˌe͡ɪbɹˈiːv(͡c͡v) ʃ
вырăнĕсем	v ˈɯ r (͡e͡n)ˌe͡ɪbɹˈiːv(͡c͡v) n (͡e͡n)ˌiːbɹˈiːv(͡c͡v) s jˈæ m
грексен	ɡrˈɛksɛn
гуманитари	ɡˌumanitˈaɾɪ
департаменчӗ	dˌɛpartamˈɛnt͡ʃɵ
дивизионĕн	d ˈɪ v ˈɪ z ˈɪ ˈɔ n (͡e͡n)ˌiːbɹˈiːv(͡c͡v) n
директор	diɾˈɛktɔr
журналист	ʒʊrnˈalɪst
звено	zvˈɛnɔ
илни	ˈɪlnɪ
имĕш	ˈɪ m (͡e͡n)ˌiːbɹˈiːv(͡c͡v) ʃ
историне	ˌɪstoɾˈinɛ
историпе	ˌɪstoɾˈipɛ
йĕрке	j (͡e͡n)ˌiːbɹˈiːv(͡c͡v) r k jˈɛ
йыш	jˈɯʃ
йышĕнчи	j ˈɯ ʃ (͡e͡n)ˌiːbɹˈiːv(͡c͡v) n t͡ʃ ˈɪ
кĕл	k (͡e͡n)ˌiːbɹˈiːv(͡c͡v) l
кĕнекесем	k (͡e͡n)ˌiːbɹˈiːv(͡c͡v) n jˈɛ k jˈɛ s jˈæ m
кĕриччен	k (͡e͡n)ˌiːbɹˈiːv(͡c͡v) r ˈɪ t͡ʃ t͡ʃ jˈæ n
кĕтеслĕ	k (͡e͡n)ˌiːbɹˈiːv(͡c͡v) t jˈɛ s l (͡e͡n)ˌiːbɹˈiːv(͡c͡v)
калăпăшĕ	k ˈa l (͡e͡n)ˌe͡ɪbɹˈiːv(͡c͡v) p (͡e͡n)ˌe͡ɪbɹˈiːv(͡c͡v) ʃ (͡e͡n)ˌiːbɹˈiːv(͡c͡v)
кас	kˈas
климат	klˈimat
кнеç	k n jˈɛ (͡e͡n)sˌiːsədˈɪlɐ(͡c͡v)
композитор	kˌɔmpozˈitɔr
кунтан	kˈʊntan
курни	kˈʊrnɪ
кӳрет	kˈyɾɛt
лăпкă	l (͡e͡n)ˌe͡ɪbɹˈiːv(͡c͡v) p k (͡e͡n)ˌe͡ɪbɹˈiːv(͡c͡v)
мана	mˈana
механика	mˌɛxanˈika
орган	ˈɔrɡan
пăхăр	p (͡e͡n)ˌe͡ɪbɹˈiːv(͡c͡v) x (͡e͡n)ˌe͡ɪbɹˈiːv(͡c͡v) r
пăхнă	p (͡e͡n)ˌe͡ɪbɹˈiːv(͡c͡v) x n (͡e͡n)ˌe͡ɪbɹˈiːv(͡c͡v)
пĕрех	p (͡e͡n)ˌiːbɹˈiːv(͡c͡v) r jˈɛ x
пĕрмай	p (͡e͡n)ˌiːbɹˈiːv(͡c͡v) r m ˈa j
пĕтерме	p (͡e͡n)ˌiːbɹˈiːv(͡c͡v) t jˈɛ r m jˈɛ
пĕтерсен	p (͡e͡n)ˌiːbɹˈiːv(͡c͡v) t jˈɛ r s jˈæ n
пай	pˈaj
парнине	parnˈinɛ
партийĕ	p ˈa r t ˈɪ j (͡e͡n)ˌiːbɹˈiːv(͡c͡v)
паттăрĕ	p ˈa t t (͡e͡n)ˌe͡ɪbɹˈiːv(͡c͡v) r (͡e͡n)ˌiːbɹˈiːv(͡c͡v)
пичĕ	p ˈɪ t͡ʃ (͡e͡n)ˌiːbɹˈiːv(͡c͡v)
планета	planˈɛta
пуçĕнчен	p ˈʊ (͡e͡n)sˌiːsədˈɪlɐ ˌiːbɹˈiːv(͡c͡v) n t͡ʃ jˈæ n
пуçтарма	p ˈʊ (͡e͡n)sˌiːsədˈɪlɐ(͡c͡v) t ˈa r m ˈa
пулăмсене	p ˈʊ l (͡e͡n)ˌe͡ɪbɹˈiːv(͡c͡v) m s jˈæ n jˈɛ
пулемётчикĕ	p ˈʊ l jˈæ m jˈɔ t t͡ʃ ˈɪ k (͡e͡n)ˌiːbɹˈiːv(͡c͡v)
пултараймасть	pˌʊltaɾˈajmast
пултаракан	pˌʊltaɾˈakan
пуль	pˈʊl
пурнăçри	p ˈʊ r n (͡e͡n)ˌe͡ɪbɹˈiːv sˌiːsədˈɪlɐ(͡c͡v) r ˈɪ
пусăм	p ˈʊ s (͡e͡n)ˌe͡ɪbɹˈiːv(͡c͡v) m
пынӑ	pˈɯnɯ
республикăра	r jˈɛ s p ˈʊ b l ˈɪ k (͡e͡n)ˌe͡ɪbɹˈiːv(͡c͡v) r ˈa
республики	rˌɛspʊblˈikɪ
сăмахĕ	s (͡e͡n)ˌe͡ɪbɹˈiːv(͡c͡v) m ˈa x (͡e͡n)ˌiːbɹˈiːv(͡c͡v)
сăнарĕсене	s (͡e͡n)ˌe͡ɪbɹˈiːv(͡c͡v) n ˈa r (͡e͡n)ˌiːbɹˈiːv(͡c͡v) s jˈæ n jˈɛ
сăнарне	s (͡e͡n)ˌe͡ɪbɹˈiːv(͡c͡v) n ˈa r n jˈɛ
сăртлă	s (͡e͡n)ˌe͡ɪbɹˈiːv(͡c͡v) r t l (͡e͡n)ˌe͡ɪbɹˈiːv(͡c͡v)
сĕтел	s (͡e͡n)ˌiːbɹˈiːv(͡c͡v) t jˈæ l
сарăлать	s ˈa r (͡e͡n)ˌe͡ɪbɹˈiːv(͡c͡v) l ˈa t
суд	sˈʊd
суйлав	sˈʊjlav
сывлăх	s ˈɯ v l (͡e͡n)ˌe͡ɪbɹˈiːv(͡c͡v) x
тăсăлăвĕ	t (͡e͡n)ˌe͡ɪbɹˈiːv(͡c͡v) s (͡e͡n)ˌe͡ɪbɹˈiːv(͡c͡v) l (͡e͡n)ˌe͡ɪbɹˈiːv(͡c͡v) v (͡e͡n)ˌiːbɹˈiːv(͡c͡v)
тăсăлнă	t (͡e͡n)ˌe͡ɪbɹˈiːv(͡c͡v) s (͡e͡n)ˌe͡ɪbɹˈiːv(͡c͡v) l n (͡e͡n)ˌe͡ɪbɹˈiːv(͡c͡v)
тĕрмене	t (͡e͡n)ˌiːbɹˈiːv(͡c͡v) r m jˈæ n jˈɛ
тапăнакан	t ˈa p (͡e͡n)ˌe͡ɪbɹˈiːv(͡c͡v) n ˈa k ˈa n
тапхăрĕн	t ˈa p x (͡e͡n)ˌe͡ɪbɹˈiːv(͡c͡v) r (͡e͡n)ˌiːbɹˈiːv(͡c͡v) n
тапхăра	t ˈa p x (͡e͡n)ˌe͡ɪbɹˈiːv(͡c͡v) r ˈa
тарать	tˈaɾat
тен	tˈɛn
трактор	trˈaktɔr
тултарнă	t ˈʊ l t ˈa r n (͡e͡n)ˌe͡ɪbɹˈiːv(͡c͡v)
туптанă	t ˈʊ p t ˈa n (͡e͡n)ˌe͡ɪbɹˈiːv(͡c͡v)
туслă	t ˈʊ s l (͡e͡n)ˌe͡ɪbɹˈiːv(͡c͡v)
тухтăр	t ˈʊ x t (͡e͡n)ˌe͡ɪbɹˈiːv(͡c͡v) r
уçăлнă	ˈʊ (͡e͡n)sˌiːsədˈɪlɐ ˌe͡ɪbɹˈiːv(͡c͡v) l n (͡e͡n)ˌe͡ɪbɹˈiːv(͡c͡v)
уйăрнă	ˈʊ j (͡e͡n)ˌe͡ɪbɹˈiːv(͡c͡v) r n (͡e͡n)ˌe͡ɪbɹˈiːv(͡c͡v)
унчен	ˈʊnt͡ʃɛn
упа	ˈupa
ур	ˈʊr
ушкăнĕсем	ˈʊ ʃ k (͡e͡n)ˌe͡ɪbɹˈiːv(͡c͡v) n (͡e͡n)ˌiːbɹˈiːv(͡c͡v) s jˈæ m
факультетĕнче	f ˈa k ˈʊ l t jˈɛ t (͡e͡n)ˌiːbɹˈiːv(͡c͡v) n t͡ʃ jˈɛ
хăват	x (͡e͡n)ˌe͡ɪbɹˈiːv(͡c͡v) v ˈa t
хăна	x (͡e͡n)ˌe͡ɪbɹˈiːv(͡c͡v) n ˈa
хăтланнă	x (͡e͡n)ˌe͡ɪbɹˈiːv(͡c͡v) t l ˈa n n (͡e͡n)ˌe͡ɪbɹˈiːv(͡c͡v)
хайхи	xˈajxɪ
хисепĕ	x ˈɪ s jˈɛ p (͡e͡n)ˌiːbɹˈiːv(͡c͡v)
хитре	xˈɪtrɛ
хутшăнаççĕ	x ˈʊ t ʃ (͡e͡n)ˌe͡ɪbɹˈiːv(͡c͡v) n ˈa (͡e͡n)sˌiːsədˈɪlɐ sˌiːsədˈɪlɐ ˌiːbɹˈiːv(͡c͡v)
хыпарсем	xɯpˈarsɛm
чăвашсемпе	t͡ʃ (͡e͡n)ˌe͡ɪbɹˈiːv(͡c͡v) v ˈa ʃ s jˈæ m p jˈɛ
чĕлхиллĕ	t͡ʃ (͡e͡n)ˌiːbɹˈiːv(͡c͡v) l x ˈɪ l l (͡e͡n)ˌiːbɹˈiːv(͡c͡v)
чакнă	t͡ʃ ˈa k n (͡e͡n)ˌe͡ɪbɹˈiːv(͡c͡v)
шăллĕ	ʃ (͡e͡n)ˌe͡ɪbɹˈiːv(͡c͡v) l l (͡e͡n)ˌiːbɹˈiːv(͡c͡v)
шайра	ʃˈajra
штурманĕ	ʃ t ˈʊ r m ˈa n (͡e͡n)ˌiːbɹˈiːv(͡c͡v)
ыйту	ˈɯjtʊ
эрехĕ	ˈɛ r jˈɛ x (͡e͡n)ˌiːbɹˈiːv(͡c͡v)
эрне	ˈɛrnɛ
эстрада	ɛstrˈada
юман	jˈuman
юрăçи	jˈʊ r (͡e͡n)ˌe͡ɪbɹˈiːv sˌiːsədˈɪlɐ(͡c͡v) ˈɪ
юхăмĕ	jˈʊ x (͡e͡n)ˌe͡ɪbɹˈiːv(͡c͡v) m (͡e͡n)ˌiːbɹˈiːv(͡c͡v)
юхăмĕн	jˈʊ x (͡e͡n)ˌe͡ɪbɹˈiːv(͡c͡v) m (͡e͡n)ˌiːbɹˈiːv(͡c͡v) n
яланхилле	jˌalanxˈɪllɛ
ӳстернĕ	ˈø s t jˈɛ r n (͡e͡n)ˌiːbɹˈiːv(͡c͡v)
V	(͡e͡n)vˈiː(͡c͡v)
XIII	(͡e͡n)ˈɛks ˈa͡ɪ ˈa͡ɪ ˈa͡ɪ(͡c͡v)
de	(͡e͡n)dˈiː ˈiː(͡c͡v)
Çывăх	(͡e͡n)sˌiːsədˈɪlɐ(͡c͡v) ˈɯ v (͡e͡n)ˌe͡ɪbɹˈiːv(͡c͡v) x
çĕкленĕ	(͡e͡n)sˌiːsədˈɪlɐ ˌiːbɹˈiːv(͡c͡v) k l jˈæ n (͡e͡n)ˌiːbɹˈiːv(͡c͡v)
çĕмĕрнĕ	(͡e͡n)sˌiːsədˈɪlɐ ˌiːbɹˈiːv(͡c͡v) m (͡e͡n)ˌiːbɹˈiːv(͡c͡v) r n (͡e͡n)ˌiːbɹˈiːv(͡c͡v)
çĕршывсенче	(͡e͡n)sˌiːsədˈɪlɐ ˌiːbɹˈiːv(͡c͡v) r ʃ ˈɯ v s jˈæ n t͡ʃ jˈɛ
çапăçусенче	(͡e͡n)sˌiːsədˈɪlɐ(͡c͡v) ˈa p (͡e͡n)ˌe͡ɪbɹˈiːv sˌiːsədˈɪlɐ(͡c͡v) ˈʊ s jˈæ n t͡ʃ jˈɛ
çарĕнче	(͡e͡n)sˌiːsədˈɪlɐ(͡c͡v) ˈa r (͡e͡n)ˌiːbɹˈiːv(͡c͡v) n t͡ʃ jˈɛ
çемьере	(͡e͡n)sˌiːsədˈɪlɐ(͡c͡v) jˈæ m jˈɛ r jˈɛ
çитĕннĕ	(͡e͡n)sˌiːsədˈɪlɐ(͡c͡v) ˈɪ t (͡e͡n)ˌiːbɹˈiːv(͡c͡v) n n (͡e͡n)ˌiːbɹˈiːv(͡c͡v)
çитерет	(͡e͡n)sˌiːsədˈɪlɐ(͡c͡v) ˈɪ t jˈɛ r jˈɛ t
çукки	(͡e͡n)sˌiːsədˈɪlɐ(͡c͡v) ˈʊ k k ˈɪ
çулĕн	(͡e͡n)sˌiːsədˈɪlɐ(͡c͡v) ˈʊ l (͡e͡n)ˌiːbɹˈiːv(͡c͡v) n
çулчен	(͡e͡n)sˌiːsədˈɪlɐ(͡c͡v) ˈʊ l t͡ʃ jˈæ n
çурлан	(͡e͡n)sˌiːsədˈɪlɐ(͡c͡v) ˈʊ r l ˈa n
çыравçăсен	(͡e͡n)sˌiːsədˈɪlɐ(͡c͡v) ˈɯ r ˈa v (͡e͡n)sˌiːsədˈɪlɐ ˌe͡ɪbɹˈiːv(͡c͡v) s jˈæ n
çӳллĕш	(͡e͡n)sˌiːsədˈɪlɐ(͡c͡v) ˈø l l (͡e͡n)ˌiːbɹˈiːv(͡c͡v) ʃ
ăрачĕ	(͡e͡n)ˌe͡ɪbɹˈiːv(͡c͡v) r ˈa t͡ʃ (͡e͡n)ˌiːbɹˈiːv(͡c͡v)
ăс	(͡e͡n)ˌe͡ɪbɹˈiːv(͡c͡v) s
ăстисем	(͡e͡n)ˌe͡ɪbɹˈiːv(͡c͡v) s t ˈɪ s jˈæ m
ĕçлев	(͡e͡n)ˌiːbɹˈiːv sˌiːsədˈɪlɐ(͡c͡v) l jˈɛ v
Александров	ˌalɛksˈandrɔv
Амур	ˈamʊr
Африка	afrˈika
Барда	bˈarda
Бах	bˈax
Вăхăт	v (͡e͡n)ˌe͡ɪbɹˈiːv(͡c͡v) x (͡e͡n)ˌe͡ɪbɹˈiːv(͡c͡v) t
Валентина	vˌalɛntˈina
Вырăсла	v ˈɯ r (͡e͡n)ˌe͡ɪbɹˈiːv(͡c͡v) s l ˈa
Гай	ɡˈaj
Григорьев	ɡriɡˈɔrʲɛv
Джордж	dʒˈɔrdʒ
Егоров	jeɡˈoɾɔv
Елизавета	jˌelizavˈɛta
Елчĕк	jˈæ l t͡ʃ (͡e͡n)ˌiːbɹˈiːv(͡c͡v) k
Енре	jˈænrɛ
Зеланди	zɛlˈandɪ
Илья	ˈɪlja
Италире	ˌitalˈiɾɛ
Кавказ	kˈavkaz
Курск	kˈʊrsk
Леонид	lɛˈonɪd
Луций	lˈut͡sɪj
Людмила	ljʊdmˈila
Мăкшă	m (͡e͡n)ˌe͡ɪbɹˈiːv(͡c͡v) k ʃ (͡e͡n)ˌe͡ɪbɹˈiːv(͡c͡v)
Мисима	misˈima
Михайлов	mixˈajlɔv
Мишши	mˈɪʃʃɪ
Наталья	natˈalja
Нидерландсем	nˌidɛrlˈandsɛm
Пĕррехинче	p (͡e͡n)ˌiːbɹˈiːv(͡c͡v) r r jˈɛ x ˈɪ n t͡ʃ jˈɛ
Пенза	pˈɛnza
Перу	pˈɛɾʊ
Президенчĕн	p r jˈɛ z ˈɪ d jˈæ n t͡ʃ (͡e͡n)ˌiːbɹˈiːv(͡c͡v) n
Пёза	pjˈoza
Районти	rajˈɔntɪ
Роговая	rˌoɡovˈaja
Сăмах	s (͡e͡n)ˌe͡ɪbɹˈiːv(͡c͡v) m ˈa x
ССР	ssr
Сарăту	s ˈa r (͡e͡n)ˌe͡ɪbɹˈiːv(͡c͡v) t ˈʊ
Тĕрĕк	t (͡e͡n)ˌiːbɹˈiːv(͡c͡v) r (͡e͡n)ˌiːbɹˈiːv(͡c͡v) k
Улатимĕр	ˈʊ l ˈa t ˈɪ m (͡e͡n)ˌiːbɹˈiːv(͡c͡v) r
Ульянов	ʊljˈanɔv
Хусана	xusˈana
Часах	t͡ʃˈasax
Чукун	t͡ʃˈukʊn
Чулман	t͡ʃˈʊlman
Юлий	jˈulɪj
акăлчанла	ˈa k (͡e͡n)ˌe͡ɪbɹˈiːv(͡c͡v) l t͡ʃ ˈa n l ˈa
академи	ˌakadˈɛmɪ
америка	ˌamɛɾˈika
ами	ˈamɪ
анса	ˈansa
арканнă	ˈa r k ˈa n n (͡e͡n)ˌe͡ɪbɹˈiːv(͡c͡v)
архитектор	ˌarxitˈɛktɔr
астула	astˈula
аффикс	ˈaffɪks
большевиксен	bˌɔlʃɛvˈɪksɛn
большевиксене	bˌɔlʃɛvɪksˈɛnɛ
вăрçăна	v (͡e͡n)ˌe͡ɪbɹˈiːv(͡c͡v) r (͡e͡n)sˌiːsədˈɪlɐ ˌe͡ɪbɹˈiːv(͡c͡v) n ˈa
вăрçинче	v (͡e͡n)ˌe͡ɪbɹˈiːv(͡c͡v) r (͡e͡n)sˌiːsədˈɪlɐ(͡c͡v) ˈɪ n t͡ʃ jˈɛ
вăхăчĕ	v (͡e͡n)ˌe͡ɪbɹˈiːv(͡c͡v) x (͡e͡n)ˌe͡ɪbɹˈiːv(͡c͡v) t͡ʃ (͡e͡n)ˌiːbɹˈiːv(͡c͡v)
вĕçĕ	v (͡e͡n)ˌiːbɹˈiːv sˌiːsədˈɪlɐ ˌiːbɹˈiːv(͡c͡v)
вĕçленсен	v (͡e͡n)ˌiːbɹˈiːv sˌiːsədˈɪlɐ(͡c͡v) l jˈæ n s jˈæ n
вĕрентекенĕ	v (͡e͡n)ˌiːbɹˈiːv(͡c͡v) r jˈæ n t jˈɛ k jˈæ n (͡e͡n)ˌiːbɹˈiːv(͡c͡v)
вĕрентет	v (͡e͡n)ˌiːbɹˈiːv(͡c͡v) r jˈæ n t jˈɛ t
вĕрентсе	v (͡e͡n)ˌiːbɹˈiːv(͡c͡v) r jˈæ n t s jˈɛ
вĕрентӳçĕ	v (͡e͡n)ˌiːbɹˈiːv(͡c͡v) r jˈæ n t ˈø (͡e͡n)sˌiːsədˈɪlɐ ˌiːbɹˈiːv(͡c͡v)
варринчен	varrˈɪnt͡ʃɛn
виҫӗ	vˈiçɵ
вырăнĕсене	v ˈɯ r (͡e͡n)ˌe͡ɪbɹˈiːv(͡c͡v) n (͡e͡n)ˌiːbɹˈiːv(͡c͡v) s jˈæ n jˈɛ
выртнă	v ˈɯ r t n (͡e͡n)ˌe͡ɪbɹˈiːv(͡c͡v)
вӗсем	vˈɵsɛm
гербĕ	ɡ jˈɛ r b (͡e͡n)ˌiːbɹˈiːv(͡c͡v)
депутачĕ	d jˈɛ p ˈʊ t ˈa t͡ʃ (͡e͡n)ˌiːbɹˈiːv(͡c͡v)
диалекчĕ	d ˈɪ ˈa l jˈɛ k t͡ʃ (͡e͡n)ˌiːbɹˈiːv(͡c͡v)
енре	jˈænrɛ
иккен	ˈɪkkɛn
илмелле	ɪlmˈɛllɛ
иртереççĕ	ˈɪ r t jˈɛ r jˈɛ (͡e͡n)sˌiːsədˈɪlɐ sˌiːsədˈɪlɐ ˌiːbɹˈiːv(͡c͡v)
ирттерет	ɪrttˈɛɾɛt
испан	ˈɪspan
йăхĕ	j (͡e͡n)ˌe͡ɪbɹˈiːv(͡c͡v) x (͡e͡n)ˌiːbɹˈiːv(͡c͡v)
йĕрĕ	j (͡e͡n)ˌiːbɹˈiːv(͡c͡v) r (͡e͡n)ˌiːbɹˈiːv(͡c͡v)
йĕркелеççĕ	j (͡e͡n)ˌiːbɹˈiːv(͡c͡v) r k jˈæ l jˈɛ (͡e͡n)sˌiːsədˈɪlɐ sˌiːsədˈɪlɐ ˌiːbɹˈiːv(͡c͡v)
йывăçран	j ˈɯ v (͡e͡n)ˌe͡ɪbɹˈiːv sˌiːsədˈɪlɐ(͡c͡v) r ˈa n
кăларас	k (͡e͡n)ˌe͡ɪbɹˈiːv(͡c͡v) l ˈa r ˈa s
кĕркунне	k (͡e͡n)ˌiːbɹˈiːv(͡c͡v) r k ˈʊ n n jˈɛ
калаçу	k ˈa l ˈa (͡e͡n)sˌiːsədˈɪlɐ(͡c͡v) ˈʊ
каналĕ	k ˈa n ˈa l (͡e͡n)ˌiːbɹˈiːv(͡c͡v)
канашĕ	k ˈa n ˈa ʃ (͡e͡n)ˌiːbɹˈiːv(͡c͡v)
картти	kˈarttɪ
кашнин	kˈaʃnɪn
килĕнче	k ˈɪ l (͡e͡n)ˌiːbɹˈiːv(͡c͡v) n t͡ʃ jˈɛ
корпусĕ	k ˈɔ r p ˈʊ s (͡e͡n)ˌiːbɹˈiːv(͡c͡v)
культурине	kˌʊltuɾˈinɛ
кураҫҫӗ	kuɾˈaççɵ
лăпкăлăх	l (͡e͡n)ˌe͡ɪbɹˈiːv(͡c͡v) p k (͡e͡n)ˌe͡ɪbɹˈiːv(͡c͡v) l (͡e͡n)ˌe͡ɪbɹˈiːv(͡c͡v) x
лартнӑ	lˈartnɯ
литературин	lˌitɛɾatˈuɾɪn
миллиона	mˌɪlliˈona
нихăçан	n ˈɪ x (͡e͡n)ˌe͡ɪbɹˈiːv sˌiːsədˈɪlɐ(͡c͡v) ˈa n
пăлхарсен	p (͡e͡n)ˌe͡ɪbɹˈiːv(͡c͡v) l x ˈa r s jˈæ n
пăрăнать	p (͡e͡n)ˌe͡ɪbɹˈiːv(͡c͡v) r (͡e͡n)ˌe͡ɪbɹˈiːv(͡c͡v) n ˈa t
пăхăнтарнă	p (͡e͡n)ˌe͡ɪbɹˈiːv(͡c͡v) x (͡e͡n)ˌe͡ɪbɹˈiːv(͡c͡v) n t ˈa r n (͡e͡n)ˌe͡ɪbɹˈiːv(͡c͡v)
пĕлĕвне	p (͡e͡n)ˌiːbɹˈiːv(͡c͡v) l (͡e͡n)ˌiːbɹˈiːv(͡c͡v) v n jˈɛ
пĕрин	p (͡e͡n)ˌiːbɹˈiːv(͡c͡v) r ˈɪ n
пĕччен	p (͡e͡n)ˌiːbɹˈiːv(͡c͡v) t͡ʃ t͡ʃ jˈæ n
пайланнă	p ˈa j l ˈa n n (͡e͡n)ˌe͡ɪbɹˈiːv(͡c͡v)
панипе	panˈipɛ
президент	prɛzˈidɛnt
пулăшаççĕ	p ˈʊ l (͡e͡n)ˌe͡ɪbɹˈiːv(͡c͡v) ʃ ˈa (͡e͡n)sˌiːsədˈɪlɐ sˌiːsədˈɪlɐ ˌiːbɹˈiːv(͡c͡v)
пултарайман	pˌʊltaɾˈajman
раштав	rˈaʃtav
регионӗн	rˌɛɡiˈonɵn
сăввисем	s (͡e͡n)ˌe͡ɪbɹˈiːv(͡c͡v) v v ˈɪ s jˈæ m
сăмахĕсем	s (͡e͡n)ˌe͡ɪbɹˈiːv(͡c͡v) m ˈa x (͡e͡n)ˌiːbɹˈiːv(͡c͡v) s jˈæ m
салинче	salˈɪnt͡ʃɛ
сарăмсăр	s ˈa r (͡e͡n)ˌe͡ɪbɹˈiːv(͡c͡v) m s (͡e͡n)ˌe͡ɪbɹˈiːv(͡c͡v) r
сортран	sˈɔrtran
сутнă	s ˈʊ t n (͡e͡n)ˌe͡ɪbɹˈiːv(͡c͡v)
тăршшĕпе	t (͡e͡n)ˌe͡ɪbɹˈiːv(͡c͡v) r ʃ ʃ (͡e͡n)ˌiːbɹˈiːv(͡c͡v) p jˈɛ
тепри	tˈɛprɪ
тинĕсе	t ˈɪ n (͡e͡n)ˌiːbɹˈiːv(͡c͡v) s jˈɛ
тишкерсе	tɪʃkˈɛrsɛ
тулă	t ˈʊ l (͡e͡n)ˌe͡ɪbɹˈiːv(͡c͡v)
тунине	tunˈinɛ
тупаççĕ	t ˈʊ p ˈa (͡e͡n)sˌiːsədˈɪlɐ sˌiːsədˈɪlɐ ˌiːbɹˈiːv(͡c͡v)
тури	tˈuɾɪ
тухăçалла	t ˈʊ x (͡e͡n)ˌe͡ɪbɹˈiːv sˌiːsədˈɪlɐ(͡c͡v) ˈa l l ˈa
туяннă	t ˈʊ jˈa n n (͡e͡n)ˌe͡ɪbɹˈiːv(͡c͡v)
тӳпе	tˈypɛ
тӳрĕ	t ˈø r (͡e͡n)ˌiːbɹˈiːv(͡c͡v)
тӳррĕн	t ˈø r r (͡e͡n)ˌiːbɹˈiːv(͡c͡v) n
уйрăммăн	ˈʊ j r (͡e͡n)ˌe͡ɪbɹˈiːv(͡c͡v) m m (͡e͡n)ˌe͡ɪbɹˈiːv(͡c͡v) n
унсăр	ˈʊ n s (͡e͡n)ˌe͡ɪbɹˈiːv(͡c͡v) r
урăхларах	ˈʊ r (͡e͡n)ˌe͡ɪbɹˈiːv(͡c͡v) x l ˈa r ˈa x
урамĕнче	ˈʊ r ˈa m (͡e͡n)ˌiːbɹˈiːv(͡c͡v) n t͡ʃ jˈɛ
урама	uɾˈama
фильма	fˈɪlma
фон	fˈɔn
хĕçпăшал	x (͡e͡n)ˌiːbɹˈiːv sˌiːsədˈɪlɐ(͡c͡v) p (͡e͡n)ˌe͡ɪbɹˈiːv(͡c͡v) ʃ ˈa l
хатĕрĕ	x ˈa t (͡e͡n)ˌiːbɹˈiːv(͡c͡v) r (͡e͡n)ˌiːbɹˈiːv(͡c͡v)
хулисенче	xˌulisˈɛnt͡ʃɛ
хутшăнса	x ˈʊ t ʃ (͡e͡n)ˌe͡ɪbɹˈiːv(͡c͡v) n s ˈa
хушаççĕ	x ˈʊ ʃ ˈa (͡e͡n)sˌiːsədˈɪlɐ sˌiːsədˈɪlɐ ˌiːbɹˈiːv(͡c͡v)
центрĕн	t͡s jˈæ n t r (͡e͡n)ˌiːbɹˈiːv(͡c͡v) n
чĕлхеллĕ	t͡ʃ (͡e͡n)ˌiːbɹˈiːv(͡c͡v) l x jˈæ l l (͡e͡n)ˌiːbɹˈiːv(͡c͡v)
чĕлхинчи	t͡ʃ (͡e͡n)ˌiːbɹˈiːv(͡c͡v) l x ˈɪ n t͡ʃ ˈɪ
чĕрчунсен	t͡ʃ (͡e͡n)ˌiːbɹˈiːv(͡c͡v) r t͡ʃ ˈʊ n s jˈæ n
чечек	t͡ʃˈɛt͡ʃɛk
шая	ʃˈaja
шутлать	ʃˈʊtlat
шывĕсем	ʃ ˈɯ v (͡e͡n)ˌiːbɹˈiːv(͡c͡v) s jˈæ m
элеменчĕ	ˈæ l jˈæ m jˈæ n t͡ʃ (͡e͡n)ˌiːbɹˈiːv(͡c͡v)
юратакан	jˌuɾatˈakan
юхан	jˈuxan
ячӗ	jˈat͡ʃɵ
ҫинчен	çˈɪnt͡ʃɛn
ҫук	çˈʊk
ҫӗнӗ	çˈɵnɵ
ӗҫ	ˈɵç
ӳсекен	ysˈɛkɛn
IV	(͡e͡n)ˈa͡ɪ vˈiː(͡c͡v)
XIV	(͡e͡n)ˈɛks ˈa͡ɪ vˈiː(͡c͡v)
Çăлтăр	(͡e͡n)sˌiːsədˈɪlɐ ˌe͡ɪbɹˈiːv(͡c͡v) l t (͡e͡n)ˌe͡ɪbɹˈiːv(͡c͡v) r
Çĕн	(͡e͡n)sˌiːsədˈɪlɐ ˌiːbɹˈiːv(͡c͡v) n
Çĕрпӳ	(͡e͡n)sˌiːsədˈɪlɐ ˌiːbɹˈiːv(͡c͡v) r p ˈø
Çара	(͡e͡n)sˌiːsədˈɪlɐ(͡c͡v) ˈa r ˈa
Çулталăк	(͡e͡n)sˌiːsədˈɪlɐ(͡c͡v) ˈʊ l t ˈa l (͡e͡n)ˌe͡ɪbɹˈiːv(͡c͡v) k
Çын	(͡e͡n)sˌiːsədˈɪlɐ(͡c͡v) ˈɯ n
Çынсем	(͡e͡n)sˌiːsədˈɪlɐ(͡c͡v) ˈɯ n s jˈæ m
çÿллĕ	(͡e͡n)sˌiːsədˈɪlɐ wˌa͡ɪˈʊmla͡ʊt(͡c͡v) l l (͡e͡n)ˌiːbɹˈiːv(͡c͡v)
çакăнпа	(͡e͡n)sˌiːsədˈɪlɐ(͡c͡v) ˈa k (͡e͡n)ˌe͡ɪbɹˈiːv(͡c͡v) n p ˈa
çарăн	(͡e͡n)sˌiːsədˈɪlɐ(͡c͡v) ˈa r (͡e͡n)ˌe͡ɪbɹˈiːv(͡c͡v) n
çулпа	(͡e͡n)sˌiːsədˈɪlɐ(͡c͡v) ˈʊ l p ˈa
çулти	(͡e͡n)sˌiːsədˈɪlɐ(͡c͡v) ˈʊ l t ˈɪ
çына	(͡e͡n)sˌiːsədˈɪlɐ(͡c͡v) ˈɯ n ˈa
çыннăн	(͡e͡n)sˌiːsədˈɪlɐ(͡c͡v) ˈɯ n n (͡e͡n)ˌe͡ɪbɹˈiːv(͡c͡v) n
çыхăнтараççĕ	(͡e͡n)sˌiːsədˈɪlɐ(͡c͡v) ˈɯ x (͡e͡n)ˌe͡ɪbɹˈiːv(͡c͡v) n t ˈa r ˈa (͡e͡n)sˌiːsədˈɪlɐ sˌiːsədˈɪlɐ ˌiːbɹˈiːv(͡c͡v)
ÿкернĕ	(͡e͡n)wˌa͡ɪˈʊmla͡ʊt(͡c͡v) k jˈɛ r n (͡e͡n)ˌiːbɹˈiːv(͡c͡v)
ĕмĕртен	(͡e͡n)ˌiːbɹˈiːv(͡c͡v) m (͡e͡n)ˌiːbɹˈiːv(͡c͡v) r t jˈæ n
Ази	ˈazɪ
Альфред	ˈalfrɛd
Анатри	anˈatrɪ
Антон	ˈantɔn
Бразили	brazˈilɪ
ГЭСĕ	ɡ ˈɛ s (͡e͡n)ˌiːbɹˈiːv(͡c͡v)
Икса	ˈɪksa
Ирланди	ɪrlˈandɪ
Истори	ɪstˈoɾɪ
Кисан	kˈisan
Китайра	kitˈajra
Константинович	kˌɔnstantinˈovɪt͡ʃ
Культура	kʊltˈuɾa
Македони	mˌakɛdˈonɪ
Малашне	malˈaʃnɛ
Музей	mˈuzɛj
Надым	nˈadɯm
Павăл	p ˈa v (͡e͡n)ˌe͡ɪbɹˈiːv(͡c͡v) l
Паз	pˈaz
Португали	pˌɔrtuɡˈalɪ
Птолемей	ptolˈɛmɛj
Пушкăрт	p ˈʊ ʃ k (͡e͡n)ˌe͡ɪbɹˈiːv(͡c͡v) r t
Республикинче	rˌɛspʊblikˈɪnt͡ʃɛ
Сарă	s ˈa r (͡e͡n)ˌe͡ɪbɹˈiːv(͡c͡v)
Туçа	t ˈʊ (͡e͡n)sˌiːsədˈɪlɐ(͡c͡v) ˈa
Хĕçпăшаллă	x (͡e͡n)ˌiːbɹˈiːv sˌiːsədˈɪlɐ(͡c͡v) p (͡e͡n)ˌe͡ɪbɹˈiːv(͡c͡v) ʃ ˈa l l (͡e͡n)ˌe͡ɪbɹˈiːv(͡c͡v)
Хĕлле	x (͡e͡n)ˌiːbɹˈiːv(͡c͡v) l l jˈɛ
Хыпар	xˈɯpar
Чĕрĕ	t͡ʃ (͡e͡n)ˌiːbɹˈiːv(͡c͡v) r (͡e͡n)ˌiːbɹˈiːv(͡c͡v)
Чарыш	t͡ʃˈaɾɯʃ
Чиркӳ	t͡ʃˈɪrkø
Швейцари	ʃvɛjt͡sˈaɾɪ
Яковлевич	jˌakɔvlˈɛvɪt͡ʃ
аçи	ˈa (͡e͡n)sˌiːsədˈɪlɐ(͡c͡v) ˈɪ
ак	ˈak
акан	ˈakan
алфавичĕн	ˈa l f ˈa v ˈɪ t͡ʃ (͡e͡n)ˌiːbɹˈiːv(͡c͡v) n
анлăрах	ˈa n l (͡e͡n)ˌe͡ɪbɹˈiːv(͡c͡v) r ˈa x
аркану	arkˈanʊ
аркатса	arkˈatsa
аэропорт	ˌaeɾˈopɔrt
б	b
вăйĕ	v (͡e͡n)ˌe͡ɪbɹˈiːv(͡c͡v) j (͡e͡n)ˌiːbɹˈiːv(͡c͡v)
вăйĕсене	v (͡e͡n)ˌe͡ɪbɹˈiːv(͡c͡v) j (͡e͡n)ˌiːbɹˈiːv(͡c͡v) s jˈæ n jˈɛ
вăрăммăшĕ	v (͡e͡n)ˌe͡ɪbɹˈiːv(͡c͡v) r (͡e͡n)ˌe͡ɪbɹˈiːv(͡c͡v) m m (͡e͡n)ˌe͡ɪbɹˈiːv(͡c͡v) ʃ (͡e͡n)ˌiːbɹˈiːv(͡c͡v)
вали	vˈalɪ
вилнӗ	vˈɪlnɵ
вӑтам	vˈɯtam
илем	ˈilɛm
инженер	ɪnʒˈɛnɛr
ирĕклĕх	ˈɪ r (͡e͡n)ˌiːbɹˈiːv(͡c͡v) k l (͡e͡n)ˌiːbɹˈiːv(͡c͡v) x
ирттереççĕ	ˈɪ r t t jˈɛ r jˈɛ (͡e͡n)sˌiːsədˈɪlɐ sˌiːsədˈɪlɐ ˌiːbɹˈiːv(͡c͡v)
йăва	j (͡e͡n)ˌe͡ɪbɹˈiːv(͡c͡v) v ˈa
йăлипе	j (͡e͡n)ˌe͡ɪbɹˈiːv(͡c͡v) l ˈɪ p jˈɛ
йăхĕсен	j (͡e͡n)ˌe͡ɪbɹˈiːv(͡c͡v) x (͡e͡n)ˌiːbɹˈiːv(͡c͡v) s jˈæ n
йĕркене	j (͡e͡n)ˌiːbɹˈiːv(͡c͡v) r k jˈæ n jˈɛ
йĕрне	j (͡e͡n)ˌiːbɹˈiːv(͡c͡v) r n jˈɛ
кĕнекене	k (͡e͡n)ˌiːbɹˈiːv(͡c͡v) n jˈɛ k jˈæ n jˈɛ
кайăксен	k ˈa j (͡e͡n)ˌe͡ɪbɹˈiːv(͡c͡v) k s jˈæ n
кайнӑ	kˈajnɯ
калаçаççĕ	k ˈa l ˈa (͡e͡n)sˌiːsədˈɪlɐ(͡c͡v) ˈa (͡e͡n)sˌiːsədˈɪlɐ sˌiːsədˈɪlɐ ˌiːbɹˈiːv(͡c͡v)
калаçакан	k ˈa l ˈa (͡e͡n)sˌiːsədˈɪlɐ(͡c͡v) ˈa k ˈa n
калаçма	k ˈa l ˈa (͡e͡n)sˌiːsədˈɪlɐ(͡c͡v) m ˈa
калать	kˈalat
кам	kˈam
канашне	kanˈaʃnɛ
канма	kˈanma
каччă	k ˈa t͡ʃ t͡ʃ (͡e͡n)ˌe͡ɪbɹˈiːv(͡c͡v)
каякан	kajˈakan
классика	klassˈika
климачĕ	k l ˈɪ m ˈa t͡ʃ (͡e͡n)ˌiːbɹˈiːv(͡c͡v)
красноармеецĕ	k r ˈa s n ˈɔ ˈa r m jˈɛ jˈɛ t͡s (͡e͡n)ˌiːbɹˈiːv(͡c͡v)
куçарма	k ˈʊ (͡e͡n)sˌiːsədˈɪlɐ(͡c͡v) ˈa r m ˈa
куçарсан	k ˈʊ (͡e͡n)sˌiːsədˈɪlɐ(͡c͡v) ˈa r s ˈa n
лавкка	lˈavkka
лараççĕ	l ˈa r ˈa (͡e͡n)sˌiːsədˈɪlɐ sˌiːsədˈɪlɐ ˌiːbɹˈiːv(͡c͡v)
меслет	mˈɛslɛt
металл	mˈɛtall
минут	mˈinʊt
мӗнле	mˈɵnlɛ
нарăс	n ˈa r (͡e͡n)ˌe͡ɪbɹˈiːv(͡c͡v) s
никама	nikˈama
нимĕн	n ˈɪ m (͡e͡n)ˌiːbɹˈiːv(͡c͡v) n
нумаях	numˈajax
объект	ˈɔbʔɛkt
органĕ	ˈɔ r ɡ ˈa n (͡e͡n)ˌiːbɹˈiːv(͡c͡v)
пĕлÿ	p (͡e͡n)ˌiːbɹˈiːv(͡c͡v) l (͡e͡n)wˌa͡ɪˈʊmla͡ʊt(͡c͡v)
пĕлĕвĕн	p (͡e͡n)ˌiːbɹˈiːv(͡c͡v) l (͡e͡n)ˌiːbɹˈiːv(͡c͡v) v (͡e͡n)ˌiːbɹˈiːv(͡c͡v) n
пĕлтерĕшне	p (͡e͡n)ˌiːbɹˈiːv(͡c͡v) l t jˈɛ r (͡e͡n)ˌiːbɹˈiːv(͡c͡v) ʃ n jˈɛ
пĕлтереççĕ	p (͡e͡n)ˌiːbɹˈiːv(͡c͡v) l t jˈɛ r jˈɛ (͡e͡n)sˌiːsədˈɪlɐ sˌiːsədˈɪlɐ ˌiːbɹˈiːv(͡c͡v)
пĕрлĕхлĕ	p (͡e͡n)ˌiːbɹˈiːv(͡c͡v) r l (͡e͡n)ˌiːbɹˈiːv(͡c͡v) x l (͡e͡n)ˌiːbɹˈiːv(͡c͡v)
пайран	pˈajran
пайӗ	pˈajɵ
палăрать	p ˈa l (͡e͡n)ˌe͡ɪbɹˈiːv(͡c͡v) r ˈa t
паллашма	pallˈaʃma
паллине	pallˈinɛ
паллисемпе	pˌallisˈɛmpɛ
пинçуллăхра	p ˈɪ n (͡e͡n)sˌiːsədˈɪlɐ(͡c͡v) ˈʊ l l (͡e͡n)ˌe͡ɪbɹˈiːv(͡c͡v) x r ˈa
пирӗн	pˈiɾɵn
подполковник	pˌɔdpɔlkˈɔvnɪk
политикине	pˌolitikˈinɛ
полици	polˈit͡sɪ
полковник	pɔlkˈɔvnɪk
почта	pˈɔt͡ʃta
пуçтараççĕ	p ˈʊ (͡e͡n)sˌiːsədˈɪlɐ(͡c͡v) t ˈa r ˈa (͡e͡n)sˌiːsədˈɪlɐ sˌiːsədˈɪlɐ ˌiːbɹˈiːv(͡c͡v)
пулăшнипе	p ˈʊ l (͡e͡n)ˌe͡ɪbɹˈiːv(͡c͡v) ʃ n ˈɪ p jˈɛ
пурăнакансем	p ˈʊ r (͡e͡n)ˌe͡ɪbɹˈiːv(͡c͡v) n ˈa k ˈa n s jˈæ m
пурăнмасть	p ˈʊ r (͡e͡n)ˌe͡ɪbɹˈiːv(͡c͡v) n m ˈa s t
пухма	pˈʊxma
пуххине	pʊxxˈinɛ
пуҫне	pˈʊçnɛ
пыл	pˈɯl
пыни	pˈɯnɪ
режиссёрĕ	r jˈɛ ʒ ˈɪ s s jˈɔ r (͡e͡n)ˌiːbɹˈiːv(͡c͡v)
республикăн	r jˈɛ s p ˈʊ b l ˈɪ k (͡e͡n)ˌe͡ɪbɹˈiːv(͡c͡v) n
республикăри	r jˈɛ s p ˈʊ b l ˈɪ k (͡e͡n)ˌe͡ɪbɹˈiːv(͡c͡v) r ˈɪ
роле	rˈolɛ
степеньлĕ	s t jˈɛ p jˈæ n l (͡e͡n)ˌiːbɹˈiːv(͡c͡v)
сывлăшра	s ˈɯ v l (͡e͡n)ˌe͡ɪbɹˈiːv(͡c͡v) ʃ r ˈa
сӳтсе	sˈøtsɛ
тĕнчен	t (͡e͡n)ˌiːbɹˈiːv(͡c͡v) n t͡ʃ jˈæ n
тĕнчипе	t (͡e͡n)ˌiːbɹˈiːv(͡c͡v) n t͡ʃ ˈɪ p jˈɛ
тĕпне	t (͡e͡n)ˌiːbɹˈiːv(͡c͡v) p n jˈɛ
тĕпчевçи	t (͡e͡n)ˌiːbɹˈiːv(͡c͡v) p t͡ʃ jˈɛ v (͡e͡n)sˌiːsədˈɪlɐ(͡c͡v) ˈɪ
тĕсне	t (͡e͡n)ˌiːbɹˈiːv(͡c͡v) s n jˈɛ
тапăну	t ˈa p (͡e͡n)ˌe͡ɪbɹˈiːv(͡c͡v) n ˈʊ
темиҫе	tɛmˈiçɛ
температури	tˌɛmpɛɾatˈuɾɪ
теори	tɛˈoɾɪ
тепре	tˈɛprɛ
технологи	tˌɛxnolˈoɡɪ
тивĕçет	t ˈɪ v (͡e͡n)ˌiːbɹˈiːv sˌiːsədˈɪlɐ(͡c͡v) jˈɛ t
тир	tˈɪr
туй	tˈʊj
тулашĕнче	t ˈʊ l ˈa ʃ (͡e͡n)ˌiːbɹˈiːv(͡c͡v) n t͡ʃ jˈɛ
турккă	t ˈʊ r k k (͡e͡n)ˌe͡ɪbɹˈiːv(͡c͡v)
тутлă	t ˈʊ t l (͡e͡n)ˌe͡ɪbɹˈiːv(͡c͡v)
тухăçлă	t ˈʊ x (͡e͡n)ˌe͡ɪbɹˈiːv sˌiːsədˈɪlɐ(͡c͡v) l (͡e͡n)ˌe͡ɪbɹˈiːv(͡c͡v)
тытăмне	t ˈɯ t (͡e͡n)ˌe͡ɪbɹˈiːv(͡c͡v) m n jˈɛ
уесĕнчи	ˈʊ jˈɛ s (͡e͡n)ˌiːbɹˈiːv(͡c͡v) n t͡ʃ ˈɪ
уйрăлнă	ˈʊ j r (͡e͡n)ˌe͡ɪbɹˈiːv(͡c͡v) l n (͡e͡n)ˌe͡ɪbɹˈiːv(͡c͡v)
уйрăмлăхĕсем	ˈʊ j r (͡e͡n)ˌe͡ɪbɹˈiːv(͡c͡v) m l (͡e͡n)ˌe͡ɪbɹˈiːv(͡c͡v) x (͡e͡n)ˌiːbɹˈiːv(͡c͡v) s jˈæ m
укçана	ˈʊ k (͡e͡n)sˌiːsədˈɪlɐ(͡c͡v) ˈa n ˈa
урамсем	uɾˈamsɛm
училищине	ˌut͡ʃiliççˈinɛ
уяв	ˈujav
физикăлла	f ˈɪ z ˈɪ k (͡e͡n)ˌe͡ɪbɹˈiːv(͡c͡v) l l ˈa
фольклор	fˈɔlklɔr
форма	fˈɔrma
фронт	frˈɔnt
хăварать	x (͡e͡n)ˌe͡ɪbɹˈiːv(͡c͡v) v ˈa r ˈa t
хĕрарăмсен	x (͡e͡n)ˌiːbɹˈiːv(͡c͡v) r ˈa r (͡e͡n)ˌe͡ɪbɹˈiːv(͡c͡v) m s jˈæ n
хĕррине	x (͡e͡n)ˌiːbɹˈiːv(͡c͡v) r r ˈɪ n jˈɛ
хĕсмечĕ	x (͡e͡n)ˌiːbɹˈiːv(͡c͡v) s m jˈɛ t͡ʃ (͡e͡n)ˌiːbɹˈiːv(͡c͡v)
хаçата	x ˈa (͡e͡n)sˌiːsədˈɪlɐ(͡c͡v) ˈa t ˈa
хаçатра	x ˈa (͡e͡n)sˌiːsədˈɪlɐ(͡c͡v) ˈa t r ˈa
хайлавĕсене	x ˈa j l ˈa v (͡e͡n)ˌiːbɹˈiːv(͡c͡v) s jˈæ n jˈɛ
халăхне	x ˈa l (͡e͡n)ˌe͡ɪbɹˈiːv(͡c͡v) x n jˈɛ
халап	xˈalap
хапхи	xˈapxɪ
хир	xˈɪr
хуласенче	xˌulasˈɛnt͡ʃɛ
хунсен	xˈʊnsɛn
хупăрласа	x ˈʊ p (͡e͡n)ˌe͡ɪbɹˈiːv(͡c͡v) r l ˈa s ˈa
хурăн	x ˈʊ r (͡e͡n)ˌe͡ɪbɹˈiːv(͡c͡v) n
хыççăнах	x ˈɯ (͡e͡n)sˌiːsədˈɪlɐ sˌiːsədˈɪlɐ ˌe͡ɪbɹˈiːv(͡c͡v) n ˈa x
чавса	t͡ʃˈavsa
чарса	t͡ʃˈarsa
чухăн	t͡ʃ ˈʊ x (͡e͡n)ˌe͡ɪbɹˈiːv(͡c͡v) n
чыслă	t͡ʃ ˈɯ s l (͡e͡n)ˌe͡ɪbɹˈiːv(͡c͡v)
шăпи	ʃ (͡e͡n)ˌe͡ɪbɹˈiːv(͡c͡v) p ˈɪ
шайĕнчи	ʃ ˈa j (͡e͡n)ˌiːbɹˈiːv(͡c͡v) n t͡ʃ ˈɪ
штаб	ʃtˈab
шучĕнче	ʃ ˈʊ t͡ʃ (͡e͡n)ˌiːbɹˈiːv(͡c͡v) n t͡ʃ jˈɛ
шывĕн	ʃ ˈɯ v (͡e͡n)ˌiːbɹˈiːv(͡c͡v) n
шывра	ʃˈɯvra
ытлах	ˈɯtlax
эрч	ˈɛrt͡ʃ
этеплĕхĕ	ˈɛ t jˈɛ p l (͡e͡n)ˌiːbɹˈiːv(͡c͡v) x (͡e͡n)ˌiːbɹˈiːv(͡c͡v)
этеплĕхĕн	ˈɛ t jˈɛ p l (͡e͡n)ˌiːbɹˈiːv(͡c͡v) x (͡e͡n)ˌiːbɹˈiːv(͡c͡v) n
юридици	jˌuɾidˈit͡sɪ
ялсенче	jalsˈɛnt͡ʃɛ
Ҫавӑн	çˈavɯn
Ӳнер	ˈynɛr
ӳнерĕн	ˈø n jˈɛ r (͡e͡n)ˌiːbɹˈiːv(͡c͡v) n
ӳсĕм	ˈø s (͡e͡n)ˌiːbɹˈiːv(͡c͡v) m
ӳсентăран	ˈø s jˈæ n t (͡e͡n)ˌe͡ɪbɹˈiːv(͡c͡v) r ˈa n
ӳстереççĕ	ˈø s t jˈɛ r jˈɛ (͡e͡n)sˌiːsədˈɪlɐ sˌiːsədˈɪlɐ ˌiːbɹˈiːv(͡c͡v)
ӳстерет	østˈɛɾɛt
XII	(͡e͡n)ˈɛks ˈa͡ɪ ˈa͡ɪ(͡c͡v)
XV	(͡e͡n)ˈɛks vˈiː(͡c͡v)
and	(͡e͡n)ˈe͡ɪ ˈɛn dˈiː(͡c͡v)
of	(͡e͡n)ˈə͡ʊ ˈɛf(͡c͡v)
Çӳллĕ	(͡e͡n)sˌiːsədˈɪlɐ(͡c͡v) ˈø l l (͡e͡n)ˌiːbɹˈiːv(͡c͡v)
çăлкуç	(͡e͡n)sˌiːsədˈɪlɐ ˌe͡ɪbɹˈiːv(͡c͡v) l k ˈʊ (͡e͡n)sˌiːsədˈɪlɐ(͡c͡v)
çĕкленнĕ	(͡e͡n)sˌiːsədˈɪlɐ ˌiːbɹˈiːv(͡c͡v) k l jˈæ n n (͡e͡n)ˌiːbɹˈiːv(͡c͡v)
çапăçăва	(͡e͡n)sˌiːsədˈɪlɐ(͡c͡v) ˈa p (͡e͡n)ˌe͡ɪbɹˈiːv sˌiːsədˈɪlɐ ˌe͡ɪbɹˈiːv(͡c͡v) v ˈa
çапăçса	(͡e͡n)sˌiːsədˈɪlɐ(͡c͡v) ˈa p (͡e͡n)ˌe͡ɪbɹˈiːv sˌiːsədˈɪlɐ(͡c͡v) s ˈa
çарĕпе	(͡e͡n)sˌiːsədˈɪlɐ(͡c͡v) ˈa r (͡e͡n)ˌiːbɹˈiːv(͡c͡v) p jˈɛ
çителĕклĕ	(͡e͡n)sˌiːsədˈɪlɐ(͡c͡v) ˈɪ t jˈæ l (͡e͡n)ˌiːbɹˈiːv(͡c͡v) k l (͡e͡n)ˌiːbɹˈiːv(͡c͡v)
çитернĕ	(͡e͡n)sˌiːsədˈɪlɐ(͡c͡v) ˈɪ t jˈɛ r n (͡e͡n)ˌiːbɹˈiːv(͡c͡v)
çуккипе	(͡e͡n)sˌiːsədˈɪlɐ(͡c͡v) ˈʊ k k ˈɪ p jˈɛ
çуллăха	(͡e͡n)sˌiːsədˈɪlɐ(͡c͡v) ˈʊ l l (͡e͡n)ˌe͡ɪbɹˈiːv(͡c͡v) x ˈa
çумăр	(͡e͡n)sˌiːsədˈɪlɐ(͡c͡v) ˈʊ m (͡e͡n)ˌe͡ɪbɹˈiːv(͡c͡v) r
çурри	(͡e͡n)sˌiːsədˈɪlɐ(͡c͡v) ˈʊ r r ˈɪ
çынĕ	(͡e͡n)sˌiːsədˈɪlɐ(͡c͡v) ˈɯ n (͡e͡n)ˌiːbɹˈiːv(͡c͡v)
çырлисем	(͡e͡n)sˌiːsədˈɪlɐ(͡c͡v) ˈɯ r l ˈɪ s jˈæ m
çырулăх	(͡e͡n)sˌiːsədˈɪlɐ(͡c͡v) ˈɯ r ˈʊ l (͡e͡n)ˌe͡ɪbɹˈiːv(͡c͡v) x
ăру	(͡e͡n)ˌe͡ɪbɹˈiːv(͡c͡v) r ˈʊ
ĕçтеш	(͡e͡n)ˌiːbɹˈiːv sˌiːsədˈɪlɐ(͡c͡v) t jˈɛ ʃ
ĕçтешĕсем	(͡e͡n)ˌiːbɹˈiːv sˌiːsədˈɪlɐ(͡c͡v) t jˈɛ ʃ (͡e͡n)ˌiːbɹˈiːv(͡c͡v) s jˈæ m
Антоний	antˈonɪj
Афанасьев	ˌafanˈasʲɛv
Ахаль	ˈaxal
Валентин	valˈɛntɪn
Виççĕмĕш	v ˈɪ (͡e͡n)sˌiːsədˈɪlɐ sˌiːsədˈɪlɐ ˌiːbɹˈiːv(͡c͡v) m (͡e͡n)ˌiːbɹˈiːv(͡c͡v) ʃ
Википеди	vˌikipˈɛdɪ
Вячеслав	vjat͡ʃˈɛslav
Генрих	ɡˈɛnrɪx
Гоби	ɡˈobɪ
Горький	ɡˈɔrkɪj
Грек	ɡrˈɛk
Двина	dvˈina
Евгений	jɛvɡˈɛnɪj
Жан	ʒˈan
Италин	itˈalɪn
Йĕпреç	j (͡e͡n)ˌiːbɹˈiːv(͡c͡v) p r jˈɛ (͡e͡n)sˌiːsədˈɪlɐ(͡c͡v)
Йышĕ	j ˈɯ ʃ (͡e͡n)ˌiːbɹˈiːv(͡c͡v)
КПСС	kpss
Кунашкал	kunˈaʃkal
Луара	luˈaɾa
Мексика	mɛksˈika
Мияс	mˈijas
Мордва	mˈɔrdva
Моте	mˈotɛ
Новгород	nɔvɡˈoɾɔd
Онега	onˈɛɡa
Пăла	p (͡e͡n)ˌe͡ɪbɹˈiːv(͡c͡v) l ˈa
Перси	pˈɛrsɪ
Петр	pˈɛtr
Полуй	pˈolʊj
Пурнăç	p ˈʊ r n (͡e͡n)ˌe͡ɪbɹˈiːv sˌiːsədˈɪlɐ(͡c͡v)
Рейн	rˈɛjn
Светлана	svɛtlˈana
Сена	sˈɛna
Тĕнчере	t (͡e͡n)ˌiːbɹˈiːv(͡c͡v) n t͡ʃ jˈɛ r jˈɛ
Тĕпхули	t (͡e͡n)ˌiːbɹˈiːv(͡c͡v) p x ˈʊ l ˈɪ
Татош	tˈatɔʃ
Тен	tˈɛn
Тухăçра	t ˈʊ x (͡e͡n)ˌe͡ɪbɹˈiːv sˌiːsədˈɪlɐ(͡c͡v) r ˈa
Урта	ˈʊrta
Фильма	fˈɪlma
Хĕвеланăç	x (͡e͡n)ˌiːbɹˈiːv(͡c͡v) v jˈæ l ˈa n (͡e͡n)ˌe͡ɪbɹˈiːv sˌiːsədˈɪlɐ(͡c͡v)
Хулари	xulˈaɾɪ
Элам	ˈelam
Эстони	ɛstˈonɪ
Этем	ˈetɛm
адресĕ	ˈa d r jˈɛ s (͡e͡n)ˌiːbɹˈiːv(͡c͡v)
айăпланă	ˈa j (͡e͡n)ˌe͡ɪbɹˈiːv(͡c͡v) p l ˈa n (͡e͡n)ˌe͡ɪbɹˈiːv(͡c͡v)
айлăмĕ	ˈa j l (͡e͡n)ˌe͡ɪbɹˈiːv(͡c͡v) m (͡e͡n)ˌiːbɹˈiːv(͡c͡v)
академийĕн	ˈa k ˈa d jˈæ m ˈɪ j (͡e͡n)ˌiːbɹˈiːv(͡c͡v) n
апачĕ	ˈa p ˈa t͡ʃ (͡e͡n)ˌiːbɹˈiːv(͡c͡v)
арçынсем	ˈa r (͡e͡n)sˌiːsədˈɪlɐ(͡c͡v) ˈɯ n s jˈæ m
археологи	ˌarxɛolˈoɡɪ
асăрханă	ˈa s (͡e͡n)ˌe͡ɪbɹˈiːv(͡c͡v) r x ˈa n (͡e͡n)ˌe͡ɪbɹˈiːv(͡c͡v)
вăйпа	v (͡e͡n)ˌe͡ɪbɹˈiːv(͡c͡v) j p ˈa
вăрмансем	v (͡e͡n)ˌe͡ɪbɹˈiːv(͡c͡v) r m ˈa n s jˈæ m
вăта	v (͡e͡n)ˌe͡ɪbɹˈiːv(͡c͡v) t ˈa
вĕçленнĕ	v (͡e͡n)ˌiːbɹˈiːv sˌiːsədˈɪlɐ(͡c͡v) l jˈæ n n (͡e͡n)ˌiːbɹˈiːv(͡c͡v)
вĕренмелли	v (͡e͡n)ˌiːbɹˈiːv(͡c͡v) r jˈæ n m jˈæ l l ˈɪ
вĕсемпе	v (͡e͡n)ˌiːbɹˈiːv(͡c͡v) s jˈæ m p jˈɛ
варрине	varrˈinɛ
виçе	v ˈɪ (͡e͡n)sˌiːsədˈɪlɐ(͡c͡v) jˈɛ
витĕм	v ˈɪ t (͡e͡n)ˌiːbɹˈiːv(͡c͡v) m
докторĕ	d ˈɔ k t ˈɔ r (͡e͡n)ˌiːbɹˈiːv(͡c͡v)
журналта	ʒʊrnˈalta
йĕркелеме	j (͡e͡n)ˌiːbɹˈiːv(͡c͡v) r k jˈæ l jˈæ m jˈɛ
йышлăхĕ	j ˈɯ ʃ l (͡e͡n)ˌe͡ɪbɹˈiːv(͡c͡v) x (͡e͡n)ˌiːbɹˈiːv(͡c͡v)
йышӑннӑ	jɯʃˈɯnnɯ
кĕлĕ	k (͡e͡n)ˌiːbɹˈiːv(͡c͡v) l (͡e͡n)ˌiːbɹˈiːv(͡c͡v)
кĕлетки	k (͡e͡n)ˌiːbɹˈiːv(͡c͡v) l jˈɛ t k ˈɪ
кĕмен	k (͡e͡n)ˌiːbɹˈiːv(͡c͡v) m jˈæ n
кĕнекере	k (͡e͡n)ˌiːbɹˈiːv(͡c͡v) n jˈɛ k jˈɛ r jˈɛ
кĕнекисем	k (͡e͡n)ˌiːbɹˈiːv(͡c͡v) n jˈɛ k ˈɪ s jˈæ m
кĕрсен	k (͡e͡n)ˌiːbɹˈiːv(͡c͡v) r s jˈæ n
кайăксем	k ˈa j (͡e͡n)ˌe͡ɪbɹˈiːv(͡c͡v) k s jˈæ m
кайман	kˈajman
кайри	kˈajrɪ
калакан	kalˈakan
карапа	kaɾˈapa
карман	kˈarman
касак	kˈasak
керменĕнче	k jˈɛ r m jˈæ n (͡e͡n)ˌiːbɹˈiːv(͡c͡v) n t͡ʃ jˈɛ
класс	klˈass
кунĕсенче	k ˈʊ n (͡e͡n)ˌiːbɹˈiːv(͡c͡v) s jˈæ n t͡ʃ jˈɛ
курăнаççĕ	k ˈʊ r (͡e͡n)ˌe͡ɪbɹˈiːv(͡c͡v) n ˈa (͡e͡n)sˌiːsədˈɪlɐ sˌiːsədˈɪlɐ ˌiːbɹˈiːv(͡c͡v)
курмалли	kʊrmˈallɪ
кӑна	kˈɯna
кӳлĕсем	k ˈø l (͡e͡n)ˌiːbɹˈiːv(͡c͡v) s jˈæ m
ман	mˈan
материалсем	mˌatɛɾiˈalsɛm
мелĕпе	m jˈæ l (͡e͡n)ˌiːbɹˈiːv(͡c͡v) p jˈɛ
меслечĕпе	m jˈɛ s l jˈɛ t͡ʃ (͡e͡n)ˌiːbɹˈiːv(͡c͡v) p jˈɛ
минерал	minˈɛɾal
министерствин	mˌinɪstˈɛrstvɪn
облаç	ˈɔ b l ˈa (͡e͡n)sˌiːsədˈɪlɐ(͡c͡v)
пăрахать	p (͡e͡n)ˌe͡ɪbɹˈiːv(͡c͡v) r ˈa x ˈa t
пĕлеççĕ	p (͡e͡n)ˌiːbɹˈiːv(͡c͡v) l jˈɛ (͡e͡n)sˌiːsədˈɪlɐ sˌiːsədˈɪlɐ ˌiːbɹˈiːv(͡c͡v)
пĕлекен	p (͡e͡n)ˌiːbɹˈiːv(͡c͡v) l jˈɛ k jˈæ n
пĕлет	p (͡e͡n)ˌiːbɹˈiːv(͡c͡v) l jˈɛ t
палăкĕсем	p ˈa l (͡e͡n)ˌe͡ɪbɹˈiːv(͡c͡v) k (͡e͡n)ˌiːbɹˈiːv(͡c͡v) s jˈæ m
паллисене	pˌallisˈɛnɛ
партине	partˈinɛ
патшалăхра	p ˈa t ʃ ˈa l (͡e͡n)ˌe͡ɪbɹˈiːv(͡c͡v) x r ˈa
паянкуна	pˌajankˈuna
пенĕ	p jˈæ n (͡e͡n)ˌiːbɹˈiːv(͡c͡v)
порчĕ	p ˈɔ r t͡ʃ (͡e͡n)ˌiːbɹˈiːv(͡c͡v)
посёлок	pɔsjˈolɔk
предприяти	prˌɛdprijˈatɪ
проект	prˈoɛkt
пуçсăр	p ˈʊ (͡e͡n)sˌiːsədˈɪlɐ(͡c͡v) s (͡e͡n)ˌe͡ɪbɹˈiːv(͡c͡v) r
пуçтарăнать	p ˈʊ (͡e͡n)sˌiːsədˈɪlɐ(͡c͡v) t ˈa r (͡e͡n)ˌe͡ɪbɹˈiːv(͡c͡v) n ˈa t
пулăм	p ˈʊ l (͡e͡n)ˌe͡ɪbɹˈiːv(͡c͡v) m
пулăма	p ˈʊ l (͡e͡n)ˌe͡ɪbɹˈiːv(͡c͡v) m ˈa
пулăшакан	p ˈʊ l (͡e͡n)ˌe͡ɪbɹˈiːv(͡c͡v) ʃ ˈa k ˈa n
пултарнине	pˌʊltarnˈinɛ
пуплев	pˈʊplɛv
пурлăхне	p ˈʊ r l (͡e͡n)ˌe͡ɪbɹˈiːv(͡c͡v) x n jˈɛ
пуҫланӑ	pʊçlˈanɯ
пӗчӗк	pˈɵt͡ʃɵk
регион	rɛɡˈiɔn
регионӗ	rˌɛɡiˈonɵ
ретне	rˈɛtnɛ
сăвăсен	s (͡e͡n)ˌe͡ɪbɹˈiːv(͡c͡v) v (͡e͡n)ˌe͡ɪbɹˈiːv(͡c͡v) s jˈæ n
сăваплă	s (͡e͡n)ˌe͡ɪbɹˈiːv(͡c͡v) v ˈa p l (͡e͡n)ˌe͡ɪbɹˈiːv(͡c͡v)
сăлтавĕ	s (͡e͡n)ˌe͡ɪbɹˈiːv(͡c͡v) l t ˈa v (͡e͡n)ˌiːbɹˈiːv(͡c͡v)
сăмахсемпе	s (͡e͡n)ˌe͡ɪbɹˈiːv(͡c͡v) m ˈa x s jˈæ m p jˈɛ
сăмахсен	s (͡e͡n)ˌe͡ɪbɹˈiːv(͡c͡v) m ˈa x s jˈæ n
сăмахсене	s (͡e͡n)ˌe͡ɪbɹˈiːv(͡c͡v) m ˈa x s jˈæ n jˈɛ
сăнарĕ	s (͡e͡n)ˌe͡ɪbɹˈiːv(͡c͡v) n ˈa r (͡e͡n)ˌiːbɹˈiːv(͡c͡v)
сăра	s (͡e͡n)ˌe͡ɪbɹˈiːv(͡c͡v) r ˈa
сĕнет	s (͡e͡n)ˌiːbɹˈiːv(͡c͡v) n jˈɛ t
савăт	s ˈa v (͡e͡n)ˌe͡ɪbɹˈiːv(͡c͡v) t
сарлакăшĕ	s ˈa r l ˈa k (͡e͡n)ˌe͡ɪbɹˈiːv(͡c͡v) ʃ (͡e͡n)ˌiːbɹˈiːv(͡c͡v)
саспалли	saspˈallɪ
сирсе	sˈɪrsɛ
словарь	slˈovar
статьясем	statjˈasɛm
стр	str
суйлаççĕ	s ˈʊ j l ˈa (͡e͡n)sˌiːsədˈɪlɐ sˌiːsədˈɪlɐ ˌiːbɹˈiːv(͡c͡v)
сутаççĕ	s ˈʊ t ˈa (͡e͡n)sˌiːsədˈɪlɐ sˌiːsədˈɪlɐ ˌiːbɹˈiːv(͡c͡v)
сцена	st͡sˈɛna
тÿрĕ	t (͡e͡n)wˌa͡ɪˈʊmla͡ʊt(͡c͡v) r (͡e͡n)ˌiːbɹˈiːv(͡c͡v)
тăваткал	t (͡e͡n)ˌe͡ɪbɹˈiːv(͡c͡v) v ˈa t k ˈa l
тăмасть	t (͡e͡n)ˌe͡ɪbɹˈiːv(͡c͡v) m ˈa s t
тăнине	t (͡e͡n)ˌe͡ɪbɹˈiːv(͡c͡v) n ˈɪ n jˈɛ
тăпра	t (͡e͡n)ˌe͡ɪbɹˈiːv(͡c͡v) p r ˈa
тăрăшнипе	t (͡e͡n)ˌe͡ɪbɹˈiːv(͡c͡v) r (͡e͡n)ˌe͡ɪbɹˈiːv(͡c͡v) ʃ n ˈɪ p jˈɛ
тăшманăн	t (͡e͡n)ˌe͡ɪbɹˈiːv(͡c͡v) ʃ m ˈa n (͡e͡n)ˌe͡ɪbɹˈiːv(͡c͡v) n
тĕле	t (͡e͡n)ˌiːbɹˈiːv(͡c͡v) l jˈɛ
тĕллĕ	t (͡e͡n)ˌiːbɹˈiːv(͡c͡v) l l (͡e͡n)ˌiːbɹˈiːv(͡c͡v)
тĕнчене	t (͡e͡n)ˌiːbɹˈiːv(͡c͡v) n t͡ʃ jˈæ n jˈɛ
тĕпе	t (͡e͡n)ˌiːbɹˈiːv(͡c͡v) p jˈɛ
тĕппипех	t (͡e͡n)ˌiːbɹˈiːv(͡c͡v) p p ˈɪ p jˈɛ x
тĕспе	t (͡e͡n)ˌiːbɹˈiːv(͡c͡v) s p jˈɛ
тавар	tˈavar
таврари	tavrˈaɾɪ
тапăннă	t ˈa p (͡e͡n)ˌe͡ɪbɹˈiːv(͡c͡v) n n (͡e͡n)ˌe͡ɪbɹˈiːv(͡c͡v)
термина	tɛrmˈina
территори	tˌɛrritˈoɾɪ
тинӗс	tˈinɵs
туйса	tˈʊjsa
тути	tˈutɪ
тӑракан	tɯɾˈakan
университетне	ˌunivˌɛrsitˈɛtnɛ
урăххисем	ˈʊ r (͡e͡n)ˌe͡ɪbɹˈiːv(͡c͡v) x x ˈɪ s jˈæ m
утравсем	ʊtrˈavsɛm
факультечĕ	f ˈa k ˈʊ l t jˈɛ t͡ʃ (͡e͡n)ˌiːbɹˈiːv(͡c͡v)
флотĕнче	f l ˈɔ t (͡e͡n)ˌiːbɹˈiːv(͡c͡v) n t͡ʃ jˈɛ
флочĕ	f l ˈɔ t͡ʃ (͡e͡n)ˌiːbɹˈiːv(͡c͡v)
фронта	frˈɔnta
хăпарма	x (͡e͡n)ˌe͡ɪbɹˈiːv(͡c͡v) p ˈa r m ˈa
хăпарса	x (͡e͡n)ˌe͡ɪbɹˈiːv(͡c͡v) p ˈa r s ˈa
хĕрарăмсем	x (͡e͡n)ˌiːbɹˈiːv(͡c͡v) r ˈa r (͡e͡n)ˌe͡ɪbɹˈiːv(͡c͡v) m s jˈæ m
хĕрри	x (͡e͡n)ˌiːbɹˈiːv(͡c͡v) r r ˈɪ
хакланă	x ˈa k l ˈa n (͡e͡n)ˌe͡ɪbɹˈiːv(͡c͡v)
халиччен	xalˈɪt͡ʃt͡ʃɛn
хатĕрлес	x ˈa t (͡e͡n)ˌiːbɹˈiːv(͡c͡v) r l jˈɛ s
хупса	xˈʊpsa
хутшăнакансем	x ˈʊ t ʃ (͡e͡n)ˌe͡ɪbɹˈiːv(͡c͡v) n ˈa k ˈa n s jˈæ m
хушăра	x ˈʊ ʃ (͡e͡n)ˌe͡ɪbɹˈiːv(͡c͡v) r ˈa
чăнкă	t͡ʃ (͡e͡n)ˌe͡ɪbɹˈiːv(͡c͡v) n k (͡e͡n)ˌe͡ɪbɹˈiːv(͡c͡v)
чĕре	t͡ʃ (͡e͡n)ˌiːbɹˈiːv(͡c͡v) r jˈɛ
чĕрчунсем	t͡ʃ (͡e͡n)ˌiːbɹˈiːv(͡c͡v) r t͡ʃ ˈʊ n s jˈæ m
чей	t͡ʃˈɛj
чылайăш	t͡ʃ ˈɯ l ˈa j (͡e͡n)ˌe͡ɪbɹˈiːv(͡c͡v) ʃ
шăпах	ʃ (͡e͡n)ˌe͡ɪbɹˈiːv(͡c͡v) p ˈa x
швед	ʃvˈɛd
шкулсенче	ʃkʊlsˈɛnt͡ʃɛ
шкултан	ʃkˈʊltan
шутласан	ʃʊtlˈasan
шухăшпа	ʃ ˈʊ x (͡e͡n)ˌe͡ɪbɹˈiːv(͡c͡v) ʃ p ˈa
ыйтăва	ˈɯ j t (͡e͡n)ˌe͡ɪbɹˈiːv(͡c͡v) v ˈa
экран	ˈɛkran
элам	ˈelam
юлнӑ	jˈʊlnɯ
юрăç	jˈʊ r (͡e͡n)ˌe͡ɪbɹˈiːv sˌiːsədˈɪlɐ(͡c͡v)
юрăсем	jˈʊ r (͡e͡n)ˌe͡ɪbɹˈiːv(͡c͡v) s jˈæ m
юрамасть	juɾˈamast
юрлама	jʊrlˈama
юхăмне	jˈʊ x (͡e͡n)ˌe͡ɪbɹˈiːv(͡c͡v) m n jˈɛ
яваплă	jˈa v ˈa p l (͡e͡n)ˌe͡ɪbɹˈiːv(͡c͡v)
япалисене	jˌapalisˈɛnɛ
ятсем	jˈatsɛm
Ҫав	çˈav
ӳкерсе	ykˈɛrsɛ
VII	(͡e͡n)vˈiː ˈa͡ɪ ˈa͡ɪ(͡c͡v)
VIII	(͡e͡n)vˈiː ˈa͡ɪ ˈa͡ɪ ˈa͡ɪ(͡c͡v)
Çĕмĕрле	(͡e͡n)sˌiːsədˈɪlɐ ˌiːbɹˈiːv(͡c͡v) m (͡e͡n)ˌiːbɹˈiːv(͡c͡v) r l jˈɛ
Çĕнтерӳ	(͡e͡n)sˌiːsədˈɪlɐ ˌiːbɹˈiːv(͡c͡v) n t jˈɛ r ˈø
Çĕпĕрти	(͡e͡n)sˌiːsədˈɪlɐ ˌiːbɹˈiːv(͡c͡v) p (͡e͡n)ˌiːbɹˈiːv(͡c͡v) r t ˈɪ
Çыран	(͡e͡n)sˌiːsədˈɪlɐ(͡c͡v) ˈɯ r ˈa n
çăви	(͡e͡n)sˌiːsədˈɪlɐ ˌe͡ɪbɹˈiːv(͡c͡v) v ˈɪ
çĕршыври	(͡e͡n)sˌiːsədˈɪlɐ ˌiːbɹˈiːv(͡c͡v) r ʃ ˈɯ v r ˈɪ
çавнашкал	(͡e͡n)sˌiːsədˈɪlɐ(͡c͡v) ˈa v n ˈa ʃ k ˈa l
çавра	(͡e͡n)sˌiːsədˈɪlɐ(͡c͡v) ˈa v r ˈa
çамрăкĕсен	(͡e͡n)sˌiːsədˈɪlɐ(͡c͡v) ˈa m r (͡e͡n)ˌe͡ɪbɹˈiːv(͡c͡v) k (͡e͡n)ˌiːbɹˈiːv(͡c͡v) s jˈæ n
çем	(͡e͡n)sˌiːsədˈɪlɐ(͡c͡v) jˈæ m
çемйи	(͡e͡n)sˌiːsədˈɪlɐ(͡c͡v) jˈæ m j ˈɪ
çимĕç	(͡e͡n)sˌiːsədˈɪlɐ(͡c͡v) ˈɪ m (͡e͡n)ˌiːbɹˈiːv sˌiːsədˈɪlɐ(͡c͡v)
çирĕплетет	(͡e͡n)sˌiːsədˈɪlɐ(͡c͡v) ˈɪ r (͡e͡n)ˌiːbɹˈiːv(͡c͡v) p l jˈɛ t jˈɛ t
çиччĕ	(͡e͡n)sˌiːsədˈɪlɐ(͡c͡v) ˈɪ t͡ʃ t͡ʃ (͡e͡n)ˌiːbɹˈiːv(͡c͡v)
çуккине	(͡e͡n)sˌiːsədˈɪlɐ(͡c͡v) ˈʊ k k ˈɪ n jˈɛ
çулсене	(͡e͡n)sˌiːsədˈɪlɐ(͡c͡v) ˈʊ l s jˈæ n jˈɛ
çулталăк	(͡e͡n)sˌiːsədˈɪlɐ(͡c͡v) ˈʊ l t ˈa l (͡e͡n)ˌe͡ɪbɹˈiːv(͡c͡v) k
çунакан	(͡e͡n)sˌiːsədˈɪlɐ(͡c͡v) ˈʊ n ˈa k ˈa n
çуран	(͡e͡n)sˌiːsədˈɪlɐ(͡c͡v) ˈʊ r ˈa n
çурчĕсем	(͡e͡n)sˌiːsədˈɪlɐ(͡c͡v) ˈʊ r t͡ʃ (͡e͡n)ˌiːbɹˈiːv(͡c͡v) s jˈæ m
çыхăнса	(͡e͡n)sˌiːsədˈɪlɐ(͡c͡v) ˈɯ x (͡e͡n)ˌe͡ɪbɹˈiːv(͡c͡v) n s ˈa
çыхăнтарнă	(͡e͡n)sˌiːsədˈɪlɐ(͡c͡v) ˈɯ x (͡e͡n)ˌe͡ɪbɹˈiːv(͡c͡v) n t ˈa r n (͡e͡n)ˌe͡ɪbɹˈiːv(͡c͡v)
çӳлелле	(͡e͡n)sˌiːsədˈɪlɐ(͡c͡v) ˈø l jˈæ l l jˈɛ
çӳлте	(͡e͡n)sˌiːsədˈɪlɐ(͡c͡v) ˈø l t jˈɛ
ăнланмалла	(͡e͡n)ˌe͡ɪbɹˈiːv(͡c͡v) n l ˈa n m ˈa l l ˈa
ăнлантарнă	(͡e͡n)ˌe͡ɪbɹˈiːv(͡c͡v) n l ˈa n t ˈa r n (͡e͡n)ˌe͡ɪbɹˈiːv(͡c͡v)
ăрат	(͡e͡n)ˌe͡ɪbɹˈiːv(͡c͡v) r ˈa t
ăслав	(͡e͡n)ˌe͡ɪbɹˈiːv(͡c͡v) s l ˈa v
ăстрăм	(͡e͡n)ˌe͡ɪbɹˈiːv(͡c͡v) s t r (͡e͡n)ˌe͡ɪbɹˈiːv(͡c͡v) m
ĕçме	(͡e͡n)ˌiːbɹˈiːv sˌiːsədˈɪlɐ(͡c͡v) m jˈɛ
ĕçми	(͡e͡n)ˌiːbɹˈiːv sˌiːsədˈɪlɐ(͡c͡v) m ˈɪ
ĕçсемпе	(͡e͡n)ˌiːbɹˈiːv sˌiːsədˈɪlɐ(͡c͡v) s jˈæ m p jˈɛ
ĕçсен	(͡e͡n)ˌiːbɹˈiːv sˌiːsədˈɪlɐ(͡c͡v) s jˈæ n
ĕçченĕсем	(͡e͡n)ˌiːbɹˈiːv sˌiːsədˈɪlɐ(͡c͡v) t͡ʃ jˈæ n (͡e͡n)ˌiːbɹˈiːv(͡c͡v) s jˈæ m
ĕмĕрсем	(͡e͡n)ˌiːbɹˈiːv(͡c͡v) m (͡e͡n)ˌiːbɹˈiːv(͡c͡v) r s jˈæ m
ĕмĕт	(͡e͡n)ˌiːbɹˈiːv(͡c͡v) m (͡e͡n)ˌiːbɹˈiːv(͡c͡v) t
А	ˈa
Акă	ˈa k (͡e͡n)ˌe͡ɪbɹˈiːv(͡c͡v)
Алексеев	ˌalɛksˈɛɛv
Америкăри	ˈa m jˈɛ r ˈɪ k (͡e͡n)ˌe͡ɪbɹˈiːv(͡c͡v) r ˈɪ
Арăмĕ	ˈa r (͡e͡n)ˌe͡ɪbɹˈiːv(͡c͡v) m (͡e͡n)ˌiːbɹˈiːv(͡c͡v)
Аркадий	arkˈadɪj
Афганистан	ˌafɡanˈɪstan
Ашшĕпе	ˈa ʃ ʃ (͡e͡n)ˌiːbɹˈiːv(͡c͡v) p jˈɛ
Борисов	boɾˈisɔv
Вăрçăра	v (͡e͡n)ˌe͡ɪbɹˈiːv(͡c͡v) r (͡e͡n)sˌiːsədˈɪlɐ ˌe͡ɪbɹˈiːv(͡c͡v) r ˈa
Вăтаçĕр	v (͡e͡n)ˌe͡ɪbɹˈiːv(͡c͡v) t ˈa (͡e͡n)sˌiːsədˈɪlɐ ˌiːbɹˈiːv(͡c͡v) r
Вăтамран	v (͡e͡n)ˌe͡ɪbɹˈiːv(͡c͡v) t ˈa m r ˈa n
Венера	vɛnˈɛɾa
Версаль	vˈɛrsal
Вивьен	vˈɪvʲɛn
Вырăссем	v ˈɯ r (͡e͡n)ˌe͡ɪbɹˈiːv(͡c͡v) s s jˈæ m
Вьетнам	vʲˈɛtnam
Газпром	ɡˈazprɔm
Дж	dʒ
Дмитриев	dmɪtrˈiɛv
Дон	dˈɔn
Екатерина	jˌekatɛɾˈina
Жуков	ʒˈukɔv
Йывăр	j ˈɯ v (͡e͡n)ˌe͡ɪbɹˈiːv(͡c͡v) r
Куйбышев	kʊjbˈɯʃɛv
Кулленхи	kʊllˈɛnxɪ
Кума	kˈuma
Кунсăр	k ˈʊ n s (͡e͡n)ˌe͡ɪbɹˈiːv(͡c͡v) r
Кунти	kˈʊntɪ
Лаба	lˈaba
Лондон	lˈɔndɔn
Мĕн	m (͡e͡n)ˌiːbɹˈiːv(͡c͡v) n
Малка	mˈalka
Нарспи	nˈarspɪ
Никита	nikˈita
Никольский	nikˈɔlskɪj
Ныда	nˈɯda
Пăва	p (͡e͡n)ˌe͡ɪbɹˈiːv(͡c͡v) v ˈa
Патшалăхăн	p ˈa t ʃ ˈa l (͡e͡n)ˌe͡ɪbɹˈiːv(͡c͡v) x (͡e͡n)ˌe͡ɪbɹˈiːv(͡c͡v) n
Раççее	r ˈa (͡e͡n)sˌiːsədˈɪlɐ sˌiːsədˈɪlɐ(͡c͡v) jˈɛ jˈɛ
Раҫҫейри	raççˈɛjrɪ
СÇВ	s (͡e͡n)sˌiːsədˈɪlɐ(͡c͡v) v
Сăр	s (͡e͡n)ˌe͡ɪbɹˈiːv(͡c͡v) r
Степан	stˈɛpan
Тĕрĕссипе	t (͡e͡n)ˌiːbɹˈiːv(͡c͡v) r (͡e͡n)ˌiːbɹˈiːv(͡c͡v) s s ˈɪ p jˈɛ
Татьяна	tatjˈana
Тимур	tˈimʊr
Тулă	t ˈʊ l (͡e͡n)ˌe͡ɪbɹˈiːv(͡c͡v)
Уйрăм	ˈʊ j r (͡e͡n)ˌe͡ɪbɹˈiːv(͡c͡v) m
Улатăр	ˈʊ l ˈa t (͡e͡n)ˌe͡ɪbɹˈiːv(͡c͡v) r
Упи	ˈupɪ
Урăхла	ˈʊ r (͡e͡n)ˌe͡ɪbɹˈiːv(͡c͡v) x l ˈa
Фильм	fˈɪlm
Хаçат	x ˈa (͡e͡n)sˌiːsədˈɪlɐ(͡c͡v) ˈa t
Цинь	t͡sˈɪn
Чутай	t͡ʃˈutaj
Чуя	t͡ʃˈuja
Шкула	ʃkˈula
Эппин	ˈɛppɪn
Ятне	jˈatnɛ
айлăмра	ˈa j l (͡e͡n)ˌe͡ɪbɹˈiːv(͡c͡v) m r ˈa
ансамблĕ	ˈa n s ˈa m b l (͡e͡n)ˌiːbɹˈiːv(͡c͡v)
антарнă	ˈa n t ˈa r n (͡e͡n)ˌe͡ɪbɹˈiːv(͡c͡v)
арамей	aɾˈamɛj
арман	ˈarman
архитектура	ˌarxitɛktˈuɾa
асăнни	ˈa s (͡e͡n)ˌe͡ɪbɹˈiːv(͡c͡v) n n ˈɪ
асфальт	ˈasfalt
аталанăвне	ˈa t ˈa l ˈa n (͡e͡n)ˌe͡ɪbɹˈiːv(͡c͡v) v n jˈɛ
аякра	ajˈakra
британи	britˈanɪ
вăрçнă	v (͡e͡n)ˌe͡ɪbɹˈiːv(͡c͡v) r (͡e͡n)sˌiːsədˈɪlɐ(͡c͡v) n (͡e͡n)ˌe͡ɪbɹˈiːv(͡c͡v)
вĕлерет	v (͡e͡n)ˌiːbɹˈiːv(͡c͡v) l jˈɛ r jˈɛ t
вĕренекенсем	v (͡e͡n)ˌiːbɹˈiːv(͡c͡v) r jˈæ n jˈɛ k jˈæ n s jˈæ m
вĕт	v (͡e͡n)ˌiːbɹˈiːv(͡c͡v) t
варианчĕ	v ˈa r ˈɪ ˈa n t͡ʃ (͡e͡n)ˌiːbɹˈiːv(͡c͡v)
ватăсем	v ˈa t (͡e͡n)ˌe͡ɪbɹˈiːv(͡c͡v) s jˈæ m
верси	vˈɛrsɪ
виçме	v ˈɪ (͡e͡n)sˌiːsədˈɪlɐ(͡c͡v) m jˈɛ
влаçĕ	v l ˈa (͡e͡n)sˌiːsədˈɪlɐ ˌiːbɹˈiːv(͡c͡v)
вуншар	vˈʊnʃar
вӑйлӑ	vˈɯjlɯ
вӗреннӗ	vɵɾˈɛnnɵ
енĕнче	jˈæ n (͡e͡n)ˌiːbɹˈiːv(͡c͡v) n t͡ʃ jˈɛ
еплерех	jɛplˈɛɾɛx
журналăн	ʒ ˈʊ r n ˈa l (͡e͡n)ˌe͡ɪbɹˈiːv(͡c͡v) n
журналистика	ʒˌʊrnalɪstˈika
завод	zˈavɔd
империн	ɪmpˈɛɾɪn
империне	ˌɪmpɛɾˈinɛ
инçе	ˈɪ n (͡e͡n)sˌiːsədˈɪlɐ(͡c͡v) jˈɛ
иртнине	ɪrtnˈinɛ
йăла	j (͡e͡n)ˌe͡ɪbɹˈiːv(͡c͡v) l ˈa
йăлапа	j (͡e͡n)ˌe͡ɪbɹˈiːv(͡c͡v) l ˈa p ˈa
йăнăш	j (͡e͡n)ˌe͡ɪbɹˈiːv(͡c͡v) n (͡e͡n)ˌe͡ɪbɹˈiːv(͡c͡v) ʃ
йăхсем	j (͡e͡n)ˌe͡ɪbɹˈiːv(͡c͡v) x s jˈæ m
йĕрĕпе	j (͡e͡n)ˌiːbɹˈiːv(͡c͡v) r (͡e͡n)ˌiːbɹˈiːv(͡c͡v) p jˈɛ
йĕркелет	j (͡e͡n)ˌiːbɹˈiːv(͡c͡v) r k jˈæ l jˈɛ t
йĕркеллĕ	j (͡e͡n)ˌiːbɹˈiːv(͡c͡v) r k jˈæ l l (͡e͡n)ˌiːbɹˈiːv(͡c͡v)
йĕрки	j (͡e͡n)ˌiːbɹˈiːv(͡c͡v) r k ˈɪ
йĕркине	j (͡e͡n)ˌiːbɹˈiːv(͡c͡v) r k ˈɪ n jˈɛ
йышĕн	j ˈɯ ʃ (͡e͡n)ˌiːbɹˈiːv(͡c͡v) n
йышĕпе	j ˈɯ ʃ (͡e͡n)ˌiːbɹˈiːv(͡c͡v) p jˈɛ
йыша	jˈɯʃa
кăтартни	k (͡e͡n)ˌe͡ɪbɹˈiːv(͡c͡v) t ˈa r t n ˈɪ
кĕмелли	k (͡e͡n)ˌiːbɹˈiːv(͡c͡v) m jˈæ l l ˈɪ
кĕнекисене	k (͡e͡n)ˌiːbɹˈiːv(͡c͡v) n jˈɛ k ˈɪ s jˈæ n jˈɛ
кĕперĕ	k (͡e͡n)ˌiːbɹˈiːv(͡c͡v) p jˈɛ r (͡e͡n)ˌiːbɹˈiːv(͡c͡v)
кĕпернин	k (͡e͡n)ˌiːbɹˈiːv(͡c͡v) p jˈɛ r n ˈɪ n
канал	kˈanal
кантонĕ	k ˈa n t ˈɔ n (͡e͡n)ˌiːbɹˈiːv(͡c͡v)
каснă	k ˈa s n (͡e͡n)ˌe͡ɪbɹˈiːv(͡c͡v)
кельт	kˈɛlt
кино	kˈinɔ
компанин	kɔmpˈanɪn
куçарать	k ˈʊ (͡e͡n)sˌiːsədˈɪlɐ(͡c͡v) ˈa r ˈa t
куллен	kˈʊllɛn
кунах	kˈunax
кунашкал	kunˈaʃkal
кунччен	kˈʊnt͡ʃt͡ʃɛn
курав	kˈuɾav
курман	kˈʊrman
кӳнĕ	k ˈø n (͡e͡n)ˌiːbɹˈiːv(͡c͡v)
лапамĕ	l ˈa p ˈa m (͡e͡n)ˌiːbɹˈiːv(͡c͡v)
литератури	lˌitɛɾatˈuɾɪ
лутра	lˈʊtra
мăшăр	m (͡e͡n)ˌe͡ɪbɹˈiːv(͡c͡v) ʃ (͡e͡n)ˌe͡ɪbɹˈiːv(͡c͡v) r
майĕпен	m ˈa j (͡e͡n)ˌiːbɹˈiːv(͡c͡v) p jˈæ n
манăн	m ˈa n (͡e͡n)ˌe͡ɪbɹˈiːv(͡c͡v) n
машина	maʃˈina
мел	mˈɛl
наука	naˈuka
обкомĕн	ˈɔ b k ˈɔ m (͡e͡n)ˌiːbɹˈiːv(͡c͡v) n
орденне	ɔrdˈɛnnɛ
пĕлмен	p (͡e͡n)ˌiːbɹˈiːv(͡c͡v) l m jˈæ n
пĕтерет	p (͡e͡n)ˌiːbɹˈiːv(͡c͡v) t jˈɛ r jˈɛ t
пайĕнчи	p ˈa j (͡e͡n)ˌiːbɹˈiːv(͡c͡v) n t͡ʃ ˈɪ
пайлама	pajlˈama
палăрнă	p ˈa l (͡e͡n)ˌe͡ɪbɹˈiːv(͡c͡v) r n (͡e͡n)ˌe͡ɪbɹˈiːv(͡c͡v)
палăртман	p ˈa l (͡e͡n)ˌe͡ɪbɹˈiːv(͡c͡v) r t m ˈa n
палăрту	p ˈa l (͡e͡n)ˌe͡ɪbɹˈiːv(͡c͡v) r t ˈʊ
паллăха	p ˈa l l (͡e͡n)ˌe͡ɪbɹˈiːv(͡c͡v) x ˈa
парас	pˈaɾas
парнин	pˈarnɪn
партизан	partˈizan
пахалăхне	p ˈa x ˈa l (͡e͡n)ˌe͡ɪbɹˈiːv(͡c͡v) x n jˈɛ
пахча	pˈaxt͡ʃa
пеме	pˈɛmɛ
порт	pˈɔrt
посёлокĕнче	p ˈɔ s jˈɔ l ˈɔ k (͡e͡n)ˌiːbɹˈiːv(͡c͡v) n t͡ʃ jˈɛ
провинцийĕ	p r ˈɔ v ˈɪ n t͡s ˈɪ j (͡e͡n)ˌiːbɹˈiːv(͡c͡v)
промăçлă	p r ˈɔ m (͡e͡n)ˌe͡ɪbɹˈiːv sˌiːsədˈɪlɐ(͡c͡v) l (͡e͡n)ˌe͡ɪbɹˈiːv(͡c͡v)
пуçĕ	p ˈʊ (͡e͡n)sˌiːsədˈɪlɐ ˌiːbɹˈiːv(͡c͡v)
пурăнакансен	p ˈʊ r (͡e͡n)ˌe͡ɪbɹˈiːv(͡c͡v) n ˈa k ˈa n s jˈæ n
пурăнман	p ˈʊ r (͡e͡n)ˌe͡ɪbɹˈiːv(͡c͡v) n m ˈa n
пурнать	pˈʊrnat
пуҫласа	pʊçlˈasa
пырас	pˈɯɾas
районăн	r ˈa j ˈɔ n (͡e͡n)ˌe͡ɪbɹˈiːv(͡c͡v) n
районĕсене	r ˈa j ˈɔ n (͡e͡n)ˌiːbɹˈiːv(͡c͡v) s jˈæ n jˈɛ
ред	rˈɛd
роль	rˈɔl
сăмахăн	s (͡e͡n)ˌe͡ɪbɹˈiːv(͡c͡v) m ˈa x (͡e͡n)ˌe͡ɪbɹˈiːv(͡c͡v) n
сăмахĕсене	s (͡e͡n)ˌe͡ɪbɹˈiːv(͡c͡v) m ˈa x (͡e͡n)ˌiːbɹˈiːv(͡c͡v) s jˈæ n jˈɛ
сăнĕ	s (͡e͡n)ˌe͡ɪbɹˈiːv(͡c͡v) n (͡e͡n)ˌiːbɹˈiːv(͡c͡v)
сăнарлă	s (͡e͡n)ˌe͡ɪbɹˈiːv(͡c͡v) n ˈa r l (͡e͡n)ˌe͡ɪbɹˈiːv(͡c͡v)
саккун	sˈakkʊn
салатса	salˈatsa
салтаксем	saltˈaksɛm
сарма	sˈarma
станцийĕ	s t ˈa n t͡s ˈɪ j (͡e͡n)ˌiːbɹˈiːv(͡c͡v)
сысна	sˈɯsna
сыхланă	s ˈɯ x l ˈa n (͡e͡n)ˌe͡ɪbɹˈiːv(͡c͡v)
тăваттăмĕш	t (͡e͡n)ˌe͡ɪbɹˈiːv(͡c͡v) v ˈa t t (͡e͡n)ˌe͡ɪbɹˈiːv(͡c͡v) m (͡e͡n)ˌiːbɹˈiːv(͡c͡v) ʃ
тăрăха	t (͡e͡n)ˌe͡ɪbɹˈiːv(͡c͡v) r (͡e͡n)ˌe͡ɪbɹˈiːv(͡c͡v) x ˈa
тĕнчи	t (͡e͡n)ˌiːbɹˈiːv(͡c͡v) n t͡ʃ ˈɪ
тĕпчес	t (͡e͡n)ˌiːbɹˈiːv(͡c͡v) p t͡ʃ jˈɛ s
тавăрнă	t ˈa v (͡e͡n)ˌe͡ɪbɹˈiːv(͡c͡v) r n (͡e͡n)ˌe͡ɪbɹˈiːv(͡c͡v)
тахçан	t ˈa x (͡e͡n)sˌiːsədˈɪlɐ(͡c͡v) ˈa n
тахçанах	t ˈa x (͡e͡n)sˌiːsədˈɪlɐ(͡c͡v) ˈa n ˈa x
театрта	tɛˈatrta
тенипе	tɛnˈipɛ
тепĕртакран	t jˈɛ p (͡e͡n)ˌiːbɹˈiːv(͡c͡v) r t ˈa k r ˈa n
тинĕсне	t ˈɪ n (͡e͡n)ˌiːbɹˈiːv(͡c͡v) s n jˈɛ
тумтир	tˈʊmtɪr
тупăннă	t ˈʊ p (͡e͡n)ˌe͡ɪbɹˈiːv(͡c͡v) n n (͡e͡n)ˌe͡ɪbɹˈiːv(͡c͡v)
тӗнче	tˈɵnt͡ʃɛ
тӗнчери	tɵnt͡ʃˈɛɾɪ
уçăмлă	ˈʊ (͡e͡n)sˌiːsədˈɪlɐ ˌe͡ɪbɹˈiːv(͡c͡v) m l (͡e͡n)ˌe͡ɪbɹˈiːv(͡c͡v)
уйăхра	ˈʊ j (͡e͡n)ˌe͡ɪbɹˈiːv(͡c͡v) x r ˈa
уйăхран	ˈʊ j (͡e͡n)ˌe͡ɪbɹˈiːv(͡c͡v) x r ˈa n
уйрӑмах	ʊjrˈɯmax
украин	ʊkrˈaɪn
улшăнать	ˈʊ l ʃ (͡e͡n)ˌe͡ɪbɹˈiːv(͡c͡v) n ˈa t
унтах	ˈʊntax
уран	ˈuɾan
усăллă	ˈʊ s (͡e͡n)ˌe͡ɪbɹˈiːv(͡c͡v) l l (͡e͡n)ˌe͡ɪbɹˈiːv(͡c͡v)
финн	fˈɪnn
хăйăр	x (͡e͡n)ˌe͡ɪbɹˈiːv(͡c͡v) j (͡e͡n)ˌe͡ɪbɹˈiːv(͡c͡v) r
хăйех	x (͡e͡n)ˌe͡ɪbɹˈiːv(͡c͡v) j jˈɛ x
хĕл	x (͡e͡n)ˌiːbɹˈiːv(͡c͡v) l
хĕрес	x (͡e͡n)ˌiːbɹˈiːv(͡c͡v) r jˈɛ s
хĕррипе	x (͡e͡n)ˌiːbɹˈiːv(͡c͡v) r r ˈɪ p jˈɛ
хĕсĕк	x (͡e͡n)ˌiːbɹˈiːv(͡c͡v) s (͡e͡n)ˌiːbɹˈiːv(͡c͡v) k
хĕсмете	x (͡e͡n)ˌiːbɹˈiːv(͡c͡v) s m jˈɛ t jˈɛ
хаçатсенче	x ˈa (͡e͡n)sˌiːsədˈɪlɐ(͡c͡v) ˈa t s jˈæ n t͡ʃ jˈɛ
хакĕ	x ˈa k (͡e͡n)ˌiːbɹˈiːv(͡c͡v)
халăхра	x ˈa l (͡e͡n)ˌe͡ɪbɹˈiːv(͡c͡v) x r ˈa
хистенĕ	x ˈɪ s t jˈæ n (͡e͡n)ˌiːbɹˈiːv(͡c͡v)
хор	xˈɔr
хуçа	x ˈʊ (͡e͡n)sˌiːsədˈɪlɐ(͡c͡v) ˈa
хуçалăхĕнче	x ˈʊ (͡e͡n)sˌiːsədˈɪlɐ(͡c͡v) ˈa l (͡e͡n)ˌe͡ɪbɹˈiːv(͡c͡v) x (͡e͡n)ˌiːbɹˈiːv(͡c͡v) n t͡ʃ jˈɛ
хуçаланнă	x ˈʊ (͡e͡n)sˌiːsədˈɪlɐ(͡c͡v) ˈa l ˈa n n (͡e͡n)ˌe͡ɪbɹˈiːv(͡c͡v)
хунӑ	xˈunɯ
хупнă	x ˈʊ p n (͡e͡n)ˌe͡ɪbɹˈiːv(͡c͡v)
хушшине	xʊʃʃˈinɛ
хӳме	xˈymɛ
хӳтĕлекен	x ˈø t (͡e͡n)ˌiːbɹˈiːv(͡c͡v) l jˈɛ k jˈæ n
чăвашсене	t͡ʃ (͡e͡n)ˌe͡ɪbɹˈiːv(͡c͡v) v ˈa ʃ s jˈæ n jˈɛ
чĕлхен	t͡ʃ (͡e͡n)ˌiːbɹˈiːv(͡c͡v) l x jˈæ n
чĕлхере	t͡ʃ (͡e͡n)ˌiːbɹˈiːv(͡c͡v) l x jˈɛ r jˈɛ
чĕлхисенчен	t͡ʃ (͡e͡n)ˌiːbɹˈiːv(͡c͡v) l x ˈɪ s jˈæ n t͡ʃ jˈæ n
чĕнеççĕ	t͡ʃ (͡e͡n)ˌiːbɹˈiːv(͡c͡v) n jˈɛ (͡e͡n)sˌiːsədˈɪlɐ sˌiːsədˈɪlɐ ˌiːbɹˈiːv(͡c͡v)
чакса	t͡ʃˈaksa
чарма	t͡ʃˈarma
чир	t͡ʃˈɪr
чирлĕ	t͡ʃ ˈɪ r l (͡e͡n)ˌiːbɹˈiːv(͡c͡v)
шут	ʃˈʊt
шутлав	ʃˈʊtlav
шухăша	ʃ ˈʊ x (͡e͡n)ˌe͡ɪbɹˈiːv(͡c͡v) ʃ ˈa
шучӗ	ʃˈut͡ʃɵ
шывсем	ʃˈɯvsɛm
ытлашши	ɯtlˈaʃʃɪ
ыттисене	ˌɯttisˈɛnɛ
элемента	ˌelɛmˈɛnta
элементарлă	ˈæ l jˈæ m jˈæ n t ˈa r l (͡e͡n)ˌe͡ɪbɹˈiːv(͡c͡v)
энциклопедийĕ	ˈæ n t͡s ˈɪ k l ˈɔ p jˈɛ d ˈɪ j (͡e͡n)ˌiːbɹˈiːv(͡c͡v)
эрехĕсем	ˈɛ r jˈɛ x (͡e͡n)ˌiːbɹˈiːv(͡c͡v) s jˈæ m
эскадрильин	ˌɛskadrˈɪlʲɪn
юлман	jˈʊlman
юраман	juɾˈaman
юратса	juɾˈatsa
юхăм	jˈʊ x (͡e͡n)ˌe͡ɪbɹˈiːv(͡c͡v) m
яланхи	jalˈanxɪ
япалана	jˌapalˈana
япун	jˈapʊn
Ҫӗнӗ	çˈɵnɵ
ҫак	çˈak
ҫурҫӗр	çˈʊrçɵr
ӳстерме	østˈɛrmɛ
