र	ɾə
छ	cʰˈə
तर	tˈaɾə
यस	jˈʌs
एक	ˈeːkə
सय	sˈʌjə
भए	bʰˈʌeː
दशमलव	dˈʌʃəmˌələwˌə
म	mə
भई	bʰˈʌi
त	tˈə
रकम	ɾˈʌkəmˌə
घर	ɡʰˈʌɾə
हक	hˈʌkə
कम	kˈʌmə
समय	sˈʌməjˌə
गत	ɡˈʌt
बदर	bˈʌdəɾˌə
थप	tʰˈʌp
ऐन	ˈʌ͡ɪn
अब	ʌbˈə
आज	aːɟˈəː
कर	kˈʌɾə
भएर	bʰəˈeːɾə
सडक	sˈʌɖəkˌə
सफल	sˈʌpʰəl
ऋण	ɾˈɪɳ
उपर	ˈʊpəɾˌə
छलफल	cʰˈʌləpʰˌəl
सदर	sˈʌdəɾˌə
पटक	pˈʌʈəkˌə
नभई	nˈʌbʰəˌiː
असर	ˈʌsəɾˌə
गठन	ɡˈʌʈʰən
फरक	pʰˈʌɾəkˌə
अझ	ˈʌɟʰ
अफ	ˈʌpʰ
मन	mˈʌn
सहज	sˈʌhəɟ
आउन	ˈaːʊn
वन	bˈanˈə
डलर	ɖˈʌləɾˌə
बहस	bˈʌhəs
अवसर	ˈʌwəsˌəɾə
ठहर	ʈʰˈʌhəɾˌə
लगत	lˈʌɡət
भवन	bʰˈʌwən
भएन	bʰˈʌjˈenə
अस	ˈʌs
दल	dˈʌl
चलन	cˈʌlən
गलत	ɡˈʌlət
नगद	nˈʌɡəd
पहल	pˈʌhəl
न	nˈə
आई	ˈaːi
गई	ɡˈʌi
वदर	wˈʌdəɾˌə
दर	dˈʌɾə
नभए	nˈʌbʰəˌeː
आय	ˈaːjə
गएर	ɡəˈeːɾə
बचत	bˈʌcət
आएर	aːˈeːɾə
मत	mˈʌt
पद	pˈʌd
तलब	tˈʌləb
रहन	ɾˈʌhən
सहमत	sˈʌhəmˌət
आठ	ˈaːʈʰ
आए	ˈaːeː
तय	tˈʌjə
of	(͡e͡n)ɒv(͡n͡e)
नगर	nˈʌɡəɾˌə
छन	cʰˈʌn
ऊ	ˈʊ
रन	ɾˈʌn
क	kˈə
टन	ʈˈʌn
बल	bˈʌl
बस	bˈʌs
खपत	kʰˈʌpət
अलग	ˈʌləɡ
आम	ˈaːmə
औसत	ˈʌ͡ʊsət
जब	ɟˈʌb
आव	ˈaːwə
एकपटक	ˈeːkəpˌəʈəkˌə
तल	tˈʌl
तह	tˈʌhə
नभएर	nˌəbʰəˈeːɾə
आयकर	ˈaːjəkˌəɾə
ख	kʰˈə
पसल	pˈʌsəl
असफल	ˈʌsəpʰˌəl
चयन	cˈʌjən
ग	ɡˈə
खबर	kʰˈʌbəɾˌə
गए	ɡˈʌeː
मल	mˈʌl
आयल	ˈaːjəl
लगभग	lˈʌɡəbʰˌəɡ
कदम	kˈʌdəmˌə
आएन	aːˈeːnə
बखत	bˈʌkʰət
News	(͡e͡n)njˈuːz(͡n͡e)
एकल	ˈeːkəl
the	(͡e͡n)ðə(͡n͡e)
यसपटक	jˈʌsəpˌəʈəkˌə
सरह	sˈʌɾəhˌə
Media	(͡e͡n)mˈiːdiːə(͡n͡e)
उपकरण	ˈʊpəkˌəɾəɳ
पटकपटक	pˈʌʈəkˌəpəʈˌəkə
ए	ˈeː
On	(͡e͡n)ˈɒn(͡n͡e)
GorkhapatraSherpa	(͡e͡n)ɡˌɔːkhɐpˈɑːtɹə ʃˈɜːpə(͡n͡e)
Nayanepal	(͡e͡n)nˈe͡ɪe͡ɪnpə͡l(͡n͡e)
April	(͡e͡n)ˈe͡ɪpɹə͡l(͡n͡e)
डर	ɖˈʌɾə
मगर	mˈʌɡəɾˌə
सरल	sˈʌɾəl
वहस	wˈʌhəs
द	dˈə
ABC	(͡e͡n)ˌe͡ɪbˌiːsˈiː(͡n͡e)
Article	(͡e͡n)ˈɑːtɪkə͡l(͡n͡e)
Television	(͡e͡n)tˈɛlɪvˌɪʒən(͡n͡e)
एस	ˈeːs
अचल	ˈʌcəl
More	(͡e͡n)mˈɔː(͡n͡e)
दश	dˈʌʃ
असल	ˈʌsəl
जफत	ɟˈʌpʰət
रगत	ɾˈʌɡət
शहर	ʃˈʌhəɾˌə
एयर	ˈeːjəɾˌə
बम	bˈʌmə
भर	bʰˈʌɾə
हल	hˈʌl
week	(͡e͡n)wˈiːk(͡n͡e)
अपहरण	ˈʌpəhˌəɾəɳ
शव	ʃˈʌwə
FM	(͡e͡n)ˌɛfˈɛm(͡n͡e)
MHzListener	(͡e͡n)ˈɛm ˌe͡ɪt͡ʃzˈɛd lˈɪsənə(͡n͡e)
कमल	kˈʌməl
VideoTuesday	(͡e͡n)vˈɪdɪə͡ʊ tjˈuːzde͡ɪ(͡n͡e)
चरम	cˈʌɾəmˌə
कप	kˈʌp
औषध	ˈʌ͡ʊʂədʰ
दशक	dˈʌʃəkˌə
ऐ	ˈʌ͡ɪ
and	(͡e͡n)and(͡n͡e)
धन	dʰˈʌn
जनरल	ɟˈʌnəɾˌəl
Sherpa	(͡e͡n)ʃˈɜːpə(͡n͡e)
गर	ɡˈʌɾə
अव	ˈʌwə
मदन	mˈʌdən
आरएसआई	ˌaːɾəˌeːsəˈaːi
पर	pˈaɾə
उ	ˈʊ
सबल	sˈʌbəl
कथन	kˈʌtʰən
ओभर	ˈoːbʰəɾˌə
इन	ˈɪn
फर	pʰˈʌɾə
ठहई	ʈʰˈʌhəˌiː
पदक	pˈʌdəkˌə
आउट	ˈaːʊʈ
सहर	sˈʌhəɾˌə
on	(͡e͡n)ˈɒn(͡n͡e)
दस	dˈʌs
प	pˈə
to	(͡e͡n)tuː(͡n͡e)
एम	ˈeːmə
by	(͡e͡n)bˈa͡ɪ(͡n͡e)
हद	hˈʌd
रङ	ɾˈʌŋ
एन	ˈeːnə
आचरण	ˈaːcəɾˌəɳ
एनआरएन	ˌeːnəˌaːɾəˈeːnə
चरण	cˈʌɾəɳ
तलव	tˈʌləwˌə
हङकङ	hˈʌŋəkˌəŋ
अरब	ˈʌɾəb
कलम	kˈʌləmˌə
भरत	bʰˈʌɾət
चल	cˈʌl
तब	tˈʌb
मह	mˈʌhə
फरकफरक	pʰˈʌɾəkˌəpʰəɾˌəkə
हनन	hˈʌnən
कल	kˈʌl
च	cˈə
दशरथ	dˈʌʃəɾˌətʰ
Development	(͡e͡n)dɪvˈɛləpmənt(͡n͡e)
असहज	ˈʌsəhˌəɟ
जनक	ɟˈʌnəkˌə
भएछ	bʰəˈeːcʰə
एफ	ˈeːpʰ
जल	ɟˈʌl
ढल	ɖʰˈʌl
घ	ɡʰˈə
अल	ˈʌl
जनमत	ɟˈʌnəmˌət
वहन	wˈʌhən
रहर	ɾˈʌhəɾˌə
गहन	ɡˈʌhən
स	sˈə
ओम	ˈoːmə
सजग	sˈʌɟəɡ
एसएमएस	ˌeːsəˌeːməˈeːs
दशमलब	dˈʌʃəmˌələb
भइ	bʰˈʌɪ
powered	(͡e͡n)pˈa͡ʊəd(͡n͡e)
रजत	ɾˈʌɟət
डट	ɖˈʌʈ
बकस	bˈʌkəs
अवगत	ˈʌwəɡˌət
छड	cʰˈʌɖ
आगमन	ˈaːɡəmˌən
उप	upˈə
गफ	ɡˈʌpʰ
एकदम	ˈeːkədˌəmə
महल	mˈʌhəl
आर	ˈaːɾə
सन	sˈʌn
जग	ɟˈʌɡ
Nov	(͡e͡n)nˈɒv(͡n͡e)
बहन	bˈʌhən
कदर	kˈʌdəɾˌə
फल	pʰˈʌl
आ	ˈaː
नरम	nˈʌɾəmˌə
अमर	ˈʌməɾˌə
मनन	mˈʌnən
ङ	ŋˈə
उपज	ˈʊpəɟ
झन	ɟʰˈʌn
सब	sˈʌb
अवतरण	ˈʌwətˌəɾəɳ
for	(͡e͡n)fɔː(͡n͡e)
जन	ɟˈʌn
महत	mˈʌhət
थर	tʰˈʌɾə
ल	lˈə
एल	ˈeːl
जस	ɟˈʌs
एफएम	ˌeːpʰəˈeːmə
औ	ˈʌ͡ʊ
financial	(͡e͡n)fa͡ɪnˈanʃə͡l(͡n͡e)
investment	(͡e͡n)ɪnvˈɛstmənt(͡n͡e)
आईएमई	ˌaːɪːˈeːməˌiː
ओपन	ˈoːpən
market	(͡e͡n)mˈɑːkɪt(͡n͡e)
वचन	wˈʌcən
Nepali	(͡e͡n)nɛpˈɑːli(͡n͡e)
दमन	dˈʌmən
दशलमव	dˈʌʃəlˌəməwˌə
अनशन	ˈʌnəʃˌən
सरदर	sˈʌɾədˌəɾə
Office	(͡e͡n)ˈɒfɪs(͡n͡e)
टस	ʈˈʌs
अलगअलग	ˈʌləɡˌəəlˌəɡ
टप	ʈˈʌp
District	(͡e͡n)dˈɪstɹɪkt(͡n͡e)
अफर	ˈʌpʰəɾˌə
लहर	lˈʌhəɾˌə
शपथ	ʃˈʌpətʰ
डबल	ɖˈʌbəl
चहलपहल	cˈʌhəlˌəpəhˌəl
सर	sˈʌɾə
पदम	pˈʌdəmˌə
शरद	ʃˈʌɾəd
Nepal	(͡e͡n)nɛpˈɔːl(͡n͡e)
नआई	nəˈaːi
आउछ	ˈaːʊcʰˌə
उदय	ˈʊdəjˌə
एप	ˈeːp
जय	ɟˈʌjə
मतलब	mˈʌtəlˌəb
नआए	nəˈaːeː
तरल	tˈʌɾəl
एच	ˈeːc
कलर	kˈʌləɾˌə
Published	(͡e͡n)pˈʌblɪʃt(͡n͡e)
सपथ	sˈʌpətʰ
अ	ˈʌ
गजल	ɡˈʌɟəl
नव	nˈʌwə
गण	ɡˈʌɳ
आइ	ˈaːɪ
सह	sˈʌhə
वखत	wˈʌkʰət
Committee	(͡e͡n)kəmˈɪti(͡n͡e)
Information	(͡e͡n)ˌɪnfəmˈe͡ɪʃən(͡n͡e)
नत	nˈʌt
सहन	sˈʌhən
वरपर	wˈʌɾəpˌəɾə
Profile	(͡e͡n)pɹˈə͡ʊfa͡ɪl(͡n͡e)
आङ	ˈaːŋ
ई	ˈiː
वतन	wˈʌtən
ज	ɟˈə
Û	(͡e͡n)jˌuːsˈɜːkəmflˌɛks(͡n͡e)
कमसल	kˈʌməsˌəl
कसरत	kˈʌsəɾˌət
झडप	ɟʰˈʌɖəp
अजय	ˈʌɟəjˌə
आमरण	ˈaːməɾˌəɳ
आजकल	ˈaːɟəkˌəl
नजर	nˈʌɟəɾˌə
Community	(͡e͡n)kəmjˈuːnɪti(͡n͡e)
बचन	bˈʌcən
शरण	ʃˈʌɾəɳ
your	(͡e͡n)jɔː(͡n͡e)
Network	(͡e͡n)nˈɛtwɜːk(͡n͡e)
Please	(͡e͡n)plˈiːz(͡n͡e)
दमक	dˈʌməkˌə
JavaScript	(͡e͡n)d͡ʒˈɑːvə skɹˈɪpt(͡n͡e)
VideoWednesday	(͡e͡n)vˈɪdɪə͡ʊ wˈɛnzde͡ɪ(͡n͡e)
आशय	ˈaːʃəjˌə
comments	(͡e͡n)kˈɒmɛnts(͡n͡e)
view	(͡e͡n)vjˈuː(͡n͡e)
अन	ˈʌn
गगन	ɡˈʌɡən
enable	(͡e͡n)ɛnˈe͡ɪbə͡l(͡n͡e)
जगत	ɟˈʌɡət
बन	bˈʌn
सतह	sˈʌtəhˌə
Forgot	(͡e͡n)fəɡˈɒt(͡n͡e)
password	(͡e͡n)pˈaswɜːd(͡n͡e)
आइरन	ˈaːɪɾˌən
in	(͡e͡n)ˈɪn(͡n͡e)
एनआरएनए	ˌeːnəˌaːɾəˈeːnəˌeː
Agriculture	(͡e͡n)ˈaɡɹɪkˌʌlt͡ʃə(͡n͡e)
पतन	pˈʌtən
महŒव	mˈʌhə(͡e͡n)lˌɪɡɐt͡ʃəə͡ʊˈiː(͡n͡e)wˈə
सदन	sˈʌdən
दमकल	dˈʌməkˌəl
नगई	nˈʌɡəˌiː
आकलन	ˈaːkəlˌən
सघन	sˈʌɡʰən
Kunena	(͡e͡n)kʌnˈiːnə(͡n͡e)
असहमत	ˈʌsəhˌəmət
Type	(͡e͡n)tˈa͡ɪp(͡n͡e)
अनसन	ˈʌnəsˌən
भय	bʰˈʌjə
Koirala	(͡e͡n)kwɑːɹˈɑːlə(͡n͡e)
अहमद	ˈʌhəmˌəd
छठ	cʰˈʌʈʰ
Rajesh	(͡e͡n)ɹˈɑːd͡ʒɛʃ(͡n͡e)
एकसय	ˈeːkəsˌəjə
खलल	kʰˈʌləl
थपघट	tʰˈʌpəɡʰˌəʈ
लभ	lˈʌbʰ
पकड	pˈʌkəɖ
खत	kʰˈʌt
घटबढ	ɡʰˈʌʈəbˌəɖʰ
वचत	wˈʌcət
जमघट	ɟˈʌməɡʰˌəʈ
खवर	kʰˈʌwəɾˌə
नहर	nˈʌhəɾˌə
Blog	(͡e͡n)blˈɒɡ(͡n͡e)
एकमत	ˈeːkəmˌət
भजन	bʰˈʌɟən
Radio	(͡e͡n)ɹˈe͡ɪdɪˌə͡ʊ(͡n͡e)
रस	ɾˈʌs
गयल	ɡˈʌjəl
नभइ	nˈʌbʰəˌɪ
पल	pˈʌl
डन	ɖˈʌn
तक	tˈʌkə
हटक	hˈʌʈəkˌə
Archive	(͡e͡n)ˈɑːka͡ɪv(͡n͡e)
अडर	ˈʌɖəɾˌə
पवन	pˈʌwən
वजन	wˈʌɟən
ऐजन	ˈʌ͡ɪɟən
पप	pˈʌp
Language	(͡e͡n)lˈaŋɡwɪd͡ʒ(͡n͡e)
अप	ˈʌp
नकआउट	nˌəkəˈaːʊʈ
सकभर	sˈʌkəbʰˌəɾə
Culture	(͡e͡n)kˈʌlt͡ʃə(͡n͡e)
Himali	(͡e͡n)hɪmˈɑːli(͡n͡e)
Programs	(͡e͡n)pɹˈə͡ʊɡɹamz(͡n͡e)
Songs	(͡e͡n)sˈɒŋz(͡n͡e)
Education	(͡e͡n)ˌɛd͡ʒuːkˈe͡ɪʃən(͡n͡e)
हर	hˈʌɾə
September	(͡e͡n)sɛptˈɛmbə(͡n͡e)
सम	sˈʌmə
आउ	ˈaːʊ
महमद	mˈʌhəmˌəd
रतन	ɾˈʌtən
कभर	kˈʌbʰəɾˌə
सटर	sˈʌʈəɾˌə
समर	sˈʌməɾˌə
खस	kʰˈʌs
हट	hˈʌʈ
लय	lˈʌjə
बगर	bˈʌɡəɾˌə
बलर	bˈʌləɾˌə
सनद	sˈʌnəd
एड	ˈeːɖ
रहनसहन	ɾˈʌhənˌəsəhˌən
लज	lˈʌɟ
Journalist	(͡e͡n)d͡ʒˈɜːnəlˌɪst(͡n͡e)
ऊन	ˈʊn
दम	dˈʌmə
आदर	ˈaːdəɾˌə
दलगत	dˈʌləɡˌət
रबर	ɾˈʌbəɾˌə
BASHYAL	(͡e͡n)bˈaʃɪə͡l(͡n͡e)
PRADEEP	(͡e͡n)pɹˈadiːp(͡n͡e)
आश	ˈaːʃ
टच	ʈˈʌc
अलआउट	ˌələˈaːʊʈ
आइटम	ˈaːɪʈˌəmə
आईएमएफ	ˌaːɪːˌeːməˈeːpʰ
भन	bʰˈʌn
August	(͡e͡n)ˈɔːɡəst(͡n͡e)
The	(͡e͡n)ðə(͡n͡e)
आईएसओ	ˌaːɪːˈeːsəˌoː
बटन	bˈʌʈən
हलचल	hˈʌləcˌəl
कसर	kˈʌsəɾˌə
मठ	mˈʌʈʰ
Sunday	(͡e͡n)sˈʌnde͡ɪ(͡n͡e)
Thursday	(͡e͡n)θˈɜːzde͡ɪ(͡n͡e)
उस	ˈʊs
तहसनहस	tˈʌhəsˌənəhˌəs
मतलव	mˈʌtəlˌəwə
जव	ɟˈʌʋə
रक	ɾˈʌkə
Association	(͡e͡n)ɐsˌə͡ʊsɪˈe͡ɪʃən(͡n͡e)
अनवरत	ˈʌnəwˌəɾət
एकएक	ˌeːkəˈeːkə
एमए	ˈeːməˌeː
चमक	cˈʌməkˌə
झ	ɟʰˈə
बबई	bˈʌbəˌiː
खर	kʰˈʌɾə
झलक	ɟʰˈʌləkˌə
नटआउट	nˌəʈəˈaːʊʈ
लक	lˈʌkə
वकस	wˈʌkəs
अथक	ˈʌtʰəkˌə
ऐनअ	ˈʌ͡ɪnəˌə
ओठ	ˈoːʈʰ
करण	kˈʌɾəɳ
मलजल	mˈʌləɟˌəl
समथर	sˈʌmətʰˌəɾə
Tuesday	(͡e͡n)tjˈuːzde͡ɪ(͡n͡e)
एज	ˈeːɟ
महìव	mˈʌhə(͡e͡n)ˌa͡ɪɡɹˈɑːv(͡n͡e)wˈə
लस	lˈʌs
अत	ˈʌt
चलअचल	cˈʌləˌəcəl
लगन	lˈʌɡən
हरण	hˈʌɾəɳ
Monday	(͡e͡n)mˈʌnde͡ɪ(͡n͡e)
a	(͡e͡n)ˈe͡ɪ(͡n͡e)
are	(͡e͡n)ɑː(͡n͡e)
अपर	ˈʌpəɾˌə
इयर	ˈɪjəɾˌə
July	(͡e͡n)d͡ʒuːlˈa͡ɪ(͡n͡e)
Khotang	(͡e͡n)kˈɒtaŋ(͡n͡e)
अलमल	ˈʌləmˌəl
असन	ˈʌsən
आसन	ˈaːsən
ओभरबट	ˈoːbʰəɾˌəbəʈ
कसम	kˈʌsəmˌə
गज	ɡˈʌɟ
तहतह	tˈʌhətˌəhə
शतक	ʃˈʌtəkˌə
सवल	sˈʌwəl
आस	ˈaːs
ओएस	oːˈeːs
हब	hˈʌb
आवत	ˈaːwət
एचआर	ˌeːcəˈaːɾə
परम	pˈʌɾəmˌə
Click	(͡e͡n)klˈɪk(͡n͡e)
Friday	(͡e͡n)fɹˈa͡ɪde͡ɪ(͡n͡e)
Right	(͡e͡n)ɹˈa͡ɪt(͡n͡e)
page	(͡e͡n)pˈe͡ɪd͡ʒ(͡n͡e)
आवरण	ˈaːwəɾˌəɳ
गरम	ɡˈʌɾəmˌə
दखल	dˈʌkʰəl
लखन	lˈʌkʰən
CHIRAG	(͡e͡n)kˈa͡ɪɹaɡ(͡n͡e)
Onta	(͡e͡n)ˈɒntə(͡n͡e)
Rama	(͡e͡n)ɹˈɑːmə(͡n͡e)
Wednesday	(͡e͡n)wˈɛnzde͡ɪ(͡n͡e)
Okhaldhunga	(͡e͡n)ˈɒkhɐldhˌʌŋɡə(͡n͡e)
is	(͡e͡n)ɪz(͡n͡e)
एमएम	ˌeːməˈeːmə
एयरबस	ˈeːjəɾˌəbəs
लङ	lˈʌŋ
इ	ˈɪ
ओ	ˈoː
नर	nˈʌɾə
बटम	bˈʌʈəmˌə
बढ	bˈʌɖʰ
Post	(͡e͡n)pˈə͡ʊst(͡n͡e)
एवम	ˈeːwəmˌə
पठन	pˈʌʈʰən
here	(͡e͡n)hˈi͡ə(͡n͡e)
not	(͡e͡n)nˈɒt(͡n͡e)
डटकम	ɖˈʌʈəkˌəmə
हरदम	hˈʌɾədˌəmə
अपचलन	ˈʌpəcˌələn
आइस	ˈaːɪs
आलम	ˈaːləmˌə
ओभन	ˈoːbʰən
घरजम	ɡʰˈʌɾəɟˌəmə
भरसक	bʰˈʌɾəsˌəkə
लत	lˈʌt
औषत	ˈʌ͡ʊʂət
कटन	kˈʌʈən
नइ	nˈʌɪ
नभईकन	nˌəbʰəˈɪːkən
भगत	bʰˈʌɡət
सकल	sˈʌkəl
ह	hˈə
बबरमहल	bˈʌbəɾˌəməhˌəl
Website	(͡e͡n)wˈɛbsa͡ɪt(͡n͡e)
this	(͡e͡n)ðˈɪs(͡n͡e)
अतएव	ˌətəˈeːwə
आड	ˈaːɖ
छत	cʰˈʌt
छनक	cʰˈʌnəkˌə
जड	ɟˈʌɖ
वध	wˈʌdʰ
सग	sˈʌɡ
Mr	(͡e͡n)mˈɪstə(͡n͡e)
ट	ʈˈə
तहगत	tˈʌhəɡˌət
नट	nˈʌʈ
रड	ɾˈʌɖ
रण	ɾˈʌɳ
शत	ʃˈʌt
be	(͡e͡n)bˈiː(͡n͡e)
लकर	lˈʌkəɾˌə
वल	wˈʌl
Source	(͡e͡n)sˈɔːs(͡n͡e)
ठहउन	ʈʰˈʌhəˌʊn
नङ	nˈʌŋ
फन	pʰˈʌn
यम	jˈʌmə
रथ	ɾˈʌtʰ
Police	(͡e͡n)pəlˈiːs(͡n͡e)
आईओएस	ˌaːɪːoːˈeːs
टक	ʈˈʌkə
मउपर	mˈʌʊpˌəɾə
वर	wˈaɾəː
Department	(͡e͡n)dɪpˈɑːtmənt(͡n͡e)
National	(͡e͡n)nˈaʃənə͡l(͡n͡e)
इज	ˈɪɟ
इलम	ˈɪləmˌə
कलह	kˈʌləhˌə
शब	ʃˈʌb
सल	sˈʌl
DDC	(͡e͡n)dˌiːdˌiːsˈiː(͡n͡e)
May	(͡e͡n)mˈe͡ɪ(͡n͡e)
अरव	ˈʌɾəwˌə
आऊ	ˈaːʊ
आयतन	ˈaːjətˌən
आवर	ˈaːwəɾˌə
ओपनर	ˈoːpənˌəɾə
ठग	ʈʰˈʌɡ
पथ	pˈʌtʰ
Category	(͡e͡n)kˈatɪɡəɹi(͡n͡e)
General	(͡e͡n)d͡ʒˈɛnəɹə͡l(͡n͡e)
आइडल	ˈaːɪɖˌəl
आइसर	ˈaːɪsˌəɾə
आयत	ˈaːjət
दह	dˈʌhə
International	(͡e͡n)ˌɪntənˈaʃənə͡l(͡n͡e)
cancel	(͡e͡n)kˈansə͡l(͡n͡e)
reply	(͡e͡n)ɹɪplˈa͡ɪ(͡n͡e)
आमद	ˈaːməd
य	jˈə
रमण	ɾˈʌməɳ
अबसर	ˈʌbəsˌəɾə
आहत	ˈaːhət
ओत	ˈoːt
चरन	cˈʌɾən
नवल	nˈʌwəl
लख	lˈʌkʰ
लचक	lˈʌcəkˌə
June	(͡e͡n)d͡ʒˈuːn(͡n͡e)
Management	(͡e͡n)mˈanɪd͡ʒmənt(͡n͡e)
अटल	ˈʌʈəl
एट	ˈeːʈ
एनएस	ˌeːnəˈeːs
कट	kˈʌʈ
कपर	kˈʌpəɾˌə
कलश	kˈʌləʃ
डच	ɖˈʌc
फगत	pʰˈʌɡət
लखनउ	lˈʌkʰənˌəʊ
वम	wˈʌmə
ओमन	ˈoːmən
कपन	kˈʌpən
घरघर	ɡʰˈʌɾəɡʰˌəɾə
छतर	cʰˈʌtəɾˌə
बट	bˈʌʈ
रह	ɾˈʌhə
वस	wˈʌs
हठ	hˈʌʈʰ
January	(͡e͡n)d͡ʒˈanjuːəɹi(͡n͡e)
March	(͡e͡n)mˈɑːt͡ʃ(͡n͡e)
Pvt	(͡e͡n)pˌiːvˌiːtˈiː(͡n͡e)
System	(͡e͡n)sˈɪstəm(͡n͡e)
एमएस	ˌeːməˈeːs
गइ	ɡˈʌɪ
गइन	ɡˈʌɪn
गएछ	ɡəˈeːcʰə
डग	ɖˈʌɡ
रनर	ɾˈʌnəɾˌə
no	(͡e͡n)nˈə͡ʊ(͡n͡e)
आसय	ˈaːsəjˌə
गएन	ɡˈʌjˈenə
टहल	ʈˈʌhəl
मदर	mˈʌdəɾˌə
हसन	hˈʌsən
Fact	(͡e͡n)fˈakt(͡n͡e)
will	(͡e͡n)wˈɪl(͡n͡e)
आफ	ˈaːpʰ
ईआईए	ˌɪːaːˈɪːeː
एअर	ˈeːəɾˌə
कमन	kˈʌmən
धक	dʰˈʌkə
Acts	(͡e͡n)ˈakts(͡n͡e)
Bank	(͡e͡n)bˈaŋk(͡n͡e)
December	(͡e͡n)dɪsˈɛmbə(͡n͡e)
Of	(͡e͡n)ɒv(͡n͡e)
Public	(͡e͡n)pˈʌblɪk(͡n͡e)
at	(͡e͡n)at(͡n͡e)
गन	ɡˈʌn
जनपद	ɟˈʌnəpˌəd
जमल	ɟˈʌməl
रनरअप	ɾˈʌnəɾˌəəp
लगइन	lˈʌɡəˌɪn
शट	ʃˈʌʈ
BirgunjObjectives	(͡e͡n)bˈɜːɡʌnd͡ʒ ɒbd͡ʒˈɛktɪvz(͡n͡e)
CellEconomic	(͡e͡n)sˈɛl ˌiːkənˈɒmɪk(͡n͡e)
Efficiency	(͡e͡n)ɪfˈɪʃənsi(͡n͡e)
Enterprise	(͡e͡n)ˈɛntəpɹˌa͡ɪz(͡n͡e)
Flash	(͡e͡n)flˈaʃ(͡n͡e)
FundEnergy	(͡e͡n)fˈʌnd ˈɛnəd͡ʒi(͡n͡e)
Myagdi	(͡e͡n)ma͡ɪˈaɡdi(͡n͡e)
OrganizationGovernment	(͡e͡n)ˌɔːɡɐna͡ɪzˈe͡ɪʃən ɡˈʌvənmənt(͡n͡e)
Palmer	(͡e͡n)pˈɑːmə(͡n͡e)
Policies	(͡e͡n)pˈɒlɪsiz(͡n͡e)
Saturday	(͡e͡n)sˈatədˌe͡ɪ(͡n͡e)
Tamang	(͡e͡n)tˈamaŋ(͡n͡e)
email	(͡e͡n)ˈiːme͡ɪl(͡n͡e)
published	(͡e͡n)pˈʌblɪʃt(͡n͡e)
इट	ˈɪʈ
खतम	kʰˈʌtəmˌə
ठह	ʈʰˈʌhə
पन	pˈʌn
व	wˈə
सरहद	sˈʌɾəhˌəd
A	(͡e͡n)ˈe͡ɪ(͡n͡e)
Adhikaree	(͡e͡n)ɐdhˈɪkɐɹˌiː(͡n͡e)
Chirag	(͡e͡n)kˈa͡ɪɹaɡ(͡n͡e)
Convention	(͡e͡n)kənvˈɛnʃən(͡n͡e)
Doctrine	(͡e͡n)dˈɒktɹɪn(͡n͡e)
November	(͡e͡n)nə͡ʊvˈɛmbə(͡n͡e)
ONLINEPersonal	(͡e͡n)ˈɒnla͡ɪn pˈɜːsənə͡l(͡n͡e)
ONLINESHARAD	(͡e͡n)ˈɒnla͡ɪnʃˌaɹad(͡n͡e)
SHARAD	(͡e͡n)ʃˈaɹad(͡n͡e)
Sharad	(͡e͡n)ʃˈaɹad(͡n͡e)
m	(͡e͡n)ˈɛm(͡n͡e)
उठबस	ˈʊʈʰəbˌəs
झपट	ɟʰˈʌpəʈ
ञ	ɲˈə
ड	ɖˈə
तथ	tˈʌtʰ
दलहन	dˈʌləhˌən
नभइकन	nˈʌbʰəˌɪkən
Business	(͡e͡n)bˈɪznəs(͡n͡e)
Ministry	(͡e͡n)mˈɪnɪstɹi(͡n͡e)
Portal	(͡e͡n)pˈɔːtə͡l(͡n͡e)
State	(͡e͡n)stˈe͡ɪt(͡n͡e)
Structure	(͡e͡n)stɹˈʌkt͡ʃə(͡n͡e)
There	(͡e͡n)ðˈe͡ə(͡n͡e)
Your	(͡e͡n)jɔː(͡n͡e)
आईए	aːˈɪːeː
आपत	ˈaːpət
ककस	kˈʌkəs
गजब	ɡˈʌɟəb
गणक	ɡˈʌɳəkˌə
जलप	ɟˈʌləp
टम	ʈˈʌmə
तसथ	tˈʌsətʰ
शय	ʃˈʌjə
October	(͡e͡n)ɒktˈə͡ʊbə(͡n͡e)
closed	(͡e͡n)klˈə͡ʊzd(͡n͡e)
posts	(͡e͡n)pˈə͡ʊsts(͡n͡e)
support	(͡e͡n)səpˈɔːt(͡n͡e)
आएछ	aːˈeːcʰə
ओखर	ˈoːkʰəɾˌə
खयर	kʰˈʌjəɾˌə
खसम	kʰˈʌsəmˌə
घटक	ɡʰˈʌʈəkˌə
घन	ɡʰˈʌn
ध	dʰˈə
मई	mˈʌi
मखन	mˈʌkʰən
मगज	mˈʌɡəɟ
लगईन	lˌəɡəˈɪːn
सकस	sˈʌkəs
समतल	sˈʌmətˌəl
समन	sˈʌmən
II	(͡e͡n)ɹˌə͡ʊmən tˈuː(͡n͡e)
Service	(͡e͡n)sˈɜːvɪs(͡n͡e)
Time	(͡e͡n)tˈa͡ɪm(͡n͡e)
related	(͡e͡n)ɹɪlˈe͡ɪtɪd(͡n͡e)
अभय	ˈʌbʰəjˌə
आइएमई	ˌaːɪˈeːməˌiː
एमएएच	ˌeːməeːˈeːc
कण	kˈʌɳ
कसमस	kˈʌsəmˌəs
तव	tˈʌwə
धरपकड	dʰˈʌɾəpˌəkəɖ
नगए	nˈʌɡəˌeː
भएउपर	bʰəˈeːʊpˌəɾə
वहश	wˈʌhəʃ
सव	sˈʌwə
सस	sˈʌs
Koshi	(͡e͡n)kˈə͡ʊʃi(͡n͡e)
Martin	(͡e͡n)mˈɑːtɪn(͡n͡e)
PDF	(͡e͡n)pˌiːdˌiːˈɛf(͡n͡e)
Rights	(͡e͡n)ɹˈa͡ɪts(͡n͡e)
address	(͡e͡n)ɐdɹˈɛs(͡n͡e)
download	(͡e͡n)dˈa͡ʊnlə͡ʊd(͡n͡e)
with	(͡e͡n)wɪð(͡n͡e)
अवध	ˈʌwədʰ
अवल	ˈʌwəl
गडबड	ɡˈʌɖəbˌəɖ
धर	dʰˈʌɾə
नरमगरम	nˈʌɾəmˌəɡəɾˌəmə
मफलर	mˈʌpʰəlˌəɾə
रम	ɾˈʌmə
सजक	sˈʌɟəkˌə
हज	hˈʌɟ
College	(͡e͡n)kˈɒlɪd͡ʒ(͡n͡e)
February	(͡e͡n)fˈɛbɹuːəɹi(͡n͡e)
create	(͡e͡n)kɹiːˈe͡ɪt(͡n͡e)
p	(͡e͡n)pˈiː(͡n͡e)
seconds	(͡e͡n)sˈɛkəndz(͡n͡e)
आइज	ˈaːɪɟ
इभन	ˈɪbʰən
एव	ˈeːwə
एसएलआर	ˌeːsəˌeːləˈaːɾə
एसर	ˈeːsəɾˌə
ओज	ˈoːɟ
कवल	kˈʌwəl
पख	pˈʌkʰ
ब	bˈə
लट	lˈʌʈ
सट	sˈʌʈ
सयर	sˈʌjəɾˌə
Chautari	(͡e͡n)t͡ʃɔːtˈɑːɹi(͡n͡e)
Human	(͡e͡n)hjˈuːmən(͡n͡e)
Land	(͡e͡n)lˈand(͡n͡e)
Nepalese	(͡e͡n)nˌɛpəlˈiːz(͡n͡e)
Organization	(͡e͡n)ˌɔːɡɐna͡ɪzˈe͡ɪʃən(͡n͡e)
Sunsari	(͡e͡n)sʌnsˈɑːɹi(͡n͡e)
Written	(͡e͡n)ɹˈɪtən(͡n͡e)
discussions	(͡e͡n)dɪskˈʌʃənz(͡n͡e)
organizes	(͡e͡n)ˈɔːɡənˌa͡ɪzɪz(͡n͡e)
twice	(͡e͡n)twˈa͡ɪs(͡n͡e)
आईएल	ˌaːɪːˈeːl
आप	ˈaːp
करम	kˈʌɾəmˌə
गड	ɡˈʌɖ
घट	ɡʰˈʌʈ
तन	tˈʌn
नन	nˈʌn
बरफ	bˈʌɾəpʰ
मटन	mˈʌʈən
वरण	wˈʌɾəɳ
शप	ʃˈʌp
bichar	(͡e͡n)bˈɪt͡ʃɑː(͡n͡e)
or	(͡e͡n)ɔː(͡n͡e)
vs	(͡e͡n)vˌiːˈɛs(͡n͡e)
अनपढ	ˈʌnəpˌəɖʰ
अहम	ˈʌhəmˌə
आइएस	ˌaːɪˈeːs
आठसय	ˈaːʈʰəsˌəjə
उठन	ˈʊʈʰən
कद	kˈʌd
ढ	ɖʰˈə
तŒव	tˈə(͡e͡n)lˌɪɡɐt͡ʃəə͡ʊˈiː(͡n͡e)wˈə
नआउन	nəˈaːʊn
परल	pˈʌɾəl
बटर	bˈʌʈəɾˌə
बढन	bˈʌɖʰən
बसर	bˈʌsəɾˌə
भइन	bʰˈʌɪn
भईकन	bʰəˈɪːkən
मम	mˈʌmə
यमन	jˈʌmən
लव	lˈʌwə
सत	sˈʌt
By	(͡e͡n)bˈa͡ɪ(͡n͡e)
Limited	(͡e͡n)lˈɪmɪtɪd(͡n͡e)
MRP	(͡e͡n)ˌɛmˌɑːpˈiː(͡n͡e)
NRN	(͡e͡n)ˌɛnˌɑːɹˈɛn(͡n͡e)
Union	(͡e͡n)jˈuːni͡ən(͡n͡e)
pathak	(͡e͡n)pˈaθak(͡n͡e)
website	(͡e͡n)wˈɛbsa͡ɪt(͡n͡e)
अमन	ˈʌmən
आइकन	ˈaːɪkˌən
आरआर	ˌaːɾəˈaːɾə
आरन	ˈaːɾən
इगल	ˈɪɡəl
इद	ˈɪd
एफएस	ˌeːpʰəˈeːs
एलओआई	ˌeːləoːˈaːi
एसएस	ˌeːsəˈeːs
कवच	kˈʌwəc
कवर	kˈʌwəɾˌə
जतन	ɟˈʌtən
दहन	dˈʌhən
नरहन	nˈʌɾəhˌən
Ambassador	(͡e͡n)ɐmbˈasədə(͡n͡e)
Browser	(͡e͡n)bɹˈa͡ʊzə(͡n͡e)
Copy	(͡e͡n)kˈɒpɪ(͡n͡e)
Executive	(͡e͡n)ɛɡzˈɛkjuːtˌɪv(͡n͡e)
Internet	(͡e͡n)ˈɪntənˌɛt(͡n͡e)
Law	(͡e͡n)lˈɔː(͡n͡e)
Posts	(͡e͡n)pˈə͡ʊsts(͡n͡e)
Reasonable	(͡e͡n)ɹˈiːzənəbə͡l(͡n͡e)
Sagar	(͡e͡n)sˈaɡə(͡n͡e)
South	(͡e͡n)sˈa͡ʊθ(͡n͡e)
This	(͡e͡n)ðˈɪs(͡n͡e)
doesnot	(͡e͡n)dˈə͡ʊsnɒt(͡n͡e)
iframe	(͡e͡n)ˈɪfɹe͡ɪm(͡n͡e)
news	(͡e͡n)njˈuːz(͡n͡e)
अनलक	ˈʌnəlˌəkə
अर	ˈʌɾə
अवयव	ˈʌwəjˌəwə
आईई	aːˈɪːi
उड	ˈʊɖ
उल	ˈʊl
एडम	ˈeːɖəmˌə
एमआरआई	ˌeːməˌaːɾəˈaːi
कचकच	kˈʌcəkˌəc
खटपट	kʰˈʌʈəpˌəʈ
छर	cʰˈʌɾə
जयनगर	ɟˈʌjənˌəɡəɾˌə
ठ	ʈʰˈə
भइकन	bʰˈʌɪkˌən
भएक	bʰəˈeːkə
लवज	lˈʌwəɟ
हरपल	hˈʌɾəpˌəl
हरफ	hˈʌɾəpʰ
I	(͡e͡n)ˈa͡ɪ(͡n͡e)
Political	(͡e͡n)pəlˈɪtɪkə͡l(͡n͡e)
Prasai	(͡e͡n)pɹˈasa͡ɪ(͡n͡e)
Related	(͡e͡n)ɹɪlˈe͡ɪtɪd(͡n͡e)
Social	(͡e͡n)sˈə͡ʊʃə͡l(͡n͡e)
User	(͡e͡n)jˈuːzə(͡n͡e)
अडचन	ˈʌɖəcˌən
असई	ˈʌsəˌiː
आइन	ˈaːɪn
आइसफल	ˈaːɪsˌəpʰəl
आईएलओ	ˌaːɪːˈeːləˌoː
उन	ˈʊn
एफएओ	ˌeːpʰəˈeːoː
ओस	ˈoːs
कस	kˈʌs
गम	ɡˈʌmə
डक	ɖˈʌkə
तडकभडक	tˈʌɖəkˌəbʰəɖˌəkə
बध	bˈʌdʰ
मकर	mˈʌkəɾˌə
मलम	mˈʌləmˌə
यल	jˈʌl
रजहर	ɾˈʌɟəhˌəɾə
लहड	lˈʌhəɖ
शक	ʃˈʌkə
सतलज	sˈʌtəlˌəɟ
सरस	sˈʌɾəs
ॐ	ˈõm
Act	(͡e͡n)ˈakt(͡n͡e)
China	(͡e͡n)t͡ʃˈa͡ɪnə(͡n͡e)
Designed	(͡e͡n)dɪzˈa͡ɪnd(͡n͡e)
Developed	(͡e͡n)dɪvˈɛləpt(͡n͡e)
Geosoft	(͡e͡n)d͡ʒˌiːə͡ʊsˈɒft(͡n͡e)
Interest	(͡e͡n)ˈɪntɹɛst(͡n͡e)
Isai	(͡e͡n)ˈɪsa͡ɪ(͡n͡e)
Judicial	(͡e͡n)d͡ʒuːdˈɪʃə͡l(͡n͡e)
List	(͡e͡n)lˈɪst(͡n͡e)
Ltd	(͡e͡n)lˈɪmɪtɪd(͡n͡e)
Medical	(͡e͡n)mˈɛdɪkə͡l(͡n͡e)
NRNA	(͡e͡n)ˌɛnˌɑːɹˌɛnˈe͡ɪ(͡n͡e)
Reform	(͡e͡n)ɹɪfˈɔːm(͡n͡e)
Technologies	(͡e͡n)tɛknˈɒləd͡ʒiz(͡n͡e)
Trust	(͡e͡n)tɹˈʌst(͡n͡e)
death	(͡e͡n)dˈɛθ(͡n͡e)
mrpo	(͡e͡n)ˌɛmˌɑːpˌiːˈə͡ʊ(͡n͡e)
आईएफआरएस	ˌaːɪːˌeːpʰəˌaːɾəˈeːs
आईएस	ˌaːɪːˈeːs
आदत	ˈaːdət
गनगन	ɡˈʌnəɡˌən
जनलहर	ɟˈʌnəlˌəhəɾˌə
जबज	ɟˈʌbəɟ
झमक	ɟʰˈʌməkˌə
धनहर	dʰˈʌnəhˌəɾə
नआएर	nˌəaːˈeːɾə
फ	pʰˈə
फरकपन	pʰˈʌɾəkˌəpən
भइरहन	bʰˈʌɪɾˌəhən
मदत	mˈʌdət
रमझम	ɾˈʌməɟʰˌəmə
वगर	wˈʌɡəɾˌə
शयन	ʃˈʌjən
Council	(͡e͡n)kˈa͡ʊnsə͡l(͡n͡e)
Date	(͡e͡n)dˈe͡ɪt(͡n͡e)
Mandali	(͡e͡n)mandˈɑːli(͡n͡e)
Meeting	(͡e͡n)mˈiːtɪŋ(͡n͡e)
New	(͡e͡n)njˈuː(͡n͡e)
No	(͡e͡n)nˈə͡ʊ(͡n͡e)
Principle	(͡e͡n)pɹˈɪnsɪpə͡l(͡n͡e)
Trade	(͡e͡n)tɹˈe͡ɪd(͡n͡e)
Training	(͡e͡n)tɹˈe͡ɪnɪŋ(͡n͡e)
URL	(͡e͡n)jˌuːˌɑːɹˈɛl(͡n͡e)
due	(͡e͡n)djˈuː(͡n͡e)
main	(͡e͡n)mˈe͡ɪn(͡n͡e)
π	(͡e͡l)pˈi(͡n͡e)
अपच	ˈʌpəc
अम	ˈʌmə
आन	ˈaːn
ईन	ˈɪːn
उठ	ˈʊʈʰ
उपलबध	ˈʊpəlˌəbədʰ
एसओएस	ˌeːsəoːˈeːs
ओदश	ˈoːdəʃ
कबल	kˈʌbəl
खट	kʰˈʌʈ
जबजब	ɟˈʌbəɟˌəb
नगएर	nˌəɡəˈeːɾə
नयन	nˈʌjən
पच	pˈʌc
पढ	pˈʌɖʰ
पलङ	pˈʌləŋ
बर	bˈʌɾə
रट	ɾˈʌʈ
रमन	ɾˈʌmən
लग	lˈʌɡ
सई	sˈʌi
सङ	sˈʌŋ
सयम	sˈʌjəmˌə
सरद	sˈʌɾəd
Armed	(͡e͡n)ˈɑːmd(͡n͡e)
Aswini	(͡e͡n)ɐswˈiːnɪ(͡n͡e)
Civil	(͡e͡n)sˈɪvə͡l(͡n͡e)
Corporate	(͡e͡n)kˈɔːpəɹət(͡n͡e)
Dr	(͡e͡n)dˈɒktə(͡n͡e)
Economic	(͡e͡n)ˌiːkənˈɒmɪk(͡n͡e)
Finality	(͡e͡n)fa͡ɪnˈalɪti(͡n͡e)
First	(͡e͡n)fˈɜːst(͡n͡e)
Head	(͡e͡n)hˈɛd(͡n͡e)
High	(͡e͡n)hˈa͡ɪ(͡n͡e)
Justice	(͡e͡n)d͡ʒˈʌstɪs(͡n͡e)
Military	(͡e͡n)mˈɪlɪtəɹi(͡n͡e)
One	(͡e͡n)wˈɒn(͡n͡e)
Report	(͡e͡n)ɹɪpˈɔːt(͡n͡e)
Resource	(͡e͡n)ɹɪzˈɔːs(͡n͡e)
Standard	(͡e͡n)stˈandəd(͡n͡e)
right	(͡e͡n)ɹˈa͡ɪt(͡n͡e)
was	(͡e͡n)wɒz(͡n͡e)
á	(͡e͡n)ˌe͡ɪɐkjˈuːt(͡n͡e)
अपजस	ˈʌpəɟˌəs
आईएमईआई	ˌaːɪːˌeːməɪːˈaːi
आगन	ˈaːɡən
इभ	ˈɪbʰ
ऊड	ˈʊɖ
एनएम	ˌeːnəˈeːmə
एमएल	ˌeːməˈeːl
एसआर	ˌeːsəˈaːɾə
एसएम	ˌeːsəˈeːmə
करङ	kˈʌɾəŋ
करन	kˈʌɾən
चक	cˈʌkə
जनपथ	ɟˈʌnəpˌətʰ
जलचर	ɟˈʌləcˌəɾə
जलन	ɟˈʌlən
ढक	ɖʰˈʌkə
नल	nˈʌl
पलट	pˈʌləʈ
बदल	bˈʌdəl
भएनछ	bʰəˈeːnəcʰˌə
भङ	bʰˈʌŋ
मप	mˈʌp
सघ	sˈʌɡʰ
सनम	sˈʌnəmˌə
सरर	sˈʌɾəɾˌə
हरबखत	hˈʌɾəbˌəkʰət
All	(͡e͡n)ˈɔːl(͡n͡e)
Certificate	(͡e͡n)sətˈɪfɪkət(͡n͡e)
Fair	(͡e͡n)fˈe͡ə(͡n͡e)
Health	(͡e͡n)hˈɛlθ(͡n͡e)
Kathmandu	(͡e͡n)kaθmˌandˈuː(͡n͡e)
Ms	(͡e͡n)ˌɛmˈɛs(͡n͡e)
Page	(͡e͡n)pˈe͡ɪd͡ʒ(͡n͡e)
Plz	(͡e͡n)pˌiːˌɛlzˈɛd(͡n͡e)
Pokhara	(͡e͡n)pˈɒkɑːɹə(͡n͡e)
School	(͡e͡n)skˈuːl(͡n͡e)
Staff	(͡e͡n)stˈaf(͡n͡e)
Technology	(͡e͡n)tɛknˈɒləd͡ʒi(͡n͡e)
World	(͡e͡n)wˈɜːld(͡n͡e)
attachment	(͡e͡n)ɐtˈat͡ʃmənt(͡n͡e)
pm	(͡e͡n)pˌiːˈɛm(͡n͡e)
अनवर	ˈʌnəwˌəɾə
अनशनरत	ˈʌnəʃˌənəɾˌət
असद	ˈʌsəd
एलए	ˈeːləˌeː
ऐनर	ˈʌ͡ɪnəɾˌə
खडग	kʰˈʌɖəɡ
चटक	cˈʌʈəkˌə
तरखर	tˈʌɾəkʰˌəɾə
दसमलव	dˈʌsəmˌələwˌə
पढन	pˈʌɖʰən
पथल	pˈʌtʰəl
परख	pˈʌɾəkʰ
पस	pˈʌs
बज	bˈʌɟ
यश	jˈʌʃ
रनआउट	ɾˌənəˈaːʊʈ
शयर	ʃˈʌjəɾˌə
हजरत	hˈʌɟəɾˌət
हस	hˈʌs
Army	(͡e͡n)ˈɑːmi(͡n͡e)
Bikash	(͡e͡n)bˈɪkaʃ(͡n͡e)
Centre	(͡e͡n)sˈɛntə(͡n͡e)
Command	(͡e͡n)kəmˈand(͡n͡e)
Commerce	(͡e͡n)kˈɒmɜːs(͡n͡e)
Commission	(͡e͡n)kəmˈɪʃən(͡n͡e)
Constituent	(͡e͡n)kənstˈɪtjuːənt(͡n͡e)
Court	(͡e͡n)kˈɔːt(͡n͡e)
DetailsHuman	(͡e͡n)dˈiːte͡ɪlz hjˈuːmən(͡n͡e)
Dharan	(͡e͡n)dˈaɹən(͡n͡e)
Energy	(͡e͡n)ˈɛnəd͡ʒi(͡n͡e)
Gallery	(͡e͡n)ɡˈaləɹi(͡n͡e)
GalleryExecutive	(͡e͡n)ɡˈaləɹi ɛɡzˈɛkjuːtˌɪv(͡n͡e)
ICT	(͡e͡n)ˈa͡ɪkt(͡n͡e)
ID	(͡e͡n)a͡ɪdˈiː(͡n͡e)
India	(͡e͡n)ˈɪndiə(͡n͡e)
Institute	(͡e͡n)ˈɪnstɪtjˌuːt(͡n͡e)
Legal	(͡e͡n)lˈiːɡə͡l(͡n͡e)
Level	(͡e͡n)lˈɛvə͡l(͡n͡e)
Policy	(͡e͡n)pˈɒlɪsi(͡n͡e)
Project	(͡e͡n)pɹˈɒd͡ʒɛkt(͡n͡e)
Reference	(͡e͡n)ɹˈɛfɹəns(͡n͡e)
Rules	(͡e͡n)ɹˈuːlz(͡n͡e)
Singh	(͡e͡n)sˈɪŋ(͡n͡e)
US	(͡e͡n)jˌuːˈɛs(͡n͡e)
Voice	(͡e͡n)vˈɔ͡ɪs(͡n͡e)
Work	(͡e͡n)wˈɜːk(͡n͡e)
Yadav	(͡e͡n)jˈadav(͡n͡e)
nepal	(͡e͡n)nɛpˈɔːl(͡n͡e)
आइएमइ	ˌaːɪˈeːməˌɪ
आईएसआई	ˌaːɪːˌeːsəˈaːi
आरए	ˈaːɾəˌeː
आरओ	ˈaːɾəˌoː
आवशयक	ˈaːwəʃˌəjəkˌə
ईआईएफ	ˌɪːaːɪːˈeːpʰ
एचएच	ˌeːcəˈeːc
एलन	ˈeːlən
ओयल	ˈoːjəl
ओरल	ˈoːɾəl
ओसन	ˈoːsən
कमलदह	kˈʌməlˌədəhˌə
चकचक	cˈʌkəcˌəkə
छलकपट	cʰˈʌləkˌəpəʈ
जप	ɟˈʌp
डल	ɖˈʌl
ण	ɳˈə
तबल	tˈʌbəl
तलतल	tˈʌlətˌəl
नब	nˈʌb
नस	nˈʌs
पज	pˈʌɟ
फसल	pʰˈʌsəl
बत	bˈʌt
बबल	bˈʌbəl
भ	bʰˈə
भईन	bʰəˈɪːn
रफ	ɾˈʌpʰ
सप	sˈʌp
सफर	sˈʌpʰəɾˌə
हम	hˈʌmə
हवस	hˈʌwəs
ADSL	(͡e͡n)ˌe͡ɪdˌiːˌɛsˈɛl(͡n͡e)
Asia	(͡e͡n)ˈe͡ɪʃə(͡n͡e)
Assembly	(͡e͡n)ɐsˈɛmblɪ(͡n͡e)
Center	(͡e͡n)sˈɛntə(͡n͡e)
Central	(͡e͡n)sˈɛntɹə͡l(͡n͡e)
Daily	(͡e͡n)dˈe͡ɪli(͡n͡e)
Declaration	(͡e͡n)dˌɛkləɹˈe͡ɪʃən(͡n͡e)
Division	(͡e͡n)dɪvˈɪʒən(͡n͡e)
Federation	(͡e͡n)fˌɛdəɹˈe͡ɪʃən(͡n͡e)
Framework	(͡e͡n)fɹˈe͡ɪmwɜːk(͡n͡e)
Gen	(͡e͡n)d͡ʒˈɛn(͡n͡e)
Google	(͡e͡n)ɡˈuːɡə͡l(͡n͡e)
Government	(͡e͡n)ɡˈʌvənmənt(͡n͡e)
Issued	(͡e͡n)ˈɪʃuːd(͡n͡e)
Kumar	(͡e͡n)kuːmˈɑː(͡n͡e)
Minister	(͡e͡n)mˈɪnɪstə(͡n͡e)
Performance	(͡e͡n)pəfˈɔːməns(͡n͡e)
Protection	(͡e͡n)pɹətˈɛkʃən(͡n͡e)
SLC	(͡e͡n)ˌɛsˌɛlsˈiː(͡n͡e)
Scanned	(͡e͡n)skˈand(͡n͡e)
law	(͡e͡n)lˈɔː(͡n͡e)
sex	(͡e͡n)sˈɛks(͡n͡e)
अतहर	ˈʌtəhˌəɾə
अमनचयन	ˈʌmənˌəcəjˌən
अलप	ˈʌləp
असम	ˈʌsəmˌə
आइएलओ	ˌaːɪˈeːləˌoː
आईईई	ˌaːɪːˈɪːi
आट	ˈaːʈ
आयरन	ˈaːjəɾˌən
आरएस	ˌaːɾəˈeːs
एएनए	eːˈeːnəˌeː
एकड	ˈeːkəɖ
एकतह	ˈeːkətˌəhə
एमआई	ˌeːməˈaːi
एमआरएफ	ˌeːməˌaːɾəˈeːpʰ
खटन	kʰˈʌʈən
खलक	kʰˈʌləkˌə
खश	kʰˈʌʃ
गल	ɡˈʌl
छल	cʰˈʌl
जगन	ɟˈʌɡən
जयमल	ɟˈʌjəmˌəl
झमझम	ɟʰˈʌməɟʰˌəmə
झवर	ɟʰˈʌwəɾˌə
नभन	nˈʌbʰən
पलपल	pˈʌləpˌəl
फलत	pʰˈʌlət
बलम	bˈʌləmˌə
बसउठ	bˈʌsəˌʊʈʰ
बहश	bˈʌhəʃ
भरण	bʰˈʌɾəɳ
मदननगर	mˈʌdənˌənəɡˌəɾə
मरण	mˈʌɾəɳ
लखनऊ	lˈʌkʰənˌəʊ
ललन	lˈʌlən
